NODE_1_length_25698_cov_36.651041	315	395	3	80	80	1.0000000
NODE_1_length_25698_cov_36.651041	368	403	3	27	35	0.7714286
NODE_1_length_25698_cov_36.651041	368	403	4	3	35	0.0857143
NODE_1_length_25698_cov_36.651041	368	403	6	3	35	0.0857143
NODE_1_length_25698_cov_36.651041	368	403	7	1	35	0.0285714
NODE_1_length_25698_cov_36.651041	368	403	14	1	35	0.0285714
NODE_1_length_25698_cov_36.651041	24448	24494	1	43	46	0.9347826
NODE_1_length_25698_cov_36.651041	24448	24494	2	2	46	0.0434783
NODE_1_length_25698_cov_36.651041	24448	24494	3	1	46	0.0217391
NODE_2_length_24307_cov_15.119712	2613	2689	2	7	76	0.0921053
NODE_2_length_24307_cov_15.119712	2613	2689	3	6	76	0.0789474
NODE_2_length_24307_cov_15.119712	2613	2689	5	2	76	0.0263158
NODE_2_length_24307_cov_15.119712	2613	2689	7	2	76	0.0263158
NODE_2_length_24307_cov_15.119712	2613	2689	8	1	76	0.0131579
NODE_2_length_24307_cov_15.119712	2613	2689	10	14	76	0.1842105
NODE_2_length_24307_cov_15.119712	2613	2689	11	1	76	0.0131579
NODE_2_length_24307_cov_15.119712	2613	2689	12	16	76	0.2105263
NODE_2_length_24307_cov_15.119712	2613	2689	13	5	76	0.0657895
NODE_2_length_24307_cov_15.119712	2613	2689	15	22	76	0.2894737
NODE_2_length_24307_cov_15.119712	2662	2716	13	5	54	0.0925926
NODE_2_length_24307_cov_15.119712	2662	2716	15	24	54	0.4444444
NODE_2_length_24307_cov_15.119712	2662	2716	17	8	54	0.1481481
NODE_2_length_24307_cov_15.119712	2662	2716	18	17	54	0.3148148
NODE_2_length_24307_cov_15.119712	11257	11320	0	63	63	1.0000000
NODE_2_length_24307_cov_15.119712	20621	20701	6	6	80	0.0750000
NODE_2_length_24307_cov_15.119712	20621	20701	7	10	80	0.1250000
NODE_2_length_24307_cov_15.119712	20621	20701	8	13	80	0.1625000
NODE_2_length_24307_cov_15.119712	20621	20701	9	2	80	0.0250000
NODE_2_length_24307_cov_15.119712	20621	20701	10	40	80	0.5000000
NODE_2_length_24307_cov_15.119712	20621	20701	11	9	80	0.1125000
NODE_2_length_24307_cov_15.119712	20674	20754	10	56	80	0.7000000
NODE_2_length_24307_cov_15.119712	20674	20754	11	18	80	0.2250000
NODE_2_length_24307_cov_15.119712	20674	20754	12	1	80	0.0125000
NODE_2_length_24307_cov_15.119712	20674	20754	13	2	80	0.0250000
NODE_2_length_24307_cov_15.119712	20674	20754	14	3	80	0.0375000
NODE_7_length_12349_cov_28.144571	12251	12310	32	1	59	0.0169492
NODE_7_length_12349_cov_28.144571	12251	12310	33	1	59	0.0169492
NODE_7_length_12349_cov_28.144571	12251	12310	35	1	59	0.0169492
NODE_7_length_12349_cov_28.144571	12251	12310	36	2	59	0.0338983
NODE_7_length_12349_cov_28.144571	12251	12310	37	5	59	0.0847458
NODE_7_length_12349_cov_28.144571	12251	12310	38	1	59	0.0169492
NODE_7_length_12349_cov_28.144571	12251	12310	39	3	59	0.0508475
NODE_7_length_12349_cov_28.144571	12251	12310	41	2	59	0.0338983
NODE_7_length_12349_cov_28.144571	12251	12310	43	7	59	0.1186441
NODE_7_length_12349_cov_28.144571	12251	12310	44	1	59	0.0169492
NODE_7_length_12349_cov_28.144571	12251	12310	46	1	59	0.0169492
NODE_7_length_12349_cov_28.144571	12251	12310	48	1	59	0.0169492
NODE_7_length_12349_cov_28.144571	12251	12310	50	1	59	0.0169492
NODE_7_length_12349_cov_28.144571	12251	12310	53	1	59	0.0169492
NODE_7_length_12349_cov_28.144571	12251	12310	54	7	59	0.1186441
NODE_7_length_12349_cov_28.144571	12251	12310	57	1	59	0.0169492
NODE_7_length_12349_cov_28.144571	12251	12310	59	1	59	0.0169492
NODE_7_length_12349_cov_28.144571	12251	12310	63	1	59	0.0169492
NODE_7_length_12349_cov_28.144571	12251	12310	64	3	59	0.0508475
NODE_7_length_12349_cov_28.144571	12251	12310	66	1	59	0.0169492
NODE_7_length_12349_cov_28.144571	12251	12310	67	9	59	0.1525424
NODE_7_length_12349_cov_28.144571	12251	12310	71	3	59	0.0508475
NODE_7_length_12349_cov_28.144571	12251	12310	72	3	59	0.0508475
NODE_7_length_12349_cov_28.144571	12251	12310	74	2	59	0.0338983
NODE_7_length_12349_cov_28.144571	12284	12310	32	1	26	0.0384615
NODE_7_length_12349_cov_28.144571	12284	12310	33	1	26	0.0384615
NODE_7_length_12349_cov_28.144571	12284	12310	35	1	26	0.0384615
NODE_7_length_12349_cov_28.144571	12284	12310	36	2	26	0.0769231
NODE_7_length_12349_cov_28.144571	12284	12310	37	5	26	0.1923077
NODE_7_length_12349_cov_28.144571	12284	12310	38	1	26	0.0384615
NODE_7_length_12349_cov_28.144571	12284	12310	39	3	26	0.1153846
NODE_7_length_12349_cov_28.144571	12284	12310	41	2	26	0.0769231
NODE_7_length_12349_cov_28.144571	12284	12310	43	7	26	0.2692308
NODE_7_length_12349_cov_28.144571	12284	12310	44	1	26	0.0384615
NODE_7_length_12349_cov_28.144571	12284	12310	46	1	26	0.0384615
NODE_7_length_12349_cov_28.144571	12284	12310	48	1	26	0.0384615
NODE_10_length_11096_cov_14.154679	6455	6535	0	37	80	0.4625000
NODE_10_length_11096_cov_14.154679	6455	6535	2	3	80	0.0375000
NODE_10_length_11096_cov_14.154679	6455	6535	3	40	80	0.5000000
NODE_10_length_11096_cov_14.154679	6508	6588	0	68	80	0.8500000
NODE_10_length_11096_cov_14.154679	6508	6588	1	12	80	0.1500000
NODE_10_length_11096_cov_14.154679	6584	6664	1	14	80	0.1750000
NODE_10_length_11096_cov_14.154679	6584	6664	2	9	80	0.1125000
NODE_10_length_11096_cov_14.154679	6584	6664	3	13	80	0.1625000
NODE_10_length_11096_cov_14.154679	6584	6664	4	8	80	0.1000000
NODE_10_length_11096_cov_14.154679	6584	6664	5	27	80	0.3375000
NODE_10_length_11096_cov_14.154679	6584	6664	6	9	80	0.1125000
NODE_10_length_11096_cov_14.154679	6637	6717	5	18	80	0.2250000
NODE_10_length_11096_cov_14.154679	6637	6717	6	10	80	0.1250000
NODE_10_length_11096_cov_14.154679	6637	6717	7	1	80	0.0125000
NODE_10_length_11096_cov_14.154679	6637	6717	9	5	80	0.0625000
NODE_10_length_11096_cov_14.154679	6637	6717	10	23	80	0.2875000
NODE_10_length_11096_cov_14.154679	6637	6717	11	11	80	0.1375000
NODE_10_length_11096_cov_14.154679	6637	6717	12	5	80	0.0625000
NODE_10_length_11096_cov_14.154679	6637	6717	13	6	80	0.0750000
NODE_10_length_11096_cov_14.154679	6637	6717	14	1	80	0.0125000
NODE_10_length_11096_cov_14.154679	7182	7229	242	1	47	0.0212766
NODE_10_length_11096_cov_14.154679	7182	7229	243	1	47	0.0212766
NODE_10_length_11096_cov_14.154679	7182	7229	244	2	47	0.0425532
NODE_10_length_11096_cov_14.154679	7182	7229	245	1	47	0.0212766
NODE_10_length_11096_cov_14.154679	7182	7229	246	3	47	0.0638298
NODE_10_length_11096_cov_14.154679	7182	7229	247	2	47	0.0425532
NODE_10_length_11096_cov_14.154679	7182	7229	248	2	47	0.0425532
NODE_10_length_11096_cov_14.154679	7182	7229	249	5	47	0.1063830
NODE_10_length_11096_cov_14.154679	7182	7229	250	3	47	0.0638298
NODE_10_length_11096_cov_14.154679	7182	7229	251	1	47	0.0212766
NODE_10_length_11096_cov_14.154679	7182	7229	252	1	47	0.0212766
NODE_10_length_11096_cov_14.154679	7182	7229	254	3	47	0.0638298
NODE_10_length_11096_cov_14.154679	7182	7229	256	4	47	0.0851064
NODE_10_length_11096_cov_14.154679	7182	7229	257	5	47	0.1063830
NODE_10_length_11096_cov_14.154679	7182	7229	258	4	47	0.0851064
NODE_10_length_11096_cov_14.154679	7182	7229	260	5	47	0.1063830
NODE_10_length_11096_cov_14.154679	7182	7229	261	2	47	0.0425532
NODE_10_length_11096_cov_14.154679	7182	7229	262	1	47	0.0212766
NODE_10_length_11096_cov_14.154679	7182	7229	264	1	47	0.0212766
NODE_10_length_11096_cov_14.154679	7218	7282	235	1	64	0.0156250
NODE_10_length_11096_cov_14.154679	7218	7282	238	1	64	0.0156250
NODE_10_length_11096_cov_14.154679	7218	7282	239	4	64	0.0625000
NODE_10_length_11096_cov_14.154679	7218	7282	240	5	64	0.0781250
NODE_10_length_11096_cov_14.154679	7218	7282	241	1	64	0.0156250
NODE_10_length_11096_cov_14.154679	7218	7282	242	4	64	0.0625000
NODE_10_length_11096_cov_14.154679	7218	7282	243	5	64	0.0781250
NODE_10_length_11096_cov_14.154679	7218	7282	244	5	64	0.0781250
NODE_10_length_11096_cov_14.154679	7218	7282	245	8	64	0.1250000
NODE_10_length_11096_cov_14.154679	7218	7282	246	4	64	0.0625000
NODE_10_length_11096_cov_14.154679	7218	7282	247	3	64	0.0468750
NODE_10_length_11096_cov_14.154679	7218	7282	248	1	64	0.0156250
NODE_10_length_11096_cov_14.154679	7218	7282	249	3	64	0.0468750
NODE_10_length_11096_cov_14.154679	7218	7282	250	4	64	0.0625000
NODE_10_length_11096_cov_14.154679	7218	7282	251	2	64	0.0312500
NODE_10_length_11096_cov_14.154679	7218	7282	252	3	64	0.0468750
NODE_10_length_11096_cov_14.154679	7218	7282	253	3	64	0.0468750
NODE_10_length_11096_cov_14.154679	7218	7282	254	1	64	0.0156250
NODE_10_length_11096_cov_14.154679	7218	7282	255	1	64	0.0156250
NODE_10_length_11096_cov_14.154679	7218	7282	256	1	64	0.0156250
NODE_10_length_11096_cov_14.154679	7218	7282	257	1	64	0.0156250
NODE_10_length_11096_cov_14.154679	7218	7282	258	1	64	0.0156250
NODE_10_length_11096_cov_14.154679	7218	7282	261	1	64	0.0156250
NODE_10_length_11096_cov_14.154679	7218	7282	263	1	64	0.0156250
NODE_13_length_10749_cov_34.330235	3589	3669	4	8	80	0.1000000
NODE_13_length_10749_cov_34.330235	3589	3669	6	19	80	0.2375000
NODE_13_length_10749_cov_34.330235	3589	3669	7	47	80	0.5875000
NODE_13_length_10749_cov_34.330235	3589	3669	8	6	80	0.0750000
NODE_13_length_10749_cov_34.330235	3642	3722	4	10	80	0.1250000
NODE_13_length_10749_cov_34.330235	3642	3722	5	51	80	0.6375000
NODE_13_length_10749_cov_34.330235	3642	3722	6	19	80	0.2375000
NODE_13_length_10749_cov_34.330235	3718	3798	1	16	80	0.2000000
NODE_13_length_10749_cov_34.330235	3718	3798	2	1	80	0.0125000
NODE_13_length_10749_cov_34.330235	3718	3798	3	35	80	0.4375000
NODE_13_length_10749_cov_34.330235	3718	3798	4	20	80	0.2500000
NODE_13_length_10749_cov_34.330235	3718	3798	5	8	80	0.1000000
NODE_13_length_10749_cov_34.330235	3771	3851	3	26	80	0.3250000
NODE_13_length_10749_cov_34.330235	3771	3851	4	46	80	0.5750000
NODE_13_length_10749_cov_34.330235	3771	3851	5	1	80	0.0125000
NODE_13_length_10749_cov_34.330235	3771	3851	6	1	80	0.0125000
NODE_13_length_10749_cov_34.330235	3771	3851	7	5	80	0.0625000
NODE_13_length_10749_cov_34.330235	3771	3851	8	1	80	0.0125000
NODE_14_length_10557_cov_50.055938	423	503	0	48	80	0.6000000
NODE_14_length_10557_cov_50.055938	423	503	1	32	80	0.4000000
NODE_14_length_10557_cov_50.055938	476	556	1	80	80	1.0000000
NODE_14_length_10557_cov_50.055938	1625	1696	146	1	71	0.0140845
NODE_14_length_10557_cov_50.055938	1625	1696	147	1	71	0.0140845
NODE_14_length_10557_cov_50.055938	1625	1696	148	2	71	0.0281690
NODE_14_length_10557_cov_50.055938	1625	1696	149	1	71	0.0140845
NODE_14_length_10557_cov_50.055938	1625	1696	150	2	71	0.0281690
NODE_14_length_10557_cov_50.055938	1625	1696	152	1	71	0.0140845
NODE_14_length_10557_cov_50.055938	1625	1696	153	2	71	0.0281690
NODE_14_length_10557_cov_50.055938	1625	1696	154	1	71	0.0140845
NODE_14_length_10557_cov_50.055938	1625	1696	155	1	71	0.0140845
NODE_14_length_10557_cov_50.055938	1625	1696	157	1	71	0.0140845
NODE_14_length_10557_cov_50.055938	1625	1696	159	1	71	0.0140845
NODE_14_length_10557_cov_50.055938	1625	1696	160	2	71	0.0281690
NODE_14_length_10557_cov_50.055938	1625	1696	162	4	71	0.0563380
NODE_14_length_10557_cov_50.055938	1625	1696	163	9	71	0.1267606
NODE_14_length_10557_cov_50.055938	1625	1696	164	4	71	0.0563380
NODE_14_length_10557_cov_50.055938	1625	1696	165	4	71	0.0563380
NODE_14_length_10557_cov_50.055938	1625	1696	166	2	71	0.0281690
NODE_14_length_10557_cov_50.055938	1625	1696	167	1	71	0.0140845
NODE_14_length_10557_cov_50.055938	1625	1696	168	1	71	0.0140845
NODE_14_length_10557_cov_50.055938	1625	1696	170	2	71	0.0281690
NODE_14_length_10557_cov_50.055938	1625	1696	171	1	71	0.0140845
NODE_14_length_10557_cov_50.055938	1625	1696	173	1	71	0.0140845
NODE_14_length_10557_cov_50.055938	1625	1696	174	1	71	0.0140845
NODE_14_length_10557_cov_50.055938	1625	1696	176	3	71	0.0422535
NODE_14_length_10557_cov_50.055938	1625	1696	177	2	71	0.0281690
NODE_14_length_10557_cov_50.055938	1625	1696	178	1	71	0.0140845
NODE_14_length_10557_cov_50.055938	1625	1696	179	2	71	0.0281690
NODE_14_length_10557_cov_50.055938	1625	1696	180	1	71	0.0140845
NODE_14_length_10557_cov_50.055938	1625	1696	181	4	71	0.0563380
NODE_14_length_10557_cov_50.055938	1625	1696	182	1	71	0.0140845
NODE_14_length_10557_cov_50.055938	1625	1696	183	3	71	0.0422535
NODE_14_length_10557_cov_50.055938	1625	1696	184	2	71	0.0281690
NODE_14_length_10557_cov_50.055938	1625	1696	185	3	71	0.0422535
NODE_14_length_10557_cov_50.055938	1625	1696	186	2	71	0.0281690
NODE_14_length_10557_cov_50.055938	1625	1696	188	1	71	0.0140845
NODE_14_length_10557_cov_50.055938	1678	1733	168	1	55	0.0181818
NODE_14_length_10557_cov_50.055938	1678	1733	169	1	55	0.0181818
NODE_14_length_10557_cov_50.055938	1678	1733	171	1	55	0.0181818
NODE_14_length_10557_cov_50.055938	1678	1733	172	2	55	0.0363636
NODE_14_length_10557_cov_50.055938	1678	1733	174	6	55	0.1090909
NODE_14_length_10557_cov_50.055938	1678	1733	175	6	55	0.1090909
NODE_14_length_10557_cov_50.055938	1678	1733	176	7	55	0.1272727
NODE_14_length_10557_cov_50.055938	1678	1733	177	4	55	0.0727273
NODE_14_length_10557_cov_50.055938	1678	1733	178	4	55	0.0727273
NODE_14_length_10557_cov_50.055938	1678	1733	179	5	55	0.0909091
NODE_14_length_10557_cov_50.055938	1678	1733	180	2	55	0.0363636
NODE_14_length_10557_cov_50.055938	1678	1733	181	5	55	0.0909091
NODE_14_length_10557_cov_50.055938	1678	1733	183	3	55	0.0545455
NODE_14_length_10557_cov_50.055938	1678	1733	184	2	55	0.0363636
NODE_14_length_10557_cov_50.055938	1678	1733	185	3	55	0.0545455
NODE_14_length_10557_cov_50.055938	1678	1733	186	2	55	0.0363636
NODE_14_length_10557_cov_50.055938	1678	1733	188	1	55	0.0181818
NODE_14_length_10557_cov_50.055938	2428	2488	241	1	60	0.0166667
NODE_14_length_10557_cov_50.055938	2428	2488	242	4	60	0.0666667
NODE_14_length_10557_cov_50.055938	2428	2488	244	1	60	0.0166667
NODE_14_length_10557_cov_50.055938	2428	2488	245	1	60	0.0166667
NODE_14_length_10557_cov_50.055938	2428	2488	248	1	60	0.0166667
NODE_14_length_10557_cov_50.055938	2428	2488	249	1	60	0.0166667
NODE_14_length_10557_cov_50.055938	2428	2488	250	3	60	0.0500000
NODE_14_length_10557_cov_50.055938	2428	2488	251	2	60	0.0333333
NODE_14_length_10557_cov_50.055938	2428	2488	252	6	60	0.1000000
NODE_14_length_10557_cov_50.055938	2428	2488	253	2	60	0.0333333
NODE_14_length_10557_cov_50.055938	2428	2488	254	5	60	0.0833333
NODE_14_length_10557_cov_50.055938	2428	2488	255	6	60	0.1000000
NODE_14_length_10557_cov_50.055938	2428	2488	256	3	60	0.0500000
NODE_14_length_10557_cov_50.055938	2428	2488	257	4	60	0.0666667
NODE_14_length_10557_cov_50.055938	2428	2488	258	5	60	0.0833333
NODE_14_length_10557_cov_50.055938	2428	2488	259	5	60	0.0833333
NODE_14_length_10557_cov_50.055938	2428	2488	260	3	60	0.0500000
NODE_14_length_10557_cov_50.055938	2428	2488	261	2	60	0.0333333
NODE_14_length_10557_cov_50.055938	2428	2488	262	2	60	0.0333333
NODE_14_length_10557_cov_50.055938	2428	2488	263	3	60	0.0500000
NODE_17_length_10101_cov_12.236253	923	966	4	3	43	0.0697674
NODE_17_length_10101_cov_12.236253	923	966	6	40	43	0.9302326
NODE_17_length_10101_cov_12.236253	943	1007	4	28	64	0.4375000
NODE_17_length_10101_cov_12.236253	943	1007	5	3	64	0.0468750
NODE_17_length_10101_cov_12.236253	943	1007	6	33	64	0.5156250
NODE_17_length_10101_cov_12.236253	1715	1795	0	49	80	0.6125000
NODE_17_length_10101_cov_12.236253	1715	1795	1	31	80	0.3875000
NODE_17_length_10101_cov_12.236253	1768	1820	0	51	52	0.9807692
NODE_17_length_10101_cov_12.236253	1768	1820	2	1	52	0.0192308
NODE_20_length_9442_cov_109.961147	2108	2188	3	2	80	0.0250000
NODE_20_length_9442_cov_109.961147	2108	2188	4	12	80	0.1500000
NODE_20_length_9442_cov_109.961147	2108	2188	5	29	80	0.3625000
NODE_20_length_9442_cov_109.961147	2108	2188	7	15	80	0.1875000
NODE_20_length_9442_cov_109.961147	2108	2188	8	22	80	0.2750000
NODE_20_length_9442_cov_109.961147	2161	2241	3	4	80	0.0500000
NODE_20_length_9442_cov_109.961147	2161	2241	5	20	80	0.2500000
NODE_20_length_9442_cov_109.961147	2161	2241	6	6	80	0.0750000
NODE_20_length_9442_cov_109.961147	2161	2241	7	5	80	0.0625000
NODE_20_length_9442_cov_109.961147	2161	2241	8	45	80	0.5625000
NODE_21_length_9414_cov_34.165217	2363	2443	48	4	80	0.0500000
NODE_21_length_9414_cov_34.165217	2363	2443	49	3	80	0.0375000
NODE_21_length_9414_cov_34.165217	2363	2443	50	4	80	0.0500000
NODE_21_length_9414_cov_34.165217	2363	2443	51	2	80	0.0250000
NODE_21_length_9414_cov_34.165217	2363	2443	52	1	80	0.0125000
NODE_21_length_9414_cov_34.165217	2363	2443	53	4	80	0.0500000
NODE_21_length_9414_cov_34.165217	2363	2443	54	7	80	0.0875000
NODE_21_length_9414_cov_34.165217	2363	2443	55	4	80	0.0500000
NODE_21_length_9414_cov_34.165217	2363	2443	57	5	80	0.0625000
NODE_21_length_9414_cov_34.165217	2363	2443	59	5	80	0.0625000
NODE_21_length_9414_cov_34.165217	2363	2443	61	1	80	0.0125000
NODE_21_length_9414_cov_34.165217	2363	2443	62	2	80	0.0250000
NODE_21_length_9414_cov_34.165217	2363	2443	63	3	80	0.0375000
NODE_21_length_9414_cov_34.165217	2363	2443	65	4	80	0.0500000
NODE_21_length_9414_cov_34.165217	2363	2443	67	1	80	0.0125000
NODE_21_length_9414_cov_34.165217	2363	2443	68	2	80	0.0250000
NODE_21_length_9414_cov_34.165217	2363	2443	71	8	80	0.1000000
NODE_21_length_9414_cov_34.165217	2363	2443	72	3	80	0.0375000
NODE_21_length_9414_cov_34.165217	2363	2443	75	2	80	0.0250000
NODE_21_length_9414_cov_34.165217	2363	2443	76	1	80	0.0125000
NODE_21_length_9414_cov_34.165217	2363	2443	77	2	80	0.0250000
NODE_21_length_9414_cov_34.165217	2363	2443	78	2	80	0.0250000
NODE_21_length_9414_cov_34.165217	2363	2443	79	1	80	0.0125000
NODE_21_length_9414_cov_34.165217	2363	2443	80	9	80	0.1125000
NODE_21_length_9414_cov_34.165217	2416	2484	15	1	68	0.0147059
NODE_21_length_9414_cov_34.165217	2416	2484	16	6	68	0.0882353
NODE_21_length_9414_cov_34.165217	2416	2484	17	3	68	0.0441176
NODE_21_length_9414_cov_34.165217	2416	2484	20	1	68	0.0147059
NODE_21_length_9414_cov_34.165217	2416	2484	21	2	68	0.0294118
NODE_21_length_9414_cov_34.165217	2416	2484	22	4	68	0.0588235
NODE_21_length_9414_cov_34.165217	2416	2484	24	1	68	0.0147059
NODE_21_length_9414_cov_34.165217	2416	2484	26	1	68	0.0147059
NODE_21_length_9414_cov_34.165217	2416	2484	28	1	68	0.0147059
NODE_21_length_9414_cov_34.165217	2416	2484	29	1	68	0.0147059
NODE_21_length_9414_cov_34.165217	2416	2484	30	1	68	0.0147059
NODE_21_length_9414_cov_34.165217	2416	2484	31	1	68	0.0147059
NODE_21_length_9414_cov_34.165217	2416	2484	32	5	68	0.0735294
NODE_21_length_9414_cov_34.165217	2416	2484	35	3	68	0.0441176
NODE_21_length_9414_cov_34.165217	2416	2484	36	3	68	0.0441176
NODE_21_length_9414_cov_34.165217	2416	2484	37	1	68	0.0147059
NODE_21_length_9414_cov_34.165217	2416	2484	40	2	68	0.0294118
NODE_21_length_9414_cov_34.165217	2416	2484	42	1	68	0.0147059
NODE_21_length_9414_cov_34.165217	2416	2484	44	2	68	0.0294118
NODE_21_length_9414_cov_34.165217	2416	2484	45	1	68	0.0147059
NODE_21_length_9414_cov_34.165217	2416	2484	48	4	68	0.0588235
NODE_21_length_9414_cov_34.165217	2416	2484	49	3	68	0.0441176
NODE_21_length_9414_cov_34.165217	2416	2484	50	4	68	0.0588235
NODE_21_length_9414_cov_34.165217	2416	2484	51	2	68	0.0294118
NODE_21_length_9414_cov_34.165217	2416	2484	52	1	68	0.0147059
NODE_21_length_9414_cov_34.165217	2416	2484	53	4	68	0.0588235
NODE_21_length_9414_cov_34.165217	2416	2484	54	7	68	0.1029412
NODE_21_length_9414_cov_34.165217	2416	2484	55	2	68	0.0294118
NODE_21_length_9414_cov_34.165217	5899	5975	77	1	76	0.0131579
NODE_21_length_9414_cov_34.165217	5899	5975	78	8	76	0.1052632
NODE_21_length_9414_cov_34.165217	5899	5975	80	5	76	0.0657895
NODE_21_length_9414_cov_34.165217	5899	5975	81	6	76	0.0789474
NODE_21_length_9414_cov_34.165217	5899	5975	82	2	76	0.0263158
NODE_21_length_9414_cov_34.165217	5899	5975	83	7	76	0.0921053
NODE_21_length_9414_cov_34.165217	5899	5975	84	4	76	0.0526316
NODE_21_length_9414_cov_34.165217	5899	5975	85	3	76	0.0394737
NODE_21_length_9414_cov_34.165217	5899	5975	87	4	76	0.0526316
NODE_21_length_9414_cov_34.165217	5899	5975	88	1	76	0.0131579
NODE_21_length_9414_cov_34.165217	5899	5975	92	2	76	0.0263158
NODE_21_length_9414_cov_34.165217	5899	5975	93	1	76	0.0131579
NODE_21_length_9414_cov_34.165217	5899	5975	95	1	76	0.0131579
NODE_21_length_9414_cov_34.165217	5899	5975	96	3	76	0.0394737
NODE_21_length_9414_cov_34.165217	5899	5975	97	1	76	0.0131579
NODE_21_length_9414_cov_34.165217	5899	5975	98	12	76	0.1578947
NODE_21_length_9414_cov_34.165217	5899	5975	99	4	76	0.0526316
NODE_21_length_9414_cov_34.165217	5899	5975	100	4	76	0.0526316
NODE_21_length_9414_cov_34.165217	5899	5975	101	3	76	0.0394737
NODE_21_length_9414_cov_34.165217	5899	5975	102	1	76	0.0131579
NODE_21_length_9414_cov_34.165217	5899	5975	104	3	76	0.0394737
NODE_24_length_9168_cov_47.407542	470	550	227	1	80	0.0125000
NODE_24_length_9168_cov_47.407542	470	550	229	1	80	0.0125000
NODE_24_length_9168_cov_47.407542	470	550	233	1	80	0.0125000
NODE_24_length_9168_cov_47.407542	470	550	234	1	80	0.0125000
NODE_24_length_9168_cov_47.407542	470	550	237	1	80	0.0125000
NODE_24_length_9168_cov_47.407542	470	550	238	1	80	0.0125000
NODE_24_length_9168_cov_47.407542	470	550	241	1	80	0.0125000
NODE_24_length_9168_cov_47.407542	470	550	244	1	80	0.0125000
NODE_24_length_9168_cov_47.407542	470	550	246	1	80	0.0125000
NODE_24_length_9168_cov_47.407542	470	550	256	1	80	0.0125000
NODE_24_length_9168_cov_47.407542	470	550	258	1	80	0.0125000
NODE_24_length_9168_cov_47.407542	470	550	264	3	80	0.0375000
NODE_24_length_9168_cov_47.407542	470	550	265	1	80	0.0125000
NODE_24_length_9168_cov_47.407542	470	550	266	2	80	0.0250000
NODE_24_length_9168_cov_47.407542	470	550	269	3	80	0.0375000
NODE_24_length_9168_cov_47.407542	470	550	270	1	80	0.0125000
NODE_24_length_9168_cov_47.407542	470	550	274	1	80	0.0125000
NODE_24_length_9168_cov_47.407542	470	550	277	1	80	0.0125000
NODE_24_length_9168_cov_47.407542	470	550	280	1	80	0.0125000
NODE_24_length_9168_cov_47.407542	470	550	284	1	80	0.0125000
NODE_24_length_9168_cov_47.407542	470	550	288	1	80	0.0125000
NODE_24_length_9168_cov_47.407542	470	550	290	1	80	0.0125000
NODE_24_length_9168_cov_47.407542	470	550	292	3	80	0.0375000
NODE_24_length_9168_cov_47.407542	470	550	294	1	80	0.0125000
NODE_24_length_9168_cov_47.407542	470	550	298	1	80	0.0125000
NODE_24_length_9168_cov_47.407542	470	550	301	3	80	0.0375000
NODE_24_length_9168_cov_47.407542	470	550	302	1	80	0.0125000
NODE_24_length_9168_cov_47.407542	470	550	305	2	80	0.0250000
NODE_24_length_9168_cov_47.407542	470	550	307	1	80	0.0125000
NODE_24_length_9168_cov_47.407542	470	550	308	1	80	0.0125000
NODE_24_length_9168_cov_47.407542	470	550	309	1	80	0.0125000
NODE_24_length_9168_cov_47.407542	470	550	310	4	80	0.0500000
NODE_24_length_9168_cov_47.407542	470	550	311	3	80	0.0375000
NODE_24_length_9168_cov_47.407542	470	550	312	2	80	0.0250000
NODE_24_length_9168_cov_47.407542	470	550	313	5	80	0.0625000
NODE_24_length_9168_cov_47.407542	470	550	314	1	80	0.0125000
NODE_24_length_9168_cov_47.407542	470	550	315	6	80	0.0750000
NODE_24_length_9168_cov_47.407542	470	550	316	2	80	0.0250000
NODE_24_length_9168_cov_47.407542	470	550	317	2	80	0.0250000
NODE_24_length_9168_cov_47.407542	470	550	318	6	80	0.0750000
NODE_24_length_9168_cov_47.407542	470	550	319	1	80	0.0125000
NODE_24_length_9168_cov_47.407542	470	550	320	3	80	0.0375000
NODE_24_length_9168_cov_47.407542	470	550	321	2	80	0.0250000
NODE_24_length_9168_cov_47.407542	470	550	323	1	80	0.0125000
NODE_24_length_9168_cov_47.407542	470	550	325	1	80	0.0125000
NODE_24_length_9168_cov_47.407542	523	603	230	1	80	0.0125000
NODE_24_length_9168_cov_47.407542	523	603	233	2	80	0.0250000
NODE_24_length_9168_cov_47.407542	523	603	238	1	80	0.0125000
NODE_24_length_9168_cov_47.407542	523	603	242	1	80	0.0125000
NODE_24_length_9168_cov_47.407542	523	603	243	1	80	0.0125000
NODE_24_length_9168_cov_47.407542	523	603	244	1	80	0.0125000
NODE_24_length_9168_cov_47.407542	523	603	246	1	80	0.0125000
NODE_24_length_9168_cov_47.407542	523	603	247	1	80	0.0125000
NODE_24_length_9168_cov_47.407542	523	603	249	3	80	0.0375000
NODE_24_length_9168_cov_47.407542	523	603	251	2	80	0.0250000
NODE_24_length_9168_cov_47.407542	523	603	256	1	80	0.0125000
NODE_24_length_9168_cov_47.407542	523	603	259	1	80	0.0125000
NODE_24_length_9168_cov_47.407542	523	603	261	1	80	0.0125000
NODE_24_length_9168_cov_47.407542	523	603	264	1	80	0.0125000
NODE_24_length_9168_cov_47.407542	523	603	267	1	80	0.0125000
NODE_24_length_9168_cov_47.407542	523	603	273	1	80	0.0125000
NODE_24_length_9168_cov_47.407542	523	603	277	3	80	0.0375000
NODE_24_length_9168_cov_47.407542	523	603	279	1	80	0.0125000
NODE_24_length_9168_cov_47.407542	523	603	280	2	80	0.0250000
NODE_24_length_9168_cov_47.407542	523	603	283	1	80	0.0125000
NODE_24_length_9168_cov_47.407542	523	603	286	5	80	0.0625000
NODE_24_length_9168_cov_47.407542	523	603	287	1	80	0.0125000
NODE_24_length_9168_cov_47.407542	523	603	288	6	80	0.0750000
NODE_24_length_9168_cov_47.407542	523	603	289	2	80	0.0250000
NODE_24_length_9168_cov_47.407542	523	603	290	1	80	0.0125000
NODE_24_length_9168_cov_47.407542	523	603	291	1	80	0.0125000
NODE_24_length_9168_cov_47.407542	523	603	292	1	80	0.0125000
NODE_24_length_9168_cov_47.407542	523	603	296	1	80	0.0125000
NODE_24_length_9168_cov_47.407542	523	603	301	1	80	0.0125000
NODE_24_length_9168_cov_47.407542	523	603	303	2	80	0.0250000
NODE_24_length_9168_cov_47.407542	523	603	304	2	80	0.0250000
NODE_24_length_9168_cov_47.407542	523	603	305	1	80	0.0125000
NODE_24_length_9168_cov_47.407542	523	603	306	1	80	0.0125000
NODE_24_length_9168_cov_47.407542	523	603	308	1	80	0.0125000
NODE_24_length_9168_cov_47.407542	523	603	310	2	80	0.0250000
NODE_24_length_9168_cov_47.407542	523	603	311	2	80	0.0250000
NODE_24_length_9168_cov_47.407542	523	603	313	5	80	0.0625000
NODE_24_length_9168_cov_47.407542	523	603	314	1	80	0.0125000
NODE_24_length_9168_cov_47.407542	523	603	315	4	80	0.0500000
NODE_24_length_9168_cov_47.407542	523	603	316	2	80	0.0250000
NODE_24_length_9168_cov_47.407542	523	603	317	2	80	0.0250000
NODE_24_length_9168_cov_47.407542	523	603	318	3	80	0.0375000
NODE_24_length_9168_cov_47.407542	523	603	319	1	80	0.0125000
NODE_24_length_9168_cov_47.407542	523	603	320	2	80	0.0250000
NODE_24_length_9168_cov_47.407542	523	603	321	2	80	0.0250000
NODE_24_length_9168_cov_47.407542	523	603	323	1	80	0.0125000
NODE_27_length_9108_cov_47.430347	4786	4866	119	1	80	0.0125000
NODE_27_length_9108_cov_47.430347	4786	4866	120	3	80	0.0375000
NODE_27_length_9108_cov_47.430347	4786	4866	121	8	80	0.1000000
NODE_27_length_9108_cov_47.430347	4786	4866	123	1	80	0.0125000
NODE_27_length_9108_cov_47.430347	4786	4866	124	3	80	0.0375000
NODE_27_length_9108_cov_47.430347	4786	4866	125	2	80	0.0250000
NODE_27_length_9108_cov_47.430347	4786	4866	126	3	80	0.0375000
NODE_27_length_9108_cov_47.430347	4786	4866	127	1	80	0.0125000
NODE_27_length_9108_cov_47.430347	4786	4866	128	5	80	0.0625000
NODE_27_length_9108_cov_47.430347	4786	4866	129	4	80	0.0500000
NODE_27_length_9108_cov_47.430347	4786	4866	130	1	80	0.0125000
NODE_27_length_9108_cov_47.430347	4786	4866	135	1	80	0.0125000
NODE_27_length_9108_cov_47.430347	4786	4866	136	2	80	0.0250000
NODE_27_length_9108_cov_47.430347	4786	4866	137	3	80	0.0375000
NODE_27_length_9108_cov_47.430347	4786	4866	138	10	80	0.1250000
NODE_27_length_9108_cov_47.430347	4786	4866	139	4	80	0.0500000
NODE_27_length_9108_cov_47.430347	4786	4866	140	5	80	0.0625000
NODE_27_length_9108_cov_47.430347	4786	4866	141	11	80	0.1375000
NODE_27_length_9108_cov_47.430347	4786	4866	142	7	80	0.0875000
NODE_27_length_9108_cov_47.430347	4786	4866	143	3	80	0.0375000
NODE_27_length_9108_cov_47.430347	4786	4866	144	2	80	0.0250000
NODE_27_length_9108_cov_47.430347	4839	4902	126	1	63	0.0158730
NODE_27_length_9108_cov_47.430347	4839	4902	128	1	63	0.0158730
NODE_27_length_9108_cov_47.430347	4839	4902	129	1	63	0.0158730
NODE_27_length_9108_cov_47.430347	4839	4902	130	1	63	0.0158730
NODE_27_length_9108_cov_47.430347	4839	4902	133	1	63	0.0158730
NODE_27_length_9108_cov_47.430347	4839	4902	137	3	63	0.0476190
NODE_27_length_9108_cov_47.430347	4839	4902	138	10	63	0.1587302
NODE_27_length_9108_cov_47.430347	4839	4902	139	7	63	0.1111111
NODE_27_length_9108_cov_47.430347	4839	4902	140	14	63	0.2222222
NODE_27_length_9108_cov_47.430347	4839	4902	141	15	63	0.2380952
NODE_27_length_9108_cov_47.430347	4839	4902	142	6	63	0.0952381
NODE_27_length_9108_cov_47.430347	4839	4902	143	2	63	0.0317460
NODE_27_length_9108_cov_47.430347	4839	4902	144	1	63	0.0158730
NODE_27_length_9108_cov_47.430347	4895	4963	78	1	68	0.0147059
NODE_27_length_9108_cov_47.430347	4895	4963	84	2	68	0.0294118
NODE_27_length_9108_cov_47.430347	4895	4963	85	3	68	0.0441176
NODE_27_length_9108_cov_47.430347	4895	4963	86	3	68	0.0441176
NODE_27_length_9108_cov_47.430347	4895	4963	87	3	68	0.0441176
NODE_27_length_9108_cov_47.430347	4895	4963	90	4	68	0.0588235
NODE_27_length_9108_cov_47.430347	4895	4963	91	4	68	0.0588235
NODE_27_length_9108_cov_47.430347	4895	4963	93	1	68	0.0147059
NODE_27_length_9108_cov_47.430347	4895	4963	95	1	68	0.0147059
NODE_27_length_9108_cov_47.430347	4895	4963	96	3	68	0.0441176
NODE_27_length_9108_cov_47.430347	4895	4963	98	3	68	0.0441176
NODE_27_length_9108_cov_47.430347	4895	4963	100	4	68	0.0588235
NODE_27_length_9108_cov_47.430347	4895	4963	101	1	68	0.0147059
NODE_27_length_9108_cov_47.430347	4895	4963	104	2	68	0.0294118
NODE_27_length_9108_cov_47.430347	4895	4963	105	1	68	0.0147059
NODE_27_length_9108_cov_47.430347	4895	4963	106	1	68	0.0147059
NODE_27_length_9108_cov_47.430347	4895	4963	108	1	68	0.0147059
NODE_27_length_9108_cov_47.430347	4895	4963	109	1	68	0.0147059
NODE_27_length_9108_cov_47.430347	4895	4963	111	2	68	0.0294118
NODE_27_length_9108_cov_47.430347	4895	4963	112	4	68	0.0588235
NODE_27_length_9108_cov_47.430347	4895	4963	114	6	68	0.0882353
NODE_27_length_9108_cov_47.430347	4895	4963	115	1	68	0.0147059
NODE_27_length_9108_cov_47.430347	4895	4963	116	2	68	0.0294118
NODE_27_length_9108_cov_47.430347	4895	4963	117	1	68	0.0147059
NODE_27_length_9108_cov_47.430347	4895	4963	121	1	68	0.0147059
NODE_27_length_9108_cov_47.430347	4895	4963	125	1	68	0.0147059
NODE_27_length_9108_cov_47.430347	4895	4963	126	1	68	0.0147059
NODE_27_length_9108_cov_47.430347	4895	4963	128	2	68	0.0294118
NODE_27_length_9108_cov_47.430347	4895	4963	129	2	68	0.0294118
NODE_27_length_9108_cov_47.430347	4895	4963	130	3	68	0.0441176
NODE_27_length_9108_cov_47.430347	4895	4963	133	1	68	0.0147059
NODE_27_length_9108_cov_47.430347	4895	4963	137	2	68	0.0294118
NODE_27_length_9108_cov_47.430347	4936	5016	17	1	80	0.0125000
NODE_27_length_9108_cov_47.430347	4936	5016	21	3	80	0.0375000
NODE_27_length_9108_cov_47.430347	4936	5016	23	1	80	0.0125000
NODE_27_length_9108_cov_47.430347	4936	5016	25	2	80	0.0250000
NODE_27_length_9108_cov_47.430347	4936	5016	27	1	80	0.0125000
NODE_27_length_9108_cov_47.430347	4936	5016	29	1	80	0.0125000
NODE_27_length_9108_cov_47.430347	4936	5016	31	2	80	0.0250000
NODE_27_length_9108_cov_47.430347	4936	5016	33	1	80	0.0125000
NODE_27_length_9108_cov_47.430347	4936	5016	34	1	80	0.0125000
NODE_27_length_9108_cov_47.430347	4936	5016	35	2	80	0.0250000
NODE_27_length_9108_cov_47.430347	4936	5016	36	3	80	0.0375000
NODE_27_length_9108_cov_47.430347	4936	5016	41	8	80	0.1000000
NODE_27_length_9108_cov_47.430347	4936	5016	42	1	80	0.0125000
NODE_27_length_9108_cov_47.430347	4936	5016	45	1	80	0.0125000
NODE_27_length_9108_cov_47.430347	4936	5016	47	3	80	0.0375000
NODE_27_length_9108_cov_47.430347	4936	5016	49	4	80	0.0500000
NODE_27_length_9108_cov_47.430347	4936	5016	54	1	80	0.0125000
NODE_27_length_9108_cov_47.430347	4936	5016	55	1	80	0.0125000
NODE_27_length_9108_cov_47.430347	4936	5016	56	1	80	0.0125000
NODE_27_length_9108_cov_47.430347	4936	5016	57	2	80	0.0250000
NODE_27_length_9108_cov_47.430347	4936	5016	58	1	80	0.0125000
NODE_27_length_9108_cov_47.430347	4936	5016	59	1	80	0.0125000
NODE_27_length_9108_cov_47.430347	4936	5016	61	2	80	0.0250000
NODE_27_length_9108_cov_47.430347	4936	5016	62	1	80	0.0125000
NODE_27_length_9108_cov_47.430347	4936	5016	63	1	80	0.0125000
NODE_27_length_9108_cov_47.430347	4936	5016	66	1	80	0.0125000
NODE_27_length_9108_cov_47.430347	4936	5016	67	1	80	0.0125000
NODE_27_length_9108_cov_47.430347	4936	5016	70	1	80	0.0125000
NODE_27_length_9108_cov_47.430347	4936	5016	72	1	80	0.0125000
NODE_27_length_9108_cov_47.430347	4936	5016	75	2	80	0.0250000
NODE_27_length_9108_cov_47.430347	4936	5016	76	1	80	0.0125000
NODE_27_length_9108_cov_47.430347	4936	5016	78	1	80	0.0125000
NODE_27_length_9108_cov_47.430347	4936	5016	84	2	80	0.0250000
NODE_27_length_9108_cov_47.430347	4936	5016	85	3	80	0.0375000
NODE_27_length_9108_cov_47.430347	4936	5016	86	3	80	0.0375000
NODE_27_length_9108_cov_47.430347	4936	5016	87	3	80	0.0375000
NODE_27_length_9108_cov_47.430347	4936	5016	90	4	80	0.0500000
NODE_27_length_9108_cov_47.430347	4936	5016	91	4	80	0.0500000
NODE_27_length_9108_cov_47.430347	4936	5016	93	1	80	0.0125000
NODE_27_length_9108_cov_47.430347	4936	5016	95	1	80	0.0125000
NODE_27_length_9108_cov_47.430347	4936	5016	96	3	80	0.0375000
NODE_27_length_9108_cov_47.430347	4936	5016	98	2	80	0.0250000
NODE_28_length_9108_cov_26.469974	44	120	0	76	76	1.0000000
NODE_28_length_9108_cov_26.469974	7711	7791	8	1	80	0.0125000
NODE_28_length_9108_cov_26.469974	7711	7791	25	1	80	0.0125000
NODE_28_length_9108_cov_26.469974	7711	7791	26	1	80	0.0125000
NODE_28_length_9108_cov_26.469974	7711	7791	29	1	80	0.0125000
NODE_28_length_9108_cov_26.469974	7711	7791	32	1	80	0.0125000
NODE_28_length_9108_cov_26.469974	7711	7791	35	2	80	0.0250000
NODE_28_length_9108_cov_26.469974	7711	7791	38	1	80	0.0125000
NODE_28_length_9108_cov_26.469974	7711	7791	39	2	80	0.0250000
NODE_28_length_9108_cov_26.469974	7711	7791	41	1	80	0.0125000
NODE_28_length_9108_cov_26.469974	7711	7791	43	1	80	0.0125000
NODE_28_length_9108_cov_26.469974	7711	7791	47	1	80	0.0125000
NODE_28_length_9108_cov_26.469974	7711	7791	49	1	80	0.0125000
NODE_28_length_9108_cov_26.469974	7711	7791	51	2	80	0.0250000
NODE_28_length_9108_cov_26.469974	7711	7791	52	1	80	0.0125000
NODE_28_length_9108_cov_26.469974	7711	7791	54	1	80	0.0125000
NODE_28_length_9108_cov_26.469974	7711	7791	55	1	80	0.0125000
NODE_28_length_9108_cov_26.469974	7711	7791	58	1	80	0.0125000
NODE_28_length_9108_cov_26.469974	7711	7791	63	1	80	0.0125000
NODE_28_length_9108_cov_26.469974	7711	7791	65	2	80	0.0250000
NODE_28_length_9108_cov_26.469974	7711	7791	66	1	80	0.0125000
NODE_28_length_9108_cov_26.469974	7711	7791	67	1	80	0.0125000
NODE_28_length_9108_cov_26.469974	7711	7791	68	2	80	0.0250000
NODE_28_length_9108_cov_26.469974	7711	7791	69	2	80	0.0250000
NODE_28_length_9108_cov_26.469974	7711	7791	70	1	80	0.0125000
NODE_28_length_9108_cov_26.469974	7711	7791	73	1	80	0.0125000
NODE_28_length_9108_cov_26.469974	7711	7791	78	1	80	0.0125000
NODE_28_length_9108_cov_26.469974	7711	7791	83	1	80	0.0125000
NODE_28_length_9108_cov_26.469974	7711	7791	84	1	80	0.0125000
NODE_28_length_9108_cov_26.469974	7711	7791	88	1	80	0.0125000
NODE_28_length_9108_cov_26.469974	7711	7791	89	1	80	0.0125000
NODE_28_length_9108_cov_26.469974	7711	7791	90	1	80	0.0125000
NODE_28_length_9108_cov_26.469974	7711	7791	93	1	80	0.0125000
NODE_28_length_9108_cov_26.469974	7711	7791	97	1	80	0.0125000
NODE_28_length_9108_cov_26.469974	7711	7791	99	1	80	0.0125000
NODE_28_length_9108_cov_26.469974	7711	7791	102	1	80	0.0125000
NODE_28_length_9108_cov_26.469974	7711	7791	104	1	80	0.0125000
NODE_28_length_9108_cov_26.469974	7711	7791	106	1	80	0.0125000
NODE_28_length_9108_cov_26.469974	7711	7791	107	1	80	0.0125000
NODE_28_length_9108_cov_26.469974	7711	7791	111	1	80	0.0125000
NODE_28_length_9108_cov_26.469974	7711	7791	113	1	80	0.0125000
NODE_28_length_9108_cov_26.469974	7711	7791	116	1	80	0.0125000
NODE_28_length_9108_cov_26.469974	7711	7791	119	1	80	0.0125000
NODE_28_length_9108_cov_26.469974	7711	7791	120	1	80	0.0125000
NODE_28_length_9108_cov_26.469974	7711	7791	123	1	80	0.0125000
NODE_28_length_9108_cov_26.469974	7711	7791	127	1	80	0.0125000
NODE_28_length_9108_cov_26.469974	7711	7791	135	1	80	0.0125000
NODE_28_length_9108_cov_26.469974	7711	7791	137	1	80	0.0125000
NODE_28_length_9108_cov_26.469974	7711	7791	145	1	80	0.0125000
NODE_28_length_9108_cov_26.469974	7711	7791	149	2	80	0.0250000
NODE_28_length_9108_cov_26.469974	7711	7791	151	1	80	0.0125000
NODE_28_length_9108_cov_26.469974	7711	7791	155	1	80	0.0125000
NODE_28_length_9108_cov_26.469974	7711	7791	163	1	80	0.0125000
NODE_28_length_9108_cov_26.469974	7711	7791	166	1	80	0.0125000
NODE_28_length_9108_cov_26.469974	7711	7791	171	1	80	0.0125000
NODE_28_length_9108_cov_26.469974	7711	7791	173	1	80	0.0125000
NODE_28_length_9108_cov_26.469974	7711	7791	176	1	80	0.0125000
NODE_28_length_9108_cov_26.469974	7711	7791	178	2	80	0.0250000
NODE_28_length_9108_cov_26.469974	7711	7791	180	1	80	0.0125000
NODE_28_length_9108_cov_26.469974	7711	7791	193	1	80	0.0125000
NODE_28_length_9108_cov_26.469974	7711	7791	201	1	80	0.0125000
NODE_28_length_9108_cov_26.469974	7711	7791	208	1	80	0.0125000
NODE_28_length_9108_cov_26.469974	7711	7791	216	1	80	0.0125000
NODE_28_length_9108_cov_26.469974	7711	7791	219	1	80	0.0125000
NODE_28_length_9108_cov_26.469974	7711	7791	222	1	80	0.0125000
NODE_28_length_9108_cov_26.469974	7711	7791	229	2	80	0.0250000
NODE_28_length_9108_cov_26.469974	7711	7791	230	1	80	0.0125000
NODE_28_length_9108_cov_26.469974	7711	7791	233	1	80	0.0125000
NODE_28_length_9108_cov_26.469974	7711	7791	235	1	80	0.0125000
NODE_28_length_9108_cov_26.469974	7711	7791	236	2	80	0.0250000
NODE_28_length_9108_cov_26.469974	7711	7791	237	1	80	0.0125000
NODE_28_length_9108_cov_26.469974	8144	8224	11	1	80	0.0125000
NODE_28_length_9108_cov_26.469974	8144	8224	34	2	80	0.0250000
NODE_28_length_9108_cov_26.469974	8144	8224	35	2	80	0.0250000
NODE_28_length_9108_cov_26.469974	8144	8224	39	5	80	0.0625000
NODE_28_length_9108_cov_26.469974	8144	8224	41	1	80	0.0125000
NODE_28_length_9108_cov_26.469974	8144	8224	43	1	80	0.0125000
NODE_28_length_9108_cov_26.469974	8144	8224	45	1	80	0.0125000
NODE_28_length_9108_cov_26.469974	8144	8224	50	2	80	0.0250000
NODE_28_length_9108_cov_26.469974	8144	8224	54	3	80	0.0375000
NODE_28_length_9108_cov_26.469974	8144	8224	59	4	80	0.0500000
NODE_28_length_9108_cov_26.469974	8144	8224	61	1	80	0.0125000
NODE_28_length_9108_cov_26.469974	8144	8224	69	1	80	0.0125000
NODE_28_length_9108_cov_26.469974	8144	8224	71	1	80	0.0125000
NODE_28_length_9108_cov_26.469974	8144	8224	73	1	80	0.0125000
NODE_28_length_9108_cov_26.469974	8144	8224	74	4	80	0.0500000
NODE_28_length_9108_cov_26.469974	8144	8224	76	2	80	0.0250000
NODE_28_length_9108_cov_26.469974	8144	8224	77	1	80	0.0125000
NODE_28_length_9108_cov_26.469974	8144	8224	78	1	80	0.0125000
NODE_28_length_9108_cov_26.469974	8144	8224	80	2	80	0.0250000
NODE_28_length_9108_cov_26.469974	8144	8224	83	2	80	0.0250000
NODE_28_length_9108_cov_26.469974	8144	8224	84	1	80	0.0125000
NODE_28_length_9108_cov_26.469974	8144	8224	86	1	80	0.0125000
NODE_28_length_9108_cov_26.469974	8144	8224	90	1	80	0.0125000
NODE_28_length_9108_cov_26.469974	8144	8224	91	1	80	0.0125000
NODE_28_length_9108_cov_26.469974	8144	8224	92	1	80	0.0125000
NODE_28_length_9108_cov_26.469974	8144	8224	94	1	80	0.0125000
NODE_28_length_9108_cov_26.469974	8144	8224	96	2	80	0.0250000
NODE_28_length_9108_cov_26.469974	8144	8224	98	1	80	0.0125000
NODE_28_length_9108_cov_26.469974	8144	8224	101	1	80	0.0125000
NODE_28_length_9108_cov_26.469974	8144	8224	102	1	80	0.0125000
NODE_28_length_9108_cov_26.469974	8144	8224	103	2	80	0.0250000
NODE_28_length_9108_cov_26.469974	8144	8224	106	2	80	0.0250000
NODE_28_length_9108_cov_26.469974	8144	8224	113	1	80	0.0125000
NODE_28_length_9108_cov_26.469974	8144	8224	117	1	80	0.0125000
NODE_28_length_9108_cov_26.469974	8144	8224	118	1	80	0.0125000
NODE_28_length_9108_cov_26.469974	8144	8224	125	2	80	0.0250000
NODE_28_length_9108_cov_26.469974	8144	8224	127	1	80	0.0125000
NODE_28_length_9108_cov_26.469974	8144	8224	130	1	80	0.0125000
NODE_28_length_9108_cov_26.469974	8144	8224	132	1	80	0.0125000
NODE_28_length_9108_cov_26.469974	8144	8224	135	2	80	0.0250000
NODE_28_length_9108_cov_26.469974	8144	8224	137	1	80	0.0125000
NODE_28_length_9108_cov_26.469974	8144	8224	140	1	80	0.0125000
NODE_28_length_9108_cov_26.469974	8144	8224	142	1	80	0.0125000
NODE_28_length_9108_cov_26.469974	8144	8224	145	1	80	0.0125000
NODE_28_length_9108_cov_26.469974	8144	8224	147	1	80	0.0125000
NODE_28_length_9108_cov_26.469974	8144	8224	149	3	80	0.0375000
NODE_28_length_9108_cov_26.469974	8144	8224	151	1	80	0.0125000
NODE_28_length_9108_cov_26.469974	8144	8224	154	2	80	0.0250000
NODE_28_length_9108_cov_26.469974	8144	8224	155	1	80	0.0125000
NODE_28_length_9108_cov_26.469974	8144	8224	157	1	80	0.0125000
NODE_28_length_9108_cov_26.469974	8144	8224	159	2	80	0.0250000
NODE_28_length_9108_cov_26.469974	8144	8224	160	1	80	0.0125000
NODE_28_length_9108_cov_26.469974	8144	8224	161	1	80	0.0125000
NODE_28_length_9108_cov_26.469974	8568	8648	1	80	80	1.0000000
NODE_28_length_9108_cov_26.469974	8621	8701	1	80	80	1.0000000
NODE_30_length_8743_cov_14.172721	7849	7929	24	1	80	0.0125000
NODE_30_length_8743_cov_14.172721	7849	7929	26	2	80	0.0250000
NODE_30_length_8743_cov_14.172721	7849	7929	28	2	80	0.0250000
NODE_30_length_8743_cov_14.172721	7849	7929	29	1	80	0.0125000
NODE_30_length_8743_cov_14.172721	7849	7929	34	1	80	0.0125000
NODE_30_length_8743_cov_14.172721	7849	7929	36	2	80	0.0250000
NODE_30_length_8743_cov_14.172721	7849	7929	38	3	80	0.0375000
NODE_30_length_8743_cov_14.172721	7849	7929	41	22	80	0.2750000
NODE_30_length_8743_cov_14.172721	7849	7929	43	1	80	0.0125000
NODE_30_length_8743_cov_14.172721	7849	7929	47	2	80	0.0250000
NODE_30_length_8743_cov_14.172721	7849	7929	48	3	80	0.0375000
NODE_30_length_8743_cov_14.172721	7849	7929	49	5	80	0.0625000
NODE_30_length_8743_cov_14.172721	7849	7929	50	10	80	0.1250000
NODE_30_length_8743_cov_14.172721	7849	7929	51	5	80	0.0625000
NODE_30_length_8743_cov_14.172721	7849	7929	52	5	80	0.0625000
NODE_30_length_8743_cov_14.172721	7849	7929	53	6	80	0.0750000
NODE_30_length_8743_cov_14.172721	7849	7929	54	3	80	0.0375000
NODE_30_length_8743_cov_14.172721	7849	7929	55	6	80	0.0750000
NODE_30_length_8743_cov_14.172721	7902	7964	10	6	62	0.0967742
NODE_30_length_8743_cov_14.172721	7902	7964	11	4	62	0.0645161
NODE_30_length_8743_cov_14.172721	7902	7964	12	1	62	0.0161290
NODE_30_length_8743_cov_14.172721	7902	7964	14	4	62	0.0645161
NODE_30_length_8743_cov_14.172721	7902	7964	16	8	62	0.1290323
NODE_30_length_8743_cov_14.172721	7902	7964	18	5	62	0.0806452
NODE_30_length_8743_cov_14.172721	7902	7964	19	2	62	0.0322581
NODE_30_length_8743_cov_14.172721	7902	7964	21	1	62	0.0161290
NODE_30_length_8743_cov_14.172721	7902	7964	22	1	62	0.0161290
NODE_30_length_8743_cov_14.172721	7902	7964	24	4	62	0.0645161
NODE_30_length_8743_cov_14.172721	7902	7964	26	2	62	0.0322581
NODE_30_length_8743_cov_14.172721	7902	7964	28	2	62	0.0322581
NODE_30_length_8743_cov_14.172721	7902	7964	29	1	62	0.0161290
NODE_30_length_8743_cov_14.172721	7902	7964	34	1	62	0.0161290
NODE_30_length_8743_cov_14.172721	7902	7964	36	2	62	0.0322581
NODE_30_length_8743_cov_14.172721	7902	7964	38	3	62	0.0483871
NODE_30_length_8743_cov_14.172721	7902	7964	41	15	62	0.2419355
NODE_32_length_8707_cov_6.353044	8541	8621	6	21	80	0.2625000
NODE_32_length_8707_cov_6.353044	8541	8621	7	10	80	0.1250000
NODE_32_length_8707_cov_6.353044	8541	8621	8	15	80	0.1875000
NODE_32_length_8707_cov_6.353044	8541	8621	9	4	80	0.0500000
NODE_32_length_8707_cov_6.353044	8541	8621	10	30	80	0.3750000
NODE_32_length_8707_cov_6.353044	8541	8621	6	21	80	0.2625000
NODE_32_length_8707_cov_6.353044	8541	8621	7	10	80	0.1250000
NODE_32_length_8707_cov_6.353044	8541	8621	8	15	80	0.1875000
NODE_32_length_8707_cov_6.353044	8541	8621	9	4	80	0.0500000
NODE_32_length_8707_cov_6.353044	8541	8621	10	30	80	0.3750000
NODE_32_length_8707_cov_6.353044	8541	8621	6	21	80	0.2625000
NODE_32_length_8707_cov_6.353044	8541	8621	7	10	80	0.1250000
NODE_32_length_8707_cov_6.353044	8541	8621	8	15	80	0.1875000
NODE_32_length_8707_cov_6.353044	8541	8621	9	4	80	0.0500000
NODE_32_length_8707_cov_6.353044	8541	8621	10	30	80	0.3750000
NODE_32_length_8707_cov_6.353044	8594	8674	4	6	80	0.0750000
NODE_32_length_8707_cov_6.353044	8594	8674	5	47	80	0.5875000
NODE_32_length_8707_cov_6.353044	8594	8674	7	10	80	0.1250000
NODE_32_length_8707_cov_6.353044	8594	8674	8	12	80	0.1500000
NODE_32_length_8707_cov_6.353044	8594	8674	9	4	80	0.0500000
NODE_32_length_8707_cov_6.353044	8594	8674	10	1	80	0.0125000
NODE_32_length_8707_cov_6.353044	8594	8674	4	6	80	0.0750000
NODE_32_length_8707_cov_6.353044	8594	8674	5	47	80	0.5875000
NODE_32_length_8707_cov_6.353044	8594	8674	7	10	80	0.1250000
NODE_32_length_8707_cov_6.353044	8594	8674	8	12	80	0.1500000
NODE_32_length_8707_cov_6.353044	8594	8674	9	4	80	0.0500000
NODE_32_length_8707_cov_6.353044	8594	8674	10	1	80	0.0125000
NODE_32_length_8707_cov_6.353044	8594	8673	4	5	79	0.0632911
NODE_32_length_8707_cov_6.353044	8594	8673	5	47	79	0.5949367
NODE_32_length_8707_cov_6.353044	8594	8673	7	10	79	0.1265823
NODE_32_length_8707_cov_6.353044	8594	8673	8	12	79	0.1518987
NODE_32_length_8707_cov_6.353044	8594	8673	9	4	79	0.0506329
NODE_32_length_8707_cov_6.353044	8594	8673	10	1	79	0.0126582
NODE_32_length_8707_cov_6.353044	8599	8674	4	6	75	0.0800000
NODE_32_length_8707_cov_6.353044	8599	8674	5	47	75	0.6266667
NODE_32_length_8707_cov_6.353044	8599	8674	7	10	75	0.1333333
NODE_32_length_8707_cov_6.353044	8599	8674	8	12	75	0.1600000
NODE_38_length_8281_cov_13.025177	7108	7188	4	20	80	0.2500000
NODE_38_length_8281_cov_13.025177	7108	7188	5	7	80	0.0875000
NODE_38_length_8281_cov_13.025177	7108	7188	6	53	80	0.6625000
NODE_38_length_8281_cov_13.025177	7161	7199	6	38	38	1.0000000
NODE_38_length_8281_cov_13.025177	7175	7255	3	56	80	0.7000000
NODE_38_length_8281_cov_13.025177	7175	7255	6	24	80	0.3000000
NODE_38_length_8281_cov_13.025177	7228	7308	1	18	80	0.2250000
NODE_38_length_8281_cov_13.025177	7228	7308	2	4	80	0.0500000
NODE_38_length_8281_cov_13.025177	7228	7308	3	58	80	0.7250000
NODE_38_length_8281_cov_13.025177	7749	7829	4	17	80	0.2125000
NODE_38_length_8281_cov_13.025177	7749	7829	5	15	80	0.1875000
NODE_38_length_8281_cov_13.025177	7749	7829	6	24	80	0.3000000
NODE_38_length_8281_cov_13.025177	7749	7829	7	24	80	0.3000000
NODE_38_length_8281_cov_13.025177	7802	7882	4	7	80	0.0875000
NODE_38_length_8281_cov_13.025177	7802	7882	5	9	80	0.1125000
NODE_38_length_8281_cov_13.025177	7802	7882	6	1	80	0.0125000
NODE_38_length_8281_cov_13.025177	7802	7882	7	49	80	0.6125000
NODE_38_length_8281_cov_13.025177	7802	7882	9	14	80	0.1750000
NODE_38_length_8281_cov_13.025177	7878	7958	2	9	80	0.1125000
NODE_38_length_8281_cov_13.025177	7878	7958	3	9	80	0.1125000
NODE_38_length_8281_cov_13.025177	7878	7958	4	33	80	0.4125000
NODE_38_length_8281_cov_13.025177	7878	7958	5	3	80	0.0375000
NODE_38_length_8281_cov_13.025177	7878	7958	7	26	80	0.3250000
NODE_38_length_8281_cov_13.025177	7931	8011	2	51	80	0.6375000
NODE_38_length_8281_cov_13.025177	7931	8011	3	20	80	0.2500000
NODE_38_length_8281_cov_13.025177	7931	8011	4	9	80	0.1125000
NODE_39_length_8259_cov_60.011152	1424	1504	157	1	80	0.0125000
NODE_39_length_8259_cov_60.011152	1424	1504	161	1	80	0.0125000
NODE_39_length_8259_cov_60.011152	1424	1504	164	1	80	0.0125000
NODE_39_length_8259_cov_60.011152	1424	1504	168	1	80	0.0125000
NODE_39_length_8259_cov_60.011152	1424	1504	172	3	80	0.0375000
NODE_39_length_8259_cov_60.011152	1424	1504	174	1	80	0.0125000
NODE_39_length_8259_cov_60.011152	1424	1504	179	2	80	0.0250000
NODE_39_length_8259_cov_60.011152	1424	1504	180	2	80	0.0250000
NODE_39_length_8259_cov_60.011152	1424	1504	181	1	80	0.0125000
NODE_39_length_8259_cov_60.011152	1424	1504	184	1	80	0.0125000
NODE_39_length_8259_cov_60.011152	1424	1504	186	1	80	0.0125000
NODE_39_length_8259_cov_60.011152	1424	1504	191	2	80	0.0250000
NODE_39_length_8259_cov_60.011152	1424	1504	193	1	80	0.0125000
NODE_39_length_8259_cov_60.011152	1424	1504	194	2	80	0.0250000
NODE_39_length_8259_cov_60.011152	1424	1504	196	1	80	0.0125000
NODE_39_length_8259_cov_60.011152	1424	1504	198	1	80	0.0125000
NODE_39_length_8259_cov_60.011152	1424	1504	199	1	80	0.0125000
NODE_39_length_8259_cov_60.011152	1424	1504	200	1	80	0.0125000
NODE_39_length_8259_cov_60.011152	1424	1504	201	1	80	0.0125000
NODE_39_length_8259_cov_60.011152	1424	1504	203	2	80	0.0250000
NODE_39_length_8259_cov_60.011152	1424	1504	208	2	80	0.0250000
NODE_39_length_8259_cov_60.011152	1424	1504	209	2	80	0.0250000
NODE_39_length_8259_cov_60.011152	1424	1504	210	5	80	0.0625000
NODE_39_length_8259_cov_60.011152	1424	1504	212	1	80	0.0125000
NODE_39_length_8259_cov_60.011152	1424	1504	213	1	80	0.0125000
NODE_39_length_8259_cov_60.011152	1424	1504	215	1	80	0.0125000
NODE_39_length_8259_cov_60.011152	1424	1504	217	1	80	0.0125000
NODE_39_length_8259_cov_60.011152	1424	1504	218	7	80	0.0875000
NODE_39_length_8259_cov_60.011152	1424	1504	219	2	80	0.0250000
NODE_39_length_8259_cov_60.011152	1424	1504	220	9	80	0.1125000
NODE_39_length_8259_cov_60.011152	1424	1504	221	5	80	0.0625000
NODE_39_length_8259_cov_60.011152	1424	1504	222	9	80	0.1125000
NODE_39_length_8259_cov_60.011152	1424	1504	223	8	80	0.1000000
NODE_39_length_8259_cov_60.011152	1477	1549	180	1	72	0.0138889
NODE_39_length_8259_cov_60.011152	1477	1549	181	1	72	0.0138889
NODE_39_length_8259_cov_60.011152	1477	1549	182	1	72	0.0138889
NODE_39_length_8259_cov_60.011152	1477	1549	184	1	72	0.0138889
NODE_39_length_8259_cov_60.011152	1477	1549	186	2	72	0.0277778
NODE_39_length_8259_cov_60.011152	1477	1549	190	1	72	0.0138889
NODE_39_length_8259_cov_60.011152	1477	1549	192	1	72	0.0138889
NODE_39_length_8259_cov_60.011152	1477	1549	193	2	72	0.0277778
NODE_39_length_8259_cov_60.011152	1477	1549	194	1	72	0.0138889
NODE_39_length_8259_cov_60.011152	1477	1549	197	1	72	0.0138889
NODE_39_length_8259_cov_60.011152	1477	1549	199	1	72	0.0138889
NODE_39_length_8259_cov_60.011152	1477	1549	200	1	72	0.0138889
NODE_39_length_8259_cov_60.011152	1477	1549	202	3	72	0.0416667
NODE_39_length_8259_cov_60.011152	1477	1549	203	4	72	0.0555556
NODE_39_length_8259_cov_60.011152	1477	1549	204	3	72	0.0416667
NODE_39_length_8259_cov_60.011152	1477	1549	205	1	72	0.0138889
NODE_39_length_8259_cov_60.011152	1477	1549	207	1	72	0.0138889
NODE_39_length_8259_cov_60.011152	1477	1549	208	4	72	0.0555556
NODE_39_length_8259_cov_60.011152	1477	1549	210	1	72	0.0138889
NODE_39_length_8259_cov_60.011152	1477	1549	211	3	72	0.0416667
NODE_39_length_8259_cov_60.011152	1477	1549	212	2	72	0.0277778
NODE_39_length_8259_cov_60.011152	1477	1549	213	1	72	0.0138889
NODE_39_length_8259_cov_60.011152	1477	1549	215	2	72	0.0277778
NODE_39_length_8259_cov_60.011152	1477	1549	216	2	72	0.0277778
NODE_39_length_8259_cov_60.011152	1477	1549	217	3	72	0.0416667
NODE_39_length_8259_cov_60.011152	1477	1549	218	8	72	0.1111111
NODE_39_length_8259_cov_60.011152	1477	1549	219	1	72	0.0138889
NODE_39_length_8259_cov_60.011152	1477	1549	220	7	72	0.0972222
NODE_39_length_8259_cov_60.011152	1477	1549	221	2	72	0.0277778
NODE_39_length_8259_cov_60.011152	1477	1549	222	3	72	0.0416667
NODE_39_length_8259_cov_60.011152	1477	1549	223	7	72	0.0972222
NODE_40_length_8228_cov_17.079592	314	394	1	20	80	0.2500000
NODE_40_length_8228_cov_17.079592	314	394	2	60	80	0.7500000
NODE_40_length_8228_cov_17.079592	367	447	1	53	80	0.6625000
NODE_40_length_8228_cov_17.079592	367	447	2	9	80	0.1125000
NODE_40_length_8228_cov_17.079592	367	447	5	18	80	0.2250000
NODE_40_length_8228_cov_17.079592	443	523	4	23	80	0.2875000
NODE_40_length_8228_cov_17.079592	443	523	5	26	80	0.3250000
NODE_40_length_8228_cov_17.079592	443	523	6	31	80	0.3875000
NODE_40_length_8228_cov_17.079592	496	576	2	9	80	0.1125000
NODE_40_length_8228_cov_17.079592	496	576	6	71	80	0.8875000
NODE_40_length_8228_cov_17.079592	3154	3217	3	1	63	0.0158730
NODE_40_length_8228_cov_17.079592	3154	3217	14	8	63	0.1269841
NODE_40_length_8228_cov_17.079592	3154	3217	16	17	63	0.2698413
NODE_40_length_8228_cov_17.079592	3154	3217	18	1	63	0.0158730
NODE_40_length_8228_cov_17.079592	3154	3217	20	36	63	0.5714286
NODE_43_length_8100_cov_32.115236	501	581	6	22	80	0.2750000
NODE_43_length_8100_cov_32.115236	501	581	7	2	80	0.0250000
NODE_43_length_8100_cov_32.115236	501	581	8	56	80	0.7000000
NODE_43_length_8100_cov_32.115236	554	634	3	19	80	0.2375000
NODE_43_length_8100_cov_32.115236	554	634	4	11	80	0.1375000
NODE_43_length_8100_cov_32.115236	554	634	5	7	80	0.0875000
NODE_43_length_8100_cov_32.115236	554	634	6	4	80	0.0500000
NODE_43_length_8100_cov_32.115236	554	634	7	12	80	0.1500000
NODE_43_length_8100_cov_32.115236	554	634	8	27	80	0.3375000
NODE_43_length_8100_cov_32.115236	1383	1463	2	33	80	0.4125000
NODE_43_length_8100_cov_32.115236	1383	1463	3	26	80	0.3250000
NODE_43_length_8100_cov_32.115236	1383	1463	4	21	80	0.2625000
NODE_43_length_8100_cov_32.115236	1436	1516	2	6	80	0.0750000
NODE_43_length_8100_cov_32.115236	1436	1516	3	42	80	0.5250000
NODE_43_length_8100_cov_32.115236	1436	1516	4	32	80	0.4000000
NODE_43_length_8100_cov_32.115236	3391	3462	305	3	71	0.0422535
NODE_43_length_8100_cov_32.115236	3391	3462	307	1	71	0.0140845
NODE_43_length_8100_cov_32.115236	3391	3462	309	1	71	0.0140845
NODE_43_length_8100_cov_32.115236	3391	3462	310	1	71	0.0140845
NODE_43_length_8100_cov_32.115236	3391	3462	311	1	71	0.0140845
NODE_43_length_8100_cov_32.115236	3391	3462	312	1	71	0.0140845
NODE_43_length_8100_cov_32.115236	3391	3462	313	3	71	0.0422535
NODE_43_length_8100_cov_32.115236	3391	3462	317	1	71	0.0140845
NODE_43_length_8100_cov_32.115236	3391	3462	319	1	71	0.0140845
NODE_43_length_8100_cov_32.115236	3391	3462	322	2	71	0.0281690
NODE_43_length_8100_cov_32.115236	3391	3462	326	1	71	0.0140845
NODE_43_length_8100_cov_32.115236	3391	3462	329	1	71	0.0140845
NODE_43_length_8100_cov_32.115236	3391	3462	333	2	71	0.0281690
NODE_43_length_8100_cov_32.115236	3391	3462	345	1	71	0.0140845
NODE_43_length_8100_cov_32.115236	3391	3462	346	1	71	0.0140845
NODE_43_length_8100_cov_32.115236	3391	3462	350	1	71	0.0140845
NODE_43_length_8100_cov_32.115236	3391	3462	352	2	71	0.0281690
NODE_43_length_8100_cov_32.115236	3391	3462	353	2	71	0.0281690
NODE_43_length_8100_cov_32.115236	3391	3462	354	1	71	0.0140845
NODE_43_length_8100_cov_32.115236	3391	3462	355	1	71	0.0140845
NODE_43_length_8100_cov_32.115236	3391	3462	356	5	71	0.0704225
NODE_43_length_8100_cov_32.115236	3391	3462	357	4	71	0.0563380
NODE_43_length_8100_cov_32.115236	3391	3462	358	3	71	0.0422535
NODE_43_length_8100_cov_32.115236	3391	3462	361	2	71	0.0281690
NODE_43_length_8100_cov_32.115236	3391	3462	363	1	71	0.0140845
NODE_43_length_8100_cov_32.115236	3391	3462	364	5	71	0.0704225
NODE_43_length_8100_cov_32.115236	3391	3462	365	3	71	0.0422535
NODE_43_length_8100_cov_32.115236	3391	3462	366	6	71	0.0845070
NODE_43_length_8100_cov_32.115236	3391	3462	368	1	71	0.0140845
NODE_43_length_8100_cov_32.115236	3391	3462	370	1	71	0.0140845
NODE_43_length_8100_cov_32.115236	3391	3462	371	3	71	0.0422535
NODE_43_length_8100_cov_32.115236	3391	3462	372	2	71	0.0281690
NODE_43_length_8100_cov_32.115236	3391	3462	373	2	71	0.0281690
NODE_43_length_8100_cov_32.115236	3391	3462	374	1	71	0.0140845
NODE_43_length_8100_cov_32.115236	3391	3462	375	2	71	0.0281690
NODE_43_length_8100_cov_32.115236	3391	3462	376	2	71	0.0281690
NODE_43_length_8100_cov_32.115236	3435	3483	264	5	48	0.1041667
NODE_43_length_8100_cov_32.115236	3435	3483	265	1	48	0.0208333
NODE_43_length_8100_cov_32.115236	3435	3483	273	1	48	0.0208333
NODE_43_length_8100_cov_32.115236	3435	3483	277	1	48	0.0208333
NODE_43_length_8100_cov_32.115236	3435	3483	279	1	48	0.0208333
NODE_43_length_8100_cov_32.115236	3435	3483	286	1	48	0.0208333
NODE_43_length_8100_cov_32.115236	3435	3483	289	1	48	0.0208333
NODE_43_length_8100_cov_32.115236	3435	3483	290	1	48	0.0208333
NODE_43_length_8100_cov_32.115236	3435	3483	291	2	48	0.0416667
NODE_43_length_8100_cov_32.115236	3435	3483	292	2	48	0.0416667
NODE_43_length_8100_cov_32.115236	3435	3483	294	2	48	0.0416667
NODE_43_length_8100_cov_32.115236	3435	3483	299	2	48	0.0416667
NODE_43_length_8100_cov_32.115236	3435	3483	302	1	48	0.0208333
NODE_43_length_8100_cov_32.115236	3435	3483	305	3	48	0.0625000
NODE_43_length_8100_cov_32.115236	3435	3483	307	1	48	0.0208333
NODE_43_length_8100_cov_32.115236	3435	3483	309	1	48	0.0208333
NODE_43_length_8100_cov_32.115236	3435	3483	310	1	48	0.0208333
NODE_43_length_8100_cov_32.115236	3435	3483	311	1	48	0.0208333
NODE_43_length_8100_cov_32.115236	3435	3483	312	1	48	0.0208333
NODE_43_length_8100_cov_32.115236	3435	3483	313	3	48	0.0625000
NODE_43_length_8100_cov_32.115236	3435	3483	317	1	48	0.0208333
NODE_43_length_8100_cov_32.115236	3435	3483	319	1	48	0.0208333
NODE_43_length_8100_cov_32.115236	3435	3483	322	2	48	0.0416667
NODE_43_length_8100_cov_32.115236	3435	3483	326	1	48	0.0208333
NODE_43_length_8100_cov_32.115236	3435	3483	329	1	48	0.0208333
NODE_43_length_8100_cov_32.115236	3435	3483	333	2	48	0.0416667
NODE_43_length_8100_cov_32.115236	3435	3483	345	1	48	0.0208333
NODE_43_length_8100_cov_32.115236	3435	3483	346	1	48	0.0208333
NODE_43_length_8100_cov_32.115236	3435	3483	352	1	48	0.0208333
NODE_43_length_8100_cov_32.115236	3435	3483	356	3	48	0.0625000
NODE_43_length_8100_cov_32.115236	3435	3483	357	2	48	0.0416667
NODE_46_length_7962_cov_31.622790	6281	6363	181	1	82	0.0121951
NODE_46_length_7962_cov_31.622790	6281	6363	182	2	82	0.0243902
NODE_46_length_7962_cov_31.622790	6281	6363	183	4	82	0.0487805
NODE_46_length_7962_cov_31.622790	6281	6363	184	3	82	0.0365854
NODE_46_length_7962_cov_31.622790	6281	6363	185	10	82	0.1219512
NODE_46_length_7962_cov_31.622790	6281	6363	186	4	82	0.0487805
NODE_46_length_7962_cov_31.622790	6281	6363	187	6	82	0.0731707
NODE_46_length_7962_cov_31.622790	6281	6363	188	3	82	0.0365854
NODE_46_length_7962_cov_31.622790	6281	6363	189	7	82	0.0853659
NODE_46_length_7962_cov_31.622790	6281	6363	190	6	82	0.0731707
NODE_46_length_7962_cov_31.622790	6281	6363	191	1	82	0.0121951
NODE_46_length_7962_cov_31.622790	6281	6363	192	1	82	0.0121951
NODE_46_length_7962_cov_31.622790	6281	6363	193	2	82	0.0243902
NODE_46_length_7962_cov_31.622790	6281	6363	194	1	82	0.0121951
NODE_46_length_7962_cov_31.622790	6281	6363	195	3	82	0.0365854
NODE_46_length_7962_cov_31.622790	6281	6363	197	6	82	0.0731707
NODE_46_length_7962_cov_31.622790	6281	6363	198	5	82	0.0609756
NODE_46_length_7962_cov_31.622790	6281	6363	199	14	82	0.1707317
NODE_46_length_7962_cov_31.622790	6281	6363	200	3	82	0.0365854
NODE_47_length_7944_cov_12.238496	348	419	3	6	71	0.0845070
NODE_47_length_7944_cov_12.238496	348	419	4	2	71	0.0281690
NODE_47_length_7944_cov_12.238496	348	419	6	17	71	0.2394366
NODE_47_length_7944_cov_12.238496	348	419	7	1	71	0.0140845
NODE_47_length_7944_cov_12.238496	348	419	8	1	71	0.0140845
NODE_47_length_7944_cov_12.238496	348	419	9	44	71	0.6197183
NODE_48_length_7919_cov_14.554859	2380	2460	31	8	80	0.1000000
NODE_48_length_7919_cov_14.554859	2380	2460	32	11	80	0.1375000
NODE_48_length_7919_cov_14.554859	2380	2460	33	7	80	0.0875000
NODE_48_length_7919_cov_14.554859	2380	2460	34	2	80	0.0250000
NODE_48_length_7919_cov_14.554859	2380	2460	35	12	80	0.1500000
NODE_48_length_7919_cov_14.554859	2380	2460	36	3	80	0.0375000
NODE_48_length_7919_cov_14.554859	2380	2460	37	10	80	0.1250000
NODE_48_length_7919_cov_14.554859	2380	2460	38	13	80	0.1625000
NODE_48_length_7919_cov_14.554859	2380	2460	39	11	80	0.1375000
NODE_48_length_7919_cov_14.554859	2380	2460	40	3	80	0.0375000
NODE_50_length_7830_cov_4.211098	0	52	2	21	52	0.4038461
NODE_50_length_7830_cov_4.211098	0	52	3	31	52	0.5961539
NODE_50_length_7830_cov_4.211098	30	105	3	48	75	0.6400000
NODE_50_length_7830_cov_4.211098	30	105	4	8	75	0.1066667
NODE_50_length_7830_cov_4.211098	30	105	5	19	75	0.2533333
NODE_52_length_7779_cov_20.230859	7691	7771	0	58	80	0.7250000
NODE_52_length_7779_cov_20.230859	7691	7771	2	22	80	0.2750000
NODE_52_length_7779_cov_20.230859	7691	7771	0	58	80	0.7250000
NODE_52_length_7779_cov_20.230859	7691	7771	2	22	80	0.2750000
NODE_52_length_7779_cov_20.230859	7691	7761	0	48	70	0.6857143
NODE_52_length_7779_cov_20.230859	7691	7761	2	22	70	0.3142857
NODE_52_length_7779_cov_20.230859	7744	7779	0	35	35	1.0000000
NODE_53_length_7765_cov_18.871119	254	322	51	2	68	0.0294118
NODE_53_length_7765_cov_18.871119	254	322	52	4	68	0.0588235
NODE_53_length_7765_cov_18.871119	254	322	53	6	68	0.0882353
NODE_53_length_7765_cov_18.871119	254	322	54	14	68	0.2058824
NODE_53_length_7765_cov_18.871119	254	322	55	14	68	0.2058824
NODE_53_length_7765_cov_18.871119	254	322	56	5	68	0.0735294
NODE_53_length_7765_cov_18.871119	254	322	57	1	68	0.0147059
NODE_53_length_7765_cov_18.871119	254	322	58	2	68	0.0294118
NODE_53_length_7765_cov_18.871119	254	322	61	1	68	0.0147059
NODE_53_length_7765_cov_18.871119	254	322	65	1	68	0.0147059
NODE_53_length_7765_cov_18.871119	254	322	68	1	68	0.0147059
NODE_53_length_7765_cov_18.871119	254	322	72	1	68	0.0147059
NODE_53_length_7765_cov_18.871119	254	322	76	1	68	0.0147059
NODE_53_length_7765_cov_18.871119	254	322	78	1	68	0.0147059
NODE_53_length_7765_cov_18.871119	254	322	79	2	68	0.0294118
NODE_53_length_7765_cov_18.871119	254	322	80	1	68	0.0147059
NODE_53_length_7765_cov_18.871119	254	322	81	1	68	0.0147059
NODE_53_length_7765_cov_18.871119	254	322	82	2	68	0.0294118
NODE_53_length_7765_cov_18.871119	254	322	87	1	68	0.0147059
NODE_53_length_7765_cov_18.871119	254	322	90	1	68	0.0147059
NODE_53_length_7765_cov_18.871119	254	322	100	1	68	0.0147059
NODE_53_length_7765_cov_18.871119	254	322	107	1	68	0.0147059
NODE_53_length_7765_cov_18.871119	254	322	110	1	68	0.0147059
NODE_53_length_7765_cov_18.871119	254	322	111	2	68	0.0294118
NODE_53_length_7765_cov_18.871119	254	322	115	1	68	0.0147059
NODE_53_length_7765_cov_18.871119	353	433	24	1	80	0.0125000
NODE_53_length_7765_cov_18.871119	353	433	25	1	80	0.0125000
NODE_53_length_7765_cov_18.871119	353	433	27	1	80	0.0125000
NODE_53_length_7765_cov_18.871119	353	433	28	6	80	0.0750000
NODE_53_length_7765_cov_18.871119	353	433	29	4	80	0.0500000
NODE_53_length_7765_cov_18.871119	353	433	31	3	80	0.0375000
NODE_53_length_7765_cov_18.871119	353	433	33	1	80	0.0125000
NODE_53_length_7765_cov_18.871119	353	433	34	7	80	0.0875000
NODE_53_length_7765_cov_18.871119	353	433	35	5	80	0.0625000
NODE_53_length_7765_cov_18.871119	353	433	36	10	80	0.1250000
NODE_53_length_7765_cov_18.871119	353	433	38	3	80	0.0375000
NODE_53_length_7765_cov_18.871119	353	433	40	2	80	0.0250000
NODE_53_length_7765_cov_18.871119	353	433	41	1	80	0.0125000
NODE_53_length_7765_cov_18.871119	353	433	42	6	80	0.0750000
NODE_53_length_7765_cov_18.871119	353	433	43	1	80	0.0125000
NODE_53_length_7765_cov_18.871119	353	433	44	1	80	0.0125000
NODE_53_length_7765_cov_18.871119	353	433	45	1	80	0.0125000
NODE_53_length_7765_cov_18.871119	353	433	46	4	80	0.0500000
NODE_53_length_7765_cov_18.871119	353	433	48	4	80	0.0500000
NODE_53_length_7765_cov_18.871119	353	433	51	1	80	0.0125000
NODE_53_length_7765_cov_18.871119	353	433	53	2	80	0.0250000
NODE_53_length_7765_cov_18.871119	353	433	54	7	80	0.0875000
NODE_53_length_7765_cov_18.871119	353	433	56	5	80	0.0625000
NODE_53_length_7765_cov_18.871119	353	433	59	1	80	0.0125000
NODE_53_length_7765_cov_18.871119	353	433	61	1	80	0.0125000
NODE_53_length_7765_cov_18.871119	353	433	62	1	80	0.0125000
NODE_61_length_7411_cov_74.967314	2283	2347	17	5	64	0.0781250
NODE_61_length_7411_cov_74.967314	2283	2347	18	9	64	0.1406250
NODE_61_length_7411_cov_74.967314	2283	2347	19	3	64	0.0468750
NODE_61_length_7411_cov_74.967314	2283	2347	20	3	64	0.0468750
NODE_61_length_7411_cov_74.967314	2283	2347	21	2	64	0.0312500
NODE_61_length_7411_cov_74.967314	2283	2347	22	5	64	0.0781250
NODE_61_length_7411_cov_74.967314	2283	2347	23	3	64	0.0468750
NODE_61_length_7411_cov_74.967314	2283	2347	24	3	64	0.0468750
NODE_61_length_7411_cov_74.967314	2283	2347	25	8	64	0.1250000
NODE_61_length_7411_cov_74.967314	2283	2347	26	1	64	0.0156250
NODE_61_length_7411_cov_74.967314	2283	2347	28	1	64	0.0156250
NODE_61_length_7411_cov_74.967314	2283	2347	29	2	64	0.0312500
NODE_61_length_7411_cov_74.967314	2283	2347	30	1	64	0.0156250
NODE_61_length_7411_cov_74.967314	2283	2347	31	1	64	0.0156250
NODE_61_length_7411_cov_74.967314	2283	2347	32	4	64	0.0625000
NODE_61_length_7411_cov_74.967314	2283	2347	33	2	64	0.0312500
NODE_61_length_7411_cov_74.967314	2283	2347	35	6	64	0.0937500
NODE_61_length_7411_cov_74.967314	2283	2347	37	1	64	0.0156250
NODE_61_length_7411_cov_74.967314	2283	2347	38	1	64	0.0156250
NODE_61_length_7411_cov_74.967314	2283	2347	40	3	64	0.0468750
NODE_61_length_7411_cov_74.967314	4725	4789	0	64	64	1.0000000
NODE_64_length_7305_cov_3.696087	971	1019	1	19	48	0.3958333
NODE_64_length_7305_cov_3.696087	971	1019	3	4	48	0.0833333
NODE_64_length_7305_cov_3.696087	971	1019	4	2	48	0.0416667
NODE_64_length_7305_cov_3.696087	971	1019	5	2	48	0.0416667
NODE_64_length_7305_cov_3.696087	971	1019	6	7	48	0.1458333
NODE_64_length_7305_cov_3.696087	971	1019	7	10	48	0.2083333
NODE_64_length_7305_cov_3.696087	971	1019	8	3	48	0.0625000
NODE_64_length_7305_cov_3.696087	971	1019	9	1	48	0.0208333
NODE_64_length_7305_cov_3.696087	7142	7190	4	1	48	0.0208333
NODE_64_length_7305_cov_3.696087	7142	7190	5	23	48	0.4791667
NODE_64_length_7305_cov_3.696087	7142	7190	6	24	48	0.5000000
NODE_66_length_7261_cov_12.433398	2313	2395	309	2	82	0.0243902
NODE_66_length_7261_cov_12.433398	2313	2395	311	1	82	0.0121951
NODE_66_length_7261_cov_12.433398	2313	2395	312	2	82	0.0243902
NODE_66_length_7261_cov_12.433398	2313	2395	313	1	82	0.0121951
NODE_66_length_7261_cov_12.433398	2313	2395	316	2	82	0.0243902
NODE_66_length_7261_cov_12.433398	2313	2395	321	2	82	0.0243902
NODE_66_length_7261_cov_12.433398	2313	2395	327	2	82	0.0243902
NODE_66_length_7261_cov_12.433398	2313	2395	328	1	82	0.0121951
NODE_66_length_7261_cov_12.433398	2313	2395	332	1	82	0.0121951
NODE_66_length_7261_cov_12.433398	2313	2395	337	1	82	0.0121951
NODE_66_length_7261_cov_12.433398	2313	2395	338	1	82	0.0121951
NODE_66_length_7261_cov_12.433398	2313	2395	339	3	82	0.0365854
NODE_66_length_7261_cov_12.433398	2313	2395	340	1	82	0.0121951
NODE_66_length_7261_cov_12.433398	2313	2395	342	1	82	0.0121951
NODE_66_length_7261_cov_12.433398	2313	2395	344	1	82	0.0121951
NODE_66_length_7261_cov_12.433398	2313	2395	345	2	82	0.0243902
NODE_66_length_7261_cov_12.433398	2313	2395	346	4	82	0.0487805
NODE_66_length_7261_cov_12.433398	2313	2395	347	2	82	0.0243902
NODE_66_length_7261_cov_12.433398	2313	2395	349	1	82	0.0121951
NODE_66_length_7261_cov_12.433398	2313	2395	350	2	82	0.0243902
NODE_66_length_7261_cov_12.433398	2313	2395	351	4	82	0.0487805
NODE_66_length_7261_cov_12.433398	2313	2395	352	1	82	0.0121951
NODE_66_length_7261_cov_12.433398	2313	2395	353	3	82	0.0365854
NODE_66_length_7261_cov_12.433398	2313	2395	355	3	82	0.0365854
NODE_66_length_7261_cov_12.433398	2313	2395	356	2	82	0.0243902
NODE_66_length_7261_cov_12.433398	2313	2395	357	5	82	0.0609756
NODE_66_length_7261_cov_12.433398	2313	2395	358	1	82	0.0121951
NODE_66_length_7261_cov_12.433398	2313	2395	359	2	82	0.0243902
NODE_66_length_7261_cov_12.433398	2313	2395	360	3	82	0.0365854
NODE_66_length_7261_cov_12.433398	2313	2395	361	1	82	0.0121951
NODE_66_length_7261_cov_12.433398	2313	2395	367	1	82	0.0121951
NODE_66_length_7261_cov_12.433398	2313	2395	368	1	82	0.0121951
NODE_66_length_7261_cov_12.433398	2313	2395	371	1	82	0.0121951
NODE_66_length_7261_cov_12.433398	2313	2395	372	2	82	0.0243902
NODE_66_length_7261_cov_12.433398	2313	2395	374	1	82	0.0121951
NODE_66_length_7261_cov_12.433398	2313	2395	377	1	82	0.0121951
NODE_66_length_7261_cov_12.433398	2313	2395	378	1	82	0.0121951
NODE_66_length_7261_cov_12.433398	2313	2395	379	1	82	0.0121951
NODE_66_length_7261_cov_12.433398	2313	2395	380	1	82	0.0121951
NODE_66_length_7261_cov_12.433398	2313	2395	383	1	82	0.0121951
NODE_66_length_7261_cov_12.433398	2313	2395	384	1	82	0.0121951
NODE_66_length_7261_cov_12.433398	2313	2395	387	1	82	0.0121951
NODE_66_length_7261_cov_12.433398	2313	2395	388	1	82	0.0121951
NODE_66_length_7261_cov_12.433398	2313	2395	389	1	82	0.0121951
NODE_66_length_7261_cov_12.433398	2313	2395	390	1	82	0.0121951
NODE_66_length_7261_cov_12.433398	2313	2395	392	1	82	0.0121951
NODE_66_length_7261_cov_12.433398	2313	2395	395	1	82	0.0121951
NODE_66_length_7261_cov_12.433398	2313	2395	396	1	82	0.0121951
NODE_66_length_7261_cov_12.433398	2313	2395	400	1	82	0.0121951
NODE_66_length_7261_cov_12.433398	2313	2395	402	1	82	0.0121951
NODE_66_length_7261_cov_12.433398	2313	2395	405	1	82	0.0121951
NODE_66_length_7261_cov_12.433398	2313	2395	406	2	82	0.0243902
NODE_73_length_7036_cov_65.961943	4375	4455	8	6	80	0.0750000
NODE_73_length_7036_cov_65.961943	4375	4455	9	6	80	0.0750000
NODE_73_length_7036_cov_65.961943	4375	4455	10	4	80	0.0500000
NODE_73_length_7036_cov_65.961943	4375	4455	11	2	80	0.0250000
NODE_73_length_7036_cov_65.961943	4375	4455	12	23	80	0.2875000
NODE_73_length_7036_cov_65.961943	4375	4455	13	12	80	0.1500000
NODE_73_length_7036_cov_65.961943	4375	4455	14	2	80	0.0250000
NODE_73_length_7036_cov_65.961943	4375	4455	15	10	80	0.1250000
NODE_73_length_7036_cov_65.961943	4375	4455	17	9	80	0.1125000
NODE_73_length_7036_cov_65.961943	4375	4455	18	5	80	0.0625000
NODE_73_length_7036_cov_65.961943	4375	4455	19	1	80	0.0125000
NODE_73_length_7036_cov_65.961943	5538	5618	197	1	80	0.0125000
NODE_73_length_7036_cov_65.961943	5538	5618	201	1	80	0.0125000
NODE_73_length_7036_cov_65.961943	5538	5618	203	1	80	0.0125000
NODE_73_length_7036_cov_65.961943	5538	5618	205	1	80	0.0125000
NODE_73_length_7036_cov_65.961943	5538	5618	211	1	80	0.0125000
NODE_73_length_7036_cov_65.961943	5538	5618	214	1	80	0.0125000
NODE_73_length_7036_cov_65.961943	5538	5618	221	1	80	0.0125000
NODE_73_length_7036_cov_65.961943	5538	5618	223	1	80	0.0125000
NODE_73_length_7036_cov_65.961943	5538	5618	226	1	80	0.0125000
NODE_73_length_7036_cov_65.961943	5538	5618	239	1	80	0.0125000
NODE_73_length_7036_cov_65.961943	5538	5618	249	1	80	0.0125000
NODE_73_length_7036_cov_65.961943	5538	5618	253	1	80	0.0125000
NODE_73_length_7036_cov_65.961943	5538	5618	261	1	80	0.0125000
NODE_73_length_7036_cov_65.961943	5538	5618	265	1	80	0.0125000
NODE_73_length_7036_cov_65.961943	5538	5618	270	1	80	0.0125000
NODE_73_length_7036_cov_65.961943	5538	5618	272	1	80	0.0125000
NODE_73_length_7036_cov_65.961943	5538	5618	277	1	80	0.0125000
NODE_73_length_7036_cov_65.961943	5538	5618	281	1	80	0.0125000
NODE_73_length_7036_cov_65.961943	5538	5618	286	1	80	0.0125000
NODE_73_length_7036_cov_65.961943	5538	5618	287	2	80	0.0250000
NODE_73_length_7036_cov_65.961943	5538	5618	303	1	80	0.0125000
NODE_73_length_7036_cov_65.961943	5538	5618	311	1	80	0.0125000
NODE_73_length_7036_cov_65.961943	5538	5618	319	1	80	0.0125000
NODE_73_length_7036_cov_65.961943	5538	5618	327	1	80	0.0125000
NODE_73_length_7036_cov_65.961943	5538	5618	333	1	80	0.0125000
NODE_73_length_7036_cov_65.961943	5538	5618	337	1	80	0.0125000
NODE_73_length_7036_cov_65.961943	5538	5618	345	1	80	0.0125000
NODE_73_length_7036_cov_65.961943	5538	5618	348	1	80	0.0125000
NODE_73_length_7036_cov_65.961943	5538	5618	352	1	80	0.0125000
NODE_73_length_7036_cov_65.961943	5538	5618	358	1	80	0.0125000
NODE_73_length_7036_cov_65.961943	5538	5618	366	1	80	0.0125000
NODE_73_length_7036_cov_65.961943	5538	5618	374	1	80	0.0125000
NODE_73_length_7036_cov_65.961943	5538	5618	379	1	80	0.0125000
NODE_73_length_7036_cov_65.961943	5538	5618	393	1	80	0.0125000
NODE_73_length_7036_cov_65.961943	5538	5618	413	1	80	0.0125000
NODE_73_length_7036_cov_65.961943	5538	5618	417	1	80	0.0125000
NODE_73_length_7036_cov_65.961943	5538	5618	419	1	80	0.0125000
NODE_73_length_7036_cov_65.961943	5538	5618	422	1	80	0.0125000
NODE_73_length_7036_cov_65.961943	5538	5618	427	1	80	0.0125000
NODE_73_length_7036_cov_65.961943	5538	5618	440	1	80	0.0125000
NODE_73_length_7036_cov_65.961943	5538	5618	443	1	80	0.0125000
NODE_73_length_7036_cov_65.961943	5538	5618	446	1	80	0.0125000
NODE_73_length_7036_cov_65.961943	5538	5618	453	1	80	0.0125000
NODE_73_length_7036_cov_65.961943	5538	5618	466	1	80	0.0125000
NODE_73_length_7036_cov_65.961943	5538	5618	472	1	80	0.0125000
NODE_73_length_7036_cov_65.961943	5538	5618	475	1	80	0.0125000
NODE_73_length_7036_cov_65.961943	5538	5618	484	1	80	0.0125000
NODE_73_length_7036_cov_65.961943	5538	5618	490	1	80	0.0125000
NODE_73_length_7036_cov_65.961943	5538	5618	492	1	80	0.0125000
NODE_73_length_7036_cov_65.961943	5538	5618	497	1	80	0.0125000
NODE_73_length_7036_cov_65.961943	5538	5618	501	1	80	0.0125000
NODE_73_length_7036_cov_65.961943	5538	5618	506	1	80	0.0125000
NODE_73_length_7036_cov_65.961943	5538	5618	515	1	80	0.0125000
NODE_73_length_7036_cov_65.961943	5538	5618	517	1	80	0.0125000
NODE_73_length_7036_cov_65.961943	5538	5618	519	1	80	0.0125000
NODE_73_length_7036_cov_65.961943	5538	5618	522	1	80	0.0125000
NODE_73_length_7036_cov_65.961943	5538	5618	531	1	80	0.0125000
NODE_73_length_7036_cov_65.961943	5538	5618	539	1	80	0.0125000
NODE_73_length_7036_cov_65.961943	5538	5618	540	1	80	0.0125000
NODE_73_length_7036_cov_65.961943	5538	5618	552	1	80	0.0125000
NODE_73_length_7036_cov_65.961943	5538	5618	557	1	80	0.0125000
NODE_73_length_7036_cov_65.961943	5538	5618	572	1	80	0.0125000
NODE_73_length_7036_cov_65.961943	5538	5618	576	1	80	0.0125000
NODE_73_length_7036_cov_65.961943	5538	5618	584	1	80	0.0125000
NODE_73_length_7036_cov_65.961943	5538	5618	590	1	80	0.0125000
NODE_73_length_7036_cov_65.961943	5538	5618	591	1	80	0.0125000
NODE_73_length_7036_cov_65.961943	5538	5618	595	2	80	0.0250000
NODE_73_length_7036_cov_65.961943	5538	5618	600	1	80	0.0125000
NODE_73_length_7036_cov_65.961943	5538	5618	604	1	80	0.0125000
NODE_73_length_7036_cov_65.961943	5538	5618	607	1	80	0.0125000
NODE_73_length_7036_cov_65.961943	5538	5618	611	1	80	0.0125000
NODE_73_length_7036_cov_65.961943	5538	5618	612	1	80	0.0125000
NODE_73_length_7036_cov_65.961943	5538	5618	617	1	80	0.0125000
NODE_73_length_7036_cov_65.961943	5538	5618	618	1	80	0.0125000
NODE_73_length_7036_cov_65.961943	5538	5618	622	1	80	0.0125000
NODE_73_length_7036_cov_65.961943	5538	5618	623	1	80	0.0125000
NODE_73_length_7036_cov_65.961943	5538	5618	624	2	80	0.0250000
NODE_73_length_7036_cov_65.961943	5591	5666	515	1	75	0.0133333
NODE_73_length_7036_cov_65.961943	5591	5666	517	1	75	0.0133333
NODE_73_length_7036_cov_65.961943	5591	5666	519	1	75	0.0133333
NODE_73_length_7036_cov_65.961943	5591	5666	522	1	75	0.0133333
NODE_73_length_7036_cov_65.961943	5591	5666	531	1	75	0.0133333
NODE_73_length_7036_cov_65.961943	5591	5666	539	1	75	0.0133333
NODE_73_length_7036_cov_65.961943	5591	5666	540	1	75	0.0133333
NODE_73_length_7036_cov_65.961943	5591	5666	552	1	75	0.0133333
NODE_73_length_7036_cov_65.961943	5591	5666	557	1	75	0.0133333
NODE_73_length_7036_cov_65.961943	5591	5666	572	1	75	0.0133333
NODE_73_length_7036_cov_65.961943	5591	5666	576	1	75	0.0133333
NODE_73_length_7036_cov_65.961943	5591	5666	584	1	75	0.0133333
NODE_73_length_7036_cov_65.961943	5591	5666	590	1	75	0.0133333
NODE_73_length_7036_cov_65.961943	5591	5666	591	1	75	0.0133333
NODE_73_length_7036_cov_65.961943	5591	5666	595	2	75	0.0266667
NODE_73_length_7036_cov_65.961943	5591	5666	600	1	75	0.0133333
NODE_73_length_7036_cov_65.961943	5591	5666	604	1	75	0.0133333
NODE_73_length_7036_cov_65.961943	5591	5666	607	1	75	0.0133333
NODE_73_length_7036_cov_65.961943	5591	5666	611	1	75	0.0133333
NODE_73_length_7036_cov_65.961943	5591	5666	612	1	75	0.0133333
NODE_73_length_7036_cov_65.961943	5591	5666	617	1	75	0.0133333
NODE_73_length_7036_cov_65.961943	5591	5666	618	1	75	0.0133333
NODE_73_length_7036_cov_65.961943	5591	5666	622	1	75	0.0133333
NODE_73_length_7036_cov_65.961943	5591	5666	623	1	75	0.0133333
NODE_73_length_7036_cov_65.961943	5591	5666	624	2	75	0.0266667
NODE_73_length_7036_cov_65.961943	5591	5666	629	1	75	0.0133333
NODE_73_length_7036_cov_65.961943	5591	5666	634	1	75	0.0133333
NODE_73_length_7036_cov_65.961943	5591	5666	650	2	75	0.0266667
NODE_73_length_7036_cov_65.961943	5591	5666	652	1	75	0.0133333
NODE_73_length_7036_cov_65.961943	5591	5666	654	1	75	0.0133333
NODE_73_length_7036_cov_65.961943	5591	5666	657	1	75	0.0133333
NODE_73_length_7036_cov_65.961943	5591	5666	658	3	75	0.0400000
NODE_73_length_7036_cov_65.961943	5591	5666	659	1	75	0.0133333
NODE_73_length_7036_cov_65.961943	5591	5666	660	1	75	0.0133333
NODE_73_length_7036_cov_65.961943	5591	5666	664	2	75	0.0266667
NODE_73_length_7036_cov_65.961943	5591	5666	665	1	75	0.0133333
NODE_73_length_7036_cov_65.961943	5591	5666	671	1	75	0.0133333
NODE_73_length_7036_cov_65.961943	5591	5666	672	1	75	0.0133333
NODE_73_length_7036_cov_65.961943	5591	5666	673	2	75	0.0266667
NODE_73_length_7036_cov_65.961943	5591	5666	678	1	75	0.0133333
NODE_73_length_7036_cov_65.961943	5591	5666	679	1	75	0.0133333
NODE_73_length_7036_cov_65.961943	5591	5666	692	1	75	0.0133333
NODE_73_length_7036_cov_65.961943	5591	5666	693	2	75	0.0266667
NODE_73_length_7036_cov_65.961943	5591	5666	697	2	75	0.0266667
NODE_73_length_7036_cov_65.961943	5591	5666	700	1	75	0.0133333
NODE_73_length_7036_cov_65.961943	5591	5666	704	1	75	0.0133333
NODE_73_length_7036_cov_65.961943	5591	5666	705	1	75	0.0133333
NODE_73_length_7036_cov_65.961943	5591	5666	706	1	75	0.0133333
NODE_73_length_7036_cov_65.961943	5591	5666	708	1	75	0.0133333
NODE_73_length_7036_cov_65.961943	5591	5666	711	1	75	0.0133333
NODE_73_length_7036_cov_65.961943	5591	5666	712	1	75	0.0133333
NODE_73_length_7036_cov_65.961943	5591	5666	714	1	75	0.0133333
NODE_73_length_7036_cov_65.961943	5591	5666	722	1	75	0.0133333
NODE_73_length_7036_cov_65.961943	5591	5666	723	1	75	0.0133333
NODE_73_length_7036_cov_65.961943	5591	5666	728	1	75	0.0133333
NODE_73_length_7036_cov_65.961943	5591	5666	729	1	75	0.0133333
NODE_73_length_7036_cov_65.961943	5591	5666	733	1	75	0.0133333
NODE_73_length_7036_cov_65.961943	5591	5666	753	1	75	0.0133333
NODE_73_length_7036_cov_65.961943	5591	5666	759	1	75	0.0133333
NODE_73_length_7036_cov_65.961943	5591	5666	767	1	75	0.0133333
NODE_73_length_7036_cov_65.961943	5591	5666	770	1	75	0.0133333
NODE_73_length_7036_cov_65.961943	5591	5666	774	1	75	0.0133333
NODE_73_length_7036_cov_65.961943	5591	5666	776	1	75	0.0133333
NODE_73_length_7036_cov_65.961943	5591	5666	778	1	75	0.0133333
NODE_73_length_7036_cov_65.961943	5591	5666	780	1	75	0.0133333
NODE_73_length_7036_cov_65.961943	5591	5666	787	1	75	0.0133333
NODE_73_length_7036_cov_65.961943	5690	5746	770	1	56	0.0178571
NODE_73_length_7036_cov_65.961943	5690	5746	774	1	56	0.0178571
NODE_73_length_7036_cov_65.961943	5690	5746	776	3	56	0.0535714
NODE_73_length_7036_cov_65.961943	5690	5746	777	2	56	0.0357143
NODE_73_length_7036_cov_65.961943	5690	5746	779	1	56	0.0178571
NODE_73_length_7036_cov_65.961943	5690	5746	780	1	56	0.0178571
NODE_73_length_7036_cov_65.961943	5690	5746	781	2	56	0.0357143
NODE_73_length_7036_cov_65.961943	5690	5746	782	5	56	0.0892857
NODE_73_length_7036_cov_65.961943	5690	5746	783	3	56	0.0535714
NODE_73_length_7036_cov_65.961943	5690	5746	785	3	56	0.0535714
NODE_73_length_7036_cov_65.961943	5690	5746	786	3	56	0.0535714
NODE_73_length_7036_cov_65.961943	5690	5746	787	1	56	0.0178571
NODE_73_length_7036_cov_65.961943	5690	5746	788	2	56	0.0357143
NODE_73_length_7036_cov_65.961943	5690	5746	789	2	56	0.0357143
NODE_73_length_7036_cov_65.961943	5690	5746	790	2	56	0.0357143
NODE_73_length_7036_cov_65.961943	5690	5746	792	3	56	0.0535714
NODE_73_length_7036_cov_65.961943	5690	5746	793	1	56	0.0178571
NODE_73_length_7036_cov_65.961943	5690	5746	794	4	56	0.0714286
NODE_73_length_7036_cov_65.961943	5690	5746	795	2	56	0.0357143
NODE_73_length_7036_cov_65.961943	5690	5746	797	2	56	0.0357143
NODE_73_length_7036_cov_65.961943	5690	5746	800	1	56	0.0178571
NODE_73_length_7036_cov_65.961943	5690	5746	801	2	56	0.0357143
NODE_73_length_7036_cov_65.961943	5690	5746	803	1	56	0.0178571
NODE_73_length_7036_cov_65.961943	5690	5746	807	1	56	0.0178571
NODE_73_length_7036_cov_65.961943	5690	5746	811	3	56	0.0535714
NODE_73_length_7036_cov_65.961943	5690	5746	812	3	56	0.0535714
NODE_73_length_7036_cov_65.961943	5690	5746	816	1	56	0.0178571
NODE_73_length_7036_cov_65.961943	6373	6453	4	12	80	0.1500000
NODE_73_length_7036_cov_65.961943	6373	6453	5	1	80	0.0125000
NODE_73_length_7036_cov_65.961943	6373	6453	6	67	80	0.8375000
NODE_73_length_7036_cov_65.961943	6426	6506	3	45	80	0.5625000
NODE_73_length_7036_cov_65.961943	6426	6506	4	1	80	0.0125000
NODE_73_length_7036_cov_65.961943	6426	6506	6	34	80	0.4250000
NODE_74_length_6974_cov_16.058327	976	1056	9	7	80	0.0875000
NODE_74_length_6974_cov_16.058327	976	1056	10	13	80	0.1625000
NODE_74_length_6974_cov_16.058327	976	1056	11	29	80	0.3625000
NODE_74_length_6974_cov_16.058327	976	1056	12	31	80	0.3875000
NODE_74_length_6974_cov_16.058327	1029	1109	5	5	80	0.0625000
NODE_74_length_6974_cov_16.058327	1029	1109	7	3	80	0.0375000
NODE_74_length_6974_cov_16.058327	1029	1109	8	27	80	0.3375000
NODE_74_length_6974_cov_16.058327	1029	1109	9	3	80	0.0375000
NODE_74_length_6974_cov_16.058327	1029	1109	10	25	80	0.3125000
NODE_74_length_6974_cov_16.058327	1029	1109	11	15	80	0.1875000
NODE_74_length_6974_cov_16.058327	1029	1109	12	2	80	0.0250000
NODE_80_length_6826_cov_10.483574	4462	4542	0	10	80	0.1250000
NODE_80_length_6826_cov_10.483574	4462	4542	17	2	80	0.0250000
NODE_80_length_6826_cov_10.483574	4462	4542	18	1	80	0.0125000
NODE_80_length_6826_cov_10.483574	4462	4542	21	1	80	0.0125000
NODE_80_length_6826_cov_10.483574	4462	4542	23	1	80	0.0125000
NODE_80_length_6826_cov_10.483574	4462	4542	24	2	80	0.0250000
NODE_80_length_6826_cov_10.483574	4462	4542	28	2	80	0.0250000
NODE_80_length_6826_cov_10.483574	4462	4542	29	2	80	0.0250000
NODE_80_length_6826_cov_10.483574	4462	4542	30	4	80	0.0500000
NODE_80_length_6826_cov_10.483574	4462	4542	32	4	80	0.0500000
NODE_80_length_6826_cov_10.483574	4462	4542	33	4	80	0.0500000
NODE_80_length_6826_cov_10.483574	4462	4542	35	4	80	0.0500000
NODE_80_length_6826_cov_10.483574	4462	4542	37	4	80	0.0500000
NODE_80_length_6826_cov_10.483574	4462	4542	38	4	80	0.0500000
NODE_80_length_6826_cov_10.483574	4462	4542	41	6	80	0.0750000
NODE_80_length_6826_cov_10.483574	4462	4542	43	1	80	0.0125000
NODE_80_length_6826_cov_10.483574	4462	4542	44	1	80	0.0125000
NODE_80_length_6826_cov_10.483574	4462	4542	45	8	80	0.1000000
NODE_80_length_6826_cov_10.483574	4462	4542	47	1	80	0.0125000
NODE_80_length_6826_cov_10.483574	4462	4542	48	18	80	0.2250000
NODE_80_length_6826_cov_10.483574	4515	4595	45	8	80	0.1000000
NODE_80_length_6826_cov_10.483574	4515	4595	47	1	80	0.0125000
NODE_80_length_6826_cov_10.483574	4515	4595	48	20	80	0.2500000
NODE_80_length_6826_cov_10.483574	4515	4595	49	5	80	0.0625000
NODE_80_length_6826_cov_10.483574	4515	4595	51	1	80	0.0125000
NODE_80_length_6826_cov_10.483574	4515	4595	54	4	80	0.0500000
NODE_80_length_6826_cov_10.483574	4515	4595	56	3	80	0.0375000
NODE_80_length_6826_cov_10.483574	4515	4595	57	4	80	0.0500000
NODE_80_length_6826_cov_10.483574	4515	4595	58	1	80	0.0125000
NODE_80_length_6826_cov_10.483574	4515	4595	59	4	80	0.0500000
NODE_80_length_6826_cov_10.483574	4515	4595	60	9	80	0.1125000
NODE_80_length_6826_cov_10.483574	4515	4595	61	4	80	0.0500000
NODE_80_length_6826_cov_10.483574	4515	4595	62	11	80	0.1375000
NODE_80_length_6826_cov_10.483574	4515	4595	63	5	80	0.0625000
NODE_81_length_6816_cov_2.820753	6726	6801	0	75	75	1.0000000
NODE_81_length_6816_cov_2.820753	6774	6816	0	42	42	1.0000000
NODE_84_length_6744_cov_6.222272	5	85	1	80	80	1.0000000
NODE_84_length_6744_cov_6.222272	58	138	1	29	80	0.3625000
NODE_84_length_6744_cov_6.222272	58	138	3	10	80	0.1250000
NODE_84_length_6744_cov_6.222272	58	138	4	34	80	0.4250000
NODE_84_length_6744_cov_6.222272	58	138	5	7	80	0.0875000
NODE_84_length_6744_cov_6.222272	6650	6730	1	71	80	0.8875000
NODE_84_length_6744_cov_6.222272	6650	6730	3	9	80	0.1125000
NODE_84_length_6744_cov_6.222272	6703	6744	1	41	41	1.0000000
NODE_86_length_6733_cov_88.965029	3141	3221	3	52	80	0.6500000
NODE_86_length_6733_cov_88.965029	3141	3221	4	28	80	0.3500000
NODE_86_length_6733_cov_88.965029	3194	3274	1	12	80	0.1500000
NODE_86_length_6733_cov_88.965029	3194	3274	2	12	80	0.1500000
NODE_86_length_6733_cov_88.965029	3194	3274	4	56	80	0.7000000
NODE_86_length_6733_cov_88.965029	3270	3350	1	4	80	0.0500000
NODE_86_length_6733_cov_88.965029	3270	3350	2	62	80	0.7750000
NODE_86_length_6733_cov_88.965029	3270	3350	3	14	80	0.1750000
NODE_86_length_6733_cov_88.965029	3323	3403	2	66	80	0.8250000
NODE_86_length_6733_cov_88.965029	3323	3403	3	14	80	0.1750000
NODE_90_length_6627_cov_9.440564	350	430	0	19	80	0.2375000
NODE_90_length_6627_cov_9.440564	350	430	2	61	80	0.7625000
NODE_90_length_6627_cov_9.440564	403	483	2	80	80	1.0000000
NODE_95_length_6507_cov_95.786049	171	247	0	24	76	0.3157895
NODE_95_length_6507_cov_95.786049	171	247	1	16	76	0.2105263
NODE_95_length_6507_cov_95.786049	171	247	2	33	76	0.4342105
NODE_95_length_6507_cov_95.786049	171	247	4	2	76	0.0263158
NODE_95_length_6507_cov_95.786049	171	247	15	1	76	0.0131579
NODE_96_length_6497_cov_2.677399	366	436	2	21	70	0.3000000
NODE_96_length_6497_cov_2.677399	366	436	3	18	70	0.2571429
NODE_96_length_6497_cov_2.677399	366	436	4	31	70	0.4428571
NODE_96_length_6497_cov_2.677399	409	444	2	29	35	0.8285714
NODE_96_length_6497_cov_2.677399	409	444	3	6	35	0.1714286
NODE_97_length_6450_cov_26.108172	5024	5104	3	13	80	0.1625000
NODE_97_length_6450_cov_26.108172	5024	5104	5	13	80	0.1625000
NODE_97_length_6450_cov_26.108172	5024	5104	6	23	80	0.2875000
NODE_97_length_6450_cov_26.108172	5024	5104	7	1	80	0.0125000
NODE_97_length_6450_cov_26.108172	5024	5104	8	4	80	0.0500000
NODE_97_length_6450_cov_26.108172	5024	5104	9	26	80	0.3250000
NODE_109_length_6171_cov_36.061100	3743	3813	21	3	70	0.0428571
NODE_109_length_6171_cov_36.061100	3743	3813	23	3	70	0.0428571
NODE_109_length_6171_cov_36.061100	3743	3813	25	1	70	0.0142857
NODE_109_length_6171_cov_36.061100	3743	3813	27	1	70	0.0142857
NODE_109_length_6171_cov_36.061100	3743	3813	30	4	70	0.0571429
NODE_109_length_6171_cov_36.061100	3743	3813	31	3	70	0.0428571
NODE_109_length_6171_cov_36.061100	3743	3813	32	8	70	0.1142857
NODE_109_length_6171_cov_36.061100	3743	3813	34	2	70	0.0285714
NODE_109_length_6171_cov_36.061100	3743	3813	35	3	70	0.0428571
NODE_109_length_6171_cov_36.061100	3743	3813	45	1	70	0.0142857
NODE_109_length_6171_cov_36.061100	3743	3813	49	1	70	0.0142857
NODE_109_length_6171_cov_36.061100	3743	3813	52	2	70	0.0285714
NODE_109_length_6171_cov_36.061100	3743	3813	53	1	70	0.0142857
NODE_109_length_6171_cov_36.061100	3743	3813	54	3	70	0.0428571
NODE_109_length_6171_cov_36.061100	3743	3813	56	1	70	0.0142857
NODE_109_length_6171_cov_36.061100	3743	3813	57	1	70	0.0142857
NODE_109_length_6171_cov_36.061100	3743	3813	59	3	70	0.0428571
NODE_109_length_6171_cov_36.061100	3743	3813	60	3	70	0.0428571
NODE_109_length_6171_cov_36.061100	3743	3813	61	1	70	0.0142857
NODE_109_length_6171_cov_36.061100	3743	3813	62	1	70	0.0142857
NODE_109_length_6171_cov_36.061100	3743	3813	63	1	70	0.0142857
NODE_109_length_6171_cov_36.061100	3743	3813	65	3	70	0.0428571
NODE_109_length_6171_cov_36.061100	3743	3813	66	1	70	0.0142857
NODE_109_length_6171_cov_36.061100	3743	3813	68	4	70	0.0571429
NODE_109_length_6171_cov_36.061100	3743	3813	70	1	70	0.0142857
NODE_109_length_6171_cov_36.061100	3743	3813	71	1	70	0.0142857
NODE_109_length_6171_cov_36.061100	3743	3813	72	1	70	0.0142857
NODE_109_length_6171_cov_36.061100	3743	3813	73	1	70	0.0142857
NODE_109_length_6171_cov_36.061100	3743	3813	74	1	70	0.0142857
NODE_109_length_6171_cov_36.061100	3743	3813	76	1	70	0.0142857
NODE_109_length_6171_cov_36.061100	3743	3813	77	2	70	0.0285714
NODE_109_length_6171_cov_36.061100	3743	3813	78	4	70	0.0571429
NODE_109_length_6171_cov_36.061100	3743	3813	80	2	70	0.0285714
NODE_109_length_6171_cov_36.061100	3743	3813	84	1	70	0.0142857
NODE_109_length_6171_cov_36.061100	3798	3851	70	1	53	0.0188679
NODE_109_length_6171_cov_36.061100	3798	3851	71	1	53	0.0188679
NODE_109_length_6171_cov_36.061100	3798	3851	72	2	53	0.0377358
NODE_109_length_6171_cov_36.061100	3798	3851	73	1	53	0.0188679
NODE_109_length_6171_cov_36.061100	3798	3851	74	1	53	0.0188679
NODE_109_length_6171_cov_36.061100	3798	3851	75	3	53	0.0566038
NODE_109_length_6171_cov_36.061100	3798	3851	76	2	53	0.0377358
NODE_109_length_6171_cov_36.061100	3798	3851	77	2	53	0.0377358
NODE_109_length_6171_cov_36.061100	3798	3851	78	5	53	0.0943396
NODE_109_length_6171_cov_36.061100	3798	3851	79	1	53	0.0188679
NODE_109_length_6171_cov_36.061100	3798	3851	80	3	53	0.0566038
NODE_109_length_6171_cov_36.061100	3798	3851	81	2	53	0.0377358
NODE_109_length_6171_cov_36.061100	3798	3851	84	1	53	0.0188679
NODE_109_length_6171_cov_36.061100	3798	3851	85	1	53	0.0188679
NODE_109_length_6171_cov_36.061100	3798	3851	86	2	53	0.0377358
NODE_109_length_6171_cov_36.061100	3798	3851	88	1	53	0.0188679
NODE_109_length_6171_cov_36.061100	3798	3851	89	1	53	0.0188679
NODE_109_length_6171_cov_36.061100	3798	3851	91	7	53	0.1320755
NODE_109_length_6171_cov_36.061100	3798	3851	92	1	53	0.0188679
NODE_109_length_6171_cov_36.061100	3798	3851	93	3	53	0.0566038
NODE_109_length_6171_cov_36.061100	3798	3851	97	3	53	0.0566038
NODE_109_length_6171_cov_36.061100	3798	3851	98	6	53	0.1132075
NODE_109_length_6171_cov_36.061100	3798	3851	99	3	53	0.0566038
NODE_109_length_6171_cov_36.061100	4552	4596	538	1	44	0.0227273
NODE_109_length_6171_cov_36.061100	4552	4596	540	1	44	0.0227273
NODE_109_length_6171_cov_36.061100	4552	4596	541	1	44	0.0227273
NODE_109_length_6171_cov_36.061100	4552	4596	544	1	44	0.0227273
NODE_109_length_6171_cov_36.061100	4552	4596	545	1	44	0.0227273
NODE_109_length_6171_cov_36.061100	4552	4596	549	2	44	0.0454545
NODE_109_length_6171_cov_36.061100	4552	4596	551	1	44	0.0227273
NODE_109_length_6171_cov_36.061100	4552	4596	553	2	44	0.0454545
NODE_109_length_6171_cov_36.061100	4552	4596	556	2	44	0.0454545
NODE_109_length_6171_cov_36.061100	4552	4596	557	3	44	0.0681818
NODE_109_length_6171_cov_36.061100	4552	4596	558	1	44	0.0227273
NODE_109_length_6171_cov_36.061100	4552	4596	559	2	44	0.0454545
NODE_109_length_6171_cov_36.061100	4552	4596	561	1	44	0.0227273
NODE_109_length_6171_cov_36.061100	4552	4596	562	1	44	0.0227273
NODE_109_length_6171_cov_36.061100	4552	4596	563	3	44	0.0681818
NODE_109_length_6171_cov_36.061100	4552	4596	565	1	44	0.0227273
NODE_109_length_6171_cov_36.061100	4552	4596	567	2	44	0.0454545
NODE_109_length_6171_cov_36.061100	4552	4596	568	1	44	0.0227273
NODE_109_length_6171_cov_36.061100	4552	4596	569	1	44	0.0227273
NODE_109_length_6171_cov_36.061100	4552	4596	570	2	44	0.0454545
NODE_109_length_6171_cov_36.061100	4552	4596	572	5	44	0.1136364
NODE_109_length_6171_cov_36.061100	4552	4596	574	1	44	0.0227273
NODE_109_length_6171_cov_36.061100	4552	4596	575	1	44	0.0227273
NODE_109_length_6171_cov_36.061100	4552	4596	577	1	44	0.0227273
NODE_109_length_6171_cov_36.061100	4552	4596	579	1	44	0.0227273
NODE_109_length_6171_cov_36.061100	4552	4596	581	1	44	0.0227273
NODE_109_length_6171_cov_36.061100	4552	4596	582	1	44	0.0227273
NODE_109_length_6171_cov_36.061100	4552	4596	590	1	44	0.0227273
NODE_109_length_6171_cov_36.061100	4552	4596	592	1	44	0.0227273
NODE_109_length_6171_cov_36.061100	4552	4596	593	1	44	0.0227273
NODE_109_length_6171_cov_36.061100	4569	4649	417	2	80	0.0250000
NODE_109_length_6171_cov_36.061100	4569	4649	418	1	80	0.0125000
NODE_109_length_6171_cov_36.061100	4569	4649	420	1	80	0.0125000
NODE_109_length_6171_cov_36.061100	4569	4649	427	1	80	0.0125000
NODE_109_length_6171_cov_36.061100	4569	4649	430	1	80	0.0125000
NODE_109_length_6171_cov_36.061100	4569	4649	432	1	80	0.0125000
NODE_109_length_6171_cov_36.061100	4569	4649	436	2	80	0.0250000
NODE_109_length_6171_cov_36.061100	4569	4649	440	1	80	0.0125000
NODE_109_length_6171_cov_36.061100	4569	4649	443	1	80	0.0125000
NODE_109_length_6171_cov_36.061100	4569	4649	444	2	80	0.0250000
NODE_109_length_6171_cov_36.061100	4569	4649	445	1	80	0.0125000
NODE_109_length_6171_cov_36.061100	4569	4649	451	1	80	0.0125000
NODE_109_length_6171_cov_36.061100	4569	4649	454	2	80	0.0250000
NODE_109_length_6171_cov_36.061100	4569	4649	455	1	80	0.0125000
NODE_109_length_6171_cov_36.061100	4569	4649	457	2	80	0.0250000
NODE_109_length_6171_cov_36.061100	4569	4649	459	1	80	0.0125000
NODE_109_length_6171_cov_36.061100	4569	4649	462	2	80	0.0250000
NODE_109_length_6171_cov_36.061100	4569	4649	466	1	80	0.0125000
NODE_109_length_6171_cov_36.061100	4569	4649	468	1	80	0.0125000
NODE_109_length_6171_cov_36.061100	4569	4649	469	1	80	0.0125000
NODE_109_length_6171_cov_36.061100	4569	4649	470	1	80	0.0125000
NODE_109_length_6171_cov_36.061100	4569	4649	471	1	80	0.0125000
NODE_109_length_6171_cov_36.061100	4569	4649	472	1	80	0.0125000
NODE_109_length_6171_cov_36.061100	4569	4649	476	1	80	0.0125000
NODE_109_length_6171_cov_36.061100	4569	4649	480	3	80	0.0375000
NODE_109_length_6171_cov_36.061100	4569	4649	481	1	80	0.0125000
NODE_109_length_6171_cov_36.061100	4569	4649	482	1	80	0.0125000
NODE_109_length_6171_cov_36.061100	4569	4649	484	1	80	0.0125000
NODE_109_length_6171_cov_36.061100	4569	4649	487	1	80	0.0125000
NODE_109_length_6171_cov_36.061100	4569	4649	489	1	80	0.0125000
NODE_109_length_6171_cov_36.061100	4569	4649	491	1	80	0.0125000
NODE_109_length_6171_cov_36.061100	4569	4649	495	1	80	0.0125000
NODE_109_length_6171_cov_36.061100	4569	4649	501	1	80	0.0125000
NODE_109_length_6171_cov_36.061100	4569	4649	502	1	80	0.0125000
NODE_109_length_6171_cov_36.061100	4569	4649	503	1	80	0.0125000
NODE_109_length_6171_cov_36.061100	4569	4649	508	1	80	0.0125000
NODE_109_length_6171_cov_36.061100	4569	4649	517	1	80	0.0125000
NODE_109_length_6171_cov_36.061100	4569	4649	519	1	80	0.0125000
NODE_109_length_6171_cov_36.061100	4569	4649	520	1	80	0.0125000
NODE_109_length_6171_cov_36.061100	4569	4649	522	1	80	0.0125000
NODE_109_length_6171_cov_36.061100	4569	4649	523	1	80	0.0125000
NODE_109_length_6171_cov_36.061100	4569	4649	524	1	80	0.0125000
NODE_109_length_6171_cov_36.061100	4569	4649	526	1	80	0.0125000
NODE_109_length_6171_cov_36.061100	4569	4649	528	1	80	0.0125000
NODE_109_length_6171_cov_36.061100	4569	4649	537	1	80	0.0125000
NODE_109_length_6171_cov_36.061100	4569	4649	538	1	80	0.0125000
NODE_109_length_6171_cov_36.061100	4569	4649	540	1	80	0.0125000
NODE_109_length_6171_cov_36.061100	4569	4649	541	1	80	0.0125000
NODE_109_length_6171_cov_36.061100	4569	4649	544	1	80	0.0125000
NODE_109_length_6171_cov_36.061100	4569	4649	545	1	80	0.0125000
NODE_109_length_6171_cov_36.061100	4569	4649	549	2	80	0.0250000
NODE_109_length_6171_cov_36.061100	4569	4649	551	1	80	0.0125000
NODE_109_length_6171_cov_36.061100	4569	4649	553	2	80	0.0250000
NODE_109_length_6171_cov_36.061100	4569	4649	556	2	80	0.0250000
NODE_109_length_6171_cov_36.061100	4569	4649	557	3	80	0.0375000
NODE_109_length_6171_cov_36.061100	4569	4649	558	1	80	0.0125000
NODE_109_length_6171_cov_36.061100	4569	4649	559	2	80	0.0250000
NODE_109_length_6171_cov_36.061100	4569	4649	561	1	80	0.0125000
NODE_109_length_6171_cov_36.061100	4569	4649	562	1	80	0.0125000
NODE_109_length_6171_cov_36.061100	4569	4649	563	3	80	0.0375000
NODE_109_length_6171_cov_36.061100	4569	4649	567	1	80	0.0125000
NODE_109_length_6171_cov_36.061100	4569	4649	568	1	80	0.0125000
NODE_109_length_6171_cov_36.061100	4569	4649	570	1	80	0.0125000
NODE_109_length_6171_cov_36.061100	4569	4649	572	1	80	0.0125000
NODE_109_length_6171_cov_36.061100	5742	5788	2	43	46	0.9347826
NODE_109_length_6171_cov_36.061100	5742	5788	3	3	46	0.0652174
NODE_109_length_6171_cov_36.061100	5761	5841	2	24	80	0.3000000
NODE_109_length_6171_cov_36.061100	5761	5841	3	20	80	0.2500000
NODE_109_length_6171_cov_36.061100	5761	5841	4	36	80	0.4500000
NODE_110_length_6148_cov_58.915358	5602	5682	5	4	80	0.0500000
NODE_110_length_6148_cov_58.915358	5602	5682	6	39	80	0.4875000
NODE_110_length_6148_cov_58.915358	5602	5682	7	29	80	0.3625000
NODE_110_length_6148_cov_58.915358	5602	5682	8	8	80	0.1000000
NODE_110_length_6148_cov_58.915358	5655	5735	6	71	80	0.8875000
NODE_110_length_6148_cov_58.915358	5655	5735	7	9	80	0.1125000
NODE_112_length_6026_cov_17.775772	4124	4204	2	20	80	0.2500000
NODE_112_length_6026_cov_17.775772	4124	4204	3	17	80	0.2125000
NODE_112_length_6026_cov_17.775772	4124	4204	4	31	80	0.3875000
NODE_112_length_6026_cov_17.775772	4124	4204	5	12	80	0.1500000
NODE_112_length_6026_cov_17.775772	4177	4257	2	55	80	0.6875000
NODE_112_length_6026_cov_17.775772	4177	4257	3	25	80	0.3125000
NODE_112_length_6026_cov_17.775772	4253	4333	2	2	80	0.0250000
NODE_112_length_6026_cov_17.775772	4253	4333	3	31	80	0.3875000
NODE_112_length_6026_cov_17.775772	4253	4333	5	1	80	0.0125000
NODE_112_length_6026_cov_17.775772	4253	4333	7	20	80	0.2500000
NODE_112_length_6026_cov_17.775772	4253	4333	8	2	80	0.0250000
NODE_112_length_6026_cov_17.775772	4253	4333	9	12	80	0.1500000
NODE_112_length_6026_cov_17.775772	4253	4333	10	7	80	0.0875000
NODE_112_length_6026_cov_17.775772	4253	4333	11	5	80	0.0625000
NODE_112_length_6026_cov_17.775772	4306	4386	7	1	80	0.0125000
NODE_112_length_6026_cov_17.775772	4306	4386	8	2	80	0.0250000
NODE_112_length_6026_cov_17.775772	4306	4386	9	12	80	0.1500000
NODE_112_length_6026_cov_17.775772	4306	4386	10	7	80	0.0875000
NODE_112_length_6026_cov_17.775772	4306	4386	11	8	80	0.1000000
NODE_112_length_6026_cov_17.775772	4306	4386	12	8	80	0.1000000
NODE_112_length_6026_cov_17.775772	4306	4386	14	17	80	0.2125000
NODE_112_length_6026_cov_17.775772	4306	4386	15	1	80	0.0125000
NODE_112_length_6026_cov_17.775772	4306	4386	16	24	80	0.3000000
NODE_124_length_5810_cov_24.750657	2064	2144	17	2	80	0.0250000
NODE_124_length_5810_cov_24.750657	2064	2144	19	3	80	0.0375000
NODE_124_length_5810_cov_24.750657	2064	2144	20	6	80	0.0750000
NODE_124_length_5810_cov_24.750657	2064	2144	24	1	80	0.0125000
NODE_124_length_5810_cov_24.750657	2064	2144	26	1	80	0.0125000
NODE_124_length_5810_cov_24.750657	2064	2144	28	3	80	0.0375000
NODE_124_length_5810_cov_24.750657	2064	2144	29	1	80	0.0125000
NODE_124_length_5810_cov_24.750657	2064	2144	30	1	80	0.0125000
NODE_124_length_5810_cov_24.750657	2064	2144	32	2	80	0.0250000
NODE_124_length_5810_cov_24.750657	2064	2144	34	2	80	0.0250000
NODE_124_length_5810_cov_24.750657	2064	2144	35	3	80	0.0375000
NODE_124_length_5810_cov_24.750657	2064	2144	36	2	80	0.0250000
NODE_124_length_5810_cov_24.750657	2064	2144	37	5	80	0.0625000
NODE_124_length_5810_cov_24.750657	2064	2144	38	2	80	0.0250000
NODE_124_length_5810_cov_24.750657	2064	2144	39	2	80	0.0250000
NODE_124_length_5810_cov_24.750657	2064	2144	40	1	80	0.0125000
NODE_124_length_5810_cov_24.750657	2064	2144	41	1	80	0.0125000
NODE_124_length_5810_cov_24.750657	2064	2144	42	1	80	0.0125000
NODE_124_length_5810_cov_24.750657	2064	2144	46	2	80	0.0250000
NODE_124_length_5810_cov_24.750657	2064	2144	47	1	80	0.0125000
NODE_124_length_5810_cov_24.750657	2064	2144	48	1	80	0.0125000
NODE_124_length_5810_cov_24.750657	2064	2144	50	1	80	0.0125000
NODE_124_length_5810_cov_24.750657	2064	2144	52	1	80	0.0125000
NODE_124_length_5810_cov_24.750657	2064	2144	55	2	80	0.0250000
NODE_124_length_5810_cov_24.750657	2064	2144	56	1	80	0.0125000
NODE_124_length_5810_cov_24.750657	2064	2144	58	9	80	0.1125000
NODE_124_length_5810_cov_24.750657	2064	2144	60	3	80	0.0375000
NODE_124_length_5810_cov_24.750657	2064	2144	65	1	80	0.0125000
NODE_124_length_5810_cov_24.750657	2064	2144	68	5	80	0.0625000
NODE_124_length_5810_cov_24.750657	2064	2144	71	1	80	0.0125000
NODE_124_length_5810_cov_24.750657	2064	2144	72	2	80	0.0250000
NODE_124_length_5810_cov_24.750657	2064	2144	74	3	80	0.0375000
NODE_124_length_5810_cov_24.750657	2064	2144	76	2	80	0.0250000
NODE_124_length_5810_cov_24.750657	2064	2144	77	2	80	0.0250000
NODE_124_length_5810_cov_24.750657	2064	2144	78	2	80	0.0250000
NODE_124_length_5810_cov_24.750657	2064	2144	81	2	80	0.0250000
NODE_124_length_5810_cov_24.750657	2117	2194	4	9	77	0.1168831
NODE_124_length_5810_cov_24.750657	2117	2194	5	10	77	0.1298701
NODE_124_length_5810_cov_24.750657	2117	2194	6	4	77	0.0519481
NODE_124_length_5810_cov_24.750657	2117	2194	7	2	77	0.0259740
NODE_124_length_5810_cov_24.750657	2117	2194	9	11	77	0.1428571
NODE_124_length_5810_cov_24.750657	2117	2194	13	3	77	0.0389610
NODE_124_length_5810_cov_24.750657	2117	2194	14	8	77	0.1038961
NODE_124_length_5810_cov_24.750657	2117	2194	16	1	77	0.0129870
NODE_124_length_5810_cov_24.750657	2117	2194	17	4	77	0.0519481
NODE_124_length_5810_cov_24.750657	2117	2194	19	3	77	0.0389610
NODE_124_length_5810_cov_24.750657	2117	2194	20	6	77	0.0779221
NODE_124_length_5810_cov_24.750657	2117	2194	24	1	77	0.0129870
NODE_124_length_5810_cov_24.750657	2117	2194	26	1	77	0.0129870
NODE_124_length_5810_cov_24.750657	2117	2194	28	3	77	0.0389610
NODE_124_length_5810_cov_24.750657	2117	2194	29	1	77	0.0129870
NODE_124_length_5810_cov_24.750657	2117	2194	30	1	77	0.0129870
NODE_124_length_5810_cov_24.750657	2117	2194	32	2	77	0.0259740
NODE_124_length_5810_cov_24.750657	2117	2194	34	2	77	0.0259740
NODE_124_length_5810_cov_24.750657	2117	2194	35	3	77	0.0389610
NODE_124_length_5810_cov_24.750657	2117	2194	36	2	77	0.0259740
NODE_127_length_5771_cov_10.854549	2814	2883	8	13	69	0.1884058
NODE_127_length_5771_cov_10.854549	2814	2883	9	13	69	0.1884058
NODE_127_length_5771_cov_10.854549	2814	2883	10	5	69	0.0724638
NODE_127_length_5771_cov_10.854549	2814	2883	11	21	69	0.3043478
NODE_127_length_5771_cov_10.854549	2814	2883	12	17	69	0.2463768
NODE_128_length_5769_cov_6.878483	5701	5731	0	29	30	0.9666666
NODE_128_length_5769_cov_6.878483	5701	5731	3	1	30	0.0333333
NODE_133_length_5728_cov_16.351039	63	134	1	11	71	0.1549296
NODE_133_length_5728_cov_16.351039	63	134	3	10	71	0.1408451
NODE_133_length_5728_cov_16.351039	63	134	4	50	71	0.7042254
NODE_133_length_5728_cov_16.351039	2960	3040	2	1	80	0.0125000
NODE_133_length_5728_cov_16.351039	2960	3040	4	1	80	0.0125000
NODE_133_length_5728_cov_16.351039	2960	3040	5	1	80	0.0125000
NODE_133_length_5728_cov_16.351039	2960	3040	6	4	80	0.0500000
NODE_133_length_5728_cov_16.351039	2960	3040	8	2	80	0.0250000
NODE_133_length_5728_cov_16.351039	2960	3040	9	8	80	0.1000000
NODE_133_length_5728_cov_16.351039	2960	3040	10	4	80	0.0500000
NODE_133_length_5728_cov_16.351039	2960	3040	11	4	80	0.0500000
NODE_133_length_5728_cov_16.351039	2960	3040	12	5	80	0.0625000
NODE_133_length_5728_cov_16.351039	2960	3040	13	2	80	0.0250000
NODE_133_length_5728_cov_16.351039	2960	3040	14	6	80	0.0750000
NODE_133_length_5728_cov_16.351039	2960	3040	16	7	80	0.0875000
NODE_133_length_5728_cov_16.351039	2960	3040	17	2	80	0.0250000
NODE_133_length_5728_cov_16.351039	2960	3040	18	15	80	0.1875000
NODE_133_length_5728_cov_16.351039	2960	3040	19	3	80	0.0375000
NODE_133_length_5728_cov_16.351039	2960	3040	20	1	80	0.0125000
NODE_133_length_5728_cov_16.351039	2960	3040	21	5	80	0.0625000
NODE_133_length_5728_cov_16.351039	2960	3040	22	2	80	0.0250000
NODE_133_length_5728_cov_16.351039	2960	3040	23	7	80	0.0875000
NODE_133_length_5728_cov_16.351039	5106	5172	97	6	66	0.0909091
NODE_133_length_5728_cov_16.351039	5106	5172	98	5	66	0.0757576
NODE_133_length_5728_cov_16.351039	5106	5172	99	13	66	0.1969697
NODE_133_length_5728_cov_16.351039	5106	5172	100	8	66	0.1212121
NODE_133_length_5728_cov_16.351039	5106	5172	101	10	66	0.1515152
NODE_133_length_5728_cov_16.351039	5106	5172	102	9	66	0.1363636
NODE_133_length_5728_cov_16.351039	5106	5172	103	8	66	0.1212121
NODE_133_length_5728_cov_16.351039	5106	5172	105	3	66	0.0454545
NODE_133_length_5728_cov_16.351039	5106	5172	106	4	66	0.0606061
NODE_133_length_5728_cov_16.351039	5145	5225	88	1	80	0.0125000
NODE_133_length_5728_cov_16.351039	5145	5225	90	3	80	0.0375000
NODE_133_length_5728_cov_16.351039	5145	5225	91	5	80	0.0625000
NODE_133_length_5728_cov_16.351039	5145	5225	92	1	80	0.0125000
NODE_133_length_5728_cov_16.351039	5145	5225	93	3	80	0.0375000
NODE_133_length_5728_cov_16.351039	5145	5225	94	3	80	0.0375000
NODE_133_length_5728_cov_16.351039	5145	5225	96	1	80	0.0125000
NODE_133_length_5728_cov_16.351039	5145	5225	97	7	80	0.0875000
NODE_133_length_5728_cov_16.351039	5145	5225	98	11	80	0.1375000
NODE_133_length_5728_cov_16.351039	5145	5225	99	12	80	0.1500000
NODE_133_length_5728_cov_16.351039	5145	5225	100	12	80	0.1500000
NODE_133_length_5728_cov_16.351039	5145	5225	101	8	80	0.1000000
NODE_133_length_5728_cov_16.351039	5145	5225	102	10	80	0.1250000
NODE_133_length_5728_cov_16.351039	5145	5225	103	3	80	0.0375000
NODE_137_length_5696_cov_20.656244	179	258	3	12	79	0.1518987
NODE_137_length_5696_cov_20.656244	179	258	4	49	79	0.6202531
NODE_137_length_5696_cov_20.656244	179	258	5	18	79	0.2278481
NODE_137_length_5696_cov_20.656244	231	311	2	51	80	0.6375000
NODE_137_length_5696_cov_20.656244	231	311	3	14	80	0.1750000
NODE_137_length_5696_cov_20.656244	231	311	4	15	80	0.1875000
NODE_137_length_5696_cov_20.656244	307	387	1	52	80	0.6500000
NODE_137_length_5696_cov_20.656244	307	387	2	22	80	0.2750000
NODE_137_length_5696_cov_20.656244	307	387	3	6	80	0.0750000
NODE_137_length_5696_cov_20.656244	360	440	1	15	80	0.1875000
NODE_137_length_5696_cov_20.656244	360	440	2	65	80	0.8125000
NODE_137_length_5696_cov_20.656244	5100	5180	0	80	80	1.0000000
NODE_137_length_5696_cov_20.656244	5153	5233	0	80	80	1.0000000
NODE_137_length_5696_cov_20.656244	5280	5360	0	80	80	1.0000000
NODE_137_length_5696_cov_20.656244	5333	5413	0	58	80	0.7250000
NODE_137_length_5696_cov_20.656244	5333	5413	2	22	80	0.2750000
NODE_139_length_5681_cov_68.065030	253	333	2	15	80	0.1875000
NODE_139_length_5681_cov_68.065030	253	333	3	25	80	0.3125000
NODE_139_length_5681_cov_68.065030	253	333	4	40	80	0.5000000
NODE_139_length_5681_cov_68.065030	306	386	2	1	80	0.0125000
NODE_139_length_5681_cov_68.065030	306	386	3	77	80	0.9625000
NODE_139_length_5681_cov_68.065030	306	386	4	2	80	0.0250000
NODE_139_length_5681_cov_68.065030	4762	4842	37	2	80	0.0250000
NODE_139_length_5681_cov_68.065030	4762	4842	38	3	80	0.0375000
NODE_139_length_5681_cov_68.065030	4762	4842	39	1	80	0.0125000
NODE_139_length_5681_cov_68.065030	4762	4842	41	1	80	0.0125000
NODE_139_length_5681_cov_68.065030	4762	4842	43	1	80	0.0125000
NODE_139_length_5681_cov_68.065030	4762	4842	46	2	80	0.0250000
NODE_139_length_5681_cov_68.065030	4762	4842	47	5	80	0.0625000
NODE_139_length_5681_cov_68.065030	4762	4842	49	2	80	0.0250000
NODE_139_length_5681_cov_68.065030	4762	4842	51	2	80	0.0250000
NODE_139_length_5681_cov_68.065030	4762	4842	52	4	80	0.0500000
NODE_139_length_5681_cov_68.065030	4762	4842	53	1	80	0.0125000
NODE_139_length_5681_cov_68.065030	4762	4842	55	6	80	0.0750000
NODE_139_length_5681_cov_68.065030	4762	4842	56	1	80	0.0125000
NODE_139_length_5681_cov_68.065030	4762	4842	57	1	80	0.0125000
NODE_139_length_5681_cov_68.065030	4762	4842	58	1	80	0.0125000
NODE_139_length_5681_cov_68.065030	4762	4842	59	4	80	0.0500000
NODE_139_length_5681_cov_68.065030	4762	4842	60	1	80	0.0125000
NODE_139_length_5681_cov_68.065030	4762	4842	61	3	80	0.0375000
NODE_139_length_5681_cov_68.065030	4762	4842	62	1	80	0.0125000
NODE_139_length_5681_cov_68.065030	4762	4842	63	2	80	0.0250000
NODE_139_length_5681_cov_68.065030	4762	4842	64	3	80	0.0375000
NODE_139_length_5681_cov_68.065030	4762	4842	66	1	80	0.0125000
NODE_139_length_5681_cov_68.065030	4762	4842	67	2	80	0.0250000
NODE_139_length_5681_cov_68.065030	4762	4842	68	2	80	0.0250000
NODE_139_length_5681_cov_68.065030	4762	4842	69	10	80	0.1250000
NODE_139_length_5681_cov_68.065030	4762	4842	70	5	80	0.0625000
NODE_139_length_5681_cov_68.065030	4762	4842	71	10	80	0.1250000
NODE_139_length_5681_cov_68.065030	4762	4842	72	3	80	0.0375000
NODE_139_length_5681_cov_68.065030	4762	4842	37	2	80	0.0250000
NODE_139_length_5681_cov_68.065030	4762	4842	38	3	80	0.0375000
NODE_139_length_5681_cov_68.065030	4762	4842	39	1	80	0.0125000
NODE_139_length_5681_cov_68.065030	4762	4842	41	1	80	0.0125000
NODE_139_length_5681_cov_68.065030	4762	4842	43	1	80	0.0125000
NODE_139_length_5681_cov_68.065030	4762	4842	46	2	80	0.0250000
NODE_139_length_5681_cov_68.065030	4762	4842	47	5	80	0.0625000
NODE_139_length_5681_cov_68.065030	4762	4842	49	2	80	0.0250000
NODE_139_length_5681_cov_68.065030	4762	4842	51	2	80	0.0250000
NODE_139_length_5681_cov_68.065030	4762	4842	52	4	80	0.0500000
NODE_139_length_5681_cov_68.065030	4762	4842	53	1	80	0.0125000
NODE_139_length_5681_cov_68.065030	4762	4842	55	6	80	0.0750000
NODE_139_length_5681_cov_68.065030	4762	4842	56	1	80	0.0125000
NODE_139_length_5681_cov_68.065030	4762	4842	57	1	80	0.0125000
NODE_139_length_5681_cov_68.065030	4762	4842	58	1	80	0.0125000
NODE_139_length_5681_cov_68.065030	4762	4842	59	4	80	0.0500000
NODE_139_length_5681_cov_68.065030	4762	4842	60	1	80	0.0125000
NODE_139_length_5681_cov_68.065030	4762	4842	61	3	80	0.0375000
NODE_139_length_5681_cov_68.065030	4762	4842	62	1	80	0.0125000
NODE_139_length_5681_cov_68.065030	4762	4842	63	2	80	0.0250000
NODE_139_length_5681_cov_68.065030	4762	4842	64	3	80	0.0375000
NODE_139_length_5681_cov_68.065030	4762	4842	66	1	80	0.0125000
NODE_139_length_5681_cov_68.065030	4762	4842	67	2	80	0.0250000
NODE_139_length_5681_cov_68.065030	4762	4842	68	2	80	0.0250000
NODE_139_length_5681_cov_68.065030	4762	4842	69	10	80	0.1250000
NODE_139_length_5681_cov_68.065030	4762	4842	70	5	80	0.0625000
NODE_139_length_5681_cov_68.065030	4762	4842	71	10	80	0.1250000
NODE_139_length_5681_cov_68.065030	4762	4842	72	3	80	0.0375000
NODE_139_length_5681_cov_68.065030	4762	4842	37	2	80	0.0250000
NODE_139_length_5681_cov_68.065030	4762	4842	38	3	80	0.0375000
NODE_139_length_5681_cov_68.065030	4762	4842	39	1	80	0.0125000
NODE_139_length_5681_cov_68.065030	4762	4842	41	1	80	0.0125000
NODE_139_length_5681_cov_68.065030	4762	4842	43	1	80	0.0125000
NODE_139_length_5681_cov_68.065030	4762	4842	46	2	80	0.0250000
NODE_139_length_5681_cov_68.065030	4762	4842	47	5	80	0.0625000
NODE_139_length_5681_cov_68.065030	4762	4842	49	2	80	0.0250000
NODE_139_length_5681_cov_68.065030	4762	4842	51	2	80	0.0250000
NODE_139_length_5681_cov_68.065030	4762	4842	52	4	80	0.0500000
NODE_139_length_5681_cov_68.065030	4762	4842	53	1	80	0.0125000
NODE_139_length_5681_cov_68.065030	4762	4842	55	6	80	0.0750000
NODE_139_length_5681_cov_68.065030	4762	4842	56	1	80	0.0125000
NODE_139_length_5681_cov_68.065030	4762	4842	57	1	80	0.0125000
NODE_139_length_5681_cov_68.065030	4762	4842	58	1	80	0.0125000
NODE_139_length_5681_cov_68.065030	4762	4842	59	4	80	0.0500000
NODE_139_length_5681_cov_68.065030	4762	4842	60	1	80	0.0125000
NODE_139_length_5681_cov_68.065030	4762	4842	61	3	80	0.0375000
NODE_139_length_5681_cov_68.065030	4762	4842	62	1	80	0.0125000
NODE_139_length_5681_cov_68.065030	4762	4842	63	2	80	0.0250000
NODE_139_length_5681_cov_68.065030	4762	4842	64	3	80	0.0375000
NODE_139_length_5681_cov_68.065030	4762	4842	66	1	80	0.0125000
NODE_139_length_5681_cov_68.065030	4762	4842	67	2	80	0.0250000
NODE_139_length_5681_cov_68.065030	4762	4842	68	2	80	0.0250000
NODE_139_length_5681_cov_68.065030	4762	4842	69	10	80	0.1250000
NODE_139_length_5681_cov_68.065030	4762	4842	70	5	80	0.0625000
NODE_139_length_5681_cov_68.065030	4762	4842	71	10	80	0.1250000
NODE_139_length_5681_cov_68.065030	4762	4842	72	3	80	0.0375000
NODE_139_length_5681_cov_68.065030	4762	4842	37	2	80	0.0250000
NODE_139_length_5681_cov_68.065030	4762	4842	38	3	80	0.0375000
NODE_139_length_5681_cov_68.065030	4762	4842	39	1	80	0.0125000
NODE_139_length_5681_cov_68.065030	4762	4842	41	1	80	0.0125000
NODE_139_length_5681_cov_68.065030	4762	4842	43	1	80	0.0125000
NODE_139_length_5681_cov_68.065030	4762	4842	46	2	80	0.0250000
NODE_139_length_5681_cov_68.065030	4762	4842	47	5	80	0.0625000
NODE_139_length_5681_cov_68.065030	4762	4842	49	2	80	0.0250000
NODE_139_length_5681_cov_68.065030	4762	4842	51	2	80	0.0250000
NODE_139_length_5681_cov_68.065030	4762	4842	52	4	80	0.0500000
NODE_139_length_5681_cov_68.065030	4762	4842	53	1	80	0.0125000
NODE_139_length_5681_cov_68.065030	4762	4842	55	6	80	0.0750000
NODE_139_length_5681_cov_68.065030	4762	4842	56	1	80	0.0125000
NODE_139_length_5681_cov_68.065030	4762	4842	57	1	80	0.0125000
NODE_139_length_5681_cov_68.065030	4762	4842	58	1	80	0.0125000
NODE_139_length_5681_cov_68.065030	4762	4842	59	4	80	0.0500000
NODE_139_length_5681_cov_68.065030	4762	4842	60	1	80	0.0125000
NODE_139_length_5681_cov_68.065030	4762	4842	61	3	80	0.0375000
NODE_139_length_5681_cov_68.065030	4762	4842	62	1	80	0.0125000
NODE_139_length_5681_cov_68.065030	4762	4842	63	2	80	0.0250000
NODE_139_length_5681_cov_68.065030	4762	4842	64	3	80	0.0375000
NODE_139_length_5681_cov_68.065030	4762	4842	66	1	80	0.0125000
NODE_139_length_5681_cov_68.065030	4762	4842	67	2	80	0.0250000
NODE_139_length_5681_cov_68.065030	4762	4842	68	2	80	0.0250000
NODE_139_length_5681_cov_68.065030	4762	4842	69	10	80	0.1250000
NODE_139_length_5681_cov_68.065030	4762	4842	70	5	80	0.0625000
NODE_139_length_5681_cov_68.065030	4762	4842	71	10	80	0.1250000
NODE_139_length_5681_cov_68.065030	4762	4842	72	3	80	0.0375000
NODE_139_length_5681_cov_68.065030	4762	4842	37	2	80	0.0250000
NODE_139_length_5681_cov_68.065030	4762	4842	38	3	80	0.0375000
NODE_139_length_5681_cov_68.065030	4762	4842	39	1	80	0.0125000
NODE_139_length_5681_cov_68.065030	4762	4842	41	1	80	0.0125000
NODE_139_length_5681_cov_68.065030	4762	4842	43	1	80	0.0125000
NODE_139_length_5681_cov_68.065030	4762	4842	46	2	80	0.0250000
NODE_139_length_5681_cov_68.065030	4762	4842	47	5	80	0.0625000
NODE_139_length_5681_cov_68.065030	4762	4842	49	2	80	0.0250000
NODE_139_length_5681_cov_68.065030	4762	4842	51	2	80	0.0250000
NODE_139_length_5681_cov_68.065030	4762	4842	52	4	80	0.0500000
NODE_139_length_5681_cov_68.065030	4762	4842	53	1	80	0.0125000
NODE_139_length_5681_cov_68.065030	4762	4842	55	6	80	0.0750000
NODE_139_length_5681_cov_68.065030	4762	4842	56	1	80	0.0125000
NODE_139_length_5681_cov_68.065030	4762	4842	57	1	80	0.0125000
NODE_139_length_5681_cov_68.065030	4762	4842	58	1	80	0.0125000
NODE_139_length_5681_cov_68.065030	4762	4842	59	4	80	0.0500000
NODE_139_length_5681_cov_68.065030	4762	4842	60	1	80	0.0125000
NODE_139_length_5681_cov_68.065030	4762	4842	61	3	80	0.0375000
NODE_139_length_5681_cov_68.065030	4762	4842	62	1	80	0.0125000
NODE_139_length_5681_cov_68.065030	4762	4842	63	2	80	0.0250000
NODE_139_length_5681_cov_68.065030	4762	4842	64	3	80	0.0375000
NODE_139_length_5681_cov_68.065030	4762	4842	66	1	80	0.0125000
NODE_139_length_5681_cov_68.065030	4762	4842	67	2	80	0.0250000
NODE_139_length_5681_cov_68.065030	4762	4842	68	2	80	0.0250000
NODE_139_length_5681_cov_68.065030	4762	4842	69	10	80	0.1250000
NODE_139_length_5681_cov_68.065030	4762	4842	70	5	80	0.0625000
NODE_139_length_5681_cov_68.065030	4762	4842	71	10	80	0.1250000
NODE_139_length_5681_cov_68.065030	4762	4842	72	3	80	0.0375000
NODE_139_length_5681_cov_68.065030	4762	4842	37	2	80	0.0250000
NODE_139_length_5681_cov_68.065030	4762	4842	38	3	80	0.0375000
NODE_139_length_5681_cov_68.065030	4762	4842	39	1	80	0.0125000
NODE_139_length_5681_cov_68.065030	4762	4842	41	1	80	0.0125000
NODE_139_length_5681_cov_68.065030	4762	4842	43	1	80	0.0125000
NODE_139_length_5681_cov_68.065030	4762	4842	46	2	80	0.0250000
NODE_139_length_5681_cov_68.065030	4762	4842	47	5	80	0.0625000
NODE_139_length_5681_cov_68.065030	4762	4842	49	2	80	0.0250000
NODE_139_length_5681_cov_68.065030	4762	4842	51	2	80	0.0250000
NODE_139_length_5681_cov_68.065030	4762	4842	52	4	80	0.0500000
NODE_139_length_5681_cov_68.065030	4762	4842	53	1	80	0.0125000
NODE_139_length_5681_cov_68.065030	4762	4842	55	6	80	0.0750000
NODE_139_length_5681_cov_68.065030	4762	4842	56	1	80	0.0125000
NODE_139_length_5681_cov_68.065030	4762	4842	57	1	80	0.0125000
NODE_139_length_5681_cov_68.065030	4762	4842	58	1	80	0.0125000
NODE_139_length_5681_cov_68.065030	4762	4842	59	4	80	0.0500000
NODE_139_length_5681_cov_68.065030	4762	4842	60	1	80	0.0125000
NODE_139_length_5681_cov_68.065030	4762	4842	61	3	80	0.0375000
NODE_139_length_5681_cov_68.065030	4762	4842	62	1	80	0.0125000
NODE_139_length_5681_cov_68.065030	4762	4842	63	2	80	0.0250000
NODE_139_length_5681_cov_68.065030	4762	4842	64	3	80	0.0375000
NODE_139_length_5681_cov_68.065030	4762	4842	66	1	80	0.0125000
NODE_139_length_5681_cov_68.065030	4762	4842	67	2	80	0.0250000
NODE_139_length_5681_cov_68.065030	4762	4842	68	2	80	0.0250000
NODE_139_length_5681_cov_68.065030	4762	4842	69	10	80	0.1250000
NODE_139_length_5681_cov_68.065030	4762	4842	70	5	80	0.0625000
NODE_139_length_5681_cov_68.065030	4762	4842	71	10	80	0.1250000
NODE_139_length_5681_cov_68.065030	4762	4842	72	3	80	0.0375000
NODE_139_length_5681_cov_68.065030	4769	4839	43	1	70	0.0142857
NODE_139_length_5681_cov_68.065030	4769	4839	46	2	70	0.0285714
NODE_139_length_5681_cov_68.065030	4769	4839	47	5	70	0.0714286
NODE_139_length_5681_cov_68.065030	4769	4839	49	2	70	0.0285714
NODE_139_length_5681_cov_68.065030	4769	4839	51	2	70	0.0285714
NODE_139_length_5681_cov_68.065030	4769	4839	52	4	70	0.0571429
NODE_139_length_5681_cov_68.065030	4769	4839	53	1	70	0.0142857
NODE_139_length_5681_cov_68.065030	4769	4839	55	6	70	0.0857143
NODE_139_length_5681_cov_68.065030	4769	4839	56	1	70	0.0142857
NODE_139_length_5681_cov_68.065030	4769	4839	57	1	70	0.0142857
NODE_139_length_5681_cov_68.065030	4769	4839	58	1	70	0.0142857
NODE_139_length_5681_cov_68.065030	4769	4839	59	4	70	0.0571429
NODE_139_length_5681_cov_68.065030	4769	4839	60	1	70	0.0142857
NODE_139_length_5681_cov_68.065030	4769	4839	61	3	70	0.0428571
NODE_139_length_5681_cov_68.065030	4769	4839	62	1	70	0.0142857
NODE_139_length_5681_cov_68.065030	4769	4839	63	2	70	0.0285714
NODE_139_length_5681_cov_68.065030	4769	4839	64	3	70	0.0428571
NODE_139_length_5681_cov_68.065030	4769	4839	67	2	70	0.0285714
NODE_139_length_5681_cov_68.065030	4769	4839	68	1	70	0.0142857
NODE_139_length_5681_cov_68.065030	4769	4839	69	9	70	0.1285714
NODE_139_length_5681_cov_68.065030	4769	4839	70	5	70	0.0714286
NODE_139_length_5681_cov_68.065030	4769	4839	71	10	70	0.1428571
NODE_139_length_5681_cov_68.065030	4769	4839	72	3	70	0.0428571
NODE_139_length_5681_cov_68.065030	4771	4842	46	2	71	0.0281690
NODE_139_length_5681_cov_68.065030	4771	4842	47	4	71	0.0563380
NODE_139_length_5681_cov_68.065030	4771	4842	49	2	71	0.0281690
NODE_139_length_5681_cov_68.065030	4771	4842	51	2	71	0.0281690
NODE_139_length_5681_cov_68.065030	4771	4842	52	4	71	0.0563380
NODE_139_length_5681_cov_68.065030	4771	4842	53	1	71	0.0140845
NODE_139_length_5681_cov_68.065030	4771	4842	55	6	71	0.0845070
NODE_139_length_5681_cov_68.065030	4771	4842	56	1	71	0.0140845
NODE_139_length_5681_cov_68.065030	4771	4842	57	1	71	0.0140845
NODE_139_length_5681_cov_68.065030	4771	4842	58	1	71	0.0140845
NODE_139_length_5681_cov_68.065030	4771	4842	59	4	71	0.0563380
NODE_139_length_5681_cov_68.065030	4771	4842	60	1	71	0.0140845
NODE_139_length_5681_cov_68.065030	4771	4842	61	3	71	0.0422535
NODE_139_length_5681_cov_68.065030	4771	4842	62	1	71	0.0140845
NODE_139_length_5681_cov_68.065030	4771	4842	63	2	71	0.0281690
NODE_139_length_5681_cov_68.065030	4771	4842	64	3	71	0.0422535
NODE_139_length_5681_cov_68.065030	4771	4842	66	1	71	0.0140845
NODE_139_length_5681_cov_68.065030	4771	4842	67	2	71	0.0281690
NODE_139_length_5681_cov_68.065030	4771	4842	68	2	71	0.0281690
NODE_139_length_5681_cov_68.065030	4771	4842	69	10	71	0.1408451
NODE_139_length_5681_cov_68.065030	4771	4842	70	5	71	0.0704225
NODE_139_length_5681_cov_68.065030	4771	4842	71	10	71	0.1408451
NODE_139_length_5681_cov_68.065030	4771	4842	72	3	71	0.0422535
NODE_139_length_5681_cov_68.065030	4815	4895	59	6	80	0.0750000
NODE_139_length_5681_cov_68.065030	4815	4895	60	9	80	0.1125000
NODE_139_length_5681_cov_68.065030	4815	4895	61	2	80	0.0250000
NODE_139_length_5681_cov_68.065030	4815	4895	62	1	80	0.0125000
NODE_139_length_5681_cov_68.065030	4815	4895	63	2	80	0.0250000
NODE_139_length_5681_cov_68.065030	4815	4895	65	5	80	0.0625000
NODE_139_length_5681_cov_68.065030	4815	4895	66	9	80	0.1125000
NODE_139_length_5681_cov_68.065030	4815	4895	67	15	80	0.1875000
NODE_139_length_5681_cov_68.065030	4815	4895	68	7	80	0.0875000
NODE_139_length_5681_cov_68.065030	4815	4895	69	6	80	0.0750000
NODE_139_length_5681_cov_68.065030	4815	4895	70	5	80	0.0625000
NODE_139_length_5681_cov_68.065030	4815	4895	71	10	80	0.1250000
NODE_139_length_5681_cov_68.065030	4815	4895	72	3	80	0.0375000
NODE_139_length_5681_cov_68.065030	4815	4895	59	6	80	0.0750000
NODE_139_length_5681_cov_68.065030	4815	4895	60	9	80	0.1125000
NODE_139_length_5681_cov_68.065030	4815	4895	61	2	80	0.0250000
NODE_139_length_5681_cov_68.065030	4815	4895	62	1	80	0.0125000
NODE_139_length_5681_cov_68.065030	4815	4895	63	2	80	0.0250000
NODE_139_length_5681_cov_68.065030	4815	4895	65	5	80	0.0625000
NODE_139_length_5681_cov_68.065030	4815	4895	66	9	80	0.1125000
NODE_139_length_5681_cov_68.065030	4815	4895	67	15	80	0.1875000
NODE_139_length_5681_cov_68.065030	4815	4895	68	7	80	0.0875000
NODE_139_length_5681_cov_68.065030	4815	4895	69	6	80	0.0750000
NODE_139_length_5681_cov_68.065030	4815	4895	70	5	80	0.0625000
NODE_139_length_5681_cov_68.065030	4815	4895	71	10	80	0.1250000
NODE_139_length_5681_cov_68.065030	4815	4895	72	3	80	0.0375000
NODE_139_length_5681_cov_68.065030	4815	4895	59	6	80	0.0750000
NODE_139_length_5681_cov_68.065030	4815	4895	60	9	80	0.1125000
NODE_139_length_5681_cov_68.065030	4815	4895	61	2	80	0.0250000
NODE_139_length_5681_cov_68.065030	4815	4895	62	1	80	0.0125000
NODE_139_length_5681_cov_68.065030	4815	4895	63	2	80	0.0250000
NODE_139_length_5681_cov_68.065030	4815	4895	65	5	80	0.0625000
NODE_139_length_5681_cov_68.065030	4815	4895	66	9	80	0.1125000
NODE_139_length_5681_cov_68.065030	4815	4895	67	15	80	0.1875000
NODE_139_length_5681_cov_68.065030	4815	4895	68	7	80	0.0875000
NODE_139_length_5681_cov_68.065030	4815	4895	69	6	80	0.0750000
NODE_139_length_5681_cov_68.065030	4815	4895	70	5	80	0.0625000
NODE_139_length_5681_cov_68.065030	4815	4895	71	10	80	0.1250000
NODE_139_length_5681_cov_68.065030	4815	4895	72	3	80	0.0375000
NODE_139_length_5681_cov_68.065030	4815	4895	59	6	80	0.0750000
NODE_139_length_5681_cov_68.065030	4815	4895	60	9	80	0.1125000
NODE_139_length_5681_cov_68.065030	4815	4895	61	2	80	0.0250000
NODE_139_length_5681_cov_68.065030	4815	4895	62	1	80	0.0125000
NODE_139_length_5681_cov_68.065030	4815	4895	63	2	80	0.0250000
NODE_139_length_5681_cov_68.065030	4815	4895	65	5	80	0.0625000
NODE_139_length_5681_cov_68.065030	4815	4895	66	9	80	0.1125000
NODE_139_length_5681_cov_68.065030	4815	4895	67	15	80	0.1875000
NODE_139_length_5681_cov_68.065030	4815	4895	68	7	80	0.0875000
NODE_139_length_5681_cov_68.065030	4815	4895	69	6	80	0.0750000
NODE_139_length_5681_cov_68.065030	4815	4895	70	5	80	0.0625000
NODE_139_length_5681_cov_68.065030	4815	4895	71	10	80	0.1250000
NODE_139_length_5681_cov_68.065030	4815	4895	72	3	80	0.0375000
NODE_139_length_5681_cov_68.065030	4815	4895	59	6	80	0.0750000
NODE_139_length_5681_cov_68.065030	4815	4895	60	9	80	0.1125000
NODE_139_length_5681_cov_68.065030	4815	4895	61	2	80	0.0250000
NODE_139_length_5681_cov_68.065030	4815	4895	62	1	80	0.0125000
NODE_139_length_5681_cov_68.065030	4815	4895	63	2	80	0.0250000
NODE_139_length_5681_cov_68.065030	4815	4895	65	5	80	0.0625000
NODE_139_length_5681_cov_68.065030	4815	4895	66	9	80	0.1125000
NODE_139_length_5681_cov_68.065030	4815	4895	67	15	80	0.1875000
NODE_139_length_5681_cov_68.065030	4815	4895	68	7	80	0.0875000
NODE_139_length_5681_cov_68.065030	4815	4895	69	6	80	0.0750000
NODE_139_length_5681_cov_68.065030	4815	4895	70	5	80	0.0625000
NODE_139_length_5681_cov_68.065030	4815	4895	71	10	80	0.1250000
NODE_139_length_5681_cov_68.065030	4815	4895	72	3	80	0.0375000
NODE_139_length_5681_cov_68.065030	4815	4895	59	6	80	0.0750000
NODE_139_length_5681_cov_68.065030	4815	4895	60	9	80	0.1125000
NODE_139_length_5681_cov_68.065030	4815	4895	61	2	80	0.0250000
NODE_139_length_5681_cov_68.065030	4815	4895	62	1	80	0.0125000
NODE_139_length_5681_cov_68.065030	4815	4895	63	2	80	0.0250000
NODE_139_length_5681_cov_68.065030	4815	4895	65	5	80	0.0625000
NODE_139_length_5681_cov_68.065030	4815	4895	66	9	80	0.1125000
NODE_139_length_5681_cov_68.065030	4815	4895	67	15	80	0.1875000
NODE_139_length_5681_cov_68.065030	4815	4895	68	7	80	0.0875000
NODE_139_length_5681_cov_68.065030	4815	4895	69	6	80	0.0750000
NODE_139_length_5681_cov_68.065030	4815	4895	70	5	80	0.0625000
NODE_139_length_5681_cov_68.065030	4815	4895	71	10	80	0.1250000
NODE_139_length_5681_cov_68.065030	4815	4895	72	3	80	0.0375000
NODE_139_length_5681_cov_68.065030	4891	4971	12	2	80	0.0250000
NODE_139_length_5681_cov_68.065030	4891	4971	13	2	80	0.0250000
NODE_139_length_5681_cov_68.065030	4891	4971	14	6	80	0.0750000
NODE_139_length_5681_cov_68.065030	4891	4971	15	2	80	0.0250000
NODE_139_length_5681_cov_68.065030	4891	4971	17	4	80	0.0500000
NODE_139_length_5681_cov_68.065030	4891	4971	18	2	80	0.0250000
NODE_139_length_5681_cov_68.065030	4891	4971	20	3	80	0.0375000
NODE_139_length_5681_cov_68.065030	4891	4971	21	1	80	0.0125000
NODE_139_length_5681_cov_68.065030	4891	4971	22	4	80	0.0500000
NODE_139_length_5681_cov_68.065030	4891	4971	23	1	80	0.0125000
NODE_139_length_5681_cov_68.065030	4891	4971	24	1	80	0.0125000
NODE_139_length_5681_cov_68.065030	4891	4971	25	1	80	0.0125000
NODE_139_length_5681_cov_68.065030	4891	4971	26	6	80	0.0750000
NODE_139_length_5681_cov_68.065030	4891	4971	27	1	80	0.0125000
NODE_139_length_5681_cov_68.065030	4891	4971	28	2	80	0.0250000
NODE_139_length_5681_cov_68.065030	4891	4971	30	2	80	0.0250000
NODE_139_length_5681_cov_68.065030	4891	4971	31	6	80	0.0750000
NODE_139_length_5681_cov_68.065030	4891	4971	32	5	80	0.0625000
NODE_139_length_5681_cov_68.065030	4891	4971	35	1	80	0.0125000
NODE_139_length_5681_cov_68.065030	4891	4971	37	2	80	0.0250000
NODE_139_length_5681_cov_68.065030	4891	4971	38	3	80	0.0375000
NODE_139_length_5681_cov_68.065030	4891	4971	39	2	80	0.0250000
NODE_139_length_5681_cov_68.065030	4891	4971	40	1	80	0.0125000
NODE_139_length_5681_cov_68.065030	4891	4971	42	1	80	0.0125000
NODE_139_length_5681_cov_68.065030	4891	4971	45	3	80	0.0375000
NODE_139_length_5681_cov_68.065030	4891	4971	47	3	80	0.0375000
NODE_139_length_5681_cov_68.065030	4891	4971	48	1	80	0.0125000
NODE_139_length_5681_cov_68.065030	4891	4971	50	1	80	0.0125000
NODE_139_length_5681_cov_68.065030	4891	4971	53	2	80	0.0250000
NODE_139_length_5681_cov_68.065030	4891	4971	57	1	80	0.0125000
NODE_139_length_5681_cov_68.065030	4891	4971	59	8	80	0.1000000
NODE_139_length_5681_cov_68.065030	4944	5007	7	5	63	0.0793651
NODE_139_length_5681_cov_68.065030	4944	5007	8	2	63	0.0317460
NODE_139_length_5681_cov_68.065030	4944	5007	9	7	63	0.1111111
NODE_139_length_5681_cov_68.065030	4944	5007	10	6	63	0.0952381
NODE_139_length_5681_cov_68.065030	4944	5007	11	7	63	0.1111111
NODE_139_length_5681_cov_68.065030	4944	5007	12	11	63	0.1746032
NODE_139_length_5681_cov_68.065030	4944	5007	13	2	63	0.0317460
NODE_139_length_5681_cov_68.065030	4944	5007	14	6	63	0.0952381
NODE_139_length_5681_cov_68.065030	4944	5007	15	2	63	0.0317460
NODE_139_length_5681_cov_68.065030	4944	5007	17	4	63	0.0634921
NODE_139_length_5681_cov_68.065030	4944	5007	18	2	63	0.0317460
NODE_139_length_5681_cov_68.065030	4944	5007	20	3	63	0.0476190
NODE_139_length_5681_cov_68.065030	4944	5007	21	1	63	0.0158730
NODE_139_length_5681_cov_68.065030	4944	5007	22	4	63	0.0634921
NODE_139_length_5681_cov_68.065030	4944	5007	23	1	63	0.0158730
NODE_139_length_5681_cov_68.065030	4944	5024	6	11	80	0.1375000
NODE_139_length_5681_cov_68.065030	4944	5024	7	11	80	0.1375000
NODE_139_length_5681_cov_68.065030	4944	5024	8	2	80	0.0250000
NODE_139_length_5681_cov_68.065030	4944	5024	9	7	80	0.0875000
NODE_139_length_5681_cov_68.065030	4944	5024	10	6	80	0.0750000
NODE_139_length_5681_cov_68.065030	4944	5024	11	7	80	0.0875000
NODE_139_length_5681_cov_68.065030	4944	5024	12	11	80	0.1375000
NODE_139_length_5681_cov_68.065030	4944	5024	13	2	80	0.0250000
NODE_139_length_5681_cov_68.065030	4944	5024	14	6	80	0.0750000
NODE_139_length_5681_cov_68.065030	4944	5024	15	2	80	0.0250000
NODE_139_length_5681_cov_68.065030	4944	5024	17	4	80	0.0500000
NODE_139_length_5681_cov_68.065030	4944	5024	18	2	80	0.0250000
NODE_139_length_5681_cov_68.065030	4944	5024	20	3	80	0.0375000
NODE_139_length_5681_cov_68.065030	4944	5024	21	1	80	0.0125000
NODE_139_length_5681_cov_68.065030	4944	5024	22	4	80	0.0500000
NODE_139_length_5681_cov_68.065030	4944	5024	23	1	80	0.0125000
NODE_140_length_5677_cov_21.613482	1792	1863	42	1	71	0.0140845
NODE_140_length_5677_cov_21.613482	1792	1863	44	6	71	0.0845070
NODE_140_length_5677_cov_21.613482	1792	1863	45	7	71	0.0985916
NODE_140_length_5677_cov_21.613482	1792	1863	46	8	71	0.1126761
NODE_140_length_5677_cov_21.613482	1792	1863	47	9	71	0.1267606
NODE_140_length_5677_cov_21.613482	1792	1863	48	2	71	0.0281690
NODE_140_length_5677_cov_21.613482	1792	1863	49	8	71	0.1126761
NODE_140_length_5677_cov_21.613482	1792	1863	50	7	71	0.0985916
NODE_140_length_5677_cov_21.613482	1792	1863	51	7	71	0.0985916
NODE_140_length_5677_cov_21.613482	1792	1863	52	3	71	0.0422535
NODE_140_length_5677_cov_21.613482	1792	1863	53	6	71	0.0845070
NODE_140_length_5677_cov_21.613482	1792	1863	54	4	71	0.0563380
NODE_140_length_5677_cov_21.613482	1792	1863	56	1	71	0.0140845
NODE_140_length_5677_cov_21.613482	1792	1863	58	2	71	0.0281690
NODE_140_length_5677_cov_21.613482	1845	1916	42	3	71	0.0422535
NODE_140_length_5677_cov_21.613482	1845	1916	43	1	71	0.0140845
NODE_140_length_5677_cov_21.613482	1845	1916	45	16	71	0.2253521
NODE_140_length_5677_cov_21.613482	1845	1916	46	21	71	0.2957746
NODE_140_length_5677_cov_21.613482	1845	1916	47	14	71	0.1971831
NODE_140_length_5677_cov_21.613482	1845	1916	48	4	71	0.0563380
NODE_140_length_5677_cov_21.613482	1845	1916	49	7	71	0.0985916
NODE_140_length_5677_cov_21.613482	1845	1916	50	5	71	0.0704225
NODE_142_length_5631_cov_25.927332	96	176	123	2	80	0.0250000
NODE_142_length_5631_cov_25.927332	96	176	124	1	80	0.0125000
NODE_142_length_5631_cov_25.927332	96	176	126	3	80	0.0375000
NODE_142_length_5631_cov_25.927332	96	176	127	2	80	0.0250000
NODE_142_length_5631_cov_25.927332	96	176	131	4	80	0.0500000
NODE_142_length_5631_cov_25.927332	96	176	134	1	80	0.0125000
NODE_142_length_5631_cov_25.927332	96	176	135	1	80	0.0125000
NODE_142_length_5631_cov_25.927332	96	176	138	1	80	0.0125000
NODE_142_length_5631_cov_25.927332	96	176	139	1	80	0.0125000
NODE_142_length_5631_cov_25.927332	96	176	141	2	80	0.0250000
NODE_142_length_5631_cov_25.927332	96	176	142	1	80	0.0125000
NODE_142_length_5631_cov_25.927332	96	176	143	3	80	0.0375000
NODE_142_length_5631_cov_25.927332	96	176	144	1	80	0.0125000
NODE_142_length_5631_cov_25.927332	96	176	145	1	80	0.0125000
NODE_142_length_5631_cov_25.927332	96	176	146	3	80	0.0375000
NODE_142_length_5631_cov_25.927332	96	176	147	8	80	0.1000000
NODE_142_length_5631_cov_25.927332	96	176	148	7	80	0.0875000
NODE_142_length_5631_cov_25.927332	96	176	149	6	80	0.0750000
NODE_142_length_5631_cov_25.927332	96	176	150	3	80	0.0375000
NODE_142_length_5631_cov_25.927332	96	176	151	2	80	0.0250000
NODE_142_length_5631_cov_25.927332	96	176	152	4	80	0.0500000
NODE_142_length_5631_cov_25.927332	96	176	153	5	80	0.0625000
NODE_142_length_5631_cov_25.927332	96	176	154	4	80	0.0500000
NODE_142_length_5631_cov_25.927332	96	176	155	4	80	0.0500000
NODE_142_length_5631_cov_25.927332	96	176	156	3	80	0.0375000
NODE_142_length_5631_cov_25.927332	96	176	157	3	80	0.0375000
NODE_142_length_5631_cov_25.927332	96	176	158	2	80	0.0250000
NODE_142_length_5631_cov_25.927332	96	176	159	1	80	0.0125000
NODE_142_length_5631_cov_25.927332	96	176	161	1	80	0.0125000
NODE_142_length_5631_cov_25.927332	149	229	100	1	80	0.0125000
NODE_142_length_5631_cov_25.927332	149	229	101	1	80	0.0125000
NODE_142_length_5631_cov_25.927332	149	229	103	2	80	0.0250000
NODE_142_length_5631_cov_25.927332	149	229	105	1	80	0.0125000
NODE_142_length_5631_cov_25.927332	149	229	106	1	80	0.0125000
NODE_142_length_5631_cov_25.927332	149	229	107	2	80	0.0250000
NODE_142_length_5631_cov_25.927332	149	229	108	1	80	0.0125000
NODE_142_length_5631_cov_25.927332	149	229	109	2	80	0.0250000
NODE_142_length_5631_cov_25.927332	149	229	110	2	80	0.0250000
NODE_142_length_5631_cov_25.927332	149	229	112	3	80	0.0375000
NODE_142_length_5631_cov_25.927332	149	229	113	2	80	0.0250000
NODE_142_length_5631_cov_25.927332	149	229	115	1	80	0.0125000
NODE_142_length_5631_cov_25.927332	149	229	117	3	80	0.0375000
NODE_142_length_5631_cov_25.927332	149	229	118	3	80	0.0375000
NODE_142_length_5631_cov_25.927332	149	229	119	3	80	0.0375000
NODE_142_length_5631_cov_25.927332	149	229	120	4	80	0.0500000
NODE_142_length_5631_cov_25.927332	149	229	122	2	80	0.0250000
NODE_142_length_5631_cov_25.927332	149	229	123	3	80	0.0375000
NODE_142_length_5631_cov_25.927332	149	229	124	2	80	0.0250000
NODE_142_length_5631_cov_25.927332	149	229	125	1	80	0.0125000
NODE_142_length_5631_cov_25.927332	149	229	126	1	80	0.0125000
NODE_142_length_5631_cov_25.927332	149	229	127	1	80	0.0125000
NODE_142_length_5631_cov_25.927332	149	229	128	2	80	0.0250000
NODE_142_length_5631_cov_25.927332	149	229	129	2	80	0.0250000
NODE_142_length_5631_cov_25.927332	149	229	130	2	80	0.0250000
NODE_142_length_5631_cov_25.927332	149	229	133	1	80	0.0125000
NODE_142_length_5631_cov_25.927332	149	229	135	1	80	0.0125000
NODE_142_length_5631_cov_25.927332	149	229	136	1	80	0.0125000
NODE_142_length_5631_cov_25.927332	149	229	138	1	80	0.0125000
NODE_142_length_5631_cov_25.927332	149	229	141	3	80	0.0375000
NODE_142_length_5631_cov_25.927332	149	229	143	2	80	0.0250000
NODE_142_length_5631_cov_25.927332	149	229	145	1	80	0.0125000
NODE_142_length_5631_cov_25.927332	149	229	146	1	80	0.0125000
NODE_142_length_5631_cov_25.927332	149	229	147	1	80	0.0125000
NODE_142_length_5631_cov_25.927332	149	229	148	2	80	0.0250000
NODE_142_length_5631_cov_25.927332	149	229	152	1	80	0.0125000
NODE_142_length_5631_cov_25.927332	149	229	153	1	80	0.0125000
NODE_142_length_5631_cov_25.927332	149	229	154	4	80	0.0500000
NODE_142_length_5631_cov_25.927332	149	229	155	4	80	0.0500000
NODE_142_length_5631_cov_25.927332	149	229	156	2	80	0.0250000
NODE_142_length_5631_cov_25.927332	149	229	157	2	80	0.0250000
NODE_142_length_5631_cov_25.927332	149	229	158	2	80	0.0250000
NODE_142_length_5631_cov_25.927332	149	229	159	1	80	0.0125000
NODE_142_length_5631_cov_25.927332	149	229	161	1	80	0.0125000
NODE_146_length_5588_cov_40.961377	2793	2873	14	1	80	0.0125000
NODE_146_length_5588_cov_40.961377	2793	2873	16	12	80	0.1500000
NODE_146_length_5588_cov_40.961377	2793	2873	17	7	80	0.0875000
NODE_146_length_5588_cov_40.961377	2793	2873	18	36	80	0.4500000
NODE_146_length_5588_cov_40.961377	2793	2873	19	16	80	0.2000000
NODE_146_length_5588_cov_40.961377	2793	2873	20	8	80	0.1000000
NODE_146_length_5588_cov_40.961377	2846	2926	14	1	80	0.0125000
NODE_146_length_5588_cov_40.961377	2846	2926	16	9	80	0.1125000
NODE_146_length_5588_cov_40.961377	2846	2926	17	3	80	0.0375000
NODE_146_length_5588_cov_40.961377	2846	2926	18	3	80	0.0375000
NODE_146_length_5588_cov_40.961377	2846	2926	19	10	80	0.1250000
NODE_146_length_5588_cov_40.961377	2846	2926	20	5	80	0.0625000
NODE_146_length_5588_cov_40.961377	2846	2926	22	7	80	0.0875000
NODE_146_length_5588_cov_40.961377	2846	2926	23	1	80	0.0125000
NODE_146_length_5588_cov_40.961377	2846	2926	25	2	80	0.0250000
NODE_146_length_5588_cov_40.961377	2846	2926	26	1	80	0.0125000
NODE_146_length_5588_cov_40.961377	2846	2926	28	1	80	0.0125000
NODE_146_length_5588_cov_40.961377	2846	2926	29	5	80	0.0625000
NODE_146_length_5588_cov_40.961377	2846	2926	31	1	80	0.0125000
NODE_146_length_5588_cov_40.961377	2846	2926	32	3	80	0.0375000
NODE_146_length_5588_cov_40.961377	2846	2926	34	6	80	0.0750000
NODE_146_length_5588_cov_40.961377	2846	2926	35	2	80	0.0250000
NODE_146_length_5588_cov_40.961377	2846	2926	36	4	80	0.0500000
NODE_146_length_5588_cov_40.961377	2846	2926	37	3	80	0.0375000
NODE_146_length_5588_cov_40.961377	2846	2926	38	13	80	0.1625000
NODE_146_length_5588_cov_40.961377	2922	3002	34	2	80	0.0250000
NODE_146_length_5588_cov_40.961377	2922	3002	35	19	80	0.2375000
NODE_146_length_5588_cov_40.961377	2922	3002	36	17	80	0.2125000
NODE_146_length_5588_cov_40.961377	2922	3002	37	18	80	0.2250000
NODE_146_length_5588_cov_40.961377	2922	3002	38	6	80	0.0750000
NODE_146_length_5588_cov_40.961377	2922	3002	39	12	80	0.1500000
NODE_146_length_5588_cov_40.961377	2922	3002	40	6	80	0.0750000
NODE_146_length_5588_cov_40.961377	2975	3055	21	6	80	0.0750000
NODE_146_length_5588_cov_40.961377	2975	3055	22	1	80	0.0125000
NODE_146_length_5588_cov_40.961377	2975	3055	23	4	80	0.0500000
NODE_146_length_5588_cov_40.961377	2975	3055	25	5	80	0.0625000
NODE_146_length_5588_cov_40.961377	2975	3055	26	2	80	0.0250000
NODE_146_length_5588_cov_40.961377	2975	3055	27	3	80	0.0375000
NODE_146_length_5588_cov_40.961377	2975	3055	28	6	80	0.0750000
NODE_146_length_5588_cov_40.961377	2975	3055	30	8	80	0.1000000
NODE_146_length_5588_cov_40.961377	2975	3055	31	2	80	0.0250000
NODE_146_length_5588_cov_40.961377	2975	3055	32	5	80	0.0625000
NODE_146_length_5588_cov_40.961377	2975	3055	33	4	80	0.0500000
NODE_146_length_5588_cov_40.961377	2975	3055	34	7	80	0.0875000
NODE_146_length_5588_cov_40.961377	2975	3055	35	11	80	0.1375000
NODE_146_length_5588_cov_40.961377	2975	3055	36	8	80	0.1000000
NODE_146_length_5588_cov_40.961377	2975	3055	37	8	80	0.1000000
NODE_149_length_5578_cov_5.173389	331	411	6	31	80	0.3875000
NODE_149_length_5578_cov_5.173389	331	411	7	24	80	0.3000000
NODE_149_length_5578_cov_5.173389	331	411	8	25	80	0.3125000
NODE_149_length_5578_cov_5.173389	388	464	3	4	76	0.0526316
NODE_149_length_5578_cov_5.173389	388	464	4	22	76	0.2894737
NODE_149_length_5578_cov_5.173389	388	464	5	3	76	0.0394737
NODE_149_length_5578_cov_5.173389	388	464	6	21	76	0.2763158
NODE_149_length_5578_cov_5.173389	388	464	7	10	76	0.1315790
NODE_149_length_5578_cov_5.173389	388	464	8	16	76	0.2105263
NODE_150_length_5572_cov_79.124246	1555	1627	145	1	72	0.0138889
NODE_150_length_5572_cov_79.124246	1555	1627	146	1	72	0.0138889
NODE_150_length_5572_cov_79.124246	1555	1627	150	1	72	0.0138889
NODE_150_length_5572_cov_79.124246	1555	1627	152	2	72	0.0277778
NODE_150_length_5572_cov_79.124246	1555	1627	153	3	72	0.0416667
NODE_150_length_5572_cov_79.124246	1555	1627	154	1	72	0.0138889
NODE_150_length_5572_cov_79.124246	1555	1627	157	1	72	0.0138889
NODE_150_length_5572_cov_79.124246	1555	1627	159	1	72	0.0138889
NODE_150_length_5572_cov_79.124246	1555	1627	162	1	72	0.0138889
NODE_150_length_5572_cov_79.124246	1555	1627	165	1	72	0.0138889
NODE_150_length_5572_cov_79.124246	1555	1627	166	1	72	0.0138889
NODE_150_length_5572_cov_79.124246	1555	1627	167	2	72	0.0277778
NODE_150_length_5572_cov_79.124246	1555	1627	169	3	72	0.0416667
NODE_150_length_5572_cov_79.124246	1555	1627	172	1	72	0.0138889
NODE_150_length_5572_cov_79.124246	1555	1627	175	1	72	0.0138889
NODE_150_length_5572_cov_79.124246	1555	1627	177	2	72	0.0277778
NODE_150_length_5572_cov_79.124246	1555	1627	178	1	72	0.0138889
NODE_150_length_5572_cov_79.124246	1555	1627	179	1	72	0.0138889
NODE_150_length_5572_cov_79.124246	1555	1627	182	2	72	0.0277778
NODE_150_length_5572_cov_79.124246	1555	1627	185	3	72	0.0416667
NODE_150_length_5572_cov_79.124246	1555	1627	186	1	72	0.0138889
NODE_150_length_5572_cov_79.124246	1555	1627	187	1	72	0.0138889
NODE_150_length_5572_cov_79.124246	1555	1627	191	1	72	0.0138889
NODE_150_length_5572_cov_79.124246	1555	1627	192	1	72	0.0138889
NODE_150_length_5572_cov_79.124246	1555	1627	195	3	72	0.0416667
NODE_150_length_5572_cov_79.124246	1555	1627	197	2	72	0.0277778
NODE_150_length_5572_cov_79.124246	1555	1627	199	1	72	0.0138889
NODE_150_length_5572_cov_79.124246	1555	1627	200	1	72	0.0138889
NODE_150_length_5572_cov_79.124246	1555	1627	202	1	72	0.0138889
NODE_150_length_5572_cov_79.124246	1555	1627	204	2	72	0.0277778
NODE_150_length_5572_cov_79.124246	1555	1627	205	2	72	0.0277778
NODE_150_length_5572_cov_79.124246	1555	1627	208	1	72	0.0138889
NODE_150_length_5572_cov_79.124246	1555	1627	209	1	72	0.0138889
NODE_150_length_5572_cov_79.124246	1555	1627	210	2	72	0.0277778
NODE_150_length_5572_cov_79.124246	1555	1627	217	2	72	0.0277778
NODE_150_length_5572_cov_79.124246	1555	1627	218	3	72	0.0416667
NODE_150_length_5572_cov_79.124246	1555	1627	219	5	72	0.0694444
NODE_150_length_5572_cov_79.124246	1555	1627	220	2	72	0.0277778
NODE_150_length_5572_cov_79.124246	1555	1627	221	1	72	0.0138889
NODE_150_length_5572_cov_79.124246	1555	1627	231	1	72	0.0138889
NODE_150_length_5572_cov_79.124246	1555	1627	233	1	72	0.0138889
NODE_150_length_5572_cov_79.124246	1555	1627	240	2	72	0.0277778
NODE_150_length_5572_cov_79.124246	1555	1627	242	1	72	0.0138889
NODE_150_length_5572_cov_79.124246	1555	1627	243	1	72	0.0138889
NODE_150_length_5572_cov_79.124246	1555	1627	245	1	72	0.0138889
NODE_150_length_5572_cov_79.124246	1555	1627	247	1	72	0.0138889
NODE_150_length_5572_cov_79.124246	1555	1627	249	1	72	0.0138889
NODE_150_length_5572_cov_79.124246	1603	1680	210	2	77	0.0259740
NODE_150_length_5572_cov_79.124246	1603	1680	217	2	77	0.0259740
NODE_150_length_5572_cov_79.124246	1603	1680	218	3	77	0.0389610
NODE_150_length_5572_cov_79.124246	1603	1680	219	5	77	0.0649351
NODE_150_length_5572_cov_79.124246	1603	1680	220	2	77	0.0259740
NODE_150_length_5572_cov_79.124246	1603	1680	221	1	77	0.0129870
NODE_150_length_5572_cov_79.124246	1603	1680	231	1	77	0.0129870
NODE_150_length_5572_cov_79.124246	1603	1680	233	1	77	0.0129870
NODE_150_length_5572_cov_79.124246	1603	1680	240	2	77	0.0259740
NODE_150_length_5572_cov_79.124246	1603	1680	242	1	77	0.0129870
NODE_150_length_5572_cov_79.124246	1603	1680	243	1	77	0.0129870
NODE_150_length_5572_cov_79.124246	1603	1680	245	1	77	0.0129870
NODE_150_length_5572_cov_79.124246	1603	1680	247	1	77	0.0129870
NODE_150_length_5572_cov_79.124246	1603	1680	249	3	77	0.0389610
NODE_150_length_5572_cov_79.124246	1603	1680	252	2	77	0.0259740
NODE_150_length_5572_cov_79.124246	1603	1680	254	1	77	0.0129870
NODE_150_length_5572_cov_79.124246	1603	1680	257	1	77	0.0129870
NODE_150_length_5572_cov_79.124246	1603	1680	259	1	77	0.0129870
NODE_150_length_5572_cov_79.124246	1603	1680	260	1	77	0.0129870
NODE_150_length_5572_cov_79.124246	1603	1680	261	1	77	0.0129870
NODE_150_length_5572_cov_79.124246	1603	1680	262	3	77	0.0389610
NODE_150_length_5572_cov_79.124246	1603	1680	263	1	77	0.0129870
NODE_150_length_5572_cov_79.124246	1603	1680	264	1	77	0.0129870
NODE_150_length_5572_cov_79.124246	1603	1680	271	1	77	0.0129870
NODE_150_length_5572_cov_79.124246	1603	1680	273	2	77	0.0259740
NODE_150_length_5572_cov_79.124246	1603	1680	275	2	77	0.0259740
NODE_150_length_5572_cov_79.124246	1603	1680	278	1	77	0.0129870
NODE_150_length_5572_cov_79.124246	1603	1680	279	1	77	0.0129870
NODE_150_length_5572_cov_79.124246	1603	1680	285	2	77	0.0259740
NODE_150_length_5572_cov_79.124246	1603	1680	291	2	77	0.0259740
NODE_150_length_5572_cov_79.124246	1603	1680	292	1	77	0.0129870
NODE_150_length_5572_cov_79.124246	1603	1680	293	1	77	0.0129870
NODE_150_length_5572_cov_79.124246	1603	1680	300	1	77	0.0129870
NODE_150_length_5572_cov_79.124246	1603	1680	301	2	77	0.0259740
NODE_150_length_5572_cov_79.124246	1603	1680	302	1	77	0.0129870
NODE_150_length_5572_cov_79.124246	1603	1680	304	2	77	0.0259740
NODE_150_length_5572_cov_79.124246	1603	1680	305	1	77	0.0129870
NODE_150_length_5572_cov_79.124246	1603	1680	306	1	77	0.0129870
NODE_150_length_5572_cov_79.124246	1603	1680	312	2	77	0.0259740
NODE_150_length_5572_cov_79.124246	1603	1680	316	1	77	0.0129870
NODE_150_length_5572_cov_79.124246	1603	1680	317	1	77	0.0129870
NODE_150_length_5572_cov_79.124246	1603	1680	320	1	77	0.0129870
NODE_150_length_5572_cov_79.124246	1603	1680	325	1	77	0.0129870
NODE_150_length_5572_cov_79.124246	1603	1680	326	1	77	0.0129870
NODE_150_length_5572_cov_79.124246	1603	1680	327	2	77	0.0259740
NODE_150_length_5572_cov_79.124246	1603	1680	331	2	77	0.0259740
NODE_150_length_5572_cov_79.124246	1603	1680	332	2	77	0.0259740
NODE_150_length_5572_cov_79.124246	1603	1680	333	1	77	0.0129870
NODE_150_length_5572_cov_79.124246	1603	1680	334	2	77	0.0259740
NODE_150_length_5572_cov_79.124246	1603	1680	335	2	77	0.0259740
NODE_150_length_5572_cov_79.124246	1637	1717	260	1	80	0.0125000
NODE_150_length_5572_cov_79.124246	1637	1717	262	1	80	0.0125000
NODE_150_length_5572_cov_79.124246	1637	1717	263	1	80	0.0125000
NODE_150_length_5572_cov_79.124246	1637	1717	264	1	80	0.0125000
NODE_150_length_5572_cov_79.124246	1637	1717	271	1	80	0.0125000
NODE_150_length_5572_cov_79.124246	1637	1717	273	2	80	0.0250000
NODE_150_length_5572_cov_79.124246	1637	1717	275	2	80	0.0250000
NODE_150_length_5572_cov_79.124246	1637	1717	278	1	80	0.0125000
NODE_150_length_5572_cov_79.124246	1637	1717	279	1	80	0.0125000
NODE_150_length_5572_cov_79.124246	1637	1717	285	2	80	0.0250000
NODE_150_length_5572_cov_79.124246	1637	1717	291	2	80	0.0250000
NODE_150_length_5572_cov_79.124246	1637	1717	292	1	80	0.0125000
NODE_150_length_5572_cov_79.124246	1637	1717	293	1	80	0.0125000
NODE_150_length_5572_cov_79.124246	1637	1717	300	1	80	0.0125000
NODE_150_length_5572_cov_79.124246	1637	1717	301	2	80	0.0250000
NODE_150_length_5572_cov_79.124246	1637	1717	302	1	80	0.0125000
NODE_150_length_5572_cov_79.124246	1637	1717	304	2	80	0.0250000
NODE_150_length_5572_cov_79.124246	1637	1717	305	1	80	0.0125000
NODE_150_length_5572_cov_79.124246	1637	1717	306	1	80	0.0125000
NODE_150_length_5572_cov_79.124246	1637	1717	312	2	80	0.0250000
NODE_150_length_5572_cov_79.124246	1637	1717	316	1	80	0.0125000
NODE_150_length_5572_cov_79.124246	1637	1717	317	1	80	0.0125000
NODE_150_length_5572_cov_79.124246	1637	1717	320	1	80	0.0125000
NODE_150_length_5572_cov_79.124246	1637	1717	325	1	80	0.0125000
NODE_150_length_5572_cov_79.124246	1637	1717	326	1	80	0.0125000
NODE_150_length_5572_cov_79.124246	1637	1717	327	2	80	0.0250000
NODE_150_length_5572_cov_79.124246	1637	1717	331	5	80	0.0625000
NODE_150_length_5572_cov_79.124246	1637	1717	332	3	80	0.0375000
NODE_150_length_5572_cov_79.124246	1637	1717	333	3	80	0.0375000
NODE_150_length_5572_cov_79.124246	1637	1717	334	2	80	0.0250000
NODE_150_length_5572_cov_79.124246	1637	1717	335	2	80	0.0250000
NODE_150_length_5572_cov_79.124246	1637	1717	336	1	80	0.0125000
NODE_150_length_5572_cov_79.124246	1637	1717	341	2	80	0.0250000
NODE_150_length_5572_cov_79.124246	1637	1717	342	2	80	0.0250000
NODE_150_length_5572_cov_79.124246	1637	1717	344	2	80	0.0250000
NODE_150_length_5572_cov_79.124246	1637	1717	348	3	80	0.0375000
NODE_150_length_5572_cov_79.124246	1637	1717	349	2	80	0.0250000
NODE_150_length_5572_cov_79.124246	1637	1717	352	1	80	0.0125000
NODE_150_length_5572_cov_79.124246	1637	1717	353	1	80	0.0125000
NODE_150_length_5572_cov_79.124246	1637	1717	354	1	80	0.0125000
NODE_150_length_5572_cov_79.124246	1637	1717	356	1	80	0.0125000
NODE_150_length_5572_cov_79.124246	1637	1717	357	1	80	0.0125000
NODE_150_length_5572_cov_79.124246	1637	1717	358	2	80	0.0250000
NODE_150_length_5572_cov_79.124246	1637	1717	361	1	80	0.0125000
NODE_150_length_5572_cov_79.124246	1637	1717	362	1	80	0.0125000
NODE_150_length_5572_cov_79.124246	1637	1717	363	2	80	0.0250000
NODE_150_length_5572_cov_79.124246	1637	1717	364	3	80	0.0375000
NODE_150_length_5572_cov_79.124246	1637	1717	365	4	80	0.0500000
NODE_150_length_5572_cov_79.124246	1637	1717	366	1	80	0.0125000
NODE_150_length_5572_cov_79.124246	1690	1770	213	1	80	0.0125000
NODE_150_length_5572_cov_79.124246	1690	1770	218	1	80	0.0125000
NODE_150_length_5572_cov_79.124246	1690	1770	225	1	80	0.0125000
NODE_150_length_5572_cov_79.124246	1690	1770	233	1	80	0.0125000
NODE_150_length_5572_cov_79.124246	1690	1770	237	1	80	0.0125000
NODE_150_length_5572_cov_79.124246	1690	1770	239	4	80	0.0500000
NODE_150_length_5572_cov_79.124246	1690	1770	241	1	80	0.0125000
NODE_150_length_5572_cov_79.124246	1690	1770	242	1	80	0.0125000
NODE_150_length_5572_cov_79.124246	1690	1770	243	1	80	0.0125000
NODE_150_length_5572_cov_79.124246	1690	1770	246	1	80	0.0125000
NODE_150_length_5572_cov_79.124246	1690	1770	249	1	80	0.0125000
NODE_150_length_5572_cov_79.124246	1690	1770	251	1	80	0.0125000
NODE_150_length_5572_cov_79.124246	1690	1770	260	2	80	0.0250000
NODE_150_length_5572_cov_79.124246	1690	1770	261	1	80	0.0125000
NODE_150_length_5572_cov_79.124246	1690	1770	262	1	80	0.0125000
NODE_150_length_5572_cov_79.124246	1690	1770	268	1	80	0.0125000
NODE_150_length_5572_cov_79.124246	1690	1770	269	1	80	0.0125000
NODE_150_length_5572_cov_79.124246	1690	1770	272	1	80	0.0125000
NODE_150_length_5572_cov_79.124246	1690	1770	276	2	80	0.0250000
NODE_150_length_5572_cov_79.124246	1690	1770	279	1	80	0.0125000
NODE_150_length_5572_cov_79.124246	1690	1770	280	1	80	0.0125000
NODE_150_length_5572_cov_79.124246	1690	1770	285	1	80	0.0125000
NODE_150_length_5572_cov_79.124246	1690	1770	287	1	80	0.0125000
NODE_150_length_5572_cov_79.124246	1690	1770	291	2	80	0.0250000
NODE_150_length_5572_cov_79.124246	1690	1770	293	1	80	0.0125000
NODE_150_length_5572_cov_79.124246	1690	1770	296	2	80	0.0250000
NODE_150_length_5572_cov_79.124246	1690	1770	302	1	80	0.0125000
NODE_150_length_5572_cov_79.124246	1690	1770	305	1	80	0.0125000
NODE_150_length_5572_cov_79.124246	1690	1770	306	1	80	0.0125000
NODE_150_length_5572_cov_79.124246	1690	1770	309	1	80	0.0125000
NODE_150_length_5572_cov_79.124246	1690	1770	311	1	80	0.0125000
NODE_150_length_5572_cov_79.124246	1690	1770	312	2	80	0.0250000
NODE_150_length_5572_cov_79.124246	1690	1770	319	1	80	0.0125000
NODE_150_length_5572_cov_79.124246	1690	1770	320	2	80	0.0250000
NODE_150_length_5572_cov_79.124246	1690	1770	321	1	80	0.0125000
NODE_150_length_5572_cov_79.124246	1690	1770	325	1	80	0.0125000
NODE_150_length_5572_cov_79.124246	1690	1770	326	1	80	0.0125000
NODE_150_length_5572_cov_79.124246	1690	1770	329	1	80	0.0125000
NODE_150_length_5572_cov_79.124246	1690	1770	331	2	80	0.0250000
NODE_150_length_5572_cov_79.124246	1690	1770	338	2	80	0.0250000
NODE_150_length_5572_cov_79.124246	1690	1770	339	1	80	0.0125000
NODE_150_length_5572_cov_79.124246	1690	1770	340	1	80	0.0125000
NODE_150_length_5572_cov_79.124246	1690	1770	341	1	80	0.0125000
NODE_150_length_5572_cov_79.124246	1690	1770	342	1	80	0.0125000
NODE_150_length_5572_cov_79.124246	1690	1770	344	1	80	0.0125000
NODE_150_length_5572_cov_79.124246	1690	1770	348	3	80	0.0375000
NODE_150_length_5572_cov_79.124246	1690	1770	349	2	80	0.0250000
NODE_150_length_5572_cov_79.124246	1690	1770	352	1	80	0.0125000
NODE_150_length_5572_cov_79.124246	1690	1770	353	1	80	0.0125000
NODE_150_length_5572_cov_79.124246	1690	1770	354	1	80	0.0125000
NODE_150_length_5572_cov_79.124246	1690	1770	356	1	80	0.0125000
NODE_150_length_5572_cov_79.124246	1690	1770	357	1	80	0.0125000
NODE_150_length_5572_cov_79.124246	1690	1770	358	2	80	0.0250000
NODE_150_length_5572_cov_79.124246	1690	1770	361	1	80	0.0125000
NODE_150_length_5572_cov_79.124246	1690	1770	362	1	80	0.0125000
NODE_150_length_5572_cov_79.124246	1690	1770	363	2	80	0.0250000
NODE_150_length_5572_cov_79.124246	1690	1770	364	3	80	0.0375000
NODE_150_length_5572_cov_79.124246	1690	1770	365	4	80	0.0500000
NODE_150_length_5572_cov_79.124246	1690	1770	366	1	80	0.0125000
NODE_150_length_5572_cov_79.124246	5130	5210	2	50	80	0.6250000
NODE_150_length_5572_cov_79.124246	5130	5210	4	30	80	0.3750000
NODE_150_length_5572_cov_79.124246	5183	5263	2	29	80	0.3625000
NODE_150_length_5572_cov_79.124246	5183	5263	3	51	80	0.6375000
NODE_151_length_5557_cov_26.198241	341	414	2	4	73	0.0547945
NODE_151_length_5557_cov_26.198241	341	414	3	14	73	0.1917808
NODE_151_length_5557_cov_26.198241	341	414	4	55	73	0.7534246
NODE_151_length_5557_cov_26.198241	394	460	2	31	66	0.4696970
NODE_151_length_5557_cov_26.198241	394	460	3	29	66	0.4393939
NODE_151_length_5557_cov_26.198241	394	460	4	6	66	0.0909091
NODE_156_length_5500_cov_35.832438	81	161	2	6	80	0.0750000
NODE_156_length_5500_cov_35.832438	81	161	4	74	80	0.9250000
NODE_156_length_5500_cov_35.832438	134	214	0	28	80	0.3500000
NODE_156_length_5500_cov_35.832438	134	214	2	13	80	0.1625000
NODE_156_length_5500_cov_35.832438	134	214	3	12	80	0.1500000
NODE_156_length_5500_cov_35.832438	134	214	4	27	80	0.3375000
NODE_159_length_5470_cov_5.987526	5180	5249	2	61	69	0.8840580
NODE_159_length_5470_cov_5.987526	5180	5249	3	2	69	0.0289855
NODE_159_length_5470_cov_5.987526	5180	5249	4	1	69	0.0144928
NODE_159_length_5470_cov_5.987526	5180	5249	6	5	69	0.0724638
NODE_160_length_5434_cov_14.997751	541	621	5	80	80	1.0000000
NODE_160_length_5434_cov_14.997751	594	674	0	13	80	0.1625000
NODE_160_length_5434_cov_14.997751	594	674	1	8	80	0.1000000
NODE_160_length_5434_cov_14.997751	594	674	3	6	80	0.0750000
NODE_160_length_5434_cov_14.997751	594	674	5	53	80	0.6625000
NODE_160_length_5434_cov_14.997751	2664	2744	4	5	80	0.0625000
NODE_160_length_5434_cov_14.997751	2664	2744	5	47	80	0.5875000
NODE_160_length_5434_cov_14.997751	2664	2744	6	28	80	0.3500000
NODE_160_length_5434_cov_14.997751	2717	2797	5	46	80	0.5750000
NODE_160_length_5434_cov_14.997751	2717	2797	6	24	80	0.3000000
NODE_160_length_5434_cov_14.997751	2717	2797	7	10	80	0.1250000
NODE_160_length_5434_cov_14.997751	3041	3093	3	6	52	0.1153846
NODE_160_length_5434_cov_14.997751	3041	3093	4	46	52	0.8846154
NODE_160_length_5434_cov_14.997751	3419	3467	12	8	48	0.1666667
NODE_160_length_5434_cov_14.997751	3419	3467	13	17	48	0.3541667
NODE_160_length_5434_cov_14.997751	3419	3467	14	18	48	0.3750000
NODE_160_length_5434_cov_14.997751	3419	3467	15	5	48	0.1041667
NODE_161_length_5425_cov_15.812242	141	218	65	1	77	0.0129870
NODE_161_length_5425_cov_15.812242	141	218	66	7	77	0.0909091
NODE_161_length_5425_cov_15.812242	141	218	67	9	77	0.1168831
NODE_161_length_5425_cov_15.812242	141	218	68	4	77	0.0519481
NODE_161_length_5425_cov_15.812242	141	218	69	7	77	0.0909091
NODE_161_length_5425_cov_15.812242	141	218	71	1	77	0.0129870
NODE_161_length_5425_cov_15.812242	141	218	72	4	77	0.0519481
NODE_161_length_5425_cov_15.812242	141	218	73	3	77	0.0389610
NODE_161_length_5425_cov_15.812242	141	218	74	1	77	0.0129870
NODE_161_length_5425_cov_15.812242	141	218	75	2	77	0.0259740
NODE_161_length_5425_cov_15.812242	141	218	76	1	77	0.0129870
NODE_161_length_5425_cov_15.812242	141	218	77	3	77	0.0389610
NODE_161_length_5425_cov_15.812242	141	218	78	1	77	0.0129870
NODE_161_length_5425_cov_15.812242	141	218	82	1	77	0.0129870
NODE_161_length_5425_cov_15.812242	141	218	83	2	77	0.0259740
NODE_161_length_5425_cov_15.812242	141	218	84	3	77	0.0389610
NODE_161_length_5425_cov_15.812242	141	218	85	5	77	0.0649351
NODE_161_length_5425_cov_15.812242	141	218	86	3	77	0.0389610
NODE_161_length_5425_cov_15.812242	141	218	91	1	77	0.0129870
NODE_161_length_5425_cov_15.812242	141	218	93	1	77	0.0129870
NODE_161_length_5425_cov_15.812242	141	218	95	4	77	0.0519481
NODE_161_length_5425_cov_15.812242	141	218	96	3	77	0.0389610
NODE_161_length_5425_cov_15.812242	141	218	97	4	77	0.0519481
NODE_161_length_5425_cov_15.812242	141	218	98	2	77	0.0259740
NODE_161_length_5425_cov_15.812242	141	218	99	2	77	0.0259740
NODE_161_length_5425_cov_15.812242	141	218	100	2	77	0.0259740
NODE_161_length_5425_cov_15.812242	841	921	6	50	80	0.6250000
NODE_161_length_5425_cov_15.812242	841	921	7	16	80	0.2000000
NODE_161_length_5425_cov_15.812242	841	921	8	14	80	0.1750000
NODE_161_length_5425_cov_15.812242	894	974	1	6	80	0.0750000
NODE_161_length_5425_cov_15.812242	894	974	2	22	80	0.2750000
NODE_161_length_5425_cov_15.812242	894	974	5	22	80	0.2750000
NODE_161_length_5425_cov_15.812242	894	974	6	30	80	0.3750000
NODE_163_length_5402_cov_5.397322	191	263	8	12	72	0.1666667
NODE_163_length_5402_cov_5.397322	191	263	9	11	72	0.1527778
NODE_163_length_5402_cov_5.397322	191	263	10	49	72	0.6805556
NODE_163_length_5402_cov_5.397322	2305	2385	27	2	80	0.0250000
NODE_163_length_5402_cov_5.397322	2305	2385	28	3	80	0.0375000
NODE_163_length_5402_cov_5.397322	2305	2385	29	32	80	0.4000000
NODE_163_length_5402_cov_5.397322	2305	2385	30	22	80	0.2750000
NODE_163_length_5402_cov_5.397322	2305	2385	31	2	80	0.0250000
NODE_163_length_5402_cov_5.397322	2305	2385	33	5	80	0.0625000
NODE_163_length_5402_cov_5.397322	2305	2385	34	12	80	0.1500000
NODE_163_length_5402_cov_5.397322	2305	2385	35	2	80	0.0250000
NODE_163_length_5402_cov_5.397322	2358	2438	23	6	80	0.0750000
NODE_163_length_5402_cov_5.397322	2358	2438	24	2	80	0.0250000
NODE_163_length_5402_cov_5.397322	2358	2438	25	3	80	0.0375000
NODE_163_length_5402_cov_5.397322	2358	2438	26	6	80	0.0750000
NODE_163_length_5402_cov_5.397322	2358	2438	27	7	80	0.0875000
NODE_163_length_5402_cov_5.397322	2358	2438	28	23	80	0.2875000
NODE_163_length_5402_cov_5.397322	2358	2438	29	20	80	0.2500000
NODE_163_length_5402_cov_5.397322	2358	2438	30	5	80	0.0625000
NODE_163_length_5402_cov_5.397322	2358	2438	33	3	80	0.0375000
NODE_163_length_5402_cov_5.397322	2358	2438	34	3	80	0.0375000
NODE_163_length_5402_cov_5.397322	2358	2438	35	2	80	0.0250000
NODE_164_length_5383_cov_15.680545	205	285	3	1	80	0.0125000
NODE_164_length_5383_cov_15.680545	205	285	5	41	80	0.5125000
NODE_164_length_5383_cov_15.680545	205	285	7	38	80	0.4750000
NODE_164_length_5383_cov_15.680545	258	317	2	13	59	0.2203390
NODE_164_length_5383_cov_15.680545	258	317	3	20	59	0.3389831
NODE_164_length_5383_cov_15.680545	258	317	5	26	59	0.4406780
NODE_164_length_5383_cov_15.680545	2042	2122	18	2	80	0.0250000
NODE_164_length_5383_cov_15.680545	2042	2122	19	34	80	0.4250000
NODE_164_length_5383_cov_15.680545	2042	2122	20	34	80	0.4250000
NODE_164_length_5383_cov_15.680545	2042	2122	21	10	80	0.1250000
NODE_164_length_5383_cov_15.680545	2095	2175	6	8	80	0.1000000
NODE_164_length_5383_cov_15.680545	2095	2175	7	3	80	0.0375000
NODE_164_length_5383_cov_15.680545	2095	2175	8	12	80	0.1500000
NODE_164_length_5383_cov_15.680545	2095	2175	9	2	80	0.0250000
NODE_164_length_5383_cov_15.680545	2095	2175	10	2	80	0.0250000
NODE_164_length_5383_cov_15.680545	2095	2175	11	4	80	0.0500000
NODE_164_length_5383_cov_15.680545	2095	2175	12	1	80	0.0125000
NODE_164_length_5383_cov_15.680545	2095	2175	13	6	80	0.0750000
NODE_164_length_5383_cov_15.680545	2095	2175	14	1	80	0.0125000
NODE_164_length_5383_cov_15.680545	2095	2175	15	5	80	0.0625000
NODE_164_length_5383_cov_15.680545	2095	2175	16	2	80	0.0250000
NODE_164_length_5383_cov_15.680545	2095	2175	17	1	80	0.0125000
NODE_164_length_5383_cov_15.680545	2095	2175	19	30	80	0.3750000
NODE_164_length_5383_cov_15.680545	2095	2175	20	3	80	0.0375000
NODE_165_length_5382_cov_16.894378	1301	1347	16	3	46	0.0652174
NODE_165_length_5382_cov_16.894378	1301	1347	17	2	46	0.0434783
NODE_165_length_5382_cov_16.894378	1301	1347	18	5	46	0.1086956
NODE_165_length_5382_cov_16.894378	1301	1347	19	11	46	0.2391304
NODE_165_length_5382_cov_16.894378	1301	1347	20	6	46	0.1304348
NODE_165_length_5382_cov_16.894378	1301	1347	21	6	46	0.1304348
NODE_165_length_5382_cov_16.894378	1301	1347	22	9	46	0.1956522
NODE_165_length_5382_cov_16.894378	1301	1347	23	2	46	0.0434783
NODE_165_length_5382_cov_16.894378	1301	1347	25	1	46	0.0217391
NODE_165_length_5382_cov_16.894378	1301	1347	27	1	46	0.0217391
NODE_165_length_5382_cov_16.894378	5056	5082	162	1	26	0.0384615
NODE_165_length_5382_cov_16.894378	5056	5082	164	1	26	0.0384615
NODE_165_length_5382_cov_16.894378	5056	5082	165	2	26	0.0769231
NODE_165_length_5382_cov_16.894378	5056	5082	166	4	26	0.1538462
NODE_165_length_5382_cov_16.894378	5056	5082	167	1	26	0.0384615
NODE_165_length_5382_cov_16.894378	5056	5082	168	2	26	0.0769231
NODE_165_length_5382_cov_16.894378	5056	5082	169	1	26	0.0384615
NODE_165_length_5382_cov_16.894378	5056	5082	173	1	26	0.0384615
NODE_165_length_5382_cov_16.894378	5056	5082	174	2	26	0.0769231
NODE_165_length_5382_cov_16.894378	5056	5082	175	2	26	0.0769231
NODE_165_length_5382_cov_16.894378	5056	5082	176	2	26	0.0769231
NODE_165_length_5382_cov_16.894378	5056	5082	177	1	26	0.0384615
NODE_165_length_5382_cov_16.894378	5056	5082	181	1	26	0.0384615
NODE_165_length_5382_cov_16.894378	5056	5082	185	1	26	0.0384615
NODE_165_length_5382_cov_16.894378	5056	5082	188	1	26	0.0384615
NODE_165_length_5382_cov_16.894378	5056	5082	196	1	26	0.0384615
NODE_165_length_5382_cov_16.894378	5056	5082	197	1	26	0.0384615
NODE_165_length_5382_cov_16.894378	5056	5082	200	1	26	0.0384615
NODE_165_length_5382_cov_16.894378	5056	5115	162	1	59	0.0169492
NODE_165_length_5382_cov_16.894378	5056	5115	164	1	59	0.0169492
NODE_165_length_5382_cov_16.894378	5056	5115	165	2	59	0.0338983
NODE_165_length_5382_cov_16.894378	5056	5115	166	4	59	0.0677966
NODE_165_length_5382_cov_16.894378	5056	5115	167	1	59	0.0169492
NODE_165_length_5382_cov_16.894378	5056	5115	168	2	59	0.0338983
NODE_165_length_5382_cov_16.894378	5056	5115	169	1	59	0.0169492
NODE_165_length_5382_cov_16.894378	5056	5115	173	1	59	0.0169492
NODE_165_length_5382_cov_16.894378	5056	5115	174	2	59	0.0338983
NODE_165_length_5382_cov_16.894378	5056	5115	175	2	59	0.0338983
NODE_165_length_5382_cov_16.894378	5056	5115	176	2	59	0.0338983
NODE_165_length_5382_cov_16.894378	5056	5115	177	1	59	0.0169492
NODE_165_length_5382_cov_16.894378	5056	5115	181	1	59	0.0169492
NODE_165_length_5382_cov_16.894378	5056	5115	185	1	59	0.0169492
NODE_165_length_5382_cov_16.894378	5056	5115	188	1	59	0.0169492
NODE_165_length_5382_cov_16.894378	5056	5115	196	1	59	0.0169492
NODE_165_length_5382_cov_16.894378	5056	5115	197	1	59	0.0169492
NODE_165_length_5382_cov_16.894378	5056	5115	200	1	59	0.0169492
NODE_165_length_5382_cov_16.894378	5056	5115	201	5	59	0.0847458
NODE_165_length_5382_cov_16.894378	5056	5115	202	1	59	0.0169492
NODE_165_length_5382_cov_16.894378	5056	5115	203	2	59	0.0338983
NODE_165_length_5382_cov_16.894378	5056	5115	204	1	59	0.0169492
NODE_165_length_5382_cov_16.894378	5056	5115	205	1	59	0.0169492
NODE_165_length_5382_cov_16.894378	5056	5115	206	1	59	0.0169492
NODE_165_length_5382_cov_16.894378	5056	5115	216	2	59	0.0338983
NODE_165_length_5382_cov_16.894378	5056	5115	217	1	59	0.0169492
NODE_165_length_5382_cov_16.894378	5056	5115	218	4	59	0.0677966
NODE_165_length_5382_cov_16.894378	5056	5115	219	1	59	0.0169492
NODE_165_length_5382_cov_16.894378	5056	5115	220	2	59	0.0338983
NODE_165_length_5382_cov_16.894378	5056	5115	221	2	59	0.0338983
NODE_165_length_5382_cov_16.894378	5056	5115	226	1	59	0.0169492
NODE_165_length_5382_cov_16.894378	5056	5115	228	1	59	0.0169492
NODE_165_length_5382_cov_16.894378	5056	5115	231	2	59	0.0338983
NODE_165_length_5382_cov_16.894378	5056	5115	234	3	59	0.0508475
NODE_165_length_5382_cov_16.894378	5056	5115	235	1	59	0.0169492
NODE_165_length_5382_cov_16.894378	5056	5115	238	1	59	0.0169492
NODE_165_length_5382_cov_16.894378	5056	5115	242	1	59	0.0169492
NODE_167_length_5339_cov_28.708969	3375	3455	2	7	80	0.0875000
NODE_167_length_5339_cov_28.708969	3375	3455	4	15	80	0.1875000
NODE_167_length_5339_cov_28.708969	3375	3455	6	10	80	0.1250000
NODE_167_length_5339_cov_28.708969	3375	3455	7	26	80	0.3250000
NODE_167_length_5339_cov_28.708969	3375	3455	8	8	80	0.1000000
NODE_167_length_5339_cov_28.708969	3375	3455	9	13	80	0.1625000
NODE_167_length_5339_cov_28.708969	3375	3455	10	1	80	0.0125000
NODE_167_length_5339_cov_28.708969	3428	3508	7	5	80	0.0625000
NODE_167_length_5339_cov_28.708969	3428	3508	8	8	80	0.1000000
NODE_167_length_5339_cov_28.708969	3428	3508	9	13	80	0.1625000
NODE_167_length_5339_cov_28.708969	3428	3508	10	1	80	0.0125000
NODE_167_length_5339_cov_28.708969	3428	3508	11	44	80	0.5500000
NODE_167_length_5339_cov_28.708969	3428	3508	12	9	80	0.1125000
NODE_168_length_5336_cov_33.036471	3109	3189	39	3	80	0.0375000
NODE_168_length_5336_cov_33.036471	3109	3189	40	2	80	0.0250000
NODE_168_length_5336_cov_33.036471	3109	3189	41	1	80	0.0125000
NODE_168_length_5336_cov_33.036471	3109	3189	42	1	80	0.0125000
NODE_168_length_5336_cov_33.036471	3109	3189	44	4	80	0.0500000
NODE_168_length_5336_cov_33.036471	3109	3189	45	8	80	0.1000000
NODE_168_length_5336_cov_33.036471	3109	3189	46	2	80	0.0250000
NODE_168_length_5336_cov_33.036471	3109	3189	47	9	80	0.1125000
NODE_168_length_5336_cov_33.036471	3109	3189	48	7	80	0.0875000
NODE_168_length_5336_cov_33.036471	3109	3189	49	4	80	0.0500000
NODE_168_length_5336_cov_33.036471	3109	3189	50	8	80	0.1000000
NODE_168_length_5336_cov_33.036471	3109	3189	51	4	80	0.0500000
NODE_168_length_5336_cov_33.036471	3109	3189	52	9	80	0.1125000
NODE_168_length_5336_cov_33.036471	3109	3189	53	14	80	0.1750000
NODE_168_length_5336_cov_33.036471	3109	3189	54	4	80	0.0500000
NODE_168_length_5336_cov_33.036471	3162	3242	33	3	80	0.0375000
NODE_168_length_5336_cov_33.036471	3162	3242	34	3	80	0.0375000
NODE_168_length_5336_cov_33.036471	3162	3242	35	2	80	0.0250000
NODE_168_length_5336_cov_33.036471	3162	3242	36	2	80	0.0250000
NODE_168_length_5336_cov_33.036471	3162	3242	37	1	80	0.0125000
NODE_168_length_5336_cov_33.036471	3162	3242	39	8	80	0.1000000
NODE_168_length_5336_cov_33.036471	3162	3242	40	2	80	0.0250000
NODE_168_length_5336_cov_33.036471	3162	3242	41	1	80	0.0125000
NODE_168_length_5336_cov_33.036471	3162	3242	43	1	80	0.0125000
NODE_168_length_5336_cov_33.036471	3162	3242	44	1	80	0.0125000
NODE_168_length_5336_cov_33.036471	3162	3242	47	18	80	0.2250000
NODE_168_length_5336_cov_33.036471	3162	3242	48	7	80	0.0875000
NODE_168_length_5336_cov_33.036471	3162	3242	49	4	80	0.0500000
NODE_168_length_5336_cov_33.036471	3162	3242	50	4	80	0.0500000
NODE_168_length_5336_cov_33.036471	3162	3242	51	7	80	0.0875000
NODE_168_length_5336_cov_33.036471	3162	3242	52	3	80	0.0375000
NODE_168_length_5336_cov_33.036471	3162	3242	53	8	80	0.1000000
NODE_168_length_5336_cov_33.036471	3162	3242	54	2	80	0.0250000
NODE_168_length_5336_cov_33.036471	3162	3242	55	3	80	0.0375000
NODE_179_length_5269_cov_23.392650	1905	1985	0	3	80	0.0375000
NODE_179_length_5269_cov_23.392650	1905	1985	1	31	80	0.3875000
NODE_179_length_5269_cov_23.392650	1905	1985	3	46	80	0.5750000
NODE_179_length_5269_cov_23.392650	1958	2038	1	25	80	0.3125000
NODE_179_length_5269_cov_23.392650	1958	2038	3	55	80	0.6875000
NODE_181_length_5207_cov_31.352780	4588	4668	1	17	80	0.2125000
NODE_181_length_5207_cov_31.352780	4588	4668	2	63	80	0.7875000
NODE_181_length_5207_cov_31.352780	4641	4721	2	40	80	0.5000000
NODE_181_length_5207_cov_31.352780	4641	4721	3	7	80	0.0875000
NODE_181_length_5207_cov_31.352780	4641	4721	4	33	80	0.4125000
NODE_183_length_5193_cov_14.930506	4659	4739	6	38	80	0.4750000
NODE_183_length_5193_cov_14.930506	4659	4739	7	7	80	0.0875000
NODE_183_length_5193_cov_14.930506	4659	4739	8	35	80	0.4375000
NODE_183_length_5193_cov_14.930506	4712	4792	6	42	80	0.5250000
NODE_183_length_5193_cov_14.930506	4712	4792	7	15	80	0.1875000
NODE_183_length_5193_cov_14.930506	4712	4792	8	23	80	0.2875000
NODE_183_length_5193_cov_14.930506	4788	4868	4	44	80	0.5500000
NODE_183_length_5193_cov_14.930506	4788	4868	5	8	80	0.1000000
NODE_183_length_5193_cov_14.930506	4788	4868	6	18	80	0.2250000
NODE_183_length_5193_cov_14.930506	4788	4868	7	10	80	0.1250000
NODE_183_length_5193_cov_14.930506	4841	4921	2	38	80	0.4750000
NODE_183_length_5193_cov_14.930506	4841	4921	4	42	80	0.5250000
NODE_186_length_5159_cov_261.593676	158	227	144	1	69	0.0144928
NODE_186_length_5159_cov_261.593676	158	227	146	1	69	0.0144928
NODE_186_length_5159_cov_261.593676	158	227	147	1	69	0.0144928
NODE_186_length_5159_cov_261.593676	158	227	149	1	69	0.0144928
NODE_186_length_5159_cov_261.593676	158	227	152	3	69	0.0434783
NODE_186_length_5159_cov_261.593676	158	227	153	4	69	0.0579710
NODE_186_length_5159_cov_261.593676	158	227	154	6	69	0.0869565
NODE_186_length_5159_cov_261.593676	158	227	155	4	69	0.0579710
NODE_186_length_5159_cov_261.593676	158	227	156	4	69	0.0579710
NODE_186_length_5159_cov_261.593676	158	227	157	8	69	0.1159420
NODE_186_length_5159_cov_261.593676	158	227	158	3	69	0.0434783
NODE_186_length_5159_cov_261.593676	158	227	160	1	69	0.0144928
NODE_186_length_5159_cov_261.593676	158	227	161	2	69	0.0289855
NODE_186_length_5159_cov_261.593676	158	227	162	1	69	0.0144928
NODE_186_length_5159_cov_261.593676	158	227	164	2	69	0.0289855
NODE_186_length_5159_cov_261.593676	158	227	165	1	69	0.0144928
NODE_186_length_5159_cov_261.593676	158	227	167	1	69	0.0144928
NODE_186_length_5159_cov_261.593676	158	227	168	4	69	0.0579710
NODE_186_length_5159_cov_261.593676	158	227	169	3	69	0.0434783
NODE_186_length_5159_cov_261.593676	158	227	170	2	69	0.0289855
NODE_186_length_5159_cov_261.593676	158	227	171	4	69	0.0579710
NODE_186_length_5159_cov_261.593676	158	227	172	5	69	0.0724638
NODE_186_length_5159_cov_261.593676	158	227	173	2	69	0.0289855
NODE_186_length_5159_cov_261.593676	158	227	174	4	69	0.0579710
NODE_186_length_5159_cov_261.593676	158	227	175	1	69	0.0144928
NODE_189_length_5138_cov_31.467355	3004	3075	1	1	71	0.0140845
NODE_189_length_5138_cov_31.467355	3004	3075	11	1	71	0.0140845
NODE_189_length_5138_cov_31.467355	3004	3075	14	1	71	0.0140845
NODE_189_length_5138_cov_31.467355	3004	3075	17	1	71	0.0140845
NODE_189_length_5138_cov_31.467355	3004	3075	20	1	71	0.0140845
NODE_189_length_5138_cov_31.467355	3004	3075	22	1	71	0.0140845
NODE_189_length_5138_cov_31.467355	3004	3075	27	1	71	0.0140845
NODE_189_length_5138_cov_31.467355	3004	3075	28	1	71	0.0140845
NODE_189_length_5138_cov_31.467355	3004	3075	34	1	71	0.0140845
NODE_189_length_5138_cov_31.467355	3004	3075	38	3	71	0.0422535
NODE_189_length_5138_cov_31.467355	3004	3075	40	2	71	0.0281690
NODE_189_length_5138_cov_31.467355	3004	3075	41	1	71	0.0140845
NODE_189_length_5138_cov_31.467355	3004	3075	43	5	71	0.0704225
NODE_189_length_5138_cov_31.467355	3004	3075	46	1	71	0.0140845
NODE_189_length_5138_cov_31.467355	3004	3075	48	1	71	0.0140845
NODE_189_length_5138_cov_31.467355	3004	3075	50	1	71	0.0140845
NODE_189_length_5138_cov_31.467355	3004	3075	52	1	71	0.0140845
NODE_189_length_5138_cov_31.467355	3004	3075	55	1	71	0.0140845
NODE_189_length_5138_cov_31.467355	3004	3075	56	3	71	0.0422535
NODE_189_length_5138_cov_31.467355	3004	3075	60	1	71	0.0140845
NODE_189_length_5138_cov_31.467355	3004	3075	63	1	71	0.0140845
NODE_189_length_5138_cov_31.467355	3004	3075	66	2	71	0.0281690
NODE_189_length_5138_cov_31.467355	3004	3075	70	2	71	0.0281690
NODE_189_length_5138_cov_31.467355	3004	3075	72	2	71	0.0281690
NODE_189_length_5138_cov_31.467355	3004	3075	74	3	71	0.0422535
NODE_189_length_5138_cov_31.467355	3004	3075	75	1	71	0.0140845
NODE_189_length_5138_cov_31.467355	3004	3075	78	4	71	0.0563380
NODE_189_length_5138_cov_31.467355	3004	3075	79	1	71	0.0140845
NODE_189_length_5138_cov_31.467355	3004	3075	81	1	71	0.0140845
NODE_189_length_5138_cov_31.467355	3004	3075	82	1	71	0.0140845
NODE_189_length_5138_cov_31.467355	3004	3075	84	3	71	0.0422535
NODE_189_length_5138_cov_31.467355	3004	3075	87	1	71	0.0140845
NODE_189_length_5138_cov_31.467355	3004	3075	89	1	71	0.0140845
NODE_189_length_5138_cov_31.467355	3004	3075	92	1	71	0.0140845
NODE_189_length_5138_cov_31.467355	3004	3075	94	2	71	0.0281690
NODE_189_length_5138_cov_31.467355	3004	3075	96	1	71	0.0140845
NODE_189_length_5138_cov_31.467355	3004	3075	97	1	71	0.0140845
NODE_189_length_5138_cov_31.467355	3004	3075	98	1	71	0.0140845
NODE_189_length_5138_cov_31.467355	3004	3075	103	1	71	0.0140845
NODE_189_length_5138_cov_31.467355	3004	3075	104	3	71	0.0422535
NODE_189_length_5138_cov_31.467355	3004	3075	105	1	71	0.0140845
NODE_189_length_5138_cov_31.467355	3004	3075	106	1	71	0.0140845
NODE_189_length_5138_cov_31.467355	3004	3075	107	3	71	0.0422535
NODE_189_length_5138_cov_31.467355	3004	3075	108	1	71	0.0140845
NODE_189_length_5138_cov_31.467355	3004	3075	110	2	71	0.0281690
NODE_189_length_5138_cov_31.467355	3004	3075	115	1	71	0.0140845
NODE_191_length_5126_cov_5.900935	731	811	4	21	80	0.2625000
NODE_191_length_5126_cov_5.900935	731	811	5	48	80	0.6000000
NODE_191_length_5126_cov_5.900935	731	811	6	11	80	0.1375000
NODE_191_length_5126_cov_5.900935	784	864	2	7	80	0.0875000
NODE_191_length_5126_cov_5.900935	784	864	4	9	80	0.1125000
NODE_191_length_5126_cov_5.900935	784	864	5	49	80	0.6125000
NODE_191_length_5126_cov_5.900935	784	864	6	15	80	0.1875000
NODE_194_length_5102_cov_12.729962	367	447	9	30	80	0.3750000
NODE_194_length_5102_cov_12.729962	367	447	10	2	80	0.0250000
NODE_194_length_5102_cov_12.729962	367	447	11	48	80	0.6000000
NODE_194_length_5102_cov_12.729962	420	500	6	4	80	0.0500000
NODE_194_length_5102_cov_12.729962	420	500	8	36	80	0.4500000
NODE_194_length_5102_cov_12.729962	420	500	9	28	80	0.3500000
NODE_194_length_5102_cov_12.729962	420	500	10	1	80	0.0125000
NODE_194_length_5102_cov_12.729962	420	500	11	11	80	0.1375000
NODE_194_length_5102_cov_12.729962	496	576	2	38	80	0.4750000
NODE_194_length_5102_cov_12.729962	496	576	3	7	80	0.0875000
NODE_194_length_5102_cov_12.729962	496	576	4	25	80	0.3125000
NODE_194_length_5102_cov_12.729962	496	576	5	1	80	0.0125000
NODE_194_length_5102_cov_12.729962	496	576	6	9	80	0.1125000
NODE_194_length_5102_cov_12.729962	549	629	2	71	80	0.8875000
NODE_194_length_5102_cov_12.729962	549	629	3	1	80	0.0125000
NODE_194_length_5102_cov_12.729962	549	629	4	8	80	0.1000000
NODE_196_length_5079_cov_5.580522	875	940	21	1	65	0.0153846
NODE_196_length_5079_cov_5.580522	875	940	23	1	65	0.0153846
NODE_196_length_5079_cov_5.580522	875	940	24	7	65	0.1076923
NODE_196_length_5079_cov_5.580522	875	940	25	3	65	0.0461538
NODE_196_length_5079_cov_5.580522	875	940	26	2	65	0.0307692
NODE_196_length_5079_cov_5.580522	875	940	27	3	65	0.0461538
NODE_196_length_5079_cov_5.580522	875	940	28	5	65	0.0769231
NODE_196_length_5079_cov_5.580522	875	940	29	18	65	0.2769231
NODE_196_length_5079_cov_5.580522	875	940	30	1	65	0.0153846
NODE_196_length_5079_cov_5.580522	875	940	32	2	65	0.0307692
NODE_196_length_5079_cov_5.580522	875	940	33	7	65	0.1076923
NODE_196_length_5079_cov_5.580522	875	940	35	2	65	0.0307692
NODE_196_length_5079_cov_5.580522	875	940	36	1	65	0.0153846
NODE_196_length_5079_cov_5.580522	875	940	38	9	65	0.1384615
NODE_196_length_5079_cov_5.580522	875	940	39	3	65	0.0461538
NODE_197_length_5057_cov_16.348729	2929	3000	36	1	71	0.0140845
NODE_197_length_5057_cov_16.348729	2929	3000	37	1	71	0.0140845
NODE_197_length_5057_cov_16.348729	2929	3000	39	1	71	0.0140845
NODE_197_length_5057_cov_16.348729	2929	3000	42	2	71	0.0281690
NODE_197_length_5057_cov_16.348729	2929	3000	45	2	71	0.0281690
NODE_197_length_5057_cov_16.348729	2929	3000	48	2	71	0.0281690
NODE_197_length_5057_cov_16.348729	2929	3000	51	1	71	0.0140845
NODE_197_length_5057_cov_16.348729	2929	3000	53	1	71	0.0140845
NODE_197_length_5057_cov_16.348729	2929	3000	54	1	71	0.0140845
NODE_197_length_5057_cov_16.348729	2929	3000	56	2	71	0.0281690
NODE_197_length_5057_cov_16.348729	2929	3000	57	6	71	0.0845070
NODE_197_length_5057_cov_16.348729	2929	3000	60	1	71	0.0140845
NODE_197_length_5057_cov_16.348729	2929	3000	62	1	71	0.0140845
NODE_197_length_5057_cov_16.348729	2929	3000	65	3	71	0.0422535
NODE_197_length_5057_cov_16.348729	2929	3000	66	1	71	0.0140845
NODE_197_length_5057_cov_16.348729	2929	3000	68	1	71	0.0140845
NODE_197_length_5057_cov_16.348729	2929	3000	70	1	71	0.0140845
NODE_197_length_5057_cov_16.348729	2929	3000	72	2	71	0.0281690
NODE_197_length_5057_cov_16.348729	2929	3000	74	4	71	0.0563380
NODE_197_length_5057_cov_16.348729	2929	3000	75	5	71	0.0704225
NODE_197_length_5057_cov_16.348729	2929	3000	76	5	71	0.0704225
NODE_197_length_5057_cov_16.348729	2929	3000	77	2	71	0.0281690
NODE_197_length_5057_cov_16.348729	2929	3000	78	4	71	0.0563380
NODE_197_length_5057_cov_16.348729	2929	3000	80	7	71	0.0985916
NODE_197_length_5057_cov_16.348729	2929	3000	84	1	71	0.0140845
NODE_197_length_5057_cov_16.348729	2929	3000	85	1	71	0.0140845
NODE_197_length_5057_cov_16.348729	2929	3000	86	3	71	0.0422535
NODE_197_length_5057_cov_16.348729	2929	3000	87	4	71	0.0563380
NODE_197_length_5057_cov_16.348729	2929	3000	88	1	71	0.0140845
NODE_197_length_5057_cov_16.348729	2929	3000	89	4	71	0.0563380
NODE_197_length_5057_cov_16.348729	2973	3012	77	2	39	0.0512821
NODE_197_length_5057_cov_16.348729	2973	3012	78	4	39	0.1025641
NODE_197_length_5057_cov_16.348729	2973	3012	80	7	39	0.1794872
NODE_197_length_5057_cov_16.348729	2973	3012	84	1	39	0.0256410
NODE_197_length_5057_cov_16.348729	2973	3012	85	1	39	0.0256410
NODE_197_length_5057_cov_16.348729	2973	3012	86	3	39	0.0769231
NODE_197_length_5057_cov_16.348729	2973	3012	87	4	39	0.1025641
NODE_197_length_5057_cov_16.348729	2973	3012	88	1	39	0.0256410
NODE_197_length_5057_cov_16.348729	2973	3012	89	4	39	0.1025641
NODE_197_length_5057_cov_16.348729	2973	3012	95	1	39	0.0256410
NODE_197_length_5057_cov_16.348729	2973	3012	96	1	39	0.0256410
NODE_197_length_5057_cov_16.348729	2973	3012	97	1	39	0.0256410
NODE_197_length_5057_cov_16.348729	2973	3012	100	6	39	0.1538462
NODE_197_length_5057_cov_16.348729	2973	3012	102	1	39	0.0256410
NODE_197_length_5057_cov_16.348729	2973	3012	103	1	39	0.0256410
NODE_197_length_5057_cov_16.348729	2973	3012	108	1	39	0.0256410
NODE_198_length_5053_cov_11.281994	791	834	3	2	43	0.0465116
NODE_198_length_5053_cov_11.281994	791	834	5	41	43	0.9534883
NODE_198_length_5053_cov_11.281994	807	887	4	14	80	0.1750000
NODE_198_length_5053_cov_11.281994	807	887	5	66	80	0.8250000
NODE_198_length_5053_cov_11.281994	883	963	1	22	80	0.2750000
NODE_198_length_5053_cov_11.281994	883	963	3	47	80	0.5875000
NODE_198_length_5053_cov_11.281994	883	963	4	9	80	0.1125000
NODE_198_length_5053_cov_11.281994	883	963	5	2	80	0.0250000
NODE_198_length_5053_cov_11.281994	936	999	0	1	63	0.0158730
NODE_198_length_5053_cov_11.281994	936	999	1	57	63	0.9047619
NODE_198_length_5053_cov_11.281994	936	999	3	5	63	0.0793651
NODE_204_length_4906_cov_37.988350	3170	3251	16	4	81	0.0493827
NODE_204_length_4906_cov_37.988350	3170	3251	18	1	81	0.0123457
NODE_204_length_4906_cov_37.988350	3170	3251	20	1	81	0.0123457
NODE_204_length_4906_cov_37.988350	3170	3251	21	2	81	0.0246914
NODE_204_length_4906_cov_37.988350	3170	3251	24	1	81	0.0123457
NODE_204_length_4906_cov_37.988350	3170	3251	25	1	81	0.0123457
NODE_204_length_4906_cov_37.988350	3170	3251	26	1	81	0.0123457
NODE_204_length_4906_cov_37.988350	3170	3251	29	1	81	0.0123457
NODE_204_length_4906_cov_37.988350	3170	3251	34	5	81	0.0617284
NODE_204_length_4906_cov_37.988350	3170	3251	35	1	81	0.0123457
NODE_204_length_4906_cov_37.988350	3170	3251	36	2	81	0.0246914
NODE_204_length_4906_cov_37.988350	3170	3251	38	1	81	0.0123457
NODE_204_length_4906_cov_37.988350	3170	3251	40	1	81	0.0123457
NODE_204_length_4906_cov_37.988350	3170	3251	44	1	81	0.0123457
NODE_204_length_4906_cov_37.988350	3170	3251	45	1	81	0.0123457
NODE_204_length_4906_cov_37.988350	3170	3251	47	1	81	0.0123457
NODE_204_length_4906_cov_37.988350	3170	3251	54	1	81	0.0123457
NODE_204_length_4906_cov_37.988350	3170	3251	55	1	81	0.0123457
NODE_204_length_4906_cov_37.988350	3170	3251	59	1	81	0.0123457
NODE_204_length_4906_cov_37.988350	3170	3251	60	1	81	0.0123457
NODE_204_length_4906_cov_37.988350	3170	3251	63	4	81	0.0493827
NODE_204_length_4906_cov_37.988350	3170	3251	65	1	81	0.0123457
NODE_204_length_4906_cov_37.988350	3170	3251	66	2	81	0.0246914
NODE_204_length_4906_cov_37.988350	3170	3251	72	3	81	0.0370370
NODE_204_length_4906_cov_37.988350	3170	3251	76	1	81	0.0123457
NODE_204_length_4906_cov_37.988350	3170	3251	81	2	81	0.0246914
NODE_204_length_4906_cov_37.988350	3170	3251	82	1	81	0.0123457
NODE_204_length_4906_cov_37.988350	3170	3251	84	1	81	0.0123457
NODE_204_length_4906_cov_37.988350	3170	3251	92	1	81	0.0123457
NODE_204_length_4906_cov_37.988350	3170	3251	93	1	81	0.0123457
NODE_204_length_4906_cov_37.988350	3170	3251	95	1	81	0.0123457
NODE_204_length_4906_cov_37.988350	3170	3251	99	5	81	0.0617284
NODE_204_length_4906_cov_37.988350	3170	3251	100	1	81	0.0123457
NODE_204_length_4906_cov_37.988350	3170	3251	101	2	81	0.0246914
NODE_204_length_4906_cov_37.988350	3170	3251	102	1	81	0.0123457
NODE_204_length_4906_cov_37.988350	3170	3251	107	1	81	0.0123457
NODE_204_length_4906_cov_37.988350	3170	3251	108	1	81	0.0123457
NODE_204_length_4906_cov_37.988350	3170	3251	111	2	81	0.0246914
NODE_204_length_4906_cov_37.988350	3170	3251	117	1	81	0.0123457
NODE_204_length_4906_cov_37.988350	3170	3251	119	1	81	0.0123457
NODE_204_length_4906_cov_37.988350	3170	3251	126	1	81	0.0123457
NODE_204_length_4906_cov_37.988350	3170	3251	128	1	81	0.0123457
NODE_204_length_4906_cov_37.988350	3170	3251	129	1	81	0.0123457
NODE_204_length_4906_cov_37.988350	3170	3251	131	3	81	0.0370370
NODE_204_length_4906_cov_37.988350	3170	3251	133	1	81	0.0123457
NODE_204_length_4906_cov_37.988350	3170	3251	134	2	81	0.0246914
NODE_204_length_4906_cov_37.988350	3170	3251	136	1	81	0.0123457
NODE_204_length_4906_cov_37.988350	3170	3251	138	1	81	0.0123457
NODE_204_length_4906_cov_37.988350	3170	3251	140	2	81	0.0246914
NODE_204_length_4906_cov_37.988350	3170	3251	141	1	81	0.0123457
NODE_204_length_4906_cov_37.988350	3170	3251	143	1	81	0.0123457
NODE_204_length_4906_cov_37.988350	3170	3251	145	1	81	0.0123457
NODE_204_length_4906_cov_37.988350	3170	3251	146	1	81	0.0123457
NODE_204_length_4906_cov_37.988350	3170	3251	147	1	81	0.0123457
NODE_204_length_4906_cov_37.988350	3170	3251	148	1	81	0.0123457
NODE_205_length_4888_cov_60.162247	4029	4068	2	37	39	0.9487180
NODE_205_length_4888_cov_60.162247	4029	4068	4	2	39	0.0512821
NODE_205_length_4888_cov_60.162247	4041	4121	2	80	80	1.0000000
NODE_207_length_4875_cov_63.035176	2905	2985	2	20	80	0.2500000
NODE_207_length_4875_cov_63.035176	2905	2985	3	35	80	0.4375000
NODE_207_length_4875_cov_63.035176	2905	2985	4	4	80	0.0500000
NODE_207_length_4875_cov_63.035176	2905	2985	5	13	80	0.1625000
NODE_207_length_4875_cov_63.035176	2905	2985	6	3	80	0.0375000
NODE_207_length_4875_cov_63.035176	2905	2985	7	5	80	0.0625000
NODE_207_length_4875_cov_63.035176	2958	3038	3	2	80	0.0250000
NODE_207_length_4875_cov_63.035176	2958	3038	4	4	80	0.0500000
NODE_207_length_4875_cov_63.035176	2958	3038	5	13	80	0.1625000
NODE_207_length_4875_cov_63.035176	2958	3038	6	3	80	0.0375000
NODE_207_length_4875_cov_63.035176	2958	3038	7	5	80	0.0625000
NODE_207_length_4875_cov_63.035176	2958	3038	8	15	80	0.1875000
NODE_207_length_4875_cov_63.035176	2958	3038	9	5	80	0.0625000
NODE_207_length_4875_cov_63.035176	2958	3038	10	3	80	0.0375000
NODE_207_length_4875_cov_63.035176	2958	3038	11	5	80	0.0625000
NODE_207_length_4875_cov_63.035176	2958	3038	14	6	80	0.0750000
NODE_207_length_4875_cov_63.035176	2958	3038	16	2	80	0.0250000
NODE_207_length_4875_cov_63.035176	2958	3038	17	4	80	0.0500000
NODE_207_length_4875_cov_63.035176	2958	3038	19	1	80	0.0125000
NODE_207_length_4875_cov_63.035176	2958	3038	20	1	80	0.0125000
NODE_207_length_4875_cov_63.035176	2958	3038	21	7	80	0.0875000
NODE_207_length_4875_cov_63.035176	2958	3038	22	1	80	0.0125000
NODE_207_length_4875_cov_63.035176	2958	3038	23	3	80	0.0375000
NODE_208_length_4875_cov_8.996859	4683	4760	1	4	77	0.0519481
NODE_208_length_4875_cov_8.996859	4683	4760	2	73	77	0.9480519
NODE_208_length_4875_cov_8.996859	4736	4813	1	21	77	0.2727273
NODE_208_length_4875_cov_8.996859	4736	4813	2	56	77	0.7272727
NODE_211_length_4827_cov_15.364636	1803	1865	44	2	62	0.0322581
NODE_211_length_4827_cov_15.364636	1803	1865	45	2	62	0.0322581
NODE_211_length_4827_cov_15.364636	1803	1865	46	9	62	0.1451613
NODE_211_length_4827_cov_15.364636	1803	1865	47	2	62	0.0322581
NODE_211_length_4827_cov_15.364636	1803	1865	48	1	62	0.0161290
NODE_211_length_4827_cov_15.364636	1803	1865	49	7	62	0.1129032
NODE_211_length_4827_cov_15.364636	1803	1865	50	5	62	0.0806452
NODE_211_length_4827_cov_15.364636	1803	1865	51	6	62	0.0967742
NODE_211_length_4827_cov_15.364636	1803	1865	52	3	62	0.0483871
NODE_211_length_4827_cov_15.364636	1803	1865	53	2	62	0.0322581
NODE_211_length_4827_cov_15.364636	1803	1865	54	6	62	0.0967742
NODE_211_length_4827_cov_15.364636	1803	1865	55	4	62	0.0645161
NODE_211_length_4827_cov_15.364636	1803	1865	56	1	62	0.0161290
NODE_211_length_4827_cov_15.364636	1803	1865	57	4	62	0.0645161
NODE_211_length_4827_cov_15.364636	1803	1865	58	3	62	0.0483871
NODE_211_length_4827_cov_15.364636	1803	1865	59	1	62	0.0161290
NODE_211_length_4827_cov_15.364636	1803	1865	60	4	62	0.0645161
NODE_211_length_4827_cov_15.364636	1899	1979	39	4	80	0.0500000
NODE_211_length_4827_cov_15.364636	1899	1979	40	1	80	0.0125000
NODE_211_length_4827_cov_15.364636	1899	1979	41	14	80	0.1750000
NODE_211_length_4827_cov_15.364636	1899	1979	42	1	80	0.0125000
NODE_211_length_4827_cov_15.364636	1899	1979	43	3	80	0.0375000
NODE_211_length_4827_cov_15.364636	1899	1979	44	9	80	0.1125000
NODE_211_length_4827_cov_15.364636	1899	1979	45	16	80	0.2000000
NODE_211_length_4827_cov_15.364636	1899	1979	46	8	80	0.1000000
NODE_211_length_4827_cov_15.364636	1899	1979	47	7	80	0.0875000
NODE_211_length_4827_cov_15.364636	1899	1979	48	10	80	0.1250000
NODE_211_length_4827_cov_15.364636	1899	1979	49	3	80	0.0375000
NODE_211_length_4827_cov_15.364636	1899	1979	50	4	80	0.0500000
NODE_211_length_4827_cov_15.364636	1952	1996	33	2	44	0.0454545
NODE_211_length_4827_cov_15.364636	1952	1996	34	2	44	0.0454545
NODE_211_length_4827_cov_15.364636	1952	1996	35	3	44	0.0681818
NODE_211_length_4827_cov_15.364636	1952	1996	38	8	44	0.1818182
NODE_211_length_4827_cov_15.364636	1952	1996	39	5	44	0.1136364
NODE_211_length_4827_cov_15.364636	1952	1996	40	1	44	0.0227273
NODE_211_length_4827_cov_15.364636	1952	1996	41	15	44	0.3409091
NODE_211_length_4827_cov_15.364636	1952	1996	42	1	44	0.0227273
NODE_211_length_4827_cov_15.364636	1952	1996	43	2	44	0.0454545
NODE_211_length_4827_cov_15.364636	1952	1996	44	5	44	0.1136364
NODE_212_length_4821_cov_10.856840	999	1061	3	6	62	0.0967742
NODE_212_length_4821_cov_10.856840	999	1061	4	19	62	0.3064516
NODE_212_length_4821_cov_10.856840	999	1061	5	21	62	0.3387097
NODE_212_length_4821_cov_10.856840	999	1061	6	12	62	0.1935484
NODE_212_length_4821_cov_10.856840	999	1061	7	4	62	0.0645161
NODE_213_length_4819_cov_16.363347	2392	2461	8	16	69	0.2318841
NODE_213_length_4819_cov_16.363347	2392	2461	12	9	69	0.1304348
NODE_213_length_4819_cov_16.363347	2392	2461	14	10	69	0.1449275
NODE_213_length_4819_cov_16.363347	2392	2461	15	4	69	0.0579710
NODE_213_length_4819_cov_16.363347	2392	2461	16	30	69	0.4347826
NODE_217_length_4794_cov_14.912886	657	737	66	1	80	0.0125000
NODE_217_length_4794_cov_14.912886	657	737	67	3	80	0.0375000
NODE_217_length_4794_cov_14.912886	657	737	68	1	80	0.0125000
NODE_217_length_4794_cov_14.912886	657	737	70	1	80	0.0125000
NODE_217_length_4794_cov_14.912886	657	737	71	1	80	0.0125000
NODE_217_length_4794_cov_14.912886	657	737	72	1	80	0.0125000
NODE_217_length_4794_cov_14.912886	657	737	73	1	80	0.0125000
NODE_217_length_4794_cov_14.912886	657	737	74	1	80	0.0125000
NODE_217_length_4794_cov_14.912886	657	737	75	2	80	0.0250000
NODE_217_length_4794_cov_14.912886	657	737	77	4	80	0.0500000
NODE_217_length_4794_cov_14.912886	657	737	78	1	80	0.0125000
NODE_217_length_4794_cov_14.912886	657	737	80	3	80	0.0375000
NODE_217_length_4794_cov_14.912886	657	737	81	3	80	0.0375000
NODE_217_length_4794_cov_14.912886	657	737	83	1	80	0.0125000
NODE_217_length_4794_cov_14.912886	657	737	84	1	80	0.0125000
NODE_217_length_4794_cov_14.912886	657	737	89	2	80	0.0250000
NODE_217_length_4794_cov_14.912886	657	737	93	2	80	0.0250000
NODE_217_length_4794_cov_14.912886	657	737	95	1	80	0.0125000
NODE_217_length_4794_cov_14.912886	657	737	97	2	80	0.0250000
NODE_217_length_4794_cov_14.912886	657	737	110	2	80	0.0250000
NODE_217_length_4794_cov_14.912886	657	737	111	1	80	0.0125000
NODE_217_length_4794_cov_14.912886	657	737	113	1	80	0.0125000
NODE_217_length_4794_cov_14.912886	657	737	114	3	80	0.0375000
NODE_217_length_4794_cov_14.912886	657	737	117	2	80	0.0250000
NODE_217_length_4794_cov_14.912886	657	737	120	1	80	0.0125000
NODE_217_length_4794_cov_14.912886	657	737	121	1	80	0.0125000
NODE_217_length_4794_cov_14.912886	657	737	123	1	80	0.0125000
NODE_217_length_4794_cov_14.912886	657	737	128	1	80	0.0125000
NODE_217_length_4794_cov_14.912886	657	737	129	2	80	0.0250000
NODE_217_length_4794_cov_14.912886	657	737	132	2	80	0.0250000
NODE_217_length_4794_cov_14.912886	657	737	133	1	80	0.0125000
NODE_217_length_4794_cov_14.912886	657	737	136	1	80	0.0125000
NODE_217_length_4794_cov_14.912886	657	737	137	2	80	0.0250000
NODE_217_length_4794_cov_14.912886	657	737	138	1	80	0.0125000
NODE_217_length_4794_cov_14.912886	657	737	141	2	80	0.0250000
NODE_217_length_4794_cov_14.912886	657	737	143	1	80	0.0125000
NODE_217_length_4794_cov_14.912886	657	737	145	2	80	0.0250000
NODE_217_length_4794_cov_14.912886	657	737	146	1	80	0.0125000
NODE_217_length_4794_cov_14.912886	657	737	149	1	80	0.0125000
NODE_217_length_4794_cov_14.912886	657	737	151	1	80	0.0125000
NODE_217_length_4794_cov_14.912886	657	737	153	1	80	0.0125000
NODE_217_length_4794_cov_14.912886	657	737	154	2	80	0.0250000
NODE_217_length_4794_cov_14.912886	657	737	156	1	80	0.0125000
NODE_217_length_4794_cov_14.912886	657	737	157	1	80	0.0125000
NODE_217_length_4794_cov_14.912886	657	737	158	3	80	0.0375000
NODE_217_length_4794_cov_14.912886	657	737	160	2	80	0.0250000
NODE_217_length_4794_cov_14.912886	657	737	161	1	80	0.0125000
NODE_217_length_4794_cov_14.912886	657	737	168	1	80	0.0125000
NODE_217_length_4794_cov_14.912886	657	737	170	1	80	0.0125000
NODE_217_length_4794_cov_14.912886	657	737	175	1	80	0.0125000
NODE_217_length_4794_cov_14.912886	657	737	176	1	80	0.0125000
NODE_217_length_4794_cov_14.912886	657	737	179	1	80	0.0125000
NODE_217_length_4794_cov_14.912886	657	737	180	1	80	0.0125000
NODE_217_length_4794_cov_14.912886	657	737	182	1	80	0.0125000
NODE_217_length_4794_cov_14.912886	4240	4312	11	10	72	0.1388889
NODE_217_length_4794_cov_14.912886	4240	4312	12	23	72	0.3194444
NODE_217_length_4794_cov_14.912886	4240	4312	13	2	72	0.0277778
NODE_217_length_4794_cov_14.912886	4240	4312	14	17	72	0.2361111
NODE_217_length_4794_cov_14.912886	4240	4312	15	20	72	0.2777778
NODE_217_length_4794_cov_14.912886	4293	4312	14	7	19	0.3684210
NODE_217_length_4794_cov_14.912886	4293	4312	15	12	19	0.6315789
NODE_217_length_4794_cov_14.912886	4345	4408	7	1	63	0.0158730
NODE_217_length_4794_cov_14.912886	4345	4408	8	7	63	0.1111111
NODE_217_length_4794_cov_14.912886	4345	4408	9	17	63	0.2698413
NODE_217_length_4794_cov_14.912886	4345	4408	10	2	63	0.0317460
NODE_217_length_4794_cov_14.912886	4345	4408	11	8	63	0.1269841
NODE_217_length_4794_cov_14.912886	4345	4408	12	9	63	0.1428571
NODE_217_length_4794_cov_14.912886	4345	4408	13	6	63	0.0952381
NODE_217_length_4794_cov_14.912886	4345	4408	14	13	63	0.2063492
NODE_218_length_4791_cov_16.126172	2438	2518	0	80	80	1.0000000
NODE_218_length_4791_cov_16.126172	2491	2571	0	80	80	1.0000000
NODE_218_length_4791_cov_16.126172	2567	2647	0	80	80	1.0000000
NODE_218_length_4791_cov_16.126172	2620	2700	0	80	80	1.0000000
NODE_218_length_4791_cov_16.126172	4607	4687	0	80	80	1.0000000
NODE_219_length_4790_cov_9.713494	2159	2239	63	2	80	0.0250000
NODE_219_length_4790_cov_9.713494	2159	2239	65	2	80	0.0250000
NODE_219_length_4790_cov_9.713494	2159	2239	67	5	80	0.0625000
NODE_219_length_4790_cov_9.713494	2159	2239	68	1	80	0.0125000
NODE_219_length_4790_cov_9.713494	2159	2239	72	6	80	0.0750000
NODE_219_length_4790_cov_9.713494	2159	2239	73	6	80	0.0750000
NODE_219_length_4790_cov_9.713494	2159	2239	74	2	80	0.0250000
NODE_219_length_4790_cov_9.713494	2159	2239	75	4	80	0.0500000
NODE_219_length_4790_cov_9.713494	2159	2239	77	1	80	0.0125000
NODE_219_length_4790_cov_9.713494	2159	2239	78	1	80	0.0125000
NODE_219_length_4790_cov_9.713494	2159	2239	79	1	80	0.0125000
NODE_219_length_4790_cov_9.713494	2159	2239	80	3	80	0.0375000
NODE_219_length_4790_cov_9.713494	2159	2239	81	1	80	0.0125000
NODE_219_length_4790_cov_9.713494	2159	2239	82	2	80	0.0250000
NODE_219_length_4790_cov_9.713494	2159	2239	85	4	80	0.0500000
NODE_219_length_4790_cov_9.713494	2159	2239	86	3	80	0.0375000
NODE_219_length_4790_cov_9.713494	2159	2239	87	2	80	0.0250000
NODE_219_length_4790_cov_9.713494	2159	2239	89	2	80	0.0250000
NODE_219_length_4790_cov_9.713494	2159	2239	90	1	80	0.0125000
NODE_219_length_4790_cov_9.713494	2159	2239	93	1	80	0.0125000
NODE_219_length_4790_cov_9.713494	2159	2239	94	4	80	0.0500000
NODE_219_length_4790_cov_9.713494	2159	2239	96	3	80	0.0375000
NODE_219_length_4790_cov_9.713494	2159	2239	97	7	80	0.0875000
NODE_219_length_4790_cov_9.713494	2159	2239	98	11	80	0.1375000
NODE_219_length_4790_cov_9.713494	2159	2239	99	2	80	0.0250000
NODE_219_length_4790_cov_9.713494	2159	2239	101	1	80	0.0125000
NODE_219_length_4790_cov_9.713494	2159	2239	102	2	80	0.0250000
NODE_219_length_4790_cov_9.713494	4273	4353	33	1	80	0.0125000
NODE_219_length_4790_cov_9.713494	4273	4353	34	8	80	0.1000000
NODE_219_length_4790_cov_9.713494	4273	4353	36	2	80	0.0250000
NODE_219_length_4790_cov_9.713494	4273	4353	37	1	80	0.0125000
NODE_219_length_4790_cov_9.713494	4273	4353	38	14	80	0.1750000
NODE_219_length_4790_cov_9.713494	4273	4353	39	16	80	0.2000000
NODE_219_length_4790_cov_9.713494	4273	4353	40	6	80	0.0750000
NODE_219_length_4790_cov_9.713494	4273	4353	41	7	80	0.0875000
NODE_219_length_4790_cov_9.713494	4273	4353	42	14	80	0.1750000
NODE_219_length_4790_cov_9.713494	4273	4353	43	9	80	0.1125000
NODE_219_length_4790_cov_9.713494	4273	4353	44	2	80	0.0250000
NODE_219_length_4790_cov_9.713494	4273	4335	38	9	62	0.1451613
NODE_219_length_4790_cov_9.713494	4273	4335	39	15	62	0.2419355
NODE_219_length_4790_cov_9.713494	4273	4335	40	6	62	0.0967742
NODE_219_length_4790_cov_9.713494	4273	4335	41	7	62	0.1129032
NODE_219_length_4790_cov_9.713494	4273	4335	42	14	62	0.2258064
NODE_219_length_4790_cov_9.713494	4273	4335	43	9	62	0.1451613
NODE_219_length_4790_cov_9.713494	4273	4335	44	2	62	0.0322581
NODE_219_length_4790_cov_9.713494	4326	4406	20	3	80	0.0375000
NODE_219_length_4790_cov_9.713494	4326	4406	21	7	80	0.0875000
NODE_219_length_4790_cov_9.713494	4326	4406	22	5	80	0.0625000
NODE_219_length_4790_cov_9.713494	4326	4406	23	13	80	0.1625000
NODE_219_length_4790_cov_9.713494	4326	4406	24	4	80	0.0500000
NODE_219_length_4790_cov_9.713494	4326	4406	25	4	80	0.0500000
NODE_219_length_4790_cov_9.713494	4326	4406	26	1	80	0.0125000
NODE_219_length_4790_cov_9.713494	4326	4406	27	1	80	0.0125000
NODE_219_length_4790_cov_9.713494	4326	4406	28	9	80	0.1125000
NODE_219_length_4790_cov_9.713494	4326	4406	33	2	80	0.0250000
NODE_219_length_4790_cov_9.713494	4326	4406	34	13	80	0.1625000
NODE_219_length_4790_cov_9.713494	4326	4406	36	2	80	0.0250000
NODE_219_length_4790_cov_9.713494	4326	4406	37	1	80	0.0125000
NODE_219_length_4790_cov_9.713494	4326	4406	38	13	80	0.1625000
NODE_219_length_4790_cov_9.713494	4326	4406	39	2	80	0.0250000
NODE_221_length_4772_cov_10.560454	4281	4367	1	5	86	0.0581395
NODE_221_length_4772_cov_10.560454	4281	4367	2	40	86	0.4651163
NODE_221_length_4772_cov_10.560454	4281	4367	3	22	86	0.2558140
NODE_221_length_4772_cov_10.560454	4281	4367	4	19	86	0.2209302
NODE_222_length_4770_cov_106.953543	2778	2858	151	3	80	0.0375000
NODE_222_length_4770_cov_106.953543	2778	2858	152	1	80	0.0125000
NODE_222_length_4770_cov_106.953543	2778	2858	155	2	80	0.0250000
NODE_222_length_4770_cov_106.953543	2778	2858	156	1	80	0.0125000
NODE_222_length_4770_cov_106.953543	2778	2858	157	1	80	0.0125000
NODE_222_length_4770_cov_106.953543	2778	2858	158	3	80	0.0375000
NODE_222_length_4770_cov_106.953543	2778	2858	161	2	80	0.0250000
NODE_222_length_4770_cov_106.953543	2778	2858	162	4	80	0.0500000
NODE_222_length_4770_cov_106.953543	2778	2858	163	9	80	0.1125000
NODE_222_length_4770_cov_106.953543	2778	2858	164	3	80	0.0375000
NODE_222_length_4770_cov_106.953543	2778	2858	165	6	80	0.0750000
NODE_222_length_4770_cov_106.953543	2778	2858	166	9	80	0.1125000
NODE_222_length_4770_cov_106.953543	2778	2858	167	2	80	0.0250000
NODE_222_length_4770_cov_106.953543	2778	2858	168	7	80	0.0875000
NODE_222_length_4770_cov_106.953543	2778	2858	169	3	80	0.0375000
NODE_222_length_4770_cov_106.953543	2778	2858	170	6	80	0.0750000
NODE_222_length_4770_cov_106.953543	2778	2858	171	3	80	0.0375000
NODE_222_length_4770_cov_106.953543	2778	2858	172	1	80	0.0125000
NODE_222_length_4770_cov_106.953543	2778	2858	173	2	80	0.0250000
NODE_222_length_4770_cov_106.953543	2778	2858	177	1	80	0.0125000
NODE_222_length_4770_cov_106.953543	2778	2858	178	4	80	0.0500000
NODE_222_length_4770_cov_106.953543	2778	2858	179	3	80	0.0375000
NODE_222_length_4770_cov_106.953543	2778	2858	180	2	80	0.0250000
NODE_222_length_4770_cov_106.953543	2778	2858	182	2	80	0.0250000
NODE_222_length_4770_cov_106.953543	2831	2911	162	3	80	0.0375000
NODE_222_length_4770_cov_106.953543	2831	2911	163	1	80	0.0125000
NODE_222_length_4770_cov_106.953543	2831	2911	164	1	80	0.0125000
NODE_222_length_4770_cov_106.953543	2831	2911	166	3	80	0.0375000
NODE_222_length_4770_cov_106.953543	2831	2911	168	1	80	0.0125000
NODE_222_length_4770_cov_106.953543	2831	2911	169	1	80	0.0125000
NODE_222_length_4770_cov_106.953543	2831	2911	170	3	80	0.0375000
NODE_222_length_4770_cov_106.953543	2831	2911	173	2	80	0.0250000
NODE_222_length_4770_cov_106.953543	2831	2911	177	1	80	0.0125000
NODE_222_length_4770_cov_106.953543	2831	2911	178	4	80	0.0500000
NODE_222_length_4770_cov_106.953543	2831	2911	179	4	80	0.0500000
NODE_222_length_4770_cov_106.953543	2831	2911	180	3	80	0.0375000
NODE_222_length_4770_cov_106.953543	2831	2911	182	6	80	0.0750000
NODE_222_length_4770_cov_106.953543	2831	2911	187	2	80	0.0250000
NODE_222_length_4770_cov_106.953543	2831	2911	188	2	80	0.0250000
NODE_222_length_4770_cov_106.953543	2831	2911	191	3	80	0.0375000
NODE_222_length_4770_cov_106.953543	2831	2911	192	1	80	0.0125000
NODE_222_length_4770_cov_106.953543	2831	2911	193	1	80	0.0125000
NODE_222_length_4770_cov_106.953543	2831	2911	197	1	80	0.0125000
NODE_222_length_4770_cov_106.953543	2831	2911	198	1	80	0.0125000
NODE_222_length_4770_cov_106.953543	2831	2911	199	1	80	0.0125000
NODE_222_length_4770_cov_106.953543	2831	2911	200	2	80	0.0250000
NODE_222_length_4770_cov_106.953543	2831	2911	201	2	80	0.0250000
NODE_222_length_4770_cov_106.953543	2831	2911	203	1	80	0.0125000
NODE_222_length_4770_cov_106.953543	2831	2911	206	2	80	0.0250000
NODE_222_length_4770_cov_106.953543	2831	2911	207	1	80	0.0125000
NODE_222_length_4770_cov_106.953543	2831	2911	209	1	80	0.0125000
NODE_222_length_4770_cov_106.953543	2831	2911	210	2	80	0.0250000
NODE_222_length_4770_cov_106.953543	2831	2911	211	1	80	0.0125000
NODE_222_length_4770_cov_106.953543	2831	2911	212	1	80	0.0125000
NODE_222_length_4770_cov_106.953543	2831	2911	213	1	80	0.0125000
NODE_222_length_4770_cov_106.953543	2831	2911	215	1	80	0.0125000
NODE_222_length_4770_cov_106.953543	2831	2911	216	1	80	0.0125000
NODE_222_length_4770_cov_106.953543	2831	2911	220	1	80	0.0125000
NODE_222_length_4770_cov_106.953543	2831	2911	221	1	80	0.0125000
NODE_222_length_4770_cov_106.953543	2831	2911	222	1	80	0.0125000
NODE_222_length_4770_cov_106.953543	2831	2911	225	1	80	0.0125000
NODE_222_length_4770_cov_106.953543	2831	2911	226	4	80	0.0500000
NODE_222_length_4770_cov_106.953543	2831	2911	227	1	80	0.0125000
NODE_222_length_4770_cov_106.953543	2831	2911	228	2	80	0.0250000
NODE_222_length_4770_cov_106.953543	2831	2911	230	2	80	0.0250000
NODE_222_length_4770_cov_106.953543	2831	2911	232	2	80	0.0250000
NODE_222_length_4770_cov_106.953543	2831	2911	234	1	80	0.0125000
NODE_222_length_4770_cov_106.953543	2831	2911	235	1	80	0.0125000
NODE_222_length_4770_cov_106.953543	2831	2911	236	2	80	0.0250000
NODE_222_length_4770_cov_106.953543	2907	2987	221	1	80	0.0125000
NODE_222_length_4770_cov_106.953543	2907	2987	222	2	80	0.0250000
NODE_222_length_4770_cov_106.953543	2907	2987	223	2	80	0.0250000
NODE_222_length_4770_cov_106.953543	2907	2987	224	1	80	0.0125000
NODE_222_length_4770_cov_106.953543	2907	2987	225	1	80	0.0125000
NODE_222_length_4770_cov_106.953543	2907	2987	226	1	80	0.0125000
NODE_222_length_4770_cov_106.953543	2907	2987	227	1	80	0.0125000
NODE_222_length_4770_cov_106.953543	2907	2987	228	2	80	0.0250000
NODE_222_length_4770_cov_106.953543	2907	2987	230	3	80	0.0375000
NODE_222_length_4770_cov_106.953543	2907	2987	234	3	80	0.0375000
NODE_222_length_4770_cov_106.953543	2907	2987	235	3	80	0.0375000
NODE_222_length_4770_cov_106.953543	2907	2987	240	1	80	0.0125000
NODE_222_length_4770_cov_106.953543	2907	2987	243	1	80	0.0125000
NODE_222_length_4770_cov_106.953543	2907	2987	245	1	80	0.0125000
NODE_222_length_4770_cov_106.953543	2907	2987	248	1	80	0.0125000
NODE_222_length_4770_cov_106.953543	2907	2987	255	1	80	0.0125000
NODE_222_length_4770_cov_106.953543	2907	2987	256	1	80	0.0125000
NODE_222_length_4770_cov_106.953543	2907	2987	258	3	80	0.0375000
NODE_222_length_4770_cov_106.953543	2907	2987	259	1	80	0.0125000
NODE_222_length_4770_cov_106.953543	2907	2987	260	1	80	0.0125000
NODE_222_length_4770_cov_106.953543	2907	2987	262	1	80	0.0125000
NODE_222_length_4770_cov_106.953543	2907	2987	263	2	80	0.0250000
NODE_222_length_4770_cov_106.953543	2907	2987	265	2	80	0.0250000
NODE_222_length_4770_cov_106.953543	2907	2987	267	2	80	0.0250000
NODE_222_length_4770_cov_106.953543	2907	2987	268	1	80	0.0125000
NODE_222_length_4770_cov_106.953543	2907	2987	271	1	80	0.0125000
NODE_222_length_4770_cov_106.953543	2907	2987	276	4	80	0.0500000
NODE_222_length_4770_cov_106.953543	2907	2987	277	3	80	0.0375000
NODE_222_length_4770_cov_106.953543	2907	2987	278	4	80	0.0500000
NODE_222_length_4770_cov_106.953543	2907	2987	279	2	80	0.0250000
NODE_222_length_4770_cov_106.953543	2907	2987	280	10	80	0.1250000
NODE_222_length_4770_cov_106.953543	2907	2987	281	5	80	0.0625000
NODE_222_length_4770_cov_106.953543	2907	2987	282	4	80	0.0500000
NODE_222_length_4770_cov_106.953543	2907	2987	283	3	80	0.0375000
NODE_222_length_4770_cov_106.953543	2907	2987	284	1	80	0.0125000
NODE_222_length_4770_cov_106.953543	2907	2987	285	1	80	0.0125000
NODE_222_length_4770_cov_106.953543	2907	2987	286	3	80	0.0375000
NODE_222_length_4770_cov_106.953543	2960	3040	222	1	80	0.0125000
NODE_222_length_4770_cov_106.953543	2960	3040	224	1	80	0.0125000
NODE_222_length_4770_cov_106.953543	2960	3040	225	1	80	0.0125000
NODE_222_length_4770_cov_106.953543	2960	3040	226	1	80	0.0125000
NODE_222_length_4770_cov_106.953543	2960	3040	230	1	80	0.0125000
NODE_222_length_4770_cov_106.953543	2960	3040	232	1	80	0.0125000
NODE_222_length_4770_cov_106.953543	2960	3040	237	2	80	0.0250000
NODE_222_length_4770_cov_106.953543	2960	3040	239	1	80	0.0125000
NODE_222_length_4770_cov_106.953543	2960	3040	240	1	80	0.0125000
NODE_222_length_4770_cov_106.953543	2960	3040	241	2	80	0.0250000
NODE_222_length_4770_cov_106.953543	2960	3040	243	1	80	0.0125000
NODE_222_length_4770_cov_106.953543	2960	3040	244	1	80	0.0125000
NODE_222_length_4770_cov_106.953543	2960	3040	245	3	80	0.0375000
NODE_222_length_4770_cov_106.953543	2960	3040	252	1	80	0.0125000
NODE_222_length_4770_cov_106.953543	2960	3040	254	1	80	0.0125000
NODE_222_length_4770_cov_106.953543	2960	3040	255	1	80	0.0125000
NODE_222_length_4770_cov_106.953543	2960	3040	257	1	80	0.0125000
NODE_222_length_4770_cov_106.953543	2960	3040	260	2	80	0.0250000
NODE_222_length_4770_cov_106.953543	2960	3040	263	1	80	0.0125000
NODE_222_length_4770_cov_106.953543	2960	3040	264	1	80	0.0125000
NODE_222_length_4770_cov_106.953543	2960	3040	267	2	80	0.0250000
NODE_222_length_4770_cov_106.953543	2960	3040	268	1	80	0.0125000
NODE_222_length_4770_cov_106.953543	2960	3040	270	1	80	0.0125000
NODE_222_length_4770_cov_106.953543	2960	3040	271	6	80	0.0750000
NODE_222_length_4770_cov_106.953543	2960	3040	273	5	80	0.0625000
NODE_222_length_4770_cov_106.953543	2960	3040	274	2	80	0.0250000
NODE_222_length_4770_cov_106.953543	2960	3040	275	1	80	0.0125000
NODE_222_length_4770_cov_106.953543	2960	3040	276	4	80	0.0500000
NODE_222_length_4770_cov_106.953543	2960	3040	277	1	80	0.0125000
NODE_222_length_4770_cov_106.953543	2960	3040	278	6	80	0.0750000
NODE_222_length_4770_cov_106.953543	2960	3040	279	4	80	0.0500000
NODE_222_length_4770_cov_106.953543	2960	3040	280	9	80	0.1125000
NODE_222_length_4770_cov_106.953543	2960	3040	281	4	80	0.0500000
NODE_222_length_4770_cov_106.953543	2960	3040	282	5	80	0.0625000
NODE_222_length_4770_cov_106.953543	2960	3040	283	3	80	0.0375000
NODE_222_length_4770_cov_106.953543	2960	3040	284	1	80	0.0125000
NODE_223_length_4768_cov_15.447205	1237	1317	90	1	80	0.0125000
NODE_223_length_4768_cov_15.447205	1237	1317	91	3	80	0.0375000
NODE_223_length_4768_cov_15.447205	1237	1317	92	3	80	0.0375000
NODE_223_length_4768_cov_15.447205	1237	1317	93	4	80	0.0500000
NODE_223_length_4768_cov_15.447205	1237	1317	94	6	80	0.0750000
NODE_223_length_4768_cov_15.447205	1237	1317	95	1	80	0.0125000
NODE_223_length_4768_cov_15.447205	1237	1317	96	11	80	0.1375000
NODE_223_length_4768_cov_15.447205	1237	1317	97	7	80	0.0875000
NODE_223_length_4768_cov_15.447205	1237	1317	98	21	80	0.2625000
NODE_223_length_4768_cov_15.447205	1237	1317	99	16	80	0.2000000
NODE_223_length_4768_cov_15.447205	1237	1317	100	3	80	0.0375000
NODE_223_length_4768_cov_15.447205	1237	1317	101	2	80	0.0250000
NODE_223_length_4768_cov_15.447205	1237	1317	104	1	80	0.0125000
NODE_223_length_4768_cov_15.447205	1237	1317	105	1	80	0.0125000
NODE_228_length_4730_cov_30.142734	256	336	2	25	80	0.3125000
NODE_228_length_4730_cov_30.142734	256	336	3	35	80	0.4375000
NODE_228_length_4730_cov_30.142734	256	336	4	20	80	0.2500000
NODE_228_length_4730_cov_30.142734	309	389	3	28	80	0.3500000
NODE_228_length_4730_cov_30.142734	309	389	4	52	80	0.6500000
NODE_228_length_4730_cov_30.142734	4052	4132	7	6	80	0.0750000
NODE_228_length_4730_cov_30.142734	4052	4132	8	9	80	0.1125000
NODE_228_length_4730_cov_30.142734	4052	4132	9	17	80	0.2125000
NODE_228_length_4730_cov_30.142734	4052	4132	10	48	80	0.6000000
NODE_228_length_4730_cov_30.142734	4105	4185	7	15	80	0.1875000
NODE_228_length_4730_cov_30.142734	4105	4185	8	36	80	0.4500000
NODE_228_length_4730_cov_30.142734	4105	4185	9	11	80	0.1375000
NODE_228_length_4730_cov_30.142734	4105	4185	10	18	80	0.2250000
NODE_231_length_4706_cov_25.522683	2181	2261	19	3	80	0.0375000
NODE_231_length_4706_cov_25.522683	2181	2261	20	3	80	0.0375000
NODE_231_length_4706_cov_25.522683	2181	2261	23	1	80	0.0125000
NODE_231_length_4706_cov_25.522683	2181	2261	25	1	80	0.0125000
NODE_231_length_4706_cov_25.522683	2181	2261	28	2	80	0.0250000
NODE_231_length_4706_cov_25.522683	2181	2261	32	3	80	0.0375000
NODE_231_length_4706_cov_25.522683	2181	2261	33	1	80	0.0125000
NODE_231_length_4706_cov_25.522683	2181	2261	34	2	80	0.0250000
NODE_231_length_4706_cov_25.522683	2181	2261	35	3	80	0.0375000
NODE_231_length_4706_cov_25.522683	2181	2261	36	5	80	0.0625000
NODE_231_length_4706_cov_25.522683	2181	2261	37	1	80	0.0125000
NODE_231_length_4706_cov_25.522683	2181	2261	38	2	80	0.0250000
NODE_231_length_4706_cov_25.522683	2181	2261	42	2	80	0.0250000
NODE_231_length_4706_cov_25.522683	2181	2261	43	1	80	0.0125000
NODE_231_length_4706_cov_25.522683	2181	2261	46	4	80	0.0500000
NODE_231_length_4706_cov_25.522683	2181	2261	47	2	80	0.0250000
NODE_231_length_4706_cov_25.522683	2181	2261	48	2	80	0.0250000
NODE_231_length_4706_cov_25.522683	2181	2261	49	1	80	0.0125000
NODE_231_length_4706_cov_25.522683	2181	2261	52	1	80	0.0125000
NODE_231_length_4706_cov_25.522683	2181	2261	54	1	80	0.0125000
NODE_231_length_4706_cov_25.522683	2181	2261	55	1	80	0.0125000
NODE_231_length_4706_cov_25.522683	2181	2261	59	1	80	0.0125000
NODE_231_length_4706_cov_25.522683	2181	2261	60	2	80	0.0250000
NODE_231_length_4706_cov_25.522683	2181	2261	62	1	80	0.0125000
NODE_231_length_4706_cov_25.522683	2181	2261	64	1	80	0.0125000
NODE_231_length_4706_cov_25.522683	2181	2261	65	2	80	0.0250000
NODE_231_length_4706_cov_25.522683	2181	2261	71	1	80	0.0125000
NODE_231_length_4706_cov_25.522683	2181	2261	73	1	80	0.0125000
NODE_231_length_4706_cov_25.522683	2181	2261	80	1	80	0.0125000
NODE_231_length_4706_cov_25.522683	2181	2261	82	1	80	0.0125000
NODE_231_length_4706_cov_25.522683	2181	2261	84	1	80	0.0125000
NODE_231_length_4706_cov_25.522683	2181	2261	86	1	80	0.0125000
NODE_231_length_4706_cov_25.522683	2181	2261	87	1	80	0.0125000
NODE_231_length_4706_cov_25.522683	2181	2261	92	1	80	0.0125000
NODE_231_length_4706_cov_25.522683	2181	2261	95	3	80	0.0375000
NODE_231_length_4706_cov_25.522683	2181	2261	96	1	80	0.0125000
NODE_231_length_4706_cov_25.522683	2181	2261	99	2	80	0.0250000
NODE_231_length_4706_cov_25.522683	2181	2261	100	1	80	0.0125000
NODE_231_length_4706_cov_25.522683	2181	2261	103	4	80	0.0500000
NODE_231_length_4706_cov_25.522683	2181	2261	104	2	80	0.0250000
NODE_231_length_4706_cov_25.522683	2181	2261	105	1	80	0.0125000
NODE_231_length_4706_cov_25.522683	2181	2261	106	1	80	0.0125000
NODE_231_length_4706_cov_25.522683	2181	2261	109	2	80	0.0250000
NODE_231_length_4706_cov_25.522683	2181	2261	110	5	80	0.0625000
NODE_231_length_4706_cov_25.522683	2181	2261	112	1	80	0.0125000
NODE_231_length_4706_cov_25.522683	2234	2288	2	2	54	0.0370370
NODE_231_length_4706_cov_25.522683	2234	2288	6	3	54	0.0555556
NODE_231_length_4706_cov_25.522683	2234	2288	7	3	54	0.0555556
NODE_231_length_4706_cov_25.522683	2234	2288	8	1	54	0.0185185
NODE_231_length_4706_cov_25.522683	2234	2288	12	4	54	0.0740741
NODE_231_length_4706_cov_25.522683	2234	2288	13	6	54	0.1111111
NODE_231_length_4706_cov_25.522683	2234	2288	16	1	54	0.0185185
NODE_231_length_4706_cov_25.522683	2234	2288	17	2	54	0.0370370
NODE_231_length_4706_cov_25.522683	2234	2288	18	3	54	0.0555556
NODE_231_length_4706_cov_25.522683	2234	2288	19	5	54	0.0925926
NODE_231_length_4706_cov_25.522683	2234	2288	20	3	54	0.0555556
NODE_231_length_4706_cov_25.522683	2234	2288	23	1	54	0.0185185
NODE_231_length_4706_cov_25.522683	2234	2288	25	1	54	0.0185185
NODE_231_length_4706_cov_25.522683	2234	2288	28	2	54	0.0370370
NODE_231_length_4706_cov_25.522683	2234	2288	32	3	54	0.0555556
NODE_231_length_4706_cov_25.522683	2234	2288	33	1	54	0.0185185
NODE_231_length_4706_cov_25.522683	2234	2288	34	2	54	0.0370370
NODE_231_length_4706_cov_25.522683	2234	2288	35	3	54	0.0555556
NODE_231_length_4706_cov_25.522683	2234	2288	36	5	54	0.0925926
NODE_231_length_4706_cov_25.522683	2234	2288	37	1	54	0.0185185
NODE_231_length_4706_cov_25.522683	2234	2288	38	2	54	0.0370370
NODE_231_length_4706_cov_25.522683	3943	4026	24	2	83	0.0240964
NODE_231_length_4706_cov_25.522683	3943	4026	25	9	83	0.1084337
NODE_231_length_4706_cov_25.522683	3943	4026	26	2	83	0.0240964
NODE_231_length_4706_cov_25.522683	3943	4026	27	1	83	0.0120482
NODE_231_length_4706_cov_25.522683	3943	4026	28	1	83	0.0120482
NODE_231_length_4706_cov_25.522683	3943	4026	29	6	83	0.0722892
NODE_231_length_4706_cov_25.522683	3943	4026	30	3	83	0.0361446
NODE_231_length_4706_cov_25.522683	3943	4026	31	7	83	0.0843373
NODE_231_length_4706_cov_25.522683	3943	4026	33	3	83	0.0361446
NODE_231_length_4706_cov_25.522683	3943	4026	34	14	83	0.1686747
NODE_231_length_4706_cov_25.522683	3943	4026	35	2	83	0.0240964
NODE_231_length_4706_cov_25.522683	3943	4026	37	2	83	0.0240964
NODE_231_length_4706_cov_25.522683	3943	4026	38	6	83	0.0722892
NODE_231_length_4706_cov_25.522683	3943	4026	39	14	83	0.1686747
NODE_231_length_4706_cov_25.522683	3943	4026	40	5	83	0.0602410
NODE_231_length_4706_cov_25.522683	3943	4026	41	6	83	0.0722892
NODE_235_length_4693_cov_16.973008	374	454	7	16	80	0.2000000
NODE_235_length_4693_cov_16.973008	374	454	8	28	80	0.3500000
NODE_235_length_4693_cov_16.973008	374	454	9	36	80	0.4500000
NODE_235_length_4693_cov_16.973008	427	507	5	5	80	0.0625000
NODE_235_length_4693_cov_16.973008	427	507	7	19	80	0.2375000
NODE_235_length_4693_cov_16.973008	427	507	8	32	80	0.4000000
NODE_235_length_4693_cov_16.973008	427	507	9	24	80	0.3000000
NODE_240_length_4672_cov_39.029084	1391	1470	111	1	79	0.0126582
NODE_240_length_4672_cov_39.029084	1391	1470	112	1	79	0.0126582
NODE_240_length_4672_cov_39.029084	1391	1470	118	3	79	0.0379747
NODE_240_length_4672_cov_39.029084	1391	1470	119	5	79	0.0632911
NODE_240_length_4672_cov_39.029084	1391	1470	121	1	79	0.0126582
NODE_240_length_4672_cov_39.029084	1391	1470	123	1	79	0.0126582
NODE_240_length_4672_cov_39.029084	1391	1470	126	1	79	0.0126582
NODE_240_length_4672_cov_39.029084	1391	1470	127	1	79	0.0126582
NODE_240_length_4672_cov_39.029084	1391	1470	128	1	79	0.0126582
NODE_240_length_4672_cov_39.029084	1391	1470	129	1	79	0.0126582
NODE_240_length_4672_cov_39.029084	1391	1470	132	1	79	0.0126582
NODE_240_length_4672_cov_39.029084	1391	1470	135	1	79	0.0126582
NODE_240_length_4672_cov_39.029084	1391	1470	138	2	79	0.0253165
NODE_240_length_4672_cov_39.029084	1391	1470	139	3	79	0.0379747
NODE_240_length_4672_cov_39.029084	1391	1470	143	1	79	0.0126582
NODE_240_length_4672_cov_39.029084	1391	1470	148	1	79	0.0126582
NODE_240_length_4672_cov_39.029084	1391	1470	151	1	79	0.0126582
NODE_240_length_4672_cov_39.029084	1391	1470	152	2	79	0.0253165
NODE_240_length_4672_cov_39.029084	1391	1470	154	2	79	0.0253165
NODE_240_length_4672_cov_39.029084	1391	1470	155	2	79	0.0253165
NODE_240_length_4672_cov_39.029084	1391	1470	156	2	79	0.0253165
NODE_240_length_4672_cov_39.029084	1391	1470	159	5	79	0.0632911
NODE_240_length_4672_cov_39.029084	1391	1470	160	3	79	0.0379747
NODE_240_length_4672_cov_39.029084	1391	1470	161	2	79	0.0253165
NODE_240_length_4672_cov_39.029084	1391	1470	162	10	79	0.1265823
NODE_240_length_4672_cov_39.029084	1391	1470	164	9	79	0.1139240
NODE_240_length_4672_cov_39.029084	1391	1470	165	4	79	0.0506329
NODE_240_length_4672_cov_39.029084	1391	1470	166	3	79	0.0379747
NODE_240_length_4672_cov_39.029084	1391	1470	167	4	79	0.0506329
NODE_240_length_4672_cov_39.029084	1391	1470	168	5	79	0.0632911
NODE_240_length_4672_cov_39.029084	1444	1523	111	2	79	0.0253165
NODE_240_length_4672_cov_39.029084	1444	1523	118	2	79	0.0253165
NODE_240_length_4672_cov_39.029084	1444	1523	125	5	79	0.0632911
NODE_240_length_4672_cov_39.029084	1444	1523	126	1	79	0.0126582
NODE_240_length_4672_cov_39.029084	1444	1523	130	1	79	0.0126582
NODE_240_length_4672_cov_39.029084	1444	1523	135	1	79	0.0126582
NODE_240_length_4672_cov_39.029084	1444	1523	137	1	79	0.0126582
NODE_240_length_4672_cov_39.029084	1444	1523	141	1	79	0.0126582
NODE_240_length_4672_cov_39.029084	1444	1523	144	1	79	0.0126582
NODE_240_length_4672_cov_39.029084	1444	1523	147	2	79	0.0253165
NODE_240_length_4672_cov_39.029084	1444	1523	156	1	79	0.0126582
NODE_240_length_4672_cov_39.029084	1444	1523	157	5	79	0.0632911
NODE_240_length_4672_cov_39.029084	1444	1523	159	1	79	0.0126582
NODE_240_length_4672_cov_39.029084	1444	1523	160	3	79	0.0379747
NODE_240_length_4672_cov_39.029084	1444	1523	161	1	79	0.0126582
NODE_240_length_4672_cov_39.029084	1444	1523	162	4	79	0.0506329
NODE_240_length_4672_cov_39.029084	1444	1523	164	10	79	0.1265823
NODE_240_length_4672_cov_39.029084	1444	1523	165	4	79	0.0506329
NODE_240_length_4672_cov_39.029084	1444	1523	166	5	79	0.0632911
NODE_240_length_4672_cov_39.029084	1444	1523	167	7	79	0.0886076
NODE_240_length_4672_cov_39.029084	1444	1523	168	20	79	0.2531646
NODE_240_length_4672_cov_39.029084	1444	1523	169	1	79	0.0126582
NODE_246_length_4602_cov_17.281368	3106	3186	16	2	80	0.0250000
NODE_246_length_4602_cov_17.281368	3106	3186	17	8	80	0.1000000
NODE_246_length_4602_cov_17.281368	3106	3186	18	1	80	0.0125000
NODE_246_length_4602_cov_17.281368	3106	3186	19	8	80	0.1000000
NODE_246_length_4602_cov_17.281368	3106	3186	20	3	80	0.0375000
NODE_246_length_4602_cov_17.281368	3106	3186	21	13	80	0.1625000
NODE_246_length_4602_cov_17.281368	3106	3186	22	3	80	0.0375000
NODE_246_length_4602_cov_17.281368	3106	3186	23	10	80	0.1250000
NODE_246_length_4602_cov_17.281368	3106	3186	24	6	80	0.0750000
NODE_246_length_4602_cov_17.281368	3106	3186	25	12	80	0.1500000
NODE_246_length_4602_cov_17.281368	3106	3186	26	4	80	0.0500000
NODE_246_length_4602_cov_17.281368	3106	3186	27	10	80	0.1250000
NODE_246_length_4602_cov_17.281368	3159	3239	21	2	80	0.0250000
NODE_246_length_4602_cov_17.281368	3159	3239	22	3	80	0.0375000
NODE_246_length_4602_cov_17.281368	3159	3239	23	15	80	0.1875000
NODE_246_length_4602_cov_17.281368	3159	3239	24	13	80	0.1625000
NODE_246_length_4602_cov_17.281368	3159	3239	25	16	80	0.2000000
NODE_246_length_4602_cov_17.281368	3159	3239	26	13	80	0.1625000
NODE_246_length_4602_cov_17.281368	3159	3239	27	18	80	0.2250000
NODE_248_length_4587_cov_14.431150	1294	1370	111	1	76	0.0131579
NODE_248_length_4587_cov_14.431150	1294	1370	112	2	76	0.0263158
NODE_248_length_4587_cov_14.431150	1294	1370	113	2	76	0.0263158
NODE_248_length_4587_cov_14.431150	1294	1370	114	2	76	0.0263158
NODE_248_length_4587_cov_14.431150	1294	1370	115	2	76	0.0263158
NODE_248_length_4587_cov_14.431150	1294	1370	116	2	76	0.0263158
NODE_248_length_4587_cov_14.431150	1294	1370	117	1	76	0.0131579
NODE_248_length_4587_cov_14.431150	1294	1370	118	1	76	0.0131579
NODE_248_length_4587_cov_14.431150	1294	1370	120	3	76	0.0394737
NODE_248_length_4587_cov_14.431150	1294	1370	121	1	76	0.0131579
NODE_248_length_4587_cov_14.431150	1294	1370	122	1	76	0.0131579
NODE_248_length_4587_cov_14.431150	1294	1370	124	2	76	0.0263158
NODE_248_length_4587_cov_14.431150	1294	1370	125	3	76	0.0394737
NODE_248_length_4587_cov_14.431150	1294	1370	126	2	76	0.0263158
NODE_248_length_4587_cov_14.431150	1294	1370	127	1	76	0.0131579
NODE_248_length_4587_cov_14.431150	1294	1370	128	3	76	0.0394737
NODE_248_length_4587_cov_14.431150	1294	1370	129	3	76	0.0394737
NODE_248_length_4587_cov_14.431150	1294	1370	130	2	76	0.0263158
NODE_248_length_4587_cov_14.431150	1294	1370	131	7	76	0.0921053
NODE_248_length_4587_cov_14.431150	1294	1370	133	2	76	0.0263158
NODE_248_length_4587_cov_14.431150	1294	1370	134	6	76	0.0789474
NODE_248_length_4587_cov_14.431150	1294	1370	136	2	76	0.0263158
NODE_248_length_4587_cov_14.431150	1294	1370	137	1	76	0.0131579
NODE_248_length_4587_cov_14.431150	1294	1370	138	1	76	0.0131579
NODE_248_length_4587_cov_14.431150	1294	1370	139	3	76	0.0394737
NODE_248_length_4587_cov_14.431150	1294	1370	140	2	76	0.0263158
NODE_248_length_4587_cov_14.431150	1294	1370	142	4	76	0.0526316
NODE_248_length_4587_cov_14.431150	1294	1370	143	1	76	0.0131579
NODE_248_length_4587_cov_14.431150	1294	1370	144	2	76	0.0263158
NODE_248_length_4587_cov_14.431150	1294	1370	145	5	76	0.0657895
NODE_248_length_4587_cov_14.431150	1294	1370	146	1	76	0.0131579
NODE_248_length_4587_cov_14.431150	1294	1370	148	3	76	0.0394737
NODE_248_length_4587_cov_14.431150	1294	1370	149	1	76	0.0131579
NODE_248_length_4587_cov_14.431150	1294	1370	150	1	76	0.0131579
NODE_248_length_4587_cov_14.431150	1347	1427	93	2	80	0.0250000
NODE_248_length_4587_cov_14.431150	1347	1427	94	1	80	0.0125000
NODE_248_length_4587_cov_14.431150	1347	1427	95	1	80	0.0125000
NODE_248_length_4587_cov_14.431150	1347	1427	97	1	80	0.0125000
NODE_248_length_4587_cov_14.431150	1347	1427	98	6	80	0.0750000
NODE_248_length_4587_cov_14.431150	1347	1427	99	9	80	0.1125000
NODE_248_length_4587_cov_14.431150	1347	1427	100	2	80	0.0250000
NODE_248_length_4587_cov_14.431150	1347	1427	101	4	80	0.0500000
NODE_248_length_4587_cov_14.431150	1347	1427	102	7	80	0.0875000
NODE_248_length_4587_cov_14.431150	1347	1427	103	3	80	0.0375000
NODE_248_length_4587_cov_14.431150	1347	1427	104	4	80	0.0500000
NODE_248_length_4587_cov_14.431150	1347	1427	105	7	80	0.0875000
NODE_248_length_4587_cov_14.431150	1347	1427	106	3	80	0.0375000
NODE_248_length_4587_cov_14.431150	1347	1427	107	3	80	0.0375000
NODE_248_length_4587_cov_14.431150	1347	1427	109	1	80	0.0125000
NODE_248_length_4587_cov_14.431150	1347	1427	110	3	80	0.0375000
NODE_248_length_4587_cov_14.431150	1347	1427	111	1	80	0.0125000
NODE_248_length_4587_cov_14.431150	1347	1427	112	2	80	0.0250000
NODE_248_length_4587_cov_14.431150	1347	1427	113	2	80	0.0250000
NODE_248_length_4587_cov_14.431150	1347	1427	114	2	80	0.0250000
NODE_248_length_4587_cov_14.431150	1347	1427	115	2	80	0.0250000
NODE_248_length_4587_cov_14.431150	1347	1427	116	2	80	0.0250000
NODE_248_length_4587_cov_14.431150	1347	1427	117	1	80	0.0125000
NODE_248_length_4587_cov_14.431150	1347	1427	118	1	80	0.0125000
NODE_248_length_4587_cov_14.431150	1347	1427	120	3	80	0.0375000
NODE_248_length_4587_cov_14.431150	1347	1427	121	1	80	0.0125000
NODE_248_length_4587_cov_14.431150	1347	1427	122	1	80	0.0125000
NODE_248_length_4587_cov_14.431150	1347	1427	124	1	80	0.0125000
NODE_248_length_4587_cov_14.431150	1347	1427	125	3	80	0.0375000
NODE_248_length_4587_cov_14.431150	1347	1427	127	1	80	0.0125000
NODE_248_length_4587_cov_14.431150	1466	1533	60	2	67	0.0298507
NODE_248_length_4587_cov_14.431150	1466	1533	61	4	67	0.0597015
NODE_248_length_4587_cov_14.431150	1466	1533	62	7	67	0.1044776
NODE_248_length_4587_cov_14.431150	1466	1533	63	1	67	0.0149254
NODE_248_length_4587_cov_14.431150	1466	1533	64	8	67	0.1194030
NODE_248_length_4587_cov_14.431150	1466	1533	65	10	67	0.1492537
NODE_248_length_4587_cov_14.431150	1466	1533	66	15	67	0.2238806
NODE_248_length_4587_cov_14.431150	1466	1533	67	11	67	0.1641791
NODE_248_length_4587_cov_14.431150	1466	1533	68	3	67	0.0447761
NODE_248_length_4587_cov_14.431150	1466	1533	69	3	67	0.0447761
NODE_248_length_4587_cov_14.431150	1466	1533	71	2	67	0.0298507
NODE_248_length_4587_cov_14.431150	1466	1533	72	1	67	0.0149254
NODE_248_length_4587_cov_14.431150	4316	4382	203	1	66	0.0151515
NODE_248_length_4587_cov_14.431150	4316	4382	204	2	66	0.0303030
NODE_248_length_4587_cov_14.431150	4316	4382	210	1	66	0.0151515
NODE_248_length_4587_cov_14.431150	4316	4382	212	1	66	0.0151515
NODE_248_length_4587_cov_14.431150	4316	4382	213	1	66	0.0151515
NODE_248_length_4587_cov_14.431150	4316	4382	214	2	66	0.0303030
NODE_248_length_4587_cov_14.431150	4316	4382	215	2	66	0.0303030
NODE_248_length_4587_cov_14.431150	4316	4382	216	2	66	0.0303030
NODE_248_length_4587_cov_14.431150	4316	4382	217	2	66	0.0303030
NODE_248_length_4587_cov_14.431150	4316	4382	219	2	66	0.0303030
NODE_248_length_4587_cov_14.431150	4316	4382	221	1	66	0.0151515
NODE_248_length_4587_cov_14.431150	4316	4382	222	3	66	0.0454545
NODE_248_length_4587_cov_14.431150	4316	4382	227	3	66	0.0454545
NODE_248_length_4587_cov_14.431150	4316	4382	231	1	66	0.0151515
NODE_248_length_4587_cov_14.431150	4316	4382	233	2	66	0.0303030
NODE_248_length_4587_cov_14.431150	4316	4382	234	1	66	0.0151515
NODE_248_length_4587_cov_14.431150	4316	4382	235	3	66	0.0454545
NODE_248_length_4587_cov_14.431150	4316	4382	236	2	66	0.0303030
NODE_248_length_4587_cov_14.431150	4316	4382	237	2	66	0.0303030
NODE_248_length_4587_cov_14.431150	4316	4382	238	3	66	0.0454545
NODE_248_length_4587_cov_14.431150	4316	4382	239	4	66	0.0606061
NODE_248_length_4587_cov_14.431150	4316	4382	240	2	66	0.0303030
NODE_248_length_4587_cov_14.431150	4316	4382	241	1	66	0.0151515
NODE_248_length_4587_cov_14.431150	4316	4382	242	3	66	0.0454545
NODE_248_length_4587_cov_14.431150	4316	4382	243	5	66	0.0757576
NODE_248_length_4587_cov_14.431150	4316	4382	244	2	66	0.0303030
NODE_248_length_4587_cov_14.431150	4316	4382	245	3	66	0.0454545
NODE_248_length_4587_cov_14.431150	4316	4382	246	1	66	0.0151515
NODE_248_length_4587_cov_14.431150	4316	4382	248	3	66	0.0454545
NODE_248_length_4587_cov_14.431150	4316	4382	249	3	66	0.0454545
NODE_248_length_4587_cov_14.431150	4316	4382	250	2	66	0.0303030
NODE_248_length_4587_cov_14.431150	4355	4435	122	1	80	0.0125000
NODE_248_length_4587_cov_14.431150	4355	4435	124	1	80	0.0125000
NODE_248_length_4587_cov_14.431150	4355	4435	125	1	80	0.0125000
NODE_248_length_4587_cov_14.431150	4355	4435	126	1	80	0.0125000
NODE_248_length_4587_cov_14.431150	4355	4435	127	2	80	0.0250000
NODE_248_length_4587_cov_14.431150	4355	4435	129	1	80	0.0125000
NODE_248_length_4587_cov_14.431150	4355	4435	135	2	80	0.0250000
NODE_248_length_4587_cov_14.431150	4355	4435	136	1	80	0.0125000
NODE_248_length_4587_cov_14.431150	4355	4435	137	1	80	0.0125000
NODE_248_length_4587_cov_14.431150	4355	4435	139	1	80	0.0125000
NODE_248_length_4587_cov_14.431150	4355	4435	140	4	80	0.0500000
NODE_248_length_4587_cov_14.431150	4355	4435	144	1	80	0.0125000
NODE_248_length_4587_cov_14.431150	4355	4435	145	1	80	0.0125000
NODE_248_length_4587_cov_14.431150	4355	4435	147	1	80	0.0125000
NODE_248_length_4587_cov_14.431150	4355	4435	150	1	80	0.0125000
NODE_248_length_4587_cov_14.431150	4355	4435	151	1	80	0.0125000
NODE_248_length_4587_cov_14.431150	4355	4435	153	1	80	0.0125000
NODE_248_length_4587_cov_14.431150	4355	4435	158	2	80	0.0250000
NODE_248_length_4587_cov_14.431150	4355	4435	163	2	80	0.0250000
NODE_248_length_4587_cov_14.431150	4355	4435	164	2	80	0.0250000
NODE_248_length_4587_cov_14.431150	4355	4435	167	2	80	0.0250000
NODE_248_length_4587_cov_14.431150	4355	4435	168	1	80	0.0125000
NODE_248_length_4587_cov_14.431150	4355	4435	170	3	80	0.0375000
NODE_248_length_4587_cov_14.431150	4355	4435	171	1	80	0.0125000
NODE_248_length_4587_cov_14.431150	4355	4435	172	1	80	0.0125000
NODE_248_length_4587_cov_14.431150	4355	4435	175	1	80	0.0125000
NODE_248_length_4587_cov_14.431150	4355	4435	176	1	80	0.0125000
NODE_248_length_4587_cov_14.431150	4355	4435	178	1	80	0.0125000
NODE_248_length_4587_cov_14.431150	4355	4435	179	1	80	0.0125000
NODE_248_length_4587_cov_14.431150	4355	4435	181	2	80	0.0250000
NODE_248_length_4587_cov_14.431150	4355	4435	183	1	80	0.0125000
NODE_248_length_4587_cov_14.431150	4355	4435	184	2	80	0.0250000
NODE_248_length_4587_cov_14.431150	4355	4435	186	1	80	0.0125000
NODE_248_length_4587_cov_14.431150	4355	4435	188	1	80	0.0125000
NODE_248_length_4587_cov_14.431150	4355	4435	191	1	80	0.0125000
NODE_248_length_4587_cov_14.431150	4355	4435	194	1	80	0.0125000
NODE_248_length_4587_cov_14.431150	4355	4435	195	2	80	0.0250000
NODE_248_length_4587_cov_14.431150	4355	4435	197	2	80	0.0250000
NODE_248_length_4587_cov_14.431150	4355	4435	203	1	80	0.0125000
NODE_248_length_4587_cov_14.431150	4355	4435	204	2	80	0.0250000
NODE_248_length_4587_cov_14.431150	4355	4435	210	1	80	0.0125000
NODE_248_length_4587_cov_14.431150	4355	4435	212	1	80	0.0125000
NODE_248_length_4587_cov_14.431150	4355	4435	213	1	80	0.0125000
NODE_248_length_4587_cov_14.431150	4355	4435	214	2	80	0.0250000
NODE_248_length_4587_cov_14.431150	4355	4435	215	2	80	0.0250000
NODE_248_length_4587_cov_14.431150	4355	4435	216	2	80	0.0250000
NODE_248_length_4587_cov_14.431150	4355	4435	217	2	80	0.0250000
NODE_248_length_4587_cov_14.431150	4355	4435	219	2	80	0.0250000
NODE_248_length_4587_cov_14.431150	4355	4435	221	1	80	0.0125000
NODE_248_length_4587_cov_14.431150	4355	4435	222	3	80	0.0375000
NODE_248_length_4587_cov_14.431150	4355	4435	227	3	80	0.0375000
NODE_248_length_4587_cov_14.431150	4355	4435	231	1	80	0.0125000
NODE_248_length_4587_cov_14.431150	4355	4435	233	2	80	0.0250000
NODE_248_length_4587_cov_14.431150	4355	4435	236	1	80	0.0125000
NODE_249_length_4572_cov_50.244579	2406	2483	4	19	77	0.2467532
NODE_249_length_4572_cov_50.244579	2406	2483	5	32	77	0.4155844
NODE_249_length_4572_cov_50.244579	2406	2483	6	26	77	0.3376623
NODE_249_length_4572_cov_50.244579	2406	2483	4	19	77	0.2467532
NODE_249_length_4572_cov_50.244579	2406	2483	5	32	77	0.4155844
NODE_249_length_4572_cov_50.244579	2406	2483	6	26	77	0.3376623
NODE_251_length_4556_cov_14.556652	4229	4288	183	1	59	0.0169492
NODE_251_length_4556_cov_14.556652	4229	4288	184	1	59	0.0169492
NODE_251_length_4556_cov_14.556652	4229	4288	185	1	59	0.0169492
NODE_251_length_4556_cov_14.556652	4229	4288	186	1	59	0.0169492
NODE_251_length_4556_cov_14.556652	4229	4288	188	2	59	0.0338983
NODE_251_length_4556_cov_14.556652	4229	4288	189	1	59	0.0169492
NODE_251_length_4556_cov_14.556652	4229	4288	190	1	59	0.0169492
NODE_251_length_4556_cov_14.556652	4229	4288	191	1	59	0.0169492
NODE_251_length_4556_cov_14.556652	4229	4288	193	1	59	0.0169492
NODE_251_length_4556_cov_14.556652	4229	4288	195	2	59	0.0338983
NODE_251_length_4556_cov_14.556652	4229	4288	196	3	59	0.0508475
NODE_251_length_4556_cov_14.556652	4229	4288	197	8	59	0.1355932
NODE_251_length_4556_cov_14.556652	4229	4288	198	2	59	0.0338983
NODE_251_length_4556_cov_14.556652	4229	4288	199	3	59	0.0508475
NODE_251_length_4556_cov_14.556652	4229	4288	200	4	59	0.0677966
NODE_251_length_4556_cov_14.556652	4229	4288	201	11	59	0.1864407
NODE_251_length_4556_cov_14.556652	4229	4288	202	4	59	0.0677966
NODE_251_length_4556_cov_14.556652	4229	4288	203	6	59	0.1016949
NODE_251_length_4556_cov_14.556652	4229	4288	204	4	59	0.0677966
NODE_251_length_4556_cov_14.556652	4229	4288	205	2	59	0.0338983
NODE_252_length_4550_cov_5.664120	3548	3628	0	80	80	1.0000000
NODE_252_length_4550_cov_5.664120	3601	3681	0	80	80	1.0000000
NODE_253_length_4544_cov_10.690439	353	433	1	4	80	0.0500000
NODE_253_length_4544_cov_10.690439	353	433	3	21	80	0.2625000
NODE_253_length_4544_cov_10.690439	353	433	4	55	80	0.6875000
NODE_253_length_4544_cov_10.690439	406	486	1	14	80	0.1750000
NODE_253_length_4544_cov_10.690439	406	486	3	15	80	0.1875000
NODE_253_length_4544_cov_10.690439	406	486	4	51	80	0.6375000
NODE_253_length_4544_cov_10.690439	4487	4544	0	55	57	0.9649123
NODE_253_length_4544_cov_10.690439	4487	4544	2	2	57	0.0350877
NODE_255_length_4535_cov_24.849188	675	755	0	8	80	0.1000000
NODE_255_length_4535_cov_24.849188	675	755	1	21	80	0.2625000
NODE_255_length_4535_cov_24.849188	675	755	2	5	80	0.0625000
NODE_255_length_4535_cov_24.849188	675	755	3	46	80	0.5750000
NODE_255_length_4535_cov_24.849188	728	809	0	62	81	0.7654321
NODE_255_length_4535_cov_24.849188	728	809	2	3	81	0.0370370
NODE_255_length_4535_cov_24.849188	728	809	3	16	81	0.1975309
NODE_255_length_4535_cov_24.849188	1319	1399	7	48	80	0.6000000
NODE_255_length_4535_cov_24.849188	1319	1399	9	1	80	0.0125000
NODE_255_length_4535_cov_24.849188	1319	1399	11	2	80	0.0250000
NODE_255_length_4535_cov_24.849188	1319	1399	12	10	80	0.1250000
NODE_255_length_4535_cov_24.849188	1319	1399	13	1	80	0.0125000
NODE_255_length_4535_cov_24.849188	1319	1399	16	2	80	0.0250000
NODE_255_length_4535_cov_24.849188	1319	1399	17	10	80	0.1250000
NODE_255_length_4535_cov_24.849188	1319	1399	18	2	80	0.0250000
NODE_255_length_4535_cov_24.849188	1319	1399	19	4	80	0.0500000
NODE_255_length_4535_cov_24.849188	1372	1452	12	8	80	0.1000000
NODE_255_length_4535_cov_24.849188	1372	1452	13	1	80	0.0125000
NODE_255_length_4535_cov_24.849188	1372	1452	15	1	80	0.0125000
NODE_255_length_4535_cov_24.849188	1372	1452	16	5	80	0.0625000
NODE_255_length_4535_cov_24.849188	1372	1452	17	11	80	0.1375000
NODE_255_length_4535_cov_24.849188	1372	1452	18	2	80	0.0250000
NODE_255_length_4535_cov_24.849188	1372	1452	19	10	80	0.1250000
NODE_255_length_4535_cov_24.849188	1372	1452	20	9	80	0.1125000
NODE_255_length_4535_cov_24.849188	1372	1452	21	1	80	0.0125000
NODE_255_length_4535_cov_24.849188	1372	1452	22	1	80	0.0125000
NODE_255_length_4535_cov_24.849188	1372	1452	23	1	80	0.0125000
NODE_255_length_4535_cov_24.849188	1372	1452	24	1	80	0.0125000
NODE_255_length_4535_cov_24.849188	1372	1452	29	2	80	0.0250000
NODE_255_length_4535_cov_24.849188	1372	1452	34	4	80	0.0500000
NODE_255_length_4535_cov_24.849188	1372	1452	37	1	80	0.0125000
NODE_255_length_4535_cov_24.849188	1372	1452	39	7	80	0.0875000
NODE_255_length_4535_cov_24.849188	1372	1452	40	5	80	0.0625000
NODE_255_length_4535_cov_24.849188	1372	1452	41	2	80	0.0250000
NODE_255_length_4535_cov_24.849188	1372	1452	42	2	80	0.0250000
NODE_255_length_4535_cov_24.849188	1372	1452	44	2	80	0.0250000
NODE_255_length_4535_cov_24.849188	1372	1452	45	1	80	0.0125000
NODE_255_length_4535_cov_24.849188	1372	1452	48	3	80	0.0375000
NODE_258_length_4528_cov_19.736509	4295	4366	1	67	71	0.9436620
NODE_258_length_4528_cov_19.736509	4295	4366	2	1	71	0.0140845
NODE_258_length_4528_cov_19.736509	4295	4366	3	1	71	0.0140845
NODE_258_length_4528_cov_19.736509	4295	4366	4	1	71	0.0140845
NODE_258_length_4528_cov_19.736509	4295	4366	10	1	71	0.0140845
NODE_259_length_4505_cov_10.409215	3166	3202	9	1	36	0.0277778
NODE_259_length_4505_cov_10.409215	3166	3202	10	6	36	0.1666667
NODE_259_length_4505_cov_10.409215	3166	3202	11	4	36	0.1111111
NODE_259_length_4505_cov_10.409215	3166	3202	13	4	36	0.1111111
NODE_259_length_4505_cov_10.409215	3166	3202	14	13	36	0.3611111
NODE_259_length_4505_cov_10.409215	3166	3202	15	8	36	0.2222222
NODE_259_length_4505_cov_10.409215	3175	3255	11	2	80	0.0250000
NODE_259_length_4505_cov_10.409215	3175	3255	13	4	80	0.0500000
NODE_259_length_4505_cov_10.409215	3175	3255	14	29	80	0.3625000
NODE_259_length_4505_cov_10.409215	3175	3255	15	32	80	0.4000000
NODE_259_length_4505_cov_10.409215	3175	3255	16	13	80	0.1625000
NODE_260_length_4498_cov_8.216185	3161	3219	0	56	58	0.9655172
NODE_260_length_4498_cov_8.216185	3161	3219	1	2	58	0.0344828
NODE_260_length_4498_cov_8.216185	4257	4314	0	57	57	1.0000000
NODE_263_length_4476_cov_29.825451	141	215	0	74	74	1.0000000
NODE_263_length_4476_cov_29.825451	1890	1970	116	3	80	0.0375000
NODE_263_length_4476_cov_29.825451	1890	1970	118	1	80	0.0125000
NODE_263_length_4476_cov_29.825451	1890	1970	119	4	80	0.0500000
NODE_263_length_4476_cov_29.825451	1890	1970	120	6	80	0.0750000
NODE_263_length_4476_cov_29.825451	1890	1970	121	3	80	0.0375000
NODE_263_length_4476_cov_29.825451	1890	1970	122	2	80	0.0250000
NODE_263_length_4476_cov_29.825451	1890	1970	123	9	80	0.1125000
NODE_263_length_4476_cov_29.825451	1890	1970	124	7	80	0.0875000
NODE_263_length_4476_cov_29.825451	1890	1970	125	6	80	0.0750000
NODE_263_length_4476_cov_29.825451	1890	1970	126	9	80	0.1125000
NODE_263_length_4476_cov_29.825451	1890	1970	127	6	80	0.0750000
NODE_263_length_4476_cov_29.825451	1890	1970	128	8	80	0.1000000
NODE_263_length_4476_cov_29.825451	1890	1970	129	4	80	0.0500000
NODE_263_length_4476_cov_29.825451	1890	1970	130	8	80	0.1000000
NODE_263_length_4476_cov_29.825451	1890	1970	131	2	80	0.0250000
NODE_263_length_4476_cov_29.825451	1890	1970	132	2	80	0.0250000
NODE_263_length_4476_cov_29.825451	1943	2023	89	1	80	0.0125000
NODE_263_length_4476_cov_29.825451	1943	2023	92	2	80	0.0250000
NODE_263_length_4476_cov_29.825451	1943	2023	95	1	80	0.0125000
NODE_263_length_4476_cov_29.825451	1943	2023	100	1	80	0.0125000
NODE_263_length_4476_cov_29.825451	1943	2023	101	2	80	0.0250000
NODE_263_length_4476_cov_29.825451	1943	2023	102	4	80	0.0500000
NODE_263_length_4476_cov_29.825451	1943	2023	103	7	80	0.0875000
NODE_263_length_4476_cov_29.825451	1943	2023	104	2	80	0.0250000
NODE_263_length_4476_cov_29.825451	1943	2023	105	4	80	0.0500000
NODE_263_length_4476_cov_29.825451	1943	2023	106	5	80	0.0625000
NODE_263_length_4476_cov_29.825451	1943	2023	107	5	80	0.0625000
NODE_263_length_4476_cov_29.825451	1943	2023	108	4	80	0.0500000
NODE_263_length_4476_cov_29.825451	1943	2023	109	1	80	0.0125000
NODE_263_length_4476_cov_29.825451	1943	2023	110	1	80	0.0125000
NODE_263_length_4476_cov_29.825451	1943	2023	111	2	80	0.0250000
NODE_263_length_4476_cov_29.825451	1943	2023	112	1	80	0.0125000
NODE_263_length_4476_cov_29.825451	1943	2023	113	1	80	0.0125000
NODE_263_length_4476_cov_29.825451	1943	2023	114	2	80	0.0250000
NODE_263_length_4476_cov_29.825451	1943	2023	115	2	80	0.0250000
NODE_263_length_4476_cov_29.825451	1943	2023	117	1	80	0.0125000
NODE_263_length_4476_cov_29.825451	1943	2023	118	2	80	0.0250000
NODE_263_length_4476_cov_29.825451	1943	2023	119	6	80	0.0750000
NODE_263_length_4476_cov_29.825451	1943	2023	120	5	80	0.0625000
NODE_263_length_4476_cov_29.825451	1943	2023	121	2	80	0.0250000
NODE_263_length_4476_cov_29.825451	1943	2023	122	2	80	0.0250000
NODE_263_length_4476_cov_29.825451	1943	2023	123	3	80	0.0375000
NODE_263_length_4476_cov_29.825451	1943	2023	124	1	80	0.0125000
NODE_263_length_4476_cov_29.825451	1943	2023	125	1	80	0.0125000
NODE_263_length_4476_cov_29.825451	1943	2023	126	1	80	0.0125000
NODE_263_length_4476_cov_29.825451	1943	2023	129	1	80	0.0125000
NODE_263_length_4476_cov_29.825451	1943	2023	130	3	80	0.0375000
NODE_263_length_4476_cov_29.825451	1943	2023	131	2	80	0.0250000
NODE_263_length_4476_cov_29.825451	1943	2023	132	2	80	0.0250000
NODE_264_length_4474_cov_17.051886	23	99	0	76	76	1.0000000
NODE_264_length_4474_cov_17.051886	23	98	0	75	75	1.0000000
NODE_264_length_4474_cov_17.051886	23	99	0	76	76	1.0000000
NODE_264_length_4474_cov_17.051886	32	99	0	67	67	1.0000000
NODE_264_length_4474_cov_17.051886	76	140	0	64	64	1.0000000
NODE_264_length_4474_cov_17.051886	1528	1569	26	2	41	0.0487805
NODE_264_length_4474_cov_17.051886	1528	1569	27	1	41	0.0243902
NODE_264_length_4474_cov_17.051886	1528	1569	29	2	41	0.0487805
NODE_264_length_4474_cov_17.051886	1528	1569	34	2	41	0.0487805
NODE_264_length_4474_cov_17.051886	1528	1569	36	4	41	0.0975610
NODE_264_length_4474_cov_17.051886	1528	1569	39	2	41	0.0487805
NODE_264_length_4474_cov_17.051886	1528	1569	41	2	41	0.0487805
NODE_264_length_4474_cov_17.051886	1528	1569	43	4	41	0.0975610
NODE_264_length_4474_cov_17.051886	1528	1569	45	1	41	0.0243902
NODE_264_length_4474_cov_17.051886	1528	1569	48	1	41	0.0243902
NODE_264_length_4474_cov_17.051886	1528	1569	51	1	41	0.0243902
NODE_264_length_4474_cov_17.051886	1528	1569	53	1	41	0.0243902
NODE_264_length_4474_cov_17.051886	1528	1569	57	3	41	0.0731707
NODE_264_length_4474_cov_17.051886	1528	1569	58	2	41	0.0487805
NODE_264_length_4474_cov_17.051886	1528	1569	61	1	41	0.0243902
NODE_264_length_4474_cov_17.051886	1528	1569	62	1	41	0.0243902
NODE_264_length_4474_cov_17.051886	1528	1569	63	1	41	0.0243902
NODE_264_length_4474_cov_17.051886	1528	1569	64	2	41	0.0487805
NODE_264_length_4474_cov_17.051886	1528	1569	68	3	41	0.0731707
NODE_264_length_4474_cov_17.051886	1528	1569	70	2	41	0.0487805
NODE_264_length_4474_cov_17.051886	1528	1569	71	1	41	0.0243902
NODE_264_length_4474_cov_17.051886	1528	1569	72	2	41	0.0487805
NODE_264_length_4474_cov_17.051886	1536	1609	11	9	73	0.1232877
NODE_264_length_4474_cov_17.051886	1536	1609	12	5	73	0.0684932
NODE_264_length_4474_cov_17.051886	1536	1609	13	4	73	0.0547945
NODE_264_length_4474_cov_17.051886	1536	1609	14	1	73	0.0136986
NODE_264_length_4474_cov_17.051886	1536	1609	15	2	73	0.0273973
NODE_264_length_4474_cov_17.051886	1536	1609	16	5	73	0.0684932
NODE_264_length_4474_cov_17.051886	1536	1609	18	5	73	0.0684932
NODE_264_length_4474_cov_17.051886	1536	1609	21	7	73	0.0958904
NODE_264_length_4474_cov_17.051886	1536	1609	23	1	73	0.0136986
NODE_264_length_4474_cov_17.051886	1536	1609	24	1	73	0.0136986
NODE_264_length_4474_cov_17.051886	1536	1609	26	2	73	0.0273973
NODE_264_length_4474_cov_17.051886	1536	1609	27	1	73	0.0136986
NODE_264_length_4474_cov_17.051886	1536	1609	29	2	73	0.0273973
NODE_264_length_4474_cov_17.051886	1536	1609	34	2	73	0.0273973
NODE_264_length_4474_cov_17.051886	1536	1609	36	4	73	0.0547945
NODE_264_length_4474_cov_17.051886	1536	1609	39	2	73	0.0273973
NODE_264_length_4474_cov_17.051886	1536	1609	41	2	73	0.0273973
NODE_264_length_4474_cov_17.051886	1536	1609	43	4	73	0.0547945
NODE_264_length_4474_cov_17.051886	1536	1609	45	1	73	0.0136986
NODE_264_length_4474_cov_17.051886	1536	1609	48	1	73	0.0136986
NODE_264_length_4474_cov_17.051886	1536	1609	51	1	73	0.0136986
NODE_264_length_4474_cov_17.051886	1536	1609	53	1	73	0.0136986
NODE_264_length_4474_cov_17.051886	1536	1609	57	3	73	0.0410959
NODE_264_length_4474_cov_17.051886	1536	1609	58	2	73	0.0273973
NODE_264_length_4474_cov_17.051886	1536	1609	61	1	73	0.0136986
NODE_264_length_4474_cov_17.051886	1536	1609	62	1	73	0.0136986
NODE_264_length_4474_cov_17.051886	1536	1609	63	1	73	0.0136986
NODE_264_length_4474_cov_17.051886	1536	1609	64	2	73	0.0273973
NODE_264_length_4474_cov_17.051886	1618	1643	7	2	25	0.0800000
NODE_264_length_4474_cov_17.051886	1618	1643	9	17	25	0.6800000
NODE_264_length_4474_cov_17.051886	1618	1643	10	1	25	0.0400000
NODE_264_length_4474_cov_17.051886	1618	1643	11	1	25	0.0400000
NODE_264_length_4474_cov_17.051886	1618	1643	12	4	25	0.1600000
NODE_264_length_4474_cov_17.051886	1618	1696	7	2	78	0.0256410
NODE_264_length_4474_cov_17.051886	1618	1696	9	34	78	0.4358974
NODE_264_length_4474_cov_17.051886	1618	1696	10	24	78	0.3076923
NODE_264_length_4474_cov_17.051886	1618	1696	11	14	78	0.1794872
NODE_264_length_4474_cov_17.051886	1618	1696	12	4	78	0.0512821
NODE_265_length_4474_cov_14.441829	282	362	6	10	80	0.1250000
NODE_265_length_4474_cov_14.441829	282	362	7	16	80	0.2000000
NODE_265_length_4474_cov_14.441829	282	362	8	14	80	0.1750000
NODE_265_length_4474_cov_14.441829	282	362	9	6	80	0.0750000
NODE_265_length_4474_cov_14.441829	282	362	10	2	80	0.0250000
NODE_265_length_4474_cov_14.441829	282	362	11	10	80	0.1250000
NODE_265_length_4474_cov_14.441829	282	362	12	22	80	0.2750000
NODE_265_length_4474_cov_14.441829	335	415	0	6	80	0.0750000
NODE_265_length_4474_cov_14.441829	335	415	1	8	80	0.1000000
NODE_265_length_4474_cov_14.441829	335	415	2	13	80	0.1625000
NODE_265_length_4474_cov_14.441829	335	415	3	15	80	0.1875000
NODE_265_length_4474_cov_14.441829	335	415	4	2	80	0.0250000
NODE_265_length_4474_cov_14.441829	335	415	5	6	80	0.0750000
NODE_265_length_4474_cov_14.441829	335	415	6	11	80	0.1375000
NODE_265_length_4474_cov_14.441829	335	415	7	16	80	0.2000000
NODE_265_length_4474_cov_14.441829	335	415	8	1	80	0.0125000
NODE_265_length_4474_cov_14.441829	335	415	21	1	80	0.0125000
NODE_265_length_4474_cov_14.441829	335	415	27	1	80	0.0125000
NODE_265_length_4474_cov_14.441829	1522	1575	5	5	53	0.0943396
NODE_265_length_4474_cov_14.441829	1522	1575	6	32	53	0.6037736
NODE_265_length_4474_cov_14.441829	1522	1575	7	12	53	0.2264151
NODE_265_length_4474_cov_14.441829	1522	1575	18	4	53	0.0754717
NODE_265_length_4474_cov_14.441829	1548	1623	4	2	75	0.0266667
NODE_265_length_4474_cov_14.441829	1548	1623	5	11	75	0.1466667
NODE_265_length_4474_cov_14.441829	1548	1623	6	45	75	0.6000000
NODE_265_length_4474_cov_14.441829	1548	1623	7	17	75	0.2266667
NODE_265_length_4474_cov_14.441829	3068	3121	2	13	53	0.2452830
NODE_265_length_4474_cov_14.441829	3068	3121	3	5	53	0.0943396
NODE_265_length_4474_cov_14.441829	3068	3121	5	21	53	0.3962264
NODE_265_length_4474_cov_14.441829	3068	3121	6	5	53	0.0943396
NODE_265_length_4474_cov_14.441829	3068	3121	7	5	53	0.0943396
NODE_265_length_4474_cov_14.441829	3068	3121	8	2	53	0.0377358
NODE_265_length_4474_cov_14.441829	3068	3121	9	2	53	0.0377358
NODE_268_length_4463_cov_7.023144	119	168	0	44	49	0.8979592
NODE_268_length_4463_cov_7.023144	119	168	5	3	49	0.0612245
NODE_268_length_4463_cov_7.023144	119	168	7	2	49	0.0408163
NODE_270_length_4453_cov_16.820395	3383	3463	143	1	80	0.0125000
NODE_270_length_4453_cov_16.820395	3383	3463	146	2	80	0.0250000
NODE_270_length_4453_cov_16.820395	3383	3463	150	1	80	0.0125000
NODE_270_length_4453_cov_16.820395	3383	3463	152	3	80	0.0375000
NODE_270_length_4453_cov_16.820395	3383	3463	154	1	80	0.0125000
NODE_270_length_4453_cov_16.820395	3383	3463	155	1	80	0.0125000
NODE_270_length_4453_cov_16.820395	3383	3463	158	2	80	0.0250000
NODE_270_length_4453_cov_16.820395	3383	3463	162	3	80	0.0375000
NODE_270_length_4453_cov_16.820395	3383	3463	164	1	80	0.0125000
NODE_270_length_4453_cov_16.820395	3383	3463	165	3	80	0.0375000
NODE_270_length_4453_cov_16.820395	3383	3463	166	4	80	0.0500000
NODE_270_length_4453_cov_16.820395	3383	3463	167	1	80	0.0125000
NODE_270_length_4453_cov_16.820395	3383	3463	169	1	80	0.0125000
NODE_270_length_4453_cov_16.820395	3383	3463	170	3	80	0.0375000
NODE_270_length_4453_cov_16.820395	3383	3463	173	1	80	0.0125000
NODE_270_length_4453_cov_16.820395	3383	3463	175	1	80	0.0125000
NODE_270_length_4453_cov_16.820395	3383	3463	176	1	80	0.0125000
NODE_270_length_4453_cov_16.820395	3383	3463	180	1	80	0.0125000
NODE_270_length_4453_cov_16.820395	3383	3463	183	3	80	0.0375000
NODE_270_length_4453_cov_16.820395	3383	3463	187	2	80	0.0250000
NODE_270_length_4453_cov_16.820395	3383	3463	189	4	80	0.0500000
NODE_270_length_4453_cov_16.820395	3383	3463	190	1	80	0.0125000
NODE_270_length_4453_cov_16.820395	3383	3463	191	2	80	0.0250000
NODE_270_length_4453_cov_16.820395	3383	3463	192	1	80	0.0125000
NODE_270_length_4453_cov_16.820395	3383	3463	193	1	80	0.0125000
NODE_270_length_4453_cov_16.820395	3383	3463	197	2	80	0.0250000
NODE_270_length_4453_cov_16.820395	3383	3463	198	1	80	0.0125000
NODE_270_length_4453_cov_16.820395	3383	3463	199	3	80	0.0375000
NODE_270_length_4453_cov_16.820395	3383	3463	200	1	80	0.0125000
NODE_270_length_4453_cov_16.820395	3383	3463	203	1	80	0.0125000
NODE_270_length_4453_cov_16.820395	3383	3463	207	1	80	0.0125000
NODE_270_length_4453_cov_16.820395	3383	3463	208	3	80	0.0375000
NODE_270_length_4453_cov_16.820395	3383	3463	211	1	80	0.0125000
NODE_270_length_4453_cov_16.820395	3383	3463	218	2	80	0.0250000
NODE_270_length_4453_cov_16.820395	3383	3463	219	2	80	0.0250000
NODE_270_length_4453_cov_16.820395	3383	3463	221	1	80	0.0125000
NODE_270_length_4453_cov_16.820395	3383	3463	222	1	80	0.0125000
NODE_270_length_4453_cov_16.820395	3383	3463	228	1	80	0.0125000
NODE_270_length_4453_cov_16.820395	3383	3463	229	1	80	0.0125000
NODE_270_length_4453_cov_16.820395	3383	3463	230	1	80	0.0125000
NODE_270_length_4453_cov_16.820395	3383	3463	231	1	80	0.0125000
NODE_270_length_4453_cov_16.820395	3383	3463	232	2	80	0.0250000
NODE_270_length_4453_cov_16.820395	3383	3463	233	1	80	0.0125000
NODE_270_length_4453_cov_16.820395	3383	3463	237	2	80	0.0250000
NODE_270_length_4453_cov_16.820395	3383	3463	241	2	80	0.0250000
NODE_270_length_4453_cov_16.820395	3383	3463	244	1	80	0.0125000
NODE_270_length_4453_cov_16.820395	3383	3463	246	2	80	0.0250000
NODE_270_length_4453_cov_16.820395	3383	3463	249	2	80	0.0250000
NODE_270_length_4453_cov_16.820395	3436	3496	68	1	60	0.0166667
NODE_270_length_4453_cov_16.820395	3436	3496	72	1	60	0.0166667
NODE_270_length_4453_cov_16.820395	3436	3496	83	1	60	0.0166667
NODE_270_length_4453_cov_16.820395	3436	3496	86	1	60	0.0166667
NODE_270_length_4453_cov_16.820395	3436	3496	88	2	60	0.0333333
NODE_270_length_4453_cov_16.820395	3436	3496	91	1	60	0.0166667
NODE_270_length_4453_cov_16.820395	3436	3496	99	1	60	0.0166667
NODE_270_length_4453_cov_16.820395	3436	3496	101	2	60	0.0333333
NODE_270_length_4453_cov_16.820395	3436	3496	104	1	60	0.0166667
NODE_270_length_4453_cov_16.820395	3436	3496	116	1	60	0.0166667
NODE_270_length_4453_cov_16.820395	3436	3496	117	5	60	0.0833333
NODE_270_length_4453_cov_16.820395	3436	3496	118	1	60	0.0166667
NODE_270_length_4453_cov_16.820395	3436	3496	123	2	60	0.0333333
NODE_270_length_4453_cov_16.820395	3436	3496	125	1	60	0.0166667
NODE_270_length_4453_cov_16.820395	3436	3496	126	1	60	0.0166667
NODE_270_length_4453_cov_16.820395	3436	3496	130	1	60	0.0166667
NODE_270_length_4453_cov_16.820395	3436	3496	131	1	60	0.0166667
NODE_270_length_4453_cov_16.820395	3436	3496	133	4	60	0.0666667
NODE_270_length_4453_cov_16.820395	3436	3496	134	1	60	0.0166667
NODE_270_length_4453_cov_16.820395	3436	3496	136	2	60	0.0333333
NODE_270_length_4453_cov_16.820395	3436	3496	138	1	60	0.0166667
NODE_270_length_4453_cov_16.820395	3436	3496	139	1	60	0.0166667
NODE_270_length_4453_cov_16.820395	3436	3496	143	1	60	0.0166667
NODE_270_length_4453_cov_16.820395	3436	3496	146	2	60	0.0333333
NODE_270_length_4453_cov_16.820395	3436	3496	150	1	60	0.0166667
NODE_270_length_4453_cov_16.820395	3436	3496	152	3	60	0.0500000
NODE_270_length_4453_cov_16.820395	3436	3496	154	1	60	0.0166667
NODE_270_length_4453_cov_16.820395	3436	3496	155	1	60	0.0166667
NODE_270_length_4453_cov_16.820395	3436	3496	158	2	60	0.0333333
NODE_270_length_4453_cov_16.820395	3436	3496	162	3	60	0.0500000
NODE_270_length_4453_cov_16.820395	3436	3496	164	1	60	0.0166667
NODE_270_length_4453_cov_16.820395	3436	3496	165	3	60	0.0500000
NODE_270_length_4453_cov_16.820395	3436	3496	166	4	60	0.0666667
NODE_270_length_4453_cov_16.820395	3436	3496	167	1	60	0.0166667
NODE_270_length_4453_cov_16.820395	3436	3496	169	1	60	0.0166667
NODE_270_length_4453_cov_16.820395	3436	3496	170	3	60	0.0500000
NODE_272_length_4436_cov_31.114595	2807	2871	2	14	64	0.2187500
NODE_272_length_4436_cov_31.114595	2807	2871	4	20	64	0.3125000
NODE_272_length_4436_cov_31.114595	2807	2871	6	4	64	0.0625000
NODE_272_length_4436_cov_31.114595	2807	2871	8	6	64	0.0937500
NODE_272_length_4436_cov_31.114595	2807	2871	9	20	64	0.3125000
NODE_272_length_4436_cov_31.114595	2846	2906	2	31	60	0.5166667
NODE_272_length_4436_cov_31.114595	2846	2906	3	7	60	0.1166667
NODE_272_length_4436_cov_31.114595	2846	2906	4	22	60	0.3666667
NODE_272_length_4436_cov_31.114595	2846	2898	2	31	52	0.5961539
NODE_272_length_4436_cov_31.114595	2846	2898	3	7	52	0.1346154
NODE_272_length_4436_cov_31.114595	2846	2898	4	14	52	0.2692308
NODE_278_length_4391_cov_7.711323	66	141	1	16	75	0.2133333
NODE_278_length_4391_cov_7.711323	66	141	2	59	75	0.7866667
NODE_278_length_4391_cov_7.711323	119	155	0	4	36	0.1111111
NODE_278_length_4391_cov_7.711323	119	155	1	26	36	0.7222222
NODE_278_length_4391_cov_7.711323	119	155	2	6	36	0.1666667
NODE_279_length_4385_cov_6.067662	1556	1606	1	3	50	0.0600000
NODE_279_length_4385_cov_6.067662	1556	1606	2	1	50	0.0200000
NODE_279_length_4385_cov_6.067662	1556	1606	9	2	50	0.0400000
NODE_279_length_4385_cov_6.067662	1556	1606	12	4	50	0.0800000
NODE_279_length_4385_cov_6.067662	1556	1606	14	4	50	0.0800000
NODE_279_length_4385_cov_6.067662	1556	1606	16	4	50	0.0800000
NODE_279_length_4385_cov_6.067662	1556	1606	18	2	50	0.0400000
NODE_279_length_4385_cov_6.067662	1556	1606	19	7	50	0.1400000
NODE_279_length_4385_cov_6.067662	1556	1606	20	4	50	0.0800000
NODE_279_length_4385_cov_6.067662	1556	1606	21	19	50	0.3800000
NODE_286_length_4331_cov_37.938800	1898	1978	26	7	80	0.0875000
NODE_286_length_4331_cov_37.938800	1898	1978	27	7	80	0.0875000
NODE_286_length_4331_cov_37.938800	1898	1978	28	17	80	0.2125000
NODE_286_length_4331_cov_37.938800	1898	1978	29	6	80	0.0750000
NODE_286_length_4331_cov_37.938800	1898	1978	31	2	80	0.0250000
NODE_286_length_4331_cov_37.938800	1898	1978	32	4	80	0.0500000
NODE_286_length_4331_cov_37.938800	1898	1978	33	9	80	0.1125000
NODE_286_length_4331_cov_37.938800	1898	1978	34	12	80	0.1500000
NODE_286_length_4331_cov_37.938800	1898	1978	35	6	80	0.0750000
NODE_286_length_4331_cov_37.938800	1898	1978	36	1	80	0.0125000
NODE_286_length_4331_cov_37.938800	1898	1978	37	3	80	0.0375000
NODE_286_length_4331_cov_37.938800	1898	1978	38	1	80	0.0125000
NODE_286_length_4331_cov_37.938800	1898	1978	39	3	80	0.0375000
NODE_286_length_4331_cov_37.938800	1898	1978	40	2	80	0.0250000
NODE_286_length_4331_cov_37.938800	1951	2031	32	3	80	0.0375000
NODE_286_length_4331_cov_37.938800	1951	2031	33	5	80	0.0625000
NODE_286_length_4331_cov_37.938800	1951	2031	34	6	80	0.0750000
NODE_286_length_4331_cov_37.938800	1951	2031	35	3	80	0.0375000
NODE_286_length_4331_cov_37.938800	1951	2031	36	1	80	0.0125000
NODE_286_length_4331_cov_37.938800	1951	2031	37	3	80	0.0375000
NODE_286_length_4331_cov_37.938800	1951	2031	38	1	80	0.0125000
NODE_286_length_4331_cov_37.938800	1951	2031	39	3	80	0.0375000
NODE_286_length_4331_cov_37.938800	1951	2031	40	2	80	0.0250000
NODE_286_length_4331_cov_37.938800	1951	2031	43	3	80	0.0375000
NODE_286_length_4331_cov_37.938800	1951	2031	45	4	80	0.0500000
NODE_286_length_4331_cov_37.938800	1951	2031	46	2	80	0.0250000
NODE_286_length_4331_cov_37.938800	1951	2031	47	1	80	0.0125000
NODE_286_length_4331_cov_37.938800	1951	2031	48	2	80	0.0250000
NODE_286_length_4331_cov_37.938800	1951	2031	49	4	80	0.0500000
NODE_286_length_4331_cov_37.938800	1951	2031	52	3	80	0.0375000
NODE_286_length_4331_cov_37.938800	1951	2031	53	1	80	0.0125000
NODE_286_length_4331_cov_37.938800	1951	2031	54	3	80	0.0375000
NODE_286_length_4331_cov_37.938800	1951	2031	55	5	80	0.0625000
NODE_286_length_4331_cov_37.938800	1951	2031	56	5	80	0.0625000
NODE_286_length_4331_cov_37.938800	1951	2031	58	5	80	0.0625000
NODE_286_length_4331_cov_37.938800	1951	2031	59	8	80	0.1000000
NODE_286_length_4331_cov_37.938800	1951	2031	60	7	80	0.0875000
NODE_286_length_4331_cov_37.938800	2027	2107	59	1	80	0.0125000
NODE_286_length_4331_cov_37.938800	2027	2107	60	4	80	0.0500000
NODE_286_length_4331_cov_37.938800	2027	2107	61	2	80	0.0250000
NODE_286_length_4331_cov_37.938800	2027	2107	64	1	80	0.0125000
NODE_286_length_4331_cov_37.938800	2027	2107	65	2	80	0.0250000
NODE_286_length_4331_cov_37.938800	2027	2107	67	5	80	0.0625000
NODE_286_length_4331_cov_37.938800	2027	2107	68	1	80	0.0125000
NODE_286_length_4331_cov_37.938800	2027	2107	69	4	80	0.0500000
NODE_286_length_4331_cov_37.938800	2027	2107	70	3	80	0.0375000
NODE_286_length_4331_cov_37.938800	2027	2107	71	3	80	0.0375000
NODE_286_length_4331_cov_37.938800	2027	2107	72	7	80	0.0875000
NODE_286_length_4331_cov_37.938800	2027	2107	73	6	80	0.0750000
NODE_286_length_4331_cov_37.938800	2027	2107	75	7	80	0.0875000
NODE_286_length_4331_cov_37.938800	2027	2107	76	5	80	0.0625000
NODE_286_length_4331_cov_37.938800	2027	2107	77	16	80	0.2000000
NODE_286_length_4331_cov_37.938800	2027	2107	78	12	80	0.1500000
NODE_286_length_4331_cov_37.938800	2027	2107	79	1	80	0.0125000
NODE_286_length_4331_cov_37.938800	2080	2160	46	2	80	0.0250000
NODE_286_length_4331_cov_37.938800	2080	2160	47	1	80	0.0125000
NODE_286_length_4331_cov_37.938800	2080	2160	49	4	80	0.0500000
NODE_286_length_4331_cov_37.938800	2080	2160	50	4	80	0.0500000
NODE_286_length_4331_cov_37.938800	2080	2160	51	1	80	0.0125000
NODE_286_length_4331_cov_37.938800	2080	2160	52	1	80	0.0125000
NODE_286_length_4331_cov_37.938800	2080	2160	56	3	80	0.0375000
NODE_286_length_4331_cov_37.938800	2080	2160	59	6	80	0.0750000
NODE_286_length_4331_cov_37.938800	2080	2160	60	3	80	0.0375000
NODE_286_length_4331_cov_37.938800	2080	2160	61	2	80	0.0250000
NODE_286_length_4331_cov_37.938800	2080	2160	64	1	80	0.0125000
NODE_286_length_4331_cov_37.938800	2080	2160	65	1	80	0.0125000
NODE_286_length_4331_cov_37.938800	2080	2160	68	3	80	0.0375000
NODE_286_length_4331_cov_37.938800	2080	2160	72	1	80	0.0125000
NODE_286_length_4331_cov_37.938800	2080	2160	74	1	80	0.0125000
NODE_286_length_4331_cov_37.938800	2080	2160	75	11	80	0.1375000
NODE_286_length_4331_cov_37.938800	2080	2160	76	10	80	0.1250000
NODE_286_length_4331_cov_37.938800	2080	2160	77	14	80	0.1750000
NODE_286_length_4331_cov_37.938800	2080	2160	78	11	80	0.1375000
NODE_289_length_4320_cov_7.680881	442	522	14	9	80	0.1125000
NODE_289_length_4320_cov_7.680881	442	522	15	25	80	0.3125000
NODE_289_length_4320_cov_7.680881	442	522	16	39	80	0.4875000
NODE_289_length_4320_cov_7.680881	442	522	17	7	80	0.0875000
NODE_289_length_4320_cov_7.680881	495	575	8	15	80	0.1875000
NODE_289_length_4320_cov_7.680881	495	575	9	17	80	0.2125000
NODE_289_length_4320_cov_7.680881	495	575	10	5	80	0.0625000
NODE_289_length_4320_cov_7.680881	495	575	12	13	80	0.1625000
NODE_289_length_4320_cov_7.680881	495	575	14	6	80	0.0750000
NODE_289_length_4320_cov_7.680881	495	575	15	3	80	0.0375000
NODE_289_length_4320_cov_7.680881	495	575	16	14	80	0.1750000
NODE_289_length_4320_cov_7.680881	495	575	17	7	80	0.0875000
NODE_289_length_4320_cov_7.680881	571	651	3	13	80	0.1625000
NODE_289_length_4320_cov_7.680881	571	651	4	40	80	0.5000000
NODE_289_length_4320_cov_7.680881	571	651	5	4	80	0.0500000
NODE_289_length_4320_cov_7.680881	571	651	6	1	80	0.0125000
NODE_289_length_4320_cov_7.680881	571	651	7	14	80	0.1750000
NODE_289_length_4320_cov_7.680881	571	651	8	8	80	0.1000000
NODE_289_length_4320_cov_7.680881	624	704	3	9	80	0.1125000
NODE_289_length_4320_cov_7.680881	624	704	4	28	80	0.3500000
NODE_289_length_4320_cov_7.680881	624	704	5	37	80	0.4625000
NODE_289_length_4320_cov_7.680881	624	704	6	6	80	0.0750000
NODE_290_length_4314_cov_5.311507	1436	1516	1	73	80	0.9125000
NODE_290_length_4314_cov_5.311507	1436	1516	2	6	80	0.0750000
NODE_290_length_4314_cov_5.311507	1436	1516	3	1	80	0.0125000
NODE_290_length_4314_cov_5.311507	1489	1569	1	20	80	0.2500000
NODE_290_length_4314_cov_5.311507	1489	1569	2	6	80	0.0750000
NODE_290_length_4314_cov_5.311507	1489	1569	3	54	80	0.6750000
NODE_290_length_4314_cov_5.311507	3331	3400	2	7	69	0.1014493
NODE_290_length_4314_cov_5.311507	3331	3400	3	17	69	0.2463768
NODE_290_length_4314_cov_5.311507	3331	3400	4	1	69	0.0144928
NODE_290_length_4314_cov_5.311507	3331	3400	5	32	69	0.4637681
NODE_290_length_4314_cov_5.311507	3331	3400	6	9	69	0.1304348
NODE_290_length_4314_cov_5.311507	3331	3400	7	3	69	0.0434783
NODE_290_length_4314_cov_5.311507	3420	3482	5	11	62	0.1774193
NODE_290_length_4314_cov_5.311507	3420	3482	7	51	62	0.8225806
NODE_292_length_4311_cov_8.733381	92	171	12	2	79	0.0253165
NODE_292_length_4311_cov_8.733381	92	171	13	2	79	0.0253165
NODE_292_length_4311_cov_8.733381	92	171	14	2	79	0.0253165
NODE_292_length_4311_cov_8.733381	92	171	15	2	79	0.0253165
NODE_292_length_4311_cov_8.733381	92	171	17	1	79	0.0126582
NODE_292_length_4311_cov_8.733381	92	171	20	1	79	0.0126582
NODE_292_length_4311_cov_8.733381	92	171	21	8	79	0.1012658
NODE_292_length_4311_cov_8.733381	92	171	23	4	79	0.0506329
NODE_292_length_4311_cov_8.733381	92	171	24	1	79	0.0126582
NODE_292_length_4311_cov_8.733381	92	171	25	8	79	0.1012658
NODE_292_length_4311_cov_8.733381	92	171	26	8	79	0.1012658
NODE_292_length_4311_cov_8.733381	92	171	27	33	79	0.4177215
NODE_292_length_4311_cov_8.733381	92	171	28	7	79	0.0886076
NODE_292_length_4311_cov_8.733381	1925	2005	2	80	80	1.0000000
NODE_292_length_4311_cov_8.733381	1978	2058	0	50	80	0.6250000
NODE_292_length_4311_cov_8.733381	1978	2058	2	30	80	0.3750000
NODE_294_length_4293_cov_3.809251	244	326	2	15	82	0.1829268
NODE_294_length_4293_cov_3.809251	244	326	3	31	82	0.3780488
NODE_294_length_4293_cov_3.809251	244	326	4	36	82	0.4390244
NODE_294_length_4293_cov_3.809251	301	394	0	19	93	0.2043011
NODE_294_length_4293_cov_3.809251	301	394	2	22	93	0.2365591
NODE_294_length_4293_cov_3.809251	301	394	4	52	93	0.5591398
NODE_295_length_4284_cov_15.940263	3726	3806	0	49	80	0.6125000
NODE_295_length_4284_cov_15.940263	3726	3806	1	20	80	0.2500000
NODE_295_length_4284_cov_15.940263	3726	3806	3	11	80	0.1375000
NODE_295_length_4284_cov_15.940263	3779	3858	1	16	79	0.2025317
NODE_295_length_4284_cov_15.940263	3779	3858	3	63	79	0.7974684
NODE_299_length_4277_cov_5.451173	3818	3898	2	14	80	0.1750000
NODE_299_length_4277_cov_5.451173	3818	3898	3	22	80	0.2750000
NODE_299_length_4277_cov_5.451173	3818	3898	4	44	80	0.5500000
NODE_299_length_4277_cov_5.451173	3927	3995	5	30	68	0.4411765
NODE_299_length_4277_cov_5.451173	3927	3995	6	38	68	0.5588235
NODE_299_length_4277_cov_5.451173	3968	4048	4	12	80	0.1500000
NODE_299_length_4277_cov_5.451173	3968	4048	5	42	80	0.5250000
NODE_299_length_4277_cov_5.451173	3968	4048	6	26	80	0.3250000
NODE_300_length_4274_cov_18.943234	591	671	6	9	80	0.1125000
NODE_300_length_4274_cov_18.943234	591	671	7	20	80	0.2500000
NODE_300_length_4274_cov_18.943234	591	671	8	31	80	0.3875000
NODE_300_length_4274_cov_18.943234	591	671	10	20	80	0.2500000
NODE_300_length_4274_cov_18.943234	644	724	7	4	80	0.0500000
NODE_300_length_4274_cov_18.943234	644	724	8	4	80	0.0500000
NODE_300_length_4274_cov_18.943234	644	724	9	5	80	0.0625000
NODE_300_length_4274_cov_18.943234	644	724	10	67	80	0.8375000
NODE_301_length_4274_cov_16.160958	416	496	4	11	80	0.1375000
NODE_301_length_4274_cov_16.160958	416	496	5	64	80	0.8000000
NODE_301_length_4274_cov_16.160958	416	496	6	5	80	0.0625000
NODE_301_length_4274_cov_16.160958	1034	1114	0	20	80	0.2500000
NODE_301_length_4274_cov_16.160958	1034	1114	1	60	80	0.7500000
NODE_301_length_4274_cov_16.160958	1087	1167	0	73	80	0.9125000
NODE_301_length_4274_cov_16.160958	1087	1167	1	7	80	0.0875000
NODE_301_length_4274_cov_16.160958	1163	1243	0	80	80	1.0000000
NODE_301_length_4274_cov_16.160958	1216	1296	0	80	80	1.0000000
NODE_301_length_4274_cov_16.160958	3411	3491	6	14	80	0.1750000
NODE_301_length_4274_cov_16.160958	3411	3491	7	4	80	0.0500000
NODE_301_length_4274_cov_16.160958	3411	3491	8	24	80	0.3000000
NODE_301_length_4274_cov_16.160958	3411	3491	10	1	80	0.0125000
NODE_301_length_4274_cov_16.160958	3411	3491	12	12	80	0.1500000
NODE_301_length_4274_cov_16.160958	3411	3491	14	8	80	0.1000000
NODE_301_length_4274_cov_16.160958	3411	3491	15	7	80	0.0875000
NODE_301_length_4274_cov_16.160958	3411	3491	19	1	80	0.0125000
NODE_301_length_4274_cov_16.160958	3411	3491	21	1	80	0.0125000
NODE_301_length_4274_cov_16.160958	3411	3491	22	2	80	0.0250000
NODE_301_length_4274_cov_16.160958	3411	3491	23	6	80	0.0750000
NODE_302_length_4270_cov_14.045792	3835	3915	91	1	80	0.0125000
NODE_302_length_4270_cov_14.045792	3835	3915	92	5	80	0.0625000
NODE_302_length_4270_cov_14.045792	3835	3915	93	9	80	0.1125000
NODE_302_length_4270_cov_14.045792	3835	3915	94	8	80	0.1000000
NODE_302_length_4270_cov_14.045792	3835	3915	95	11	80	0.1375000
NODE_302_length_4270_cov_14.045792	3835	3915	96	2	80	0.0250000
NODE_302_length_4270_cov_14.045792	3835	3915	97	8	80	0.1000000
NODE_302_length_4270_cov_14.045792	3835	3915	98	19	80	0.2375000
NODE_302_length_4270_cov_14.045792	3835	3915	99	9	80	0.1125000
NODE_302_length_4270_cov_14.045792	3835	3915	100	3	80	0.0375000
NODE_302_length_4270_cov_14.045792	3835	3915	101	2	80	0.0250000
NODE_302_length_4270_cov_14.045792	3835	3915	102	1	80	0.0125000
NODE_302_length_4270_cov_14.045792	3835	3915	103	1	80	0.0125000
NODE_302_length_4270_cov_14.045792	3835	3915	104	1	80	0.0125000
NODE_302_length_4270_cov_14.045792	3888	3968	95	12	80	0.1500000
NODE_302_length_4270_cov_14.045792	3888	3968	96	4	80	0.0500000
NODE_302_length_4270_cov_14.045792	3888	3968	97	11	80	0.1375000
NODE_302_length_4270_cov_14.045792	3888	3968	98	8	80	0.1000000
NODE_302_length_4270_cov_14.045792	3888	3968	99	12	80	0.1500000
NODE_302_length_4270_cov_14.045792	3888	3968	100	5	80	0.0625000
NODE_302_length_4270_cov_14.045792	3888	3968	101	5	80	0.0625000
NODE_302_length_4270_cov_14.045792	3888	3968	102	1	80	0.0125000
NODE_302_length_4270_cov_14.045792	3888	3968	103	1	80	0.0125000
NODE_302_length_4270_cov_14.045792	3888	3968	104	1	80	0.0125000
NODE_302_length_4270_cov_14.045792	3888	3968	105	2	80	0.0250000
NODE_302_length_4270_cov_14.045792	3888	3968	106	2	80	0.0250000
NODE_302_length_4270_cov_14.045792	3888	3968	107	4	80	0.0500000
NODE_302_length_4270_cov_14.045792	3888	3968	108	1	80	0.0125000
NODE_302_length_4270_cov_14.045792	3888	3968	109	1	80	0.0125000
NODE_302_length_4270_cov_14.045792	3888	3968	112	3	80	0.0375000
NODE_302_length_4270_cov_14.045792	3888	3968	113	1	80	0.0125000
NODE_302_length_4270_cov_14.045792	3888	3968	114	2	80	0.0250000
NODE_302_length_4270_cov_14.045792	3888	3968	115	4	80	0.0500000
NODE_303_length_4260_cov_24.780822	244	311	10	4	67	0.0597015
NODE_303_length_4260_cov_24.780822	244	311	11	8	67	0.1194030
NODE_303_length_4260_cov_24.780822	244	311	12	55	67	0.8208955
NODE_303_length_4260_cov_24.780822	244	311	10	4	67	0.0597015
NODE_303_length_4260_cov_24.780822	244	311	11	8	67	0.1194030
NODE_303_length_4260_cov_24.780822	244	311	12	55	67	0.8208955
NODE_303_length_4260_cov_24.780822	263	311	11	6	48	0.1250000
NODE_303_length_4260_cov_24.780822	263	311	12	42	48	0.8750000
NODE_303_length_4260_cov_24.780822	1605	1633	3	3	28	0.1071429
NODE_303_length_4260_cov_24.780822	1605	1633	4	1	28	0.0357143
NODE_303_length_4260_cov_24.780822	1605	1633	5	2	28	0.0714286
NODE_303_length_4260_cov_24.780822	1605	1633	6	10	28	0.3571429
NODE_303_length_4260_cov_24.780822	1605	1633	8	3	28	0.1071429
NODE_303_length_4260_cov_24.780822	1605	1633	9	1	28	0.0357143
NODE_303_length_4260_cov_24.780822	1605	1633	10	3	28	0.1071429
NODE_303_length_4260_cov_24.780822	1605	1633	12	3	28	0.1071429
NODE_303_length_4260_cov_24.780822	1605	1633	13	1	28	0.0357143
NODE_303_length_4260_cov_24.780822	1605	1633	25	1	28	0.0357143
NODE_303_length_4260_cov_24.780822	1660	1699	21	1	39	0.0256410
NODE_303_length_4260_cov_24.780822	1660	1699	24	1	39	0.0256410
NODE_303_length_4260_cov_24.780822	1660	1699	26	1	39	0.0256410
NODE_303_length_4260_cov_24.780822	1660	1699	27	7	39	0.1794872
NODE_303_length_4260_cov_24.780822	1660	1699	29	1	39	0.0256410
NODE_303_length_4260_cov_24.780822	1660	1699	30	4	39	0.1025641
NODE_303_length_4260_cov_24.780822	1660	1699	31	3	39	0.0769231
NODE_303_length_4260_cov_24.780822	1660	1699	33	2	39	0.0512821
NODE_303_length_4260_cov_24.780822	1660	1699	34	3	39	0.0769231
NODE_303_length_4260_cov_24.780822	1660	1699	35	1	39	0.0256410
NODE_303_length_4260_cov_24.780822	1660	1699	37	2	39	0.0512821
NODE_303_length_4260_cov_24.780822	1660	1699	39	4	39	0.1025641
NODE_303_length_4260_cov_24.780822	1660	1699	40	3	39	0.0769231
NODE_303_length_4260_cov_24.780822	1660	1699	41	3	39	0.0769231
NODE_303_length_4260_cov_24.780822	1660	1699	43	1	39	0.0256410
NODE_303_length_4260_cov_24.780822	1660	1699	44	2	39	0.0512821
NODE_310_length_4207_cov_6.923564	3664	3722	20	22	58	0.3793103
NODE_310_length_4207_cov_6.923564	3664	3722	21	2	58	0.0344828
NODE_310_length_4207_cov_6.923564	3664	3722	22	3	58	0.0517241
NODE_310_length_4207_cov_6.923564	3664	3722	23	10	58	0.1724138
NODE_310_length_4207_cov_6.923564	3664	3722	24	3	58	0.0517241
NODE_310_length_4207_cov_6.923564	3664	3722	25	5	58	0.0862069
NODE_310_length_4207_cov_6.923564	3664	3722	26	3	58	0.0517241
NODE_310_length_4207_cov_6.923564	3664	3722	27	4	58	0.0689655
NODE_310_length_4207_cov_6.923564	3664	3722	28	6	58	0.1034483
NODE_310_length_4207_cov_6.923564	3695	3775	18	3	80	0.0375000
NODE_310_length_4207_cov_6.923564	3695	3775	19	17	80	0.2125000
NODE_310_length_4207_cov_6.923564	3695	3775	20	40	80	0.5000000
NODE_310_length_4207_cov_6.923564	3695	3775	21	13	80	0.1625000
NODE_310_length_4207_cov_6.923564	3695	3775	22	7	80	0.0875000
NODE_311_length_4205_cov_6.121042	592	632	1	2	40	0.0500000
NODE_311_length_4205_cov_6.121042	592	632	2	24	40	0.6000000
NODE_311_length_4205_cov_6.121042	592	632	3	14	40	0.3500000
NODE_311_length_4205_cov_6.121042	605	685	2	13	80	0.1625000
NODE_311_length_4205_cov_6.121042	605	685	3	67	80	0.8375000
NODE_311_length_4205_cov_6.121042	681	745	2	20	64	0.3125000
NODE_311_length_4205_cov_6.121042	681	745	3	44	64	0.6875000
NODE_312_length_4196_cov_4.170857	340	420	3	53	80	0.6625000
NODE_312_length_4196_cov_4.170857	340	420	4	27	80	0.3375000
NODE_312_length_4196_cov_4.170857	393	473	1	24	80	0.3000000
NODE_312_length_4196_cov_4.170857	393	473	2	20	80	0.2500000
NODE_312_length_4196_cov_4.170857	393	473	3	36	80	0.4500000
NODE_316_length_4179_cov_6.655882	1	65	0	12	64	0.1875000
NODE_316_length_4179_cov_6.655882	1	65	2	52	64	0.8125000
NODE_316_length_4179_cov_6.655882	1087	1140	2	5	53	0.0943396
NODE_316_length_4179_cov_6.655882	1087	1140	3	14	53	0.2641509
NODE_316_length_4179_cov_6.655882	1087	1140	4	34	53	0.6415094
NODE_316_length_4179_cov_6.655882	1818	1898	0	80	80	1.0000000
NODE_319_length_4150_cov_10.600099	2827	2849	28	9	22	0.4090909
NODE_319_length_4150_cov_10.600099	2827	2849	29	9	22	0.4090909
NODE_319_length_4150_cov_10.600099	2827	2849	30	1	22	0.0454545
NODE_319_length_4150_cov_10.600099	2827	2849	32	3	22	0.1363636
NODE_319_length_4150_cov_10.600099	2973	3053	33	8	80	0.1000000
NODE_319_length_4150_cov_10.600099	2973	3053	34	1	80	0.0125000
NODE_319_length_4150_cov_10.600099	2973	3053	35	6	80	0.0750000
NODE_319_length_4150_cov_10.600099	2973	3053	36	3	80	0.0375000
NODE_319_length_4150_cov_10.600099	2973	3053	37	12	80	0.1500000
NODE_319_length_4150_cov_10.600099	2973	3053	38	4	80	0.0500000
NODE_319_length_4150_cov_10.600099	2973	3053	39	4	80	0.0500000
NODE_319_length_4150_cov_10.600099	2973	3053	40	3	80	0.0375000
NODE_319_length_4150_cov_10.600099	2973	3053	41	12	80	0.1500000
NODE_319_length_4150_cov_10.600099	2973	3053	42	2	80	0.0250000
NODE_319_length_4150_cov_10.600099	2973	3053	43	1	80	0.0125000
NODE_319_length_4150_cov_10.600099	2973	3053	44	18	80	0.2250000
NODE_319_length_4150_cov_10.600099	2973	3053	45	5	80	0.0625000
NODE_319_length_4150_cov_10.600099	2973	3053	47	1	80	0.0125000
NODE_319_length_4150_cov_10.600099	3026	3106	27	1	80	0.0125000
NODE_319_length_4150_cov_10.600099	3026	3106	28	1	80	0.0125000
NODE_319_length_4150_cov_10.600099	3026	3106	29	7	80	0.0875000
NODE_319_length_4150_cov_10.600099	3026	3106	30	1	80	0.0125000
NODE_319_length_4150_cov_10.600099	3026	3106	32	5	80	0.0625000
NODE_319_length_4150_cov_10.600099	3026	3106	33	8	80	0.1000000
NODE_319_length_4150_cov_10.600099	3026	3106	34	9	80	0.1125000
NODE_319_length_4150_cov_10.600099	3026	3106	35	2	80	0.0250000
NODE_319_length_4150_cov_10.600099	3026	3106	36	10	80	0.1250000
NODE_319_length_4150_cov_10.600099	3026	3106	37	15	80	0.1875000
NODE_319_length_4150_cov_10.600099	3026	3106	38	3	80	0.0375000
NODE_319_length_4150_cov_10.600099	3026	3106	39	3	80	0.0375000
NODE_319_length_4150_cov_10.600099	3026	3106	40	1	80	0.0125000
NODE_319_length_4150_cov_10.600099	3026	3106	41	1	80	0.0125000
NODE_319_length_4150_cov_10.600099	3026	3106	42	1	80	0.0125000
NODE_319_length_4150_cov_10.600099	3026	3106	44	6	80	0.0750000
NODE_319_length_4150_cov_10.600099	3026	3106	45	5	80	0.0625000
NODE_319_length_4150_cov_10.600099	3026	3106	47	1	80	0.0125000
NODE_324_length_4119_cov_27.984328	2818	2898	173	1	80	0.0125000
NODE_324_length_4119_cov_27.984328	2818	2898	176	2	80	0.0250000
NODE_324_length_4119_cov_27.984328	2818	2898	177	2	80	0.0250000
NODE_324_length_4119_cov_27.984328	2818	2898	182	2	80	0.0250000
NODE_324_length_4119_cov_27.984328	2818	2898	189	2	80	0.0250000
NODE_324_length_4119_cov_27.984328	2818	2898	190	3	80	0.0375000
NODE_324_length_4119_cov_27.984328	2818	2898	191	6	80	0.0750000
NODE_324_length_4119_cov_27.984328	2818	2898	192	3	80	0.0375000
NODE_324_length_4119_cov_27.984328	2818	2898	193	5	80	0.0625000
NODE_324_length_4119_cov_27.984328	2818	2898	194	5	80	0.0625000
NODE_324_length_4119_cov_27.984328	2818	2898	195	2	80	0.0250000
NODE_324_length_4119_cov_27.984328	2818	2898	196	1	80	0.0125000
NODE_324_length_4119_cov_27.984328	2818	2898	197	3	80	0.0375000
NODE_324_length_4119_cov_27.984328	2818	2898	198	3	80	0.0375000
NODE_324_length_4119_cov_27.984328	2818	2898	199	1	80	0.0125000
NODE_324_length_4119_cov_27.984328	2818	2898	200	5	80	0.0625000
NODE_324_length_4119_cov_27.984328	2818	2898	201	5	80	0.0625000
NODE_324_length_4119_cov_27.984328	2818	2898	202	4	80	0.0500000
NODE_324_length_4119_cov_27.984328	2818	2898	203	3	80	0.0375000
NODE_324_length_4119_cov_27.984328	2818	2898	204	3	80	0.0375000
NODE_324_length_4119_cov_27.984328	2818	2898	205	4	80	0.0500000
NODE_324_length_4119_cov_27.984328	2818	2898	206	5	80	0.0625000
NODE_324_length_4119_cov_27.984328	2818	2898	207	2	80	0.0250000
NODE_324_length_4119_cov_27.984328	2818	2898	208	2	80	0.0250000
NODE_324_length_4119_cov_27.984328	2818	2898	209	4	80	0.0500000
NODE_324_length_4119_cov_27.984328	2818	2898	210	1	80	0.0125000
NODE_324_length_4119_cov_27.984328	2818	2898	214	1	80	0.0125000
NODE_325_length_4108_cov_14.755550	378	422	3	8	44	0.1818182
NODE_325_length_4108_cov_14.755550	378	422	4	36	44	0.8181818
NODE_325_length_4108_cov_14.755550	3537	3617	1	8	80	0.1000000
NODE_325_length_4108_cov_14.755550	3537	3617	3	29	80	0.3625000
NODE_325_length_4108_cov_14.755550	3537	3617	4	1	80	0.0125000
NODE_325_length_4108_cov_14.755550	3537	3617	5	12	80	0.1500000
NODE_325_length_4108_cov_14.755550	3537	3617	7	1	80	0.0125000
NODE_325_length_4108_cov_14.755550	3537	3617	8	29	80	0.3625000
NODE_325_length_4108_cov_14.755550	3590	3670	7	12	80	0.1500000
NODE_325_length_4108_cov_14.755550	3590	3670	8	28	80	0.3500000
NODE_325_length_4108_cov_14.755550	3590	3670	9	27	80	0.3375000
NODE_325_length_4108_cov_14.755550	3590	3670	10	13	80	0.1625000
NODE_326_length_4107_cov_1.855539	207	287	0	80	80	1.0000000
NODE_328_length_4096_cov_31.197648	379	459	12	13	80	0.1625000
NODE_328_length_4096_cov_31.197648	379	459	14	4	80	0.0500000
NODE_328_length_4096_cov_31.197648	379	459	16	10	80	0.1250000
NODE_328_length_4096_cov_31.197648	379	459	18	6	80	0.0750000
NODE_328_length_4096_cov_31.197648	379	459	19	11	80	0.1375000
NODE_328_length_4096_cov_31.197648	379	459	20	4	80	0.0500000
NODE_328_length_4096_cov_31.197648	379	459	21	5	80	0.0625000
NODE_328_length_4096_cov_31.197648	379	459	22	27	80	0.3375000
NODE_328_length_4096_cov_31.197648	432	512	8	2	80	0.0250000
NODE_328_length_4096_cov_31.197648	432	512	10	5	80	0.0625000
NODE_328_length_4096_cov_31.197648	432	512	11	21	80	0.2625000
NODE_328_length_4096_cov_31.197648	432	512	13	4	80	0.0500000
NODE_328_length_4096_cov_31.197648	432	512	14	3	80	0.0375000
NODE_328_length_4096_cov_31.197648	432	512	15	4	80	0.0500000
NODE_328_length_4096_cov_31.197648	432	512	16	5	80	0.0625000
NODE_328_length_4096_cov_31.197648	432	512	17	1	80	0.0125000
NODE_328_length_4096_cov_31.197648	432	512	18	4	80	0.0500000
NODE_328_length_4096_cov_31.197648	432	512	19	4	80	0.0500000
NODE_328_length_4096_cov_31.197648	432	512	22	27	80	0.3375000
NODE_328_length_4096_cov_31.197648	3305	3385	0	80	80	1.0000000
NODE_328_length_4096_cov_31.197648	3358	3438	0	80	80	1.0000000
NODE_329_length_4081_cov_20.248870	3673	3753	2	80	80	1.0000000
NODE_329_length_4081_cov_20.248870	3726	3806	2	80	80	1.0000000
NODE_330_length_4076_cov_15.138044	1062	1142	1	20	80	0.2500000
NODE_330_length_4076_cov_15.138044	1062	1142	3	60	80	0.7500000
NODE_330_length_4076_cov_15.138044	1115	1195	2	5	80	0.0625000
NODE_330_length_4076_cov_15.138044	1115	1195	3	75	80	0.9375000
NODE_331_length_4069_cov_14.261209	3871	3936	0	4	65	0.0615385
NODE_331_length_4069_cov_14.261209	3871	3936	1	5	65	0.0769231
NODE_331_length_4069_cov_14.261209	3871	3936	2	56	65	0.8615385
NODE_333_length_4050_cov_31.044039	1703	1783	33	9	80	0.1125000
NODE_333_length_4050_cov_31.044039	1703	1783	34	5	80	0.0625000
NODE_333_length_4050_cov_31.044039	1703	1783	35	5	80	0.0625000
NODE_333_length_4050_cov_31.044039	1703	1783	36	6	80	0.0750000
NODE_333_length_4050_cov_31.044039	1703	1783	37	15	80	0.1875000
NODE_333_length_4050_cov_31.044039	1703	1783	38	3	80	0.0375000
NODE_333_length_4050_cov_31.044039	1703	1783	39	12	80	0.1500000
NODE_333_length_4050_cov_31.044039	1703	1783	40	7	80	0.0875000
NODE_333_length_4050_cov_31.044039	1703	1783	41	9	80	0.1125000
NODE_333_length_4050_cov_31.044039	1703	1783	42	7	80	0.0875000
NODE_333_length_4050_cov_31.044039	1703	1783	44	2	80	0.0250000
NODE_335_length_4021_cov_34.619072	379	459	2	12	80	0.1500000
NODE_335_length_4021_cov_34.619072	379	459	3	2	80	0.0250000
NODE_335_length_4021_cov_34.619072	379	459	4	8	80	0.1000000
NODE_335_length_4021_cov_34.619072	379	459	5	3	80	0.0375000
NODE_335_length_4021_cov_34.619072	379	459	7	17	80	0.2125000
NODE_335_length_4021_cov_34.619072	379	459	8	38	80	0.4750000
NODE_335_length_4021_cov_34.619072	432	512	3	12	80	0.1500000
NODE_335_length_4021_cov_34.619072	432	512	5	18	80	0.2250000
NODE_335_length_4021_cov_34.619072	432	512	6	5	80	0.0625000
NODE_335_length_4021_cov_34.619072	432	512	7	1	80	0.0125000
NODE_335_length_4021_cov_34.619072	432	512	8	44	80	0.5500000
NODE_336_length_4020_cov_5.130834	3455	3535	0	80	80	1.0000000
NODE_336_length_4020_cov_5.130834	3508	3588	0	80	80	1.0000000
NODE_339_length_4004_cov_9.718054	387	467	3	41	80	0.5125000
NODE_339_length_4004_cov_9.718054	387	467	4	11	80	0.1375000
NODE_339_length_4004_cov_9.718054	387	467	6	28	80	0.3500000
NODE_339_length_4004_cov_9.718054	440	520	1	27	80	0.3375000
NODE_339_length_4004_cov_9.718054	440	520	3	53	80	0.6625000
NODE_339_length_4004_cov_9.718054	516	596	0	23	80	0.2875000
NODE_339_length_4004_cov_9.718054	516	596	1	57	80	0.7125000
NODE_339_length_4004_cov_9.718054	569	649	0	76	80	0.9500000
NODE_339_length_4004_cov_9.718054	569	649	1	4	80	0.0500000
NODE_341_length_3991_cov_18.617934	867	947	7	22	80	0.2750000
NODE_341_length_3991_cov_18.617934	867	947	8	16	80	0.2000000
NODE_341_length_3991_cov_18.617934	867	947	9	30	80	0.3750000
NODE_341_length_3991_cov_18.617934	867	947	10	12	80	0.1500000
NODE_341_length_3991_cov_18.617934	920	1000	7	17	80	0.2125000
NODE_341_length_3991_cov_18.617934	920	1000	8	19	80	0.2375000
NODE_341_length_3991_cov_18.617934	920	1000	9	25	80	0.3125000
NODE_341_length_3991_cov_18.617934	920	1000	10	19	80	0.2375000
NODE_341_length_3991_cov_18.617934	996	1076	4	26	80	0.3250000
NODE_341_length_3991_cov_18.617934	996	1076	5	1	80	0.0125000
NODE_341_length_3991_cov_18.617934	996	1076	6	16	80	0.2000000
NODE_341_length_3991_cov_18.617934	996	1076	7	29	80	0.3625000
NODE_341_length_3991_cov_18.617934	996	1076	8	8	80	0.1000000
NODE_341_length_3991_cov_18.617934	1049	1124	1	15	75	0.2000000
NODE_341_length_3991_cov_18.617934	1049	1124	2	1	75	0.0133333
NODE_341_length_3991_cov_18.617934	1049	1124	3	7	75	0.0933333
NODE_341_length_3991_cov_18.617934	1049	1124	4	51	75	0.6800000
NODE_341_length_3991_cov_18.617934	1049	1124	5	1	75	0.0133333
NODE_348_length_3973_cov_6.906298	17	65	0	7	48	0.1458333
NODE_348_length_3973_cov_6.906298	17	65	2	38	48	0.7916667
NODE_348_length_3973_cov_6.906298	17	65	4	3	48	0.0625000
NODE_348_length_3973_cov_6.906298	1945	1995	14	13	50	0.2600000
NODE_348_length_3973_cov_6.906298	1945	1995	16	2	50	0.0400000
NODE_348_length_3973_cov_6.906298	1945	1995	17	8	50	0.1600000
NODE_348_length_3973_cov_6.906298	1945	1995	18	4	50	0.0800000
NODE_348_length_3973_cov_6.906298	1945	1995	19	2	50	0.0400000
NODE_348_length_3973_cov_6.906298	1945	1995	20	16	50	0.3200000
NODE_348_length_3973_cov_6.906298	1945	1995	21	4	50	0.0800000
NODE_348_length_3973_cov_6.906298	1945	1995	22	1	50	0.0200000
NODE_350_length_3960_cov_6.246827	2673	2761	0	85	88	0.9659091
NODE_350_length_3960_cov_6.246827	2673	2761	1	3	88	0.0340909
NODE_350_length_3960_cov_6.246827	3520	3600	1	4	80	0.0500000
NODE_350_length_3960_cov_6.246827	3520	3600	3	71	80	0.8875000
NODE_350_length_3960_cov_6.246827	3520	3600	4	5	80	0.0625000
NODE_350_length_3960_cov_6.246827	3573	3653	3	80	80	1.0000000
NODE_353_length_3952_cov_8.805346	826	906	5	2	80	0.0250000
NODE_353_length_3952_cov_8.805346	826	906	7	1	80	0.0125000
NODE_353_length_3952_cov_8.805346	826	906	8	13	80	0.1625000
NODE_353_length_3952_cov_8.805346	826	906	9	4	80	0.0500000
NODE_353_length_3952_cov_8.805346	826	906	11	37	80	0.4625000
NODE_353_length_3952_cov_8.805346	826	906	12	6	80	0.0750000
NODE_353_length_3952_cov_8.805346	826	906	14	2	80	0.0250000
NODE_353_length_3952_cov_8.805346	826	906	16	15	80	0.1875000
NODE_353_length_3952_cov_8.805346	879	959	10	14	80	0.1750000
NODE_353_length_3952_cov_8.805346	879	959	11	12	80	0.1500000
NODE_353_length_3952_cov_8.805346	879	959	12	7	80	0.0875000
NODE_353_length_3952_cov_8.805346	879	959	13	15	80	0.1875000
NODE_353_length_3952_cov_8.805346	879	959	14	2	80	0.0250000
NODE_353_length_3952_cov_8.805346	879	959	16	30	80	0.3750000
NODE_354_length_3928_cov_5.936798	2440	2521	1	72	81	0.8888889
NODE_354_length_3928_cov_5.936798	2440	2521	2	9	81	0.1111111
NODE_354_length_3928_cov_5.936798	2493	2574	1	75	81	0.9259259
NODE_354_length_3928_cov_5.936798	2493	2574	2	6	81	0.0740741
NODE_356_length_3923_cov_14.807793	3759	3800	1	41	41	1.0000000
NODE_358_length_3922_cov_7.609731	1493	1573	6	4	80	0.0500000
NODE_358_length_3922_cov_7.609731	1493	1573	7	5	80	0.0625000
NODE_358_length_3922_cov_7.609731	1493	1573	9	15	80	0.1875000
NODE_358_length_3922_cov_7.609731	1493	1573	10	1	80	0.0125000
NODE_358_length_3922_cov_7.609731	1493	1573	11	5	80	0.0625000
NODE_358_length_3922_cov_7.609731	1493	1573	12	8	80	0.1000000
NODE_358_length_3922_cov_7.609731	1493	1573	13	31	80	0.3875000
NODE_358_length_3922_cov_7.609731	1493	1573	14	2	80	0.0250000
NODE_358_length_3922_cov_7.609731	1493	1573	15	9	80	0.1125000
NODE_358_length_3922_cov_7.609731	1546	1600	6	4	54	0.0740741
NODE_358_length_3922_cov_7.609731	1546	1600	7	5	54	0.0925926
NODE_358_length_3922_cov_7.609731	1546	1600	9	15	54	0.2777778
NODE_358_length_3922_cov_7.609731	1546	1600	10	8	54	0.1481481
NODE_358_length_3922_cov_7.609731	1546	1600	11	5	54	0.0925926
NODE_358_length_3922_cov_7.609731	1546	1600	12	5	54	0.0925926
NODE_358_length_3922_cov_7.609731	1546	1600	13	12	54	0.2222222
NODE_359_length_3921_cov_9.943223	2936	3016	178	1	80	0.0125000
NODE_359_length_3921_cov_9.943223	2936	3016	181	3	80	0.0375000
NODE_359_length_3921_cov_9.943223	2936	3016	183	5	80	0.0625000
NODE_359_length_3921_cov_9.943223	2936	3016	184	6	80	0.0750000
NODE_359_length_3921_cov_9.943223	2936	3016	185	1	80	0.0125000
NODE_359_length_3921_cov_9.943223	2936	3016	186	4	80	0.0500000
NODE_359_length_3921_cov_9.943223	2936	3016	187	3	80	0.0375000
NODE_359_length_3921_cov_9.943223	2936	3016	188	2	80	0.0250000
NODE_359_length_3921_cov_9.943223	2936	3016	189	2	80	0.0250000
NODE_359_length_3921_cov_9.943223	2936	3016	190	3	80	0.0375000
NODE_359_length_3921_cov_9.943223	2936	3016	191	7	80	0.0875000
NODE_359_length_3921_cov_9.943223	2936	3016	192	2	80	0.0250000
NODE_359_length_3921_cov_9.943223	2936	3016	193	2	80	0.0250000
NODE_359_length_3921_cov_9.943223	2936	3016	194	3	80	0.0375000
NODE_359_length_3921_cov_9.943223	2936	3016	201	1	80	0.0125000
NODE_359_length_3921_cov_9.943223	2936	3016	204	1	80	0.0125000
NODE_359_length_3921_cov_9.943223	2936	3016	206	1	80	0.0125000
NODE_359_length_3921_cov_9.943223	2936	3016	207	1	80	0.0125000
NODE_359_length_3921_cov_9.943223	2936	3016	208	2	80	0.0250000
NODE_359_length_3921_cov_9.943223	2936	3016	210	1	80	0.0125000
NODE_359_length_3921_cov_9.943223	2936	3016	211	4	80	0.0500000
NODE_359_length_3921_cov_9.943223	2936	3016	212	6	80	0.0750000
NODE_359_length_3921_cov_9.943223	2936	3016	213	2	80	0.0250000
NODE_359_length_3921_cov_9.943223	2936	3016	215	3	80	0.0375000
NODE_359_length_3921_cov_9.943223	2936	3016	216	5	80	0.0625000
NODE_359_length_3921_cov_9.943223	2936	3016	217	3	80	0.0375000
NODE_359_length_3921_cov_9.943223	2936	3016	218	1	80	0.0125000
NODE_359_length_3921_cov_9.943223	2936	3016	219	2	80	0.0250000
NODE_359_length_3921_cov_9.943223	2936	3016	220	3	80	0.0375000
NODE_359_length_3921_cov_9.943223	2989	3057	208	1	68	0.0147059
NODE_359_length_3921_cov_9.943223	2989	3057	210	1	68	0.0147059
NODE_359_length_3921_cov_9.943223	2989	3057	211	3	68	0.0441176
NODE_359_length_3921_cov_9.943223	2989	3057	212	4	68	0.0588235
NODE_359_length_3921_cov_9.943223	2989	3057	213	1	68	0.0147059
NODE_359_length_3921_cov_9.943223	2989	3057	214	2	68	0.0294118
NODE_359_length_3921_cov_9.943223	2989	3057	215	4	68	0.0588235
NODE_359_length_3921_cov_9.943223	2989	3057	216	11	68	0.1617647
NODE_359_length_3921_cov_9.943223	2989	3057	217	4	68	0.0588235
NODE_359_length_3921_cov_9.943223	2989	3057	218	4	68	0.0588235
NODE_359_length_3921_cov_9.943223	2989	3057	219	3	68	0.0441176
NODE_359_length_3921_cov_9.943223	2989	3057	220	6	68	0.0882353
NODE_359_length_3921_cov_9.943223	2989	3057	221	3	68	0.0441176
NODE_359_length_3921_cov_9.943223	2989	3057	222	3	68	0.0441176
NODE_359_length_3921_cov_9.943223	2989	3057	223	3	68	0.0441176
NODE_359_length_3921_cov_9.943223	2989	3057	224	2	68	0.0294118
NODE_359_length_3921_cov_9.943223	2989	3057	225	6	68	0.0882353
NODE_359_length_3921_cov_9.943223	2989	3057	226	3	68	0.0441176
NODE_359_length_3921_cov_9.943223	2989	3057	227	1	68	0.0147059
NODE_359_length_3921_cov_9.943223	2989	3057	229	3	68	0.0441176
NODE_359_length_3921_cov_9.943223	3047	3066	214	1	19	0.0526316
NODE_359_length_3921_cov_9.943223	3047	3066	215	2	19	0.1052632
NODE_359_length_3921_cov_9.943223	3047	3066	216	1	19	0.0526316
NODE_359_length_3921_cov_9.943223	3047	3066	218	1	19	0.0526316
NODE_359_length_3921_cov_9.943223	3047	3066	219	1	19	0.0526316
NODE_359_length_3921_cov_9.943223	3047	3066	221	2	19	0.1052632
NODE_359_length_3921_cov_9.943223	3047	3066	222	2	19	0.1052632
NODE_359_length_3921_cov_9.943223	3047	3066	223	3	19	0.1578947
NODE_359_length_3921_cov_9.943223	3047	3066	224	1	19	0.0526316
NODE_359_length_3921_cov_9.943223	3047	3066	225	3	19	0.1578947
NODE_359_length_3921_cov_9.943223	3047	3066	226	2	19	0.1052632
NODE_363_length_3898_cov_40.033167	3296	3370	29	1	74	0.0135135
NODE_363_length_3898_cov_40.033167	3296	3370	30	10	74	0.1351351
NODE_363_length_3898_cov_40.033167	3296	3370	31	26	74	0.3513514
NODE_363_length_3898_cov_40.033167	3296	3370	32	26	74	0.3513514
NODE_363_length_3898_cov_40.033167	3296	3370	33	11	74	0.1486486
NODE_363_length_3898_cov_40.033167	3539	3619	1	14	80	0.1750000
NODE_363_length_3898_cov_40.033167	3539	3619	3	17	80	0.2125000
NODE_363_length_3898_cov_40.033167	3539	3619	5	3	80	0.0375000
NODE_363_length_3898_cov_40.033167	3539	3619	6	24	80	0.3000000
NODE_363_length_3898_cov_40.033167	3539	3619	7	9	80	0.1125000
NODE_363_length_3898_cov_40.033167	3539	3619	8	13	80	0.1625000
NODE_364_length_3898_cov_7.550145	668	748	2	26	80	0.3250000
NODE_364_length_3898_cov_7.550145	668	748	3	54	80	0.6750000
NODE_364_length_3898_cov_7.550145	721	801	3	38	80	0.4750000
NODE_364_length_3898_cov_7.550145	721	801	4	36	80	0.4500000
NODE_364_length_3898_cov_7.550145	721	801	5	1	80	0.0125000
NODE_364_length_3898_cov_7.550145	721	801	8	1	80	0.0125000
NODE_364_length_3898_cov_7.550145	721	801	12	2	80	0.0250000
NODE_364_length_3898_cov_7.550145	721	801	14	2	80	0.0250000
NODE_367_length_3882_cov_4.166006	3244	3324	4	45	80	0.5625000
NODE_367_length_3882_cov_4.166006	3244	3324	6	33	80	0.4125000
NODE_367_length_3882_cov_4.166006	3244	3324	8	2	80	0.0250000
NODE_367_length_3882_cov_4.166006	3282	3324	4	7	42	0.1666667
NODE_367_length_3882_cov_4.166006	3282	3324	6	33	42	0.7857143
NODE_367_length_3882_cov_4.166006	3282	3324	8	2	42	0.0476190
NODE_367_length_3882_cov_4.166006	3297	3377	6	53	80	0.6625000
NODE_367_length_3882_cov_4.166006	3297	3377	8	27	80	0.3375000
NODE_367_length_3882_cov_4.166006	3297	3377	6	53	80	0.6625000
NODE_367_length_3882_cov_4.166006	3297	3377	8	27	80	0.3375000
NODE_367_length_3882_cov_4.166006	3373	3450	2	9	77	0.1168831
NODE_367_length_3882_cov_4.166006	3373	3450	4	2	77	0.0259740
NODE_367_length_3882_cov_4.166006	3373	3450	6	66	77	0.8571429
NODE_374_length_3853_cov_18.816196	524	579	5	25	55	0.4545455
NODE_374_length_3853_cov_18.816196	524	579	6	15	55	0.2727273
NODE_374_length_3853_cov_18.816196	524	579	9	15	55	0.2727273
NODE_374_length_3853_cov_18.816196	559	639	5	1	80	0.0125000
NODE_374_length_3853_cov_18.816196	559	639	6	17	80	0.2125000
NODE_374_length_3853_cov_18.816196	559	639	7	26	80	0.3250000
NODE_374_length_3853_cov_18.816196	559	639	8	20	80	0.2500000
NODE_374_length_3853_cov_18.816196	559	639	9	16	80	0.2000000
NODE_379_length_3829_cov_12.697319	515	595	2	7	80	0.0875000
NODE_379_length_3829_cov_12.697319	515	595	3	4	80	0.0500000
NODE_379_length_3829_cov_12.697319	515	595	4	17	80	0.2125000
NODE_379_length_3829_cov_12.697319	515	595	5	1	80	0.0125000
NODE_379_length_3829_cov_12.697319	515	595	7	51	80	0.6375000
NODE_379_length_3829_cov_12.697319	568	648	3	13	80	0.1625000
NODE_379_length_3829_cov_12.697319	568	648	4	14	80	0.1750000
NODE_379_length_3829_cov_12.697319	568	648	6	15	80	0.1875000
NODE_379_length_3829_cov_12.697319	568	648	7	38	80	0.4750000
NODE_379_length_3829_cov_12.697319	644	724	0	31	80	0.3875000
NODE_379_length_3829_cov_12.697319	644	724	1	17	80	0.2125000
NODE_379_length_3829_cov_12.697319	644	724	2	4	80	0.0500000
NODE_379_length_3829_cov_12.697319	644	724	3	28	80	0.3500000
NODE_379_length_3829_cov_12.697319	697	777	0	80	80	1.0000000
NODE_381_length_3815_cov_17.218784	399	479	5	3	80	0.0375000
NODE_381_length_3815_cov_17.218784	399	479	6	49	80	0.6125000
NODE_381_length_3815_cov_17.218784	399	479	7	28	80	0.3500000
NODE_381_length_3815_cov_17.218784	452	532	3	14	80	0.1750000
NODE_381_length_3815_cov_17.218784	452	532	5	11	80	0.1375000
NODE_381_length_3815_cov_17.218784	452	532	6	55	80	0.6875000
NODE_383_length_3812_cov_65.007272	840	903	32	1	63	0.0158730
NODE_383_length_3812_cov_65.007272	840	903	36	1	63	0.0158730
NODE_383_length_3812_cov_65.007272	840	903	46	1	63	0.0158730
NODE_383_length_3812_cov_65.007272	840	903	47	1	63	0.0158730
NODE_383_length_3812_cov_65.007272	840	903	55	1	63	0.0158730
NODE_383_length_3812_cov_65.007272	840	903	57	1	63	0.0158730
NODE_383_length_3812_cov_65.007272	840	903	59	1	63	0.0158730
NODE_383_length_3812_cov_65.007272	840	903	61	1	63	0.0158730
NODE_383_length_3812_cov_65.007272	840	903	64	1	63	0.0158730
NODE_383_length_3812_cov_65.007272	840	903	79	1	63	0.0158730
NODE_383_length_3812_cov_65.007272	840	903	86	1	63	0.0158730
NODE_383_length_3812_cov_65.007272	840	903	88	1	63	0.0158730
NODE_383_length_3812_cov_65.007272	840	903	94	1	63	0.0158730
NODE_383_length_3812_cov_65.007272	840	903	96	1	63	0.0158730
NODE_383_length_3812_cov_65.007272	840	903	99	2	63	0.0317460
NODE_383_length_3812_cov_65.007272	840	903	102	1	63	0.0158730
NODE_383_length_3812_cov_65.007272	840	903	103	2	63	0.0317460
NODE_383_length_3812_cov_65.007272	840	903	106	1	63	0.0158730
NODE_383_length_3812_cov_65.007272	840	903	107	1	63	0.0158730
NODE_383_length_3812_cov_65.007272	840	903	108	1	63	0.0158730
NODE_383_length_3812_cov_65.007272	840	903	118	1	63	0.0158730
NODE_383_length_3812_cov_65.007272	840	903	130	1	63	0.0158730
NODE_383_length_3812_cov_65.007272	840	903	137	1	63	0.0158730
NODE_383_length_3812_cov_65.007272	840	903	150	1	63	0.0158730
NODE_383_length_3812_cov_65.007272	840	903	154	1	63	0.0158730
NODE_383_length_3812_cov_65.007272	840	903	162	1	63	0.0158730
NODE_383_length_3812_cov_65.007272	840	903	163	1	63	0.0158730
NODE_383_length_3812_cov_65.007272	840	903	166	1	63	0.0158730
NODE_383_length_3812_cov_65.007272	840	903	175	1	63	0.0158730
NODE_383_length_3812_cov_65.007272	840	903	178	1	63	0.0158730
NODE_383_length_3812_cov_65.007272	840	903	180	1	63	0.0158730
NODE_383_length_3812_cov_65.007272	840	903	182	1	63	0.0158730
NODE_383_length_3812_cov_65.007272	840	903	187	1	63	0.0158730
NODE_383_length_3812_cov_65.007272	840	903	191	1	63	0.0158730
NODE_383_length_3812_cov_65.007272	840	903	197	1	63	0.0158730
NODE_383_length_3812_cov_65.007272	840	903	199	1	63	0.0158730
NODE_383_length_3812_cov_65.007272	840	903	200	2	63	0.0317460
NODE_383_length_3812_cov_65.007272	840	903	204	1	63	0.0158730
NODE_383_length_3812_cov_65.007272	840	903	213	1	63	0.0158730
NODE_383_length_3812_cov_65.007272	840	903	215	1	63	0.0158730
NODE_383_length_3812_cov_65.007272	840	903	217	1	63	0.0158730
NODE_383_length_3812_cov_65.007272	840	903	222	1	63	0.0158730
NODE_383_length_3812_cov_65.007272	840	903	228	1	63	0.0158730
NODE_383_length_3812_cov_65.007272	840	903	232	1	63	0.0158730
NODE_383_length_3812_cov_65.007272	840	903	244	1	63	0.0158730
NODE_383_length_3812_cov_65.007272	840	903	250	1	63	0.0158730
NODE_383_length_3812_cov_65.007272	840	903	256	1	63	0.0158730
NODE_383_length_3812_cov_65.007272	840	903	261	1	63	0.0158730
NODE_383_length_3812_cov_65.007272	840	903	265	1	63	0.0158730
NODE_383_length_3812_cov_65.007272	840	903	268	1	63	0.0158730
NODE_383_length_3812_cov_65.007272	840	903	273	1	63	0.0158730
NODE_383_length_3812_cov_65.007272	840	903	276	1	63	0.0158730
NODE_383_length_3812_cov_65.007272	840	903	280	1	63	0.0158730
NODE_383_length_3812_cov_65.007272	840	903	283	1	63	0.0158730
NODE_383_length_3812_cov_65.007272	840	903	290	1	63	0.0158730
NODE_383_length_3812_cov_65.007272	840	903	294	2	63	0.0317460
NODE_383_length_3812_cov_65.007272	840	903	296	1	63	0.0158730
NODE_383_length_3812_cov_65.007272	840	903	300	1	63	0.0158730
NODE_383_length_3812_cov_65.007272	840	903	305	1	63	0.0158730
NODE_384_length_3805_cov_9.533189	145	236	0	91	91	1.0000000
NODE_384_length_3805_cov_9.533189	209	279	0	70	70	1.0000000
NODE_386_length_3799_cov_10.046486	2944	3024	7	7	80	0.0875000
NODE_386_length_3799_cov_10.046486	2944	3024	9	13	80	0.1625000
NODE_386_length_3799_cov_10.046486	2944	3024	10	33	80	0.4125000
NODE_386_length_3799_cov_10.046486	2944	3024	11	13	80	0.1625000
NODE_386_length_3799_cov_10.046486	2944	3024	12	1	80	0.0125000
NODE_386_length_3799_cov_10.046486	2944	3024	13	9	80	0.1125000
NODE_386_length_3799_cov_10.046486	2944	3024	16	1	80	0.0125000
NODE_386_length_3799_cov_10.046486	2944	3024	17	2	80	0.0250000
NODE_386_length_3799_cov_10.046486	2944	3024	18	1	80	0.0125000
NODE_386_length_3799_cov_10.046486	2997	3077	4	3	80	0.0375000
NODE_386_length_3799_cov_10.046486	2997	3077	5	7	80	0.0875000
NODE_386_length_3799_cov_10.046486	2997	3077	6	34	80	0.4250000
NODE_386_length_3799_cov_10.046486	2997	3077	7	16	80	0.2000000
NODE_386_length_3799_cov_10.046486	2997	3077	9	13	80	0.1625000
NODE_386_length_3799_cov_10.046486	2997	3077	11	7	80	0.0875000
NODE_388_length_3795_cov_13.724297	3350	3430	3	80	80	1.0000000
NODE_388_length_3795_cov_13.724297	3403	3483	1	4	80	0.0500000
NODE_388_length_3795_cov_13.724297	3403	3483	2	8	80	0.1000000
NODE_388_length_3795_cov_13.724297	3403	3483	3	68	80	0.8500000
NODE_388_length_3795_cov_13.724297	3479	3562	0	41	83	0.4939759
NODE_388_length_3795_cov_13.724297	3479	3562	1	5	83	0.0602410
NODE_388_length_3795_cov_13.724297	3479	3562	2	11	83	0.1325301
NODE_388_length_3795_cov_13.724297	3479	3562	3	3	83	0.0361446
NODE_388_length_3795_cov_13.724297	3479	3562	5	13	83	0.1566265
NODE_388_length_3795_cov_13.724297	3479	3562	6	10	83	0.1204819
NODE_388_length_3795_cov_13.724297	3479	3562	0	41	83	0.4939759
NODE_388_length_3795_cov_13.724297	3479	3562	1	5	83	0.0602410
NODE_388_length_3795_cov_13.724297	3479	3562	2	11	83	0.1325301
NODE_388_length_3795_cov_13.724297	3479	3562	3	3	83	0.0361446
NODE_388_length_3795_cov_13.724297	3479	3562	5	13	83	0.1566265
NODE_388_length_3795_cov_13.724297	3479	3562	6	10	83	0.1204819
NODE_388_length_3795_cov_13.724297	3479	3552	0	41	73	0.5616438
NODE_388_length_3795_cov_13.724297	3479	3552	1	5	73	0.0684932
NODE_388_length_3795_cov_13.724297	3479	3552	2	11	73	0.1506849
NODE_388_length_3795_cov_13.724297	3479	3552	3	3	73	0.0410959
NODE_388_length_3795_cov_13.724297	3479	3552	5	13	73	0.1780822
NODE_388_length_3795_cov_13.724297	3535	3586	2	1	51	0.0196078
NODE_388_length_3795_cov_13.724297	3535	3586	3	3	51	0.0588235
NODE_388_length_3795_cov_13.724297	3535	3586	5	13	51	0.2549020
NODE_388_length_3795_cov_13.724297	3535	3586	6	28	51	0.5490196
NODE_388_length_3795_cov_13.724297	3535	3586	8	6	51	0.1176471
NODE_388_length_3795_cov_13.724297	3535	3584	2	1	49	0.0204082
NODE_388_length_3795_cov_13.724297	3535	3584	3	3	49	0.0612245
NODE_388_length_3795_cov_13.724297	3535	3584	5	13	49	0.2653061
NODE_388_length_3795_cov_13.724297	3535	3584	6	28	49	0.5714286
NODE_388_length_3795_cov_13.724297	3535	3584	8	4	49	0.0816327
NODE_388_length_3795_cov_13.724297	3698	3721	29	11	23	0.4782609
NODE_388_length_3795_cov_13.724297	3698	3721	30	5	23	0.2173913
NODE_388_length_3795_cov_13.724297	3698	3721	32	7	23	0.3043478
NODE_394_length_3774_cov_7.720544	538	595	5	7	57	0.1228070
NODE_394_length_3774_cov_7.720544	538	595	7	25	57	0.4385965
NODE_394_length_3774_cov_7.720544	538	595	9	4	57	0.0701754
NODE_394_length_3774_cov_7.720544	538	595	10	5	57	0.0877193
NODE_394_length_3774_cov_7.720544	538	595	12	16	57	0.2807018
NODE_404_length_3747_cov_3.328947	2230	2292	4	16	62	0.2580645
NODE_404_length_3747_cov_3.328947	2230	2292	5	10	62	0.1612903
NODE_404_length_3747_cov_3.328947	2230	2292	6	10	62	0.1612903
NODE_404_length_3747_cov_3.328947	2230	2292	7	2	62	0.0322581
NODE_404_length_3747_cov_3.328947	2230	2292	8	24	62	0.3870968
NODE_406_length_3743_cov_38.767014	1354	1434	22	1	80	0.0125000
NODE_406_length_3743_cov_38.767014	1354	1434	24	7	80	0.0875000
NODE_406_length_3743_cov_38.767014	1354	1434	25	3	80	0.0375000
NODE_406_length_3743_cov_38.767014	1354	1434	26	2	80	0.0250000
NODE_406_length_3743_cov_38.767014	1354	1434	27	11	80	0.1375000
NODE_406_length_3743_cov_38.767014	1354	1434	28	1	80	0.0125000
NODE_406_length_3743_cov_38.767014	1354	1434	30	10	80	0.1250000
NODE_406_length_3743_cov_38.767014	1354	1434	32	1	80	0.0125000
NODE_406_length_3743_cov_38.767014	1354	1434	33	1	80	0.0125000
NODE_406_length_3743_cov_38.767014	1354	1434	34	6	80	0.0750000
NODE_406_length_3743_cov_38.767014	1354	1434	35	11	80	0.1375000
NODE_406_length_3743_cov_38.767014	1354	1434	36	4	80	0.0500000
NODE_406_length_3743_cov_38.767014	1354	1434	38	4	80	0.0500000
NODE_406_length_3743_cov_38.767014	1354	1434	39	3	80	0.0375000
NODE_406_length_3743_cov_38.767014	1354	1434	40	11	80	0.1375000
NODE_406_length_3743_cov_38.767014	1354	1434	41	4	80	0.0500000
NODE_406_length_3743_cov_38.767014	1407	1487	27	2	80	0.0250000
NODE_406_length_3743_cov_38.767014	1407	1487	29	6	80	0.0750000
NODE_406_length_3743_cov_38.767014	1407	1487	30	7	80	0.0875000
NODE_406_length_3743_cov_38.767014	1407	1487	33	5	80	0.0625000
NODE_406_length_3743_cov_38.767014	1407	1487	34	2	80	0.0250000
NODE_406_length_3743_cov_38.767014	1407	1487	35	5	80	0.0625000
NODE_406_length_3743_cov_38.767014	1407	1487	36	10	80	0.1250000
NODE_406_length_3743_cov_38.767014	1407	1487	38	4	80	0.0500000
NODE_406_length_3743_cov_38.767014	1407	1487	39	3	80	0.0375000
NODE_406_length_3743_cov_38.767014	1407	1487	40	11	80	0.1375000
NODE_406_length_3743_cov_38.767014	1407	1487	41	17	80	0.2125000
NODE_406_length_3743_cov_38.767014	1407	1487	42	2	80	0.0250000
NODE_406_length_3743_cov_38.767014	1407	1487	43	6	80	0.0750000
NODE_408_length_3733_cov_16.204458	186	249	3	47	63	0.7460318
NODE_408_length_3733_cov_16.204458	186	249	4	1	63	0.0158730
NODE_408_length_3733_cov_16.204458	186	249	5	4	63	0.0634921
NODE_408_length_3733_cov_16.204458	186	249	11	1	63	0.0158730
NODE_408_length_3733_cov_16.204458	186	249	18	1	63	0.0158730
NODE_408_length_3733_cov_16.204458	186	249	25	1	63	0.0158730
NODE_408_length_3733_cov_16.204458	186	249	28	3	63	0.0476190
NODE_408_length_3733_cov_16.204458	186	249	35	2	63	0.0317460
NODE_408_length_3733_cov_16.204458	186	249	39	3	63	0.0476190
NODE_413_length_3707_cov_56.575665	2387	2467	5	12	80	0.1500000
NODE_413_length_3707_cov_56.575665	2387	2467	7	9	80	0.1125000
NODE_413_length_3707_cov_56.575665	2387	2467	8	7	80	0.0875000
NODE_413_length_3707_cov_56.575665	2387	2467	9	18	80	0.2250000
NODE_413_length_3707_cov_56.575665	2387	2467	10	6	80	0.0750000
NODE_413_length_3707_cov_56.575665	2387	2467	12	3	80	0.0375000
NODE_413_length_3707_cov_56.575665	2387	2467	13	7	80	0.0875000
NODE_413_length_3707_cov_56.575665	2387	2467	14	16	80	0.2000000
NODE_413_length_3707_cov_56.575665	2387	2467	15	1	80	0.0125000
NODE_413_length_3707_cov_56.575665	2387	2467	16	1	80	0.0125000
NODE_413_length_3707_cov_56.575665	2440	2520	12	2	80	0.0250000
NODE_413_length_3707_cov_56.575665	2440	2520	13	7	80	0.0875000
NODE_413_length_3707_cov_56.575665	2440	2520	14	16	80	0.2000000
NODE_413_length_3707_cov_56.575665	2440	2520	15	8	80	0.1000000
NODE_413_length_3707_cov_56.575665	2440	2520	16	33	80	0.4125000
NODE_413_length_3707_cov_56.575665	2440	2520	17	10	80	0.1250000
NODE_413_length_3707_cov_56.575665	2440	2520	18	4	80	0.0500000
NODE_413_length_3707_cov_56.575665	2516	2596	16	3	80	0.0375000
NODE_413_length_3707_cov_56.575665	2516	2596	17	22	80	0.2750000
NODE_413_length_3707_cov_56.575665	2516	2596	18	17	80	0.2125000
NODE_413_length_3707_cov_56.575665	2516	2596	19	24	80	0.3000000
NODE_413_length_3707_cov_56.575665	2516	2596	20	9	80	0.1125000
NODE_413_length_3707_cov_56.575665	2516	2596	21	5	80	0.0625000
NODE_413_length_3707_cov_56.575665	2569	2649	16	5	80	0.0625000
NODE_413_length_3707_cov_56.575665	2569	2649	17	22	80	0.2750000
NODE_413_length_3707_cov_56.575665	2569	2649	18	22	80	0.2750000
NODE_413_length_3707_cov_56.575665	2569	2649	19	19	80	0.2375000
NODE_413_length_3707_cov_56.575665	2569	2649	20	12	80	0.1500000
NODE_416_length_3690_cov_7.476190	723	792	4	69	69	1.0000000
NODE_416_length_3690_cov_7.476190	776	855	0	15	79	0.1898734
NODE_416_length_3690_cov_7.476190	776	855	2	14	79	0.1772152
NODE_416_length_3690_cov_7.476190	776	855	3	14	79	0.1772152
NODE_416_length_3690_cov_7.476190	776	855	4	36	79	0.4556962
NODE_419_length_3685_cov_7.011154	1966	2046	77	3	80	0.0375000
NODE_419_length_3685_cov_7.011154	1966	2046	79	4	80	0.0500000
NODE_419_length_3685_cov_7.011154	1966	2046	80	4	80	0.0500000
NODE_419_length_3685_cov_7.011154	1966	2046	81	5	80	0.0625000
NODE_419_length_3685_cov_7.011154	1966	2046	82	3	80	0.0375000
NODE_419_length_3685_cov_7.011154	1966	2046	83	4	80	0.0500000
NODE_419_length_3685_cov_7.011154	1966	2046	84	6	80	0.0750000
NODE_419_length_3685_cov_7.011154	1966	2046	86	2	80	0.0250000
NODE_419_length_3685_cov_7.011154	1966	2046	87	4	80	0.0500000
NODE_419_length_3685_cov_7.011154	1966	2046	88	1	80	0.0125000
NODE_419_length_3685_cov_7.011154	1966	2046	89	2	80	0.0250000
NODE_419_length_3685_cov_7.011154	1966	2046	90	12	80	0.1500000
NODE_419_length_3685_cov_7.011154	1966	2046	91	7	80	0.0875000
NODE_419_length_3685_cov_7.011154	1966	2046	92	14	80	0.1750000
NODE_419_length_3685_cov_7.011154	1966	2046	93	8	80	0.1000000
NODE_419_length_3685_cov_7.011154	1966	2046	94	1	80	0.0125000
NODE_419_length_3685_cov_7.011154	2019	2086	71	1	67	0.0149254
NODE_419_length_3685_cov_7.011154	2019	2086	72	4	67	0.0597015
NODE_419_length_3685_cov_7.011154	2019	2086	73	1	67	0.0149254
NODE_419_length_3685_cov_7.011154	2019	2086	75	1	67	0.0149254
NODE_419_length_3685_cov_7.011154	2019	2086	76	5	67	0.0746269
NODE_419_length_3685_cov_7.011154	2019	2086	79	4	67	0.0597015
NODE_419_length_3685_cov_7.011154	2019	2086	80	3	67	0.0447761
NODE_419_length_3685_cov_7.011154	2019	2086	82	3	67	0.0447761
NODE_419_length_3685_cov_7.011154	2019	2086	83	6	67	0.0895522
NODE_419_length_3685_cov_7.011154	2019	2086	84	2	67	0.0298507
NODE_419_length_3685_cov_7.011154	2019	2086	86	4	67	0.0597015
NODE_419_length_3685_cov_7.011154	2019	2086	87	2	67	0.0298507
NODE_419_length_3685_cov_7.011154	2019	2086	88	1	67	0.0149254
NODE_419_length_3685_cov_7.011154	2019	2086	90	7	67	0.1044776
NODE_419_length_3685_cov_7.011154	2019	2086	91	7	67	0.1044776
NODE_419_length_3685_cov_7.011154	2019	2086	92	9	67	0.1343284
NODE_419_length_3685_cov_7.011154	2019	2086	93	7	67	0.1044776
NODE_426_length_3667_cov_1089.047365	1634	1705	57	1	71	0.0140845
NODE_426_length_3667_cov_1089.047365	1634	1705	58	6	71	0.0845070
NODE_426_length_3667_cov_1089.047365	1634	1705	59	1	71	0.0140845
NODE_426_length_3667_cov_1089.047365	1634	1705	60	7	71	0.0985916
NODE_426_length_3667_cov_1089.047365	1634	1705	61	3	71	0.0422535
NODE_426_length_3667_cov_1089.047365	1634	1705	62	1	71	0.0140845
NODE_426_length_3667_cov_1089.047365	1634	1705	63	1	71	0.0140845
NODE_426_length_3667_cov_1089.047365	1634	1705	64	5	71	0.0704225
NODE_426_length_3667_cov_1089.047365	1634	1705	65	7	71	0.0985916
NODE_426_length_3667_cov_1089.047365	1634	1705	66	3	71	0.0422535
NODE_426_length_3667_cov_1089.047365	1634	1705	68	1	71	0.0140845
NODE_426_length_3667_cov_1089.047365	1634	1705	70	1	71	0.0140845
NODE_426_length_3667_cov_1089.047365	1634	1705	72	1	71	0.0140845
NODE_426_length_3667_cov_1089.047365	1634	1705	74	9	71	0.1267606
NODE_426_length_3667_cov_1089.047365	1634	1705	75	1	71	0.0140845
NODE_426_length_3667_cov_1089.047365	1634	1705	77	2	71	0.0281690
NODE_426_length_3667_cov_1089.047365	1634	1705	78	3	71	0.0422535
NODE_426_length_3667_cov_1089.047365	1634	1705	79	1	71	0.0140845
NODE_426_length_3667_cov_1089.047365	1634	1705	82	2	71	0.0281690
NODE_426_length_3667_cov_1089.047365	1634	1705	83	7	71	0.0985916
NODE_426_length_3667_cov_1089.047365	1634	1705	84	4	71	0.0563380
NODE_426_length_3667_cov_1089.047365	1634	1705	85	3	71	0.0422535
NODE_426_length_3667_cov_1089.047365	1634	1705	86	1	71	0.0140845
NODE_426_length_3667_cov_1089.047365	1678	1758	71	1	80	0.0125000
NODE_426_length_3667_cov_1089.047365	1678	1758	72	4	80	0.0500000
NODE_426_length_3667_cov_1089.047365	1678	1758	73	1	80	0.0125000
NODE_426_length_3667_cov_1089.047365	1678	1758	74	3	80	0.0375000
NODE_426_length_3667_cov_1089.047365	1678	1758	75	5	80	0.0625000
NODE_426_length_3667_cov_1089.047365	1678	1758	77	5	80	0.0625000
NODE_426_length_3667_cov_1089.047365	1678	1758	78	3	80	0.0375000
NODE_426_length_3667_cov_1089.047365	1678	1758	79	1	80	0.0125000
NODE_426_length_3667_cov_1089.047365	1678	1758	81	4	80	0.0500000
NODE_426_length_3667_cov_1089.047365	1678	1758	82	3	80	0.0375000
NODE_426_length_3667_cov_1089.047365	1678	1758	83	14	80	0.1750000
NODE_426_length_3667_cov_1089.047365	1678	1758	84	8	80	0.1000000
NODE_426_length_3667_cov_1089.047365	1678	1758	85	18	80	0.2250000
NODE_426_length_3667_cov_1089.047365	1678	1758	86	3	80	0.0375000
NODE_426_length_3667_cov_1089.047365	1678	1758	87	6	80	0.0750000
NODE_426_length_3667_cov_1089.047365	1678	1758	88	1	80	0.0125000
NODE_428_length_3660_cov_79.447627	1806	1870	140	1	64	0.0156250
NODE_428_length_3660_cov_79.447627	1806	1870	142	3	64	0.0468750
NODE_428_length_3660_cov_79.447627	1806	1870	143	2	64	0.0312500
NODE_428_length_3660_cov_79.447627	1806	1870	144	2	64	0.0312500
NODE_428_length_3660_cov_79.447627	1806	1870	146	2	64	0.0312500
NODE_428_length_3660_cov_79.447627	1806	1870	147	1	64	0.0156250
NODE_428_length_3660_cov_79.447627	1806	1870	148	1	64	0.0156250
NODE_428_length_3660_cov_79.447627	1806	1870	151	1	64	0.0156250
NODE_428_length_3660_cov_79.447627	1806	1870	152	1	64	0.0156250
NODE_428_length_3660_cov_79.447627	1806	1870	154	1	64	0.0156250
NODE_428_length_3660_cov_79.447627	1806	1870	159	1	64	0.0156250
NODE_428_length_3660_cov_79.447627	1806	1870	164	1	64	0.0156250
NODE_428_length_3660_cov_79.447627	1806	1870	165	1	64	0.0156250
NODE_428_length_3660_cov_79.447627	1806	1870	167	1	64	0.0156250
NODE_428_length_3660_cov_79.447627	1806	1870	168	1	64	0.0156250
NODE_428_length_3660_cov_79.447627	1806	1870	170	1	64	0.0156250
NODE_428_length_3660_cov_79.447627	1806	1870	172	1	64	0.0156250
NODE_428_length_3660_cov_79.447627	1806	1870	174	2	64	0.0312500
NODE_428_length_3660_cov_79.447627	1806	1870	177	1	64	0.0156250
NODE_428_length_3660_cov_79.447627	1806	1870	178	1	64	0.0156250
NODE_428_length_3660_cov_79.447627	1806	1870	179	4	64	0.0625000
NODE_428_length_3660_cov_79.447627	1806	1870	180	1	64	0.0156250
NODE_428_length_3660_cov_79.447627	1806	1870	183	1	64	0.0156250
NODE_428_length_3660_cov_79.447627	1806	1870	184	1	64	0.0156250
NODE_428_length_3660_cov_79.447627	1806	1870	185	3	64	0.0468750
NODE_428_length_3660_cov_79.447627	1806	1870	186	5	64	0.0781250
NODE_428_length_3660_cov_79.447627	1806	1870	187	3	64	0.0468750
NODE_428_length_3660_cov_79.447627	1806	1870	188	3	64	0.0468750
NODE_428_length_3660_cov_79.447627	1806	1870	189	3	64	0.0468750
NODE_428_length_3660_cov_79.447627	1806	1870	190	2	64	0.0312500
NODE_428_length_3660_cov_79.447627	1806	1870	194	1	64	0.0156250
NODE_428_length_3660_cov_79.447627	1806	1870	196	2	64	0.0312500
NODE_428_length_3660_cov_79.447627	1806	1870	197	1	64	0.0156250
NODE_428_length_3660_cov_79.447627	1806	1870	198	1	64	0.0156250
NODE_428_length_3660_cov_79.447627	1806	1870	201	2	64	0.0312500
NODE_428_length_3660_cov_79.447627	1806	1870	202	3	64	0.0468750
NODE_428_length_3660_cov_79.447627	1806	1870	203	1	64	0.0156250
NODE_428_length_3660_cov_79.447627	1806	1870	204	1	64	0.0156250
NODE_428_length_3660_cov_79.447627	1859	1906	196	2	47	0.0425532
NODE_428_length_3660_cov_79.447627	1859	1906	197	1	47	0.0212766
NODE_428_length_3660_cov_79.447627	1859	1906	198	1	47	0.0212766
NODE_428_length_3660_cov_79.447627	1859	1906	200	1	47	0.0212766
NODE_428_length_3660_cov_79.447627	1859	1906	201	5	47	0.1063830
NODE_428_length_3660_cov_79.447627	1859	1906	202	11	47	0.2340426
NODE_428_length_3660_cov_79.447627	1859	1906	203	3	47	0.0638298
NODE_428_length_3660_cov_79.447627	1859	1906	204	3	47	0.0638298
NODE_428_length_3660_cov_79.447627	1859	1906	205	7	47	0.1489362
NODE_428_length_3660_cov_79.447627	1859	1906	206	5	47	0.1063830
NODE_428_length_3660_cov_79.447627	1859	1906	207	3	47	0.0638298
NODE_428_length_3660_cov_79.447627	1859	1906	208	4	47	0.0851064
NODE_428_length_3660_cov_79.447627	1859	1906	209	1	47	0.0212766
NODE_428_length_3660_cov_79.447627	2358	2438	0	19	80	0.2375000
NODE_428_length_3660_cov_79.447627	2358	2438	1	26	80	0.3250000
NODE_428_length_3660_cov_79.447627	2358	2438	2	20	80	0.2500000
NODE_428_length_3660_cov_79.447627	2358	2438	4	15	80	0.1875000
NODE_428_length_3660_cov_79.447627	2411	2491	2	25	80	0.3125000
NODE_428_length_3660_cov_79.447627	2411	2491	4	55	80	0.6875000
NODE_428_length_3660_cov_79.447627	2487	2567	1	14	80	0.1750000
NODE_428_length_3660_cov_79.447627	2487	2567	2	35	80	0.4375000
NODE_428_length_3660_cov_79.447627	2487	2567	3	31	80	0.3875000
NODE_428_length_3660_cov_79.447627	2540	2620	1	67	80	0.8375000
NODE_428_length_3660_cov_79.447627	2540	2620	2	13	80	0.1625000
NODE_430_length_3634_cov_34.913154	1499	1544	76	1	45	0.0222222
NODE_430_length_3634_cov_34.913154	1499	1544	88	1	45	0.0222222
NODE_430_length_3634_cov_34.913154	1499	1544	93	1	45	0.0222222
NODE_430_length_3634_cov_34.913154	1499	1544	105	1	45	0.0222222
NODE_430_length_3634_cov_34.913154	1499	1544	111	1	45	0.0222222
NODE_430_length_3634_cov_34.913154	1499	1544	114	1	45	0.0222222
NODE_430_length_3634_cov_34.913154	1499	1544	121	1	45	0.0222222
NODE_430_length_3634_cov_34.913154	1499	1544	122	1	45	0.0222222
NODE_430_length_3634_cov_34.913154	1499	1544	124	1	45	0.0222222
NODE_430_length_3634_cov_34.913154	1499	1544	125	1	45	0.0222222
NODE_430_length_3634_cov_34.913154	1499	1544	137	1	45	0.0222222
NODE_430_length_3634_cov_34.913154	1499	1544	140	1	45	0.0222222
NODE_430_length_3634_cov_34.913154	1499	1544	146	1	45	0.0222222
NODE_430_length_3634_cov_34.913154	1499	1544	148	1	45	0.0222222
NODE_430_length_3634_cov_34.913154	1499	1544	153	1	45	0.0222222
NODE_430_length_3634_cov_34.913154	1499	1544	154	1	45	0.0222222
NODE_430_length_3634_cov_34.913154	1499	1544	157	1	45	0.0222222
NODE_430_length_3634_cov_34.913154	1499	1544	160	1	45	0.0222222
NODE_430_length_3634_cov_34.913154	1499	1544	165	1	45	0.0222222
NODE_430_length_3634_cov_34.913154	1499	1544	168	1	45	0.0222222
NODE_430_length_3634_cov_34.913154	1499	1544	171	1	45	0.0222222
NODE_430_length_3634_cov_34.913154	1499	1544	185	1	45	0.0222222
NODE_430_length_3634_cov_34.913154	1499	1544	194	1	45	0.0222222
NODE_430_length_3634_cov_34.913154	1499	1544	195	1	45	0.0222222
NODE_430_length_3634_cov_34.913154	1499	1544	198	1	45	0.0222222
NODE_430_length_3634_cov_34.913154	1499	1544	201	1	45	0.0222222
NODE_430_length_3634_cov_34.913154	1499	1544	204	1	45	0.0222222
NODE_430_length_3634_cov_34.913154	1499	1544	209	1	45	0.0222222
NODE_430_length_3634_cov_34.913154	1499	1544	211	1	45	0.0222222
NODE_430_length_3634_cov_34.913154	1499	1544	216	1	45	0.0222222
NODE_430_length_3634_cov_34.913154	1499	1544	219	1	45	0.0222222
NODE_430_length_3634_cov_34.913154	1499	1544	220	1	45	0.0222222
NODE_430_length_3634_cov_34.913154	1499	1544	226	2	45	0.0444444
NODE_430_length_3634_cov_34.913154	1499	1544	230	1	45	0.0222222
NODE_430_length_3634_cov_34.913154	1499	1544	240	1	45	0.0222222
NODE_430_length_3634_cov_34.913154	1499	1544	241	1	45	0.0222222
NODE_430_length_3634_cov_34.913154	1499	1544	252	1	45	0.0222222
NODE_430_length_3634_cov_34.913154	1499	1544	255	1	45	0.0222222
NODE_430_length_3634_cov_34.913154	1499	1544	257	1	45	0.0222222
NODE_430_length_3634_cov_34.913154	1499	1544	261	1	45	0.0222222
NODE_430_length_3634_cov_34.913154	1499	1544	266	1	45	0.0222222
NODE_430_length_3634_cov_34.913154	1499	1544	272	1	45	0.0222222
NODE_430_length_3634_cov_34.913154	1499	1544	277	1	45	0.0222222
NODE_430_length_3634_cov_34.913154	1499	1544	282	1	45	0.0222222
NODE_430_length_3634_cov_34.913154	1517	1597	165	1	80	0.0125000
NODE_430_length_3634_cov_34.913154	1517	1597	168	1	80	0.0125000
NODE_430_length_3634_cov_34.913154	1517	1597	171	1	80	0.0125000
NODE_430_length_3634_cov_34.913154	1517	1597	185	1	80	0.0125000
NODE_430_length_3634_cov_34.913154	1517	1597	194	1	80	0.0125000
NODE_430_length_3634_cov_34.913154	1517	1597	195	1	80	0.0125000
NODE_430_length_3634_cov_34.913154	1517	1597	198	1	80	0.0125000
NODE_430_length_3634_cov_34.913154	1517	1597	201	1	80	0.0125000
NODE_430_length_3634_cov_34.913154	1517	1597	204	1	80	0.0125000
NODE_430_length_3634_cov_34.913154	1517	1597	209	1	80	0.0125000
NODE_430_length_3634_cov_34.913154	1517	1597	211	1	80	0.0125000
NODE_430_length_3634_cov_34.913154	1517	1597	216	1	80	0.0125000
NODE_430_length_3634_cov_34.913154	1517	1597	219	1	80	0.0125000
NODE_430_length_3634_cov_34.913154	1517	1597	220	1	80	0.0125000
NODE_430_length_3634_cov_34.913154	1517	1597	226	2	80	0.0250000
NODE_430_length_3634_cov_34.913154	1517	1597	230	1	80	0.0125000
NODE_430_length_3634_cov_34.913154	1517	1597	240	1	80	0.0125000
NODE_430_length_3634_cov_34.913154	1517	1597	241	1	80	0.0125000
NODE_430_length_3634_cov_34.913154	1517	1597	252	1	80	0.0125000
NODE_430_length_3634_cov_34.913154	1517	1597	255	1	80	0.0125000
NODE_430_length_3634_cov_34.913154	1517	1597	257	1	80	0.0125000
NODE_430_length_3634_cov_34.913154	1517	1597	261	1	80	0.0125000
NODE_430_length_3634_cov_34.913154	1517	1597	266	1	80	0.0125000
NODE_430_length_3634_cov_34.913154	1517	1597	272	1	80	0.0125000
NODE_430_length_3634_cov_34.913154	1517	1597	277	1	80	0.0125000
NODE_430_length_3634_cov_34.913154	1517	1597	282	1	80	0.0125000
NODE_430_length_3634_cov_34.913154	1517	1597	283	1	80	0.0125000
NODE_430_length_3634_cov_34.913154	1517	1597	286	1	80	0.0125000
NODE_430_length_3634_cov_34.913154	1517	1597	288	1	80	0.0125000
NODE_430_length_3634_cov_34.913154	1517	1597	292	1	80	0.0125000
NODE_430_length_3634_cov_34.913154	1517	1597	296	1	80	0.0125000
NODE_430_length_3634_cov_34.913154	1517	1597	297	1	80	0.0125000
NODE_430_length_3634_cov_34.913154	1517	1597	300	1	80	0.0125000
NODE_430_length_3634_cov_34.913154	1517	1597	305	1	80	0.0125000
NODE_430_length_3634_cov_34.913154	1517	1597	306	1	80	0.0125000
NODE_430_length_3634_cov_34.913154	1517	1597	312	2	80	0.0250000
NODE_430_length_3634_cov_34.913154	1517	1597	313	1	80	0.0125000
NODE_430_length_3634_cov_34.913154	1517	1597	316	1	80	0.0125000
NODE_430_length_3634_cov_34.913154	1517	1597	318	1	80	0.0125000
NODE_430_length_3634_cov_34.913154	1517	1597	323	1	80	0.0125000
NODE_430_length_3634_cov_34.913154	1517	1597	329	1	80	0.0125000
NODE_430_length_3634_cov_34.913154	1517	1597	341	1	80	0.0125000
NODE_430_length_3634_cov_34.913154	1517	1597	346	1	80	0.0125000
NODE_430_length_3634_cov_34.913154	1517	1597	357	1	80	0.0125000
NODE_430_length_3634_cov_34.913154	1517	1597	361	1	80	0.0125000
NODE_430_length_3634_cov_34.913154	1517	1597	375	1	80	0.0125000
NODE_430_length_3634_cov_34.913154	1517	1597	378	1	80	0.0125000
NODE_430_length_3634_cov_34.913154	1517	1597	380	1	80	0.0125000
NODE_430_length_3634_cov_34.913154	1517	1597	382	1	80	0.0125000
NODE_430_length_3634_cov_34.913154	1517	1597	388	1	80	0.0125000
NODE_430_length_3634_cov_34.913154	1517	1597	390	1	80	0.0125000
NODE_430_length_3634_cov_34.913154	1517	1597	398	1	80	0.0125000
NODE_430_length_3634_cov_34.913154	1517	1597	401	1	80	0.0125000
NODE_430_length_3634_cov_34.913154	1517	1597	402	1	80	0.0125000
NODE_430_length_3634_cov_34.913154	1517	1597	407	1	80	0.0125000
NODE_430_length_3634_cov_34.913154	1517	1597	410	1	80	0.0125000
NODE_430_length_3634_cov_34.913154	1517	1597	419	1	80	0.0125000
NODE_430_length_3634_cov_34.913154	1517	1597	422	1	80	0.0125000
NODE_430_length_3634_cov_34.913154	1517	1597	430	1	80	0.0125000
NODE_430_length_3634_cov_34.913154	1517	1597	437	1	80	0.0125000
NODE_430_length_3634_cov_34.913154	1517	1597	450	1	80	0.0125000
NODE_430_length_3634_cov_34.913154	1517	1597	451	2	80	0.0250000
NODE_430_length_3634_cov_34.913154	1517	1597	455	1	80	0.0125000
NODE_430_length_3634_cov_34.913154	1517	1597	459	1	80	0.0125000
NODE_430_length_3634_cov_34.913154	1517	1597	460	1	80	0.0125000
NODE_430_length_3634_cov_34.913154	1517	1597	462	1	80	0.0125000
NODE_430_length_3634_cov_34.913154	1517	1597	463	2	80	0.0250000
NODE_430_length_3634_cov_34.913154	1517	1597	464	1	80	0.0125000
NODE_430_length_3634_cov_34.913154	1517	1597	466	1	80	0.0125000
NODE_430_length_3634_cov_34.913154	1517	1597	472	1	80	0.0125000
NODE_430_length_3634_cov_34.913154	1517	1597	475	1	80	0.0125000
NODE_430_length_3634_cov_34.913154	1517	1597	478	1	80	0.0125000
NODE_430_length_3634_cov_34.913154	1517	1597	481	1	80	0.0125000
NODE_430_length_3634_cov_34.913154	1517	1597	482	2	80	0.0250000
NODE_430_length_3634_cov_34.913154	1517	1597	485	1	80	0.0125000
NODE_430_length_3634_cov_34.913154	1978	2058	117	2	80	0.0250000
NODE_430_length_3634_cov_34.913154	1978	2058	119	1	80	0.0125000
NODE_430_length_3634_cov_34.913154	1978	2058	121	1	80	0.0125000
NODE_430_length_3634_cov_34.913154	1978	2058	131	1	80	0.0125000
NODE_430_length_3634_cov_34.913154	1978	2058	132	1	80	0.0125000
NODE_430_length_3634_cov_34.913154	1978	2058	133	2	80	0.0250000
NODE_430_length_3634_cov_34.913154	1978	2058	134	1	80	0.0125000
NODE_430_length_3634_cov_34.913154	1978	2058	136	1	80	0.0125000
NODE_430_length_3634_cov_34.913154	1978	2058	144	1	80	0.0125000
NODE_430_length_3634_cov_34.913154	1978	2058	150	1	80	0.0125000
NODE_430_length_3634_cov_34.913154	1978	2058	154	1	80	0.0125000
NODE_430_length_3634_cov_34.913154	1978	2058	162	1	80	0.0125000
NODE_430_length_3634_cov_34.913154	1978	2058	163	1	80	0.0125000
NODE_430_length_3634_cov_34.913154	1978	2058	167	1	80	0.0125000
NODE_430_length_3634_cov_34.913154	1978	2058	171	1	80	0.0125000
NODE_430_length_3634_cov_34.913154	1978	2058	172	1	80	0.0125000
NODE_430_length_3634_cov_34.913154	1978	2058	181	1	80	0.0125000
NODE_430_length_3634_cov_34.913154	1978	2058	182	1	80	0.0125000
NODE_430_length_3634_cov_34.913154	1978	2058	187	1	80	0.0125000
NODE_430_length_3634_cov_34.913154	1978	2058	188	1	80	0.0125000
NODE_430_length_3634_cov_34.913154	1978	2058	193	1	80	0.0125000
NODE_430_length_3634_cov_34.913154	1978	2058	198	1	80	0.0125000
NODE_430_length_3634_cov_34.913154	1978	2058	203	1	80	0.0125000
NODE_430_length_3634_cov_34.913154	1978	2058	209	1	80	0.0125000
NODE_430_length_3634_cov_34.913154	1978	2058	223	1	80	0.0125000
NODE_430_length_3634_cov_34.913154	1978	2058	227	1	80	0.0125000
NODE_430_length_3634_cov_34.913154	1978	2058	234	1	80	0.0125000
NODE_430_length_3634_cov_34.913154	1978	2058	236	1	80	0.0125000
NODE_430_length_3634_cov_34.913154	1978	2058	240	1	80	0.0125000
NODE_430_length_3634_cov_34.913154	1978	2058	243	2	80	0.0250000
NODE_430_length_3634_cov_34.913154	1978	2058	251	1	80	0.0125000
NODE_430_length_3634_cov_34.913154	1978	2058	254	1	80	0.0125000
NODE_430_length_3634_cov_34.913154	1978	2058	256	1	80	0.0125000
NODE_430_length_3634_cov_34.913154	1978	2058	258	1	80	0.0125000
NODE_430_length_3634_cov_34.913154	1978	2058	265	1	80	0.0125000
NODE_430_length_3634_cov_34.913154	1978	2058	271	1	80	0.0125000
NODE_430_length_3634_cov_34.913154	1978	2058	277	1	80	0.0125000
NODE_430_length_3634_cov_34.913154	1978	2058	280	1	80	0.0125000
NODE_430_length_3634_cov_34.913154	1978	2058	284	1	80	0.0125000
NODE_430_length_3634_cov_34.913154	1978	2058	289	1	80	0.0125000
NODE_430_length_3634_cov_34.913154	1978	2058	298	1	80	0.0125000
NODE_430_length_3634_cov_34.913154	1978	2058	300	1	80	0.0125000
NODE_430_length_3634_cov_34.913154	1978	2058	301	1	80	0.0125000
NODE_430_length_3634_cov_34.913154	1978	2058	303	1	80	0.0125000
NODE_430_length_3634_cov_34.913154	1978	2058	308	1	80	0.0125000
NODE_430_length_3634_cov_34.913154	1978	2058	310	1	80	0.0125000
NODE_430_length_3634_cov_34.913154	1978	2058	312	1	80	0.0125000
NODE_430_length_3634_cov_34.913154	1978	2058	313	1	80	0.0125000
NODE_430_length_3634_cov_34.913154	1978	2058	320	1	80	0.0125000
NODE_430_length_3634_cov_34.913154	1978	2058	322	1	80	0.0125000
NODE_430_length_3634_cov_34.913154	1978	2058	324	1	80	0.0125000
NODE_430_length_3634_cov_34.913154	1978	2058	331	1	80	0.0125000
NODE_430_length_3634_cov_34.913154	1978	2058	337	2	80	0.0250000
NODE_430_length_3634_cov_34.913154	1978	2058	338	1	80	0.0125000
NODE_430_length_3634_cov_34.913154	1978	2058	344	1	80	0.0125000
NODE_430_length_3634_cov_34.913154	1978	2058	346	1	80	0.0125000
NODE_430_length_3634_cov_34.913154	1978	2058	349	1	80	0.0125000
NODE_430_length_3634_cov_34.913154	1978	2058	353	1	80	0.0125000
NODE_430_length_3634_cov_34.913154	1978	2058	360	1	80	0.0125000
NODE_430_length_3634_cov_34.913154	1978	2058	362	1	80	0.0125000
NODE_430_length_3634_cov_34.913154	1978	2058	363	1	80	0.0125000
NODE_430_length_3634_cov_34.913154	1978	2058	368	1	80	0.0125000
NODE_430_length_3634_cov_34.913154	1978	2058	374	1	80	0.0125000
NODE_430_length_3634_cov_34.913154	1978	2058	377	1	80	0.0125000
NODE_430_length_3634_cov_34.913154	1978	2058	382	1	80	0.0125000
NODE_430_length_3634_cov_34.913154	1978	2058	384	1	80	0.0125000
NODE_430_length_3634_cov_34.913154	1978	2058	391	1	80	0.0125000
NODE_430_length_3634_cov_34.913154	1978	2058	395	1	80	0.0125000
NODE_430_length_3634_cov_34.913154	1978	2058	417	1	80	0.0125000
NODE_430_length_3634_cov_34.913154	1978	2058	421	1	80	0.0125000
NODE_430_length_3634_cov_34.913154	1978	2058	426	1	80	0.0125000
NODE_430_length_3634_cov_34.913154	1978	2058	429	1	80	0.0125000
NODE_430_length_3634_cov_34.913154	1978	2058	433	1	80	0.0125000
NODE_430_length_3634_cov_34.913154	1978	2058	443	1	80	0.0125000
NODE_430_length_3634_cov_34.913154	1978	2058	444	2	80	0.0250000
NODE_430_length_3634_cov_34.913154	2031	2077	51	1	46	0.0217391
NODE_430_length_3634_cov_34.913154	2031	2077	53	1	46	0.0217391
NODE_430_length_3634_cov_34.913154	2031	2077	56	1	46	0.0217391
NODE_430_length_3634_cov_34.913154	2031	2077	57	1	46	0.0217391
NODE_430_length_3634_cov_34.913154	2031	2077	65	1	46	0.0217391
NODE_430_length_3634_cov_34.913154	2031	2077	73	1	46	0.0217391
NODE_430_length_3634_cov_34.913154	2031	2077	74	1	46	0.0217391
NODE_430_length_3634_cov_34.913154	2031	2077	77	1	46	0.0217391
NODE_430_length_3634_cov_34.913154	2031	2077	82	1	46	0.0217391
NODE_430_length_3634_cov_34.913154	2031	2077	89	1	46	0.0217391
NODE_430_length_3634_cov_34.913154	2031	2077	94	1	46	0.0217391
NODE_430_length_3634_cov_34.913154	2031	2077	97	1	46	0.0217391
NODE_430_length_3634_cov_34.913154	2031	2077	102	3	46	0.0652174
NODE_430_length_3634_cov_34.913154	2031	2077	107	1	46	0.0217391
NODE_430_length_3634_cov_34.913154	2031	2077	111	1	46	0.0217391
NODE_430_length_3634_cov_34.913154	2031	2077	112	1	46	0.0217391
NODE_430_length_3634_cov_34.913154	2031	2077	114	1	46	0.0217391
NODE_430_length_3634_cov_34.913154	2031	2077	117	2	46	0.0434783
NODE_430_length_3634_cov_34.913154	2031	2077	119	1	46	0.0217391
NODE_430_length_3634_cov_34.913154	2031	2077	121	1	46	0.0217391
NODE_430_length_3634_cov_34.913154	2031	2077	131	1	46	0.0217391
NODE_430_length_3634_cov_34.913154	2031	2077	132	1	46	0.0217391
NODE_430_length_3634_cov_34.913154	2031	2077	133	2	46	0.0434783
NODE_430_length_3634_cov_34.913154	2031	2077	134	1	46	0.0217391
NODE_430_length_3634_cov_34.913154	2031	2077	136	1	46	0.0217391
NODE_430_length_3634_cov_34.913154	2031	2077	144	1	46	0.0217391
NODE_430_length_3634_cov_34.913154	2031	2077	150	1	46	0.0217391
NODE_430_length_3634_cov_34.913154	2031	2077	154	1	46	0.0217391
NODE_430_length_3634_cov_34.913154	2031	2077	162	1	46	0.0217391
NODE_430_length_3634_cov_34.913154	2031	2077	163	1	46	0.0217391
NODE_430_length_3634_cov_34.913154	2031	2077	167	1	46	0.0217391
NODE_430_length_3634_cov_34.913154	2031	2077	171	1	46	0.0217391
NODE_430_length_3634_cov_34.913154	2031	2077	172	1	46	0.0217391
NODE_430_length_3634_cov_34.913154	2031	2077	181	1	46	0.0217391
NODE_430_length_3634_cov_34.913154	2031	2077	182	1	46	0.0217391
NODE_430_length_3634_cov_34.913154	2031	2077	187	1	46	0.0217391
NODE_430_length_3634_cov_34.913154	2031	2077	188	1	46	0.0217391
NODE_430_length_3634_cov_34.913154	2031	2077	193	1	46	0.0217391
NODE_430_length_3634_cov_34.913154	2031	2077	198	1	46	0.0217391
NODE_430_length_3634_cov_34.913154	2031	2077	203	1	46	0.0217391
NODE_430_length_3634_cov_34.913154	2031	2077	209	1	46	0.0217391
NODE_430_length_3634_cov_34.913154	2031	2077	223	1	46	0.0217391
NODE_435_length_3622_cov_29.112120	201	281	2	49	80	0.6125000
NODE_435_length_3622_cov_29.112120	201	281	4	31	80	0.3875000
NODE_435_length_3622_cov_29.112120	254	334	2	50	80	0.6250000
NODE_435_length_3622_cov_29.112120	254	334	4	30	80	0.3750000
NODE_435_length_3622_cov_29.112120	2310	2390	136	1	80	0.0125000
NODE_435_length_3622_cov_29.112120	2310	2390	138	2	80	0.0250000
NODE_435_length_3622_cov_29.112120	2310	2390	140	5	80	0.0625000
NODE_435_length_3622_cov_29.112120	2310	2390	142	1	80	0.0125000
NODE_435_length_3622_cov_29.112120	2310	2390	147	1	80	0.0125000
NODE_435_length_3622_cov_29.112120	2310	2390	149	1	80	0.0125000
NODE_435_length_3622_cov_29.112120	2310	2390	152	1	80	0.0125000
NODE_435_length_3622_cov_29.112120	2310	2390	156	2	80	0.0250000
NODE_435_length_3622_cov_29.112120	2310	2390	160	1	80	0.0125000
NODE_435_length_3622_cov_29.112120	2310	2390	164	1	80	0.0125000
NODE_435_length_3622_cov_29.112120	2310	2390	166	1	80	0.0125000
NODE_435_length_3622_cov_29.112120	2310	2390	167	1	80	0.0125000
NODE_435_length_3622_cov_29.112120	2310	2390	171	1	80	0.0125000
NODE_435_length_3622_cov_29.112120	2310	2390	176	1	80	0.0125000
NODE_435_length_3622_cov_29.112120	2310	2390	177	2	80	0.0250000
NODE_435_length_3622_cov_29.112120	2310	2390	180	1	80	0.0125000
NODE_435_length_3622_cov_29.112120	2310	2390	183	1	80	0.0125000
NODE_435_length_3622_cov_29.112120	2310	2390	189	1	80	0.0125000
NODE_435_length_3622_cov_29.112120	2310	2390	190	1	80	0.0125000
NODE_435_length_3622_cov_29.112120	2310	2390	191	3	80	0.0375000
NODE_435_length_3622_cov_29.112120	2310	2390	196	1	80	0.0125000
NODE_435_length_3622_cov_29.112120	2310	2390	199	1	80	0.0125000
NODE_435_length_3622_cov_29.112120	2310	2390	200	2	80	0.0250000
NODE_435_length_3622_cov_29.112120	2310	2390	204	1	80	0.0125000
NODE_435_length_3622_cov_29.112120	2310	2390	207	1	80	0.0125000
NODE_435_length_3622_cov_29.112120	2310	2390	210	2	80	0.0250000
NODE_435_length_3622_cov_29.112120	2310	2390	213	2	80	0.0250000
NODE_435_length_3622_cov_29.112120	2310	2390	217	2	80	0.0250000
NODE_435_length_3622_cov_29.112120	2310	2390	218	2	80	0.0250000
NODE_435_length_3622_cov_29.112120	2310	2390	220	2	80	0.0250000
NODE_435_length_3622_cov_29.112120	2310	2390	221	1	80	0.0125000
NODE_435_length_3622_cov_29.112120	2310	2390	225	1	80	0.0125000
NODE_435_length_3622_cov_29.112120	2310	2390	226	1	80	0.0125000
NODE_435_length_3622_cov_29.112120	2310	2390	227	1	80	0.0125000
NODE_435_length_3622_cov_29.112120	2310	2390	228	1	80	0.0125000
NODE_435_length_3622_cov_29.112120	2310	2390	229	5	80	0.0625000
NODE_435_length_3622_cov_29.112120	2310	2390	231	1	80	0.0125000
NODE_435_length_3622_cov_29.112120	2310	2390	232	3	80	0.0375000
NODE_435_length_3622_cov_29.112120	2310	2390	234	1	80	0.0125000
NODE_435_length_3622_cov_29.112120	2310	2390	236	4	80	0.0500000
NODE_435_length_3622_cov_29.112120	2310	2390	237	4	80	0.0500000
NODE_435_length_3622_cov_29.112120	2310	2390	238	3	80	0.0375000
NODE_435_length_3622_cov_29.112120	2310	2390	239	2	80	0.0250000
NODE_435_length_3622_cov_29.112120	2310	2390	240	1	80	0.0125000
NODE_435_length_3622_cov_29.112120	2310	2390	242	3	80	0.0375000
NODE_435_length_3622_cov_29.112120	2310	2390	243	2	80	0.0250000
NODE_435_length_3622_cov_29.112120	2310	2390	244	1	80	0.0125000
NODE_435_length_3622_cov_29.112120	2363	2441	26	1	78	0.0128205
NODE_435_length_3622_cov_29.112120	2363	2441	27	1	78	0.0128205
NODE_435_length_3622_cov_29.112120	2363	2441	29	1	78	0.0128205
NODE_435_length_3622_cov_29.112120	2363	2441	32	1	78	0.0128205
NODE_435_length_3622_cov_29.112120	2363	2441	34	1	78	0.0128205
NODE_435_length_3622_cov_29.112120	2363	2441	36	1	78	0.0128205
NODE_435_length_3622_cov_29.112120	2363	2441	37	1	78	0.0128205
NODE_435_length_3622_cov_29.112120	2363	2441	39	2	78	0.0256410
NODE_435_length_3622_cov_29.112120	2363	2441	40	2	78	0.0256410
NODE_435_length_3622_cov_29.112120	2363	2441	42	1	78	0.0128205
NODE_435_length_3622_cov_29.112120	2363	2441	43	1	78	0.0128205
NODE_435_length_3622_cov_29.112120	2363	2441	46	1	78	0.0128205
NODE_435_length_3622_cov_29.112120	2363	2441	47	2	78	0.0256410
NODE_435_length_3622_cov_29.112120	2363	2441	51	2	78	0.0256410
NODE_435_length_3622_cov_29.112120	2363	2441	55	2	78	0.0256410
NODE_435_length_3622_cov_29.112120	2363	2441	57	2	78	0.0256410
NODE_435_length_3622_cov_29.112120	2363	2441	58	2	78	0.0256410
NODE_435_length_3622_cov_29.112120	2363	2441	63	1	78	0.0128205
NODE_435_length_3622_cov_29.112120	2363	2441	65	1	78	0.0128205
NODE_435_length_3622_cov_29.112120	2363	2441	73	1	78	0.0128205
NODE_435_length_3622_cov_29.112120	2363	2441	75	1	78	0.0128205
NODE_435_length_3622_cov_29.112120	2363	2441	77	2	78	0.0256410
NODE_435_length_3622_cov_29.112120	2363	2441	84	1	78	0.0128205
NODE_435_length_3622_cov_29.112120	2363	2441	85	1	78	0.0128205
NODE_435_length_3622_cov_29.112120	2363	2441	86	1	78	0.0128205
NODE_435_length_3622_cov_29.112120	2363	2441	90	2	78	0.0256410
NODE_435_length_3622_cov_29.112120	2363	2441	91	1	78	0.0128205
NODE_435_length_3622_cov_29.112120	2363	2441	93	1	78	0.0128205
NODE_435_length_3622_cov_29.112120	2363	2441	96	1	78	0.0128205
NODE_435_length_3622_cov_29.112120	2363	2441	97	1	78	0.0128205
NODE_435_length_3622_cov_29.112120	2363	2441	101	1	78	0.0128205
NODE_435_length_3622_cov_29.112120	2363	2441	104	2	78	0.0256410
NODE_435_length_3622_cov_29.112120	2363	2441	105	1	78	0.0128205
NODE_435_length_3622_cov_29.112120	2363	2441	108	1	78	0.0128205
NODE_435_length_3622_cov_29.112120	2363	2441	111	2	78	0.0256410
NODE_435_length_3622_cov_29.112120	2363	2441	118	1	78	0.0128205
NODE_435_length_3622_cov_29.112120	2363	2441	123	1	78	0.0128205
NODE_435_length_3622_cov_29.112120	2363	2441	131	2	78	0.0256410
NODE_435_length_3622_cov_29.112120	2363	2441	133	1	78	0.0128205
NODE_435_length_3622_cov_29.112120	2363	2441	136	1	78	0.0128205
NODE_435_length_3622_cov_29.112120	2363	2441	138	2	78	0.0256410
NODE_435_length_3622_cov_29.112120	2363	2441	140	5	78	0.0641026
NODE_435_length_3622_cov_29.112120	2363	2441	142	1	78	0.0128205
NODE_435_length_3622_cov_29.112120	2363	2441	147	1	78	0.0128205
NODE_435_length_3622_cov_29.112120	2363	2441	149	1	78	0.0128205
NODE_435_length_3622_cov_29.112120	2363	2441	152	1	78	0.0128205
NODE_435_length_3622_cov_29.112120	2363	2441	156	2	78	0.0256410
NODE_435_length_3622_cov_29.112120	2363	2441	160	1	78	0.0128205
NODE_435_length_3622_cov_29.112120	2363	2441	164	1	78	0.0128205
NODE_435_length_3622_cov_29.112120	2363	2441	166	1	78	0.0128205
NODE_435_length_3622_cov_29.112120	2363	2441	167	1	78	0.0128205
NODE_435_length_3622_cov_29.112120	2363	2441	171	1	78	0.0128205
NODE_435_length_3622_cov_29.112120	2363	2441	176	1	78	0.0128205
NODE_435_length_3622_cov_29.112120	2363	2441	177	2	78	0.0256410
NODE_435_length_3622_cov_29.112120	2363	2441	180	1	78	0.0128205
NODE_435_length_3622_cov_29.112120	2363	2441	183	1	78	0.0128205
NODE_435_length_3622_cov_29.112120	2363	2441	189	1	78	0.0128205
NODE_435_length_3622_cov_29.112120	2363	2441	190	1	78	0.0128205
NODE_435_length_3622_cov_29.112120	2363	2441	191	1	78	0.0128205
NODE_437_length_3610_cov_8.785816	294	340	1	45	46	0.9782609
NODE_437_length_3610_cov_8.785816	294	340	2	1	46	0.0217391
NODE_437_length_3610_cov_8.785816	313	393	1	66	80	0.8250000
NODE_437_length_3610_cov_8.785816	313	393	2	14	80	0.1750000
NODE_444_length_3588_cov_16.296360	2421	2501	11	2	80	0.0250000
NODE_444_length_3588_cov_16.296360	2421	2501	12	4	80	0.0500000
NODE_444_length_3588_cov_16.296360	2421	2501	13	3	80	0.0375000
NODE_444_length_3588_cov_16.296360	2421	2501	15	12	80	0.1500000
NODE_444_length_3588_cov_16.296360	2421	2501	16	2	80	0.0250000
NODE_444_length_3588_cov_16.296360	2421	2501	17	7	80	0.0875000
NODE_444_length_3588_cov_16.296360	2421	2501	18	10	80	0.1250000
NODE_444_length_3588_cov_16.296360	2421	2501	19	5	80	0.0625000
NODE_444_length_3588_cov_16.296360	2421	2501	20	35	80	0.4375000
NODE_444_length_3588_cov_16.296360	2474	2539	17	7	65	0.1076923
NODE_444_length_3588_cov_16.296360	2474	2539	18	5	65	0.0769231
NODE_444_length_3588_cov_16.296360	2474	2539	19	25	65	0.3846154
NODE_444_length_3588_cov_16.296360	2474	2539	20	28	65	0.4307692
NODE_447_length_3585_cov_2.283419	605	668	2	9	63	0.1428571
NODE_447_length_3585_cov_2.283419	605	668	3	46	63	0.7301587
NODE_447_length_3585_cov_2.283419	605	668	4	8	63	0.1269841
NODE_451_length_3567_cov_16.283160	410	429	1	6	19	0.3157895
NODE_451_length_3567_cov_16.283160	410	429	2	12	19	0.6315789
NODE_451_length_3567_cov_16.283160	410	429	4	1	19	0.0526316
NODE_451_length_3567_cov_16.283160	2259	2339	37	1	80	0.0125000
NODE_451_length_3567_cov_16.283160	2259	2339	38	1	80	0.0125000
NODE_451_length_3567_cov_16.283160	2259	2339	42	1	80	0.0125000
NODE_451_length_3567_cov_16.283160	2259	2339	43	1	80	0.0125000
NODE_451_length_3567_cov_16.283160	2259	2339	45	2	80	0.0250000
NODE_451_length_3567_cov_16.283160	2259	2339	47	2	80	0.0250000
NODE_451_length_3567_cov_16.283160	2259	2339	51	2	80	0.0250000
NODE_451_length_3567_cov_16.283160	2259	2339	53	1	80	0.0125000
NODE_451_length_3567_cov_16.283160	2259	2339	54	2	80	0.0250000
NODE_451_length_3567_cov_16.283160	2259	2339	56	2	80	0.0250000
NODE_451_length_3567_cov_16.283160	2259	2339	57	3	80	0.0375000
NODE_451_length_3567_cov_16.283160	2259	2339	58	7	80	0.0875000
NODE_451_length_3567_cov_16.283160	2259	2339	60	3	80	0.0375000
NODE_451_length_3567_cov_16.283160	2259	2339	61	1	80	0.0125000
NODE_451_length_3567_cov_16.283160	2259	2339	63	5	80	0.0625000
NODE_451_length_3567_cov_16.283160	2259	2339	65	1	80	0.0125000
NODE_451_length_3567_cov_16.283160	2259	2339	66	11	80	0.1375000
NODE_451_length_3567_cov_16.283160	2259	2339	68	3	80	0.0375000
NODE_451_length_3567_cov_16.283160	2259	2339	71	5	80	0.0625000
NODE_451_length_3567_cov_16.283160	2259	2339	72	1	80	0.0125000
NODE_451_length_3567_cov_16.283160	2259	2339	73	10	80	0.1250000
NODE_451_length_3567_cov_16.283160	2259	2339	74	1	80	0.0125000
NODE_451_length_3567_cov_16.283160	2259	2339	75	4	80	0.0500000
NODE_451_length_3567_cov_16.283160	2259	2339	76	3	80	0.0375000
NODE_451_length_3567_cov_16.283160	2259	2339	78	4	80	0.0500000
NODE_451_length_3567_cov_16.283160	2259	2339	79	2	80	0.0250000
NODE_451_length_3567_cov_16.283160	2259	2339	80	1	80	0.0125000
NODE_451_length_3567_cov_16.283160	2312	2379	0	2	67	0.0298507
NODE_451_length_3567_cov_16.283160	2312	2379	1	1	67	0.0149254
NODE_451_length_3567_cov_16.283160	2312	2379	3	2	67	0.0298507
NODE_451_length_3567_cov_16.283160	2312	2379	8	2	67	0.0298507
NODE_451_length_3567_cov_16.283160	2312	2379	13	5	67	0.0746269
NODE_451_length_3567_cov_16.283160	2312	2379	16	5	67	0.0746269
NODE_451_length_3567_cov_16.283160	2312	2379	18	1	67	0.0149254
NODE_451_length_3567_cov_16.283160	2312	2379	19	3	67	0.0447761
NODE_451_length_3567_cov_16.283160	2312	2379	22	2	67	0.0298507
NODE_451_length_3567_cov_16.283160	2312	2379	23	3	67	0.0447761
NODE_451_length_3567_cov_16.283160	2312	2379	24	1	67	0.0149254
NODE_451_length_3567_cov_16.283160	2312	2379	25	4	67	0.0597015
NODE_451_length_3567_cov_16.283160	2312	2379	27	2	67	0.0298507
NODE_451_length_3567_cov_16.283160	2312	2379	31	1	67	0.0149254
NODE_451_length_3567_cov_16.283160	2312	2379	32	2	67	0.0298507
NODE_451_length_3567_cov_16.283160	2312	2379	33	1	67	0.0149254
NODE_451_length_3567_cov_16.283160	2312	2379	35	1	67	0.0149254
NODE_451_length_3567_cov_16.283160	2312	2379	37	3	67	0.0447761
NODE_451_length_3567_cov_16.283160	2312	2379	38	1	67	0.0149254
NODE_451_length_3567_cov_16.283160	2312	2379	42	1	67	0.0149254
NODE_451_length_3567_cov_16.283160	2312	2379	43	1	67	0.0149254
NODE_451_length_3567_cov_16.283160	2312	2379	45	2	67	0.0298507
NODE_451_length_3567_cov_16.283160	2312	2379	47	2	67	0.0298507
NODE_451_length_3567_cov_16.283160	2312	2379	51	2	67	0.0298507
NODE_451_length_3567_cov_16.283160	2312	2379	53	1	67	0.0149254
NODE_451_length_3567_cov_16.283160	2312	2379	54	2	67	0.0298507
NODE_451_length_3567_cov_16.283160	2312	2379	56	2	67	0.0298507
NODE_451_length_3567_cov_16.283160	2312	2379	57	3	67	0.0447761
NODE_451_length_3567_cov_16.283160	2312	2379	58	7	67	0.1044776
NODE_451_length_3567_cov_16.283160	2312	2379	60	2	67	0.0298507
NODE_454_length_3557_cov_12.423077	640	718	0	78	78	1.0000000
NODE_454_length_3557_cov_12.423077	640	688	0	48	48	1.0000000
NODE_454_length_3557_cov_12.423077	640	688	0	48	48	1.0000000
NODE_454_length_3557_cov_12.423077	640	688	0	48	48	1.0000000
NODE_454_length_3557_cov_12.423077	640	688	0	48	48	1.0000000
NODE_454_length_3557_cov_12.423077	693	771	0	78	78	1.0000000
NODE_455_length_3548_cov_7.216295	554	634	2	27	80	0.3375000
NODE_455_length_3548_cov_7.216295	554	634	3	4	80	0.0500000
NODE_455_length_3548_cov_7.216295	554	634	4	4	80	0.0500000
NODE_455_length_3548_cov_7.216295	554	634	6	20	80	0.2500000
NODE_455_length_3548_cov_7.216295	554	634	7	25	80	0.3125000
NODE_455_length_3548_cov_7.216295	607	687	3	29	80	0.3625000
NODE_455_length_3548_cov_7.216295	607	687	4	20	80	0.2500000
NODE_455_length_3548_cov_7.216295	607	687	6	6	80	0.0750000
NODE_455_length_3548_cov_7.216295	607	687	7	25	80	0.3125000
NODE_461_length_3518_cov_40.508336	1320	1400	22	3	80	0.0375000
NODE_461_length_3518_cov_40.508336	1320	1400	23	18	80	0.2250000
NODE_461_length_3518_cov_40.508336	1320	1400	24	27	80	0.3375000
NODE_461_length_3518_cov_40.508336	1320	1400	25	32	80	0.4000000
NODE_461_length_3518_cov_40.508336	1373	1453	12	1	80	0.0125000
NODE_461_length_3518_cov_40.508336	1373	1453	13	3	80	0.0375000
NODE_461_length_3518_cov_40.508336	1373	1453	14	3	80	0.0375000
NODE_461_length_3518_cov_40.508336	1373	1453	16	3	80	0.0375000
NODE_461_length_3518_cov_40.508336	1373	1453	17	2	80	0.0250000
NODE_461_length_3518_cov_40.508336	1373	1453	18	2	80	0.0250000
NODE_461_length_3518_cov_40.508336	1373	1453	20	27	80	0.3375000
NODE_461_length_3518_cov_40.508336	1373	1453	21	1	80	0.0125000
NODE_461_length_3518_cov_40.508336	1373	1453	23	21	80	0.2625000
NODE_461_length_3518_cov_40.508336	1373	1453	24	3	80	0.0375000
NODE_461_length_3518_cov_40.508336	1373	1453	25	14	80	0.1750000
NODE_465_length_3497_cov_65.791348	3062	3142	190	2	80	0.0250000
NODE_465_length_3497_cov_65.791348	3062	3142	193	1	80	0.0125000
NODE_465_length_3497_cov_65.791348	3062	3142	194	1	80	0.0125000
NODE_465_length_3497_cov_65.791348	3062	3142	197	1	80	0.0125000
NODE_465_length_3497_cov_65.791348	3062	3142	198	1	80	0.0125000
NODE_465_length_3497_cov_65.791348	3062	3142	202	2	80	0.0250000
NODE_465_length_3497_cov_65.791348	3062	3142	203	1	80	0.0125000
NODE_465_length_3497_cov_65.791348	3062	3142	206	1	80	0.0125000
NODE_465_length_3497_cov_65.791348	3062	3142	207	2	80	0.0250000
NODE_465_length_3497_cov_65.791348	3062	3142	208	1	80	0.0125000
NODE_465_length_3497_cov_65.791348	3062	3142	210	3	80	0.0375000
NODE_465_length_3497_cov_65.791348	3062	3142	211	3	80	0.0375000
NODE_465_length_3497_cov_65.791348	3062	3142	212	6	80	0.0750000
NODE_465_length_3497_cov_65.791348	3062	3142	213	9	80	0.1125000
NODE_465_length_3497_cov_65.791348	3062	3142	214	7	80	0.0875000
NODE_465_length_3497_cov_65.791348	3062	3142	215	5	80	0.0625000
NODE_465_length_3497_cov_65.791348	3062	3142	216	10	80	0.1250000
NODE_465_length_3497_cov_65.791348	3062	3142	217	8	80	0.1000000
NODE_465_length_3497_cov_65.791348	3062	3142	218	6	80	0.0750000
NODE_465_length_3497_cov_65.791348	3062	3142	219	2	80	0.0250000
NODE_465_length_3497_cov_65.791348	3062	3142	220	3	80	0.0375000
NODE_465_length_3497_cov_65.791348	3062	3142	222	2	80	0.0250000
NODE_465_length_3497_cov_65.791348	3062	3142	223	2	80	0.0250000
NODE_465_length_3497_cov_65.791348	3062	3142	224	1	80	0.0125000
NODE_466_length_3488_cov_2.243730	506	529	1	2	23	0.0869565
NODE_466_length_3488_cov_2.243730	506	529	2	15	23	0.6521739
NODE_466_length_3488_cov_2.243730	506	529	3	6	23	0.2608696
NODE_470_length_3483_cov_14.759456	360	440	2	15	80	0.1875000
NODE_470_length_3483_cov_14.759456	360	440	4	47	80	0.5875000
NODE_470_length_3483_cov_14.759456	360	440	5	18	80	0.2250000
NODE_470_length_3483_cov_14.759456	413	493	3	6	80	0.0750000
NODE_470_length_3483_cov_14.759456	413	493	4	25	80	0.3125000
NODE_470_length_3483_cov_14.759456	413	493	5	49	80	0.6125000
NODE_474_length_3471_cov_37.887604	2795	2875	1	9	80	0.1125000
NODE_474_length_3471_cov_37.887604	2795	2875	2	71	80	0.8875000
NODE_474_length_3471_cov_37.887604	2848	2928	2	34	80	0.4250000
NODE_474_length_3471_cov_37.887604	2848	2928	4	6	80	0.0750000
NODE_474_length_3471_cov_37.887604	2848	2928	5	40	80	0.5000000
NODE_474_length_3471_cov_37.887604	2924	2943	5	16	19	0.8421053
NODE_474_length_3471_cov_37.887604	2924	2943	6	3	19	0.1578947
NODE_474_length_3471_cov_37.887604	2924	3004	5	16	80	0.2000000
NODE_474_length_3471_cov_37.887604	2924	3004	6	5	80	0.0625000
NODE_474_length_3471_cov_37.887604	2924	3004	7	59	80	0.7375000
NODE_474_length_3471_cov_37.887604	2977	3057	4	19	80	0.2375000
NODE_474_length_3471_cov_37.887604	2977	3057	5	32	80	0.4000000
NODE_474_length_3471_cov_37.887604	2977	3057	7	29	80	0.3625000
NODE_479_length_3451_cov_29.833234	2973	3053	1	21	80	0.2625000
NODE_479_length_3451_cov_29.833234	2973	3053	2	23	80	0.2875000
NODE_479_length_3451_cov_29.833234	2973	3053	4	15	80	0.1875000
NODE_479_length_3451_cov_29.833234	2973	3053	5	17	80	0.2125000
NODE_479_length_3451_cov_29.833234	2973	3053	6	4	80	0.0500000
NODE_479_length_3451_cov_29.833234	3026	3106	1	4	80	0.0500000
NODE_479_length_3451_cov_29.833234	3026	3106	2	25	80	0.3125000
NODE_479_length_3451_cov_29.833234	3026	3106	3	3	80	0.0375000
NODE_479_length_3451_cov_29.833234	3026	3106	4	2	80	0.0250000
NODE_479_length_3451_cov_29.833234	3026	3106	5	46	80	0.5750000
NODE_481_length_3446_cov_32.421273	3181	3261	20	26	80	0.3250000
NODE_481_length_3446_cov_32.421273	3181	3261	22	29	80	0.3625000
NODE_481_length_3446_cov_32.421273	3181	3261	23	10	80	0.1250000
NODE_481_length_3446_cov_32.421273	3181	3261	24	4	80	0.0500000
NODE_481_length_3446_cov_32.421273	3181	3261	25	1	80	0.0125000
NODE_481_length_3446_cov_32.421273	3181	3261	26	4	80	0.0500000
NODE_481_length_3446_cov_32.421273	3181	3261	27	6	80	0.0750000
NODE_482_length_3444_cov_29.954858	792	872	12	13	80	0.1625000
NODE_482_length_3444_cov_29.954858	792	872	13	11	80	0.1375000
NODE_482_length_3444_cov_29.954858	792	872	14	1	80	0.0125000
NODE_482_length_3444_cov_29.954858	792	872	15	3	80	0.0375000
NODE_482_length_3444_cov_29.954858	792	872	16	17	80	0.2125000
NODE_482_length_3444_cov_29.954858	792	872	18	17	80	0.2125000
NODE_482_length_3444_cov_29.954858	792	872	20	18	80	0.2250000
NODE_482_length_3444_cov_29.954858	845	925	12	10	80	0.1250000
NODE_482_length_3444_cov_29.954858	845	925	13	1	80	0.0125000
NODE_482_length_3444_cov_29.954858	845	925	14	2	80	0.0250000
NODE_482_length_3444_cov_29.954858	845	925	17	28	80	0.3500000
NODE_482_length_3444_cov_29.954858	845	925	18	9	80	0.1125000
NODE_482_length_3444_cov_29.954858	845	925	19	11	80	0.1375000
NODE_482_length_3444_cov_29.954858	845	925	20	19	80	0.2375000
NODE_483_length_3442_cov_17.799880	3155	3220	6	1	65	0.0153846
NODE_483_length_3442_cov_17.799880	3155	3220	17	1	65	0.0153846
NODE_483_length_3442_cov_17.799880	3155	3220	19	3	65	0.0461538
NODE_483_length_3442_cov_17.799880	3155	3220	20	1	65	0.0153846
NODE_483_length_3442_cov_17.799880	3155	3220	22	7	65	0.1076923
NODE_483_length_3442_cov_17.799880	3155	3220	24	1	65	0.0153846
NODE_483_length_3442_cov_17.799880	3155	3220	28	4	65	0.0615385
NODE_483_length_3442_cov_17.799880	3155	3220	31	1	65	0.0153846
NODE_483_length_3442_cov_17.799880	3155	3220	32	1	65	0.0153846
NODE_483_length_3442_cov_17.799880	3155	3220	33	3	65	0.0461538
NODE_483_length_3442_cov_17.799880	3155	3220	35	1	65	0.0153846
NODE_483_length_3442_cov_17.799880	3155	3220	38	5	65	0.0769231
NODE_483_length_3442_cov_17.799880	3155	3220	39	1	65	0.0153846
NODE_483_length_3442_cov_17.799880	3155	3220	44	1	65	0.0153846
NODE_483_length_3442_cov_17.799880	3155	3220	47	1	65	0.0153846
NODE_483_length_3442_cov_17.799880	3155	3220	50	1	65	0.0153846
NODE_483_length_3442_cov_17.799880	3155	3220	52	2	65	0.0307692
NODE_483_length_3442_cov_17.799880	3155	3220	57	2	65	0.0307692
NODE_483_length_3442_cov_17.799880	3155	3220	58	2	65	0.0307692
NODE_483_length_3442_cov_17.799880	3155	3220	59	1	65	0.0153846
NODE_483_length_3442_cov_17.799880	3155	3220	60	1	65	0.0153846
NODE_483_length_3442_cov_17.799880	3155	3220	61	1	65	0.0153846
NODE_483_length_3442_cov_17.799880	3155	3220	62	2	65	0.0307692
NODE_483_length_3442_cov_17.799880	3155	3220	63	1	65	0.0153846
NODE_483_length_3442_cov_17.799880	3155	3220	64	2	65	0.0307692
NODE_483_length_3442_cov_17.799880	3155	3220	65	2	65	0.0307692
NODE_483_length_3442_cov_17.799880	3155	3220	69	2	65	0.0307692
NODE_483_length_3442_cov_17.799880	3155	3220	71	1	65	0.0153846
NODE_483_length_3442_cov_17.799880	3155	3220	72	2	65	0.0307692
NODE_483_length_3442_cov_17.799880	3155	3220	73	1	65	0.0153846
NODE_483_length_3442_cov_17.799880	3155	3220	74	1	65	0.0153846
NODE_483_length_3442_cov_17.799880	3155	3220	76	2	65	0.0307692
NODE_483_length_3442_cov_17.799880	3155	3220	80	1	65	0.0153846
NODE_483_length_3442_cov_17.799880	3155	3220	82	1	65	0.0153846
NODE_483_length_3442_cov_17.799880	3155	3220	84	1	65	0.0153846
NODE_483_length_3442_cov_17.799880	3155	3220	86	1	65	0.0153846
NODE_483_length_3442_cov_17.799880	3155	3220	91	1	65	0.0153846
NODE_483_length_3442_cov_17.799880	3155	3220	92	1	65	0.0153846
NODE_483_length_3442_cov_17.799880	3155	3220	93	1	65	0.0153846
NODE_483_length_3442_cov_17.799880	3208	3273	72	1	65	0.0153846
NODE_483_length_3442_cov_17.799880	3208	3273	73	1	65	0.0153846
NODE_483_length_3442_cov_17.799880	3208	3273	74	1	65	0.0153846
NODE_483_length_3442_cov_17.799880	3208	3273	76	2	65	0.0307692
NODE_483_length_3442_cov_17.799880	3208	3273	80	1	65	0.0153846
NODE_483_length_3442_cov_17.799880	3208	3273	82	1	65	0.0153846
NODE_483_length_3442_cov_17.799880	3208	3273	84	1	65	0.0153846
NODE_483_length_3442_cov_17.799880	3208	3273	86	1	65	0.0153846
NODE_483_length_3442_cov_17.799880	3208	3273	91	1	65	0.0153846
NODE_483_length_3442_cov_17.799880	3208	3273	92	1	65	0.0153846
NODE_483_length_3442_cov_17.799880	3208	3273	93	1	65	0.0153846
NODE_483_length_3442_cov_17.799880	3208	3273	97	2	65	0.0307692
NODE_483_length_3442_cov_17.799880	3208	3273	98	2	65	0.0307692
NODE_483_length_3442_cov_17.799880	3208	3273	99	1	65	0.0153846
NODE_483_length_3442_cov_17.799880	3208	3273	100	2	65	0.0307692
NODE_483_length_3442_cov_17.799880	3208	3273	101	1	65	0.0153846
NODE_483_length_3442_cov_17.799880	3208	3273	102	1	65	0.0153846
NODE_483_length_3442_cov_17.799880	3208	3273	103	1	65	0.0153846
NODE_483_length_3442_cov_17.799880	3208	3273	106	1	65	0.0153846
NODE_483_length_3442_cov_17.799880	3208	3273	107	1	65	0.0153846
NODE_483_length_3442_cov_17.799880	3208	3273	109	1	65	0.0153846
NODE_483_length_3442_cov_17.799880	3208	3273	110	1	65	0.0153846
NODE_483_length_3442_cov_17.799880	3208	3273	112	1	65	0.0153846
NODE_483_length_3442_cov_17.799880	3208	3273	113	2	65	0.0307692
NODE_483_length_3442_cov_17.799880	3208	3273	114	1	65	0.0153846
NODE_483_length_3442_cov_17.799880	3208	3273	116	3	65	0.0461538
NODE_483_length_3442_cov_17.799880	3208	3273	120	2	65	0.0307692
NODE_483_length_3442_cov_17.799880	3208	3273	121	1	65	0.0153846
NODE_483_length_3442_cov_17.799880	3208	3273	122	1	65	0.0153846
NODE_483_length_3442_cov_17.799880	3208	3273	124	3	65	0.0461538
NODE_483_length_3442_cov_17.799880	3208	3273	129	1	65	0.0153846
NODE_483_length_3442_cov_17.799880	3208	3273	130	1	65	0.0153846
NODE_483_length_3442_cov_17.799880	3208	3273	134	1	65	0.0153846
NODE_483_length_3442_cov_17.799880	3208	3273	135	1	65	0.0153846
NODE_483_length_3442_cov_17.799880	3208	3273	138	1	65	0.0153846
NODE_483_length_3442_cov_17.799880	3208	3273	140	3	65	0.0461538
NODE_483_length_3442_cov_17.799880	3208	3273	141	6	65	0.0923077
NODE_483_length_3442_cov_17.799880	3208	3273	142	1	65	0.0153846
NODE_483_length_3442_cov_17.799880	3208	3273	143	2	65	0.0307692
NODE_483_length_3442_cov_17.799880	3208	3273	147	1	65	0.0153846
NODE_483_length_3442_cov_17.799880	3208	3273	152	4	65	0.0615385
NODE_483_length_3442_cov_17.799880	3208	3273	154	2	65	0.0307692
NODE_483_length_3442_cov_17.799880	3208	3273	155	1	65	0.0153846
NODE_486_length_3429_cov_5.070270	125	148	33	3	23	0.1304348
NODE_486_length_3429_cov_5.070270	125	148	34	1	23	0.0434783
NODE_486_length_3429_cov_5.070270	125	148	36	1	23	0.0434783
NODE_486_length_3429_cov_5.070270	125	148	38	12	23	0.5217391
NODE_486_length_3429_cov_5.070270	125	148	40	1	23	0.0434783
NODE_486_length_3429_cov_5.070270	125	148	41	2	23	0.0869565
NODE_486_length_3429_cov_5.070270	125	148	42	3	23	0.1304348
NODE_493_length_3408_cov_2.406769	0	45	0	45	45	1.0000000
NODE_495_length_3405_cov_44.930127	2683	2759	10	4	76	0.0526316
NODE_495_length_3405_cov_44.930127	2683	2759	11	2	76	0.0263158
NODE_495_length_3405_cov_44.930127	2683	2759	12	19	76	0.2500000
NODE_495_length_3405_cov_44.930127	2683	2759	13	44	76	0.5789474
NODE_495_length_3405_cov_44.930127	2683	2759	14	7	76	0.0921053
NODE_495_length_3405_cov_44.930127	3116	3164	3	42	48	0.8750000
NODE_495_length_3405_cov_44.930127	3116	3164	4	6	48	0.1250000
NODE_496_length_3402_cov_28.961550	128	183	4	55	55	1.0000000
NODE_496_length_3402_cov_28.961550	3154	3234	80	1	80	0.0125000
NODE_496_length_3402_cov_28.961550	3154	3234	81	1	80	0.0125000
NODE_496_length_3402_cov_28.961550	3154	3234	85	3	80	0.0375000
NODE_496_length_3402_cov_28.961550	3154	3234	88	1	80	0.0125000
NODE_496_length_3402_cov_28.961550	3154	3234	89	1	80	0.0125000
NODE_496_length_3402_cov_28.961550	3154	3234	91	4	80	0.0500000
NODE_496_length_3402_cov_28.961550	3154	3234	92	1	80	0.0125000
NODE_496_length_3402_cov_28.961550	3154	3234	93	2	80	0.0250000
NODE_496_length_3402_cov_28.961550	3154	3234	94	3	80	0.0375000
NODE_496_length_3402_cov_28.961550	3154	3234	95	2	80	0.0250000
NODE_496_length_3402_cov_28.961550	3154	3234	97	1	80	0.0125000
NODE_496_length_3402_cov_28.961550	3154	3234	100	1	80	0.0125000
NODE_496_length_3402_cov_28.961550	3154	3234	101	3	80	0.0375000
NODE_496_length_3402_cov_28.961550	3154	3234	102	5	80	0.0625000
NODE_496_length_3402_cov_28.961550	3154	3234	103	2	80	0.0250000
NODE_496_length_3402_cov_28.961550	3154	3234	104	8	80	0.1000000
NODE_496_length_3402_cov_28.961550	3154	3234	105	18	80	0.2250000
NODE_496_length_3402_cov_28.961550	3154	3234	106	7	80	0.0875000
NODE_496_length_3402_cov_28.961550	3154	3234	107	3	80	0.0375000
NODE_496_length_3402_cov_28.961550	3154	3234	108	4	80	0.0500000
NODE_496_length_3402_cov_28.961550	3154	3234	109	9	80	0.1125000
NODE_496_length_3402_cov_28.961550	3207	3287	6	1	80	0.0125000
NODE_496_length_3402_cov_28.961550	3207	3287	9	1	80	0.0125000
NODE_496_length_3402_cov_28.961550	3207	3287	25	1	80	0.0125000
NODE_496_length_3402_cov_28.961550	3207	3287	28	2	80	0.0250000
NODE_496_length_3402_cov_28.961550	3207	3287	29	1	80	0.0125000
NODE_496_length_3402_cov_28.961550	3207	3287	31	1	80	0.0125000
NODE_496_length_3402_cov_28.961550	3207	3287	33	5	80	0.0625000
NODE_496_length_3402_cov_28.961550	3207	3287	34	1	80	0.0125000
NODE_496_length_3402_cov_28.961550	3207	3287	38	1	80	0.0125000
NODE_496_length_3402_cov_28.961550	3207	3287	41	1	80	0.0125000
NODE_496_length_3402_cov_28.961550	3207	3287	45	3	80	0.0375000
NODE_496_length_3402_cov_28.961550	3207	3287	50	5	80	0.0625000
NODE_496_length_3402_cov_28.961550	3207	3287	52	2	80	0.0250000
NODE_496_length_3402_cov_28.961550	3207	3287	53	2	80	0.0250000
NODE_496_length_3402_cov_28.961550	3207	3287	54	4	80	0.0500000
NODE_496_length_3402_cov_28.961550	3207	3287	56	1	80	0.0125000
NODE_496_length_3402_cov_28.961550	3207	3287	57	1	80	0.0125000
NODE_496_length_3402_cov_28.961550	3207	3287	59	1	80	0.0125000
NODE_496_length_3402_cov_28.961550	3207	3287	60	1	80	0.0125000
NODE_496_length_3402_cov_28.961550	3207	3287	61	1	80	0.0125000
NODE_496_length_3402_cov_28.961550	3207	3287	62	2	80	0.0250000
NODE_496_length_3402_cov_28.961550	3207	3287	63	1	80	0.0125000
NODE_496_length_3402_cov_28.961550	3207	3287	65	3	80	0.0375000
NODE_496_length_3402_cov_28.961550	3207	3287	66	4	80	0.0500000
NODE_496_length_3402_cov_28.961550	3207	3287	68	1	80	0.0125000
NODE_496_length_3402_cov_28.961550	3207	3287	69	1	80	0.0125000
NODE_496_length_3402_cov_28.961550	3207	3287	70	1	80	0.0125000
NODE_496_length_3402_cov_28.961550	3207	3287	74	2	80	0.0250000
NODE_496_length_3402_cov_28.961550	3207	3287	75	1	80	0.0125000
NODE_496_length_3402_cov_28.961550	3207	3287	77	1	80	0.0125000
NODE_496_length_3402_cov_28.961550	3207	3287	80	1	80	0.0125000
NODE_496_length_3402_cov_28.961550	3207	3287	81	1	80	0.0125000
NODE_496_length_3402_cov_28.961550	3207	3287	85	3	80	0.0375000
NODE_496_length_3402_cov_28.961550	3207	3287	88	1	80	0.0125000
NODE_496_length_3402_cov_28.961550	3207	3287	89	1	80	0.0125000
NODE_496_length_3402_cov_28.961550	3207	3287	91	4	80	0.0500000
NODE_496_length_3402_cov_28.961550	3207	3287	92	1	80	0.0125000
NODE_496_length_3402_cov_28.961550	3207	3287	93	2	80	0.0250000
NODE_496_length_3402_cov_28.961550	3207	3287	94	3	80	0.0375000
NODE_496_length_3402_cov_28.961550	3207	3287	95	2	80	0.0250000
NODE_496_length_3402_cov_28.961550	3207	3287	97	1	80	0.0125000
NODE_496_length_3402_cov_28.961550	3207	3287	100	1	80	0.0125000
NODE_496_length_3402_cov_28.961550	3207	3287	101	3	80	0.0375000
NODE_496_length_3402_cov_28.961550	3207	3287	102	1	80	0.0125000
NODE_496_length_3402_cov_28.961550	3207	3287	104	2	80	0.0250000
NODE_498_length_3393_cov_43.623558	1009	1075	28	1	66	0.0151515
NODE_498_length_3393_cov_43.623558	1009	1075	30	2	66	0.0303030
NODE_498_length_3393_cov_43.623558	1009	1075	31	4	66	0.0606061
NODE_498_length_3393_cov_43.623558	1009	1075	34	5	66	0.0757576
NODE_498_length_3393_cov_43.623558	1009	1075	36	1	66	0.0151515
NODE_498_length_3393_cov_43.623558	1009	1075	37	3	66	0.0454545
NODE_498_length_3393_cov_43.623558	1009	1075	38	1	66	0.0151515
NODE_498_length_3393_cov_43.623558	1009	1075	39	1	66	0.0151515
NODE_498_length_3393_cov_43.623558	1009	1075	40	1	66	0.0151515
NODE_498_length_3393_cov_43.623558	1009	1075	41	4	66	0.0606061
NODE_498_length_3393_cov_43.623558	1009	1075	42	2	66	0.0303030
NODE_498_length_3393_cov_43.623558	1009	1075	44	2	66	0.0303030
NODE_498_length_3393_cov_43.623558	1009	1075	46	4	66	0.0606061
NODE_498_length_3393_cov_43.623558	1009	1075	47	1	66	0.0151515
NODE_498_length_3393_cov_43.623558	1009	1075	48	1	66	0.0151515
NODE_498_length_3393_cov_43.623558	1009	1075	50	3	66	0.0454545
NODE_498_length_3393_cov_43.623558	1009	1075	51	5	66	0.0757576
NODE_498_length_3393_cov_43.623558	1009	1075	53	2	66	0.0303030
NODE_498_length_3393_cov_43.623558	1009	1075	55	2	66	0.0303030
NODE_498_length_3393_cov_43.623558	1009	1075	57	2	66	0.0303030
NODE_498_length_3393_cov_43.623558	1009	1075	61	4	66	0.0606061
NODE_498_length_3393_cov_43.623558	1009	1075	62	1	66	0.0151515
NODE_498_length_3393_cov_43.623558	1009	1075	64	1	66	0.0151515
NODE_498_length_3393_cov_43.623558	1009	1075	65	4	66	0.0606061
NODE_498_length_3393_cov_43.623558	1009	1075	66	3	66	0.0454545
NODE_498_length_3393_cov_43.623558	1009	1075	68	5	66	0.0757576
NODE_498_length_3393_cov_43.623558	1009	1075	71	1	66	0.0151515
NODE_498_length_3393_cov_43.623558	1048	1128	20	8	80	0.1000000
NODE_498_length_3393_cov_43.623558	1048	1128	21	2	80	0.0250000
NODE_498_length_3393_cov_43.623558	1048	1128	23	10	80	0.1250000
NODE_498_length_3393_cov_43.623558	1048	1128	24	6	80	0.0750000
NODE_498_length_3393_cov_43.623558	1048	1128	25	21	80	0.2625000
NODE_498_length_3393_cov_43.623558	1048	1128	27	5	80	0.0625000
NODE_498_length_3393_cov_43.623558	1048	1128	28	2	80	0.0250000
NODE_498_length_3393_cov_43.623558	1048	1128	30	2	80	0.0250000
NODE_498_length_3393_cov_43.623558	1048	1128	31	4	80	0.0500000
NODE_498_length_3393_cov_43.623558	1048	1128	34	5	80	0.0625000
NODE_498_length_3393_cov_43.623558	1048	1128	36	1	80	0.0125000
NODE_498_length_3393_cov_43.623558	1048	1128	37	3	80	0.0375000
NODE_498_length_3393_cov_43.623558	1048	1128	38	1	80	0.0125000
NODE_498_length_3393_cov_43.623558	1048	1128	39	1	80	0.0125000
NODE_498_length_3393_cov_43.623558	1048	1128	40	1	80	0.0125000
NODE_498_length_3393_cov_43.623558	1048	1128	41	4	80	0.0500000
NODE_498_length_3393_cov_43.623558	1048	1128	42	2	80	0.0250000
NODE_498_length_3393_cov_43.623558	1048	1128	44	2	80	0.0250000
NODE_498_length_3393_cov_43.623558	3086	3128	38	1	42	0.0238095
NODE_498_length_3393_cov_43.623558	3086	3128	54	1	42	0.0238095
NODE_498_length_3393_cov_43.623558	3086	3128	60	1	42	0.0238095
NODE_498_length_3393_cov_43.623558	3086	3128	86	1	42	0.0238095
NODE_498_length_3393_cov_43.623558	3086	3128	92	1	42	0.0238095
NODE_498_length_3393_cov_43.623558	3086	3128	100	1	42	0.0238095
NODE_498_length_3393_cov_43.623558	3086	3128	101	1	42	0.0238095
NODE_498_length_3393_cov_43.623558	3086	3128	106	1	42	0.0238095
NODE_498_length_3393_cov_43.623558	3086	3128	112	1	42	0.0238095
NODE_498_length_3393_cov_43.623558	3086	3128	118	1	42	0.0238095
NODE_498_length_3393_cov_43.623558	3086	3128	120	1	42	0.0238095
NODE_498_length_3393_cov_43.623558	3086	3128	121	1	42	0.0238095
NODE_498_length_3393_cov_43.623558	3086	3128	123	1	42	0.0238095
NODE_498_length_3393_cov_43.623558	3086	3128	126	1	42	0.0238095
NODE_498_length_3393_cov_43.623558	3086	3128	127	1	42	0.0238095
NODE_498_length_3393_cov_43.623558	3086	3128	132	2	42	0.0476190
NODE_498_length_3393_cov_43.623558	3086	3128	133	1	42	0.0238095
NODE_498_length_3393_cov_43.623558	3086	3128	134	1	42	0.0238095
NODE_498_length_3393_cov_43.623558	3086	3128	135	1	42	0.0238095
NODE_498_length_3393_cov_43.623558	3086	3128	148	1	42	0.0238095
NODE_498_length_3393_cov_43.623558	3086	3128	149	1	42	0.0238095
NODE_498_length_3393_cov_43.623558	3086	3128	152	1	42	0.0238095
NODE_498_length_3393_cov_43.623558	3086	3128	153	1	42	0.0238095
NODE_498_length_3393_cov_43.623558	3086	3128	155	1	42	0.0238095
NODE_498_length_3393_cov_43.623558	3086	3128	160	1	42	0.0238095
NODE_498_length_3393_cov_43.623558	3086	3128	162	1	42	0.0238095
NODE_498_length_3393_cov_43.623558	3086	3128	169	1	42	0.0238095
NODE_498_length_3393_cov_43.623558	3086	3128	173	2	42	0.0476190
NODE_498_length_3393_cov_43.623558	3086	3128	177	1	42	0.0238095
NODE_498_length_3393_cov_43.623558	3086	3128	184	1	42	0.0238095
NODE_498_length_3393_cov_43.623558	3086	3128	186	1	42	0.0238095
NODE_498_length_3393_cov_43.623558	3086	3128	192	2	42	0.0476190
NODE_498_length_3393_cov_43.623558	3086	3128	198	1	42	0.0238095
NODE_498_length_3393_cov_43.623558	3086	3128	199	1	42	0.0238095
NODE_498_length_3393_cov_43.623558	3086	3128	202	1	42	0.0238095
NODE_498_length_3393_cov_43.623558	3086	3128	204	2	42	0.0476190
NODE_498_length_3393_cov_43.623558	3086	3128	211	1	42	0.0238095
NODE_498_length_3393_cov_43.623558	3086	3128	215	1	42	0.0238095
NODE_498_length_3393_cov_43.623558	3293	3373	151	1	80	0.0125000
NODE_498_length_3393_cov_43.623558	3293	3373	158	1	80	0.0125000
NODE_498_length_3393_cov_43.623558	3293	3373	163	1	80	0.0125000
NODE_498_length_3393_cov_43.623558	3293	3373	172	1	80	0.0125000
NODE_498_length_3393_cov_43.623558	3293	3373	180	1	80	0.0125000
NODE_498_length_3393_cov_43.623558	3293	3373	193	1	80	0.0125000
NODE_498_length_3393_cov_43.623558	3293	3373	199	1	80	0.0125000
NODE_498_length_3393_cov_43.623558	3293	3373	203	1	80	0.0125000
NODE_498_length_3393_cov_43.623558	3293	3373	204	1	80	0.0125000
NODE_498_length_3393_cov_43.623558	3293	3373	205	1	80	0.0125000
NODE_498_length_3393_cov_43.623558	3293	3373	213	1	80	0.0125000
NODE_498_length_3393_cov_43.623558	3293	3373	220	1	80	0.0125000
NODE_498_length_3393_cov_43.623558	3293	3373	222	1	80	0.0125000
NODE_498_length_3393_cov_43.623558	3293	3373	224	1	80	0.0125000
NODE_498_length_3393_cov_43.623558	3293	3373	227	1	80	0.0125000
NODE_498_length_3393_cov_43.623558	3293	3373	228	1	80	0.0125000
NODE_498_length_3393_cov_43.623558	3293	3373	237	1	80	0.0125000
NODE_498_length_3393_cov_43.623558	3293	3373	241	1	80	0.0125000
NODE_498_length_3393_cov_43.623558	3293	3373	251	1	80	0.0125000
NODE_498_length_3393_cov_43.623558	3293	3373	253	1	80	0.0125000
NODE_498_length_3393_cov_43.623558	3293	3373	266	1	80	0.0125000
NODE_498_length_3393_cov_43.623558	3293	3373	271	1	80	0.0125000
NODE_498_length_3393_cov_43.623558	3293	3373	277	1	80	0.0125000
NODE_498_length_3393_cov_43.623558	3293	3373	286	1	80	0.0125000
NODE_498_length_3393_cov_43.623558	3293	3373	291	1	80	0.0125000
NODE_498_length_3393_cov_43.623558	3293	3373	301	1	80	0.0125000
NODE_498_length_3393_cov_43.623558	3293	3373	302	1	80	0.0125000
NODE_498_length_3393_cov_43.623558	3293	3373	309	2	80	0.0250000
NODE_498_length_3393_cov_43.623558	3293	3373	314	1	80	0.0125000
NODE_498_length_3393_cov_43.623558	3293	3373	315	1	80	0.0125000
NODE_498_length_3393_cov_43.623558	3293	3373	317	1	80	0.0125000
NODE_498_length_3393_cov_43.623558	3293	3373	320	1	80	0.0125000
NODE_498_length_3393_cov_43.623558	3293	3373	325	1	80	0.0125000
NODE_498_length_3393_cov_43.623558	3293	3373	332	1	80	0.0125000
NODE_498_length_3393_cov_43.623558	3293	3373	336	1	80	0.0125000
NODE_498_length_3393_cov_43.623558	3293	3373	346	1	80	0.0125000
NODE_498_length_3393_cov_43.623558	3293	3373	353	1	80	0.0125000
NODE_498_length_3393_cov_43.623558	3293	3373	358	1	80	0.0125000
NODE_498_length_3393_cov_43.623558	3293	3373	361	1	80	0.0125000
NODE_498_length_3393_cov_43.623558	3293	3373	363	1	80	0.0125000
NODE_498_length_3393_cov_43.623558	3293	3373	368	1	80	0.0125000
NODE_498_length_3393_cov_43.623558	3293	3373	378	1	80	0.0125000
NODE_498_length_3393_cov_43.623558	3293	3373	384	1	80	0.0125000
NODE_498_length_3393_cov_43.623558	3293	3373	389	1	80	0.0125000
NODE_498_length_3393_cov_43.623558	3293	3373	391	1	80	0.0125000
NODE_498_length_3393_cov_43.623558	3293	3373	396	1	80	0.0125000
NODE_498_length_3393_cov_43.623558	3293	3373	400	1	80	0.0125000
NODE_498_length_3393_cov_43.623558	3293	3373	401	1	80	0.0125000
NODE_498_length_3393_cov_43.623558	3293	3373	404	1	80	0.0125000
NODE_498_length_3393_cov_43.623558	3293	3373	418	1	80	0.0125000
NODE_498_length_3393_cov_43.623558	3293	3373	421	1	80	0.0125000
NODE_498_length_3393_cov_43.623558	3293	3373	429	1	80	0.0125000
NODE_498_length_3393_cov_43.623558	3293	3373	431	1	80	0.0125000
NODE_498_length_3393_cov_43.623558	3293	3373	435	2	80	0.0250000
NODE_498_length_3393_cov_43.623558	3293	3373	437	1	80	0.0125000
NODE_498_length_3393_cov_43.623558	3293	3373	441	1	80	0.0125000
NODE_498_length_3393_cov_43.623558	3293	3373	455	1	80	0.0125000
NODE_498_length_3393_cov_43.623558	3293	3373	458	1	80	0.0125000
NODE_498_length_3393_cov_43.623558	3293	3373	468	1	80	0.0125000
NODE_498_length_3393_cov_43.623558	3293	3373	474	1	80	0.0125000
NODE_498_length_3393_cov_43.623558	3293	3373	477	1	80	0.0125000
NODE_498_length_3393_cov_43.623558	3293	3373	483	1	80	0.0125000
NODE_498_length_3393_cov_43.623558	3293	3373	487	1	80	0.0125000
NODE_498_length_3393_cov_43.623558	3293	3373	492	1	80	0.0125000
NODE_498_length_3393_cov_43.623558	3293	3373	497	1	80	0.0125000
NODE_498_length_3393_cov_43.623558	3293	3373	501	1	80	0.0125000
NODE_498_length_3393_cov_43.623558	3293	3373	516	1	80	0.0125000
NODE_498_length_3393_cov_43.623558	3293	3373	529	1	80	0.0125000
NODE_498_length_3393_cov_43.623558	3293	3373	534	1	80	0.0125000
NODE_498_length_3393_cov_43.623558	3293	3373	537	1	80	0.0125000
NODE_498_length_3393_cov_43.623558	3293	3373	539	1	80	0.0125000
NODE_498_length_3393_cov_43.623558	3293	3373	550	1	80	0.0125000
NODE_498_length_3393_cov_43.623558	3293	3373	554	1	80	0.0125000
NODE_498_length_3393_cov_43.623558	3293	3373	555	1	80	0.0125000
NODE_498_length_3393_cov_43.623558	3293	3373	558	1	80	0.0125000
NODE_498_length_3393_cov_43.623558	3293	3373	561	1	80	0.0125000
NODE_498_length_3393_cov_43.623558	3293	3373	568	1	80	0.0125000
NODE_498_length_3393_cov_43.623558	3293	3373	574	1	80	0.0125000
NODE_499_length_3392_cov_41.514728	255	335	4	2	80	0.0250000
NODE_499_length_3392_cov_41.514728	255	335	5	28	80	0.3500000
NODE_499_length_3392_cov_41.514728	255	335	7	49	80	0.6125000
NODE_499_length_3392_cov_41.514728	255	335	8	1	80	0.0125000
NODE_499_length_3392_cov_41.514728	308	388	4	24	80	0.3000000
NODE_499_length_3392_cov_41.514728	308	388	6	15	80	0.1875000
NODE_499_length_3392_cov_41.514728	308	388	7	41	80	0.5125000
NODE_499_length_3392_cov_41.514728	917	997	160	1	80	0.0125000
NODE_499_length_3392_cov_41.514728	917	997	161	2	80	0.0250000
NODE_499_length_3392_cov_41.514728	917	997	162	2	80	0.0250000
NODE_499_length_3392_cov_41.514728	917	997	163	3	80	0.0375000
NODE_499_length_3392_cov_41.514728	917	997	164	2	80	0.0250000
NODE_499_length_3392_cov_41.514728	917	997	165	1	80	0.0125000
NODE_499_length_3392_cov_41.514728	917	997	166	2	80	0.0250000
NODE_499_length_3392_cov_41.514728	917	997	169	1	80	0.0125000
NODE_499_length_3392_cov_41.514728	917	997	170	1	80	0.0125000
NODE_499_length_3392_cov_41.514728	917	997	171	4	80	0.0500000
NODE_499_length_3392_cov_41.514728	917	997	172	2	80	0.0250000
NODE_499_length_3392_cov_41.514728	917	997	173	3	80	0.0375000
NODE_499_length_3392_cov_41.514728	917	997	176	1	80	0.0125000
NODE_499_length_3392_cov_41.514728	917	997	177	1	80	0.0125000
NODE_499_length_3392_cov_41.514728	917	997	178	1	80	0.0125000
NODE_499_length_3392_cov_41.514728	917	997	179	2	80	0.0250000
NODE_499_length_3392_cov_41.514728	917	997	180	1	80	0.0125000
NODE_499_length_3392_cov_41.514728	917	997	181	2	80	0.0250000
NODE_499_length_3392_cov_41.514728	917	997	182	2	80	0.0250000
NODE_499_length_3392_cov_41.514728	917	997	183	3	80	0.0375000
NODE_499_length_3392_cov_41.514728	917	997	184	4	80	0.0500000
NODE_499_length_3392_cov_41.514728	917	997	185	1	80	0.0125000
NODE_499_length_3392_cov_41.514728	917	997	186	1	80	0.0125000
NODE_499_length_3392_cov_41.514728	917	997	187	1	80	0.0125000
NODE_499_length_3392_cov_41.514728	917	997	188	11	80	0.1375000
NODE_499_length_3392_cov_41.514728	917	997	189	3	80	0.0375000
NODE_499_length_3392_cov_41.514728	917	997	190	5	80	0.0625000
NODE_499_length_3392_cov_41.514728	917	997	191	4	80	0.0500000
NODE_499_length_3392_cov_41.514728	917	997	192	2	80	0.0250000
NODE_499_length_3392_cov_41.514728	917	997	194	2	80	0.0250000
NODE_499_length_3392_cov_41.514728	917	997	195	2	80	0.0250000
NODE_499_length_3392_cov_41.514728	917	997	196	4	80	0.0500000
NODE_499_length_3392_cov_41.514728	917	997	197	2	80	0.0250000
NODE_499_length_3392_cov_41.514728	917	997	198	1	80	0.0125000
NODE_499_length_3392_cov_41.514728	970	1053	108	1	83	0.0120482
NODE_499_length_3392_cov_41.514728	970	1053	111	1	83	0.0120482
NODE_499_length_3392_cov_41.514728	970	1053	118	1	83	0.0120482
NODE_499_length_3392_cov_41.514728	970	1053	119	1	83	0.0120482
NODE_499_length_3392_cov_41.514728	970	1053	122	1	83	0.0120482
NODE_499_length_3392_cov_41.514728	970	1053	126	2	83	0.0240964
NODE_499_length_3392_cov_41.514728	970	1053	127	3	83	0.0361446
NODE_499_length_3392_cov_41.514728	970	1053	128	1	83	0.0120482
NODE_499_length_3392_cov_41.514728	970	1053	130	1	83	0.0120482
NODE_499_length_3392_cov_41.514728	970	1053	131	2	83	0.0240964
NODE_499_length_3392_cov_41.514728	970	1053	132	3	83	0.0361446
NODE_499_length_3392_cov_41.514728	970	1053	133	2	83	0.0240964
NODE_499_length_3392_cov_41.514728	970	1053	134	2	83	0.0240964
NODE_499_length_3392_cov_41.514728	970	1053	135	1	83	0.0120482
NODE_499_length_3392_cov_41.514728	970	1053	137	1	83	0.0120482
NODE_499_length_3392_cov_41.514728	970	1053	138	5	83	0.0602410
NODE_499_length_3392_cov_41.514728	970	1053	139	5	83	0.0602410
NODE_499_length_3392_cov_41.514728	970	1053	140	1	83	0.0120482
NODE_499_length_3392_cov_41.514728	970	1053	143	2	83	0.0240964
NODE_499_length_3392_cov_41.514728	970	1053	144	1	83	0.0120482
NODE_499_length_3392_cov_41.514728	970	1053	145	2	83	0.0240964
NODE_499_length_3392_cov_41.514728	970	1053	147	1	83	0.0120482
NODE_499_length_3392_cov_41.514728	970	1053	149	1	83	0.0120482
NODE_499_length_3392_cov_41.514728	970	1053	150	1	83	0.0120482
NODE_499_length_3392_cov_41.514728	970	1053	152	5	83	0.0602410
NODE_499_length_3392_cov_41.514728	970	1053	153	3	83	0.0361446
NODE_499_length_3392_cov_41.514728	970	1053	154	1	83	0.0120482
NODE_499_length_3392_cov_41.514728	970	1053	157	1	83	0.0120482
NODE_499_length_3392_cov_41.514728	970	1053	158	2	83	0.0240964
NODE_499_length_3392_cov_41.514728	970	1053	159	2	83	0.0240964
NODE_499_length_3392_cov_41.514728	970	1053	160	1	83	0.0120482
NODE_499_length_3392_cov_41.514728	970	1053	161	2	83	0.0240964
NODE_499_length_3392_cov_41.514728	970	1053	162	2	83	0.0240964
NODE_499_length_3392_cov_41.514728	970	1053	163	3	83	0.0361446
NODE_499_length_3392_cov_41.514728	970	1053	164	2	83	0.0240964
NODE_499_length_3392_cov_41.514728	970	1053	165	1	83	0.0120482
NODE_499_length_3392_cov_41.514728	970	1053	166	2	83	0.0240964
NODE_499_length_3392_cov_41.514728	970	1053	169	1	83	0.0120482
NODE_499_length_3392_cov_41.514728	970	1053	170	1	83	0.0120482
NODE_499_length_3392_cov_41.514728	970	1053	171	4	83	0.0481928
NODE_499_length_3392_cov_41.514728	970	1053	172	2	83	0.0240964
NODE_499_length_3392_cov_41.514728	970	1053	173	3	83	0.0361446
NODE_499_length_3392_cov_41.514728	970	1053	176	1	83	0.0120482
NODE_499_length_3392_cov_41.514728	970	1053	177	1	83	0.0120482
NODE_499_length_3392_cov_41.514728	970	1053	179	1	83	0.0120482
NODE_501_length_3389_cov_8.244073	2159	2239	0	40	80	0.5000000
NODE_501_length_3389_cov_8.244073	2159	2239	1	40	80	0.5000000
NODE_501_length_3389_cov_8.244073	2212	2292	0	25	80	0.3125000
NODE_501_length_3389_cov_8.244073	2212	2292	1	2	80	0.0250000
NODE_501_length_3389_cov_8.244073	2212	2292	2	53	80	0.6625000
NODE_506_length_3363_cov_4.412684	56	124	0	21	68	0.3088235
NODE_506_length_3363_cov_4.412684	56	124	2	47	68	0.6911765
NODE_510_length_3353_cov_2.687462	0	61	0	61	61	1.0000000
NODE_510_length_3353_cov_2.687462	0	61	0	61	61	1.0000000
NODE_510_length_3353_cov_2.687462	34	99	0	65	65	1.0000000
NODE_513_length_3348_cov_243.959372	2473	2553	438	1	80	0.0125000
NODE_513_length_3348_cov_243.959372	2473	2553	440	4	80	0.0500000
NODE_513_length_3348_cov_243.959372	2473	2553	443	2	80	0.0250000
NODE_513_length_3348_cov_243.959372	2473	2553	444	2	80	0.0250000
NODE_513_length_3348_cov_243.959372	2473	2553	447	2	80	0.0250000
NODE_513_length_3348_cov_243.959372	2473	2553	448	2	80	0.0250000
NODE_513_length_3348_cov_243.959372	2473	2553	449	2	80	0.0250000
NODE_513_length_3348_cov_243.959372	2473	2553	451	1	80	0.0125000
NODE_513_length_3348_cov_243.959372	2473	2553	453	2	80	0.0250000
NODE_513_length_3348_cov_243.959372	2473	2553	454	2	80	0.0250000
NODE_513_length_3348_cov_243.959372	2473	2553	456	2	80	0.0250000
NODE_513_length_3348_cov_243.959372	2473	2553	461	1	80	0.0125000
NODE_513_length_3348_cov_243.959372	2473	2553	464	1	80	0.0125000
NODE_513_length_3348_cov_243.959372	2473	2553	465	2	80	0.0250000
NODE_513_length_3348_cov_243.959372	2473	2553	468	1	80	0.0125000
NODE_513_length_3348_cov_243.959372	2473	2553	469	2	80	0.0250000
NODE_513_length_3348_cov_243.959372	2473	2553	470	1	80	0.0125000
NODE_513_length_3348_cov_243.959372	2473	2553	475	1	80	0.0125000
NODE_513_length_3348_cov_243.959372	2473	2553	476	1	80	0.0125000
NODE_513_length_3348_cov_243.959372	2473	2553	477	3	80	0.0375000
NODE_513_length_3348_cov_243.959372	2473	2553	478	1	80	0.0125000
NODE_513_length_3348_cov_243.959372	2473	2553	479	1	80	0.0125000
NODE_513_length_3348_cov_243.959372	2473	2553	480	1	80	0.0125000
NODE_513_length_3348_cov_243.959372	2473	2553	483	4	80	0.0500000
NODE_513_length_3348_cov_243.959372	2473	2553	485	2	80	0.0250000
NODE_513_length_3348_cov_243.959372	2473	2553	486	1	80	0.0125000
NODE_513_length_3348_cov_243.959372	2473	2553	488	1	80	0.0125000
NODE_513_length_3348_cov_243.959372	2473	2553	489	5	80	0.0625000
NODE_513_length_3348_cov_243.959372	2473	2553	490	5	80	0.0625000
NODE_513_length_3348_cov_243.959372	2473	2553	491	1	80	0.0125000
NODE_513_length_3348_cov_243.959372	2473	2553	492	3	80	0.0375000
NODE_513_length_3348_cov_243.959372	2473	2553	493	2	80	0.0250000
NODE_513_length_3348_cov_243.959372	2473	2553	494	2	80	0.0250000
NODE_513_length_3348_cov_243.959372	2473	2553	495	4	80	0.0500000
NODE_513_length_3348_cov_243.959372	2473	2553	498	1	80	0.0125000
NODE_513_length_3348_cov_243.959372	2473	2553	500	1	80	0.0125000
NODE_513_length_3348_cov_243.959372	2473	2553	502	2	80	0.0250000
NODE_513_length_3348_cov_243.959372	2473	2553	504	1	80	0.0125000
NODE_513_length_3348_cov_243.959372	2473	2553	506	3	80	0.0375000
NODE_513_length_3348_cov_243.959372	2473	2553	508	3	80	0.0375000
NODE_513_length_3348_cov_243.959372	2473	2553	510	1	80	0.0125000
NODE_513_length_3348_cov_243.959372	2526	2606	418	2	80	0.0250000
NODE_513_length_3348_cov_243.959372	2526	2606	422	1	80	0.0125000
NODE_513_length_3348_cov_243.959372	2526	2606	425	1	80	0.0125000
NODE_513_length_3348_cov_243.959372	2526	2606	428	1	80	0.0125000
NODE_513_length_3348_cov_243.959372	2526	2606	431	1	80	0.0125000
NODE_513_length_3348_cov_243.959372	2526	2606	434	3	80	0.0375000
NODE_513_length_3348_cov_243.959372	2526	2606	436	2	80	0.0250000
NODE_513_length_3348_cov_243.959372	2526	2606	437	1	80	0.0125000
NODE_513_length_3348_cov_243.959372	2526	2606	438	2	80	0.0250000
NODE_513_length_3348_cov_243.959372	2526	2606	441	1	80	0.0125000
NODE_513_length_3348_cov_243.959372	2526	2606	442	1	80	0.0125000
NODE_513_length_3348_cov_243.959372	2526	2606	444	1	80	0.0125000
NODE_513_length_3348_cov_243.959372	2526	2606	446	1	80	0.0125000
NODE_513_length_3348_cov_243.959372	2526	2606	455	2	80	0.0250000
NODE_513_length_3348_cov_243.959372	2526	2606	456	1	80	0.0125000
NODE_513_length_3348_cov_243.959372	2526	2606	468	1	80	0.0125000
NODE_513_length_3348_cov_243.959372	2526	2606	471	1	80	0.0125000
NODE_513_length_3348_cov_243.959372	2526	2606	472	1	80	0.0125000
NODE_513_length_3348_cov_243.959372	2526	2606	474	1	80	0.0125000
NODE_513_length_3348_cov_243.959372	2526	2606	475	2	80	0.0250000
NODE_513_length_3348_cov_243.959372	2526	2606	477	1	80	0.0125000
NODE_513_length_3348_cov_243.959372	2526	2606	480	2	80	0.0250000
NODE_513_length_3348_cov_243.959372	2526	2606	483	3	80	0.0375000
NODE_513_length_3348_cov_243.959372	2526	2606	484	1	80	0.0125000
NODE_513_length_3348_cov_243.959372	2526	2606	485	1	80	0.0125000
NODE_513_length_3348_cov_243.959372	2526	2606	486	1	80	0.0125000
NODE_513_length_3348_cov_243.959372	2526	2606	488	1	80	0.0125000
NODE_513_length_3348_cov_243.959372	2526	2606	489	4	80	0.0500000
NODE_513_length_3348_cov_243.959372	2526	2606	490	3	80	0.0375000
NODE_513_length_3348_cov_243.959372	2526	2606	491	1	80	0.0125000
NODE_513_length_3348_cov_243.959372	2526	2606	492	4	80	0.0500000
NODE_513_length_3348_cov_243.959372	2526	2606	493	3	80	0.0375000
NODE_513_length_3348_cov_243.959372	2526	2606	494	6	80	0.0750000
NODE_513_length_3348_cov_243.959372	2526	2606	495	2	80	0.0250000
NODE_513_length_3348_cov_243.959372	2526	2606	497	1	80	0.0125000
NODE_513_length_3348_cov_243.959372	2526	2606	498	3	80	0.0375000
NODE_513_length_3348_cov_243.959372	2526	2606	500	2	80	0.0250000
NODE_513_length_3348_cov_243.959372	2526	2606	501	3	80	0.0375000
NODE_513_length_3348_cov_243.959372	2526	2606	502	3	80	0.0375000
NODE_513_length_3348_cov_243.959372	2526	2606	504	1	80	0.0125000
NODE_513_length_3348_cov_243.959372	2526	2606	506	3	80	0.0375000
NODE_513_length_3348_cov_243.959372	2526	2606	508	3	80	0.0375000
NODE_513_length_3348_cov_243.959372	2526	2606	510	1	80	0.0125000
NODE_514_length_3348_cov_31.953216	103	183	1	24	80	0.3000000
NODE_514_length_3348_cov_31.953216	103	183	4	3	80	0.0375000
NODE_514_length_3348_cov_31.953216	103	183	6	8	80	0.1000000
NODE_514_length_3348_cov_31.953216	103	183	7	2	80	0.0250000
NODE_514_length_3348_cov_31.953216	103	183	8	43	80	0.5375000
NODE_514_length_3348_cov_31.953216	105	179	1	22	74	0.2972973
NODE_514_length_3348_cov_31.953216	105	179	4	3	74	0.0405405
NODE_514_length_3348_cov_31.953216	105	179	6	8	74	0.1081081
NODE_514_length_3348_cov_31.953216	105	179	7	2	74	0.0270270
NODE_514_length_3348_cov_31.953216	105	179	8	39	74	0.5270270
NODE_514_length_3348_cov_31.953216	156	236	7	9	80	0.1125000
NODE_514_length_3348_cov_31.953216	156	236	8	43	80	0.5375000
NODE_514_length_3348_cov_31.953216	156	236	9	23	80	0.2875000
NODE_514_length_3348_cov_31.953216	156	236	10	5	80	0.0625000
NODE_514_length_3348_cov_31.953216	156	236	7	9	80	0.1125000
NODE_514_length_3348_cov_31.953216	156	236	8	43	80	0.5375000
NODE_514_length_3348_cov_31.953216	156	236	9	23	80	0.2875000
NODE_514_length_3348_cov_31.953216	156	236	10	5	80	0.0625000
NODE_514_length_3348_cov_31.953216	2405	2476	100	2	71	0.0281690
NODE_514_length_3348_cov_31.953216	2405	2476	101	4	71	0.0563380
NODE_514_length_3348_cov_31.953216	2405	2476	102	1	71	0.0140845
NODE_514_length_3348_cov_31.953216	2405	2476	103	1	71	0.0140845
NODE_514_length_3348_cov_31.953216	2405	2476	104	5	71	0.0704225
NODE_514_length_3348_cov_31.953216	2405	2476	105	2	71	0.0281690
NODE_514_length_3348_cov_31.953216	2405	2476	107	3	71	0.0422535
NODE_514_length_3348_cov_31.953216	2405	2476	108	3	71	0.0422535
NODE_514_length_3348_cov_31.953216	2405	2476	109	2	71	0.0281690
NODE_514_length_3348_cov_31.953216	2405	2476	110	2	71	0.0281690
NODE_514_length_3348_cov_31.953216	2405	2476	111	1	71	0.0140845
NODE_514_length_3348_cov_31.953216	2405	2476	113	1	71	0.0140845
NODE_514_length_3348_cov_31.953216	2405	2476	115	1	71	0.0140845
NODE_514_length_3348_cov_31.953216	2405	2476	117	3	71	0.0422535
NODE_514_length_3348_cov_31.953216	2405	2476	119	1	71	0.0140845
NODE_514_length_3348_cov_31.953216	2405	2476	120	2	71	0.0281690
NODE_514_length_3348_cov_31.953216	2405	2476	121	1	71	0.0140845
NODE_514_length_3348_cov_31.953216	2405	2476	122	1	71	0.0140845
NODE_514_length_3348_cov_31.953216	2405	2476	123	1	71	0.0140845
NODE_514_length_3348_cov_31.953216	2405	2476	124	1	71	0.0140845
NODE_514_length_3348_cov_31.953216	2405	2476	125	1	71	0.0140845
NODE_514_length_3348_cov_31.953216	2405	2476	127	3	71	0.0422535
NODE_514_length_3348_cov_31.953216	2405	2476	129	1	71	0.0140845
NODE_514_length_3348_cov_31.953216	2405	2476	130	4	71	0.0563380
NODE_514_length_3348_cov_31.953216	2405	2476	132	1	71	0.0140845
NODE_514_length_3348_cov_31.953216	2405	2476	133	1	71	0.0140845
NODE_514_length_3348_cov_31.953216	2405	2476	139	2	71	0.0281690
NODE_514_length_3348_cov_31.953216	2405	2476	141	1	71	0.0140845
NODE_514_length_3348_cov_31.953216	2405	2476	145	1	71	0.0140845
NODE_514_length_3348_cov_31.953216	2405	2476	146	1	71	0.0140845
NODE_514_length_3348_cov_31.953216	2405	2476	147	1	71	0.0140845
NODE_514_length_3348_cov_31.953216	2405	2476	148	4	71	0.0563380
NODE_514_length_3348_cov_31.953216	2405	2476	149	2	71	0.0281690
NODE_514_length_3348_cov_31.953216	2405	2476	150	2	71	0.0281690
NODE_514_length_3348_cov_31.953216	2405	2476	151	6	71	0.0845070
NODE_514_length_3348_cov_31.953216	2405	2476	152	2	71	0.0281690
NODE_514_length_3348_cov_31.953216	2458	2529	145	1	71	0.0140845
NODE_514_length_3348_cov_31.953216	2458	2529	146	1	71	0.0140845
NODE_514_length_3348_cov_31.953216	2458	2529	147	1	71	0.0140845
NODE_514_length_3348_cov_31.953216	2458	2529	148	3	71	0.0422535
NODE_514_length_3348_cov_31.953216	2458	2529	149	2	71	0.0281690
NODE_514_length_3348_cov_31.953216	2458	2529	150	2	71	0.0281690
NODE_514_length_3348_cov_31.953216	2458	2529	151	10	71	0.1408451
NODE_514_length_3348_cov_31.953216	2458	2529	152	4	71	0.0563380
NODE_514_length_3348_cov_31.953216	2458	2529	153	4	71	0.0563380
NODE_514_length_3348_cov_31.953216	2458	2529	154	3	71	0.0422535
NODE_514_length_3348_cov_31.953216	2458	2529	155	1	71	0.0140845
NODE_514_length_3348_cov_31.953216	2458	2529	156	11	71	0.1549296
NODE_514_length_3348_cov_31.953216	2458	2529	157	8	71	0.1126761
NODE_514_length_3348_cov_31.953216	2458	2529	158	4	71	0.0563380
NODE_514_length_3348_cov_31.953216	2458	2529	159	2	71	0.0281690
NODE_514_length_3348_cov_31.953216	2458	2529	160	2	71	0.0281690
NODE_514_length_3348_cov_31.953216	2458	2529	161	2	71	0.0281690
NODE_514_length_3348_cov_31.953216	2458	2529	162	1	71	0.0140845
NODE_514_length_3348_cov_31.953216	2458	2529	164	2	71	0.0281690
NODE_514_length_3348_cov_31.953216	2458	2529	165	3	71	0.0422535
NODE_514_length_3348_cov_31.953216	2458	2529	166	3	71	0.0422535
NODE_514_length_3348_cov_31.953216	2458	2529	168	1	71	0.0140845
NODE_517_length_3335_cov_19.649567	2100	2180	21	4	80	0.0500000
NODE_517_length_3335_cov_19.649567	2100	2180	22	4	80	0.0500000
NODE_517_length_3335_cov_19.649567	2100	2180	23	9	80	0.1125000
NODE_517_length_3335_cov_19.649567	2100	2180	24	7	80	0.0875000
NODE_517_length_3335_cov_19.649567	2100	2180	25	15	80	0.1875000
NODE_517_length_3335_cov_19.649567	2100	2180	26	28	80	0.3500000
NODE_517_length_3335_cov_19.649567	2100	2180	27	12	80	0.1500000
NODE_517_length_3335_cov_19.649567	2100	2180	28	1	80	0.0125000
NODE_517_length_3335_cov_19.649567	2153	2233	15	7	80	0.0875000
NODE_517_length_3335_cov_19.649567	2153	2233	16	8	80	0.1000000
NODE_517_length_3335_cov_19.649567	2153	2233	17	18	80	0.2250000
NODE_517_length_3335_cov_19.649567	2153	2233	20	2	80	0.0250000
NODE_517_length_3335_cov_19.649567	2153	2233	21	6	80	0.0750000
NODE_517_length_3335_cov_19.649567	2153	2233	22	4	80	0.0500000
NODE_517_length_3335_cov_19.649567	2153	2233	23	15	80	0.1875000
NODE_517_length_3335_cov_19.649567	2153	2233	24	9	80	0.1125000
NODE_517_length_3335_cov_19.649567	2153	2233	25	7	80	0.0875000
NODE_517_length_3335_cov_19.649567	2153	2233	26	4	80	0.0500000
NODE_517_length_3335_cov_19.649567	2229	2309	8	2	80	0.0250000
NODE_517_length_3335_cov_19.649567	2229	2309	9	14	80	0.1750000
NODE_517_length_3335_cov_19.649567	2229	2309	10	5	80	0.0625000
NODE_517_length_3335_cov_19.649567	2229	2309	11	3	80	0.0375000
NODE_517_length_3335_cov_19.649567	2229	2309	12	8	80	0.1000000
NODE_517_length_3335_cov_19.649567	2229	2309	13	8	80	0.1000000
NODE_517_length_3335_cov_19.649567	2229	2309	14	2	80	0.0250000
NODE_517_length_3335_cov_19.649567	2229	2309	16	18	80	0.2250000
NODE_517_length_3335_cov_19.649567	2229	2309	17	18	80	0.2250000
NODE_517_length_3335_cov_19.649567	2229	2309	18	2	80	0.0250000
NODE_517_length_3335_cov_19.649567	2282	2362	6	11	80	0.1375000
NODE_517_length_3335_cov_19.649567	2282	2362	7	12	80	0.1500000
NODE_517_length_3335_cov_19.649567	2282	2362	8	22	80	0.2750000
NODE_517_length_3335_cov_19.649567	2282	2362	9	15	80	0.1875000
NODE_517_length_3335_cov_19.649567	2282	2362	10	14	80	0.1750000
NODE_517_length_3335_cov_19.649567	2282	2362	11	3	80	0.0375000
NODE_517_length_3335_cov_19.649567	2282	2362	12	3	80	0.0375000
NODE_518_length_3333_cov_24.805504	734	814	3	36	80	0.4500000
NODE_518_length_3333_cov_24.805504	734	814	4	44	80	0.5500000
NODE_518_length_3333_cov_24.805504	787	867	2	6	80	0.0750000
NODE_518_length_3333_cov_24.805504	787	867	4	74	80	0.9250000
NODE_523_length_3312_cov_6.996576	85	165	2	24	80	0.3000000
NODE_523_length_3312_cov_6.996576	85	165	3	56	80	0.7000000
NODE_523_length_3312_cov_6.996576	138	218	2	20	80	0.2500000
NODE_523_length_3312_cov_6.996576	138	218	3	60	80	0.7500000
NODE_525_length_3302_cov_3.859195	3184	3262	0	43	78	0.5512820
NODE_525_length_3302_cov_3.859195	3184	3262	1	17	78	0.2179487
NODE_525_length_3302_cov_3.859195	3184	3262	2	3	78	0.0384615
NODE_525_length_3302_cov_3.859195	3184	3262	4	15	78	0.1923077
NODE_525_length_3302_cov_3.859195	3184	3253	0	34	69	0.4927536
NODE_525_length_3302_cov_3.859195	3184	3253	1	17	69	0.2463768
NODE_525_length_3302_cov_3.859195	3184	3253	2	3	69	0.0434783
NODE_525_length_3302_cov_3.859195	3184	3253	4	15	69	0.2173913
NODE_526_length_3299_cov_6.014687	1632	1688	1	51	56	0.9107143
NODE_526_length_3299_cov_6.014687	1632	1688	2	5	56	0.0892857
NODE_530_length_3290_cov_17.805390	773	853	3	1	80	0.0125000
NODE_530_length_3290_cov_17.805390	773	853	4	2	80	0.0250000
NODE_530_length_3290_cov_17.805390	773	853	5	77	80	0.9625000
NODE_530_length_3290_cov_17.805390	826	906	2	2	80	0.0250000
NODE_530_length_3290_cov_17.805390	826	906	4	53	80	0.6625000
NODE_530_length_3290_cov_17.805390	826	906	5	25	80	0.3125000
NODE_531_length_3290_cov_12.352554	2749	2829	3	28	80	0.3500000
NODE_531_length_3290_cov_12.352554	2749	2829	4	19	80	0.2375000
NODE_531_length_3290_cov_12.352554	2749	2829	5	33	80	0.4125000
NODE_531_length_3290_cov_12.352554	2802	2882	1	4	80	0.0500000
NODE_531_length_3290_cov_12.352554	2802	2882	2	28	80	0.3500000
NODE_531_length_3290_cov_12.352554	2802	2882	3	48	80	0.6000000
NODE_532_length_3286_cov_5.973015	0	50	0	50	50	1.0000000
NODE_532_length_3286_cov_5.973015	0	50	0	50	50	1.0000000
NODE_532_length_3286_cov_5.973015	0	50	0	50	50	1.0000000
NODE_532_length_3286_cov_5.973015	23	89	0	66	66	1.0000000
NODE_532_length_3286_cov_5.973015	23	94	0	71	71	1.0000000
NODE_533_length_3284_cov_6.453689	313	392	5	2	79	0.0253165
NODE_533_length_3284_cov_6.453689	313	392	7	37	79	0.4683544
NODE_533_length_3284_cov_6.453689	313	392	8	29	79	0.3670886
NODE_533_length_3284_cov_6.453689	313	392	9	11	79	0.1392405
NODE_533_length_3284_cov_6.453689	365	445	3	4	80	0.0500000
NODE_533_length_3284_cov_6.453689	365	445	5	4	80	0.0500000
NODE_533_length_3284_cov_6.453689	365	445	6	1	80	0.0125000
NODE_533_length_3284_cov_6.453689	365	445	7	6	80	0.0750000
NODE_533_length_3284_cov_6.453689	365	445	8	56	80	0.7000000
NODE_533_length_3284_cov_6.453689	365	445	9	9	80	0.1125000
NODE_541_length_3267_cov_12.768624	11	91	3	5	80	0.0625000
NODE_541_length_3267_cov_12.768624	11	91	4	1	80	0.0125000
NODE_541_length_3267_cov_12.768624	11	91	6	11	80	0.1375000
NODE_541_length_3267_cov_12.768624	11	91	7	9	80	0.1125000
NODE_541_length_3267_cov_12.768624	11	91	9	1	80	0.0125000
NODE_541_length_3267_cov_12.768624	11	91	10	1	80	0.0125000
NODE_541_length_3267_cov_12.768624	11	91	12	10	80	0.1250000
NODE_541_length_3267_cov_12.768624	11	91	13	13	80	0.1625000
NODE_541_length_3267_cov_12.768624	11	91	14	12	80	0.1500000
NODE_541_length_3267_cov_12.768624	11	91	15	17	80	0.2125000
NODE_542_length_3266_cov_14.108304	2620	2684	3	16	64	0.2500000
NODE_542_length_3266_cov_14.108304	2620	2684	5	48	64	0.7500000
NODE_542_length_3266_cov_14.108304	2620	2684	3	16	64	0.2500000
NODE_542_length_3266_cov_14.108304	2620	2684	5	48	64	0.7500000
NODE_542_length_3266_cov_14.108304	2620	2684	3	16	64	0.2500000
NODE_542_length_3266_cov_14.108304	2620	2684	5	48	64	0.7500000
NODE_547_length_3242_cov_12.407891	391	471	2	80	80	1.0000000
NODE_547_length_3242_cov_12.407891	444	524	0	36	80	0.4500000
NODE_547_length_3242_cov_12.407891	444	524	2	44	80	0.5500000
NODE_550_length_3233_cov_19.903957	411	491	1	80	80	1.0000000
NODE_550_length_3233_cov_19.903957	411	491	1	80	80	1.0000000
NODE_550_length_3233_cov_19.903957	464	544	0	19	80	0.2375000
NODE_550_length_3233_cov_19.903957	464	544	1	61	80	0.7625000
NODE_552_length_3232_cov_11.378870	2586	2621	2	35	35	1.0000000
NODE_555_length_3214_cov_22.853291	2090	2170	56	6	80	0.0750000
NODE_555_length_3214_cov_22.853291	2090	2170	57	9	80	0.1125000
NODE_555_length_3214_cov_22.853291	2090	2170	58	14	80	0.1750000
NODE_555_length_3214_cov_22.853291	2090	2170	59	10	80	0.1250000
NODE_555_length_3214_cov_22.853291	2090	2170	60	6	80	0.0750000
NODE_555_length_3214_cov_22.853291	2090	2170	61	8	80	0.1000000
NODE_555_length_3214_cov_22.853291	2090	2170	62	6	80	0.0750000
NODE_555_length_3214_cov_22.853291	2090	2170	63	3	80	0.0375000
NODE_555_length_3214_cov_22.853291	2090	2170	64	9	80	0.1125000
NODE_555_length_3214_cov_22.853291	2090	2170	65	5	80	0.0625000
NODE_555_length_3214_cov_22.853291	2090	2170	67	4	80	0.0500000
NODE_555_length_3214_cov_22.853291	2143	2223	45	8	80	0.1000000
NODE_555_length_3214_cov_22.853291	2143	2223	46	6	80	0.0750000
NODE_555_length_3214_cov_22.853291	2143	2223	47	1	80	0.0125000
NODE_555_length_3214_cov_22.853291	2143	2223	49	2	80	0.0250000
NODE_555_length_3214_cov_22.853291	2143	2223	52	1	80	0.0125000
NODE_555_length_3214_cov_22.853291	2143	2223	54	5	80	0.0625000
NODE_555_length_3214_cov_22.853291	2143	2223	55	5	80	0.0625000
NODE_555_length_3214_cov_22.853291	2143	2223	56	1	80	0.0125000
NODE_555_length_3214_cov_22.853291	2143	2223	57	6	80	0.0750000
NODE_555_length_3214_cov_22.853291	2143	2223	58	6	80	0.0750000
NODE_555_length_3214_cov_22.853291	2143	2223	59	15	80	0.1875000
NODE_555_length_3214_cov_22.853291	2143	2223	60	9	80	0.1125000
NODE_555_length_3214_cov_22.853291	2143	2223	61	6	80	0.0750000
NODE_555_length_3214_cov_22.853291	2143	2223	62	6	80	0.0750000
NODE_555_length_3214_cov_22.853291	2143	2223	63	3	80	0.0375000
NODE_555_length_3214_cov_22.853291	3028	3086	14	32	58	0.5517241
NODE_555_length_3214_cov_22.853291	3028	3086	15	9	58	0.1551724
NODE_555_length_3214_cov_22.853291	3028	3086	16	8	58	0.1379310
NODE_555_length_3214_cov_22.853291	3028	3086	17	1	58	0.0172414
NODE_555_length_3214_cov_22.853291	3028	3086	18	8	58	0.1379310
NODE_556_length_3211_cov_1.921915	95	175	0	3	80	0.0375000
NODE_556_length_3211_cov_1.921915	95	175	2	6	80	0.0750000
NODE_556_length_3211_cov_1.921915	95	175	3	13	80	0.1625000
NODE_556_length_3211_cov_1.921915	95	175	4	2	80	0.0250000
NODE_556_length_3211_cov_1.921915	95	175	5	56	80	0.7000000
NODE_556_length_3211_cov_1.921915	148	178	0	6	30	0.2000000
NODE_556_length_3211_cov_1.921915	148	178	2	6	30	0.2000000
NODE_556_length_3211_cov_1.921915	148	178	3	13	30	0.4333333
NODE_556_length_3211_cov_1.921915	148	178	4	2	30	0.0666667
NODE_556_length_3211_cov_1.921915	148	178	5	3	30	0.1000000
NODE_557_length_3210_cov_7.428480	2040	2111	2	4	71	0.0563380
NODE_557_length_3210_cov_7.428480	2040	2111	4	2	71	0.0281690
NODE_557_length_3210_cov_7.428480	2040	2111	6	24	71	0.3380282
NODE_557_length_3210_cov_7.428480	2040	2111	8	41	71	0.5774648
NODE_557_length_3210_cov_7.428480	2084	2164	5	13	80	0.1625000
NODE_557_length_3210_cov_7.428480	2084	2164	7	9	80	0.1125000
NODE_557_length_3210_cov_7.428480	2084	2164	8	58	80	0.7250000
NODE_557_length_3210_cov_7.428480	2715	2797	2	82	82	1.0000000
NODE_557_length_3210_cov_7.428480	2770	2850	0	10	80	0.1250000
NODE_557_length_3210_cov_7.428480	2770	2850	1	5	80	0.0625000
NODE_557_length_3210_cov_7.428480	2770	2850	2	65	80	0.8125000
NODE_562_length_3201_cov_3.591231	3120	3200	0	80	80	1.0000000
NODE_566_length_3189_cov_69.446602	137	188	2	17	51	0.3333333
NODE_566_length_3189_cov_69.446602	137	188	4	34	51	0.6666667
NODE_567_length_3188_cov_7.233085	1663	1743	14	20	80	0.2500000
NODE_567_length_3188_cov_7.233085	1663	1743	15	60	80	0.7500000
NODE_567_length_3188_cov_7.233085	1716	1796	9	1	80	0.0125000
NODE_567_length_3188_cov_7.233085	1716	1796	10	9	80	0.1125000
NODE_567_length_3188_cov_7.233085	1716	1796	11	5	80	0.0625000
NODE_567_length_3188_cov_7.233085	1716	1796	12	14	80	0.1750000
NODE_567_length_3188_cov_7.233085	1716	1796	13	24	80	0.3000000
NODE_567_length_3188_cov_7.233085	1716	1796	14	5	80	0.0625000
NODE_567_length_3188_cov_7.233085	1716	1796	15	22	80	0.2750000
NODE_570_length_3177_cov_2.789474	2021	2042	5	4	21	0.1904762
NODE_570_length_3177_cov_2.789474	2021	2042	7	17	21	0.8095238
NODE_575_length_3158_cov_19.018960	840	920	9	1	80	0.0125000
NODE_575_length_3158_cov_19.018960	840	920	10	14	80	0.1750000
NODE_575_length_3158_cov_19.018960	840	920	12	43	80	0.5375000
NODE_575_length_3158_cov_19.018960	840	920	14	8	80	0.1000000
NODE_575_length_3158_cov_19.018960	840	920	15	1	80	0.0125000
NODE_575_length_3158_cov_19.018960	840	920	16	13	80	0.1625000
NODE_575_length_3158_cov_19.018960	893	973	12	5	80	0.0625000
NODE_575_length_3158_cov_19.018960	893	973	14	10	80	0.1250000
NODE_575_length_3158_cov_19.018960	893	973	15	22	80	0.2750000
NODE_575_length_3158_cov_19.018960	893	973	16	24	80	0.3000000
NODE_575_length_3158_cov_19.018960	893	973	17	19	80	0.2375000
NODE_575_length_3158_cov_19.018960	2833	2915	4	5	82	0.0609756
NODE_575_length_3158_cov_19.018960	2833	2915	5	10	82	0.1219512
NODE_575_length_3158_cov_19.018960	2833	2915	6	59	82	0.7195122
NODE_575_length_3158_cov_19.018960	2833	2915	7	8	82	0.0975610
NODE_575_length_3158_cov_19.018960	2888	2959	5	10	71	0.1408451
NODE_575_length_3158_cov_19.018960	2888	2959	6	59	71	0.8309859
NODE_575_length_3158_cov_19.018960	2888	2959	7	2	71	0.0281690
NODE_576_length_3150_cov_26.520813	770	850	12	2	80	0.0250000
NODE_576_length_3150_cov_26.520813	770	850	13	15	80	0.1875000
NODE_576_length_3150_cov_26.520813	770	850	14	2	80	0.0250000
NODE_576_length_3150_cov_26.520813	770	850	16	7	80	0.0875000
NODE_576_length_3150_cov_26.520813	770	850	17	12	80	0.1500000
NODE_576_length_3150_cov_26.520813	770	850	18	1	80	0.0125000
NODE_576_length_3150_cov_26.520813	770	850	20	15	80	0.1875000
NODE_576_length_3150_cov_26.520813	770	850	21	22	80	0.2750000
NODE_576_length_3150_cov_26.520813	770	850	22	4	80	0.0500000
NODE_576_length_3150_cov_26.520813	823	901	12	2	78	0.0256410
NODE_576_length_3150_cov_26.520813	823	901	13	1	78	0.0128205
NODE_576_length_3150_cov_26.520813	823	901	15	3	78	0.0384615
NODE_576_length_3150_cov_26.520813	823	901	16	1	78	0.0128205
NODE_576_length_3150_cov_26.520813	823	901	17	32	78	0.4102564
NODE_576_length_3150_cov_26.520813	823	901	19	3	78	0.0384615
NODE_576_length_3150_cov_26.520813	823	901	20	4	78	0.0512821
NODE_576_length_3150_cov_26.520813	823	901	21	28	78	0.3589744
NODE_576_length_3150_cov_26.520813	823	901	22	4	78	0.0512821
NODE_576_length_3150_cov_26.520813	2616	2696	0	80	80	1.0000000
NODE_576_length_3150_cov_26.520813	2669	2749	0	80	80	1.0000000
NODE_577_length_3150_cov_5.923959	2313	2393	1	11	80	0.1375000
NODE_577_length_3150_cov_5.923959	2313	2393	3	36	80	0.4500000
NODE_577_length_3150_cov_5.923959	2313	2393	5	33	80	0.4125000
NODE_579_length_3148_cov_2.313873	3053	3105	0	52	52	1.0000000
NODE_581_length_3146_cov_18.277322	2418	2498	0	1	80	0.0125000
NODE_581_length_3146_cov_18.277322	2418	2498	1	21	80	0.2625000
NODE_581_length_3146_cov_18.277322	2418	2498	2	14	80	0.1750000
NODE_581_length_3146_cov_18.277322	2418	2498	3	4	80	0.0500000
NODE_581_length_3146_cov_18.277322	2418	2498	4	13	80	0.1625000
NODE_581_length_3146_cov_18.277322	2418	2498	6	27	80	0.3375000
NODE_581_length_3146_cov_18.277322	2471	2551	6	29	80	0.3625000
NODE_581_length_3146_cov_18.277322	2471	2551	7	21	80	0.2625000
NODE_581_length_3146_cov_18.277322	2471	2551	11	11	80	0.1375000
NODE_581_length_3146_cov_18.277322	2471	2551	14	4	80	0.0500000
NODE_581_length_3146_cov_18.277322	2471	2551	15	8	80	0.1000000
NODE_581_length_3146_cov_18.277322	2471	2551	18	7	80	0.0875000
NODE_581_length_3146_cov_18.277322	2547	2627	18	4	80	0.0500000
NODE_581_length_3146_cov_18.277322	2547	2627	20	10	80	0.1250000
NODE_581_length_3146_cov_18.277322	2547	2627	21	2	80	0.0250000
NODE_581_length_3146_cov_18.277322	2547	2627	22	9	80	0.1125000
NODE_581_length_3146_cov_18.277322	2547	2627	25	2	80	0.0250000
NODE_581_length_3146_cov_18.277322	2547	2627	26	5	80	0.0625000
NODE_581_length_3146_cov_18.277322	2547	2627	27	2	80	0.0250000
NODE_581_length_3146_cov_18.277322	2547	2627	28	2	80	0.0250000
NODE_581_length_3146_cov_18.277322	2547	2627	29	3	80	0.0375000
NODE_581_length_3146_cov_18.277322	2547	2627	30	2	80	0.0250000
NODE_581_length_3146_cov_18.277322	2547	2627	31	9	80	0.1125000
NODE_581_length_3146_cov_18.277322	2547	2627	32	2	80	0.0250000
NODE_581_length_3146_cov_18.277322	2547	2627	33	15	80	0.1875000
NODE_581_length_3146_cov_18.277322	2547	2627	34	8	80	0.1000000
NODE_581_length_3146_cov_18.277322	2547	2627	36	3	80	0.0375000
NODE_581_length_3146_cov_18.277322	2547	2627	37	2	80	0.0250000
NODE_581_length_3146_cov_18.277322	2600	2680	32	1	80	0.0125000
NODE_581_length_3146_cov_18.277322	2600	2680	33	13	80	0.1625000
NODE_581_length_3146_cov_18.277322	2600	2680	34	8	80	0.1000000
NODE_581_length_3146_cov_18.277322	2600	2680	36	6	80	0.0750000
NODE_581_length_3146_cov_18.277322	2600	2680	37	3	80	0.0375000
NODE_581_length_3146_cov_18.277322	2600	2680	38	5	80	0.0625000
NODE_581_length_3146_cov_18.277322	2600	2680	39	8	80	0.1000000
NODE_581_length_3146_cov_18.277322	2600	2680	41	15	80	0.1875000
NODE_581_length_3146_cov_18.277322	2600	2680	42	5	80	0.0625000
NODE_581_length_3146_cov_18.277322	2600	2680	43	11	80	0.1375000
NODE_581_length_3146_cov_18.277322	2600	2680	44	4	80	0.0500000
NODE_581_length_3146_cov_18.277322	2600	2680	45	1	80	0.0125000
NODE_581_length_3146_cov_18.277322	2975	3055	7	6	80	0.0750000
NODE_581_length_3146_cov_18.277322	2975	3055	8	1	80	0.0125000
NODE_581_length_3146_cov_18.277322	2975	3055	10	8	80	0.1000000
NODE_581_length_3146_cov_18.277322	2975	3055	11	41	80	0.5125000
NODE_581_length_3146_cov_18.277322	2975	3055	12	24	80	0.3000000
NODE_585_length_3134_cov_8.717957	1290	1362	26	7	72	0.0972222
NODE_585_length_3134_cov_8.717957	1290	1362	27	1	72	0.0138889
NODE_585_length_3134_cov_8.717957	1290	1362	28	3	72	0.0416667
NODE_585_length_3134_cov_8.717957	1290	1362	29	4	72	0.0555556
NODE_585_length_3134_cov_8.717957	1290	1362	30	4	72	0.0555556
NODE_585_length_3134_cov_8.717957	1290	1362	32	6	72	0.0833333
NODE_585_length_3134_cov_8.717957	1290	1362	33	3	72	0.0416667
NODE_585_length_3134_cov_8.717957	1290	1362	34	3	72	0.0416667
NODE_585_length_3134_cov_8.717957	1290	1362	35	2	72	0.0277778
NODE_585_length_3134_cov_8.717957	1290	1362	36	1	72	0.0138889
NODE_585_length_3134_cov_8.717957	1290	1362	37	1	72	0.0138889
NODE_585_length_3134_cov_8.717957	1290	1362	38	1	72	0.0138889
NODE_585_length_3134_cov_8.717957	1290	1362	39	9	72	0.1250000
NODE_585_length_3134_cov_8.717957	1290	1362	40	12	72	0.1666667
NODE_585_length_3134_cov_8.717957	1290	1362	42	1	72	0.0138889
NODE_585_length_3134_cov_8.717957	1290	1362	43	3	72	0.0416667
NODE_585_length_3134_cov_8.717957	1290	1362	44	1	72	0.0138889
NODE_585_length_3134_cov_8.717957	1290	1362	46	6	72	0.0833333
NODE_585_length_3134_cov_8.717957	1290	1362	47	3	72	0.0416667
NODE_585_length_3134_cov_8.717957	1290	1362	48	1	72	0.0138889
NODE_585_length_3134_cov_8.717957	1335	1415	40	12	80	0.1500000
NODE_585_length_3134_cov_8.717957	1335	1415	42	1	80	0.0125000
NODE_585_length_3134_cov_8.717957	1335	1415	43	3	80	0.0375000
NODE_585_length_3134_cov_8.717957	1335	1415	44	1	80	0.0125000
NODE_585_length_3134_cov_8.717957	1335	1415	46	6	80	0.0750000
NODE_585_length_3134_cov_8.717957	1335	1415	47	3	80	0.0375000
NODE_585_length_3134_cov_8.717957	1335	1415	48	1	80	0.0125000
NODE_585_length_3134_cov_8.717957	1335	1415	49	5	80	0.0625000
NODE_585_length_3134_cov_8.717957	1335	1415	50	6	80	0.0750000
NODE_585_length_3134_cov_8.717957	1335	1415	51	1	80	0.0125000
NODE_585_length_3134_cov_8.717957	1335	1415	52	2	80	0.0250000
NODE_585_length_3134_cov_8.717957	1335	1415	53	1	80	0.0125000
NODE_585_length_3134_cov_8.717957	1335	1415	54	1	80	0.0125000
NODE_585_length_3134_cov_8.717957	1335	1415	55	1	80	0.0125000
NODE_585_length_3134_cov_8.717957	1335	1415	56	5	80	0.0625000
NODE_585_length_3134_cov_8.717957	1335	1415	57	1	80	0.0125000
NODE_585_length_3134_cov_8.717957	1335	1415	59	2	80	0.0250000
NODE_585_length_3134_cov_8.717957	1335	1415	60	2	80	0.0250000
NODE_585_length_3134_cov_8.717957	1335	1415	61	3	80	0.0375000
NODE_585_length_3134_cov_8.717957	1335	1415	62	6	80	0.0750000
NODE_585_length_3134_cov_8.717957	1335	1415	63	1	80	0.0125000
NODE_585_length_3134_cov_8.717957	1335	1415	64	1	80	0.0125000
NODE_585_length_3134_cov_8.717957	1335	1415	65	1	80	0.0125000
NODE_585_length_3134_cov_8.717957	1335	1415	66	3	80	0.0375000
NODE_585_length_3134_cov_8.717957	1335	1415	67	5	80	0.0625000
NODE_585_length_3134_cov_8.717957	1335	1415	68	3	80	0.0375000
NODE_585_length_3134_cov_8.717957	1335	1415	69	1	80	0.0125000
NODE_585_length_3134_cov_8.717957	1335	1415	70	2	80	0.0250000
NODE_586_length_3131_cov_26.910620	232	312	5	35	80	0.4375000
NODE_586_length_3131_cov_26.910620	232	312	6	45	80	0.5625000
NODE_586_length_3131_cov_26.910620	285	364	4	1	79	0.0126582
NODE_586_length_3131_cov_26.910620	285	364	5	26	79	0.3291139
NODE_586_length_3131_cov_26.910620	285	364	6	28	79	0.3544304
NODE_586_length_3131_cov_26.910620	285	364	7	24	79	0.3037975
NODE_586_length_3131_cov_26.910620	2151	2231	0	80	80	1.0000000
NODE_586_length_3131_cov_26.910620	2155	2227	0	72	72	1.0000000
NODE_586_length_3131_cov_26.910620	2204	2284	0	80	80	1.0000000
NODE_586_length_3131_cov_26.910620	2208	2284	0	76	76	1.0000000
NODE_586_length_3131_cov_26.910620	2280	2360	0	27	80	0.3375000
NODE_586_length_3131_cov_26.910620	2280	2360	1	46	80	0.5750000
NODE_586_length_3131_cov_26.910620	2280	2360	2	7	80	0.0875000
NODE_586_length_3131_cov_26.910620	2333	2413	1	20	80	0.2500000
NODE_586_length_3131_cov_26.910620	2333	2413	2	40	80	0.5000000
NODE_586_length_3131_cov_26.910620	2333	2413	3	20	80	0.2500000
NODE_590_length_3118_cov_5.059622	367	445	1	2	78	0.0256410
NODE_590_length_3118_cov_5.059622	367	445	2	1	78	0.0128205
NODE_590_length_3118_cov_5.059622	367	445	3	58	78	0.7435898
NODE_590_length_3118_cov_5.059622	367	445	4	2	78	0.0256410
NODE_590_length_3118_cov_5.059622	367	445	5	9	78	0.1153846
NODE_590_length_3118_cov_5.059622	367	445	6	6	78	0.0769231
NODE_590_length_3118_cov_5.059622	418	498	3	10	80	0.1250000
NODE_590_length_3118_cov_5.059622	418	498	4	2	80	0.0250000
NODE_590_length_3118_cov_5.059622	418	498	5	34	80	0.4250000
NODE_590_length_3118_cov_5.059622	418	498	6	34	80	0.4250000
NODE_591_length_3117_cov_5.938038	2525	2605	0	21	80	0.2625000
NODE_591_length_3117_cov_5.938038	2525	2605	2	5	80	0.0625000
NODE_591_length_3117_cov_5.938038	2525	2605	4	7	80	0.0875000
NODE_591_length_3117_cov_5.938038	2525	2605	5	37	80	0.4625000
NODE_591_length_3117_cov_5.938038	2525	2605	6	10	80	0.1250000
NODE_591_length_3117_cov_5.938038	2578	2658	5	17	80	0.2125000
NODE_591_length_3117_cov_5.938038	2578	2658	6	63	80	0.7875000
NODE_595_length_3110_cov_31.733643	2864	2923	1	2	59	0.0338983
NODE_595_length_3110_cov_31.733643	2864	2923	3	6	59	0.1016949
NODE_595_length_3110_cov_31.733643	2864	2923	4	4	59	0.0677966
NODE_595_length_3110_cov_31.733643	2864	2923	6	6	59	0.1016949
NODE_595_length_3110_cov_31.733643	2864	2923	7	39	59	0.6610169
NODE_595_length_3110_cov_31.733643	2864	2923	8	2	59	0.0338983
NODE_602_length_3093_cov_54.559786	571	651	1	46	80	0.5750000
NODE_602_length_3093_cov_54.559786	571	651	2	34	80	0.4250000
NODE_602_length_3093_cov_54.559786	624	704	0	5	80	0.0625000
NODE_602_length_3093_cov_54.559786	624	704	2	75	80	0.9375000
NODE_602_length_3093_cov_54.559786	2901	2981	79	2	80	0.0250000
NODE_602_length_3093_cov_54.559786	2901	2981	80	1	80	0.0125000
NODE_602_length_3093_cov_54.559786	2901	2981	81	1	80	0.0125000
NODE_602_length_3093_cov_54.559786	2901	2981	83	1	80	0.0125000
NODE_602_length_3093_cov_54.559786	2901	2981	87	1	80	0.0125000
NODE_602_length_3093_cov_54.559786	2901	2981	88	3	80	0.0375000
NODE_602_length_3093_cov_54.559786	2901	2981	89	1	80	0.0125000
NODE_602_length_3093_cov_54.559786	2901	2981	90	1	80	0.0125000
NODE_602_length_3093_cov_54.559786	2901	2981	92	3	80	0.0375000
NODE_602_length_3093_cov_54.559786	2901	2981	93	1	80	0.0125000
NODE_602_length_3093_cov_54.559786	2901	2981	96	4	80	0.0500000
NODE_602_length_3093_cov_54.559786	2901	2981	98	2	80	0.0250000
NODE_602_length_3093_cov_54.559786	2901	2981	99	2	80	0.0250000
NODE_602_length_3093_cov_54.559786	2901	2981	101	2	80	0.0250000
NODE_602_length_3093_cov_54.559786	2901	2981	102	1	80	0.0125000
NODE_602_length_3093_cov_54.559786	2901	2981	108	1	80	0.0125000
NODE_602_length_3093_cov_54.559786	2901	2981	109	2	80	0.0250000
NODE_602_length_3093_cov_54.559786	2901	2981	110	3	80	0.0375000
NODE_602_length_3093_cov_54.559786	2901	2981	113	2	80	0.0250000
NODE_602_length_3093_cov_54.559786	2901	2981	116	5	80	0.0625000
NODE_602_length_3093_cov_54.559786	2901	2981	118	1	80	0.0125000
NODE_602_length_3093_cov_54.559786	2901	2981	119	2	80	0.0250000
NODE_602_length_3093_cov_54.559786	2901	2981	121	1	80	0.0125000
NODE_602_length_3093_cov_54.559786	2901	2981	122	1	80	0.0125000
NODE_602_length_3093_cov_54.559786	2901	2981	124	1	80	0.0125000
NODE_602_length_3093_cov_54.559786	2901	2981	125	1	80	0.0125000
NODE_602_length_3093_cov_54.559786	2901	2981	127	3	80	0.0375000
NODE_602_length_3093_cov_54.559786	2901	2981	128	1	80	0.0125000
NODE_602_length_3093_cov_54.559786	2901	2981	130	12	80	0.1500000
NODE_602_length_3093_cov_54.559786	2901	2981	132	16	80	0.2000000
NODE_602_length_3093_cov_54.559786	2901	2981	134	2	80	0.0250000
NODE_602_length_3093_cov_54.559786	2954	3034	60	1	80	0.0125000
NODE_602_length_3093_cov_54.559786	2954	3034	61	1	80	0.0125000
NODE_602_length_3093_cov_54.559786	2954	3034	62	1	80	0.0125000
NODE_602_length_3093_cov_54.559786	2954	3034	64	1	80	0.0125000
NODE_602_length_3093_cov_54.559786	2954	3034	65	1	80	0.0125000
NODE_602_length_3093_cov_54.559786	2954	3034	69	1	80	0.0125000
NODE_602_length_3093_cov_54.559786	2954	3034	75	1	80	0.0125000
NODE_602_length_3093_cov_54.559786	2954	3034	81	2	80	0.0250000
NODE_602_length_3093_cov_54.559786	2954	3034	82	1	80	0.0125000
NODE_602_length_3093_cov_54.559786	2954	3034	83	1	80	0.0125000
NODE_602_length_3093_cov_54.559786	2954	3034	87	1	80	0.0125000
NODE_602_length_3093_cov_54.559786	2954	3034	90	1	80	0.0125000
NODE_602_length_3093_cov_54.559786	2954	3034	93	2	80	0.0250000
NODE_602_length_3093_cov_54.559786	2954	3034	98	1	80	0.0125000
NODE_602_length_3093_cov_54.559786	2954	3034	99	2	80	0.0250000
NODE_602_length_3093_cov_54.559786	2954	3034	101	1	80	0.0125000
NODE_602_length_3093_cov_54.559786	2954	3034	103	1	80	0.0125000
NODE_602_length_3093_cov_54.559786	2954	3034	105	1	80	0.0125000
NODE_602_length_3093_cov_54.559786	2954	3034	109	1	80	0.0125000
NODE_602_length_3093_cov_54.559786	2954	3034	110	1	80	0.0125000
NODE_602_length_3093_cov_54.559786	2954	3034	111	9	80	0.1125000
NODE_602_length_3093_cov_54.559786	2954	3034	112	1	80	0.0125000
NODE_602_length_3093_cov_54.559786	2954	3034	113	2	80	0.0250000
NODE_602_length_3093_cov_54.559786	2954	3034	114	1	80	0.0125000
NODE_602_length_3093_cov_54.559786	2954	3034	117	1	80	0.0125000
NODE_602_length_3093_cov_54.559786	2954	3034	120	6	80	0.0750000
NODE_602_length_3093_cov_54.559786	2954	3034	122	1	80	0.0125000
NODE_602_length_3093_cov_54.559786	2954	3034	126	3	80	0.0375000
NODE_602_length_3093_cov_54.559786	2954	3034	129	1	80	0.0125000
NODE_602_length_3093_cov_54.559786	2954	3034	130	14	80	0.1750000
NODE_602_length_3093_cov_54.559786	2954	3034	132	16	80	0.2000000
NODE_602_length_3093_cov_54.559786	2954	3034	134	2	80	0.0250000
NODE_603_length_3091_cov_35.895722	1743	1804	2	33	61	0.5409836
NODE_603_length_3091_cov_35.895722	1743	1804	3	27	61	0.4426230
NODE_603_length_3091_cov_35.895722	1743	1804	4	1	61	0.0163934
NODE_603_length_3091_cov_35.895722	1777	1857	2	31	80	0.3875000
NODE_603_length_3091_cov_35.895722	1777	1857	3	49	80	0.6125000
NODE_603_length_3091_cov_35.895722	2472	2535	10	23	63	0.3650794
NODE_603_length_3091_cov_35.895722	2472	2535	14	40	63	0.6349207
NODE_603_length_3091_cov_35.895722	2508	2553	9	8	45	0.1777778
NODE_603_length_3091_cov_35.895722	2508	2553	10	28	45	0.6222222
NODE_603_length_3091_cov_35.895722	2508	2553	11	5	45	0.1111111
NODE_603_length_3091_cov_35.895722	2508	2553	14	4	45	0.0888889
NODE_603_length_3091_cov_35.895722	2534	2604	8	8	70	0.1142857
NODE_603_length_3091_cov_35.895722	2534	2604	9	14	70	0.2000000
NODE_603_length_3091_cov_35.895722	2534	2604	10	13	70	0.1857143
NODE_603_length_3091_cov_35.895722	2534	2604	11	32	70	0.4571429
NODE_603_length_3091_cov_35.895722	2534	2604	12	3	70	0.0428571
NODE_603_length_3091_cov_35.895722	2578	2618	7	3	40	0.0750000
NODE_603_length_3091_cov_35.895722	2578	2618	8	19	40	0.4750000
NODE_603_length_3091_cov_35.895722	2578	2618	9	1	40	0.0250000
NODE_603_length_3091_cov_35.895722	2578	2618	10	7	40	0.1750000
NODE_603_length_3091_cov_35.895722	2578	2618	11	7	40	0.1750000
NODE_603_length_3091_cov_35.895722	2578	2618	12	3	40	0.0750000
NODE_603_length_3091_cov_35.895722	2586	2623	7	4	37	0.1081081
NODE_603_length_3091_cov_35.895722	2586	2623	8	23	37	0.6216216
NODE_603_length_3091_cov_35.895722	2586	2623	9	1	37	0.0270270
NODE_603_length_3091_cov_35.895722	2586	2623	10	7	37	0.1891892
NODE_603_length_3091_cov_35.895722	2586	2623	11	1	37	0.0270270
NODE_603_length_3091_cov_35.895722	2586	2623	12	1	37	0.0270270
NODE_603_length_3091_cov_35.895722	2626	2671	5	19	45	0.4222222
NODE_603_length_3091_cov_35.895722	2626	2671	7	7	45	0.1555556
NODE_603_length_3091_cov_35.895722	2626	2671	9	15	45	0.3333333
NODE_603_length_3091_cov_35.895722	2626	2671	10	4	45	0.0888889
NODE_603_length_3091_cov_35.895722	2682	2730	7	35	48	0.7291667
NODE_603_length_3091_cov_35.895722	2682	2730	9	13	48	0.2708333
NODE_603_length_3091_cov_35.895722	2918	2969	0	51	51	1.0000000
NODE_603_length_3091_cov_35.895722	2942	2987	0	45	45	1.0000000
NODE_603_length_3091_cov_35.895722	2994	3039	0	45	45	1.0000000
NODE_607_length_3079_cov_7.081879	2340	2420	10	2	80	0.0250000
NODE_607_length_3079_cov_7.081879	2340	2420	12	29	80	0.3625000
NODE_607_length_3079_cov_7.081879	2340	2420	13	4	80	0.0500000
NODE_607_length_3079_cov_7.081879	2340	2420	14	45	80	0.5625000
NODE_607_length_3079_cov_7.081879	2886	2938	19	18	52	0.3461539
NODE_607_length_3079_cov_7.081879	2886	2938	20	2	52	0.0384615
NODE_607_length_3079_cov_7.081879	2886	2938	21	18	52	0.3461539
NODE_607_length_3079_cov_7.081879	2886	2938	22	1	52	0.0192308
NODE_607_length_3079_cov_7.081879	2886	2938	23	2	52	0.0384615
NODE_607_length_3079_cov_7.081879	2886	2938	25	5	52	0.0961538
NODE_607_length_3079_cov_7.081879	2886	2938	27	2	52	0.0384615
NODE_607_length_3079_cov_7.081879	2886	2938	28	3	52	0.0576923
NODE_607_length_3079_cov_7.081879	2886	2938	29	1	52	0.0192308
NODE_607_length_3079_cov_7.081879	2893	2959	19	18	66	0.2727273
NODE_607_length_3079_cov_7.081879	2893	2959	20	2	66	0.0303030
NODE_607_length_3079_cov_7.081879	2893	2959	21	11	66	0.1666667
NODE_607_length_3079_cov_7.081879	2893	2959	22	1	66	0.0151515
NODE_607_length_3079_cov_7.081879	2893	2959	23	2	66	0.0303030
NODE_607_length_3079_cov_7.081879	2893	2959	25	5	66	0.0757576
NODE_607_length_3079_cov_7.081879	2893	2959	27	2	66	0.0303030
NODE_607_length_3079_cov_7.081879	2893	2959	28	3	66	0.0454545
NODE_607_length_3079_cov_7.081879	2893	2959	29	7	66	0.1060606
NODE_607_length_3079_cov_7.081879	2893	2959	30	8	66	0.1212121
NODE_607_length_3079_cov_7.081879	2893	2959	31	4	66	0.0606061
NODE_607_length_3079_cov_7.081879	2893	2959	32	3	66	0.0454545
NODE_607_length_3079_cov_7.081879	2932	2993	25	3	61	0.0491803
NODE_607_length_3079_cov_7.081879	2932	2993	27	2	61	0.0327869
NODE_607_length_3079_cov_7.081879	2932	2993	28	28	61	0.4590164
NODE_607_length_3079_cov_7.081879	2932	2993	29	7	61	0.1147541
NODE_607_length_3079_cov_7.081879	2932	2993	30	8	61	0.1311475
NODE_607_length_3079_cov_7.081879	2932	2993	31	4	61	0.0655738
NODE_607_length_3079_cov_7.081879	2932	2993	32	9	61	0.1475410
NODE_607_length_3079_cov_7.081879	2932	2995	25	5	63	0.0793651
NODE_607_length_3079_cov_7.081879	2932	2995	27	2	63	0.0317460
NODE_607_length_3079_cov_7.081879	2932	2995	28	28	63	0.4444444
NODE_607_length_3079_cov_7.081879	2932	2995	29	7	63	0.1111111
NODE_607_length_3079_cov_7.081879	2932	2995	30	8	63	0.1269841
NODE_607_length_3079_cov_7.081879	2932	2995	31	4	63	0.0634921
NODE_607_length_3079_cov_7.081879	2932	2995	32	9	63	0.1428571
NODE_607_length_3079_cov_7.081879	2932	2995	25	5	63	0.0793651
NODE_607_length_3079_cov_7.081879	2932	2995	27	2	63	0.0317460
NODE_607_length_3079_cov_7.081879	2932	2995	28	28	63	0.4444444
NODE_607_length_3079_cov_7.081879	2932	2995	29	7	63	0.1111111
NODE_607_length_3079_cov_7.081879	2932	2995	30	8	63	0.1269841
NODE_607_length_3079_cov_7.081879	2932	2995	31	4	63	0.0634921
NODE_607_length_3079_cov_7.081879	2932	2995	32	9	63	0.1428571
NODE_608_length_3077_cov_23.535259	1244	1321	0	26	77	0.3376623
NODE_608_length_3077_cov_23.535259	1244	1321	1	30	77	0.3896104
NODE_608_length_3077_cov_23.535259	1244	1321	2	1	77	0.0129870
NODE_608_length_3077_cov_23.535259	1244	1321	3	20	77	0.2597403
NODE_608_length_3077_cov_23.535259	1911	1991	2	80	80	1.0000000
NODE_608_length_3077_cov_23.535259	1964	2016	2	52	52	1.0000000
NODE_608_length_3077_cov_23.535259	2028	2114	1	40	86	0.4651163
NODE_608_length_3077_cov_23.535259	2028	2114	2	23	86	0.2674419
NODE_608_length_3077_cov_23.535259	2028	2114	3	23	86	0.2674419
NODE_609_length_3077_cov_8.693083	1157	1237	1	28	80	0.3500000
NODE_609_length_3077_cov_8.693083	1157	1237	2	13	80	0.1625000
NODE_609_length_3077_cov_8.693083	1157	1237	3	2	80	0.0250000
NODE_609_length_3077_cov_8.693083	1157	1237	4	4	80	0.0500000
NODE_609_length_3077_cov_8.693083	1157	1237	6	8	80	0.1000000
NODE_609_length_3077_cov_8.693083	1157	1237	7	4	80	0.0500000
NODE_609_length_3077_cov_8.693083	1157	1237	9	3	80	0.0375000
NODE_609_length_3077_cov_8.693083	1157	1237	10	6	80	0.0750000
NODE_609_length_3077_cov_8.693083	1157	1237	12	1	80	0.0125000
NODE_609_length_3077_cov_8.693083	1157	1237	13	1	80	0.0125000
NODE_609_length_3077_cov_8.693083	1157	1237	14	5	80	0.0625000
NODE_609_length_3077_cov_8.693083	1157	1237	15	2	80	0.0250000
NODE_609_length_3077_cov_8.693083	1157	1237	16	3	80	0.0375000
NODE_609_length_3077_cov_8.693083	1161	1184	1	23	23	1.0000000
NODE_609_length_3077_cov_8.693083	1233	1313	15	1	80	0.0125000
NODE_609_length_3077_cov_8.693083	1233	1313	16	6	80	0.0750000
NODE_609_length_3077_cov_8.693083	1233	1313	17	1	80	0.0125000
NODE_609_length_3077_cov_8.693083	1233	1313	19	6	80	0.0750000
NODE_609_length_3077_cov_8.693083	1233	1313	20	6	80	0.0750000
NODE_609_length_3077_cov_8.693083	1233	1313	21	2	80	0.0250000
NODE_609_length_3077_cov_8.693083	1233	1313	23	4	80	0.0500000
NODE_609_length_3077_cov_8.693083	1233	1313	24	5	80	0.0625000
NODE_609_length_3077_cov_8.693083	1233	1313	25	5	80	0.0625000
NODE_609_length_3077_cov_8.693083	1233	1313	26	1	80	0.0125000
NODE_609_length_3077_cov_8.693083	1233	1313	27	1	80	0.0125000
NODE_609_length_3077_cov_8.693083	1233	1313	31	3	80	0.0375000
NODE_609_length_3077_cov_8.693083	1233	1313	32	1	80	0.0125000
NODE_609_length_3077_cov_8.693083	1233	1313	33	3	80	0.0375000
NODE_609_length_3077_cov_8.693083	1233	1313	34	9	80	0.1125000
NODE_609_length_3077_cov_8.693083	1233	1313	35	2	80	0.0250000
NODE_609_length_3077_cov_8.693083	1233	1313	36	2	80	0.0250000
NODE_609_length_3077_cov_8.693083	1233	1313	37	1	80	0.0125000
NODE_609_length_3077_cov_8.693083	1233	1313	40	9	80	0.1125000
NODE_609_length_3077_cov_8.693083	1233	1313	41	1	80	0.0125000
NODE_609_length_3077_cov_8.693083	1233	1313	42	3	80	0.0375000
NODE_609_length_3077_cov_8.693083	1233	1313	43	8	80	0.1000000
NODE_609_length_3077_cov_8.693083	1286	1352	34	1	66	0.0151515
NODE_609_length_3077_cov_8.693083	1286	1352	35	2	66	0.0303030
NODE_609_length_3077_cov_8.693083	1286	1352	36	2	66	0.0303030
NODE_609_length_3077_cov_8.693083	1286	1352	37	1	66	0.0151515
NODE_609_length_3077_cov_8.693083	1286	1352	40	9	66	0.1363636
NODE_609_length_3077_cov_8.693083	1286	1352	41	1	66	0.0151515
NODE_609_length_3077_cov_8.693083	1286	1352	42	3	66	0.0454545
NODE_609_length_3077_cov_8.693083	1286	1352	43	12	66	0.1818182
NODE_609_length_3077_cov_8.693083	1286	1352	44	3	66	0.0454545
NODE_609_length_3077_cov_8.693083	1286	1352	45	6	66	0.0909091
NODE_609_length_3077_cov_8.693083	1286	1352	46	1	66	0.0151515
NODE_609_length_3077_cov_8.693083	1286	1352	47	6	66	0.0909091
NODE_609_length_3077_cov_8.693083	1286	1352	48	2	66	0.0303030
NODE_609_length_3077_cov_8.693083	1286	1352	49	8	66	0.1212121
NODE_609_length_3077_cov_8.693083	1286	1352	50	6	66	0.0909091
NODE_609_length_3077_cov_8.693083	1286	1352	52	3	66	0.0454545
NODE_609_length_3077_cov_8.693083	2672	2757	4	25	85	0.2941177
NODE_609_length_3077_cov_8.693083	2672	2757	5	2	85	0.0235294
NODE_609_length_3077_cov_8.693083	2672	2757	6	8	85	0.0941176
NODE_609_length_3077_cov_8.693083	2672	2757	7	8	85	0.0941176
NODE_609_length_3077_cov_8.693083	2672	2757	8	13	85	0.1529412
NODE_609_length_3077_cov_8.693083	2672	2757	10	7	85	0.0823529
NODE_609_length_3077_cov_8.693083	2672	2757	11	1	85	0.0117647
NODE_609_length_3077_cov_8.693083	2672	2757	12	2	85	0.0235294
NODE_609_length_3077_cov_8.693083	2672	2757	14	10	85	0.1176471
NODE_609_length_3077_cov_8.693083	2672	2757	15	9	85	0.1058824
NODE_611_length_3074_cov_2.996303	2561	2629	29	2	68	0.0294118
NODE_611_length_3074_cov_2.996303	2561	2629	30	1	68	0.0147059
NODE_611_length_3074_cov_2.996303	2561	2629	32	1	68	0.0147059
NODE_611_length_3074_cov_2.996303	2561	2629	33	1	68	0.0147059
NODE_611_length_3074_cov_2.996303	2561	2629	35	4	68	0.0588235
NODE_611_length_3074_cov_2.996303	2561	2629	40	1	68	0.0147059
NODE_611_length_3074_cov_2.996303	2561	2629	41	1	68	0.0147059
NODE_611_length_3074_cov_2.996303	2561	2629	44	2	68	0.0294118
NODE_611_length_3074_cov_2.996303	2561	2629	46	1	68	0.0147059
NODE_611_length_3074_cov_2.996303	2561	2629	49	1	68	0.0147059
NODE_611_length_3074_cov_2.996303	2561	2629	51	2	68	0.0294118
NODE_611_length_3074_cov_2.996303	2561	2629	52	3	68	0.0441176
NODE_611_length_3074_cov_2.996303	2561	2629	54	1	68	0.0147059
NODE_611_length_3074_cov_2.996303	2561	2629	60	1	68	0.0147059
NODE_611_length_3074_cov_2.996303	2561	2629	61	2	68	0.0294118
NODE_611_length_3074_cov_2.996303	2561	2629	64	2	68	0.0294118
NODE_611_length_3074_cov_2.996303	2561	2629	67	1	68	0.0147059
NODE_611_length_3074_cov_2.996303	2561	2629	68	1	68	0.0147059
NODE_611_length_3074_cov_2.996303	2561	2629	70	1	68	0.0147059
NODE_611_length_3074_cov_2.996303	2561	2629	72	1	68	0.0147059
NODE_611_length_3074_cov_2.996303	2561	2629	73	2	68	0.0294118
NODE_611_length_3074_cov_2.996303	2561	2629	75	2	68	0.0294118
NODE_611_length_3074_cov_2.996303	2561	2629	76	2	68	0.0294118
NODE_611_length_3074_cov_2.996303	2561	2629	79	1	68	0.0147059
NODE_611_length_3074_cov_2.996303	2561	2629	86	1	68	0.0147059
NODE_611_length_3074_cov_2.996303	2561	2629	91	1	68	0.0147059
NODE_611_length_3074_cov_2.996303	2561	2629	93	1	68	0.0147059
NODE_611_length_3074_cov_2.996303	2561	2629	97	2	68	0.0294118
NODE_611_length_3074_cov_2.996303	2561	2629	98	1	68	0.0147059
NODE_611_length_3074_cov_2.996303	2561	2629	101	1	68	0.0147059
NODE_611_length_3074_cov_2.996303	2561	2629	102	1	68	0.0147059
NODE_611_length_3074_cov_2.996303	2561	2629	104	1	68	0.0147059
NODE_611_length_3074_cov_2.996303	2561	2629	106	1	68	0.0147059
NODE_611_length_3074_cov_2.996303	2561	2629	109	1	68	0.0147059
NODE_611_length_3074_cov_2.996303	2561	2629	112	1	68	0.0147059
NODE_611_length_3074_cov_2.996303	2561	2629	115	2	68	0.0294118
NODE_611_length_3074_cov_2.996303	2561	2629	117	1	68	0.0147059
NODE_611_length_3074_cov_2.996303	2561	2629	118	1	68	0.0147059
NODE_611_length_3074_cov_2.996303	2561	2629	121	1	68	0.0147059
NODE_611_length_3074_cov_2.996303	2561	2629	122	2	68	0.0294118
NODE_611_length_3074_cov_2.996303	2561	2629	123	1	68	0.0147059
NODE_611_length_3074_cov_2.996303	2561	2629	124	2	68	0.0294118
NODE_611_length_3074_cov_2.996303	2561	2629	130	1	68	0.0147059
NODE_611_length_3074_cov_2.996303	2561	2629	132	2	68	0.0294118
NODE_611_length_3074_cov_2.996303	2561	2629	133	1	68	0.0147059
NODE_611_length_3074_cov_2.996303	2561	2629	136	1	68	0.0147059
NODE_611_length_3074_cov_2.996303	2561	2629	137	1	68	0.0147059
NODE_611_length_3074_cov_2.996303	2561	2629	139	1	68	0.0147059
NODE_611_length_3074_cov_2.996303	2561	2629	140	1	68	0.0147059
NODE_611_length_3074_cov_2.996303	2561	2629	142	1	68	0.0147059
NODE_615_length_3069_cov_2.448822	2948	2991	0	43	43	1.0000000
NODE_616_length_3059_cov_20.037500	346	426	10	2	80	0.0250000
NODE_616_length_3059_cov_20.037500	346	426	12	12	80	0.1500000
NODE_616_length_3059_cov_20.037500	346	426	13	7	80	0.0875000
NODE_616_length_3059_cov_20.037500	346	426	14	4	80	0.0500000
NODE_616_length_3059_cov_20.037500	346	426	15	1	80	0.0125000
NODE_616_length_3059_cov_20.037500	346	426	16	9	80	0.1125000
NODE_616_length_3059_cov_20.037500	346	426	17	28	80	0.3500000
NODE_616_length_3059_cov_20.037500	346	426	18	3	80	0.0375000
NODE_616_length_3059_cov_20.037500	346	426	19	14	80	0.1750000
NODE_616_length_3059_cov_20.037500	399	479	11	2	80	0.0250000
NODE_616_length_3059_cov_20.037500	399	479	12	7	80	0.0875000
NODE_616_length_3059_cov_20.037500	399	479	13	13	80	0.1625000
NODE_616_length_3059_cov_20.037500	399	479	15	12	80	0.1500000
NODE_616_length_3059_cov_20.037500	399	479	17	29	80	0.3625000
NODE_616_length_3059_cov_20.037500	399	479	18	3	80	0.0375000
NODE_616_length_3059_cov_20.037500	399	479	19	14	80	0.1750000
NODE_616_length_3059_cov_20.037500	1317	1397	5	6	80	0.0750000
NODE_616_length_3059_cov_20.037500	1317	1397	6	13	80	0.1625000
NODE_616_length_3059_cov_20.037500	1317	1397	7	34	80	0.4250000
NODE_616_length_3059_cov_20.037500	1317	1397	8	15	80	0.1875000
NODE_616_length_3059_cov_20.037500	1317	1397	9	1	80	0.0125000
NODE_616_length_3059_cov_20.037500	1317	1397	10	11	80	0.1375000
NODE_616_length_3059_cov_20.037500	1370	1447	4	7	77	0.0909091
NODE_616_length_3059_cov_20.037500	1370	1447	6	43	77	0.5584416
NODE_616_length_3059_cov_20.037500	1370	1447	7	18	77	0.2337662
NODE_616_length_3059_cov_20.037500	1370	1447	8	4	77	0.0519481
NODE_616_length_3059_cov_20.037500	1370	1447	10	5	77	0.0649351
NODE_616_length_3059_cov_20.037500	2514	2594	5	9	80	0.1125000
NODE_616_length_3059_cov_20.037500	2514	2594	6	7	80	0.0875000
NODE_616_length_3059_cov_20.037500	2514	2594	9	13	80	0.1625000
NODE_616_length_3059_cov_20.037500	2514	2594	10	31	80	0.3875000
NODE_616_length_3059_cov_20.037500	2514	2594	11	20	80	0.2500000
NODE_616_length_3059_cov_20.037500	2567	2647	8	11	80	0.1375000
NODE_616_length_3059_cov_20.037500	2567	2647	9	1	80	0.0125000
NODE_616_length_3059_cov_20.037500	2567	2647	10	23	80	0.2875000
NODE_616_length_3059_cov_20.037500	2567	2647	11	45	80	0.5625000
NODE_617_length_3058_cov_21.767489	2802	2882	4	1	80	0.0125000
NODE_617_length_3058_cov_21.767489	2802	2882	5	5	80	0.0625000
NODE_617_length_3058_cov_21.767489	2802	2882	6	3	80	0.0375000
NODE_617_length_3058_cov_21.767489	2802	2882	7	6	80	0.0750000
NODE_617_length_3058_cov_21.767489	2802	2882	8	11	80	0.1375000
NODE_617_length_3058_cov_21.767489	2802	2882	9	4	80	0.0500000
NODE_617_length_3058_cov_21.767489	2802	2882	10	6	80	0.0750000
NODE_617_length_3058_cov_21.767489	2802	2882	11	6	80	0.0750000
NODE_617_length_3058_cov_21.767489	2802	2882	12	12	80	0.1500000
NODE_617_length_3058_cov_21.767489	2802	2882	13	25	80	0.3125000
NODE_617_length_3058_cov_21.767489	2802	2882	15	1	80	0.0125000
NODE_617_length_3058_cov_21.767489	2855	2930	12	2	75	0.0266667
NODE_617_length_3058_cov_21.767489	2855	2930	13	43	75	0.5733333
NODE_617_length_3058_cov_21.767489	2855	2930	14	19	75	0.2533333
NODE_617_length_3058_cov_21.767489	2855	2930	15	11	75	0.1466667
NODE_621_length_3047_cov_47.232361	418	489	0	71	71	1.0000000
NODE_621_length_3047_cov_47.232361	758	801	9	3	43	0.0697674
NODE_621_length_3047_cov_47.232361	758	801	10	3	43	0.0697674
NODE_621_length_3047_cov_47.232361	758	801	11	2	43	0.0465116
NODE_621_length_3047_cov_47.232361	758	801	12	1	43	0.0232558
NODE_621_length_3047_cov_47.232361	758	801	13	3	43	0.0697674
NODE_621_length_3047_cov_47.232361	758	801	15	1	43	0.0232558
NODE_621_length_3047_cov_47.232361	758	801	17	2	43	0.0465116
NODE_621_length_3047_cov_47.232361	758	801	18	5	43	0.1162791
NODE_621_length_3047_cov_47.232361	758	801	19	2	43	0.0465116
NODE_621_length_3047_cov_47.232361	758	801	20	4	43	0.0930233
NODE_621_length_3047_cov_47.232361	758	801	25	11	43	0.2558140
NODE_621_length_3047_cov_47.232361	758	801	28	1	43	0.0232558
NODE_621_length_3047_cov_47.232361	758	801	31	5	43	0.1162791
NODE_623_length_3044_cov_38.951783	1702	1782	0	3	80	0.0375000
NODE_623_length_3044_cov_38.951783	1702	1782	2	77	80	0.9625000
NODE_623_length_3044_cov_38.951783	1755	1835	0	11	80	0.1375000
NODE_623_length_3044_cov_38.951783	1755	1835	1	34	80	0.4250000
NODE_623_length_3044_cov_38.951783	1755	1835	2	35	80	0.4375000
NODE_623_length_3044_cov_38.951783	1831	1911	0	22	80	0.2750000
NODE_623_length_3044_cov_38.951783	1831	1911	2	58	80	0.7250000
NODE_623_length_3044_cov_38.951783	1884	1964	0	7	80	0.0875000
NODE_623_length_3044_cov_38.951783	1884	1964	2	73	80	0.9125000
NODE_623_length_3044_cov_38.951783	2556	2636	0	12	80	0.1500000
NODE_623_length_3044_cov_38.951783	2556	2636	2	68	80	0.8500000
NODE_623_length_3044_cov_38.951783	2609	2689	0	31	80	0.3875000
NODE_623_length_3044_cov_38.951783	2609	2689	2	49	80	0.6125000
NODE_625_length_3039_cov_3.258163	261	337	4	1	76	0.0131579
NODE_625_length_3039_cov_3.258163	261	337	5	29	76	0.3815790
NODE_625_length_3039_cov_3.258163	261	337	6	33	76	0.4342105
NODE_625_length_3039_cov_3.258163	261	337	7	2	76	0.0263158
NODE_625_length_3039_cov_3.258163	261	337	8	11	76	0.1447368
NODE_625_length_3039_cov_3.258163	261	336	4	1	75	0.0133333
NODE_625_length_3039_cov_3.258163	261	336	5	28	75	0.3733333
NODE_625_length_3039_cov_3.258163	261	336	6	33	75	0.4400000
NODE_625_length_3039_cov_3.258163	261	336	7	2	75	0.0266667
NODE_625_length_3039_cov_3.258163	261	336	8	11	75	0.1466667
NODE_625_length_3039_cov_3.258163	261	337	4	1	76	0.0131579
NODE_625_length_3039_cov_3.258163	261	337	5	29	76	0.3815790
NODE_625_length_3039_cov_3.258163	261	337	6	33	76	0.4342105
NODE_625_length_3039_cov_3.258163	261	337	7	2	76	0.0263158
NODE_625_length_3039_cov_3.258163	261	337	8	11	76	0.1447368
NODE_625_length_3039_cov_3.258163	270	337	5	28	67	0.4179105
NODE_625_length_3039_cov_3.258163	270	337	6	26	67	0.3880597
NODE_625_length_3039_cov_3.258163	270	337	7	2	67	0.0298507
NODE_625_length_3039_cov_3.258163	270	337	8	11	67	0.1641791
NODE_627_length_3036_cov_8.968676	2303	2367	1	43	64	0.6718750
NODE_627_length_3036_cov_8.968676	2303	2367	2	14	64	0.2187500
NODE_627_length_3036_cov_8.968676	2303	2367	4	7	64	0.1093750
NODE_627_length_3036_cov_8.968676	2340	2420	1	6	80	0.0750000
NODE_627_length_3036_cov_8.968676	2340	2420	2	14	80	0.1750000
NODE_627_length_3036_cov_8.968676	2340	2420	3	25	80	0.3125000
NODE_627_length_3036_cov_8.968676	2340	2420	4	18	80	0.2250000
NODE_627_length_3036_cov_8.968676	2340	2420	5	11	80	0.1375000
NODE_627_length_3036_cov_8.968676	2340	2420	6	6	80	0.0750000
NODE_627_length_3036_cov_8.968676	2416	2496	6	7	80	0.0875000
NODE_627_length_3036_cov_8.968676	2416	2496	7	18	80	0.2250000
NODE_627_length_3036_cov_8.968676	2416	2496	8	3	80	0.0375000
NODE_627_length_3036_cov_8.968676	2416	2496	9	15	80	0.1875000
NODE_627_length_3036_cov_8.968676	2416	2496	10	12	80	0.1500000
NODE_627_length_3036_cov_8.968676	2416	2496	11	25	80	0.3125000
NODE_627_length_3036_cov_8.968676	2469	2549	8	22	80	0.2750000
NODE_627_length_3036_cov_8.968676	2469	2549	9	6	80	0.0750000
NODE_627_length_3036_cov_8.968676	2469	2549	10	31	80	0.3875000
NODE_627_length_3036_cov_8.968676	2469	2549	11	21	80	0.2625000
NODE_629_length_3032_cov_7.470849	1026	1068	23	4	42	0.0952381
NODE_629_length_3032_cov_7.470849	1026	1068	24	14	42	0.3333333
NODE_629_length_3032_cov_7.470849	1026	1068	25	9	42	0.2142857
NODE_629_length_3032_cov_7.470849	1026	1068	26	12	42	0.2857143
NODE_629_length_3032_cov_7.470849	1026	1068	27	1	42	0.0238095
NODE_629_length_3032_cov_7.470849	1026	1068	28	2	42	0.0476190
NODE_630_length_3025_cov_11.862611	2371	2451	0	21	80	0.2625000
NODE_630_length_3025_cov_11.862611	2371	2451	2	46	80	0.5750000
NODE_630_length_3025_cov_11.862611	2371	2451	3	13	80	0.1625000
NODE_630_length_3025_cov_11.862611	2424	2504	2	33	80	0.4125000
NODE_630_length_3025_cov_11.862611	2424	2504	3	21	80	0.2625000
NODE_630_length_3025_cov_11.862611	2424	2504	4	26	80	0.3250000
NODE_630_length_3025_cov_11.862611	2500	2580	2	9	80	0.1125000
NODE_630_length_3025_cov_11.862611	2500	2580	3	71	80	0.8875000
NODE_630_length_3025_cov_11.862611	2553	2633	1	6	80	0.0750000
NODE_630_length_3025_cov_11.862611	2553	2633	2	39	80	0.4875000
NODE_630_length_3025_cov_11.862611	2553	2633	3	35	80	0.4375000
NODE_635_length_3012_cov_33.100240	2379	2459	6	4	80	0.0500000
NODE_635_length_3012_cov_33.100240	2379	2459	7	5	80	0.0625000
NODE_635_length_3012_cov_33.100240	2379	2459	9	34	80	0.4250000
NODE_635_length_3012_cov_33.100240	2379	2459	10	14	80	0.1750000
NODE_635_length_3012_cov_33.100240	2379	2459	11	19	80	0.2375000
NODE_635_length_3012_cov_33.100240	2379	2459	12	4	80	0.0500000
NODE_635_length_3012_cov_33.100240	2432	2512	10	14	80	0.1750000
NODE_635_length_3012_cov_33.100240	2432	2512	11	29	80	0.3625000
NODE_635_length_3012_cov_33.100240	2432	2512	12	7	80	0.0875000
NODE_635_length_3012_cov_33.100240	2432	2512	13	30	80	0.3750000
NODE_637_length_3007_cov_11.843535	2641	2721	2	27	80	0.3375000
NODE_637_length_3007_cov_11.843535	2641	2721	3	1	80	0.0125000
NODE_637_length_3007_cov_11.843535	2641	2721	4	49	80	0.6125000
NODE_637_length_3007_cov_11.843535	2641	2721	5	3	80	0.0375000
NODE_643_length_2992_cov_2.636709	2032	2112	0	78	80	0.9750000
NODE_643_length_2992_cov_2.636709	2032	2112	4	2	80	0.0250000
NODE_643_length_2992_cov_2.636709	2085	2165	0	48	80	0.6000000
NODE_643_length_2992_cov_2.636709	2085	2165	1	2	80	0.0250000
NODE_643_length_2992_cov_2.636709	2085	2165	2	11	80	0.1375000
NODE_643_length_2992_cov_2.636709	2085	2165	3	9	80	0.1125000
NODE_643_length_2992_cov_2.636709	2085	2165	4	10	80	0.1250000
NODE_646_length_2978_cov_4.883293	382	452	0	12	70	0.1714286
NODE_646_length_2978_cov_4.883293	382	452	1	58	70	0.8285714
NODE_646_length_2978_cov_4.883293	1858	1938	0	80	80	1.0000000
NODE_646_length_2978_cov_4.883293	1926	1991	0	65	65	1.0000000
NODE_646_length_2978_cov_4.883293	1987	2066	0	79	79	1.0000000
NODE_646_length_2978_cov_4.883293	2040	2079	0	39	39	1.0000000
NODE_647_length_2976_cov_24.683003	1764	1844	3	29	80	0.3625000
NODE_647_length_2976_cov_24.683003	1764	1844	4	34	80	0.4250000
NODE_647_length_2976_cov_24.683003	1764	1844	5	17	80	0.2125000
NODE_647_length_2976_cov_24.683003	1817	1897	4	13	80	0.1625000
NODE_647_length_2976_cov_24.683003	1817	1897	5	17	80	0.2125000
NODE_647_length_2976_cov_24.683003	1817	1897	7	2	80	0.0250000
NODE_647_length_2976_cov_24.683003	1817	1897	8	35	80	0.4375000
NODE_647_length_2976_cov_24.683003	1817	1897	9	13	80	0.1625000
NODE_647_length_2976_cov_24.683003	1893	1973	8	4	80	0.0500000
NODE_647_length_2976_cov_24.683003	1893	1973	9	6	80	0.0750000
NODE_647_length_2976_cov_24.683003	1893	1973	10	16	80	0.2000000
NODE_647_length_2976_cov_24.683003	1893	1973	11	11	80	0.1375000
NODE_647_length_2976_cov_24.683003	1893	1973	13	17	80	0.2125000
NODE_647_length_2976_cov_24.683003	1893	1973	14	2	80	0.0250000
NODE_647_length_2976_cov_24.683003	1893	1973	15	8	80	0.1000000
NODE_647_length_2976_cov_24.683003	1893	1973	16	16	80	0.2000000
NODE_647_length_2976_cov_24.683003	1946	2026	11	5	80	0.0625000
NODE_647_length_2976_cov_24.683003	1946	2026	12	23	80	0.2875000
NODE_647_length_2976_cov_24.683003	1946	2026	13	5	80	0.0625000
NODE_647_length_2976_cov_24.683003	1946	2026	15	25	80	0.3125000
NODE_647_length_2976_cov_24.683003	1946	2026	16	22	80	0.2750000
NODE_651_length_2967_cov_16.146095	238	318	0	77	80	0.9625000
NODE_651_length_2967_cov_16.146095	238	318	1	3	80	0.0375000
NODE_651_length_2967_cov_16.146095	291	371	0	24	80	0.3000000
NODE_651_length_2967_cov_16.146095	291	371	1	38	80	0.4750000
NODE_651_length_2967_cov_16.146095	291	371	2	18	80	0.2250000
NODE_651_length_2967_cov_16.146095	367	447	2	19	80	0.2375000
NODE_651_length_2967_cov_16.146095	367	447	3	11	80	0.1375000
NODE_651_length_2967_cov_16.146095	367	447	5	3	80	0.0375000
NODE_651_length_2967_cov_16.146095	367	447	6	2	80	0.0250000
NODE_651_length_2967_cov_16.146095	367	447	7	45	80	0.5625000
NODE_651_length_2967_cov_16.146095	420	500	4	19	80	0.2375000
NODE_651_length_2967_cov_16.146095	420	500	6	16	80	0.2000000
NODE_651_length_2967_cov_16.146095	420	500	7	45	80	0.5625000
NODE_653_length_2965_cov_19.913468	92	134	6	42	42	1.0000000
NODE_653_length_2965_cov_19.913468	109	178	2	21	69	0.3043478
NODE_653_length_2965_cov_19.913468	109	178	3	6	69	0.0869565
NODE_653_length_2965_cov_19.913468	109	178	4	7	69	0.1014493
NODE_653_length_2965_cov_19.913468	109	178	6	35	69	0.5072464
NODE_653_length_2965_cov_19.913468	109	178	2	21	69	0.3043478
NODE_653_length_2965_cov_19.913468	109	178	3	6	69	0.0869565
NODE_653_length_2965_cov_19.913468	109	178	4	7	69	0.1014493
NODE_653_length_2965_cov_19.913468	109	178	6	35	69	0.5072464
NODE_653_length_2965_cov_19.913468	2298	2378	0	80	80	1.0000000
NODE_653_length_2965_cov_19.913468	2351	2431	0	30	80	0.3750000
NODE_653_length_2965_cov_19.913468	2351	2431	2	11	80	0.1375000
NODE_653_length_2965_cov_19.913468	2351	2431	3	13	80	0.1625000
NODE_653_length_2965_cov_19.913468	2351	2431	5	12	80	0.1500000
NODE_653_length_2965_cov_19.913468	2351	2431	7	14	80	0.1750000
NODE_653_length_2965_cov_19.913468	2427	2507	7	34	80	0.4250000
NODE_653_length_2965_cov_19.913468	2427	2507	8	22	80	0.2750000
NODE_653_length_2965_cov_19.913468	2427	2507	9	13	80	0.1625000
NODE_653_length_2965_cov_19.913468	2427	2507	10	11	80	0.1375000
NODE_653_length_2965_cov_19.913468	2480	2560	6	15	80	0.1875000
NODE_653_length_2965_cov_19.913468	2480	2560	8	8	80	0.1000000
NODE_653_length_2965_cov_19.913468	2480	2560	9	29	80	0.3625000
NODE_653_length_2965_cov_19.913468	2480	2560	10	28	80	0.3500000
NODE_656_length_2960_cov_35.741699	459	539	2	11	80	0.1375000
NODE_656_length_2960_cov_35.741699	459	539	3	60	80	0.7500000
NODE_656_length_2960_cov_35.741699	459	539	4	9	80	0.1125000
NODE_656_length_2960_cov_35.741699	512	592	3	80	80	1.0000000
NODE_659_length_2951_cov_7.195652	1100	1141	228	1	41	0.0243902
NODE_659_length_2951_cov_7.195652	1100	1141	229	1	41	0.0243902
NODE_659_length_2951_cov_7.195652	1100	1141	230	1	41	0.0243902
NODE_659_length_2951_cov_7.195652	1100	1141	241	1	41	0.0243902
NODE_659_length_2951_cov_7.195652	1100	1141	244	1	41	0.0243902
NODE_659_length_2951_cov_7.195652	1100	1141	249	1	41	0.0243902
NODE_659_length_2951_cov_7.195652	1100	1141	254	2	41	0.0487805
NODE_659_length_2951_cov_7.195652	1100	1141	264	1	41	0.0243902
NODE_659_length_2951_cov_7.195652	1100	1141	267	2	41	0.0487805
NODE_659_length_2951_cov_7.195652	1100	1141	268	1	41	0.0243902
NODE_659_length_2951_cov_7.195652	1100	1141	272	1	41	0.0243902
NODE_659_length_2951_cov_7.195652	1100	1141	274	1	41	0.0243902
NODE_659_length_2951_cov_7.195652	1100	1141	275	1	41	0.0243902
NODE_659_length_2951_cov_7.195652	1100	1141	276	1	41	0.0243902
NODE_659_length_2951_cov_7.195652	1100	1141	281	1	41	0.0243902
NODE_659_length_2951_cov_7.195652	1100	1141	282	1	41	0.0243902
NODE_659_length_2951_cov_7.195652	1100	1141	283	2	41	0.0487805
NODE_659_length_2951_cov_7.195652	1100	1141	287	1	41	0.0243902
NODE_659_length_2951_cov_7.195652	1100	1141	290	1	41	0.0243902
NODE_659_length_2951_cov_7.195652	1100	1141	292	1	41	0.0243902
NODE_659_length_2951_cov_7.195652	1100	1141	294	1	41	0.0243902
NODE_659_length_2951_cov_7.195652	1100	1141	295	1	41	0.0243902
NODE_659_length_2951_cov_7.195652	1100	1141	297	1	41	0.0243902
NODE_659_length_2951_cov_7.195652	1100	1141	298	1	41	0.0243902
NODE_659_length_2951_cov_7.195652	1100	1141	300	3	41	0.0731707
NODE_659_length_2951_cov_7.195652	1100	1141	301	1	41	0.0243902
NODE_659_length_2951_cov_7.195652	1100	1141	302	1	41	0.0243902
NODE_659_length_2951_cov_7.195652	1100	1141	303	1	41	0.0243902
NODE_659_length_2951_cov_7.195652	1100	1141	304	3	41	0.0731707
NODE_659_length_2951_cov_7.195652	1100	1141	305	3	41	0.0731707
NODE_659_length_2951_cov_7.195652	1100	1141	306	1	41	0.0243902
NODE_659_length_2951_cov_7.195652	1100	1141	309	1	41	0.0243902
NODE_665_length_2935_cov_37.693230	1492	1572	53	2	80	0.0250000
NODE_665_length_2935_cov_37.693230	1492	1572	54	4	80	0.0500000
NODE_665_length_2935_cov_37.693230	1492	1572	55	11	80	0.1375000
NODE_665_length_2935_cov_37.693230	1492	1572	56	1	80	0.0125000
NODE_665_length_2935_cov_37.693230	1492	1572	57	2	80	0.0250000
NODE_665_length_2935_cov_37.693230	1492	1572	58	3	80	0.0375000
NODE_665_length_2935_cov_37.693230	1492	1572	59	1	80	0.0125000
NODE_665_length_2935_cov_37.693230	1492	1572	60	4	80	0.0500000
NODE_665_length_2935_cov_37.693230	1492	1572	65	1	80	0.0125000
NODE_665_length_2935_cov_37.693230	1492	1572	66	2	80	0.0250000
NODE_665_length_2935_cov_37.693230	1492	1572	68	2	80	0.0250000
NODE_665_length_2935_cov_37.693230	1492	1572	70	1	80	0.0125000
NODE_665_length_2935_cov_37.693230	1492	1572	72	1	80	0.0125000
NODE_665_length_2935_cov_37.693230	1492	1572	73	2	80	0.0250000
NODE_665_length_2935_cov_37.693230	1492	1572	74	2	80	0.0250000
NODE_665_length_2935_cov_37.693230	1492	1572	75	3	80	0.0375000
NODE_665_length_2935_cov_37.693230	1492	1572	76	1	80	0.0125000
NODE_665_length_2935_cov_37.693230	1492	1572	78	8	80	0.1000000
NODE_665_length_2935_cov_37.693230	1492	1572	79	3	80	0.0375000
NODE_665_length_2935_cov_37.693230	1492	1572	80	9	80	0.1125000
NODE_665_length_2935_cov_37.693230	1492	1572	81	5	80	0.0625000
NODE_665_length_2935_cov_37.693230	1492	1572	82	2	80	0.0250000
NODE_665_length_2935_cov_37.693230	1492	1572	83	6	80	0.0750000
NODE_665_length_2935_cov_37.693230	1492	1572	84	1	80	0.0125000
NODE_665_length_2935_cov_37.693230	1492	1572	85	3	80	0.0375000
NODE_665_length_2935_cov_37.693230	1534	1589	53	2	55	0.0363636
NODE_665_length_2935_cov_37.693230	1534	1589	54	4	55	0.0727273
NODE_665_length_2935_cov_37.693230	1534	1589	55	15	55	0.2727273
NODE_665_length_2935_cov_37.693230	1534	1589	56	11	55	0.2000000
NODE_665_length_2935_cov_37.693230	1534	1589	57	5	55	0.0909091
NODE_665_length_2935_cov_37.693230	1534	1589	58	3	55	0.0545455
NODE_665_length_2935_cov_37.693230	1534	1589	59	1	55	0.0181818
NODE_665_length_2935_cov_37.693230	1534	1589	60	4	55	0.0727273
NODE_665_length_2935_cov_37.693230	1534	1589	65	1	55	0.0181818
NODE_665_length_2935_cov_37.693230	1534	1589	66	2	55	0.0363636
NODE_665_length_2935_cov_37.693230	1534	1589	68	2	55	0.0363636
NODE_665_length_2935_cov_37.693230	1534	1589	70	1	55	0.0181818
NODE_665_length_2935_cov_37.693230	1534	1589	72	1	55	0.0181818
NODE_665_length_2935_cov_37.693230	1534	1589	73	2	55	0.0363636
NODE_665_length_2935_cov_37.693230	1534	1589	74	1	55	0.0181818
NODE_665_length_2935_cov_37.693230	1545	1619	43	1	74	0.0135135
NODE_665_length_2935_cov_37.693230	1545	1619	46	6	74	0.0810811
NODE_665_length_2935_cov_37.693230	1545	1619	47	1	74	0.0135135
NODE_665_length_2935_cov_37.693230	1545	1619	48	5	74	0.0675676
NODE_665_length_2935_cov_37.693230	1545	1619	49	7	74	0.0945946
NODE_665_length_2935_cov_37.693230	1545	1619	50	5	74	0.0675676
NODE_665_length_2935_cov_37.693230	1545	1619	51	2	74	0.0270270
NODE_665_length_2935_cov_37.693230	1545	1619	52	1	74	0.0135135
NODE_665_length_2935_cov_37.693230	1545	1619	53	3	74	0.0405405
NODE_665_length_2935_cov_37.693230	1545	1619	54	4	74	0.0540541
NODE_665_length_2935_cov_37.693230	1545	1619	55	16	74	0.2162162
NODE_665_length_2935_cov_37.693230	1545	1619	56	11	74	0.1486486
NODE_665_length_2935_cov_37.693230	1545	1619	57	5	74	0.0675676
NODE_665_length_2935_cov_37.693230	1545	1619	58	3	74	0.0405405
NODE_665_length_2935_cov_37.693230	1545	1619	59	1	74	0.0135135
NODE_665_length_2935_cov_37.693230	1545	1619	60	3	74	0.0405405
NODE_665_length_2935_cov_37.693230	1625	1701	20	5	76	0.0657895
NODE_665_length_2935_cov_37.693230	1625	1701	21	6	76	0.0789474
NODE_665_length_2935_cov_37.693230	1625	1701	22	7	76	0.0921053
NODE_665_length_2935_cov_37.693230	1625	1701	23	7	76	0.0921053
NODE_665_length_2935_cov_37.693230	1625	1701	24	12	76	0.1578947
NODE_665_length_2935_cov_37.693230	1625	1701	25	6	76	0.0789474
NODE_665_length_2935_cov_37.693230	1625	1701	26	4	76	0.0526316
NODE_665_length_2935_cov_37.693230	1625	1701	27	4	76	0.0526316
NODE_665_length_2935_cov_37.693230	1625	1701	28	6	76	0.0789474
NODE_665_length_2935_cov_37.693230	1625	1701	29	1	76	0.0131579
NODE_665_length_2935_cov_37.693230	1625	1701	30	13	76	0.1710526
NODE_665_length_2935_cov_37.693230	1625	1701	31	5	76	0.0657895
NODE_665_length_2935_cov_37.693230	2863	2906	9	16	43	0.3720930
NODE_665_length_2935_cov_37.693230	2863	2906	11	2	43	0.0465116
NODE_665_length_2935_cov_37.693230	2863	2906	12	8	43	0.1860465
NODE_665_length_2935_cov_37.693230	2863	2906	13	1	43	0.0232558
NODE_665_length_2935_cov_37.693230	2863	2906	15	2	43	0.0465116
NODE_665_length_2935_cov_37.693230	2863	2906	17	1	43	0.0232558
NODE_665_length_2935_cov_37.693230	2863	2906	18	3	43	0.0697674
NODE_665_length_2935_cov_37.693230	2863	2906	20	2	43	0.0465116
NODE_665_length_2935_cov_37.693230	2863	2906	21	5	43	0.1162791
NODE_665_length_2935_cov_37.693230	2863	2906	22	3	43	0.0697674
NODE_675_length_2913_cov_4.376688	2664	2739	0	59	75	0.7866667
NODE_675_length_2913_cov_4.376688	2664	2739	1	16	75	0.2133333
NODE_675_length_2913_cov_4.376688	2664	2723	0	59	59	1.0000000
NODE_675_length_2913_cov_4.376688	2664	2739	0	59	75	0.7866667
NODE_675_length_2913_cov_4.376688	2664	2739	1	16	75	0.2133333
NODE_675_length_2913_cov_4.376688	2664	2739	0	59	75	0.7866667
NODE_675_length_2913_cov_4.376688	2664	2739	1	16	75	0.2133333
NODE_675_length_2913_cov_4.376688	2673	2739	0	50	66	0.7575758
NODE_675_length_2913_cov_4.376688	2673	2739	1	16	66	0.2424242
NODE_675_length_2913_cov_4.376688	2717	2780	0	6	63	0.0952381
NODE_675_length_2913_cov_4.376688	2717	2780	1	35	63	0.5555556
NODE_675_length_2913_cov_4.376688	2717	2780	2	22	63	0.3492064
NODE_675_length_2913_cov_4.376688	2745	2778	1	13	33	0.3939394
NODE_675_length_2913_cov_4.376688	2745	2778	2	20	33	0.6060606
NODE_677_length_2909_cov_71.975089	2090	2174	24	3	84	0.0357143
NODE_677_length_2909_cov_71.975089	2090	2174	25	6	84	0.0714286
NODE_677_length_2909_cov_71.975089	2090	2174	26	1	84	0.0119048
NODE_677_length_2909_cov_71.975089	2090	2174	27	5	84	0.0595238
NODE_677_length_2909_cov_71.975089	2090	2174	29	2	84	0.0238095
NODE_677_length_2909_cov_71.975089	2090	2174	33	3	84	0.0357143
NODE_677_length_2909_cov_71.975089	2090	2174	34	3	84	0.0357143
NODE_677_length_2909_cov_71.975089	2090	2174	35	1	84	0.0119048
NODE_677_length_2909_cov_71.975089	2090	2174	37	2	84	0.0238095
NODE_677_length_2909_cov_71.975089	2090	2174	39	1	84	0.0119048
NODE_677_length_2909_cov_71.975089	2090	2174	40	4	84	0.0476190
NODE_677_length_2909_cov_71.975089	2090	2174	42	1	84	0.0119048
NODE_677_length_2909_cov_71.975089	2090	2174	46	1	84	0.0119048
NODE_677_length_2909_cov_71.975089	2090	2174	47	3	84	0.0357143
NODE_677_length_2909_cov_71.975089	2090	2174	48	7	84	0.0833333
NODE_677_length_2909_cov_71.975089	2090	2174	50	1	84	0.0119048
NODE_677_length_2909_cov_71.975089	2090	2174	51	1	84	0.0119048
NODE_677_length_2909_cov_71.975089	2090	2174	54	2	84	0.0238095
NODE_677_length_2909_cov_71.975089	2090	2174	56	1	84	0.0119048
NODE_677_length_2909_cov_71.975089	2090	2174	57	3	84	0.0357143
NODE_677_length_2909_cov_71.975089	2090	2174	58	2	84	0.0238095
NODE_677_length_2909_cov_71.975089	2090	2174	59	2	84	0.0238095
NODE_677_length_2909_cov_71.975089	2090	2174	60	2	84	0.0238095
NODE_677_length_2909_cov_71.975089	2090	2174	62	1	84	0.0119048
NODE_677_length_2909_cov_71.975089	2090	2174	64	1	84	0.0119048
NODE_677_length_2909_cov_71.975089	2090	2174	65	10	84	0.1190476
NODE_677_length_2909_cov_71.975089	2090	2174	66	4	84	0.0476190
NODE_677_length_2909_cov_71.975089	2090	2174	67	9	84	0.1071429
NODE_677_length_2909_cov_71.975089	2090	2174	68	1	84	0.0119048
NODE_677_length_2909_cov_71.975089	2090	2174	69	1	84	0.0119048
NODE_678_length_2908_cov_5.937344	2495	2575	0	37	80	0.4625000
NODE_678_length_2908_cov_5.937344	2495	2575	1	43	80	0.5375000
NODE_678_length_2908_cov_5.937344	2548	2628	0	41	80	0.5125000
NODE_678_length_2908_cov_5.937344	2548	2628	1	39	80	0.4875000
NODE_678_length_2908_cov_5.937344	2624	2704	1	80	80	1.0000000
NODE_678_length_2908_cov_5.937344	2677	2757	0	18	80	0.2250000
NODE_678_length_2908_cov_5.937344	2677	2757	1	62	80	0.7750000
NODE_679_length_2905_cov_12.777619	2358	2419	4	5	61	0.0819672
NODE_679_length_2905_cov_12.777619	2358	2419	5	18	61	0.2950820
NODE_679_length_2905_cov_12.777619	2358	2419	6	35	61	0.5737705
NODE_679_length_2905_cov_12.777619	2358	2419	13	3	61	0.0491803
NODE_679_length_2905_cov_12.777619	2358	2419	4	5	61	0.0819672
NODE_679_length_2905_cov_12.777619	2358	2419	5	18	61	0.2950820
NODE_679_length_2905_cov_12.777619	2358	2419	6	35	61	0.5737705
NODE_679_length_2905_cov_12.777619	2358	2419	13	3	61	0.0491803
NODE_679_length_2905_cov_12.777619	2358	2419	4	5	61	0.0819672
NODE_679_length_2905_cov_12.777619	2358	2419	5	18	61	0.2950820
NODE_679_length_2905_cov_12.777619	2358	2419	6	35	61	0.5737705
NODE_679_length_2905_cov_12.777619	2358	2419	13	3	61	0.0491803
NODE_679_length_2905_cov_12.777619	2392	2472	2	11	80	0.1375000
NODE_679_length_2905_cov_12.777619	2392	2472	4	17	80	0.2125000
NODE_679_length_2905_cov_12.777619	2392	2472	6	52	80	0.6500000
NODE_680_length_2903_cov_5.474322	2423	2464	2	15	41	0.3658537
NODE_680_length_2903_cov_5.474322	2423	2464	3	5	41	0.1219512
NODE_680_length_2903_cov_5.474322	2423	2464	5	21	41	0.5121951
NODE_684_length_2898_cov_5.786352	0	74	0	14	74	0.1891892
NODE_684_length_2898_cov_5.786352	0	74	2	10	74	0.1351351
NODE_684_length_2898_cov_5.786352	0	74	3	6	74	0.0810811
NODE_684_length_2898_cov_5.786352	0	74	4	23	74	0.3108108
NODE_684_length_2898_cov_5.786352	0	74	5	13	74	0.1756757
NODE_684_length_2898_cov_5.786352	0	74	6	2	74	0.0270270
NODE_684_length_2898_cov_5.786352	0	74	7	6	74	0.0810811
NODE_684_length_2898_cov_5.786352	47	124	4	6	77	0.0779221
NODE_684_length_2898_cov_5.786352	47	124	5	13	77	0.1688312
NODE_684_length_2898_cov_5.786352	47	124	6	13	77	0.1688312
NODE_684_length_2898_cov_5.786352	47	124	7	10	77	0.1298701
NODE_684_length_2898_cov_5.786352	47	124	8	35	77	0.4545455
NODE_686_length_2895_cov_8.519313	869	949	10	5	80	0.0625000
NODE_686_length_2895_cov_8.519313	869	949	11	9	80	0.1125000
NODE_686_length_2895_cov_8.519313	869	949	12	29	80	0.3625000
NODE_686_length_2895_cov_8.519313	869	949	13	16	80	0.2000000
NODE_686_length_2895_cov_8.519313	869	949	14	11	80	0.1375000
NODE_686_length_2895_cov_8.519313	869	949	15	10	80	0.1250000
NODE_686_length_2895_cov_8.519313	922	1002	6	12	80	0.1500000
NODE_686_length_2895_cov_8.519313	922	1002	8	24	80	0.3000000
NODE_686_length_2895_cov_8.519313	922	1002	9	7	80	0.0875000
NODE_686_length_2895_cov_8.519313	922	1002	10	2	80	0.0250000
NODE_686_length_2895_cov_8.519313	922	1002	12	35	80	0.4375000
NODE_688_length_2894_cov_2.036136	2677	2757	4	17	80	0.2125000
NODE_688_length_2894_cov_2.036136	2677	2757	6	16	80	0.2000000
NODE_688_length_2894_cov_2.036136	2677	2757	7	14	80	0.1750000
NODE_688_length_2894_cov_2.036136	2677	2757	8	28	80	0.3500000
NODE_688_length_2894_cov_2.036136	2677	2757	10	5	80	0.0625000
NODE_689_length_2891_cov_7.938037	193	275	0	17	82	0.2073171
NODE_689_length_2891_cov_7.938037	193	275	1	23	82	0.2804878
NODE_689_length_2891_cov_7.938037	193	275	3	19	82	0.2317073
NODE_689_length_2891_cov_7.938037	193	275	5	5	82	0.0609756
NODE_689_length_2891_cov_7.938037	193	275	6	17	82	0.2073171
NODE_689_length_2891_cov_7.938037	193	275	8	1	82	0.0121951
NODE_691_length_2889_cov_11.426882	407	487	3	5	80	0.0625000
NODE_691_length_2889_cov_11.426882	407	487	4	28	80	0.3500000
NODE_691_length_2889_cov_11.426882	407	487	5	47	80	0.5875000
NODE_691_length_2889_cov_11.426882	460	540	4	6	80	0.0750000
NODE_691_length_2889_cov_11.426882	460	540	5	65	80	0.8125000
NODE_691_length_2889_cov_11.426882	460	540	6	9	80	0.1125000
NODE_691_length_2889_cov_11.426882	1006	1086	8	3	80	0.0375000
NODE_691_length_2889_cov_11.426882	1006	1086	9	1	80	0.0125000
NODE_691_length_2889_cov_11.426882	1006	1086	10	3	80	0.0375000
NODE_691_length_2889_cov_11.426882	1006	1086	12	3	80	0.0375000
NODE_691_length_2889_cov_11.426882	1006	1086	13	1	80	0.0125000
NODE_691_length_2889_cov_11.426882	1006	1086	14	1	80	0.0125000
NODE_691_length_2889_cov_11.426882	1006	1086	16	1	80	0.0125000
NODE_691_length_2889_cov_11.426882	1006	1086	17	8	80	0.1000000
NODE_691_length_2889_cov_11.426882	1006	1086	18	1	80	0.0125000
NODE_691_length_2889_cov_11.426882	1006	1086	19	3	80	0.0375000
NODE_691_length_2889_cov_11.426882	1006	1086	20	8	80	0.1000000
NODE_691_length_2889_cov_11.426882	1006	1086	22	3	80	0.0375000
NODE_691_length_2889_cov_11.426882	1006	1086	23	3	80	0.0375000
NODE_691_length_2889_cov_11.426882	1006	1086	24	1	80	0.0125000
NODE_691_length_2889_cov_11.426882	1006	1086	25	1	80	0.0125000
NODE_691_length_2889_cov_11.426882	1006	1086	26	6	80	0.0750000
NODE_691_length_2889_cov_11.426882	1006	1086	27	8	80	0.1000000
NODE_691_length_2889_cov_11.426882	1006	1086	28	3	80	0.0375000
NODE_691_length_2889_cov_11.426882	1006	1086	29	3	80	0.0375000
NODE_691_length_2889_cov_11.426882	1006	1086	30	1	80	0.0125000
NODE_691_length_2889_cov_11.426882	1006	1086	32	3	80	0.0375000
NODE_691_length_2889_cov_11.426882	1006	1086	35	8	80	0.1000000
NODE_691_length_2889_cov_11.426882	1006	1086	36	3	80	0.0375000
NODE_691_length_2889_cov_11.426882	1006	1086	38	4	80	0.0500000
NODE_691_length_2889_cov_11.426882	1007	1086	8	3	79	0.0379747
NODE_691_length_2889_cov_11.426882	1007	1086	9	1	79	0.0126582
NODE_691_length_2889_cov_11.426882	1007	1086	10	3	79	0.0379747
NODE_691_length_2889_cov_11.426882	1007	1086	12	3	79	0.0379747
NODE_691_length_2889_cov_11.426882	1007	1086	13	1	79	0.0126582
NODE_691_length_2889_cov_11.426882	1007	1086	14	1	79	0.0126582
NODE_691_length_2889_cov_11.426882	1007	1086	16	1	79	0.0126582
NODE_691_length_2889_cov_11.426882	1007	1086	17	8	79	0.1012658
NODE_691_length_2889_cov_11.426882	1007	1086	18	1	79	0.0126582
NODE_691_length_2889_cov_11.426882	1007	1086	19	3	79	0.0379747
NODE_691_length_2889_cov_11.426882	1007	1086	20	8	79	0.1012658
NODE_691_length_2889_cov_11.426882	1007	1086	22	3	79	0.0379747
NODE_691_length_2889_cov_11.426882	1007	1086	23	3	79	0.0379747
NODE_691_length_2889_cov_11.426882	1007	1086	24	1	79	0.0126582
NODE_691_length_2889_cov_11.426882	1007	1086	25	1	79	0.0126582
NODE_691_length_2889_cov_11.426882	1007	1086	26	6	79	0.0759494
NODE_691_length_2889_cov_11.426882	1007	1086	27	8	79	0.1012658
NODE_691_length_2889_cov_11.426882	1007	1086	28	3	79	0.0379747
NODE_691_length_2889_cov_11.426882	1007	1086	29	3	79	0.0379747
NODE_691_length_2889_cov_11.426882	1007	1086	30	1	79	0.0126582
NODE_691_length_2889_cov_11.426882	1007	1086	32	3	79	0.0379747
NODE_691_length_2889_cov_11.426882	1007	1086	35	8	79	0.1012658
NODE_691_length_2889_cov_11.426882	1007	1086	36	3	79	0.0379747
NODE_691_length_2889_cov_11.426882	1007	1086	38	3	79	0.0379747
NODE_691_length_2889_cov_11.426882	1059	1138	0	13	79	0.1645570
NODE_691_length_2889_cov_11.426882	1059	1138	1	4	79	0.0506329
NODE_691_length_2889_cov_11.426882	1059	1138	2	11	79	0.1392405
NODE_691_length_2889_cov_11.426882	1059	1138	3	8	79	0.1012658
NODE_691_length_2889_cov_11.426882	1059	1138	4	3	79	0.0379747
NODE_691_length_2889_cov_11.426882	1059	1138	5	8	79	0.1012658
NODE_691_length_2889_cov_11.426882	1059	1138	7	4	79	0.0506329
NODE_691_length_2889_cov_11.426882	1059	1138	8	4	79	0.0506329
NODE_691_length_2889_cov_11.426882	1059	1138	9	1	79	0.0126582
NODE_691_length_2889_cov_11.426882	1059	1138	10	3	79	0.0379747
NODE_691_length_2889_cov_11.426882	1059	1138	12	3	79	0.0379747
NODE_691_length_2889_cov_11.426882	1059	1138	13	1	79	0.0126582
NODE_691_length_2889_cov_11.426882	1059	1138	14	1	79	0.0126582
NODE_691_length_2889_cov_11.426882	1059	1138	16	1	79	0.0126582
NODE_691_length_2889_cov_11.426882	1059	1138	17	8	79	0.1012658
NODE_691_length_2889_cov_11.426882	1059	1138	18	1	79	0.0126582
NODE_691_length_2889_cov_11.426882	1059	1138	19	3	79	0.0379747
NODE_691_length_2889_cov_11.426882	1059	1138	20	2	79	0.0253165
NODE_691_length_2889_cov_11.426882	1059	1138	0	13	79	0.1645570
NODE_691_length_2889_cov_11.426882	1059	1138	1	4	79	0.0506329
NODE_691_length_2889_cov_11.426882	1059	1138	2	11	79	0.1392405
NODE_691_length_2889_cov_11.426882	1059	1138	3	8	79	0.1012658
NODE_691_length_2889_cov_11.426882	1059	1138	4	3	79	0.0379747
NODE_691_length_2889_cov_11.426882	1059	1138	5	8	79	0.1012658
NODE_691_length_2889_cov_11.426882	1059	1138	7	4	79	0.0506329
NODE_691_length_2889_cov_11.426882	1059	1138	8	4	79	0.0506329
NODE_691_length_2889_cov_11.426882	1059	1138	9	1	79	0.0126582
NODE_691_length_2889_cov_11.426882	1059	1138	10	3	79	0.0379747
NODE_691_length_2889_cov_11.426882	1059	1138	12	3	79	0.0379747
NODE_691_length_2889_cov_11.426882	1059	1138	13	1	79	0.0126582
NODE_691_length_2889_cov_11.426882	1059	1138	14	1	79	0.0126582
NODE_691_length_2889_cov_11.426882	1059	1138	16	1	79	0.0126582
NODE_691_length_2889_cov_11.426882	1059	1138	17	8	79	0.1012658
NODE_691_length_2889_cov_11.426882	1059	1138	18	1	79	0.0126582
NODE_691_length_2889_cov_11.426882	1059	1138	19	3	79	0.0379747
NODE_691_length_2889_cov_11.426882	1059	1138	20	2	79	0.0253165
NODE_693_length_2888_cov_3.789172	992	1072	6	8	80	0.1000000
NODE_693_length_2888_cov_3.789172	992	1072	7	1	80	0.0125000
NODE_693_length_2888_cov_3.789172	992	1072	8	26	80	0.3250000
NODE_693_length_2888_cov_3.789172	992	1072	9	31	80	0.3875000
NODE_693_length_2888_cov_3.789172	992	1072	10	14	80	0.1750000
NODE_693_length_2888_cov_3.789172	1045	1087	6	5	42	0.1190476
NODE_693_length_2888_cov_3.789172	1045	1087	7	3	42	0.0714286
NODE_693_length_2888_cov_3.789172	1045	1087	8	18	42	0.4285714
NODE_693_length_2888_cov_3.789172	1045	1087	9	2	42	0.0476190
NODE_693_length_2888_cov_3.789172	1045	1087	10	14	42	0.3333333
NODE_697_length_2878_cov_6.277798	2712	2781	4	4	69	0.0579710
NODE_697_length_2878_cov_6.277798	2712	2781	5	10	69	0.1449275
NODE_697_length_2878_cov_6.277798	2712	2781	6	4	69	0.0579710
NODE_697_length_2878_cov_6.277798	2712	2781	10	3	69	0.0434783
NODE_697_length_2878_cov_6.277798	2712	2781	11	3	69	0.0434783
NODE_697_length_2878_cov_6.277798	2712	2781	13	3	69	0.0434783
NODE_697_length_2878_cov_6.277798	2712	2781	15	10	69	0.1449275
NODE_697_length_2878_cov_6.277798	2712	2781	16	11	69	0.1594203
NODE_697_length_2878_cov_6.277798	2712	2781	18	21	69	0.3043478
NODE_703_length_2862_cov_9.060803	2409	2489	0	80	80	1.0000000
NODE_703_length_2862_cov_9.060803	2462	2542	0	80	80	1.0000000
NODE_712_length_2840_cov_2.079533	1660	1740	0	9	80	0.1125000
NODE_712_length_2840_cov_2.079533	1660	1740	1	71	80	0.8875000
NODE_713_length_2839_cov_16.762044	327	402	0	74	75	0.9866667
NODE_713_length_2839_cov_16.762044	327	402	1	1	75	0.0133333
NODE_713_length_2839_cov_16.762044	380	468	0	21	88	0.2386364
NODE_713_length_2839_cov_16.762044	380	468	1	49	88	0.5568182
NODE_713_length_2839_cov_16.762044	380	468	2	18	88	0.2045455
NODE_713_length_2839_cov_16.762044	1021	1101	0	80	80	1.0000000
NODE_713_length_2839_cov_16.762044	1074	1154	0	80	80	1.0000000
NODE_714_length_2835_cov_29.691520	1552	1581	113	1	29	0.0344828
NODE_714_length_2835_cov_29.691520	1552	1581	115	1	29	0.0344828
NODE_714_length_2835_cov_29.691520	1552	1581	122	1	29	0.0344828
NODE_714_length_2835_cov_29.691520	1552	1581	124	1	29	0.0344828
NODE_714_length_2835_cov_29.691520	1552	1581	126	1	29	0.0344828
NODE_714_length_2835_cov_29.691520	1552	1581	127	1	29	0.0344828
NODE_714_length_2835_cov_29.691520	1552	1581	128	1	29	0.0344828
NODE_714_length_2835_cov_29.691520	1552	1581	130	2	29	0.0689655
NODE_714_length_2835_cov_29.691520	1552	1581	131	2	29	0.0689655
NODE_714_length_2835_cov_29.691520	1552	1581	133	3	29	0.1034483
NODE_714_length_2835_cov_29.691520	1552	1581	139	1	29	0.0344828
NODE_714_length_2835_cov_29.691520	1552	1581	140	2	29	0.0689655
NODE_714_length_2835_cov_29.691520	1552	1581	141	2	29	0.0689655
NODE_714_length_2835_cov_29.691520	1552	1581	143	3	29	0.1034483
NODE_714_length_2835_cov_29.691520	1552	1581	144	3	29	0.1034483
NODE_714_length_2835_cov_29.691520	1552	1581	148	3	29	0.1034483
NODE_714_length_2835_cov_29.691520	1552	1581	150	1	29	0.0344828
NODE_714_length_2835_cov_29.691520	1554	1629	26	1	75	0.0133333
NODE_714_length_2835_cov_29.691520	1554	1629	28	1	75	0.0133333
NODE_714_length_2835_cov_29.691520	1554	1629	30	2	75	0.0266667
NODE_714_length_2835_cov_29.691520	1554	1629	32	1	75	0.0133333
NODE_714_length_2835_cov_29.691520	1554	1629	35	3	75	0.0400000
NODE_714_length_2835_cov_29.691520	1554	1629	36	1	75	0.0133333
NODE_714_length_2835_cov_29.691520	1554	1629	37	1	75	0.0133333
NODE_714_length_2835_cov_29.691520	1554	1629	38	1	75	0.0133333
NODE_714_length_2835_cov_29.691520	1554	1629	42	2	75	0.0266667
NODE_714_length_2835_cov_29.691520	1554	1629	47	1	75	0.0133333
NODE_714_length_2835_cov_29.691520	1554	1629	50	2	75	0.0266667
NODE_714_length_2835_cov_29.691520	1554	1629	56	1	75	0.0133333
NODE_714_length_2835_cov_29.691520	1554	1629	60	1	75	0.0133333
NODE_714_length_2835_cov_29.691520	1554	1629	64	1	75	0.0133333
NODE_714_length_2835_cov_29.691520	1554	1629	65	1	75	0.0133333
NODE_714_length_2835_cov_29.691520	1554	1629	72	1	75	0.0133333
NODE_714_length_2835_cov_29.691520	1554	1629	74	1	75	0.0133333
NODE_714_length_2835_cov_29.691520	1554	1629	76	1	75	0.0133333
NODE_714_length_2835_cov_29.691520	1554	1629	77	2	75	0.0266667
NODE_714_length_2835_cov_29.691520	1554	1629	78	4	75	0.0533333
NODE_714_length_2835_cov_29.691520	1554	1629	79	1	75	0.0133333
NODE_714_length_2835_cov_29.691520	1554	1629	81	1	75	0.0133333
NODE_714_length_2835_cov_29.691520	1554	1629	83	1	75	0.0133333
NODE_714_length_2835_cov_29.691520	1554	1629	86	1	75	0.0133333
NODE_714_length_2835_cov_29.691520	1554	1629	87	1	75	0.0133333
NODE_714_length_2835_cov_29.691520	1554	1629	89	1	75	0.0133333
NODE_714_length_2835_cov_29.691520	1554	1629	90	1	75	0.0133333
NODE_714_length_2835_cov_29.691520	1554	1629	92	2	75	0.0266667
NODE_714_length_2835_cov_29.691520	1554	1629	98	1	75	0.0133333
NODE_714_length_2835_cov_29.691520	1554	1629	100	1	75	0.0133333
NODE_714_length_2835_cov_29.691520	1554	1629	101	1	75	0.0133333
NODE_714_length_2835_cov_29.691520	1554	1629	104	2	75	0.0266667
NODE_714_length_2835_cov_29.691520	1554	1629	106	1	75	0.0133333
NODE_714_length_2835_cov_29.691520	1554	1629	107	2	75	0.0266667
NODE_714_length_2835_cov_29.691520	1554	1629	108	2	75	0.0266667
NODE_714_length_2835_cov_29.691520	1554	1629	113	1	75	0.0133333
NODE_714_length_2835_cov_29.691520	1554	1629	115	1	75	0.0133333
NODE_714_length_2835_cov_29.691520	1554	1629	122	1	75	0.0133333
NODE_714_length_2835_cov_29.691520	1554	1629	124	1	75	0.0133333
NODE_714_length_2835_cov_29.691520	1554	1629	126	1	75	0.0133333
NODE_714_length_2835_cov_29.691520	1554	1629	127	1	75	0.0133333
NODE_714_length_2835_cov_29.691520	1554	1629	128	1	75	0.0133333
NODE_714_length_2835_cov_29.691520	1554	1629	130	2	75	0.0266667
NODE_714_length_2835_cov_29.691520	1554	1629	131	2	75	0.0266667
NODE_714_length_2835_cov_29.691520	1554	1629	133	3	75	0.0400000
NODE_714_length_2835_cov_29.691520	1554	1629	139	1	75	0.0133333
NODE_714_length_2835_cov_29.691520	1554	1629	140	2	75	0.0266667
NODE_714_length_2835_cov_29.691520	1554	1629	141	2	75	0.0266667
NODE_714_length_2835_cov_29.691520	1554	1629	143	3	75	0.0400000
NODE_714_length_2835_cov_29.691520	1554	1629	144	3	75	0.0400000
NODE_714_length_2835_cov_29.691520	1554	1629	148	2	75	0.0266667
NODE_720_length_2825_cov_9.731108	487	567	2	10	80	0.1250000
NODE_720_length_2825_cov_9.731108	487	567	3	70	80	0.8750000
NODE_720_length_2825_cov_9.731108	540	620	1	12	80	0.1500000
NODE_720_length_2825_cov_9.731108	540	620	2	46	80	0.5750000
NODE_720_length_2825_cov_9.731108	540	620	3	22	80	0.2750000
NODE_726_length_2810_cov_2.844338	206	289	20	3	83	0.0361446
NODE_726_length_2810_cov_2.844338	206	289	22	2	83	0.0240964
NODE_726_length_2810_cov_2.844338	206	289	24	1	83	0.0120482
NODE_726_length_2810_cov_2.844338	206	289	25	2	83	0.0240964
NODE_726_length_2810_cov_2.844338	206	289	26	6	83	0.0722892
NODE_726_length_2810_cov_2.844338	206	289	27	7	83	0.0843373
NODE_726_length_2810_cov_2.844338	206	289	29	2	83	0.0240964
NODE_726_length_2810_cov_2.844338	206	289	30	2	83	0.0240964
NODE_726_length_2810_cov_2.844338	206	289	31	3	83	0.0361446
NODE_726_length_2810_cov_2.844338	206	289	34	4	83	0.0481928
NODE_726_length_2810_cov_2.844338	206	289	36	3	83	0.0361446
NODE_726_length_2810_cov_2.844338	206	289	37	3	83	0.0361446
NODE_726_length_2810_cov_2.844338	206	289	38	11	83	0.1325301
NODE_726_length_2810_cov_2.844338	206	289	39	1	83	0.0120482
NODE_726_length_2810_cov_2.844338	206	289	40	1	83	0.0120482
NODE_726_length_2810_cov_2.844338	206	289	41	3	83	0.0361446
NODE_726_length_2810_cov_2.844338	206	289	42	1	83	0.0120482
NODE_726_length_2810_cov_2.844338	206	289	45	8	83	0.0963855
NODE_726_length_2810_cov_2.844338	206	289	46	1	83	0.0120482
NODE_726_length_2810_cov_2.844338	206	289	47	3	83	0.0361446
NODE_726_length_2810_cov_2.844338	206	289	48	8	83	0.0963855
NODE_726_length_2810_cov_2.844338	206	289	49	2	83	0.0240964
NODE_726_length_2810_cov_2.844338	206	289	51	6	83	0.0722892
NODE_728_length_2808_cov_2.867110	140	163	6	3	23	0.1304348
NODE_728_length_2808_cov_2.867110	140	163	7	7	23	0.3043478
NODE_728_length_2808_cov_2.867110	140	163	9	13	23	0.5652174
NODE_729_length_2807_cov_8.423191	125	205	0	80	80	1.0000000
NODE_729_length_2807_cov_8.423191	178	258	0	80	80	1.0000000
NODE_729_length_2807_cov_8.423191	2451	2515	3	17	64	0.2656250
NODE_729_length_2807_cov_8.423191	2451	2515	4	46	64	0.7187500
NODE_729_length_2807_cov_8.423191	2451	2515	6	1	64	0.0156250
NODE_735_length_2801_cov_26.131384	461	521	0	60	60	1.0000000
NODE_735_length_2801_cov_26.131384	494	574	0	80	80	1.0000000
NODE_735_length_2801_cov_26.131384	1536	1596	37	2	60	0.0333333
NODE_735_length_2801_cov_26.131384	1536	1596	38	1	60	0.0166667
NODE_735_length_2801_cov_26.131384	1536	1596	40	2	60	0.0333333
NODE_735_length_2801_cov_26.131384	1536	1596	41	1	60	0.0166667
NODE_735_length_2801_cov_26.131384	1536	1596	42	1	60	0.0166667
NODE_735_length_2801_cov_26.131384	1536	1596	48	2	60	0.0333333
NODE_735_length_2801_cov_26.131384	1536	1596	50	5	60	0.0833333
NODE_735_length_2801_cov_26.131384	1536	1596	54	1	60	0.0166667
NODE_735_length_2801_cov_26.131384	1536	1596	56	1	60	0.0166667
NODE_735_length_2801_cov_26.131384	1536	1596	58	3	60	0.0500000
NODE_735_length_2801_cov_26.131384	1536	1596	62	3	60	0.0500000
NODE_735_length_2801_cov_26.131384	1536	1596	64	5	60	0.0833333
NODE_735_length_2801_cov_26.131384	1536	1596	66	1	60	0.0166667
NODE_735_length_2801_cov_26.131384	1536	1596	70	3	60	0.0500000
NODE_735_length_2801_cov_26.131384	1536	1596	71	2	60	0.0333333
NODE_735_length_2801_cov_26.131384	1536	1596	73	2	60	0.0333333
NODE_735_length_2801_cov_26.131384	1536	1596	74	3	60	0.0500000
NODE_735_length_2801_cov_26.131384	1536	1596	77	1	60	0.0166667
NODE_735_length_2801_cov_26.131384	1536	1596	80	2	60	0.0333333
NODE_735_length_2801_cov_26.131384	1536	1596	81	1	60	0.0166667
NODE_735_length_2801_cov_26.131384	1536	1596	86	1	60	0.0166667
NODE_735_length_2801_cov_26.131384	1536	1596	88	2	60	0.0333333
NODE_735_length_2801_cov_26.131384	1536	1596	89	2	60	0.0333333
NODE_735_length_2801_cov_26.131384	1536	1596	90	3	60	0.0500000
NODE_735_length_2801_cov_26.131384	1536	1596	91	1	60	0.0166667
NODE_735_length_2801_cov_26.131384	1536	1596	93	1	60	0.0166667
NODE_735_length_2801_cov_26.131384	1536	1596	94	1	60	0.0166667
NODE_735_length_2801_cov_26.131384	1536	1596	95	2	60	0.0333333
NODE_735_length_2801_cov_26.131384	1536	1596	96	1	60	0.0166667
NODE_735_length_2801_cov_26.131384	1536	1596	99	4	60	0.0666667
NODE_735_length_2801_cov_26.131384	1815	1881	4	10	66	0.1515152
NODE_735_length_2801_cov_26.131384	1815	1881	5	50	66	0.7575758
NODE_735_length_2801_cov_26.131384	1815	1881	6	6	66	0.0909091
NODE_735_length_2801_cov_26.131384	1854	1934	4	10	80	0.1250000
NODE_735_length_2801_cov_26.131384	1854	1934	5	38	80	0.4750000
NODE_735_length_2801_cov_26.131384	1854	1934	6	29	80	0.3625000
NODE_735_length_2801_cov_26.131384	1854	1934	7	3	80	0.0375000
NODE_736_length_2801_cov_3.594375	2589	2645	1	56	56	1.0000000
NODE_738_length_2796_cov_94.511680	1090	1137	23	3	47	0.0638298
NODE_738_length_2796_cov_94.511680	1090	1137	24	3	47	0.0638298
NODE_738_length_2796_cov_94.511680	1090	1137	28	3	47	0.0638298
NODE_738_length_2796_cov_94.511680	1090	1137	29	3	47	0.0638298
NODE_738_length_2796_cov_94.511680	1090	1137	33	8	47	0.1702128
NODE_738_length_2796_cov_94.511680	1090	1137	34	5	47	0.1063830
NODE_738_length_2796_cov_94.511680	1090	1137	36	5	47	0.1063830
NODE_738_length_2796_cov_94.511680	1090	1137	38	2	47	0.0425532
NODE_738_length_2796_cov_94.511680	1090	1137	39	5	47	0.1063830
NODE_738_length_2796_cov_94.511680	1090	1137	41	1	47	0.0212766
NODE_738_length_2796_cov_94.511680	1090	1137	42	1	47	0.0212766
NODE_738_length_2796_cov_94.511680	1090	1137	45	1	47	0.0212766
NODE_738_length_2796_cov_94.511680	1090	1137	46	2	47	0.0425532
NODE_738_length_2796_cov_94.511680	1090	1137	48	2	47	0.0425532
NODE_738_length_2796_cov_94.511680	1090	1137	51	1	47	0.0212766
NODE_738_length_2796_cov_94.511680	1090	1137	53	1	47	0.0212766
NODE_738_length_2796_cov_94.511680	1090	1137	54	1	47	0.0212766
NODE_738_length_2796_cov_94.511680	2717	2796	0	79	79	1.0000000
NODE_744_length_2791_cov_9.997028	310	390	1	48	80	0.6000000
NODE_744_length_2791_cov_9.997028	310	390	2	32	80	0.4000000
NODE_744_length_2791_cov_9.997028	363	443	1	27	80	0.3375000
NODE_744_length_2791_cov_9.997028	363	443	2	53	80	0.6625000
NODE_752_length_2778_cov_31.340799	2241	2321	5	12	80	0.1500000
NODE_752_length_2778_cov_31.340799	2241	2321	6	15	80	0.1875000
NODE_752_length_2778_cov_31.340799	2241	2321	7	14	80	0.1750000
NODE_752_length_2778_cov_31.340799	2241	2321	8	30	80	0.3750000
NODE_752_length_2778_cov_31.340799	2241	2321	11	9	80	0.1125000
NODE_752_length_2778_cov_31.340799	2294	2374	8	18	80	0.2250000
NODE_752_length_2778_cov_31.340799	2294	2374	9	35	80	0.4375000
NODE_752_length_2778_cov_31.340799	2294	2374	11	27	80	0.3375000
NODE_752_length_2778_cov_31.340799	2370	2450	8	7	80	0.0875000
NODE_752_length_2778_cov_31.340799	2370	2450	10	10	80	0.1250000
NODE_752_length_2778_cov_31.340799	2370	2450	11	5	80	0.0625000
NODE_752_length_2778_cov_31.340799	2370	2450	12	24	80	0.3000000
NODE_752_length_2778_cov_31.340799	2370	2450	13	4	80	0.0500000
NODE_752_length_2778_cov_31.340799	2370	2450	14	9	80	0.1125000
NODE_752_length_2778_cov_31.340799	2370	2450	15	12	80	0.1500000
NODE_752_length_2778_cov_31.340799	2370	2450	16	9	80	0.1125000
NODE_752_length_2778_cov_31.340799	2423	2503	4	18	80	0.2250000
NODE_752_length_2778_cov_31.340799	2423	2503	5	12	80	0.1500000
NODE_752_length_2778_cov_31.340799	2423	2503	6	17	80	0.2125000
NODE_752_length_2778_cov_31.340799	2423	2503	8	13	80	0.1625000
NODE_752_length_2778_cov_31.340799	2423	2503	10	10	80	0.1250000
NODE_752_length_2778_cov_31.340799	2423	2503	11	1	80	0.0125000
NODE_752_length_2778_cov_31.340799	2423	2503	12	9	80	0.1125000
NODE_752_length_2778_cov_31.340799	2564	2620	2	15	56	0.2678571
NODE_752_length_2778_cov_31.340799	2564	2620	3	40	56	0.7142857
NODE_752_length_2778_cov_31.340799	2564	2620	4	1	56	0.0178571
NODE_758_length_2767_cov_12.450150	1941	2021	4	80	80	1.0000000
NODE_758_length_2767_cov_12.450150	1994	2074	2	27	80	0.3375000
NODE_758_length_2767_cov_12.450150	1994	2074	4	53	80	0.6625000
NODE_767_length_2745_cov_5.322751	511	583	12	15	72	0.2083333
NODE_767_length_2745_cov_5.322751	511	583	13	16	72	0.2222222
NODE_767_length_2745_cov_5.322751	511	583	14	41	72	0.5694444
NODE_777_length_2720_cov_25.561618	2213	2293	0	80	80	1.0000000
NODE_777_length_2720_cov_25.561618	2266	2346	0	80	80	1.0000000
NODE_782_length_2716_cov_39.885747	715	795	5	46	80	0.5750000
NODE_782_length_2716_cov_39.885747	715	795	6	34	80	0.4250000
NODE_782_length_2716_cov_39.885747	768	848	1	19	80	0.2375000
NODE_782_length_2716_cov_39.885747	768	848	3	11	80	0.1375000
NODE_782_length_2716_cov_39.885747	768	848	4	3	80	0.0375000
NODE_782_length_2716_cov_39.885747	768	848	5	7	80	0.0875000
NODE_782_length_2716_cov_39.885747	768	848	6	40	80	0.5000000
NODE_782_length_2716_cov_39.885747	844	924	0	13	80	0.1625000
NODE_782_length_2716_cov_39.885747	844	924	1	67	80	0.8375000
NODE_782_length_2716_cov_39.885747	897	977	0	66	80	0.8250000
NODE_782_length_2716_cov_39.885747	897	977	1	14	80	0.1750000
NODE_785_length_2710_cov_10.896974	2410	2446	4	6	36	0.1666667
NODE_785_length_2710_cov_10.896974	2410	2446	5	30	36	0.8333333
NODE_785_length_2710_cov_10.896974	2419	2499	4	24	80	0.3000000
NODE_785_length_2710_cov_10.896974	2419	2499	5	33	80	0.4125000
NODE_785_length_2710_cov_10.896974	2419	2499	6	23	80	0.2875000
NODE_788_length_2708_cov_25.097355	2289	2369	6	7	80	0.0875000
NODE_788_length_2708_cov_25.097355	2289	2369	7	2	80	0.0250000
NODE_788_length_2708_cov_25.097355	2289	2369	8	9	80	0.1125000
NODE_788_length_2708_cov_25.097355	2289	2369	9	25	80	0.3125000
NODE_788_length_2708_cov_25.097355	2289	2369	10	37	80	0.4625000
NODE_788_length_2708_cov_25.097355	2342	2422	8	8	80	0.1000000
NODE_788_length_2708_cov_25.097355	2342	2422	9	29	80	0.3625000
NODE_788_length_2708_cov_25.097355	2342	2422	10	43	80	0.5375000
NODE_789_length_2708_cov_14.569950	18	98	6	2	80	0.0250000
NODE_789_length_2708_cov_14.569950	18	98	8	4	80	0.0500000
NODE_789_length_2708_cov_14.569950	18	98	10	2	80	0.0250000
NODE_789_length_2708_cov_14.569950	18	98	12	1	80	0.0125000
NODE_789_length_2708_cov_14.569950	18	98	14	5	80	0.0625000
NODE_789_length_2708_cov_14.569950	18	98	16	1	80	0.0125000
NODE_789_length_2708_cov_14.569950	18	98	17	65	80	0.8125000
NODE_789_length_2708_cov_14.569950	71	134	2	1	63	0.0158730
NODE_789_length_2708_cov_14.569950	71	134	3	2	63	0.0317460
NODE_789_length_2708_cov_14.569950	71	134	7	1	63	0.0158730
NODE_789_length_2708_cov_14.569950	71	134	13	2	63	0.0317460
NODE_789_length_2708_cov_14.569950	71	134	17	57	63	0.9047619
NODE_797_length_2691_cov_35.457948	401	481	2	3	80	0.0375000
NODE_797_length_2691_cov_35.457948	401	481	4	13	80	0.1625000
NODE_797_length_2691_cov_35.457948	401	481	5	38	80	0.4750000
NODE_797_length_2691_cov_35.457948	401	481	6	3	80	0.0375000
NODE_797_length_2691_cov_35.457948	401	481	7	23	80	0.2875000
NODE_797_length_2691_cov_35.457948	454	534	5	1	80	0.0125000
NODE_797_length_2691_cov_35.457948	454	534	6	35	80	0.4375000
NODE_797_length_2691_cov_35.457948	454	534	7	44	80	0.5500000
NODE_803_length_2684_cov_17.345068	146	194	5	11	48	0.2291667
NODE_803_length_2684_cov_17.345068	146	194	6	10	48	0.2083333
NODE_803_length_2684_cov_17.345068	146	194	7	11	48	0.2291667
NODE_803_length_2684_cov_17.345068	146	194	8	3	48	0.0625000
NODE_803_length_2684_cov_17.345068	146	194	9	2	48	0.0416667
NODE_803_length_2684_cov_17.345068	146	194	10	1	48	0.0208333
NODE_803_length_2684_cov_17.345068	146	194	11	10	48	0.2083333
NODE_803_length_2684_cov_17.345068	146	194	5	11	48	0.2291667
NODE_803_length_2684_cov_17.345068	146	194	6	10	48	0.2083333
NODE_803_length_2684_cov_17.345068	146	194	7	11	48	0.2291667
NODE_803_length_2684_cov_17.345068	146	194	8	3	48	0.0625000
NODE_803_length_2684_cov_17.345068	146	194	9	2	48	0.0416667
NODE_803_length_2684_cov_17.345068	146	194	10	1	48	0.0208333
NODE_803_length_2684_cov_17.345068	146	194	11	10	48	0.2083333
NODE_803_length_2684_cov_17.345068	146	194	5	11	48	0.2291667
NODE_803_length_2684_cov_17.345068	146	194	6	10	48	0.2083333
NODE_803_length_2684_cov_17.345068	146	194	7	11	48	0.2291667
NODE_803_length_2684_cov_17.345068	146	194	8	3	48	0.0625000
NODE_803_length_2684_cov_17.345068	146	194	9	2	48	0.0416667
NODE_803_length_2684_cov_17.345068	146	194	10	1	48	0.0208333
NODE_803_length_2684_cov_17.345068	146	194	11	10	48	0.2083333
NODE_803_length_2684_cov_17.345068	146	194	5	11	48	0.2291667
NODE_803_length_2684_cov_17.345068	146	194	6	10	48	0.2083333
NODE_803_length_2684_cov_17.345068	146	194	7	11	48	0.2291667
NODE_803_length_2684_cov_17.345068	146	194	8	3	48	0.0625000
NODE_803_length_2684_cov_17.345068	146	194	9	2	48	0.0416667
NODE_803_length_2684_cov_17.345068	146	194	10	1	48	0.0208333
NODE_803_length_2684_cov_17.345068	146	194	11	10	48	0.2083333
NODE_803_length_2684_cov_17.345068	146	194	5	11	48	0.2291667
NODE_803_length_2684_cov_17.345068	146	194	6	10	48	0.2083333
NODE_803_length_2684_cov_17.345068	146	194	7	11	48	0.2291667
NODE_803_length_2684_cov_17.345068	146	194	8	3	48	0.0625000
NODE_803_length_2684_cov_17.345068	146	194	9	2	48	0.0416667
NODE_803_length_2684_cov_17.345068	146	194	10	1	48	0.0208333
NODE_803_length_2684_cov_17.345068	146	194	11	10	48	0.2083333
NODE_805_length_2682_cov_43.500581	913	992	183	2	79	0.0253165
NODE_805_length_2682_cov_43.500581	913	992	184	3	79	0.0379747
NODE_805_length_2682_cov_43.500581	913	992	185	4	79	0.0506329
NODE_805_length_2682_cov_43.500581	913	992	188	2	79	0.0253165
NODE_805_length_2682_cov_43.500581	913	992	190	2	79	0.0253165
NODE_805_length_2682_cov_43.500581	913	992	191	1	79	0.0126582
NODE_805_length_2682_cov_43.500581	913	992	192	1	79	0.0126582
NODE_805_length_2682_cov_43.500581	913	992	198	1	79	0.0126582
NODE_805_length_2682_cov_43.500581	913	992	199	1	79	0.0126582
NODE_805_length_2682_cov_43.500581	913	992	200	1	79	0.0126582
NODE_805_length_2682_cov_43.500581	913	992	204	1	79	0.0126582
NODE_805_length_2682_cov_43.500581	913	992	207	2	79	0.0253165
NODE_805_length_2682_cov_43.500581	913	992	208	2	79	0.0253165
NODE_805_length_2682_cov_43.500581	913	992	211	1	79	0.0126582
NODE_805_length_2682_cov_43.500581	913	992	212	2	79	0.0253165
NODE_805_length_2682_cov_43.500581	913	992	214	1	79	0.0126582
NODE_805_length_2682_cov_43.500581	913	992	216	1	79	0.0126582
NODE_805_length_2682_cov_43.500581	913	992	217	2	79	0.0253165
NODE_805_length_2682_cov_43.500581	913	992	218	1	79	0.0126582
NODE_805_length_2682_cov_43.500581	913	992	219	4	79	0.0506329
NODE_805_length_2682_cov_43.500581	913	992	220	5	79	0.0632911
NODE_805_length_2682_cov_43.500581	913	992	222	1	79	0.0126582
NODE_805_length_2682_cov_43.500581	913	992	223	2	79	0.0253165
NODE_805_length_2682_cov_43.500581	913	992	229	1	79	0.0126582
NODE_805_length_2682_cov_43.500581	913	992	230	2	79	0.0253165
NODE_805_length_2682_cov_43.500581	913	992	231	4	79	0.0506329
NODE_805_length_2682_cov_43.500581	913	992	232	4	79	0.0506329
NODE_805_length_2682_cov_43.500581	913	992	233	10	79	0.1265823
NODE_805_length_2682_cov_43.500581	913	992	234	6	79	0.0759494
NODE_805_length_2682_cov_43.500581	913	992	235	4	79	0.0506329
NODE_805_length_2682_cov_43.500581	913	992	237	3	79	0.0379747
NODE_805_length_2682_cov_43.500581	913	992	238	2	79	0.0253165
NODE_805_length_2682_cov_43.500581	965	1002	227	1	37	0.0270270
NODE_805_length_2682_cov_43.500581	965	1002	229	3	37	0.0810811
NODE_805_length_2682_cov_43.500581	965	1002	230	1	37	0.0270270
NODE_805_length_2682_cov_43.500581	965	1002	231	5	37	0.1351351
NODE_805_length_2682_cov_43.500581	965	1002	232	7	37	0.1891892
NODE_805_length_2682_cov_43.500581	965	1002	233	5	37	0.1351351
NODE_805_length_2682_cov_43.500581	965	1002	234	6	37	0.1621622
NODE_805_length_2682_cov_43.500581	965	1002	235	4	37	0.1081081
NODE_805_length_2682_cov_43.500581	965	1002	237	3	37	0.0810811
NODE_805_length_2682_cov_43.500581	965	1002	238	2	37	0.0540541
NODE_808_length_2675_cov_10.369565	209	289	23	8	80	0.1000000
NODE_808_length_2675_cov_10.369565	209	289	24	7	80	0.0875000
NODE_808_length_2675_cov_10.369565	209	289	26	2	80	0.0250000
NODE_808_length_2675_cov_10.369565	209	289	29	3	80	0.0375000
NODE_808_length_2675_cov_10.369565	209	289	30	4	80	0.0500000
NODE_808_length_2675_cov_10.369565	209	289	31	2	80	0.0250000
NODE_808_length_2675_cov_10.369565	209	289	32	1	80	0.0125000
NODE_808_length_2675_cov_10.369565	209	289	33	13	80	0.1625000
NODE_808_length_2675_cov_10.369565	209	289	34	9	80	0.1125000
NODE_808_length_2675_cov_10.369565	209	289	35	1	80	0.0125000
NODE_808_length_2675_cov_10.369565	209	289	36	1	80	0.0125000
NODE_808_length_2675_cov_10.369565	209	289	38	4	80	0.0500000
NODE_808_length_2675_cov_10.369565	209	289	39	7	80	0.0875000
NODE_808_length_2675_cov_10.369565	209	289	40	9	80	0.1125000
NODE_808_length_2675_cov_10.369565	209	289	41	9	80	0.1125000
NODE_813_length_2670_cov_17.489304	1995	2075	0	23	80	0.2875000
NODE_813_length_2670_cov_17.489304	1995	2075	1	8	80	0.1000000
NODE_813_length_2670_cov_17.489304	1995	2075	3	49	80	0.6125000
NODE_813_length_2670_cov_17.489304	2048	2128	3	31	80	0.3875000
NODE_813_length_2670_cov_17.489304	2048	2128	5	49	80	0.6125000
NODE_813_length_2670_cov_17.489304	2124	2204	3	30	80	0.3750000
NODE_813_length_2670_cov_17.489304	2124	2204	4	32	80	0.4000000
NODE_813_length_2670_cov_17.489304	2124	2204	5	18	80	0.2250000
NODE_813_length_2670_cov_17.489304	2177	2257	3	36	80	0.4500000
NODE_813_length_2670_cov_17.489304	2177	2257	4	23	80	0.2875000
NODE_813_length_2670_cov_17.489304	2177	2257	5	21	80	0.2625000
NODE_815_length_2665_cov_19.145752	548	628	2	80	80	1.0000000
NODE_815_length_2665_cov_19.145752	601	681	0	3	80	0.0375000
NODE_815_length_2665_cov_19.145752	601	681	1	44	80	0.5500000
NODE_815_length_2665_cov_19.145752	601	681	2	33	80	0.4125000
NODE_815_length_2665_cov_19.145752	2099	2176	0	16	77	0.2077922
NODE_815_length_2665_cov_19.145752	2099	2176	1	19	77	0.2467532
NODE_815_length_2665_cov_19.145752	2099	2176	2	42	77	0.5454546
NODE_815_length_2665_cov_19.145752	2172	2252	2	73	80	0.9125000
NODE_815_length_2665_cov_19.145752	2172	2252	3	7	80	0.0875000
NODE_815_length_2665_cov_19.145752	2172	2252	2	73	80	0.9125000
NODE_815_length_2665_cov_19.145752	2172	2252	3	7	80	0.0875000
NODE_815_length_2665_cov_19.145752	2225	2267	2	22	42	0.5238096
NODE_815_length_2665_cov_19.145752	2225	2267	3	20	42	0.4761905
NODE_816_length_2664_cov_4.175049	2005	2085	3	31	80	0.3875000
NODE_816_length_2664_cov_4.175049	2005	2085	4	17	80	0.2125000
NODE_816_length_2664_cov_4.175049	2005	2085	5	32	80	0.4000000
NODE_816_length_2664_cov_4.175049	2058	2138	4	5	80	0.0625000
NODE_816_length_2664_cov_4.175049	2058	2138	5	59	80	0.7375000
NODE_816_length_2664_cov_4.175049	2058	2138	6	16	80	0.2000000
NODE_822_length_2650_cov_19.800862	800	880	10	7	80	0.0875000
NODE_822_length_2650_cov_19.800862	800	880	11	17	80	0.2125000
NODE_822_length_2650_cov_19.800862	800	880	12	26	80	0.3250000
NODE_822_length_2650_cov_19.800862	800	880	13	19	80	0.2375000
NODE_822_length_2650_cov_19.800862	800	880	14	11	80	0.1375000
NODE_824_length_2645_cov_8.618225	931	1011	3	20	80	0.2500000
NODE_824_length_2645_cov_8.618225	931	1011	4	28	80	0.3500000
NODE_824_length_2645_cov_8.618225	931	1011	5	32	80	0.4000000
NODE_824_length_2645_cov_8.618225	984	1064	2	36	80	0.4500000
NODE_824_length_2645_cov_8.618225	984	1064	3	37	80	0.4625000
NODE_824_length_2645_cov_8.618225	984	1064	5	7	80	0.0875000
NODE_827_length_2640_cov_16.462810	94	164	231	2	70	0.0285714
NODE_827_length_2640_cov_16.462810	94	164	233	3	70	0.0428571
NODE_827_length_2640_cov_16.462810	94	164	234	1	70	0.0142857
NODE_827_length_2640_cov_16.462810	94	164	238	1	70	0.0142857
NODE_827_length_2640_cov_16.462810	94	164	239	1	70	0.0142857
NODE_827_length_2640_cov_16.462810	94	164	241	1	70	0.0142857
NODE_827_length_2640_cov_16.462810	94	164	243	1	70	0.0142857
NODE_827_length_2640_cov_16.462810	94	164	244	1	70	0.0142857
NODE_827_length_2640_cov_16.462810	94	164	245	1	70	0.0142857
NODE_827_length_2640_cov_16.462810	94	164	247	1	70	0.0142857
NODE_827_length_2640_cov_16.462810	94	164	248	1	70	0.0142857
NODE_827_length_2640_cov_16.462810	94	164	249	1	70	0.0142857
NODE_827_length_2640_cov_16.462810	94	164	250	2	70	0.0285714
NODE_827_length_2640_cov_16.462810	94	164	253	1	70	0.0142857
NODE_827_length_2640_cov_16.462810	94	164	254	3	70	0.0428571
NODE_827_length_2640_cov_16.462810	94	164	257	1	70	0.0142857
NODE_827_length_2640_cov_16.462810	94	164	262	1	70	0.0142857
NODE_827_length_2640_cov_16.462810	94	164	266	1	70	0.0142857
NODE_827_length_2640_cov_16.462810	94	164	267	4	70	0.0571429
NODE_827_length_2640_cov_16.462810	94	164	268	1	70	0.0142857
NODE_827_length_2640_cov_16.462810	94	164	269	1	70	0.0142857
NODE_827_length_2640_cov_16.462810	94	164	270	1	70	0.0142857
NODE_827_length_2640_cov_16.462810	94	164	272	1	70	0.0142857
NODE_827_length_2640_cov_16.462810	94	164	273	1	70	0.0142857
NODE_827_length_2640_cov_16.462810	94	164	274	2	70	0.0285714
NODE_827_length_2640_cov_16.462810	94	164	275	6	70	0.0857143
NODE_827_length_2640_cov_16.462810	94	164	276	2	70	0.0285714
NODE_827_length_2640_cov_16.462810	94	164	277	1	70	0.0142857
NODE_827_length_2640_cov_16.462810	94	164	278	1	70	0.0142857
NODE_827_length_2640_cov_16.462810	94	164	279	2	70	0.0285714
NODE_827_length_2640_cov_16.462810	94	164	280	2	70	0.0285714
NODE_827_length_2640_cov_16.462810	94	164	281	2	70	0.0285714
NODE_827_length_2640_cov_16.462810	94	164	283	7	70	0.1000000
NODE_827_length_2640_cov_16.462810	94	164	284	3	70	0.0428571
NODE_827_length_2640_cov_16.462810	94	164	288	2	70	0.0285714
NODE_827_length_2640_cov_16.462810	94	164	289	5	70	0.0714286
NODE_827_length_2640_cov_16.462810	94	164	291	2	70	0.0285714
NODE_827_length_2640_cov_16.462810	147	209	183	1	62	0.0161290
NODE_827_length_2640_cov_16.462810	147	209	187	1	62	0.0161290
NODE_827_length_2640_cov_16.462810	147	209	192	1	62	0.0161290
NODE_827_length_2640_cov_16.462810	147	209	193	1	62	0.0161290
NODE_827_length_2640_cov_16.462810	147	209	194	1	62	0.0161290
NODE_827_length_2640_cov_16.462810	147	209	196	1	62	0.0161290
NODE_827_length_2640_cov_16.462810	147	209	198	1	62	0.0161290
NODE_827_length_2640_cov_16.462810	147	209	199	2	62	0.0322581
NODE_827_length_2640_cov_16.462810	147	209	200	1	62	0.0161290
NODE_827_length_2640_cov_16.462810	147	209	201	1	62	0.0161290
NODE_827_length_2640_cov_16.462810	147	209	203	1	62	0.0161290
NODE_827_length_2640_cov_16.462810	147	209	206	3	62	0.0483871
NODE_827_length_2640_cov_16.462810	147	209	208	1	62	0.0161290
NODE_827_length_2640_cov_16.462810	147	209	209	1	62	0.0161290
NODE_827_length_2640_cov_16.462810	147	209	212	1	62	0.0161290
NODE_827_length_2640_cov_16.462810	147	209	213	1	62	0.0161290
NODE_827_length_2640_cov_16.462810	147	209	215	1	62	0.0161290
NODE_827_length_2640_cov_16.462810	147	209	216	1	62	0.0161290
NODE_827_length_2640_cov_16.462810	147	209	217	2	62	0.0322581
NODE_827_length_2640_cov_16.462810	147	209	218	1	62	0.0161290
NODE_827_length_2640_cov_16.462810	147	209	219	2	62	0.0322581
NODE_827_length_2640_cov_16.462810	147	209	223	3	62	0.0483871
NODE_827_length_2640_cov_16.462810	147	209	224	3	62	0.0483871
NODE_827_length_2640_cov_16.462810	147	209	225	3	62	0.0483871
NODE_827_length_2640_cov_16.462810	147	209	226	6	62	0.0967742
NODE_827_length_2640_cov_16.462810	147	209	227	1	62	0.0161290
NODE_827_length_2640_cov_16.462810	147	209	228	3	62	0.0483871
NODE_827_length_2640_cov_16.462810	147	209	231	2	62	0.0322581
NODE_827_length_2640_cov_16.462810	147	209	233	3	62	0.0483871
NODE_827_length_2640_cov_16.462810	147	209	234	1	62	0.0161290
NODE_827_length_2640_cov_16.462810	147	209	238	1	62	0.0161290
NODE_827_length_2640_cov_16.462810	147	209	239	1	62	0.0161290
NODE_827_length_2640_cov_16.462810	147	209	241	1	62	0.0161290
NODE_827_length_2640_cov_16.462810	147	209	243	1	62	0.0161290
NODE_827_length_2640_cov_16.462810	147	209	244	1	62	0.0161290
NODE_827_length_2640_cov_16.462810	147	209	245	1	62	0.0161290
NODE_827_length_2640_cov_16.462810	147	209	247	1	62	0.0161290
NODE_827_length_2640_cov_16.462810	147	209	248	1	62	0.0161290
NODE_827_length_2640_cov_16.462810	147	209	249	1	62	0.0161290
NODE_827_length_2640_cov_16.462810	147	209	250	2	62	0.0322581
NODE_828_length_2636_cov_200.191171	561	641	65	2	80	0.0250000
NODE_828_length_2636_cov_200.191171	561	641	67	2	80	0.0250000
NODE_828_length_2636_cov_200.191171	561	641	68	3	80	0.0375000
NODE_828_length_2636_cov_200.191171	561	641	69	1	80	0.0125000
NODE_828_length_2636_cov_200.191171	561	641	70	2	80	0.0250000
NODE_828_length_2636_cov_200.191171	561	641	71	3	80	0.0375000
NODE_828_length_2636_cov_200.191171	561	641	72	1	80	0.0125000
NODE_828_length_2636_cov_200.191171	561	641	74	5	80	0.0625000
NODE_828_length_2636_cov_200.191171	561	641	75	1	80	0.0125000
NODE_828_length_2636_cov_200.191171	561	641	76	1	80	0.0125000
NODE_828_length_2636_cov_200.191171	561	641	77	4	80	0.0500000
NODE_828_length_2636_cov_200.191171	561	641	78	1	80	0.0125000
NODE_828_length_2636_cov_200.191171	561	641	79	1	80	0.0125000
NODE_828_length_2636_cov_200.191171	561	641	82	2	80	0.0250000
NODE_828_length_2636_cov_200.191171	561	641	84	3	80	0.0375000
NODE_828_length_2636_cov_200.191171	561	641	85	5	80	0.0625000
NODE_828_length_2636_cov_200.191171	561	641	86	1	80	0.0125000
NODE_828_length_2636_cov_200.191171	561	641	87	4	80	0.0500000
NODE_828_length_2636_cov_200.191171	561	641	88	2	80	0.0250000
NODE_828_length_2636_cov_200.191171	561	641	89	4	80	0.0500000
NODE_828_length_2636_cov_200.191171	561	641	90	2	80	0.0250000
NODE_828_length_2636_cov_200.191171	561	641	91	1	80	0.0125000
NODE_828_length_2636_cov_200.191171	561	641	92	3	80	0.0375000
NODE_828_length_2636_cov_200.191171	561	641	93	5	80	0.0625000
NODE_828_length_2636_cov_200.191171	561	641	94	4	80	0.0500000
NODE_828_length_2636_cov_200.191171	561	641	95	6	80	0.0750000
NODE_828_length_2636_cov_200.191171	561	641	96	8	80	0.1000000
NODE_828_length_2636_cov_200.191171	561	641	97	3	80	0.0375000
NODE_828_length_2636_cov_200.191171	614	695	39	2	81	0.0246914
NODE_828_length_2636_cov_200.191171	614	695	41	5	81	0.0617284
NODE_828_length_2636_cov_200.191171	614	695	42	1	81	0.0123457
NODE_828_length_2636_cov_200.191171	614	695	43	1	81	0.0123457
NODE_828_length_2636_cov_200.191171	614	695	44	2	81	0.0246914
NODE_828_length_2636_cov_200.191171	614	695	45	1	81	0.0123457
NODE_828_length_2636_cov_200.191171	614	695	49	7	81	0.0864198
NODE_828_length_2636_cov_200.191171	614	695	50	3	81	0.0370370
NODE_828_length_2636_cov_200.191171	614	695	51	3	81	0.0370370
NODE_828_length_2636_cov_200.191171	614	695	52	2	81	0.0246914
NODE_828_length_2636_cov_200.191171	614	695	53	7	81	0.0864198
NODE_828_length_2636_cov_200.191171	614	695	54	4	81	0.0493827
NODE_828_length_2636_cov_200.191171	614	695	55	3	81	0.0370370
NODE_828_length_2636_cov_200.191171	614	695	57	2	81	0.0246914
NODE_828_length_2636_cov_200.191171	614	695	60	4	81	0.0493827
NODE_828_length_2636_cov_200.191171	614	695	61	2	81	0.0246914
NODE_828_length_2636_cov_200.191171	614	695	62	1	81	0.0123457
NODE_828_length_2636_cov_200.191171	614	695	63	1	81	0.0123457
NODE_828_length_2636_cov_200.191171	614	695	65	2	81	0.0246914
NODE_828_length_2636_cov_200.191171	614	695	67	2	81	0.0246914
NODE_828_length_2636_cov_200.191171	614	695	68	5	81	0.0617284
NODE_828_length_2636_cov_200.191171	614	695	69	2	81	0.0246914
NODE_828_length_2636_cov_200.191171	614	695	70	2	81	0.0246914
NODE_828_length_2636_cov_200.191171	614	695	71	3	81	0.0370370
NODE_828_length_2636_cov_200.191171	614	695	72	1	81	0.0123457
NODE_828_length_2636_cov_200.191171	614	695	74	5	81	0.0617284
NODE_828_length_2636_cov_200.191171	614	695	75	1	81	0.0123457
NODE_828_length_2636_cov_200.191171	614	695	76	1	81	0.0123457
NODE_828_length_2636_cov_200.191171	614	695	77	4	81	0.0493827
NODE_828_length_2636_cov_200.191171	614	695	78	1	81	0.0123457
NODE_828_length_2636_cov_200.191171	614	695	79	1	81	0.0123457
NODE_830_length_2631_cov_10.831754	446	526	10	2	80	0.0250000
NODE_830_length_2631_cov_10.831754	446	526	11	18	80	0.2250000
NODE_830_length_2631_cov_10.831754	446	526	12	11	80	0.1375000
NODE_830_length_2631_cov_10.831754	446	526	13	14	80	0.1750000
NODE_830_length_2631_cov_10.831754	446	526	14	5	80	0.0625000
NODE_830_length_2631_cov_10.831754	446	526	15	6	80	0.0750000
NODE_830_length_2631_cov_10.831754	446	526	16	15	80	0.1875000
NODE_830_length_2631_cov_10.831754	446	526	17	9	80	0.1125000
NODE_830_length_2631_cov_10.831754	499	572	12	17	73	0.2328767
NODE_830_length_2631_cov_10.831754	499	572	13	31	73	0.4246575
NODE_830_length_2631_cov_10.831754	499	572	14	11	73	0.1506849
NODE_830_length_2631_cov_10.831754	499	572	16	5	73	0.0684932
NODE_830_length_2631_cov_10.831754	499	572	17	9	73	0.1232877
NODE_833_length_2622_cov_63.057471	1877	1953	76	1	76	0.0131579
NODE_833_length_2622_cov_63.057471	1877	1953	77	1	76	0.0131579
NODE_833_length_2622_cov_63.057471	1877	1953	80	1	76	0.0131579
NODE_833_length_2622_cov_63.057471	1877	1953	81	11	76	0.1447368
NODE_833_length_2622_cov_63.057471	1877	1953	82	1	76	0.0131579
NODE_833_length_2622_cov_63.057471	1877	1953	83	6	76	0.0789474
NODE_833_length_2622_cov_63.057471	1877	1953	84	17	76	0.2236842
NODE_833_length_2622_cov_63.057471	1877	1953	85	12	76	0.1578947
NODE_833_length_2622_cov_63.057471	1877	1953	86	13	76	0.1710526
NODE_833_length_2622_cov_63.057471	1877	1953	87	7	76	0.0921053
NODE_833_length_2622_cov_63.057471	1877	1953	89	6	76	0.0789474
NODE_833_length_2622_cov_63.057471	2426	2506	169	1	80	0.0125000
NODE_833_length_2622_cov_63.057471	2426	2506	170	3	80	0.0375000
NODE_833_length_2622_cov_63.057471	2426	2506	171	1	80	0.0125000
NODE_833_length_2622_cov_63.057471	2426	2506	173	1	80	0.0125000
NODE_833_length_2622_cov_63.057471	2426	2506	174	3	80	0.0375000
NODE_833_length_2622_cov_63.057471	2426	2506	177	1	80	0.0125000
NODE_833_length_2622_cov_63.057471	2426	2506	179	1	80	0.0125000
NODE_833_length_2622_cov_63.057471	2426	2506	182	2	80	0.0250000
NODE_833_length_2622_cov_63.057471	2426	2506	183	8	80	0.1000000
NODE_833_length_2622_cov_63.057471	2426	2506	184	4	80	0.0500000
NODE_833_length_2622_cov_63.057471	2426	2506	185	5	80	0.0625000
NODE_833_length_2622_cov_63.057471	2426	2506	186	3	80	0.0375000
NODE_833_length_2622_cov_63.057471	2426	2506	188	2	80	0.0250000
NODE_833_length_2622_cov_63.057471	2426	2506	189	6	80	0.0750000
NODE_833_length_2622_cov_63.057471	2426	2506	190	1	80	0.0125000
NODE_833_length_2622_cov_63.057471	2426	2506	193	3	80	0.0375000
NODE_833_length_2622_cov_63.057471	2426	2506	194	1	80	0.0125000
NODE_833_length_2622_cov_63.057471	2426	2506	195	1	80	0.0125000
NODE_833_length_2622_cov_63.057471	2426	2506	196	1	80	0.0125000
NODE_833_length_2622_cov_63.057471	2426	2506	197	2	80	0.0250000
NODE_833_length_2622_cov_63.057471	2426	2506	198	1	80	0.0125000
NODE_833_length_2622_cov_63.057471	2426	2506	199	2	80	0.0250000
NODE_833_length_2622_cov_63.057471	2426	2506	200	1	80	0.0125000
NODE_833_length_2622_cov_63.057471	2426	2506	201	5	80	0.0625000
NODE_833_length_2622_cov_63.057471	2426	2506	202	5	80	0.0625000
NODE_833_length_2622_cov_63.057471	2426	2506	203	2	80	0.0250000
NODE_833_length_2622_cov_63.057471	2426	2506	204	4	80	0.0500000
NODE_833_length_2622_cov_63.057471	2426	2506	205	2	80	0.0250000
NODE_833_length_2622_cov_63.057471	2426	2506	206	3	80	0.0375000
NODE_833_length_2622_cov_63.057471	2426	2506	207	3	80	0.0375000
NODE_833_length_2622_cov_63.057471	2426	2506	208	2	80	0.0250000
NODE_833_length_2622_cov_63.057471	2479	2559	101	1	80	0.0125000
NODE_833_length_2622_cov_63.057471	2479	2559	102	1	80	0.0125000
NODE_833_length_2622_cov_63.057471	2479	2559	104	1	80	0.0125000
NODE_833_length_2622_cov_63.057471	2479	2559	107	2	80	0.0250000
NODE_833_length_2622_cov_63.057471	2479	2559	108	4	80	0.0500000
NODE_833_length_2622_cov_63.057471	2479	2559	111	1	80	0.0125000
NODE_833_length_2622_cov_63.057471	2479	2559	112	1	80	0.0125000
NODE_833_length_2622_cov_63.057471	2479	2559	118	3	80	0.0375000
NODE_833_length_2622_cov_63.057471	2479	2559	119	1	80	0.0125000
NODE_833_length_2622_cov_63.057471	2479	2559	120	1	80	0.0125000
NODE_833_length_2622_cov_63.057471	2479	2559	126	1	80	0.0125000
NODE_833_length_2622_cov_63.057471	2479	2559	129	2	80	0.0250000
NODE_833_length_2622_cov_63.057471	2479	2559	130	3	80	0.0375000
NODE_833_length_2622_cov_63.057471	2479	2559	132	1	80	0.0125000
NODE_833_length_2622_cov_63.057471	2479	2559	134	3	80	0.0375000
NODE_833_length_2622_cov_63.057471	2479	2559	137	1	80	0.0125000
NODE_833_length_2622_cov_63.057471	2479	2559	139	1	80	0.0125000
NODE_833_length_2622_cov_63.057471	2479	2559	141	2	80	0.0250000
NODE_833_length_2622_cov_63.057471	2479	2559	143	1	80	0.0125000
NODE_833_length_2622_cov_63.057471	2479	2559	145	1	80	0.0125000
NODE_833_length_2622_cov_63.057471	2479	2559	146	2	80	0.0250000
NODE_833_length_2622_cov_63.057471	2479	2559	147	1	80	0.0125000
NODE_833_length_2622_cov_63.057471	2479	2559	148	1	80	0.0125000
NODE_833_length_2622_cov_63.057471	2479	2559	149	2	80	0.0250000
NODE_833_length_2622_cov_63.057471	2479	2559	150	1	80	0.0125000
NODE_833_length_2622_cov_63.057471	2479	2559	153	1	80	0.0125000
NODE_833_length_2622_cov_63.057471	2479	2559	157	1	80	0.0125000
NODE_833_length_2622_cov_63.057471	2479	2559	159	3	80	0.0375000
NODE_833_length_2622_cov_63.057471	2479	2559	160	2	80	0.0250000
NODE_833_length_2622_cov_63.057471	2479	2559	163	2	80	0.0250000
NODE_833_length_2622_cov_63.057471	2479	2559	165	2	80	0.0250000
NODE_833_length_2622_cov_63.057471	2479	2559	168	1	80	0.0125000
NODE_833_length_2622_cov_63.057471	2479	2559	169	3	80	0.0375000
NODE_833_length_2622_cov_63.057471	2479	2559	170	3	80	0.0375000
NODE_833_length_2622_cov_63.057471	2479	2559	171	1	80	0.0125000
NODE_833_length_2622_cov_63.057471	2479	2559	173	1	80	0.0125000
NODE_833_length_2622_cov_63.057471	2479	2559	174	3	80	0.0375000
NODE_833_length_2622_cov_63.057471	2479	2559	177	1	80	0.0125000
NODE_833_length_2622_cov_63.057471	2479	2559	179	1	80	0.0125000
NODE_833_length_2622_cov_63.057471	2479	2559	182	1	80	0.0125000
NODE_833_length_2622_cov_63.057471	2479	2559	183	2	80	0.0250000
NODE_833_length_2622_cov_63.057471	2479	2559	184	1	80	0.0125000
NODE_833_length_2622_cov_63.057471	2479	2559	185	4	80	0.0500000
NODE_833_length_2622_cov_63.057471	2479	2559	186	1	80	0.0125000
NODE_833_length_2622_cov_63.057471	2479	2559	188	1	80	0.0125000
NODE_833_length_2622_cov_63.057471	2479	2559	189	5	80	0.0625000
NODE_833_length_2622_cov_63.057471	2479	2559	190	1	80	0.0125000
NODE_836_length_2617_cov_16.817315	1404	1448	2	37	44	0.8409091
NODE_836_length_2617_cov_16.817315	1404	1448	3	7	44	0.1590909
NODE_836_length_2617_cov_16.817315	1467	1521	0	5	54	0.0925926
NODE_836_length_2617_cov_16.817315	1467	1521	1	23	54	0.4259259
NODE_836_length_2617_cov_16.817315	1467	1521	2	24	54	0.4444444
NODE_836_length_2617_cov_16.817315	1467	1521	4	2	54	0.0370370
NODE_839_length_2610_cov_2.232577	2127	2163	0	36	36	1.0000000
NODE_840_length_2609_cov_13.245418	2066	2146	3	18	80	0.2250000
NODE_840_length_2609_cov_13.245418	2066	2146	4	6	80	0.0750000
NODE_840_length_2609_cov_13.245418	2066	2146	5	56	80	0.7000000
NODE_840_length_2609_cov_13.245418	2119	2199	1	27	80	0.3375000
NODE_840_length_2609_cov_13.245418	2119	2199	3	37	80	0.4625000
NODE_840_length_2609_cov_13.245418	2119	2199	5	16	80	0.2000000
NODE_840_length_2609_cov_13.245418	2195	2275	0	46	80	0.5750000
NODE_840_length_2609_cov_13.245418	2195	2275	1	34	80	0.4250000
NODE_840_length_2609_cov_13.245418	2248	2328	0	80	80	1.0000000
NODE_845_length_2595_cov_5.638622	2157	2237	0	80	80	1.0000000
NODE_847_length_2594_cov_109.880160	386	450	174	1	64	0.0156250
NODE_847_length_2594_cov_109.880160	386	450	176	1	64	0.0156250
NODE_847_length_2594_cov_109.880160	386	450	178	1	64	0.0156250
NODE_847_length_2594_cov_109.880160	386	450	185	1	64	0.0156250
NODE_847_length_2594_cov_109.880160	386	450	192	1	64	0.0156250
NODE_847_length_2594_cov_109.880160	386	450	201	1	64	0.0156250
NODE_847_length_2594_cov_109.880160	386	450	203	1	64	0.0156250
NODE_847_length_2594_cov_109.880160	386	450	205	1	64	0.0156250
NODE_847_length_2594_cov_109.880160	386	450	206	1	64	0.0156250
NODE_847_length_2594_cov_109.880160	386	450	207	1	64	0.0156250
NODE_847_length_2594_cov_109.880160	386	450	210	3	64	0.0468750
NODE_847_length_2594_cov_109.880160	386	450	211	1	64	0.0156250
NODE_847_length_2594_cov_109.880160	386	450	214	1	64	0.0156250
NODE_847_length_2594_cov_109.880160	386	450	217	1	64	0.0156250
NODE_847_length_2594_cov_109.880160	386	450	218	1	64	0.0156250
NODE_847_length_2594_cov_109.880160	386	450	220	1	64	0.0156250
NODE_847_length_2594_cov_109.880160	386	450	224	1	64	0.0156250
NODE_847_length_2594_cov_109.880160	386	450	225	1	64	0.0156250
NODE_847_length_2594_cov_109.880160	386	450	232	1	64	0.0156250
NODE_847_length_2594_cov_109.880160	386	450	234	1	64	0.0156250
NODE_847_length_2594_cov_109.880160	386	450	236	1	64	0.0156250
NODE_847_length_2594_cov_109.880160	386	450	237	1	64	0.0156250
NODE_847_length_2594_cov_109.880160	386	450	239	1	64	0.0156250
NODE_847_length_2594_cov_109.880160	386	450	241	1	64	0.0156250
NODE_847_length_2594_cov_109.880160	386	450	245	1	64	0.0156250
NODE_847_length_2594_cov_109.880160	386	450	249	1	64	0.0156250
NODE_847_length_2594_cov_109.880160	386	450	255	1	64	0.0156250
NODE_847_length_2594_cov_109.880160	386	450	262	1	64	0.0156250
NODE_847_length_2594_cov_109.880160	386	450	263	1	64	0.0156250
NODE_847_length_2594_cov_109.880160	386	450	266	1	64	0.0156250
NODE_847_length_2594_cov_109.880160	386	450	270	1	64	0.0156250
NODE_847_length_2594_cov_109.880160	386	450	277	1	64	0.0156250
NODE_847_length_2594_cov_109.880160	386	450	280	4	64	0.0625000
NODE_847_length_2594_cov_109.880160	386	450	282	1	64	0.0156250
NODE_847_length_2594_cov_109.880160	386	450	287	1	64	0.0156250
NODE_847_length_2594_cov_109.880160	386	450	292	1	64	0.0156250
NODE_847_length_2594_cov_109.880160	386	450	297	1	64	0.0156250
NODE_847_length_2594_cov_109.880160	386	450	299	1	64	0.0156250
NODE_847_length_2594_cov_109.880160	386	450	301	2	64	0.0312500
NODE_847_length_2594_cov_109.880160	386	450	302	1	64	0.0156250
NODE_847_length_2594_cov_109.880160	386	450	303	2	64	0.0312500
NODE_847_length_2594_cov_109.880160	386	450	304	3	64	0.0468750
NODE_847_length_2594_cov_109.880160	386	450	305	5	64	0.0781250
NODE_847_length_2594_cov_109.880160	386	450	306	1	64	0.0156250
NODE_847_length_2594_cov_109.880160	386	450	307	1	64	0.0156250
NODE_847_length_2594_cov_109.880160	386	450	312	2	64	0.0312500
NODE_847_length_2594_cov_109.880160	386	450	313	1	64	0.0156250
NODE_847_length_2594_cov_109.880160	386	450	314	1	64	0.0156250
NODE_847_length_2594_cov_109.880160	386	450	315	1	64	0.0156250
NODE_847_length_2594_cov_109.880160	386	450	317	1	64	0.0156250
NODE_856_length_2575_cov_4.890549	1860	1912	4	1	52	0.0192308
NODE_856_length_2575_cov_4.890549	1860	1912	5	2	52	0.0384615
NODE_856_length_2575_cov_4.890549	1860	1912	6	5	52	0.0961538
NODE_856_length_2575_cov_4.890549	1860	1912	7	2	52	0.0384615
NODE_856_length_2575_cov_4.890549	1860	1912	9	10	52	0.1923077
NODE_856_length_2575_cov_4.890549	1860	1912	11	2	52	0.0384615
NODE_856_length_2575_cov_4.890549	1860	1912	12	16	52	0.3076923
NODE_856_length_2575_cov_4.890549	1860	1912	14	5	52	0.0961538
NODE_856_length_2575_cov_4.890549	1860	1912	15	9	52	0.1730769
NODE_857_length_2572_cov_46.828548	302	382	0	80	80	1.0000000
NODE_857_length_2572_cov_46.828548	355	435	0	80	80	1.0000000
NODE_868_length_2551_cov_40.721860	1104	1150	0	14	46	0.3043478
NODE_868_length_2551_cov_40.721860	1104	1150	1	32	46	0.6956522
NODE_868_length_2551_cov_40.721860	1199	1259	0	60	60	1.0000000
NODE_870_length_2547_cov_218.062908	436	486	10	1	50	0.0200000
NODE_870_length_2547_cov_218.062908	436	486	11	6	50	0.1200000
NODE_870_length_2547_cov_218.062908	436	486	12	14	50	0.2800000
NODE_870_length_2547_cov_218.062908	436	486	13	3	50	0.0600000
NODE_870_length_2547_cov_218.062908	436	486	14	1	50	0.0200000
NODE_870_length_2547_cov_218.062908	436	486	17	1	50	0.0200000
NODE_870_length_2547_cov_218.062908	436	486	45	1	50	0.0200000
NODE_870_length_2547_cov_218.062908	436	486	48	1	50	0.0200000
NODE_870_length_2547_cov_218.062908	436	486	53	1	50	0.0200000
NODE_870_length_2547_cov_218.062908	436	486	62	1	50	0.0200000
NODE_870_length_2547_cov_218.062908	436	486	72	1	50	0.0200000
NODE_870_length_2547_cov_218.062908	436	486	77	1	50	0.0200000
NODE_870_length_2547_cov_218.062908	436	486	81	1	50	0.0200000
NODE_870_length_2547_cov_218.062908	436	486	85	1	50	0.0200000
NODE_870_length_2547_cov_218.062908	436	486	87	2	50	0.0400000
NODE_870_length_2547_cov_218.062908	436	486	103	1	50	0.0200000
NODE_870_length_2547_cov_218.062908	436	486	120	1	50	0.0200000
NODE_870_length_2547_cov_218.062908	436	486	128	1	50	0.0200000
NODE_870_length_2547_cov_218.062908	436	486	130	1	50	0.0200000
NODE_870_length_2547_cov_218.062908	436	486	136	1	50	0.0200000
NODE_870_length_2547_cov_218.062908	436	486	147	1	50	0.0200000
NODE_870_length_2547_cov_218.062908	436	486	158	1	50	0.0200000
NODE_870_length_2547_cov_218.062908	436	486	167	1	50	0.0200000
NODE_870_length_2547_cov_218.062908	436	486	174	1	50	0.0200000
NODE_870_length_2547_cov_218.062908	436	486	203	1	50	0.0200000
NODE_870_length_2547_cov_218.062908	436	486	215	1	50	0.0200000
NODE_870_length_2547_cov_218.062908	436	486	220	1	50	0.0200000
NODE_870_length_2547_cov_218.062908	436	486	236	1	50	0.0200000
NODE_870_length_2547_cov_218.062908	436	486	264	1	50	0.0200000
NODE_879_length_2527_cov_27.275947	503	548	77	1	45	0.0222222
NODE_879_length_2527_cov_27.275947	503	548	79	4	45	0.0888889
NODE_879_length_2527_cov_27.275947	503	548	80	2	45	0.0444444
NODE_879_length_2527_cov_27.275947	503	548	81	3	45	0.0666667
NODE_879_length_2527_cov_27.275947	503	548	82	2	45	0.0444444
NODE_879_length_2527_cov_27.275947	503	548	84	3	45	0.0666667
NODE_879_length_2527_cov_27.275947	503	548	85	3	45	0.0666667
NODE_879_length_2527_cov_27.275947	503	548	86	7	45	0.1555556
NODE_879_length_2527_cov_27.275947	503	548	87	7	45	0.1555556
NODE_879_length_2527_cov_27.275947	503	548	88	10	45	0.2222222
NODE_879_length_2527_cov_27.275947	503	548	89	2	45	0.0444444
NODE_879_length_2527_cov_27.275947	503	548	91	1	45	0.0222222
NODE_884_length_2519_cov_15.991322	2122	2202	2	22	80	0.2750000
NODE_884_length_2519_cov_15.991322	2122	2202	8	58	80	0.7250000
NODE_884_length_2519_cov_15.991322	2175	2255	6	7	80	0.0875000
NODE_884_length_2519_cov_15.991322	2175	2255	8	73	80	0.9125000
NODE_885_length_2518_cov_7.035965	62	142	8	1	80	0.0125000
NODE_885_length_2518_cov_7.035965	62	142	9	7	80	0.0875000
NODE_885_length_2518_cov_7.035965	62	142	10	2	80	0.0250000
NODE_885_length_2518_cov_7.035965	62	142	11	11	80	0.1375000
NODE_885_length_2518_cov_7.035965	62	142	12	39	80	0.4875000
NODE_885_length_2518_cov_7.035965	62	142	13	20	80	0.2500000
NODE_885_length_2518_cov_7.035965	2005	2085	0	80	80	1.0000000
NODE_885_length_2518_cov_7.035965	2058	2138	0	80	80	1.0000000
NODE_887_length_2515_cov_37.984272	393	473	1	36	80	0.4500000
NODE_887_length_2515_cov_37.984272	393	473	3	27	80	0.3375000
NODE_887_length_2515_cov_37.984272	393	473	4	4	80	0.0500000
NODE_887_length_2515_cov_37.984272	393	473	5	13	80	0.1625000
NODE_887_length_2515_cov_37.984272	446	526	3	10	80	0.1250000
NODE_887_length_2515_cov_37.984272	446	526	4	14	80	0.1750000
NODE_887_length_2515_cov_37.984272	446	526	5	56	80	0.7000000
NODE_887_length_2515_cov_37.984272	1896	1976	1	60	80	0.7500000
NODE_887_length_2515_cov_37.984272	1896	1976	2	20	80	0.2500000
NODE_887_length_2515_cov_37.984272	1949	2029	1	80	80	1.0000000
NODE_887_length_2515_cov_37.984272	2025	2105	0	18	80	0.2250000
NODE_887_length_2515_cov_37.984272	2025	2105	1	41	80	0.5125000
NODE_887_length_2515_cov_37.984272	2025	2105	2	21	80	0.2625000
NODE_887_length_2515_cov_37.984272	2025	2104	0	18	79	0.2278481
NODE_887_length_2515_cov_37.984272	2025	2104	1	41	79	0.5189874
NODE_887_length_2515_cov_37.984272	2025	2104	2	20	79	0.2531646
NODE_887_length_2515_cov_37.984272	2078	2158	1	6	80	0.0750000
NODE_887_length_2515_cov_37.984272	2078	2158	2	74	80	0.9250000
NODE_888_length_2512_cov_48.259428	1299	1379	41	5	80	0.0625000
NODE_888_length_2512_cov_48.259428	1299	1379	42	11	80	0.1375000
NODE_888_length_2512_cov_48.259428	1299	1379	43	8	80	0.1000000
NODE_888_length_2512_cov_48.259428	1299	1379	44	3	80	0.0375000
NODE_888_length_2512_cov_48.259428	1299	1379	45	3	80	0.0375000
NODE_888_length_2512_cov_48.259428	1299	1379	47	1	80	0.0125000
NODE_888_length_2512_cov_48.259428	1299	1379	49	1	80	0.0125000
NODE_888_length_2512_cov_48.259428	1299	1379	50	2	80	0.0250000
NODE_888_length_2512_cov_48.259428	1299	1379	51	12	80	0.1500000
NODE_888_length_2512_cov_48.259428	1299	1379	52	8	80	0.1000000
NODE_888_length_2512_cov_48.259428	1299	1379	53	5	80	0.0625000
NODE_888_length_2512_cov_48.259428	1299	1379	54	5	80	0.0625000
NODE_888_length_2512_cov_48.259428	1299	1379	55	7	80	0.0875000
NODE_888_length_2512_cov_48.259428	1299	1379	56	2	80	0.0250000
NODE_888_length_2512_cov_48.259428	1299	1379	57	1	80	0.0125000
NODE_888_length_2512_cov_48.259428	1299	1379	58	3	80	0.0375000
NODE_888_length_2512_cov_48.259428	1299	1379	59	3	80	0.0375000
NODE_888_length_2512_cov_48.259428	1352	1432	51	1	80	0.0125000
NODE_888_length_2512_cov_48.259428	1352	1432	52	2	80	0.0250000
NODE_888_length_2512_cov_48.259428	1352	1432	53	4	80	0.0500000
NODE_888_length_2512_cov_48.259428	1352	1432	54	5	80	0.0625000
NODE_888_length_2512_cov_48.259428	1352	1432	55	16	80	0.2000000
NODE_888_length_2512_cov_48.259428	1352	1432	56	8	80	0.1000000
NODE_888_length_2512_cov_48.259428	1352	1432	57	5	80	0.0625000
NODE_888_length_2512_cov_48.259428	1352	1432	58	7	80	0.0875000
NODE_888_length_2512_cov_48.259428	1352	1432	59	5	80	0.0625000
NODE_888_length_2512_cov_48.259428	1352	1432	60	6	80	0.0750000
NODE_888_length_2512_cov_48.259428	1352	1432	61	5	80	0.0625000
NODE_888_length_2512_cov_48.259428	1352	1432	62	5	80	0.0625000
NODE_888_length_2512_cov_48.259428	1352	1432	63	3	80	0.0375000
NODE_888_length_2512_cov_48.259428	1352	1432	64	8	80	0.1000000
NODE_888_length_2512_cov_48.259428	1428	1512	61	3	84	0.0357143
NODE_888_length_2512_cov_48.259428	1428	1512	62	5	84	0.0595238
NODE_888_length_2512_cov_48.259428	1428	1512	63	12	84	0.1428571
NODE_888_length_2512_cov_48.259428	1428	1512	64	9	84	0.1071429
NODE_888_length_2512_cov_48.259428	1428	1512	65	4	84	0.0476190
NODE_888_length_2512_cov_48.259428	1428	1512	66	3	84	0.0357143
NODE_888_length_2512_cov_48.259428	1428	1512	67	2	84	0.0238095
NODE_888_length_2512_cov_48.259428	1428	1512	74	2	84	0.0238095
NODE_888_length_2512_cov_48.259428	1428	1512	75	1	84	0.0119048
NODE_888_length_2512_cov_48.259428	1428	1512	76	2	84	0.0238095
NODE_888_length_2512_cov_48.259428	1428	1512	77	3	84	0.0357143
NODE_888_length_2512_cov_48.259428	1428	1512	78	3	84	0.0357143
NODE_888_length_2512_cov_48.259428	1428	1512	79	3	84	0.0357143
NODE_888_length_2512_cov_48.259428	1428	1512	80	2	84	0.0238095
NODE_888_length_2512_cov_48.259428	1428	1512	81	5	84	0.0595238
NODE_888_length_2512_cov_48.259428	1428	1512	82	5	84	0.0595238
NODE_888_length_2512_cov_48.259428	1428	1512	83	10	84	0.1190476
NODE_888_length_2512_cov_48.259428	1428	1512	84	2	84	0.0238095
NODE_888_length_2512_cov_48.259428	1428	1512	85	2	84	0.0238095
NODE_888_length_2512_cov_48.259428	1428	1512	86	1	84	0.0119048
NODE_888_length_2512_cov_48.259428	1428	1512	87	5	84	0.0595238
NODE_888_length_2512_cov_48.259428	1485	1565	62	1	80	0.0125000
NODE_888_length_2512_cov_48.259428	1485	1565	63	1	80	0.0125000
NODE_888_length_2512_cov_48.259428	1485	1565	64	6	80	0.0750000
NODE_888_length_2512_cov_48.259428	1485	1565	65	6	80	0.0750000
NODE_888_length_2512_cov_48.259428	1485	1565	66	4	80	0.0500000
NODE_888_length_2512_cov_48.259428	1485	1565	67	3	80	0.0375000
NODE_888_length_2512_cov_48.259428	1485	1565	68	2	80	0.0250000
NODE_888_length_2512_cov_48.259428	1485	1565	69	5	80	0.0625000
NODE_888_length_2512_cov_48.259428	1485	1565	70	4	80	0.0500000
NODE_888_length_2512_cov_48.259428	1485	1565	71	2	80	0.0250000
NODE_888_length_2512_cov_48.259428	1485	1565	72	1	80	0.0125000
NODE_888_length_2512_cov_48.259428	1485	1565	74	1	80	0.0125000
NODE_888_length_2512_cov_48.259428	1485	1565	76	2	80	0.0250000
NODE_888_length_2512_cov_48.259428	1485	1565	77	7	80	0.0875000
NODE_888_length_2512_cov_48.259428	1485	1565	78	6	80	0.0750000
NODE_888_length_2512_cov_48.259428	1485	1565	79	8	80	0.1000000
NODE_888_length_2512_cov_48.259428	1485	1565	80	1	80	0.0125000
NODE_888_length_2512_cov_48.259428	1485	1565	81	5	80	0.0625000
NODE_888_length_2512_cov_48.259428	1485	1565	82	2	80	0.0250000
NODE_888_length_2512_cov_48.259428	1485	1565	83	3	80	0.0375000
NODE_888_length_2512_cov_48.259428	1485	1565	84	2	80	0.0250000
NODE_888_length_2512_cov_48.259428	1485	1565	85	2	80	0.0250000
NODE_888_length_2512_cov_48.259428	1485	1565	86	1	80	0.0125000
NODE_888_length_2512_cov_48.259428	1485	1565	87	5	80	0.0625000
NODE_891_length_2505_cov_102.009975	390	470	5	1	80	0.0125000
NODE_891_length_2505_cov_102.009975	390	470	6	1	80	0.0125000
NODE_891_length_2505_cov_102.009975	390	470	7	5	80	0.0625000
NODE_891_length_2505_cov_102.009975	390	470	9	9	80	0.1125000
NODE_891_length_2505_cov_102.009975	390	470	10	9	80	0.1125000
NODE_891_length_2505_cov_102.009975	390	470	11	6	80	0.0750000
NODE_891_length_2505_cov_102.009975	390	470	12	9	80	0.1125000
NODE_891_length_2505_cov_102.009975	390	470	14	6	80	0.0750000
NODE_891_length_2505_cov_102.009975	390	470	16	12	80	0.1500000
NODE_891_length_2505_cov_102.009975	390	470	18	18	80	0.2250000
NODE_891_length_2505_cov_102.009975	390	470	20	4	80	0.0500000
NODE_891_length_2505_cov_102.009975	443	510	0	6	67	0.0895522
NODE_891_length_2505_cov_102.009975	443	510	1	1	67	0.0149254
NODE_891_length_2505_cov_102.009975	443	510	2	4	67	0.0597015
NODE_891_length_2505_cov_102.009975	443	510	3	9	67	0.1343284
NODE_891_length_2505_cov_102.009975	443	510	4	6	67	0.0895522
NODE_891_length_2505_cov_102.009975	443	510	5	15	67	0.2238806
NODE_891_length_2505_cov_102.009975	443	510	6	1	67	0.0149254
NODE_891_length_2505_cov_102.009975	443	510	7	5	67	0.0746269
NODE_891_length_2505_cov_102.009975	443	510	9	9	67	0.1343284
NODE_891_length_2505_cov_102.009975	443	510	10	9	67	0.1343284
NODE_891_length_2505_cov_102.009975	443	510	11	2	67	0.0298507
NODE_894_length_2499_cov_2.655417	2325	2375	4	12	50	0.2400000
NODE_894_length_2499_cov_2.655417	2325	2375	6	3	50	0.0600000
NODE_894_length_2499_cov_2.655417	2325	2375	8	4	50	0.0800000
NODE_894_length_2499_cov_2.655417	2325	2375	9	4	50	0.0800000
NODE_894_length_2499_cov_2.655417	2325	2375	11	6	50	0.1200000
NODE_894_length_2499_cov_2.655417	2325	2375	15	21	50	0.4200000
NODE_895_length_2498_cov_9.614840	239	281	4	42	42	1.0000000
NODE_895_length_2498_cov_9.614840	254	335	2	34	81	0.4197531
NODE_895_length_2498_cov_9.614840	254	335	3	5	81	0.0617284
NODE_895_length_2498_cov_9.614840	254	335	4	27	81	0.3333333
NODE_895_length_2498_cov_9.614840	254	335	5	13	81	0.1604938
NODE_895_length_2498_cov_9.614840	254	335	6	2	81	0.0246914
NODE_895_length_2498_cov_9.614840	254	335	2	34	81	0.4197531
NODE_895_length_2498_cov_9.614840	254	335	3	5	81	0.0617284
NODE_895_length_2498_cov_9.614840	254	335	4	27	81	0.3333333
NODE_895_length_2498_cov_9.614840	254	335	5	13	81	0.1604938
NODE_895_length_2498_cov_9.614840	254	335	6	2	81	0.0246914
NODE_895_length_2498_cov_9.614840	331	411	4	15	80	0.1875000
NODE_895_length_2498_cov_9.614840	331	411	5	47	80	0.5875000
NODE_895_length_2498_cov_9.614840	331	411	6	18	80	0.2250000
NODE_895_length_2498_cov_9.614840	384	464	3	10	80	0.1250000
NODE_895_length_2498_cov_9.614840	384	464	4	3	80	0.0375000
NODE_895_length_2498_cov_9.614840	384	464	5	67	80	0.8375000
NODE_898_length_2495_cov_5.151085	2395	2444	1	10	49	0.2040816
NODE_898_length_2495_cov_5.151085	2395	2444	2	16	49	0.3265306
NODE_898_length_2495_cov_5.151085	2395	2444	4	16	49	0.3265306
NODE_898_length_2495_cov_5.151085	2395	2444	6	7	49	0.1428571
NODE_898_length_2495_cov_5.151085	2395	2444	1	10	49	0.2040816
NODE_898_length_2495_cov_5.151085	2395	2444	2	16	49	0.3265306
NODE_898_length_2495_cov_5.151085	2395	2444	4	16	49	0.3265306
NODE_898_length_2495_cov_5.151085	2395	2444	6	7	49	0.1428571
NODE_898_length_2495_cov_5.151085	2396	2444	1	10	48	0.2083333
NODE_898_length_2495_cov_5.151085	2396	2444	2	16	48	0.3333333
NODE_898_length_2495_cov_5.151085	2396	2444	4	16	48	0.3333333
NODE_898_length_2495_cov_5.151085	2396	2444	6	6	48	0.1250000
NODE_898_length_2495_cov_5.151085	2396	2444	1	10	48	0.2083333
NODE_898_length_2495_cov_5.151085	2396	2444	2	16	48	0.3333333
NODE_898_length_2495_cov_5.151085	2396	2444	4	16	48	0.3333333
NODE_898_length_2495_cov_5.151085	2396	2444	6	6	48	0.1250000
NODE_898_length_2495_cov_5.151085	2396	2444	1	10	48	0.2083333
NODE_898_length_2495_cov_5.151085	2396	2444	2	16	48	0.3333333
NODE_898_length_2495_cov_5.151085	2396	2444	4	16	48	0.3333333
NODE_898_length_2495_cov_5.151085	2396	2444	6	6	48	0.1250000
NODE_900_length_2492_cov_43.645215	408	488	2	11	80	0.1375000
NODE_900_length_2492_cov_43.645215	408	488	4	48	80	0.6000000
NODE_900_length_2492_cov_43.645215	408	488	5	21	80	0.2625000
NODE_903_length_2489_cov_15.105021	204	234	0	25	30	0.8333333
NODE_903_length_2489_cov_15.105021	204	234	2	5	30	0.1666667
NODE_905_length_2488_cov_2.434910	2141	2200	38	10	59	0.1694915
NODE_905_length_2488_cov_2.434910	2141	2200	39	8	59	0.1355932
NODE_905_length_2488_cov_2.434910	2141	2200	40	9	59	0.1525424
NODE_905_length_2488_cov_2.434910	2141	2200	41	9	59	0.1525424
NODE_905_length_2488_cov_2.434910	2141	2200	42	7	59	0.1186441
NODE_905_length_2488_cov_2.434910	2141	2200	43	2	59	0.0338983
NODE_905_length_2488_cov_2.434910	2141	2200	45	4	59	0.0677966
NODE_905_length_2488_cov_2.434910	2141	2200	46	1	59	0.0169492
NODE_905_length_2488_cov_2.434910	2141	2200	47	6	59	0.1016949
NODE_905_length_2488_cov_2.434910	2141	2200	48	3	59	0.0508475
NODE_906_length_2484_cov_335.301887	224	279	408	3	55	0.0545455
NODE_906_length_2484_cov_335.301887	224	279	410	3	55	0.0545455
NODE_906_length_2484_cov_335.301887	224	279	411	4	55	0.0727273
NODE_906_length_2484_cov_335.301887	224	279	412	4	55	0.0727273
NODE_906_length_2484_cov_335.301887	224	279	413	2	55	0.0363636
NODE_906_length_2484_cov_335.301887	224	279	415	3	55	0.0545455
NODE_906_length_2484_cov_335.301887	224	279	416	2	55	0.0363636
NODE_906_length_2484_cov_335.301887	224	279	417	2	55	0.0363636
NODE_906_length_2484_cov_335.301887	224	279	418	1	55	0.0181818
NODE_906_length_2484_cov_335.301887	224	279	419	2	55	0.0363636
NODE_906_length_2484_cov_335.301887	224	279	420	3	55	0.0545455
NODE_906_length_2484_cov_335.301887	224	279	421	3	55	0.0545455
NODE_906_length_2484_cov_335.301887	224	279	422	3	55	0.0545455
NODE_906_length_2484_cov_335.301887	224	279	423	4	55	0.0727273
NODE_906_length_2484_cov_335.301887	224	279	424	4	55	0.0727273
NODE_906_length_2484_cov_335.301887	224	279	425	1	55	0.0181818
NODE_906_length_2484_cov_335.301887	224	279	429	3	55	0.0545455
NODE_906_length_2484_cov_335.301887	224	279	430	1	55	0.0181818
NODE_906_length_2484_cov_335.301887	224	279	431	1	55	0.0181818
NODE_906_length_2484_cov_335.301887	224	279	433	2	55	0.0363636
NODE_906_length_2484_cov_335.301887	224	279	434	2	55	0.0363636
NODE_906_length_2484_cov_335.301887	224	279	435	1	55	0.0181818
NODE_906_length_2484_cov_335.301887	224	279	436	1	55	0.0181818
NODE_906_length_2484_cov_335.301887	252	332	392	2	80	0.0250000
NODE_906_length_2484_cov_335.301887	252	332	393	2	80	0.0250000
NODE_906_length_2484_cov_335.301887	252	332	394	2	80	0.0250000
NODE_906_length_2484_cov_335.301887	252	332	395	2	80	0.0250000
NODE_906_length_2484_cov_335.301887	252	332	396	2	80	0.0250000
NODE_906_length_2484_cov_335.301887	252	332	397	1	80	0.0125000
NODE_906_length_2484_cov_335.301887	252	332	398	1	80	0.0125000
NODE_906_length_2484_cov_335.301887	252	332	399	1	80	0.0125000
NODE_906_length_2484_cov_335.301887	252	332	402	1	80	0.0125000
NODE_906_length_2484_cov_335.301887	252	332	405	2	80	0.0250000
NODE_906_length_2484_cov_335.301887	252	332	408	4	80	0.0500000
NODE_906_length_2484_cov_335.301887	252	332	410	1	80	0.0125000
NODE_906_length_2484_cov_335.301887	252	332	411	2	80	0.0250000
NODE_906_length_2484_cov_335.301887	252	332	412	5	80	0.0625000
NODE_906_length_2484_cov_335.301887	252	332	413	3	80	0.0375000
NODE_906_length_2484_cov_335.301887	252	332	414	1	80	0.0125000
NODE_906_length_2484_cov_335.301887	252	332	415	2	80	0.0250000
NODE_906_length_2484_cov_335.301887	252	332	416	4	80	0.0500000
NODE_906_length_2484_cov_335.301887	252	332	417	1	80	0.0125000
NODE_906_length_2484_cov_335.301887	252	332	418	2	80	0.0250000
NODE_906_length_2484_cov_335.301887	252	332	419	1	80	0.0125000
NODE_906_length_2484_cov_335.301887	252	332	420	1	80	0.0125000
NODE_906_length_2484_cov_335.301887	252	332	421	1	80	0.0125000
NODE_906_length_2484_cov_335.301887	252	332	422	2	80	0.0250000
NODE_906_length_2484_cov_335.301887	252	332	423	3	80	0.0375000
NODE_906_length_2484_cov_335.301887	252	332	424	5	80	0.0625000
NODE_906_length_2484_cov_335.301887	252	332	425	2	80	0.0250000
NODE_906_length_2484_cov_335.301887	252	332	426	3	80	0.0375000
NODE_906_length_2484_cov_335.301887	252	332	427	5	80	0.0625000
NODE_906_length_2484_cov_335.301887	252	332	428	2	80	0.0250000
NODE_906_length_2484_cov_335.301887	252	332	429	5	80	0.0625000
NODE_906_length_2484_cov_335.301887	252	332	430	2	80	0.0250000
NODE_906_length_2484_cov_335.301887	252	332	431	3	80	0.0375000
NODE_906_length_2484_cov_335.301887	252	332	432	2	80	0.0250000
NODE_906_length_2484_cov_335.301887	252	332	433	1	80	0.0125000
NODE_906_length_2484_cov_335.301887	252	332	435	1	80	0.0125000
NODE_912_length_2479_cov_90.381092	369	449	2	80	80	1.0000000
NODE_912_length_2479_cov_90.381092	422	499	1	11	77	0.1428571
NODE_912_length_2479_cov_90.381092	422	499	2	66	77	0.8571429
NODE_912_length_2479_cov_90.381092	1610	1685	87	1	75	0.0133333
NODE_912_length_2479_cov_90.381092	1610	1685	95	1	75	0.0133333
NODE_912_length_2479_cov_90.381092	1610	1685	97	1	75	0.0133333
NODE_912_length_2479_cov_90.381092	1610	1685	103	2	75	0.0266667
NODE_912_length_2479_cov_90.381092	1610	1685	110	1	75	0.0133333
NODE_912_length_2479_cov_90.381092	1610	1685	111	1	75	0.0133333
NODE_912_length_2479_cov_90.381092	1610	1685	112	1	75	0.0133333
NODE_912_length_2479_cov_90.381092	1610	1685	115	1	75	0.0133333
NODE_912_length_2479_cov_90.381092	1610	1685	122	2	75	0.0266667
NODE_912_length_2479_cov_90.381092	1610	1685	125	1	75	0.0133333
NODE_912_length_2479_cov_90.381092	1610	1685	135	1	75	0.0133333
NODE_912_length_2479_cov_90.381092	1610	1685	137	1	75	0.0133333
NODE_912_length_2479_cov_90.381092	1610	1685	139	1	75	0.0133333
NODE_912_length_2479_cov_90.381092	1610	1685	142	1	75	0.0133333
NODE_912_length_2479_cov_90.381092	1610	1685	143	1	75	0.0133333
NODE_912_length_2479_cov_90.381092	1610	1685	149	1	75	0.0133333
NODE_912_length_2479_cov_90.381092	1610	1685	156	1	75	0.0133333
NODE_912_length_2479_cov_90.381092	1610	1685	171	1	75	0.0133333
NODE_912_length_2479_cov_90.381092	1610	1685	184	1	75	0.0133333
NODE_912_length_2479_cov_90.381092	1610	1685	190	1	75	0.0133333
NODE_912_length_2479_cov_90.381092	1610	1685	210	1	75	0.0133333
NODE_912_length_2479_cov_90.381092	1610	1685	216	1	75	0.0133333
NODE_912_length_2479_cov_90.381092	1610	1685	219	2	75	0.0266667
NODE_912_length_2479_cov_90.381092	1610	1685	226	1	75	0.0133333
NODE_912_length_2479_cov_90.381092	1610	1685	230	2	75	0.0266667
NODE_912_length_2479_cov_90.381092	1610	1685	231	1	75	0.0133333
NODE_912_length_2479_cov_90.381092	1610	1685	234	1	75	0.0133333
NODE_912_length_2479_cov_90.381092	1610	1685	235	1	75	0.0133333
NODE_912_length_2479_cov_90.381092	1610	1685	239	1	75	0.0133333
NODE_912_length_2479_cov_90.381092	1610	1685	245	1	75	0.0133333
NODE_912_length_2479_cov_90.381092	1610	1685	252	1	75	0.0133333
NODE_912_length_2479_cov_90.381092	1610	1685	265	1	75	0.0133333
NODE_912_length_2479_cov_90.381092	1610	1685	268	1	75	0.0133333
NODE_912_length_2479_cov_90.381092	1610	1685	273	1	75	0.0133333
NODE_912_length_2479_cov_90.381092	1610	1685	274	1	75	0.0133333
NODE_912_length_2479_cov_90.381092	1610	1685	277	1	75	0.0133333
NODE_912_length_2479_cov_90.381092	1610	1685	281	1	75	0.0133333
NODE_912_length_2479_cov_90.381092	1610	1685	283	1	75	0.0133333
NODE_912_length_2479_cov_90.381092	1610	1685	296	1	75	0.0133333
NODE_912_length_2479_cov_90.381092	1610	1685	300	1	75	0.0133333
NODE_912_length_2479_cov_90.381092	1610	1685	301	1	75	0.0133333
NODE_912_length_2479_cov_90.381092	1610	1685	305	1	75	0.0133333
NODE_912_length_2479_cov_90.381092	1610	1685	323	1	75	0.0133333
NODE_912_length_2479_cov_90.381092	1610	1685	324	1	75	0.0133333
NODE_912_length_2479_cov_90.381092	1610	1685	328	1	75	0.0133333
NODE_912_length_2479_cov_90.381092	1610	1685	333	1	75	0.0133333
NODE_912_length_2479_cov_90.381092	1610	1685	335	1	75	0.0133333
NODE_912_length_2479_cov_90.381092	1610	1685	342	1	75	0.0133333
NODE_912_length_2479_cov_90.381092	1610	1685	345	1	75	0.0133333
NODE_912_length_2479_cov_90.381092	1610	1685	346	1	75	0.0133333
NODE_912_length_2479_cov_90.381092	1610	1685	347	1	75	0.0133333
NODE_912_length_2479_cov_90.381092	1610	1685	349	1	75	0.0133333
NODE_912_length_2479_cov_90.381092	1610	1685	352	1	75	0.0133333
NODE_912_length_2479_cov_90.381092	1610	1685	354	1	75	0.0133333
NODE_912_length_2479_cov_90.381092	1610	1685	356	1	75	0.0133333
NODE_912_length_2479_cov_90.381092	1610	1685	362	1	75	0.0133333
NODE_912_length_2479_cov_90.381092	1610	1685	366	1	75	0.0133333
NODE_912_length_2479_cov_90.381092	1610	1685	368	1	75	0.0133333
NODE_912_length_2479_cov_90.381092	1610	1685	370	2	75	0.0266667
NODE_912_length_2479_cov_90.381092	1610	1685	374	1	75	0.0133333
NODE_912_length_2479_cov_90.381092	1610	1685	382	1	75	0.0133333
NODE_912_length_2479_cov_90.381092	1610	1685	384	1	75	0.0133333
NODE_912_length_2479_cov_90.381092	1610	1685	385	1	75	0.0133333
NODE_912_length_2479_cov_90.381092	1610	1685	388	1	75	0.0133333
NODE_912_length_2479_cov_90.381092	1610	1685	390	1	75	0.0133333
NODE_912_length_2479_cov_90.381092	1610	1685	399	1	75	0.0133333
NODE_912_length_2479_cov_90.381092	1610	1685	402	1	75	0.0133333
NODE_912_length_2479_cov_90.381092	1610	1685	408	1	75	0.0133333
NODE_912_length_2479_cov_90.381092	1610	1685	416	1	75	0.0133333
NODE_912_length_2479_cov_90.381092	1610	1685	419	1	75	0.0133333
NODE_912_length_2479_cov_90.381092	1658	1730	328	1	72	0.0138889
NODE_912_length_2479_cov_90.381092	1658	1730	333	1	72	0.0138889
NODE_912_length_2479_cov_90.381092	1658	1730	335	1	72	0.0138889
NODE_912_length_2479_cov_90.381092	1658	1730	342	1	72	0.0138889
NODE_912_length_2479_cov_90.381092	1658	1730	345	1	72	0.0138889
NODE_912_length_2479_cov_90.381092	1658	1730	346	1	72	0.0138889
NODE_912_length_2479_cov_90.381092	1658	1730	347	1	72	0.0138889
NODE_912_length_2479_cov_90.381092	1658	1730	349	1	72	0.0138889
NODE_912_length_2479_cov_90.381092	1658	1730	352	1	72	0.0138889
NODE_912_length_2479_cov_90.381092	1658	1730	354	1	72	0.0138889
NODE_912_length_2479_cov_90.381092	1658	1730	356	1	72	0.0138889
NODE_912_length_2479_cov_90.381092	1658	1730	362	1	72	0.0138889
NODE_912_length_2479_cov_90.381092	1658	1730	366	1	72	0.0138889
NODE_912_length_2479_cov_90.381092	1658	1730	368	1	72	0.0138889
NODE_912_length_2479_cov_90.381092	1658	1730	370	2	72	0.0277778
NODE_912_length_2479_cov_90.381092	1658	1730	374	1	72	0.0138889
NODE_912_length_2479_cov_90.381092	1658	1730	382	1	72	0.0138889
NODE_912_length_2479_cov_90.381092	1658	1730	384	1	72	0.0138889
NODE_912_length_2479_cov_90.381092	1658	1730	385	1	72	0.0138889
NODE_912_length_2479_cov_90.381092	1658	1730	388	1	72	0.0138889
NODE_912_length_2479_cov_90.381092	1658	1730	390	1	72	0.0138889
NODE_912_length_2479_cov_90.381092	1658	1730	399	1	72	0.0138889
NODE_912_length_2479_cov_90.381092	1658	1730	402	1	72	0.0138889
NODE_912_length_2479_cov_90.381092	1658	1730	408	1	72	0.0138889
NODE_912_length_2479_cov_90.381092	1658	1730	416	1	72	0.0138889
NODE_912_length_2479_cov_90.381092	1658	1730	418	1	72	0.0138889
NODE_912_length_2479_cov_90.381092	1658	1730	419	1	72	0.0138889
NODE_912_length_2479_cov_90.381092	1658	1730	421	1	72	0.0138889
NODE_912_length_2479_cov_90.381092	1658	1730	422	1	72	0.0138889
NODE_912_length_2479_cov_90.381092	1658	1730	423	2	72	0.0277778
NODE_912_length_2479_cov_90.381092	1658	1730	424	2	72	0.0277778
NODE_912_length_2479_cov_90.381092	1658	1730	432	1	72	0.0138889
NODE_912_length_2479_cov_90.381092	1658	1730	433	1	72	0.0138889
NODE_912_length_2479_cov_90.381092	1658	1730	435	1	72	0.0138889
NODE_912_length_2479_cov_90.381092	1658	1730	440	1	72	0.0138889
NODE_912_length_2479_cov_90.381092	1658	1730	444	1	72	0.0138889
NODE_912_length_2479_cov_90.381092	1658	1730	446	1	72	0.0138889
NODE_912_length_2479_cov_90.381092	1658	1730	452	3	72	0.0416667
NODE_912_length_2479_cov_90.381092	1658	1730	456	1	72	0.0138889
NODE_912_length_2479_cov_90.381092	1658	1730	458	2	72	0.0277778
NODE_912_length_2479_cov_90.381092	1658	1730	460	1	72	0.0138889
NODE_912_length_2479_cov_90.381092	1658	1730	466	1	72	0.0138889
NODE_912_length_2479_cov_90.381092	1658	1730	467	2	72	0.0277778
NODE_912_length_2479_cov_90.381092	1658	1730	469	1	72	0.0138889
NODE_912_length_2479_cov_90.381092	1658	1730	470	1	72	0.0138889
NODE_912_length_2479_cov_90.381092	1658	1730	473	1	72	0.0138889
NODE_912_length_2479_cov_90.381092	1658	1730	474	1	72	0.0138889
NODE_912_length_2479_cov_90.381092	1658	1730	475	1	72	0.0138889
NODE_912_length_2479_cov_90.381092	1658	1730	485	1	72	0.0138889
NODE_912_length_2479_cov_90.381092	1658	1730	489	1	72	0.0138889
NODE_912_length_2479_cov_90.381092	1658	1730	490	1	72	0.0138889
NODE_912_length_2479_cov_90.381092	1658	1730	492	2	72	0.0277778
NODE_912_length_2479_cov_90.381092	1658	1730	493	1	72	0.0138889
NODE_912_length_2479_cov_90.381092	1658	1730	496	1	72	0.0138889
NODE_912_length_2479_cov_90.381092	1658	1730	500	1	72	0.0138889
NODE_912_length_2479_cov_90.381092	1658	1730	503	1	72	0.0138889
NODE_912_length_2479_cov_90.381092	1658	1730	504	1	72	0.0138889
NODE_912_length_2479_cov_90.381092	1658	1730	505	1	72	0.0138889
NODE_912_length_2479_cov_90.381092	1658	1730	506	1	72	0.0138889
NODE_912_length_2479_cov_90.381092	1658	1730	507	2	72	0.0277778
NODE_912_length_2479_cov_90.381092	1658	1730	508	1	72	0.0138889
NODE_912_length_2479_cov_90.381092	1658	1730	509	2	72	0.0277778
NODE_913_length_2479_cov_3.433193	2379	2426	0	47	47	1.0000000
NODE_913_length_2479_cov_3.433193	2399	2479	0	80	80	1.0000000
NODE_915_length_2474_cov_7.237895	399	479	0	80	80	1.0000000
NODE_915_length_2474_cov_7.237895	452	532	0	80	80	1.0000000
NODE_922_length_2465_cov_3.098056	2133	2213	0	1	80	0.0125000
NODE_922_length_2465_cov_3.098056	2133	2213	1	79	80	0.9875000
NODE_922_length_2465_cov_3.098056	2191	2253	1	62	62	1.0000000
NODE_923_length_2464_cov_24.562791	331	409	2	49	78	0.6282051
NODE_923_length_2464_cov_24.562791	331	409	4	29	78	0.3717949
NODE_923_length_2464_cov_24.562791	382	462	4	80	80	1.0000000
NODE_924_length_2461_cov_2.696444	292	372	0	80	80	1.0000000
NODE_924_length_2461_cov_2.696444	345	425	0	80	80	1.0000000
NODE_938_length_2447_cov_16.079216	2344	2424	45	1	80	0.0125000
NODE_938_length_2447_cov_16.079216	2344	2424	48	2	80	0.0250000
NODE_938_length_2447_cov_16.079216	2344	2424	50	1	80	0.0125000
NODE_938_length_2447_cov_16.079216	2344	2424	51	1	80	0.0125000
NODE_938_length_2447_cov_16.079216	2344	2424	52	3	80	0.0375000
NODE_938_length_2447_cov_16.079216	2344	2424	53	3	80	0.0375000
NODE_938_length_2447_cov_16.079216	2344	2424	55	1	80	0.0125000
NODE_938_length_2447_cov_16.079216	2344	2424	56	7	80	0.0875000
NODE_938_length_2447_cov_16.079216	2344	2424	57	4	80	0.0500000
NODE_938_length_2447_cov_16.079216	2344	2424	60	2	80	0.0250000
NODE_938_length_2447_cov_16.079216	2344	2424	61	7	80	0.0875000
NODE_938_length_2447_cov_16.079216	2344	2424	62	1	80	0.0125000
NODE_938_length_2447_cov_16.079216	2344	2424	66	6	80	0.0750000
NODE_938_length_2447_cov_16.079216	2344	2424	67	2	80	0.0250000
NODE_938_length_2447_cov_16.079216	2344	2424	68	1	80	0.0125000
NODE_938_length_2447_cov_16.079216	2344	2424	69	1	80	0.0125000
NODE_938_length_2447_cov_16.079216	2344	2424	70	2	80	0.0250000
NODE_938_length_2447_cov_16.079216	2344	2424	71	3	80	0.0375000
NODE_938_length_2447_cov_16.079216	2344	2424	72	1	80	0.0125000
NODE_938_length_2447_cov_16.079216	2344	2424	73	1	80	0.0125000
NODE_938_length_2447_cov_16.079216	2344	2424	77	2	80	0.0250000
NODE_938_length_2447_cov_16.079216	2344	2424	81	3	80	0.0375000
NODE_938_length_2447_cov_16.079216	2344	2424	82	8	80	0.1000000
NODE_938_length_2447_cov_16.079216	2344	2424	83	6	80	0.0750000
NODE_938_length_2447_cov_16.079216	2344	2424	84	1	80	0.0125000
NODE_938_length_2447_cov_16.079216	2344	2424	85	4	80	0.0500000
NODE_938_length_2447_cov_16.079216	2344	2424	86	6	80	0.0750000
NODE_938_length_2447_cov_16.079216	2397	2447	18	2	50	0.0400000
NODE_938_length_2447_cov_16.079216	2397	2447	20	1	50	0.0200000
NODE_938_length_2447_cov_16.079216	2397	2447	24	1	50	0.0200000
NODE_938_length_2447_cov_16.079216	2397	2447	25	1	50	0.0200000
NODE_938_length_2447_cov_16.079216	2397	2447	26	1	50	0.0200000
NODE_938_length_2447_cov_16.079216	2397	2447	28	2	50	0.0400000
NODE_938_length_2447_cov_16.079216	2397	2447	29	2	50	0.0400000
NODE_938_length_2447_cov_16.079216	2397	2447	33	3	50	0.0600000
NODE_938_length_2447_cov_16.079216	2397	2447	36	1	50	0.0200000
NODE_938_length_2447_cov_16.079216	2397	2447	38	3	50	0.0600000
NODE_938_length_2447_cov_16.079216	2397	2447	39	1	50	0.0200000
NODE_938_length_2447_cov_16.079216	2397	2447	40	1	50	0.0200000
NODE_938_length_2447_cov_16.079216	2397	2447	41	1	50	0.0200000
NODE_938_length_2447_cov_16.079216	2397	2447	43	2	50	0.0400000
NODE_938_length_2447_cov_16.079216	2397	2447	44	1	50	0.0200000
NODE_938_length_2447_cov_16.079216	2397	2447	45	1	50	0.0200000
NODE_938_length_2447_cov_16.079216	2397	2447	48	2	50	0.0400000
NODE_938_length_2447_cov_16.079216	2397	2447	50	1	50	0.0200000
NODE_938_length_2447_cov_16.079216	2397	2447	51	1	50	0.0200000
NODE_938_length_2447_cov_16.079216	2397	2447	52	3	50	0.0600000
NODE_938_length_2447_cov_16.079216	2397	2447	53	3	50	0.0600000
NODE_938_length_2447_cov_16.079216	2397	2447	55	1	50	0.0200000
NODE_938_length_2447_cov_16.079216	2397	2447	56	7	50	0.1400000
NODE_938_length_2447_cov_16.079216	2397	2447	57	4	50	0.0800000
NODE_938_length_2447_cov_16.079216	2397	2447	60	2	50	0.0400000
NODE_938_length_2447_cov_16.079216	2397	2447	61	2	50	0.0400000
NODE_940_length_2446_cov_2.341287	1521	1578	0	36	57	0.6315789
NODE_940_length_2446_cov_2.341287	1521	1578	1	8	57	0.1403509
NODE_940_length_2446_cov_2.341287	1521	1578	2	13	57	0.2280702
NODE_940_length_2446_cov_2.341287	1551	1593	0	6	42	0.1428571
NODE_940_length_2446_cov_2.341287	1551	1593	1	8	42	0.1904762
NODE_940_length_2446_cov_2.341287	1551	1593	2	28	42	0.6666667
NODE_949_length_2437_cov_13.341745	418	498	13	21	80	0.2625000
NODE_949_length_2437_cov_13.341745	418	498	14	34	80	0.4250000
NODE_949_length_2437_cov_13.341745	418	498	15	23	80	0.2875000
NODE_949_length_2437_cov_13.341745	418	498	16	2	80	0.0250000
NODE_949_length_2437_cov_13.341745	471	551	13	12	80	0.1500000
NODE_949_length_2437_cov_13.341745	471	551	14	38	80	0.4750000
NODE_949_length_2437_cov_13.341745	471	551	15	2	80	0.0250000
NODE_949_length_2437_cov_13.341745	471	551	16	6	80	0.0750000
NODE_949_length_2437_cov_13.341745	471	551	17	6	80	0.0750000
NODE_949_length_2437_cov_13.341745	471	551	19	1	80	0.0125000
NODE_949_length_2437_cov_13.341745	471	551	20	2	80	0.0250000
NODE_949_length_2437_cov_13.341745	471	551	21	6	80	0.0750000
NODE_949_length_2437_cov_13.341745	471	551	22	2	80	0.0250000
NODE_949_length_2437_cov_13.341745	471	551	23	1	80	0.0125000
NODE_949_length_2437_cov_13.341745	471	551	26	1	80	0.0125000
NODE_949_length_2437_cov_13.341745	471	551	27	1	80	0.0125000
NODE_949_length_2437_cov_13.341745	471	551	30	2	80	0.0250000
NODE_951_length_2432_cov_70.360909	1875	1955	0	2	80	0.0250000
NODE_951_length_2432_cov_70.360909	1875	1955	6	35	80	0.4375000
NODE_951_length_2432_cov_70.360909	1875	1955	7	39	80	0.4875000
NODE_951_length_2432_cov_70.360909	1875	1955	9	4	80	0.0500000
NODE_951_length_2432_cov_70.360909	1928	2008	5	6	80	0.0750000
NODE_951_length_2432_cov_70.360909	1928	2008	6	21	80	0.2625000
NODE_951_length_2432_cov_70.360909	1928	2008	7	28	80	0.3500000
NODE_951_length_2432_cov_70.360909	1928	2008	8	18	80	0.2250000
NODE_951_length_2432_cov_70.360909	1928	2008	9	7	80	0.0875000
NODE_955_length_2430_cov_19.835264	0	68	15	1	68	0.0147059
NODE_955_length_2430_cov_19.835264	0	68	17	1	68	0.0147059
NODE_955_length_2430_cov_19.835264	0	68	18	1	68	0.0147059
NODE_955_length_2430_cov_19.835264	0	68	24	2	68	0.0294118
NODE_955_length_2430_cov_19.835264	0	68	26	7	68	0.1029412
NODE_955_length_2430_cov_19.835264	0	68	29	3	68	0.0441176
NODE_955_length_2430_cov_19.835264	0	68	30	1	68	0.0147059
NODE_955_length_2430_cov_19.835264	0	68	32	2	68	0.0294118
NODE_955_length_2430_cov_19.835264	0	68	33	3	68	0.0441176
NODE_955_length_2430_cov_19.835264	0	68	38	3	68	0.0441176
NODE_955_length_2430_cov_19.835264	0	68	41	1	68	0.0147059
NODE_955_length_2430_cov_19.835264	0	68	42	1	68	0.0147059
NODE_955_length_2430_cov_19.835264	0	68	44	3	68	0.0441176
NODE_955_length_2430_cov_19.835264	0	68	47	3	68	0.0441176
NODE_955_length_2430_cov_19.835264	0	68	50	2	68	0.0294118
NODE_955_length_2430_cov_19.835264	0	68	52	1	68	0.0147059
NODE_955_length_2430_cov_19.835264	0	68	53	1	68	0.0147059
NODE_955_length_2430_cov_19.835264	0	68	55	1	68	0.0147059
NODE_955_length_2430_cov_19.835264	0	68	57	2	68	0.0294118
NODE_955_length_2430_cov_19.835264	0	68	58	5	68	0.0735294
NODE_955_length_2430_cov_19.835264	0	68	59	1	68	0.0147059
NODE_955_length_2430_cov_19.835264	0	68	60	1	68	0.0147059
NODE_955_length_2430_cov_19.835264	0	68	61	1	68	0.0147059
NODE_955_length_2430_cov_19.835264	0	68	63	1	68	0.0147059
NODE_955_length_2430_cov_19.835264	0	68	64	1	68	0.0147059
NODE_955_length_2430_cov_19.835264	0	68	66	8	68	0.1176471
NODE_955_length_2430_cov_19.835264	0	68	72	1	68	0.0147059
NODE_955_length_2430_cov_19.835264	0	68	73	1	68	0.0147059
NODE_955_length_2430_cov_19.835264	0	68	75	2	68	0.0294118
NODE_955_length_2430_cov_19.835264	0	68	76	7	68	0.1029412
NODE_955_length_2430_cov_19.835264	0	24	15	1	24	0.0416667
NODE_955_length_2430_cov_19.835264	0	24	17	1	24	0.0416667
NODE_955_length_2430_cov_19.835264	0	24	18	1	24	0.0416667
NODE_955_length_2430_cov_19.835264	0	24	24	2	24	0.0833333
NODE_955_length_2430_cov_19.835264	0	24	26	7	24	0.2916667
NODE_955_length_2430_cov_19.835264	0	24	29	3	24	0.1250000
NODE_955_length_2430_cov_19.835264	0	24	30	1	24	0.0416667
NODE_955_length_2430_cov_19.835264	0	24	32	2	24	0.0833333
NODE_955_length_2430_cov_19.835264	0	24	33	3	24	0.1250000
NODE_955_length_2430_cov_19.835264	0	24	38	3	24	0.1250000
NODE_956_length_2428_cov_179.842422	538	618	1	11	80	0.1375000
NODE_956_length_2428_cov_179.842422	538	618	2	10	80	0.1250000
NODE_956_length_2428_cov_179.842422	538	618	3	6	80	0.0750000
NODE_956_length_2428_cov_179.842422	538	618	4	13	80	0.1625000
NODE_956_length_2428_cov_179.842422	538	618	5	40	80	0.5000000
NODE_956_length_2428_cov_179.842422	591	671	0	38	80	0.4750000
NODE_956_length_2428_cov_179.842422	591	671	1	26	80	0.3250000
NODE_956_length_2428_cov_179.842422	591	671	2	10	80	0.1250000
NODE_956_length_2428_cov_179.842422	591	671	3	6	80	0.0750000
NODE_956_length_2428_cov_179.842422	667	747	0	80	80	1.0000000
NODE_956_length_2428_cov_179.842422	720	800	0	80	80	1.0000000
NODE_956_length_2428_cov_179.842422	1308	1388	3	8	80	0.1000000
NODE_956_length_2428_cov_179.842422	1308	1388	4	48	80	0.6000000
NODE_956_length_2428_cov_179.842422	1308	1388	5	24	80	0.3000000
NODE_956_length_2428_cov_179.842422	1361	1441	4	25	80	0.3125000
NODE_956_length_2428_cov_179.842422	1361	1441	5	55	80	0.6875000
NODE_956_length_2428_cov_179.842422	1437	1517	3	10	80	0.1250000
NODE_956_length_2428_cov_179.842422	1437	1517	4	44	80	0.5500000
NODE_956_length_2428_cov_179.842422	1437	1517	5	26	80	0.3250000
NODE_956_length_2428_cov_179.842422	1490	1570	4	13	80	0.1625000
NODE_956_length_2428_cov_179.842422	1490	1570	5	59	80	0.7375000
NODE_956_length_2428_cov_179.842422	1490	1570	6	8	80	0.1000000
NODE_956_length_2428_cov_179.842422	1986	2026	913	1	40	0.0250000
NODE_956_length_2428_cov_179.842422	1986	2026	914	1	40	0.0250000
NODE_956_length_2428_cov_179.842422	1986	2026	916	1	40	0.0250000
NODE_956_length_2428_cov_179.842422	1986	2026	917	1	40	0.0250000
NODE_956_length_2428_cov_179.842422	1986	2026	919	1	40	0.0250000
NODE_956_length_2428_cov_179.842422	1986	2026	933	1	40	0.0250000
NODE_956_length_2428_cov_179.842422	1986	2026	942	1	40	0.0250000
NODE_956_length_2428_cov_179.842422	1986	2026	950	3	40	0.0750000
NODE_956_length_2428_cov_179.842422	1986	2026	952	1	40	0.0250000
NODE_956_length_2428_cov_179.842422	1986	2026	960	1	40	0.0250000
NODE_956_length_2428_cov_179.842422	1986	2026	961	1	40	0.0250000
NODE_956_length_2428_cov_179.842422	1986	2026	963	1	40	0.0250000
NODE_956_length_2428_cov_179.842422	1986	2026	964	2	40	0.0500000
NODE_956_length_2428_cov_179.842422	1986	2026	966	1	40	0.0250000
NODE_956_length_2428_cov_179.842422	1986	2026	969	1	40	0.0250000
NODE_956_length_2428_cov_179.842422	1986	2026	975	1	40	0.0250000
NODE_956_length_2428_cov_179.842422	1986	2026	978	1	40	0.0250000
NODE_956_length_2428_cov_179.842422	1986	2026	979	1	40	0.0250000
NODE_956_length_2428_cov_179.842422	1986	2026	980	1	40	0.0250000
NODE_956_length_2428_cov_179.842422	1986	2026	983	1	40	0.0250000
NODE_956_length_2428_cov_179.842422	1986	2026	985	1	40	0.0250000
NODE_956_length_2428_cov_179.842422	1986	2026	986	1	40	0.0250000
NODE_956_length_2428_cov_179.842422	1986	2026	990	2	40	0.0500000
NODE_956_length_2428_cov_179.842422	1986	2026	991	1	40	0.0250000
NODE_956_length_2428_cov_179.842422	1986	2026	992	1	40	0.0250000
NODE_956_length_2428_cov_179.842422	1986	2026	996	1	40	0.0250000
NODE_956_length_2428_cov_179.842422	1986	2026	1013	1	40	0.0250000
NODE_956_length_2428_cov_179.842422	1986	2026	1019	1	40	0.0250000
NODE_956_length_2428_cov_179.842422	1986	2026	1029	1	40	0.0250000
NODE_956_length_2428_cov_179.842422	1986	2026	1031	1	40	0.0250000
NODE_956_length_2428_cov_179.842422	1986	2026	1039	1	40	0.0250000
NODE_956_length_2428_cov_179.842422	1986	2026	1051	1	40	0.0250000
NODE_956_length_2428_cov_179.842422	1986	2026	1075	1	40	0.0250000
NODE_956_length_2428_cov_179.842422	1986	2026	1079	2	40	0.0500000
NODE_956_length_2428_cov_179.842422	1986	2026	1088	1	40	0.0250000
NODE_959_length_2422_cov_6.665088	197	255	0	56	58	0.9655172
NODE_959_length_2422_cov_6.665088	197	255	5	1	58	0.0172414
NODE_959_length_2422_cov_6.665088	197	255	7	1	58	0.0172414
NODE_963_length_2414_cov_32.871706	411	491	11	23	80	0.2875000
NODE_963_length_2414_cov_32.871706	411	491	12	4	80	0.0500000
NODE_963_length_2414_cov_32.871706	411	491	13	25	80	0.3125000
NODE_963_length_2414_cov_32.871706	411	491	14	4	80	0.0500000
NODE_963_length_2414_cov_32.871706	411	491	15	24	80	0.3000000
NODE_963_length_2414_cov_32.871706	464	544	0	2	80	0.0250000
NODE_963_length_2414_cov_32.871706	464	544	2	21	80	0.2625000
NODE_963_length_2414_cov_32.871706	464	544	3	1	80	0.0125000
NODE_963_length_2414_cov_32.871706	464	544	5	4	80	0.0500000
NODE_963_length_2414_cov_32.871706	464	544	7	5	80	0.0625000
NODE_963_length_2414_cov_32.871706	464	544	8	4	80	0.0500000
NODE_963_length_2414_cov_32.871706	464	544	9	2	80	0.0250000
NODE_963_length_2414_cov_32.871706	464	544	10	5	80	0.0625000
NODE_963_length_2414_cov_32.871706	464	544	11	32	80	0.4000000
NODE_963_length_2414_cov_32.871706	464	544	12	3	80	0.0375000
NODE_963_length_2414_cov_32.871706	464	544	13	1	80	0.0125000
NODE_964_length_2414_cov_2.105832	2349	2390	0	41	41	1.0000000
NODE_968_length_2410_cov_9.107313	1874	1954	0	4	80	0.0500000
NODE_968_length_2410_cov_9.107313	1874	1954	1	27	80	0.3375000
NODE_968_length_2410_cov_9.107313	1874	1954	2	8	80	0.1000000
NODE_968_length_2410_cov_9.107313	1874	1954	3	41	80	0.5125000
NODE_968_length_2410_cov_9.107313	1927	2007	3	28	80	0.3500000
NODE_968_length_2410_cov_9.107313	1927	2007	4	49	80	0.6125000
NODE_968_length_2410_cov_9.107313	1927	2007	5	3	80	0.0375000
NODE_977_length_2390_cov_20.371454	1753	1833	1	2	80	0.0250000
NODE_977_length_2390_cov_20.371454	1753	1833	2	35	80	0.4375000
NODE_977_length_2390_cov_20.371454	1753	1833	3	43	80	0.5375000
NODE_977_length_2390_cov_20.371454	1806	1886	1	2	80	0.0250000
NODE_977_length_2390_cov_20.371454	1806	1886	2	16	80	0.2000000
NODE_977_length_2390_cov_20.371454	1806	1886	3	19	80	0.2375000
NODE_977_length_2390_cov_20.371454	1806	1886	4	43	80	0.5375000
NODE_979_length_2389_cov_17.904803	1601	1681	7	11	80	0.1375000
NODE_979_length_2389_cov_17.904803	1601	1681	8	6	80	0.0750000
NODE_979_length_2389_cov_17.904803	1601	1681	9	7	80	0.0875000
NODE_979_length_2389_cov_17.904803	1601	1681	11	8	80	0.1000000
NODE_979_length_2389_cov_17.904803	1601	1681	13	2	80	0.0250000
NODE_979_length_2389_cov_17.904803	1601	1681	14	32	80	0.4000000
NODE_979_length_2389_cov_17.904803	1601	1681	15	14	80	0.1750000
NODE_979_length_2389_cov_17.904803	1654	1734	9	18	80	0.2250000
NODE_979_length_2389_cov_17.904803	1654	1734	11	6	80	0.0750000
NODE_979_length_2389_cov_17.904803	1654	1734	12	18	80	0.2250000
NODE_979_length_2389_cov_17.904803	1654	1734	13	11	80	0.1375000
NODE_979_length_2389_cov_17.904803	1654	1734	14	17	80	0.2125000
NODE_979_length_2389_cov_17.904803	1654	1734	15	10	80	0.1250000
NODE_979_length_2389_cov_17.904803	1730	1810	1	10	80	0.1250000
NODE_979_length_2389_cov_17.904803	1730	1810	2	15	80	0.1875000
NODE_979_length_2389_cov_17.904803	1730	1810	3	17	80	0.2125000
NODE_979_length_2389_cov_17.904803	1730	1810	4	4	80	0.0500000
NODE_979_length_2389_cov_17.904803	1730	1810	6	2	80	0.0250000
NODE_979_length_2389_cov_17.904803	1730	1810	7	19	80	0.2375000
NODE_979_length_2389_cov_17.904803	1730	1810	9	13	80	0.1625000
NODE_979_length_2389_cov_17.904803	1783	1863	0	26	80	0.3250000
NODE_979_length_2389_cov_17.904803	1783	1863	1	37	80	0.4625000
NODE_979_length_2389_cov_17.904803	1783	1863	2	15	80	0.1875000
NODE_979_length_2389_cov_17.904803	1783	1863	3	2	80	0.0250000
NODE_988_length_2381_cov_32.280894	398	478	5	31	80	0.3875000
NODE_988_length_2381_cov_32.280894	398	478	6	49	80	0.6125000
NODE_988_length_2381_cov_32.280894	451	531	4	12	80	0.1500000
NODE_988_length_2381_cov_32.280894	451	531	5	17	80	0.2125000
NODE_988_length_2381_cov_32.280894	451	531	6	51	80	0.6375000
NODE_988_length_2381_cov_32.280894	527	607	3	8	80	0.1000000
NODE_988_length_2381_cov_32.280894	527	607	4	60	80	0.7500000
NODE_988_length_2381_cov_32.280894	527	607	6	12	80	0.1500000
NODE_988_length_2381_cov_32.280894	580	660	0	40	80	0.5000000
NODE_988_length_2381_cov_32.280894	580	660	2	3	80	0.0375000
NODE_988_length_2381_cov_32.280894	580	660	3	18	80	0.2250000
NODE_988_length_2381_cov_32.280894	580	660	4	19	80	0.2375000
NODE_988_length_2381_cov_32.280894	2288	2368	0	80	80	1.0000000
NODE_997_length_2369_cov_4.896916	241	321	3	53	80	0.6625000
NODE_997_length_2369_cov_4.896916	241	321	4	15	80	0.1875000
NODE_997_length_2369_cov_4.896916	241	321	5	12	80	0.1500000
NODE_997_length_2369_cov_4.896916	294	374	2	17	80	0.2125000
NODE_997_length_2369_cov_4.896916	294	374	3	9	80	0.1125000
NODE_997_length_2369_cov_4.896916	294	374	4	15	80	0.1875000
NODE_997_length_2369_cov_4.896916	294	374	5	39	80	0.4875000
NODE_1002_length_2364_cov_2.482561	0	79	0	79	79	1.0000000
NODE_1004_length_2360_cov_8.620080	587	651	10	1	64	0.0156250
NODE_1004_length_2360_cov_8.620080	587	651	11	7	64	0.1093750
NODE_1004_length_2360_cov_8.620080	587	651	12	9	64	0.1406250
NODE_1004_length_2360_cov_8.620080	587	651	14	4	64	0.0625000
NODE_1004_length_2360_cov_8.620080	587	651	15	1	64	0.0156250
NODE_1004_length_2360_cov_8.620080	587	651	16	42	64	0.6562500
NODE_1004_length_2360_cov_8.620080	587	651	10	1	64	0.0156250
NODE_1004_length_2360_cov_8.620080	587	651	11	7	64	0.1093750
NODE_1004_length_2360_cov_8.620080	587	651	12	9	64	0.1406250
NODE_1004_length_2360_cov_8.620080	587	651	14	4	64	0.0625000
NODE_1004_length_2360_cov_8.620080	587	651	15	1	64	0.0156250
NODE_1004_length_2360_cov_8.620080	587	651	16	42	64	0.6562500
NODE_1004_length_2360_cov_8.620080	624	684	3	2	60	0.0333333
NODE_1004_length_2360_cov_8.620080	624	684	4	3	60	0.0500000
NODE_1004_length_2360_cov_8.620080	624	684	5	1	60	0.0166667
NODE_1004_length_2360_cov_8.620080	624	684	6	6	60	0.1000000
NODE_1004_length_2360_cov_8.620080	624	684	7	5	60	0.0833333
NODE_1004_length_2360_cov_8.620080	624	684	10	7	60	0.1166667
NODE_1004_length_2360_cov_8.620080	624	684	11	17	60	0.2833333
NODE_1004_length_2360_cov_8.620080	624	684	12	9	60	0.1500000
NODE_1004_length_2360_cov_8.620080	624	684	14	4	60	0.0666667
NODE_1004_length_2360_cov_8.620080	624	684	15	1	60	0.0166667
NODE_1004_length_2360_cov_8.620080	624	684	16	5	60	0.0833333
NODE_1004_length_2360_cov_8.620080	1827	1907	2	6	80	0.0750000
NODE_1004_length_2360_cov_8.620080	1827	1907	3	60	80	0.7500000
NODE_1004_length_2360_cov_8.620080	1827	1907	4	14	80	0.1750000
NODE_1004_length_2360_cov_8.620080	1880	1960	3	19	80	0.2375000
NODE_1004_length_2360_cov_8.620080	1880	1960	4	61	80	0.7625000
NODE_1005_length_2359_cov_22.317257	958	1038	17	1	80	0.0125000
NODE_1005_length_2359_cov_22.317257	958	1038	19	1	80	0.0125000
NODE_1005_length_2359_cov_22.317257	958	1038	21	3	80	0.0375000
NODE_1005_length_2359_cov_22.317257	958	1038	22	9	80	0.1125000
NODE_1005_length_2359_cov_22.317257	958	1038	23	28	80	0.3500000
NODE_1005_length_2359_cov_22.317257	958	1038	24	12	80	0.1500000
NODE_1005_length_2359_cov_22.317257	958	1038	25	3	80	0.0375000
NODE_1005_length_2359_cov_22.317257	958	1038	26	18	80	0.2250000
NODE_1005_length_2359_cov_22.317257	958	1038	27	5	80	0.0625000
NODE_1005_length_2359_cov_22.317257	1011	1091	19	2	80	0.0250000
NODE_1005_length_2359_cov_22.317257	1011	1091	20	11	80	0.1375000
NODE_1005_length_2359_cov_22.317257	1011	1091	22	9	80	0.1125000
NODE_1005_length_2359_cov_22.317257	1011	1091	23	16	80	0.2000000
NODE_1005_length_2359_cov_22.317257	1011	1091	24	10	80	0.1250000
NODE_1005_length_2359_cov_22.317257	1011	1091	25	3	80	0.0375000
NODE_1005_length_2359_cov_22.317257	1011	1091	26	24	80	0.3000000
NODE_1005_length_2359_cov_22.317257	1011	1091	27	5	80	0.0625000
NODE_1008_length_2357_cov_25.711249	716	796	1	8	80	0.1000000
NODE_1008_length_2357_cov_25.711249	716	796	2	72	80	0.9000000
NODE_1008_length_2357_cov_25.711249	769	849	1	22	80	0.2750000
NODE_1008_length_2357_cov_25.711249	769	849	2	58	80	0.7250000
NODE_1015_length_2345_cov_5.386465	1845	1925	1	62	80	0.7750000
NODE_1015_length_2345_cov_5.386465	1845	1925	2	18	80	0.2250000
NODE_1015_length_2345_cov_5.386465	1898	1978	1	13	80	0.1625000
NODE_1015_length_2345_cov_5.386465	1898	1978	2	67	80	0.8375000
NODE_1016_length_2344_cov_6.236526	1208	1269	12	8	61	0.1311475
NODE_1016_length_2344_cov_6.236526	1208	1269	14	53	61	0.8688524
NODE_1016_length_2344_cov_6.236526	1208	1269	12	8	61	0.1311475
NODE_1016_length_2344_cov_6.236526	1208	1269	14	53	61	0.8688524
NODE_1016_length_2344_cov_6.236526	1208	1269	12	8	61	0.1311475
NODE_1016_length_2344_cov_6.236526	1208	1269	14	53	61	0.8688524
NODE_1016_length_2344_cov_6.236526	1208	1267	12	8	59	0.1355932
NODE_1016_length_2344_cov_6.236526	1208	1267	14	51	59	0.8644068
NODE_1023_length_2332_cov_4.725929	34	101	0	65	67	0.9701493
NODE_1023_length_2332_cov_4.725929	34	101	4	2	67	0.0298507
NODE_1027_length_2327_cov_18.210952	2213	2293	7	4	80	0.0500000
NODE_1027_length_2327_cov_18.210952	2213	2293	9	4	80	0.0500000
NODE_1027_length_2327_cov_18.210952	2213	2293	10	17	80	0.2125000
NODE_1027_length_2327_cov_18.210952	2213	2293	11	9	80	0.1125000
NODE_1027_length_2327_cov_18.210952	2213	2293	12	12	80	0.1500000
NODE_1027_length_2327_cov_18.210952	2213	2293	13	14	80	0.1750000
NODE_1027_length_2327_cov_18.210952	2213	2293	14	14	80	0.1750000
NODE_1027_length_2327_cov_18.210952	2213	2293	15	6	80	0.0750000
NODE_1027_length_2327_cov_18.210952	2266	2327	10	4	61	0.0655738
NODE_1027_length_2327_cov_18.210952	2266	2327	12	42	61	0.6885246
NODE_1027_length_2327_cov_18.210952	2266	2327	13	14	61	0.2295082
NODE_1027_length_2327_cov_18.210952	2266	2327	14	1	61	0.0163934
NODE_1028_length_2326_cov_15.583745	1709	1789	6	14	80	0.1750000
NODE_1028_length_2326_cov_15.583745	1709	1789	7	66	80	0.8250000
NODE_1028_length_2326_cov_15.583745	1762	1842	1	3	80	0.0375000
NODE_1028_length_2326_cov_15.583745	1762	1842	2	20	80	0.2500000
NODE_1028_length_2326_cov_15.583745	1762	1842	3	3	80	0.0375000
NODE_1028_length_2326_cov_15.583745	1762	1842	4	15	80	0.1875000
NODE_1028_length_2326_cov_15.583745	1762	1842	5	1	80	0.0125000
NODE_1028_length_2326_cov_15.583745	1762	1842	6	5	80	0.0625000
NODE_1028_length_2326_cov_15.583745	1762	1842	7	33	80	0.4125000
NODE_1030_length_2325_cov_14.998652	553	633	1	52	80	0.6500000
NODE_1030_length_2325_cov_14.998652	553	633	2	26	80	0.3250000
NODE_1030_length_2325_cov_14.998652	553	633	3	2	80	0.0250000
NODE_1030_length_2325_cov_14.998652	606	686	2	79	80	0.9875000
NODE_1030_length_2325_cov_14.998652	606	686	3	1	80	0.0125000
NODE_1034_length_2317_cov_11.956718	920	1000	1	80	80	1.0000000
NODE_1034_length_2317_cov_11.956718	973	1053	1	63	80	0.7875000
NODE_1034_length_2317_cov_11.956718	973	1053	2	17	80	0.2125000
NODE_1034_length_2317_cov_11.956718	1049	1129	1	53	80	0.6625000
NODE_1034_length_2317_cov_11.956718	1049	1129	2	27	80	0.3375000
NODE_1034_length_2317_cov_11.956718	1102	1184	1	35	82	0.4268293
NODE_1034_length_2317_cov_11.956718	1102	1184	2	47	82	0.5731707
NODE_1037_length_2316_cov_8.556608	168	247	112	2	79	0.0253165
NODE_1037_length_2316_cov_8.556608	168	247	120	1	79	0.0126582
NODE_1037_length_2316_cov_8.556608	168	247	124	1	79	0.0126582
NODE_1037_length_2316_cov_8.556608	168	247	126	3	79	0.0379747
NODE_1037_length_2316_cov_8.556608	168	247	132	1	79	0.0126582
NODE_1037_length_2316_cov_8.556608	168	247	133	1	79	0.0126582
NODE_1037_length_2316_cov_8.556608	168	247	134	1	79	0.0126582
NODE_1037_length_2316_cov_8.556608	168	247	135	2	79	0.0253165
NODE_1037_length_2316_cov_8.556608	168	247	136	1	79	0.0126582
NODE_1037_length_2316_cov_8.556608	168	247	140	1	79	0.0126582
NODE_1037_length_2316_cov_8.556608	168	247	141	2	79	0.0253165
NODE_1037_length_2316_cov_8.556608	168	247	146	1	79	0.0126582
NODE_1037_length_2316_cov_8.556608	168	247	150	1	79	0.0126582
NODE_1037_length_2316_cov_8.556608	168	247	152	2	79	0.0253165
NODE_1037_length_2316_cov_8.556608	168	247	153	3	79	0.0379747
NODE_1037_length_2316_cov_8.556608	168	247	154	2	79	0.0253165
NODE_1037_length_2316_cov_8.556608	168	247	155	4	79	0.0506329
NODE_1037_length_2316_cov_8.556608	168	247	156	3	79	0.0379747
NODE_1037_length_2316_cov_8.556608	168	247	157	1	79	0.0126582
NODE_1037_length_2316_cov_8.556608	168	247	158	3	79	0.0379747
NODE_1037_length_2316_cov_8.556608	168	247	162	1	79	0.0126582
NODE_1037_length_2316_cov_8.556608	168	247	163	1	79	0.0126582
NODE_1037_length_2316_cov_8.556608	168	247	170	1	79	0.0126582
NODE_1037_length_2316_cov_8.556608	168	247	172	1	79	0.0126582
NODE_1037_length_2316_cov_8.556608	168	247	176	1	79	0.0126582
NODE_1037_length_2316_cov_8.556608	168	247	178	1	79	0.0126582
NODE_1037_length_2316_cov_8.556608	168	247	180	1	79	0.0126582
NODE_1037_length_2316_cov_8.556608	168	247	181	1	79	0.0126582
NODE_1037_length_2316_cov_8.556608	168	247	183	1	79	0.0126582
NODE_1037_length_2316_cov_8.556608	168	247	184	1	79	0.0126582
NODE_1037_length_2316_cov_8.556608	168	247	187	1	79	0.0126582
NODE_1037_length_2316_cov_8.556608	168	247	189	1	79	0.0126582
NODE_1037_length_2316_cov_8.556608	168	247	190	1	79	0.0126582
NODE_1037_length_2316_cov_8.556608	168	247	191	2	79	0.0253165
NODE_1037_length_2316_cov_8.556608	168	247	192	1	79	0.0126582
NODE_1037_length_2316_cov_8.556608	168	247	193	4	79	0.0506329
NODE_1037_length_2316_cov_8.556608	168	247	194	1	79	0.0126582
NODE_1037_length_2316_cov_8.556608	168	247	197	1	79	0.0126582
NODE_1037_length_2316_cov_8.556608	168	247	198	5	79	0.0632911
NODE_1037_length_2316_cov_8.556608	168	247	199	1	79	0.0126582
NODE_1037_length_2316_cov_8.556608	168	247	200	3	79	0.0379747
NODE_1037_length_2316_cov_8.556608	168	247	201	4	79	0.0506329
NODE_1037_length_2316_cov_8.556608	168	247	203	1	79	0.0126582
NODE_1037_length_2316_cov_8.556608	168	247	207	1	79	0.0126582
NODE_1037_length_2316_cov_8.556608	168	247	210	2	79	0.0253165
NODE_1037_length_2316_cov_8.556608	168	247	212	1	79	0.0126582
NODE_1037_length_2316_cov_8.556608	168	247	214	1	79	0.0126582
NODE_1037_length_2316_cov_8.556608	168	247	216	2	79	0.0253165
NODE_1037_length_2316_cov_8.556608	1117	1198	47	3	81	0.0370370
NODE_1037_length_2316_cov_8.556608	1117	1198	48	2	81	0.0246914
NODE_1037_length_2316_cov_8.556608	1117	1198	49	14	81	0.1728395
NODE_1037_length_2316_cov_8.556608	1117	1198	50	6	81	0.0740741
NODE_1037_length_2316_cov_8.556608	1117	1198	51	7	81	0.0864198
NODE_1037_length_2316_cov_8.556608	1117	1198	52	1	81	0.0123457
NODE_1037_length_2316_cov_8.556608	1117	1198	53	3	81	0.0370370
NODE_1037_length_2316_cov_8.556608	1117	1198	55	2	81	0.0246914
NODE_1037_length_2316_cov_8.556608	1117	1198	56	2	81	0.0246914
NODE_1037_length_2316_cov_8.556608	1117	1198	58	4	81	0.0493827
NODE_1037_length_2316_cov_8.556608	1117	1198	59	2	81	0.0246914
NODE_1037_length_2316_cov_8.556608	1117	1198	60	1	81	0.0123457
NODE_1037_length_2316_cov_8.556608	1117	1198	61	4	81	0.0493827
NODE_1037_length_2316_cov_8.556608	1117	1198	62	9	81	0.1111111
NODE_1037_length_2316_cov_8.556608	1117	1198	63	10	81	0.1234568
NODE_1037_length_2316_cov_8.556608	1117	1198	64	9	81	0.1111111
NODE_1037_length_2316_cov_8.556608	1117	1198	65	2	81	0.0246914
NODE_1037_length_2316_cov_8.556608	1369	1412	144	1	43	0.0232558
NODE_1037_length_2316_cov_8.556608	1369	1412	148	1	43	0.0232558
NODE_1037_length_2316_cov_8.556608	1369	1412	155	2	43	0.0465116
NODE_1037_length_2316_cov_8.556608	1369	1412	156	1	43	0.0232558
NODE_1037_length_2316_cov_8.556608	1369	1412	157	1	43	0.0232558
NODE_1037_length_2316_cov_8.556608	1369	1412	160	1	43	0.0232558
NODE_1037_length_2316_cov_8.556608	1369	1412	161	1	43	0.0232558
NODE_1037_length_2316_cov_8.556608	1369	1412	162	2	43	0.0465116
NODE_1037_length_2316_cov_8.556608	1369	1412	165	1	43	0.0232558
NODE_1037_length_2316_cov_8.556608	1369	1412	166	1	43	0.0232558
NODE_1037_length_2316_cov_8.556608	1369	1412	168	1	43	0.0232558
NODE_1037_length_2316_cov_8.556608	1369	1412	169	1	43	0.0232558
NODE_1037_length_2316_cov_8.556608	1369	1412	172	1	43	0.0232558
NODE_1037_length_2316_cov_8.556608	1369	1412	173	1	43	0.0232558
NODE_1037_length_2316_cov_8.556608	1369	1412	174	1	43	0.0232558
NODE_1037_length_2316_cov_8.556608	1369	1412	175	1	43	0.0232558
NODE_1037_length_2316_cov_8.556608	1369	1412	176	2	43	0.0465116
NODE_1037_length_2316_cov_8.556608	1369	1412	178	1	43	0.0232558
NODE_1037_length_2316_cov_8.556608	1369	1412	179	6	43	0.1395349
NODE_1037_length_2316_cov_8.556608	1369	1412	180	2	43	0.0465116
NODE_1037_length_2316_cov_8.556608	1369	1412	181	2	43	0.0465116
NODE_1037_length_2316_cov_8.556608	1369	1412	182	1	43	0.0232558
NODE_1037_length_2316_cov_8.556608	1369	1412	183	1	43	0.0232558
NODE_1037_length_2316_cov_8.556608	1369	1412	184	1	43	0.0232558
NODE_1037_length_2316_cov_8.556608	1369	1412	188	3	43	0.0697674
NODE_1037_length_2316_cov_8.556608	1369	1412	197	1	43	0.0232558
NODE_1037_length_2316_cov_8.556608	1369	1412	202	1	43	0.0232558
NODE_1037_length_2316_cov_8.556608	1369	1412	208	2	43	0.0465116
NODE_1037_length_2316_cov_8.556608	1369	1412	211	1	43	0.0232558
NODE_1037_length_2316_cov_8.556608	1369	1412	215	1	43	0.0232558
NODE_1040_length_2311_cov_2.821881	2121	2201	3	15	80	0.1875000
NODE_1040_length_2311_cov_2.821881	2121	2201	4	65	80	0.8125000
NODE_1040_length_2311_cov_2.821881	2174	2225	3	39	51	0.7647059
NODE_1040_length_2311_cov_2.821881	2174	2225	4	12	51	0.2352941
NODE_1044_length_2306_cov_17.347984	995	1075	1	67	80	0.8375000
NODE_1044_length_2306_cov_17.347984	995	1075	2	13	80	0.1625000
NODE_1044_length_2306_cov_17.347984	1048	1128	1	67	80	0.8375000
NODE_1044_length_2306_cov_17.347984	1048	1128	2	13	80	0.1625000
NODE_1052_length_2300_cov_9.803271	934	1014	2	5	80	0.0625000
NODE_1052_length_2300_cov_9.803271	934	1014	3	11	80	0.1375000
NODE_1052_length_2300_cov_9.803271	934	1014	4	17	80	0.2125000
NODE_1052_length_2300_cov_9.803271	934	1014	6	3	80	0.0375000
NODE_1052_length_2300_cov_9.803271	934	1014	7	16	80	0.2000000
NODE_1052_length_2300_cov_9.803271	934	1014	9	28	80	0.3500000
NODE_1052_length_2300_cov_9.803271	1892	1965	0	73	73	1.0000000
NODE_1059_length_2289_cov_17.807306	968	1026	70	2	58	0.0344828
NODE_1059_length_2289_cov_17.807306	968	1026	71	11	58	0.1896552
NODE_1059_length_2289_cov_17.807306	968	1026	72	2	58	0.0344828
NODE_1059_length_2289_cov_17.807306	968	1026	73	9	58	0.1551724
NODE_1059_length_2289_cov_17.807306	968	1026	74	14	58	0.2413793
NODE_1059_length_2289_cov_17.807306	968	1026	75	4	58	0.0689655
NODE_1059_length_2289_cov_17.807306	968	1026	76	5	58	0.0862069
NODE_1059_length_2289_cov_17.807306	968	1026	77	1	58	0.0172414
NODE_1059_length_2289_cov_17.807306	968	1026	78	2	58	0.0344828
NODE_1059_length_2289_cov_17.807306	968	1026	82	2	58	0.0344828
NODE_1059_length_2289_cov_17.807306	968	1026	83	1	58	0.0172414
NODE_1059_length_2289_cov_17.807306	968	1026	84	1	58	0.0172414
NODE_1059_length_2289_cov_17.807306	968	1026	85	2	58	0.0344828
NODE_1059_length_2289_cov_17.807306	968	1026	87	2	58	0.0344828
NODE_1059_length_2289_cov_17.807306	1021	1079	59	5	58	0.0862069
NODE_1059_length_2289_cov_17.807306	1021	1079	60	3	58	0.0517241
NODE_1059_length_2289_cov_17.807306	1021	1079	61	5	58	0.0862069
NODE_1059_length_2289_cov_17.807306	1021	1079	62	2	58	0.0344828
NODE_1059_length_2289_cov_17.807306	1021	1079	63	2	58	0.0344828
NODE_1059_length_2289_cov_17.807306	1021	1079	64	2	58	0.0344828
NODE_1059_length_2289_cov_17.807306	1021	1079	65	4	58	0.0689655
NODE_1059_length_2289_cov_17.807306	1021	1079	66	4	58	0.0689655
NODE_1059_length_2289_cov_17.807306	1021	1079	68	2	58	0.0344828
NODE_1059_length_2289_cov_17.807306	1021	1079	69	1	58	0.0172414
NODE_1059_length_2289_cov_17.807306	1021	1079	70	2	58	0.0344828
NODE_1059_length_2289_cov_17.807306	1021	1079	71	6	58	0.1034483
NODE_1059_length_2289_cov_17.807306	1021	1079	72	7	58	0.1206897
NODE_1059_length_2289_cov_17.807306	1021	1079	73	4	58	0.0689655
NODE_1059_length_2289_cov_17.807306	1021	1079	74	3	58	0.0517241
NODE_1059_length_2289_cov_17.807306	1021	1079	75	2	58	0.0344828
NODE_1059_length_2289_cov_17.807306	1021	1079	77	1	58	0.0172414
NODE_1059_length_2289_cov_17.807306	1021	1079	78	3	58	0.0517241
NODE_1060_length_2289_cov_7.736986	2161	2218	19	1	57	0.0175439
NODE_1060_length_2289_cov_7.736986	2161	2218	21	3	57	0.0526316
NODE_1060_length_2289_cov_7.736986	2161	2218	23	4	57	0.0701754
NODE_1060_length_2289_cov_7.736986	2161	2218	27	4	57	0.0701754
NODE_1060_length_2289_cov_7.736986	2161	2218	29	2	57	0.0350877
NODE_1060_length_2289_cov_7.736986	2161	2218	31	10	57	0.1754386
NODE_1060_length_2289_cov_7.736986	2161	2218	33	33	57	0.5789474
NODE_1060_length_2289_cov_7.736986	2191	2271	14	3	80	0.0375000
NODE_1060_length_2289_cov_7.736986	2191	2271	18	4	80	0.0500000
NODE_1060_length_2289_cov_7.736986	2191	2271	20	1	80	0.0125000
NODE_1060_length_2289_cov_7.736986	2191	2271	27	1	80	0.0125000
NODE_1060_length_2289_cov_7.736986	2191	2271	31	4	80	0.0500000
NODE_1060_length_2289_cov_7.736986	2191	2271	33	67	80	0.8375000
NODE_1061_length_2288_cov_8.539973	340	420	3	51	80	0.6375000
NODE_1061_length_2288_cov_8.539973	340	420	4	2	80	0.0250000
NODE_1061_length_2288_cov_8.539973	340	420	7	2	80	0.0250000
NODE_1061_length_2288_cov_8.539973	340	420	9	5	80	0.0625000
NODE_1061_length_2288_cov_8.539973	340	420	10	12	80	0.1500000
NODE_1061_length_2288_cov_8.539973	340	420	11	2	80	0.0250000
NODE_1061_length_2288_cov_8.539973	340	420	12	2	80	0.0250000
NODE_1061_length_2288_cov_8.539973	340	420	13	2	80	0.0250000
NODE_1061_length_2288_cov_8.539973	340	420	14	2	80	0.0250000
NODE_1061_length_2288_cov_8.539973	393	473	1	13	80	0.1625000
NODE_1061_length_2288_cov_8.539973	393	473	3	65	80	0.8125000
NODE_1061_length_2288_cov_8.539973	393	473	4	2	80	0.0250000
NODE_1065_length_2278_cov_19.655805	450	530	0	42	80	0.5250000
NODE_1065_length_2278_cov_19.655805	450	530	1	25	80	0.3125000
NODE_1065_length_2278_cov_19.655805	450	530	2	13	80	0.1625000
NODE_1065_length_2278_cov_19.655805	503	583	0	8	80	0.1000000
NODE_1065_length_2278_cov_19.655805	503	583	1	25	80	0.3125000
NODE_1065_length_2278_cov_19.655805	503	583	2	47	80	0.5875000
NODE_1065_length_2278_cov_19.655805	579	659	1	31	80	0.3875000
NODE_1065_length_2278_cov_19.655805	579	659	3	4	80	0.0500000
NODE_1065_length_2278_cov_19.655805	579	659	4	45	80	0.5625000
NODE_1065_length_2278_cov_19.655805	632	712	4	80	80	1.0000000
NODE_1071_length_2272_cov_26.123792	226	306	0	80	80	1.0000000
NODE_1071_length_2272_cov_26.123792	279	359	0	80	80	1.0000000
NODE_1071_length_2272_cov_26.123792	1684	1731	34	1	47	0.0212766
NODE_1071_length_2272_cov_26.123792	1684	1731	40	1	47	0.0212766
NODE_1071_length_2272_cov_26.123792	1684	1731	58	1	47	0.0212766
NODE_1071_length_2272_cov_26.123792	1684	1731	84	1	47	0.0212766
NODE_1071_length_2272_cov_26.123792	1684	1731	122	1	47	0.0212766
NODE_1071_length_2272_cov_26.123792	1684	1731	124	1	47	0.0212766
NODE_1071_length_2272_cov_26.123792	1684	1731	126	1	47	0.0212766
NODE_1071_length_2272_cov_26.123792	1684	1731	129	1	47	0.0212766
NODE_1071_length_2272_cov_26.123792	1684	1731	134	1	47	0.0212766
NODE_1071_length_2272_cov_26.123792	1684	1731	136	3	47	0.0638298
NODE_1071_length_2272_cov_26.123792	1684	1731	139	1	47	0.0212766
NODE_1071_length_2272_cov_26.123792	1684	1731	142	1	47	0.0212766
NODE_1071_length_2272_cov_26.123792	1684	1731	150	1	47	0.0212766
NODE_1071_length_2272_cov_26.123792	1684	1731	157	2	47	0.0425532
NODE_1071_length_2272_cov_26.123792	1684	1731	159	1	47	0.0212766
NODE_1071_length_2272_cov_26.123792	1684	1731	165	1	47	0.0212766
NODE_1071_length_2272_cov_26.123792	1684	1731	168	3	47	0.0638298
NODE_1071_length_2272_cov_26.123792	1684	1731	173	1	47	0.0212766
NODE_1071_length_2272_cov_26.123792	1684	1731	176	1	47	0.0212766
NODE_1071_length_2272_cov_26.123792	1684	1731	184	1	47	0.0212766
NODE_1071_length_2272_cov_26.123792	1684	1731	186	1	47	0.0212766
NODE_1071_length_2272_cov_26.123792	1684	1731	193	1	47	0.0212766
NODE_1071_length_2272_cov_26.123792	1684	1731	197	1	47	0.0212766
NODE_1071_length_2272_cov_26.123792	1684	1731	213	1	47	0.0212766
NODE_1071_length_2272_cov_26.123792	1684	1731	217	1	47	0.0212766
NODE_1071_length_2272_cov_26.123792	1684	1731	218	2	47	0.0425532
NODE_1071_length_2272_cov_26.123792	1684	1731	221	1	47	0.0212766
NODE_1071_length_2272_cov_26.123792	1684	1731	227	1	47	0.0212766
NODE_1071_length_2272_cov_26.123792	1684	1731	234	2	47	0.0425532
NODE_1071_length_2272_cov_26.123792	1684	1731	238	1	47	0.0212766
NODE_1071_length_2272_cov_26.123792	1684	1731	240	2	47	0.0425532
NODE_1071_length_2272_cov_26.123792	1684	1731	247	1	47	0.0212766
NODE_1071_length_2272_cov_26.123792	1684	1731	249	1	47	0.0212766
NODE_1071_length_2272_cov_26.123792	1684	1731	251	1	47	0.0212766
NODE_1071_length_2272_cov_26.123792	1684	1731	252	1	47	0.0212766
NODE_1071_length_2272_cov_26.123792	1684	1731	254	1	47	0.0212766
NODE_1071_length_2272_cov_26.123792	1684	1731	263	1	47	0.0212766
NODE_1071_length_2272_cov_26.123792	1684	1731	266	1	47	0.0212766
NODE_1071_length_2272_cov_26.123792	1684	1731	272	1	47	0.0212766
NODE_1071_length_2272_cov_26.123792	1694	1725	126	1	31	0.0322581
NODE_1071_length_2272_cov_26.123792	1694	1725	129	1	31	0.0322581
NODE_1071_length_2272_cov_26.123792	1694	1725	134	1	31	0.0322581
NODE_1071_length_2272_cov_26.123792	1694	1725	136	3	31	0.0967742
NODE_1071_length_2272_cov_26.123792	1694	1725	139	1	31	0.0322581
NODE_1071_length_2272_cov_26.123792	1694	1725	142	1	31	0.0322581
NODE_1071_length_2272_cov_26.123792	1694	1725	150	1	31	0.0322581
NODE_1071_length_2272_cov_26.123792	1694	1725	157	2	31	0.0645161
NODE_1071_length_2272_cov_26.123792	1694	1725	159	1	31	0.0322581
NODE_1071_length_2272_cov_26.123792	1694	1725	165	1	31	0.0322581
NODE_1071_length_2272_cov_26.123792	1694	1725	168	3	31	0.0967742
NODE_1071_length_2272_cov_26.123792	1694	1725	173	1	31	0.0322581
NODE_1071_length_2272_cov_26.123792	1694	1725	176	1	31	0.0322581
NODE_1071_length_2272_cov_26.123792	1694	1725	184	1	31	0.0322581
NODE_1071_length_2272_cov_26.123792	1694	1725	186	1	31	0.0322581
NODE_1071_length_2272_cov_26.123792	1694	1725	193	1	31	0.0322581
NODE_1071_length_2272_cov_26.123792	1694	1725	197	1	31	0.0322581
NODE_1071_length_2272_cov_26.123792	1694	1725	213	1	31	0.0322581
NODE_1071_length_2272_cov_26.123792	1694	1725	217	1	31	0.0322581
NODE_1071_length_2272_cov_26.123792	1694	1725	218	2	31	0.0645161
NODE_1071_length_2272_cov_26.123792	1694	1725	221	1	31	0.0322581
NODE_1071_length_2272_cov_26.123792	1694	1725	227	1	31	0.0322581
NODE_1071_length_2272_cov_26.123792	1694	1725	234	2	31	0.0645161
NODE_1071_length_2272_cov_26.123792	1694	1725	238	1	31	0.0322581
NODE_1071_length_2272_cov_26.123792	1759	1833	4	74	74	1.0000000
NODE_1071_length_2272_cov_26.123792	1812	1892	1	6	80	0.0750000
NODE_1071_length_2272_cov_26.123792	1812	1892	2	8	80	0.1000000
NODE_1071_length_2272_cov_26.123792	1812	1892	3	16	80	0.2000000
NODE_1071_length_2272_cov_26.123792	1812	1892	4	50	80	0.6250000
NODE_1072_length_2272_cov_8.175334	213	293	33	2	80	0.0250000
NODE_1072_length_2272_cov_8.175334	213	293	34	8	80	0.1000000
NODE_1072_length_2272_cov_8.175334	213	293	35	2	80	0.0250000
NODE_1072_length_2272_cov_8.175334	213	293	36	2	80	0.0250000
NODE_1072_length_2272_cov_8.175334	213	293	37	4	80	0.0500000
NODE_1072_length_2272_cov_8.175334	213	293	38	1	80	0.0125000
NODE_1072_length_2272_cov_8.175334	213	293	40	3	80	0.0375000
NODE_1072_length_2272_cov_8.175334	213	293	42	5	80	0.0625000
NODE_1072_length_2272_cov_8.175334	213	293	46	10	80	0.1250000
NODE_1072_length_2272_cov_8.175334	213	293	47	6	80	0.0750000
NODE_1072_length_2272_cov_8.175334	213	293	48	19	80	0.2375000
NODE_1072_length_2272_cov_8.175334	213	293	49	3	80	0.0375000
NODE_1072_length_2272_cov_8.175334	213	293	50	4	80	0.0500000
NODE_1072_length_2272_cov_8.175334	213	293	51	1	80	0.0125000
NODE_1072_length_2272_cov_8.175334	213	293	52	2	80	0.0250000
NODE_1072_length_2272_cov_8.175334	213	293	53	5	80	0.0625000
NODE_1072_length_2272_cov_8.175334	213	293	54	3	80	0.0375000
NODE_1072_length_2272_cov_8.175334	266	346	0	2	80	0.0250000
NODE_1072_length_2272_cov_8.175334	266	346	9	2	80	0.0250000
NODE_1072_length_2272_cov_8.175334	266	346	11	5	80	0.0625000
NODE_1072_length_2272_cov_8.175334	266	346	13	1	80	0.0125000
NODE_1072_length_2272_cov_8.175334	266	346	15	5	80	0.0625000
NODE_1072_length_2272_cov_8.175334	266	346	16	8	80	0.1000000
NODE_1072_length_2272_cov_8.175334	266	346	18	6	80	0.0750000
NODE_1072_length_2272_cov_8.175334	266	346	19	1	80	0.0125000
NODE_1072_length_2272_cov_8.175334	266	346	21	1	80	0.0125000
NODE_1072_length_2272_cov_8.175334	266	346	22	3	80	0.0375000
NODE_1072_length_2272_cov_8.175334	266	346	24	2	80	0.0250000
NODE_1072_length_2272_cov_8.175334	266	346	25	1	80	0.0125000
NODE_1072_length_2272_cov_8.175334	266	346	27	9	80	0.1125000
NODE_1072_length_2272_cov_8.175334	266	346	28	1	80	0.0125000
NODE_1072_length_2272_cov_8.175334	266	346	30	1	80	0.0125000
NODE_1072_length_2272_cov_8.175334	266	346	31	2	80	0.0250000
NODE_1072_length_2272_cov_8.175334	266	346	33	5	80	0.0625000
NODE_1072_length_2272_cov_8.175334	266	346	34	8	80	0.1000000
NODE_1072_length_2272_cov_8.175334	266	346	35	2	80	0.0250000
NODE_1072_length_2272_cov_8.175334	266	346	36	2	80	0.0250000
NODE_1072_length_2272_cov_8.175334	266	346	37	4	80	0.0500000
NODE_1072_length_2272_cov_8.175334	266	346	38	1	80	0.0125000
NODE_1072_length_2272_cov_8.175334	266	346	40	3	80	0.0375000
NODE_1072_length_2272_cov_8.175334	266	346	42	5	80	0.0625000
NODE_1077_length_2266_cov_13.206276	359	439	5	25	80	0.3125000
NODE_1077_length_2266_cov_13.206276	359	439	6	50	80	0.6250000
NODE_1077_length_2266_cov_13.206276	359	439	7	5	80	0.0625000
NODE_1077_length_2266_cov_13.206276	412	492	4	11	80	0.1375000
NODE_1077_length_2266_cov_13.206276	412	492	5	50	80	0.6250000
NODE_1077_length_2266_cov_13.206276	412	492	6	19	80	0.2375000
NODE_1077_length_2266_cov_13.206276	488	568	3	3	80	0.0375000
NODE_1077_length_2266_cov_13.206276	488	568	4	65	80	0.8125000
NODE_1077_length_2266_cov_13.206276	488	568	5	12	80	0.1500000
NODE_1077_length_2266_cov_13.206276	541	627	3	25	86	0.2906977
NODE_1077_length_2266_cov_13.206276	541	627	4	37	86	0.4302326
NODE_1077_length_2266_cov_13.206276	541	627	5	24	86	0.2790698
NODE_1078_length_2262_cov_11.759131	413	493	0	80	80	1.0000000
NODE_1078_length_2262_cov_11.759131	466	546	0	80	80	1.0000000
NODE_1079_length_2260_cov_37.814901	219	299	3	2	80	0.0250000
NODE_1079_length_2260_cov_37.814901	219	299	4	32	80	0.4000000
NODE_1079_length_2260_cov_37.814901	219	299	5	15	80	0.1875000
NODE_1079_length_2260_cov_37.814901	219	299	6	2	80	0.0250000
NODE_1079_length_2260_cov_37.814901	219	299	7	29	80	0.3625000
NODE_1079_length_2260_cov_37.814901	742	822	2	41	80	0.5125000
NODE_1079_length_2260_cov_37.814901	742	822	4	37	80	0.4625000
NODE_1079_length_2260_cov_37.814901	742	822	6	2	80	0.0250000
NODE_1079_length_2260_cov_37.814901	795	875	4	25	80	0.3125000
NODE_1079_length_2260_cov_37.814901	795	875	6	2	80	0.0250000
NODE_1079_length_2260_cov_37.814901	795	875	7	19	80	0.2375000
NODE_1079_length_2260_cov_37.814901	795	875	8	34	80	0.4250000
NODE_1079_length_2260_cov_37.814901	1533	1613	4	23	80	0.2875000
NODE_1079_length_2260_cov_37.814901	1533	1613	6	57	80	0.7125000
NODE_1079_length_2260_cov_37.814901	1586	1666	2	34	80	0.4250000
NODE_1079_length_2260_cov_37.814901	1586	1666	3	1	80	0.0125000
NODE_1079_length_2260_cov_37.814901	1586	1666	4	41	80	0.5125000
NODE_1079_length_2260_cov_37.814901	1586	1666	6	4	80	0.0500000
NODE_1079_length_2260_cov_37.814901	1662	1742	0	60	80	0.7500000
NODE_1079_length_2260_cov_37.814901	1662	1742	1	9	80	0.1125000
NODE_1079_length_2260_cov_37.814901	1662	1742	2	11	80	0.1375000
NODE_1079_length_2260_cov_37.814901	1715	1795	0	80	80	1.0000000
NODE_1082_length_2253_cov_8.904828	472	552	13	1	80	0.0125000
NODE_1082_length_2253_cov_8.904828	472	552	14	3	80	0.0375000
NODE_1082_length_2253_cov_8.904828	472	552	15	17	80	0.2125000
NODE_1082_length_2253_cov_8.904828	472	552	16	7	80	0.0875000
NODE_1082_length_2253_cov_8.904828	472	552	17	2	80	0.0250000
NODE_1082_length_2253_cov_8.904828	472	552	18	4	80	0.0500000
NODE_1082_length_2253_cov_8.904828	472	552	19	6	80	0.0750000
NODE_1082_length_2253_cov_8.904828	472	552	21	2	80	0.0250000
NODE_1082_length_2253_cov_8.904828	472	552	25	8	80	0.1000000
NODE_1082_length_2253_cov_8.904828	472	552	30	2	80	0.0250000
NODE_1082_length_2253_cov_8.904828	472	552	36	1	80	0.0125000
NODE_1082_length_2253_cov_8.904828	472	552	38	1	80	0.0125000
NODE_1082_length_2253_cov_8.904828	472	552	40	4	80	0.0500000
NODE_1082_length_2253_cov_8.904828	472	552	41	2	80	0.0250000
NODE_1082_length_2253_cov_8.904828	472	552	42	6	80	0.0750000
NODE_1082_length_2253_cov_8.904828	472	552	43	6	80	0.0750000
NODE_1082_length_2253_cov_8.904828	472	552	44	4	80	0.0500000
NODE_1082_length_2253_cov_8.904828	472	552	45	4	80	0.0500000
NODE_1085_length_2252_cov_2.801208	1128	1170	0	42	42	1.0000000
NODE_1085_length_2252_cov_2.801208	1137	1172	0	35	35	1.0000000
NODE_1086_length_2252_cov_2.078031	13	62	0	49	49	1.0000000
NODE_1086_length_2252_cov_2.078031	13	61	0	48	48	1.0000000
NODE_1086_length_2252_cov_2.078031	13	62	0	49	49	1.0000000
NODE_1086_length_2252_cov_2.078031	13	62	0	49	49	1.0000000
NODE_1086_length_2252_cov_2.078031	13	61	0	48	48	1.0000000
NODE_1087_length_2251_cov_15.458178	1443	1506	0	5	63	0.0793651
NODE_1087_length_2251_cov_15.458178	1443	1506	1	1	63	0.0158730
NODE_1087_length_2251_cov_15.458178	1443	1506	2	17	63	0.2698413
NODE_1087_length_2251_cov_15.458178	1443	1506	3	16	63	0.2539683
NODE_1087_length_2251_cov_15.458178	1443	1506	4	8	63	0.1269841
NODE_1087_length_2251_cov_15.458178	1443	1506	5	15	63	0.2380952
NODE_1087_length_2251_cov_15.458178	1443	1506	15	1	63	0.0158730
NODE_1087_length_2251_cov_15.458178	1496	1550	5	15	54	0.2777778
NODE_1087_length_2251_cov_15.458178	1496	1550	8	1	54	0.0185185
NODE_1087_length_2251_cov_15.458178	1496	1550	10	2	54	0.0370370
NODE_1087_length_2251_cov_15.458178	1496	1550	11	6	54	0.1111111
NODE_1087_length_2251_cov_15.458178	1496	1550	13	6	54	0.1111111
NODE_1087_length_2251_cov_15.458178	1496	1550	14	20	54	0.3703704
NODE_1087_length_2251_cov_15.458178	1496	1550	16	4	54	0.0740741
NODE_1089_length_2250_cov_18.370990	1658	1738	3	26	80	0.3250000
NODE_1089_length_2250_cov_18.370990	1658	1738	4	54	80	0.6750000
NODE_1089_length_2250_cov_18.370990	1711	1791	2	39	80	0.4875000
NODE_1089_length_2250_cov_18.370990	1711	1791	3	31	80	0.3875000
NODE_1089_length_2250_cov_18.370990	1711	1791	4	10	80	0.1250000
NODE_1090_length_2250_cov_5.331474	1844	1924	2	6	80	0.0750000
NODE_1090_length_2250_cov_5.331474	1844	1924	3	11	80	0.1375000
NODE_1090_length_2250_cov_5.331474	1844	1924	4	19	80	0.2375000
NODE_1090_length_2250_cov_5.331474	1844	1924	5	8	80	0.1000000
NODE_1090_length_2250_cov_5.331474	1844	1924	6	9	80	0.1125000
NODE_1090_length_2250_cov_5.331474	1844	1924	7	27	80	0.3375000
NODE_1093_length_2247_cov_7.906890	364	436	15	13	72	0.1805556
NODE_1093_length_2247_cov_7.906890	364	436	16	35	72	0.4861111
NODE_1093_length_2247_cov_7.906890	364	436	17	6	72	0.0833333
NODE_1093_length_2247_cov_7.906890	364	436	18	15	72	0.2083333
NODE_1093_length_2247_cov_7.906890	364	436	19	3	72	0.0416667
NODE_1095_length_2246_cov_7.612948	1992	2055	7	30	63	0.4761905
NODE_1095_length_2246_cov_7.612948	1992	2055	8	28	63	0.4444444
NODE_1095_length_2246_cov_7.612948	1992	2055	9	5	63	0.0793651
NODE_1095_length_2246_cov_7.612948	2045	2108	3	8	63	0.1269841
NODE_1095_length_2246_cov_7.612948	2045	2108	4	11	63	0.1746032
NODE_1095_length_2246_cov_7.612948	2045	2108	5	1	63	0.0158730
NODE_1095_length_2246_cov_7.612948	2045	2108	6	2	63	0.0317460
NODE_1095_length_2246_cov_7.612948	2045	2108	7	35	63	0.5555556
NODE_1095_length_2246_cov_7.612948	2045	2108	8	6	63	0.0952381
NODE_1104_length_2233_cov_35.127460	1517	1597	0	80	80	1.0000000
NODE_1104_length_2233_cov_35.127460	1570	1650	0	80	80	1.0000000
NODE_1105_length_2231_cov_45.701689	315	396	4	11	81	0.1358025
NODE_1105_length_2231_cov_45.701689	315	396	6	27	81	0.3333333
NODE_1105_length_2231_cov_45.701689	315	396	7	24	81	0.2962963
NODE_1105_length_2231_cov_45.701689	315	396	8	1	81	0.0123457
NODE_1105_length_2231_cov_45.701689	315	396	9	6	81	0.0740741
NODE_1105_length_2231_cov_45.701689	315	396	10	12	81	0.1481481
NODE_1105_length_2231_cov_45.701689	369	449	0	16	80	0.2000000
NODE_1105_length_2231_cov_45.701689	369	449	1	3	80	0.0375000
NODE_1105_length_2231_cov_45.701689	369	449	3	33	80	0.4125000
NODE_1105_length_2231_cov_45.701689	369	449	4	12	80	0.1500000
NODE_1105_length_2231_cov_45.701689	369	449	6	16	80	0.2000000
NODE_1105_length_2231_cov_45.701689	496	576	6	15	80	0.1875000
NODE_1105_length_2231_cov_45.701689	496	576	8	15	80	0.1875000
NODE_1105_length_2231_cov_45.701689	496	576	9	4	80	0.0500000
NODE_1105_length_2231_cov_45.701689	496	576	10	7	80	0.0875000
NODE_1105_length_2231_cov_45.701689	496	576	12	5	80	0.0625000
NODE_1105_length_2231_cov_45.701689	496	576	14	1	80	0.0125000
NODE_1105_length_2231_cov_45.701689	496	576	15	2	80	0.0250000
NODE_1105_length_2231_cov_45.701689	496	576	17	21	80	0.2625000
NODE_1105_length_2231_cov_45.701689	496	576	19	10	80	0.1250000
NODE_1105_length_2231_cov_45.701689	582	662	15	4	80	0.0500000
NODE_1105_length_2231_cov_45.701689	582	662	16	5	80	0.0625000
NODE_1105_length_2231_cov_45.701689	582	662	17	8	80	0.1000000
NODE_1105_length_2231_cov_45.701689	582	662	18	1	80	0.0125000
NODE_1105_length_2231_cov_45.701689	582	662	19	1	80	0.0125000
NODE_1105_length_2231_cov_45.701689	582	662	20	38	80	0.4750000
NODE_1105_length_2231_cov_45.701689	582	662	21	2	80	0.0250000
NODE_1105_length_2231_cov_45.701689	582	662	22	2	80	0.0250000
NODE_1105_length_2231_cov_45.701689	582	662	23	2	80	0.0250000
NODE_1105_length_2231_cov_45.701689	582	662	24	4	80	0.0500000
NODE_1105_length_2231_cov_45.701689	582	662	25	13	80	0.1625000
NODE_1105_length_2231_cov_45.701689	625	705	4	10	80	0.1250000
NODE_1105_length_2231_cov_45.701689	625	705	6	3	80	0.0375000
NODE_1105_length_2231_cov_45.701689	625	705	9	5	80	0.0625000
NODE_1105_length_2231_cov_45.701689	625	705	11	5	80	0.0625000
NODE_1105_length_2231_cov_45.701689	625	705	13	2	80	0.0250000
NODE_1105_length_2231_cov_45.701689	625	705	14	4	80	0.0500000
NODE_1105_length_2231_cov_45.701689	625	705	15	7	80	0.0875000
NODE_1105_length_2231_cov_45.701689	625	705	16	15	80	0.1875000
NODE_1105_length_2231_cov_45.701689	625	705	17	9	80	0.1125000
NODE_1105_length_2231_cov_45.701689	625	705	18	1	80	0.0125000
NODE_1105_length_2231_cov_45.701689	625	705	20	19	80	0.2375000
NODE_1105_length_2231_cov_45.701689	711	791	5	21	80	0.2625000
NODE_1105_length_2231_cov_45.701689	711	791	6	41	80	0.5125000
NODE_1105_length_2231_cov_45.701689	711	791	8	18	80	0.2250000
NODE_1105_length_2231_cov_45.701689	1141	1186	3	11	45	0.2444444
NODE_1105_length_2231_cov_45.701689	1141	1186	4	22	45	0.4888889
NODE_1105_length_2231_cov_45.701689	1141	1186	5	12	45	0.2666667
NODE_1105_length_2231_cov_45.701689	1787	1867	0	41	80	0.5125000
NODE_1105_length_2231_cov_45.701689	1787	1867	2	18	80	0.2250000
NODE_1105_length_2231_cov_45.701689	1787	1867	4	21	80	0.2625000
NODE_1105_length_2231_cov_45.701689	1840	1920	0	35	80	0.4375000
NODE_1105_length_2231_cov_45.701689	1840	1920	1	45	80	0.5625000
NODE_1106_length_2230_cov_12.608634	1520	1600	0	80	80	1.0000000
NODE_1106_length_2230_cov_12.608634	1573	1653	0	80	80	1.0000000
NODE_1112_length_2218_cov_5.292591	1427	1497	15	3	70	0.0428571
NODE_1112_length_2218_cov_5.292591	1427	1497	16	5	70	0.0714286
NODE_1112_length_2218_cov_5.292591	1427	1497	17	35	70	0.5000000
NODE_1112_length_2218_cov_5.292591	1427	1497	18	23	70	0.3285714
NODE_1112_length_2218_cov_5.292591	1427	1497	19	4	70	0.0571429
NODE_1112_length_2218_cov_5.292591	1470	1536	13	3	66	0.0454545
NODE_1112_length_2218_cov_5.292591	1470	1536	15	18	66	0.2727273
NODE_1112_length_2218_cov_5.292591	1470	1536	16	6	66	0.0909091
NODE_1112_length_2218_cov_5.292591	1470	1536	17	13	66	0.1969697
NODE_1112_length_2218_cov_5.292591	1470	1536	18	16	66	0.2424242
NODE_1112_length_2218_cov_5.292591	1470	1536	19	10	66	0.1515152
NODE_1115_length_2215_cov_51.865784	108	188	0	15	80	0.1875000
NODE_1115_length_2215_cov_51.865784	108	188	2	65	80	0.8125000
NODE_1115_length_2215_cov_51.865784	161	241	0	29	80	0.3625000
NODE_1115_length_2215_cov_51.865784	161	241	2	51	80	0.6375000
NODE_1115_length_2215_cov_51.865784	237	317	0	80	80	1.0000000
NODE_1115_length_2215_cov_51.865784	290	370	0	80	80	1.0000000
NODE_1115_length_2215_cov_51.865784	1030	1102	50	1	72	0.0138889
NODE_1115_length_2215_cov_51.865784	1030	1102	71	1	72	0.0138889
NODE_1115_length_2215_cov_51.865784	1030	1102	77	1	72	0.0138889
NODE_1115_length_2215_cov_51.865784	1030	1102	80	1	72	0.0138889
NODE_1115_length_2215_cov_51.865784	1030	1102	83	1	72	0.0138889
NODE_1115_length_2215_cov_51.865784	1030	1102	84	1	72	0.0138889
NODE_1115_length_2215_cov_51.865784	1030	1102	85	1	72	0.0138889
NODE_1115_length_2215_cov_51.865784	1030	1102	90	1	72	0.0138889
NODE_1115_length_2215_cov_51.865784	1030	1102	96	2	72	0.0277778
NODE_1115_length_2215_cov_51.865784	1030	1102	108	1	72	0.0138889
NODE_1115_length_2215_cov_51.865784	1030	1102	111	2	72	0.0277778
NODE_1115_length_2215_cov_51.865784	1030	1102	113	1	72	0.0138889
NODE_1115_length_2215_cov_51.865784	1030	1102	115	1	72	0.0138889
NODE_1115_length_2215_cov_51.865784	1030	1102	116	1	72	0.0138889
NODE_1115_length_2215_cov_51.865784	1030	1102	117	1	72	0.0138889
NODE_1115_length_2215_cov_51.865784	1030	1102	121	1	72	0.0138889
NODE_1115_length_2215_cov_51.865784	1030	1102	123	1	72	0.0138889
NODE_1115_length_2215_cov_51.865784	1030	1102	128	1	72	0.0138889
NODE_1115_length_2215_cov_51.865784	1030	1102	132	1	72	0.0138889
NODE_1115_length_2215_cov_51.865784	1030	1102	134	1	72	0.0138889
NODE_1115_length_2215_cov_51.865784	1030	1102	137	1	72	0.0138889
NODE_1115_length_2215_cov_51.865784	1030	1102	140	1	72	0.0138889
NODE_1115_length_2215_cov_51.865784	1030	1102	144	1	72	0.0138889
NODE_1115_length_2215_cov_51.865784	1030	1102	146	1	72	0.0138889
NODE_1115_length_2215_cov_51.865784	1030	1102	147	2	72	0.0277778
NODE_1115_length_2215_cov_51.865784	1030	1102	153	1	72	0.0138889
NODE_1115_length_2215_cov_51.865784	1030	1102	154	1	72	0.0138889
NODE_1115_length_2215_cov_51.865784	1030	1102	156	2	72	0.0277778
NODE_1115_length_2215_cov_51.865784	1030	1102	158	1	72	0.0138889
NODE_1115_length_2215_cov_51.865784	1030	1102	160	1	72	0.0138889
NODE_1115_length_2215_cov_51.865784	1030	1102	162	1	72	0.0138889
NODE_1115_length_2215_cov_51.865784	1030	1102	164	1	72	0.0138889
NODE_1115_length_2215_cov_51.865784	1030	1102	170	1	72	0.0138889
NODE_1115_length_2215_cov_51.865784	1030	1102	171	1	72	0.0138889
NODE_1115_length_2215_cov_51.865784	1030	1102	175	1	72	0.0138889
NODE_1115_length_2215_cov_51.865784	1030	1102	180	1	72	0.0138889
NODE_1115_length_2215_cov_51.865784	1030	1102	183	1	72	0.0138889
NODE_1115_length_2215_cov_51.865784	1030	1102	185	2	72	0.0277778
NODE_1115_length_2215_cov_51.865784	1030	1102	190	1	72	0.0138889
NODE_1115_length_2215_cov_51.865784	1030	1102	192	1	72	0.0138889
NODE_1115_length_2215_cov_51.865784	1030	1102	201	3	72	0.0416667
NODE_1115_length_2215_cov_51.865784	1030	1102	205	1	72	0.0138889
NODE_1115_length_2215_cov_51.865784	1030	1102	208	1	72	0.0138889
NODE_1115_length_2215_cov_51.865784	1030	1102	209	1	72	0.0138889
NODE_1115_length_2215_cov_51.865784	1030	1102	218	1	72	0.0138889
NODE_1115_length_2215_cov_51.865784	1030	1102	220	1	72	0.0138889
NODE_1115_length_2215_cov_51.865784	1030	1102	221	1	72	0.0138889
NODE_1115_length_2215_cov_51.865784	1030	1102	223	2	72	0.0277778
NODE_1115_length_2215_cov_51.865784	1030	1102	227	1	72	0.0138889
NODE_1115_length_2215_cov_51.865784	1030	1102	228	1	72	0.0138889
NODE_1115_length_2215_cov_51.865784	1030	1102	229	3	72	0.0416667
NODE_1115_length_2215_cov_51.865784	1030	1102	233	1	72	0.0138889
NODE_1115_length_2215_cov_51.865784	1030	1102	238	1	72	0.0138889
NODE_1115_length_2215_cov_51.865784	1030	1102	239	1	72	0.0138889
NODE_1115_length_2215_cov_51.865784	1030	1102	246	1	72	0.0138889
NODE_1115_length_2215_cov_51.865784	1030	1102	249	2	72	0.0277778
NODE_1115_length_2215_cov_51.865784	1030	1102	250	1	72	0.0138889
NODE_1115_length_2215_cov_51.865784	1030	1102	251	1	72	0.0138889
NODE_1115_length_2215_cov_51.865784	1030	1102	253	1	72	0.0138889
NODE_1115_length_2215_cov_51.865784	1030	1102	257	1	72	0.0138889
NODE_1115_length_2215_cov_51.865784	1030	1102	258	1	72	0.0138889
NODE_1115_length_2215_cov_51.865784	1571	1651	1	80	80	1.0000000
NODE_1115_length_2215_cov_51.865784	1624	1704	0	37	80	0.4625000
NODE_1115_length_2215_cov_51.865784	1624	1704	1	43	80	0.5375000
NODE_1117_length_2212_cov_63.988168	459	539	1	20	80	0.2500000
NODE_1117_length_2212_cov_63.988168	459	539	2	47	80	0.5875000
NODE_1117_length_2212_cov_63.988168	459	539	3	13	80	0.1625000
NODE_1117_length_2212_cov_63.988168	512	592	2	71	80	0.8875000
NODE_1117_length_2212_cov_63.988168	512	592	3	9	80	0.1125000
NODE_1117_length_2212_cov_63.988168	588	668	0	10	80	0.1250000
NODE_1117_length_2212_cov_63.988168	588	668	1	29	80	0.3625000
NODE_1117_length_2212_cov_63.988168	588	668	2	41	80	0.5125000
NODE_1117_length_2212_cov_63.988168	641	721	0	15	80	0.1875000
NODE_1117_length_2212_cov_63.988168	641	721	1	57	80	0.7125000
NODE_1117_length_2212_cov_63.988168	641	721	2	8	80	0.1000000
NODE_1119_length_2212_cov_4.632750	1479	1559	3	41	80	0.5125000
NODE_1119_length_2212_cov_4.632750	1479	1559	5	10	80	0.1250000
NODE_1119_length_2212_cov_4.632750	1479	1559	6	29	80	0.3625000
NODE_1119_length_2212_cov_4.632750	1532	1612	1	13	80	0.1625000
NODE_1119_length_2212_cov_4.632750	1532	1612	3	67	80	0.8375000
NODE_1122_length_2211_cov_16.247159	1808	1888	19	5	80	0.0625000
NODE_1122_length_2211_cov_16.247159	1808	1888	20	15	80	0.1875000
NODE_1122_length_2211_cov_16.247159	1808	1888	21	7	80	0.0875000
NODE_1122_length_2211_cov_16.247159	1808	1888	22	11	80	0.1375000
NODE_1122_length_2211_cov_16.247159	1808	1888	23	26	80	0.3250000
NODE_1122_length_2211_cov_16.247159	1808	1888	24	11	80	0.1375000
NODE_1122_length_2211_cov_16.247159	1808	1888	26	5	80	0.0625000
NODE_1124_length_2207_cov_46.766129	1273	1348	229	1	75	0.0133333
NODE_1124_length_2207_cov_46.766129	1273	1348	230	3	75	0.0400000
NODE_1124_length_2207_cov_46.766129	1273	1348	231	1	75	0.0133333
NODE_1124_length_2207_cov_46.766129	1273	1348	232	2	75	0.0266667
NODE_1124_length_2207_cov_46.766129	1273	1348	233	3	75	0.0400000
NODE_1124_length_2207_cov_46.766129	1273	1348	234	2	75	0.0266667
NODE_1124_length_2207_cov_46.766129	1273	1348	235	4	75	0.0533333
NODE_1124_length_2207_cov_46.766129	1273	1348	236	6	75	0.0800000
NODE_1124_length_2207_cov_46.766129	1273	1348	237	4	75	0.0533333
NODE_1124_length_2207_cov_46.766129	1273	1348	238	5	75	0.0666667
NODE_1124_length_2207_cov_46.766129	1273	1348	239	4	75	0.0533333
NODE_1124_length_2207_cov_46.766129	1273	1348	240	8	75	0.1066667
NODE_1124_length_2207_cov_46.766129	1273	1348	241	10	75	0.1333333
NODE_1124_length_2207_cov_46.766129	1273	1348	242	3	75	0.0400000
NODE_1124_length_2207_cov_46.766129	1273	1348	243	6	75	0.0800000
NODE_1124_length_2207_cov_46.766129	1273	1348	244	3	75	0.0400000
NODE_1124_length_2207_cov_46.766129	1273	1348	245	4	75	0.0533333
NODE_1124_length_2207_cov_46.766129	1273	1348	246	3	75	0.0400000
NODE_1124_length_2207_cov_46.766129	1273	1348	247	2	75	0.0266667
NODE_1124_length_2207_cov_46.766129	1273	1348	248	1	75	0.0133333
NODE_1124_length_2207_cov_46.766129	1324	1401	171	1	77	0.0129870
NODE_1124_length_2207_cov_46.766129	1324	1401	174	1	77	0.0129870
NODE_1124_length_2207_cov_46.766129	1324	1401	178	1	77	0.0129870
NODE_1124_length_2207_cov_46.766129	1324	1401	180	1	77	0.0129870
NODE_1124_length_2207_cov_46.766129	1324	1401	185	6	77	0.0779221
NODE_1124_length_2207_cov_46.766129	1324	1401	186	4	77	0.0519481
NODE_1124_length_2207_cov_46.766129	1324	1401	187	3	77	0.0389610
NODE_1124_length_2207_cov_46.766129	1324	1401	194	1	77	0.0129870
NODE_1124_length_2207_cov_46.766129	1324	1401	196	1	77	0.0129870
NODE_1124_length_2207_cov_46.766129	1324	1401	201	1	77	0.0129870
NODE_1124_length_2207_cov_46.766129	1324	1401	203	3	77	0.0389610
NODE_1124_length_2207_cov_46.766129	1324	1401	204	1	77	0.0129870
NODE_1124_length_2207_cov_46.766129	1324	1401	207	4	77	0.0519481
NODE_1124_length_2207_cov_46.766129	1324	1401	208	1	77	0.0129870
NODE_1124_length_2207_cov_46.766129	1324	1401	215	1	77	0.0129870
NODE_1124_length_2207_cov_46.766129	1324	1401	218	3	77	0.0389610
NODE_1124_length_2207_cov_46.766129	1324	1401	219	1	77	0.0129870
NODE_1124_length_2207_cov_46.766129	1324	1401	220	3	77	0.0389610
NODE_1124_length_2207_cov_46.766129	1324	1401	221	1	77	0.0129870
NODE_1124_length_2207_cov_46.766129	1324	1401	222	2	77	0.0259740
NODE_1124_length_2207_cov_46.766129	1324	1401	223	1	77	0.0129870
NODE_1124_length_2207_cov_46.766129	1324	1401	226	1	77	0.0129870
NODE_1124_length_2207_cov_46.766129	1324	1401	228	2	77	0.0259740
NODE_1124_length_2207_cov_46.766129	1324	1401	229	3	77	0.0389610
NODE_1124_length_2207_cov_46.766129	1324	1401	230	4	77	0.0519481
NODE_1124_length_2207_cov_46.766129	1324	1401	231	4	77	0.0519481
NODE_1124_length_2207_cov_46.766129	1324	1401	232	4	77	0.0519481
NODE_1124_length_2207_cov_46.766129	1324	1401	233	4	77	0.0519481
NODE_1124_length_2207_cov_46.766129	1324	1401	234	2	77	0.0259740
NODE_1124_length_2207_cov_46.766129	1324	1401	235	2	77	0.0259740
NODE_1124_length_2207_cov_46.766129	1324	1401	236	5	77	0.0649351
NODE_1124_length_2207_cov_46.766129	1324	1401	237	3	77	0.0389610
NODE_1124_length_2207_cov_46.766129	1324	1401	240	1	77	0.0129870
NODE_1124_length_2207_cov_46.766129	1324	1401	241	1	77	0.0129870
NODE_1127_length_2205_cov_12.762108	1818	1898	4	13	80	0.1625000
NODE_1127_length_2205_cov_12.762108	1818	1898	5	21	80	0.2625000
NODE_1127_length_2205_cov_12.762108	1818	1898	6	12	80	0.1500000
NODE_1127_length_2205_cov_12.762108	1818	1898	7	4	80	0.0500000
NODE_1127_length_2205_cov_12.762108	1818	1898	8	8	80	0.1000000
NODE_1127_length_2205_cov_12.762108	1818	1898	9	1	80	0.0125000
NODE_1127_length_2205_cov_12.762108	1818	1898	10	5	80	0.0625000
NODE_1127_length_2205_cov_12.762108	1818	1898	11	16	80	0.2000000
NODE_1127_length_2205_cov_12.762108	1871	1951	8	5	80	0.0625000
NODE_1127_length_2205_cov_12.762108	1871	1951	9	28	80	0.3500000
NODE_1127_length_2205_cov_12.762108	1871	1951	10	31	80	0.3875000
NODE_1127_length_2205_cov_12.762108	1871	1951	11	16	80	0.2000000
NODE_1127_length_2205_cov_12.762108	1872	1951	8	4	79	0.0506329
NODE_1127_length_2205_cov_12.762108	1872	1951	9	28	79	0.3544304
NODE_1127_length_2205_cov_12.762108	1872	1951	10	31	79	0.3924051
NODE_1127_length_2205_cov_12.762108	1872	1951	11	16	79	0.2025317
NODE_1127_length_2205_cov_12.762108	1947	2020	4	2	73	0.0273973
NODE_1127_length_2205_cov_12.762108	1947	2020	5	4	73	0.0547945
NODE_1127_length_2205_cov_12.762108	1947	2020	6	12	73	0.1643836
NODE_1127_length_2205_cov_12.762108	1947	2020	7	21	73	0.2876712
NODE_1127_length_2205_cov_12.762108	1947	2020	8	20	73	0.2739726
NODE_1127_length_2205_cov_12.762108	1947	2020	9	14	73	0.1917808
NODE_1128_length_2202_cov_8.687114	1848	1912	0	64	64	1.0000000
NODE_1130_length_2200_cov_10.639695	1461	1541	0	15	80	0.1875000
NODE_1130_length_2200_cov_10.639695	1461	1541	2	45	80	0.5625000
NODE_1130_length_2200_cov_10.639695	1461	1541	3	20	80	0.2500000
NODE_1130_length_2200_cov_10.639695	1514	1594	2	7	80	0.0875000
NODE_1130_length_2200_cov_10.639695	1514	1594	3	73	80	0.9125000
NODE_1131_length_2199_cov_10.839524	1709	1789	2	29	80	0.3625000
NODE_1131_length_2199_cov_10.839524	1709	1789	3	20	80	0.2500000
NODE_1131_length_2199_cov_10.839524	1709	1789	4	31	80	0.3875000
NODE_1131_length_2199_cov_10.839524	1762	1842	2	32	80	0.4000000
NODE_1131_length_2199_cov_10.839524	1762	1842	3	3	80	0.0375000
NODE_1131_length_2199_cov_10.839524	1762	1842	4	45	80	0.5625000
NODE_1135_length_2196_cov_64.718646	885	965	29	2	80	0.0250000
NODE_1135_length_2196_cov_64.718646	885	965	30	1	80	0.0125000
NODE_1135_length_2196_cov_64.718646	885	965	31	1	80	0.0125000
NODE_1135_length_2196_cov_64.718646	885	965	33	9	80	0.1125000
NODE_1135_length_2196_cov_64.718646	885	965	34	8	80	0.1000000
NODE_1135_length_2196_cov_64.718646	885	965	35	5	80	0.0625000
NODE_1135_length_2196_cov_64.718646	885	965	37	2	80	0.0250000
NODE_1135_length_2196_cov_64.718646	885	965	38	4	80	0.0500000
NODE_1135_length_2196_cov_64.718646	885	965	39	1	80	0.0125000
NODE_1135_length_2196_cov_64.718646	885	965	40	2	80	0.0250000
NODE_1135_length_2196_cov_64.718646	885	965	41	9	80	0.1125000
NODE_1135_length_2196_cov_64.718646	885	965	42	7	80	0.0875000
NODE_1135_length_2196_cov_64.718646	885	965	43	13	80	0.1625000
NODE_1135_length_2196_cov_64.718646	885	965	44	1	80	0.0125000
NODE_1135_length_2196_cov_64.718646	885	965	45	15	80	0.1875000
NODE_1135_length_2196_cov_64.718646	938	1018	26	3	80	0.0375000
NODE_1135_length_2196_cov_64.718646	938	1018	27	2	80	0.0250000
NODE_1135_length_2196_cov_64.718646	938	1018	28	5	80	0.0625000
NODE_1135_length_2196_cov_64.718646	938	1018	30	3	80	0.0375000
NODE_1135_length_2196_cov_64.718646	938	1018	31	3	80	0.0375000
NODE_1135_length_2196_cov_64.718646	938	1018	32	2	80	0.0250000
NODE_1135_length_2196_cov_64.718646	938	1018	39	2	80	0.0250000
NODE_1135_length_2196_cov_64.718646	938	1018	40	4	80	0.0500000
NODE_1135_length_2196_cov_64.718646	938	1018	41	6	80	0.0750000
NODE_1135_length_2196_cov_64.718646	938	1018	42	8	80	0.1000000
NODE_1135_length_2196_cov_64.718646	938	1018	43	10	80	0.1250000
NODE_1135_length_2196_cov_64.718646	938	1018	44	16	80	0.2000000
NODE_1135_length_2196_cov_64.718646	938	1018	45	16	80	0.2000000
NODE_1138_length_2195_cov_8.443225	114	136	0	22	22	1.0000000
NODE_1139_length_2195_cov_6.113550	1245	1330	1	8	85	0.0941176
NODE_1139_length_2195_cov_6.113550	1245	1330	2	7	85	0.0823529
NODE_1139_length_2195_cov_6.113550	1245	1330	4	9	85	0.1058824
NODE_1139_length_2195_cov_6.113550	1245	1330	6	61	85	0.7176471
NODE_1139_length_2195_cov_6.113550	1306	1352	6	46	46	1.0000000
NODE_1141_length_2194_cov_1.366587	15	77	0	22	62	0.3548387
NODE_1141_length_2194_cov_1.366587	15	77	2	40	62	0.6451613
NODE_1142_length_2193_cov_8.320917	374	454	0	80	80	1.0000000
NODE_1142_length_2193_cov_8.320917	427	502	0	75	75	1.0000000
NODE_1146_length_2189_cov_36.884689	383	463	3	13	80	0.1625000
NODE_1146_length_2189_cov_36.884689	383	463	5	5	80	0.0625000
NODE_1146_length_2189_cov_36.884689	383	463	7	4	80	0.0500000
NODE_1146_length_2189_cov_36.884689	383	463	9	39	80	0.4875000
NODE_1146_length_2189_cov_36.884689	383	463	10	19	80	0.2375000
NODE_1146_length_2189_cov_36.884689	436	516	9	12	80	0.1500000
NODE_1146_length_2189_cov_36.884689	436	516	10	20	80	0.2500000
NODE_1146_length_2189_cov_36.884689	436	516	11	23	80	0.2875000
NODE_1146_length_2189_cov_36.884689	436	516	12	22	80	0.2750000
NODE_1146_length_2189_cov_36.884689	436	516	13	3	80	0.0375000
NODE_1146_length_2189_cov_36.884689	1257	1337	2	3	80	0.0375000
NODE_1146_length_2189_cov_36.884689	1257	1337	3	10	80	0.1250000
NODE_1146_length_2189_cov_36.884689	1257	1337	4	67	80	0.8375000
NODE_1146_length_2189_cov_36.884689	1310	1390	2	15	80	0.1875000
NODE_1146_length_2189_cov_36.884689	1310	1390	4	65	80	0.8125000
NODE_1146_length_2189_cov_36.884689	1427	1507	0	5	80	0.0625000
NODE_1146_length_2189_cov_36.884689	1427	1507	2	75	80	0.9375000
NODE_1146_length_2189_cov_36.884689	1480	1560	0	58	80	0.7250000
NODE_1146_length_2189_cov_36.884689	1480	1560	2	22	80	0.2750000
NODE_1152_length_2184_cov_9.464748	1536	1616	14	2	80	0.0250000
NODE_1152_length_2184_cov_9.464748	1536	1616	16	23	80	0.2875000
NODE_1152_length_2184_cov_9.464748	1536	1616	17	9	80	0.1125000
NODE_1152_length_2184_cov_9.464748	1536	1616	18	12	80	0.1500000
NODE_1152_length_2184_cov_9.464748	1536	1616	19	10	80	0.1250000
NODE_1152_length_2184_cov_9.464748	1536	1616	20	19	80	0.2375000
NODE_1152_length_2184_cov_9.464748	1536	1616	21	5	80	0.0625000
NODE_1152_length_2184_cov_9.464748	1589	1669	7	12	80	0.1500000
NODE_1152_length_2184_cov_9.464748	1589	1669	9	2	80	0.0250000
NODE_1152_length_2184_cov_9.464748	1589	1669	11	1	80	0.0125000
NODE_1152_length_2184_cov_9.464748	1589	1669	12	3	80	0.0375000
NODE_1152_length_2184_cov_9.464748	1589	1669	13	6	80	0.0750000
NODE_1152_length_2184_cov_9.464748	1589	1669	15	10	80	0.1250000
NODE_1152_length_2184_cov_9.464748	1589	1669	16	9	80	0.1125000
NODE_1152_length_2184_cov_9.464748	1589	1669	17	17	80	0.2125000
NODE_1152_length_2184_cov_9.464748	1589	1669	19	5	80	0.0625000
NODE_1152_length_2184_cov_9.464748	1589	1669	20	10	80	0.1250000
NODE_1152_length_2184_cov_9.464748	1589	1669	21	5	80	0.0625000
NODE_1154_length_2183_cov_45.471209	1632	1712	6	2	80	0.0250000
NODE_1154_length_2183_cov_45.471209	1632	1712	7	1	80	0.0125000
NODE_1154_length_2183_cov_45.471209	1632	1712	9	1	80	0.0125000
NODE_1154_length_2183_cov_45.471209	1632	1712	10	14	80	0.1750000
NODE_1154_length_2183_cov_45.471209	1632	1712	12	10	80	0.1250000
NODE_1154_length_2183_cov_45.471209	1632	1712	14	14	80	0.1750000
NODE_1154_length_2183_cov_45.471209	1632	1712	15	2	80	0.0250000
NODE_1154_length_2183_cov_45.471209	1632	1712	16	34	80	0.4250000
NODE_1154_length_2183_cov_45.471209	1632	1712	17	2	80	0.0250000
NODE_1154_length_2183_cov_45.471209	1685	1765	15	5	80	0.0625000
NODE_1154_length_2183_cov_45.471209	1685	1765	16	42	80	0.5250000
NODE_1154_length_2183_cov_45.471209	1685	1765	17	24	80	0.3000000
NODE_1154_length_2183_cov_45.471209	1685	1765	18	6	80	0.0750000
NODE_1154_length_2183_cov_45.471209	1685	1765	19	3	80	0.0375000
NODE_1159_length_2176_cov_47.338950	0	52	2	19	52	0.3653846
NODE_1159_length_2176_cov_47.338950	0	52	3	33	52	0.6346154
NODE_1162_length_2174_cov_40.560964	1638	1718	5	15	80	0.1875000
NODE_1162_length_2174_cov_40.560964	1638	1718	6	25	80	0.3125000
NODE_1162_length_2174_cov_40.560964	1638	1718	7	13	80	0.1625000
NODE_1162_length_2174_cov_40.560964	1638	1718	8	27	80	0.3375000
NODE_1162_length_2174_cov_40.560964	1691	1771	4	25	80	0.3125000
NODE_1162_length_2174_cov_40.560964	1691	1771	6	22	80	0.2750000
NODE_1162_length_2174_cov_40.560964	1691	1771	7	3	80	0.0375000
NODE_1162_length_2174_cov_40.560964	1691	1771	8	30	80	0.3750000
NODE_1163_length_2174_cov_35.399518	284	364	3	16	80	0.2000000
NODE_1163_length_2174_cov_35.399518	284	364	4	64	80	0.8000000
NODE_1163_length_2174_cov_35.399518	337	414	3	3	77	0.0389610
NODE_1163_length_2174_cov_35.399518	337	414	4	74	77	0.9610389
NODE_1163_length_2174_cov_35.399518	1542	1620	154	5	78	0.0641026
NODE_1163_length_2174_cov_35.399518	1542	1620	155	2	78	0.0256410
NODE_1163_length_2174_cov_35.399518	1542	1620	156	2	78	0.0256410
NODE_1163_length_2174_cov_35.399518	1542	1620	158	3	78	0.0384615
NODE_1163_length_2174_cov_35.399518	1542	1620	159	6	78	0.0769231
NODE_1163_length_2174_cov_35.399518	1542	1620	160	3	78	0.0384615
NODE_1163_length_2174_cov_35.399518	1542	1620	161	8	78	0.1025641
NODE_1163_length_2174_cov_35.399518	1542	1620	162	7	78	0.0897436
NODE_1163_length_2174_cov_35.399518	1542	1620	166	2	78	0.0256410
NODE_1163_length_2174_cov_35.399518	1542	1620	167	1	78	0.0128205
NODE_1163_length_2174_cov_35.399518	1542	1620	169	2	78	0.0256410
NODE_1163_length_2174_cov_35.399518	1542	1620	170	1	78	0.0128205
NODE_1163_length_2174_cov_35.399518	1542	1620	172	2	78	0.0256410
NODE_1163_length_2174_cov_35.399518	1542	1620	173	3	78	0.0384615
NODE_1163_length_2174_cov_35.399518	1542	1620	176	3	78	0.0384615
NODE_1163_length_2174_cov_35.399518	1542	1620	177	3	78	0.0384615
NODE_1163_length_2174_cov_35.399518	1542	1620	178	3	78	0.0384615
NODE_1163_length_2174_cov_35.399518	1542	1620	179	1	78	0.0128205
NODE_1163_length_2174_cov_35.399518	1542	1620	181	3	78	0.0384615
NODE_1163_length_2174_cov_35.399518	1542	1620	182	2	78	0.0256410
NODE_1163_length_2174_cov_35.399518	1542	1620	184	1	78	0.0128205
NODE_1163_length_2174_cov_35.399518	1542	1620	186	1	78	0.0128205
NODE_1163_length_2174_cov_35.399518	1542	1620	188	1	78	0.0128205
NODE_1163_length_2174_cov_35.399518	1542	1620	189	1	78	0.0128205
NODE_1163_length_2174_cov_35.399518	1542	1620	190	2	78	0.0256410
NODE_1163_length_2174_cov_35.399518	1542	1620	191	1	78	0.0128205
NODE_1163_length_2174_cov_35.399518	1542	1620	192	1	78	0.0128205
NODE_1163_length_2174_cov_35.399518	1542	1620	197	1	78	0.0128205
NODE_1163_length_2174_cov_35.399518	1542	1620	198	1	78	0.0128205
NODE_1163_length_2174_cov_35.399518	1542	1620	201	1	78	0.0128205
NODE_1163_length_2174_cov_35.399518	1542	1620	203	2	78	0.0256410
NODE_1163_length_2174_cov_35.399518	1542	1620	206	2	78	0.0256410
NODE_1163_length_2174_cov_35.399518	1542	1620	207	1	78	0.0128205
NODE_1163_length_2174_cov_35.399518	1593	1673	170	1	80	0.0125000
NODE_1163_length_2174_cov_35.399518	1593	1673	173	1	80	0.0125000
NODE_1163_length_2174_cov_35.399518	1593	1673	176	3	80	0.0375000
NODE_1163_length_2174_cov_35.399518	1593	1673	177	1	80	0.0125000
NODE_1163_length_2174_cov_35.399518	1593	1673	178	2	80	0.0250000
NODE_1163_length_2174_cov_35.399518	1593	1673	181	1	80	0.0125000
NODE_1163_length_2174_cov_35.399518	1593	1673	182	2	80	0.0250000
NODE_1163_length_2174_cov_35.399518	1593	1673	184	1	80	0.0125000
NODE_1163_length_2174_cov_35.399518	1593	1673	186	1	80	0.0125000
NODE_1163_length_2174_cov_35.399518	1593	1673	188	1	80	0.0125000
NODE_1163_length_2174_cov_35.399518	1593	1673	189	1	80	0.0125000
NODE_1163_length_2174_cov_35.399518	1593	1673	190	2	80	0.0250000
NODE_1163_length_2174_cov_35.399518	1593	1673	191	1	80	0.0125000
NODE_1163_length_2174_cov_35.399518	1593	1673	192	1	80	0.0125000
NODE_1163_length_2174_cov_35.399518	1593	1673	197	1	80	0.0125000
NODE_1163_length_2174_cov_35.399518	1593	1673	198	2	80	0.0250000
NODE_1163_length_2174_cov_35.399518	1593	1673	199	1	80	0.0125000
NODE_1163_length_2174_cov_35.399518	1593	1673	200	1	80	0.0125000
NODE_1163_length_2174_cov_35.399518	1593	1673	201	1	80	0.0125000
NODE_1163_length_2174_cov_35.399518	1593	1673	202	1	80	0.0125000
NODE_1163_length_2174_cov_35.399518	1593	1673	203	5	80	0.0625000
NODE_1163_length_2174_cov_35.399518	1593	1673	206	2	80	0.0250000
NODE_1163_length_2174_cov_35.399518	1593	1673	207	1	80	0.0125000
NODE_1163_length_2174_cov_35.399518	1593	1673	208	1	80	0.0125000
NODE_1163_length_2174_cov_35.399518	1593	1673	209	1	80	0.0125000
NODE_1163_length_2174_cov_35.399518	1593	1673	212	1	80	0.0125000
NODE_1163_length_2174_cov_35.399518	1593	1673	213	1	80	0.0125000
NODE_1163_length_2174_cov_35.399518	1593	1673	214	1	80	0.0125000
NODE_1163_length_2174_cov_35.399518	1593	1673	215	3	80	0.0375000
NODE_1163_length_2174_cov_35.399518	1593	1673	217	3	80	0.0375000
NODE_1163_length_2174_cov_35.399518	1593	1673	218	7	80	0.0875000
NODE_1163_length_2174_cov_35.399518	1593	1673	221	2	80	0.0250000
NODE_1163_length_2174_cov_35.399518	1593	1673	223	4	80	0.0500000
NODE_1163_length_2174_cov_35.399518	1593	1673	224	3	80	0.0375000
NODE_1163_length_2174_cov_35.399518	1593	1673	225	1	80	0.0125000
NODE_1163_length_2174_cov_35.399518	1593	1673	227	1	80	0.0125000
NODE_1163_length_2174_cov_35.399518	1593	1673	228	1	80	0.0125000
NODE_1163_length_2174_cov_35.399518	1593	1673	234	2	80	0.0250000
NODE_1163_length_2174_cov_35.399518	1593	1673	235	2	80	0.0250000
NODE_1163_length_2174_cov_35.399518	1593	1673	236	1	80	0.0125000
NODE_1163_length_2174_cov_35.399518	1593	1673	237	1	80	0.0125000
NODE_1163_length_2174_cov_35.399518	1593	1673	238	1	80	0.0125000
NODE_1163_length_2174_cov_35.399518	1593	1673	239	1	80	0.0125000
NODE_1163_length_2174_cov_35.399518	1593	1673	244	1	80	0.0125000
NODE_1163_length_2174_cov_35.399518	1593	1673	245	1	80	0.0125000
NODE_1163_length_2174_cov_35.399518	1593	1673	248	1	80	0.0125000
NODE_1163_length_2174_cov_35.399518	1593	1673	250	2	80	0.0250000
NODE_1163_length_2174_cov_35.399518	1593	1673	251	1	80	0.0125000
NODE_1163_length_2174_cov_35.399518	1593	1673	253	1	80	0.0125000
NODE_1163_length_2174_cov_35.399518	1593	1673	255	1	80	0.0125000
NODE_1163_length_2174_cov_35.399518	2075	2152	9	4	77	0.0519481
NODE_1163_length_2174_cov_35.399518	2075	2152	11	2	77	0.0259740
NODE_1163_length_2174_cov_35.399518	2075	2152	12	71	77	0.9220779
NODE_1163_length_2174_cov_35.399518	2075	2152	9	4	77	0.0519481
NODE_1163_length_2174_cov_35.399518	2075	2152	11	2	77	0.0259740
NODE_1163_length_2174_cov_35.399518	2075	2152	12	71	77	0.9220779
NODE_1163_length_2174_cov_35.399518	2075	2152	9	4	77	0.0519481
NODE_1163_length_2174_cov_35.399518	2075	2152	11	2	77	0.0259740
NODE_1163_length_2174_cov_35.399518	2075	2152	12	71	77	0.9220779
NODE_1163_length_2174_cov_35.399518	2125	2174	2	5	49	0.1020408
NODE_1163_length_2174_cov_35.399518	2125	2174	4	8	49	0.1632653
NODE_1163_length_2174_cov_35.399518	2125	2174	5	2	49	0.0408163
NODE_1163_length_2174_cov_35.399518	2125	2174	7	5	49	0.1020408
NODE_1163_length_2174_cov_35.399518	2125	2174	9	6	49	0.1224490
NODE_1163_length_2174_cov_35.399518	2125	2174	11	2	49	0.0408163
NODE_1163_length_2174_cov_35.399518	2125	2174	12	21	49	0.4285714
NODE_1163_length_2174_cov_35.399518	2128	2174	2	5	46	0.1086956
NODE_1163_length_2174_cov_35.399518	2128	2174	4	8	46	0.1739130
NODE_1163_length_2174_cov_35.399518	2128	2174	5	2	46	0.0434783
NODE_1163_length_2174_cov_35.399518	2128	2174	7	5	46	0.1086956
NODE_1163_length_2174_cov_35.399518	2128	2174	9	6	46	0.1304348
NODE_1163_length_2174_cov_35.399518	2128	2174	11	2	46	0.0434783
NODE_1163_length_2174_cov_35.399518	2128	2174	12	18	46	0.3913043
NODE_1163_length_2174_cov_35.399518	2130	2174	2	5	44	0.1136364
NODE_1163_length_2174_cov_35.399518	2130	2174	4	8	44	0.1818182
NODE_1163_length_2174_cov_35.399518	2130	2174	5	2	44	0.0454545
NODE_1163_length_2174_cov_35.399518	2130	2174	7	5	44	0.1136364
NODE_1163_length_2174_cov_35.399518	2130	2174	9	6	44	0.1363636
NODE_1163_length_2174_cov_35.399518	2130	2174	11	2	44	0.0454545
NODE_1163_length_2174_cov_35.399518	2130	2174	12	16	44	0.3636364
NODE_1164_length_2172_cov_44.861553	1110	1190	1	8	80	0.1000000
NODE_1164_length_2172_cov_44.861553	1110	1190	2	23	80	0.2875000
NODE_1164_length_2172_cov_44.861553	1110	1190	3	49	80	0.6125000
NODE_1164_length_2172_cov_44.861553	1163	1243	2	9	80	0.1125000
NODE_1164_length_2172_cov_44.861553	1163	1243	3	71	80	0.8875000
NODE_1164_length_2172_cov_44.861553	1239	1319	2	10	80	0.1250000
NODE_1164_length_2172_cov_44.861553	1239	1319	3	4	80	0.0500000
NODE_1164_length_2172_cov_44.861553	1239	1319	4	52	80	0.6500000
NODE_1164_length_2172_cov_44.861553	1239	1319	5	14	80	0.1750000
NODE_1164_length_2172_cov_44.861553	1292	1372	4	28	80	0.3500000
NODE_1164_length_2172_cov_44.861553	1292	1372	5	5	80	0.0625000
NODE_1164_length_2172_cov_44.861553	1292	1372	6	2	80	0.0250000
NODE_1164_length_2172_cov_44.861553	1292	1372	7	45	80	0.5625000
NODE_1166_length_2167_cov_33.133946	414	494	2	13	80	0.1625000
NODE_1166_length_2167_cov_33.133946	414	494	3	67	80	0.8375000
NODE_1166_length_2167_cov_33.133946	467	547	2	49	80	0.6125000
NODE_1166_length_2167_cov_33.133946	467	547	3	31	80	0.3875000
NODE_1166_length_2167_cov_33.133946	543	623	1	25	80	0.3125000
NODE_1166_length_2167_cov_33.133946	543	623	2	53	80	0.6625000
NODE_1166_length_2167_cov_33.133946	543	623	4	2	80	0.0250000
NODE_1166_length_2167_cov_33.133946	596	676	2	25	80	0.3125000
NODE_1166_length_2167_cov_33.133946	596	676	4	5	80	0.0625000
NODE_1166_length_2167_cov_33.133946	596	676	5	11	80	0.1375000
NODE_1166_length_2167_cov_33.133946	596	676	6	1	80	0.0125000
NODE_1166_length_2167_cov_33.133946	596	676	7	3	80	0.0375000
NODE_1166_length_2167_cov_33.133946	596	676	8	26	80	0.3250000
NODE_1166_length_2167_cov_33.133946	596	676	9	9	80	0.1125000
NODE_1169_length_2165_cov_21.460794	980	1060	0	80	80	1.0000000
NODE_1169_length_2165_cov_21.460794	1033	1113	0	80	80	1.0000000
NODE_1176_length_2157_cov_22.284257	989	1069	2	29	80	0.3625000
NODE_1176_length_2157_cov_22.284257	989	1069	3	5	80	0.0625000
NODE_1176_length_2157_cov_22.284257	989	1069	5	7	80	0.0875000
NODE_1176_length_2157_cov_22.284257	989	1069	6	21	80	0.2625000
NODE_1176_length_2157_cov_22.284257	989	1069	7	11	80	0.1375000
NODE_1176_length_2157_cov_22.284257	989	1069	8	2	80	0.0250000
NODE_1176_length_2157_cov_22.284257	989	1069	9	5	80	0.0625000
NODE_1176_length_2157_cov_22.284257	1042	1122	6	16	80	0.2000000
NODE_1176_length_2157_cov_22.284257	1042	1122	7	15	80	0.1875000
NODE_1176_length_2157_cov_22.284257	1042	1122	8	7	80	0.0875000
NODE_1176_length_2157_cov_22.284257	1042	1122	9	42	80	0.5250000
NODE_1176_length_2157_cov_22.284257	1118	1198	4	18	80	0.2250000
NODE_1176_length_2157_cov_22.284257	1118	1198	5	12	80	0.1500000
NODE_1176_length_2157_cov_22.284257	1118	1198	6	50	80	0.6250000
NODE_1176_length_2157_cov_22.284257	1171	1251	1	12	80	0.1500000
NODE_1176_length_2157_cov_22.284257	1171	1251	2	13	80	0.1625000
NODE_1176_length_2157_cov_22.284257	1171	1251	3	25	80	0.3125000
NODE_1176_length_2157_cov_22.284257	1171	1251	4	21	80	0.2625000
NODE_1176_length_2157_cov_22.284257	1171	1251	5	9	80	0.1125000
NODE_1177_length_2157_cov_8.830418	867	947	2	14	80	0.1750000
NODE_1177_length_2157_cov_8.830418	867	947	3	19	80	0.2375000
NODE_1177_length_2157_cov_8.830418	867	947	4	12	80	0.1500000
NODE_1177_length_2157_cov_8.830418	867	947	6	5	80	0.0625000
NODE_1177_length_2157_cov_8.830418	867	947	7	29	80	0.3625000
NODE_1177_length_2157_cov_8.830418	867	947	8	1	80	0.0125000
NODE_1177_length_2157_cov_8.830418	920	1000	7	26	80	0.3250000
NODE_1177_length_2157_cov_8.830418	920	1000	8	12	80	0.1500000
NODE_1177_length_2157_cov_8.830418	920	1000	9	25	80	0.3125000
NODE_1177_length_2157_cov_8.830418	920	1000	10	9	80	0.1125000
NODE_1177_length_2157_cov_8.830418	920	1000	12	8	80	0.1000000
NODE_1177_length_2157_cov_8.830418	996	1076	8	10	80	0.1250000
NODE_1177_length_2157_cov_8.830418	996	1076	9	9	80	0.1125000
NODE_1177_length_2157_cov_8.830418	996	1076	10	11	80	0.1375000
NODE_1177_length_2157_cov_8.830418	996	1076	11	26	80	0.3250000
NODE_1177_length_2157_cov_8.830418	996	1076	12	24	80	0.3000000
NODE_1177_length_2157_cov_8.830418	1049	1129	7	26	80	0.3250000
NODE_1177_length_2157_cov_8.830418	1049	1129	8	28	80	0.3500000
NODE_1177_length_2157_cov_8.830418	1049	1129	9	18	80	0.2250000
NODE_1177_length_2157_cov_8.830418	1049	1129	10	7	80	0.0875000
NODE_1177_length_2157_cov_8.830418	1049	1129	11	1	80	0.0125000
NODE_1178_length_2156_cov_25.065630	0	41	11	1	41	0.0243902
NODE_1178_length_2156_cov_25.065630	0	41	12	1	41	0.0243902
NODE_1178_length_2156_cov_25.065630	0	41	13	1	41	0.0243902
NODE_1178_length_2156_cov_25.065630	0	41	14	2	41	0.0487805
NODE_1178_length_2156_cov_25.065630	0	41	16	3	41	0.0731707
NODE_1178_length_2156_cov_25.065630	0	41	20	1	41	0.0243902
NODE_1178_length_2156_cov_25.065630	0	41	22	4	41	0.0975610
NODE_1178_length_2156_cov_25.065630	0	41	24	1	41	0.0243902
NODE_1178_length_2156_cov_25.065630	0	41	25	1	41	0.0243902
NODE_1178_length_2156_cov_25.065630	0	41	27	2	41	0.0487805
NODE_1178_length_2156_cov_25.065630	0	41	30	4	41	0.0975610
NODE_1178_length_2156_cov_25.065630	0	41	34	1	41	0.0243902
NODE_1178_length_2156_cov_25.065630	0	41	35	3	41	0.0731707
NODE_1178_length_2156_cov_25.065630	0	41	37	1	41	0.0243902
NODE_1178_length_2156_cov_25.065630	0	41	40	1	41	0.0243902
NODE_1178_length_2156_cov_25.065630	0	41	42	4	41	0.0975610
NODE_1178_length_2156_cov_25.065630	0	41	43	10	41	0.2439024
NODE_1178_length_2156_cov_25.065630	14	94	25	1	80	0.0125000
NODE_1178_length_2156_cov_25.065630	14	94	27	2	80	0.0250000
NODE_1178_length_2156_cov_25.065630	14	94	30	4	80	0.0500000
NODE_1178_length_2156_cov_25.065630	14	94	34	1	80	0.0125000
NODE_1178_length_2156_cov_25.065630	14	94	35	3	80	0.0375000
NODE_1178_length_2156_cov_25.065630	14	94	37	1	80	0.0125000
NODE_1178_length_2156_cov_25.065630	14	94	40	1	80	0.0125000
NODE_1178_length_2156_cov_25.065630	14	94	42	4	80	0.0500000
NODE_1178_length_2156_cov_25.065630	14	94	43	11	80	0.1375000
NODE_1178_length_2156_cov_25.065630	14	94	45	3	80	0.0375000
NODE_1178_length_2156_cov_25.065630	14	94	46	3	80	0.0375000
NODE_1178_length_2156_cov_25.065630	14	94	47	1	80	0.0125000
NODE_1178_length_2156_cov_25.065630	14	94	50	1	80	0.0125000
NODE_1178_length_2156_cov_25.065630	14	94	51	7	80	0.0875000
NODE_1178_length_2156_cov_25.065630	14	94	53	2	80	0.0250000
NODE_1178_length_2156_cov_25.065630	14	94	54	1	80	0.0125000
NODE_1178_length_2156_cov_25.065630	14	94	55	2	80	0.0250000
NODE_1178_length_2156_cov_25.065630	14	94	56	3	80	0.0375000
NODE_1178_length_2156_cov_25.065630	14	94	58	1	80	0.0125000
NODE_1178_length_2156_cov_25.065630	14	94	59	2	80	0.0250000
NODE_1178_length_2156_cov_25.065630	14	94	60	1	80	0.0125000
NODE_1178_length_2156_cov_25.065630	14	94	61	1	80	0.0125000
NODE_1178_length_2156_cov_25.065630	14	94	64	5	80	0.0625000
NODE_1178_length_2156_cov_25.065630	14	94	65	1	80	0.0125000
NODE_1178_length_2156_cov_25.065630	14	94	66	1	80	0.0125000
NODE_1178_length_2156_cov_25.065630	14	94	68	2	80	0.0250000
NODE_1178_length_2156_cov_25.065630	14	94	70	1	80	0.0125000
NODE_1178_length_2156_cov_25.065630	14	94	71	3	80	0.0375000
NODE_1178_length_2156_cov_25.065630	14	94	72	6	80	0.0750000
NODE_1178_length_2156_cov_25.065630	14	94	73	2	80	0.0250000
NODE_1178_length_2156_cov_25.065630	14	94	74	1	80	0.0125000
NODE_1178_length_2156_cov_25.065630	14	94	75	2	80	0.0250000
NODE_1181_length_2156_cov_3.216334	1890	1970	3	52	80	0.6500000
NODE_1181_length_2156_cov_3.216334	1890	1970	4	28	80	0.3500000
NODE_1181_length_2156_cov_3.216334	1943	2023	1	13	80	0.1625000
NODE_1181_length_2156_cov_3.216334	1943	2023	2	27	80	0.3375000
NODE_1181_length_2156_cov_3.216334	1943	2023	3	40	80	0.5000000
NODE_1184_length_2153_cov_11.610029	1968	2048	1	5	80	0.0625000
NODE_1184_length_2153_cov_11.610029	1968	2048	2	47	80	0.5875000
NODE_1184_length_2153_cov_11.610029	1968	2048	3	27	80	0.3375000
NODE_1184_length_2153_cov_11.610029	1968	2048	5	1	80	0.0125000
NODE_1184_length_2153_cov_11.610029	1977	2048	1	5	71	0.0704225
NODE_1184_length_2153_cov_11.610029	1977	2048	2	38	71	0.5352113
NODE_1184_length_2153_cov_11.610029	1977	2048	3	27	71	0.3802817
NODE_1184_length_2153_cov_11.610029	1977	2048	5	1	71	0.0140845
NODE_1190_length_2147_cov_25.116211	814	894	4	17	80	0.2125000
NODE_1190_length_2147_cov_25.116211	814	894	5	12	80	0.1500000
NODE_1190_length_2147_cov_25.116211	814	894	7	18	80	0.2250000
NODE_1190_length_2147_cov_25.116211	814	894	8	9	80	0.1125000
NODE_1190_length_2147_cov_25.116211	814	894	10	19	80	0.2375000
NODE_1190_length_2147_cov_25.116211	814	894	12	5	80	0.0625000
NODE_1190_length_2147_cov_25.116211	867	947	8	3	80	0.0375000
NODE_1190_length_2147_cov_25.116211	867	947	9	22	80	0.2750000
NODE_1190_length_2147_cov_25.116211	867	947	10	30	80	0.3750000
NODE_1190_length_2147_cov_25.116211	867	947	11	20	80	0.2500000
NODE_1190_length_2147_cov_25.116211	867	947	12	5	80	0.0625000
NODE_1197_length_2136_cov_16.947472	279	359	1	5	80	0.0625000
NODE_1197_length_2136_cov_16.947472	279	359	3	55	80	0.6875000
NODE_1197_length_2136_cov_16.947472	279	359	5	14	80	0.1750000
NODE_1197_length_2136_cov_16.947472	279	359	6	6	80	0.0750000
NODE_1197_length_2136_cov_16.947472	332	412	3	7	80	0.0875000
NODE_1197_length_2136_cov_16.947472	332	412	4	22	80	0.2750000
NODE_1197_length_2136_cov_16.947472	332	412	5	22	80	0.2750000
NODE_1197_length_2136_cov_16.947472	332	412	6	29	80	0.3625000
NODE_1197_length_2136_cov_16.947472	408	488	2	9	80	0.1125000
NODE_1197_length_2136_cov_16.947472	408	488	3	9	80	0.1125000
NODE_1197_length_2136_cov_16.947472	408	488	4	53	80	0.6625000
NODE_1197_length_2136_cov_16.947472	408	488	5	9	80	0.1125000
NODE_1197_length_2136_cov_16.947472	461	541	3	19	80	0.2375000
NODE_1197_length_2136_cov_16.947472	461	541	4	61	80	0.7625000
NODE_1199_length_2133_cov_15.038840	498	578	2	80	80	1.0000000
NODE_1199_length_2133_cov_15.038840	551	631	0	9	80	0.1125000
NODE_1199_length_2133_cov_15.038840	551	631	1	2	80	0.0250000
NODE_1199_length_2133_cov_15.038840	551	631	2	69	80	0.8625000
NODE_1199_length_2133_cov_15.038840	627	707	0	80	80	1.0000000
NODE_1199_length_2133_cov_15.038840	680	722	0	42	42	1.0000000
NODE_1204_length_2128_cov_11.799409	1698	1778	0	7	80	0.0875000
NODE_1204_length_2128_cov_11.799409	1698	1778	2	73	80	0.9125000
NODE_1204_length_2128_cov_11.799409	1751	1831	2	75	80	0.9375000
NODE_1204_length_2128_cov_11.799409	1751	1831	3	5	80	0.0625000
NODE_1206_length_2126_cov_6.854465	1614	1694	1	78	80	0.9750000
NODE_1206_length_2126_cov_6.854465	1614	1694	2	2	80	0.0250000
NODE_1206_length_2126_cov_6.854465	1667	1747	1	34	80	0.4250000
NODE_1206_length_2126_cov_6.854465	1667	1747	2	46	80	0.5750000
NODE_1209_length_2123_cov_12.668478	102	143	1	41	41	1.0000000
NODE_1209_length_2123_cov_12.668478	1474	1500	1	8	26	0.3076923
NODE_1209_length_2123_cov_12.668478	1474	1500	3	2	26	0.0769231
NODE_1209_length_2123_cov_12.668478	1474	1500	4	16	26	0.6153846
NODE_1209_length_2123_cov_12.668478	1552	1601	5	3	49	0.0612245
NODE_1209_length_2123_cov_12.668478	1552	1601	6	1	49	0.0204082
NODE_1209_length_2123_cov_12.668478	1552	1601	7	8	49	0.1632653
NODE_1209_length_2123_cov_12.668478	1552	1601	8	37	49	0.7551020
NODE_1209_length_2123_cov_12.668478	1574	1654	4	20	80	0.2500000
NODE_1209_length_2123_cov_12.668478	1574	1654	5	36	80	0.4500000
NODE_1209_length_2123_cov_12.668478	1574	1654	7	8	80	0.1000000
NODE_1209_length_2123_cov_12.668478	1574	1654	8	16	80	0.2000000
NODE_1211_length_2121_cov_10.101879	497	577	6	12	80	0.1500000
NODE_1211_length_2121_cov_10.101879	497	577	7	14	80	0.1750000
NODE_1211_length_2121_cov_10.101879	497	577	8	17	80	0.2125000
NODE_1211_length_2121_cov_10.101879	497	577	9	12	80	0.1500000
NODE_1211_length_2121_cov_10.101879	497	577	10	25	80	0.3125000
NODE_1211_length_2121_cov_10.101879	550	630	3	8	80	0.1000000
NODE_1211_length_2121_cov_10.101879	550	630	4	2	80	0.0250000
NODE_1211_length_2121_cov_10.101879	550	630	5	22	80	0.2750000
NODE_1211_length_2121_cov_10.101879	550	630	6	33	80	0.4125000
NODE_1211_length_2121_cov_10.101879	550	630	7	2	80	0.0250000
NODE_1211_length_2121_cov_10.101879	550	630	8	5	80	0.0625000
NODE_1211_length_2121_cov_10.101879	550	630	9	8	80	0.1000000
NODE_1211_length_2121_cov_10.101879	1935	2008	0	27	73	0.3698630
NODE_1211_length_2121_cov_10.101879	1935	2008	2	46	73	0.6301370
NODE_1212_length_2121_cov_9.964886	1523	1603	4	12	80	0.1500000
NODE_1212_length_2121_cov_9.964886	1523	1603	6	50	80	0.6250000
NODE_1212_length_2121_cov_9.964886	1523	1603	7	18	80	0.2250000
NODE_1212_length_2121_cov_9.964886	1576	1656	3	9	80	0.1125000
NODE_1212_length_2121_cov_9.964886	1576	1656	4	24	80	0.3000000
NODE_1212_length_2121_cov_9.964886	1576	1656	5	3	80	0.0375000
NODE_1212_length_2121_cov_9.964886	1576	1656	6	26	80	0.3250000
NODE_1212_length_2121_cov_9.964886	1576	1656	7	18	80	0.2250000
NODE_1213_length_2120_cov_24.609599	25	92	0	67	67	1.0000000
NODE_1215_length_2119_cov_18.446040	366	446	3	16	80	0.2000000
NODE_1215_length_2119_cov_18.446040	366	446	4	1	80	0.0125000
NODE_1215_length_2119_cov_18.446040	366	446	5	14	80	0.1750000
NODE_1215_length_2119_cov_18.446040	366	446	6	31	80	0.3875000
NODE_1215_length_2119_cov_18.446040	366	446	7	18	80	0.2250000
NODE_1215_length_2119_cov_18.446040	419	499	4	21	80	0.2625000
NODE_1215_length_2119_cov_18.446040	419	499	5	2	80	0.0250000
NODE_1215_length_2119_cov_18.446040	419	499	6	57	80	0.7125000
NODE_1215_length_2119_cov_18.446040	1239	1319	0	11	80	0.1375000
NODE_1215_length_2119_cov_18.446040	1239	1319	2	9	80	0.1125000
NODE_1215_length_2119_cov_18.446040	1239	1319	3	60	80	0.7500000
NODE_1215_length_2119_cov_18.446040	1292	1372	3	66	80	0.8250000
NODE_1215_length_2119_cov_18.446040	1292	1372	4	14	80	0.1750000
NODE_1225_length_2110_cov_8.668324	1755	1835	2	80	80	1.0000000
NODE_1225_length_2110_cov_8.668324	1808	1888	0	4	80	0.0500000
NODE_1225_length_2110_cov_8.668324	1808	1888	1	21	80	0.2625000
NODE_1225_length_2110_cov_8.668324	1808	1888	2	55	80	0.6875000
NODE_1227_length_2106_cov_14.643747	1579	1659	0	11	80	0.1375000
NODE_1227_length_2106_cov_14.643747	1579	1659	1	69	80	0.8625000
NODE_1227_length_2106_cov_14.643747	1632	1712	0	64	80	0.8000000
NODE_1227_length_2106_cov_14.643747	1632	1712	1	16	80	0.2000000
NODE_1227_length_2106_cov_14.643747	1708	1786	0	13	78	0.1666667
NODE_1227_length_2106_cov_14.643747	1708	1786	1	65	78	0.8333333
NODE_1227_length_2106_cov_14.643747	1759	1839	1	80	80	1.0000000
NODE_1228_length_2106_cov_3.173393	48	96	0	48	48	1.0000000
NODE_1228_length_2106_cov_3.173393	48	96	0	48	48	1.0000000
NODE_1228_length_2106_cov_3.173393	48	96	0	48	48	1.0000000
NODE_1228_length_2106_cov_3.173393	48	96	0	48	48	1.0000000
NODE_1228_length_2106_cov_3.173393	48	96	0	48	48	1.0000000
NODE_1229_length_2102_cov_23.872192	390	470	1	27	80	0.3375000
NODE_1229_length_2102_cov_23.872192	390	470	2	19	80	0.2375000
NODE_1229_length_2102_cov_23.872192	390	470	4	28	80	0.3500000
NODE_1229_length_2102_cov_23.872192	390	470	5	6	80	0.0750000
NODE_1229_length_2102_cov_23.872192	443	523	4	21	80	0.2625000
NODE_1229_length_2102_cov_23.872192	443	523	5	17	80	0.2125000
NODE_1229_length_2102_cov_23.872192	443	523	6	42	80	0.5250000
NODE_1229_length_2102_cov_23.872192	519	599	6	4	80	0.0500000
NODE_1229_length_2102_cov_23.872192	519	599	7	3	80	0.0375000
NODE_1229_length_2102_cov_23.872192	519	599	8	23	80	0.2875000
NODE_1229_length_2102_cov_23.872192	519	599	9	7	80	0.0875000
NODE_1229_length_2102_cov_23.872192	519	599	10	5	80	0.0625000
NODE_1229_length_2102_cov_23.872192	519	599	11	8	80	0.1000000
NODE_1229_length_2102_cov_23.872192	519	599	12	1	80	0.0125000
NODE_1229_length_2102_cov_23.872192	519	599	13	24	80	0.3000000
NODE_1229_length_2102_cov_23.872192	519	599	14	3	80	0.0375000
NODE_1229_length_2102_cov_23.872192	519	599	15	2	80	0.0250000
NODE_1229_length_2102_cov_23.872192	572	652	11	7	80	0.0875000
NODE_1229_length_2102_cov_23.872192	572	652	12	1	80	0.0125000
NODE_1229_length_2102_cov_23.872192	572	652	13	17	80	0.2125000
NODE_1229_length_2102_cov_23.872192	572	652	15	7	80	0.0875000
NODE_1229_length_2102_cov_23.872192	572	652	17	3	80	0.0375000
NODE_1229_length_2102_cov_23.872192	572	652	18	25	80	0.3125000
NODE_1229_length_2102_cov_23.872192	572	652	19	11	80	0.1375000
NODE_1229_length_2102_cov_23.872192	572	652	21	9	80	0.1125000
NODE_1229_length_2102_cov_23.872192	1049	1101	216	2	52	0.0384615
NODE_1229_length_2102_cov_23.872192	1049	1101	217	2	52	0.0384615
NODE_1229_length_2102_cov_23.872192	1049	1101	222	2	52	0.0384615
NODE_1229_length_2102_cov_23.872192	1049	1101	224	1	52	0.0192308
NODE_1229_length_2102_cov_23.872192	1049	1101	228	1	52	0.0192308
NODE_1229_length_2102_cov_23.872192	1049	1101	230	1	52	0.0192308
NODE_1229_length_2102_cov_23.872192	1049	1101	232	5	52	0.0961538
NODE_1229_length_2102_cov_23.872192	1049	1101	233	6	52	0.1153846
NODE_1229_length_2102_cov_23.872192	1049	1101	234	6	52	0.1153846
NODE_1229_length_2102_cov_23.872192	1049	1101	235	9	52	0.1730769
NODE_1229_length_2102_cov_23.872192	1049	1101	236	9	52	0.1730769
NODE_1229_length_2102_cov_23.872192	1049	1101	237	4	52	0.0769231
NODE_1229_length_2102_cov_23.872192	1049	1101	238	2	52	0.0384615
NODE_1229_length_2102_cov_23.872192	1049	1101	241	2	52	0.0384615
NODE_1231_length_2100_cov_21.504248	450	530	0	80	80	1.0000000
NODE_1231_length_2100_cov_21.504248	503	578	0	75	75	1.0000000
NODE_1231_length_2100_cov_21.504248	579	659	0	80	80	1.0000000
NODE_1231_length_2100_cov_21.504248	632	712	0	80	80	1.0000000
NODE_1231_length_2100_cov_21.504248	1420	1500	0	80	80	1.0000000
NODE_1231_length_2100_cov_21.504248	1473	1553	0	80	80	1.0000000
NODE_1232_length_2100_cov_6.399300	1510	1590	3	4	80	0.0500000
NODE_1232_length_2100_cov_6.399300	1510	1590	4	21	80	0.2625000
NODE_1232_length_2100_cov_6.399300	1510	1590	6	55	80	0.6875000
NODE_1232_length_2100_cov_6.399300	1559	1590	4	14	31	0.4516129
NODE_1232_length_2100_cov_6.399300	1559	1590	6	17	31	0.5483871
NODE_1232_length_2100_cov_6.399300	1563	1644	4	68	81	0.8395061
NODE_1232_length_2100_cov_6.399300	1563	1644	6	13	81	0.1604938
NODE_1232_length_2100_cov_6.399300	1563	1644	4	68	81	0.8395061
NODE_1232_length_2100_cov_6.399300	1563	1644	6	13	81	0.1604938
NODE_1234_length_2099_cov_40.603500	960	1040	4	8	80	0.1000000
NODE_1234_length_2099_cov_40.603500	960	1040	6	22	80	0.2750000
NODE_1234_length_2099_cov_40.603500	960	1040	7	45	80	0.5625000
NODE_1234_length_2099_cov_40.603500	960	1040	8	2	80	0.0250000
NODE_1234_length_2099_cov_40.603500	960	1040	10	3	80	0.0375000
NODE_1234_length_2099_cov_40.603500	1013	1093	7	45	80	0.5625000
NODE_1234_length_2099_cov_40.603500	1013	1093	8	4	80	0.0500000
NODE_1234_length_2099_cov_40.603500	1013	1093	9	12	80	0.1500000
NODE_1234_length_2099_cov_40.603500	1013	1093	10	13	80	0.1625000
NODE_1234_length_2099_cov_40.603500	1013	1093	11	6	80	0.0750000
NODE_1234_length_2099_cov_40.603500	1089	1169	4	13	80	0.1625000
NODE_1234_length_2099_cov_40.603500	1089	1169	5	16	80	0.2000000
NODE_1234_length_2099_cov_40.603500	1089	1169	8	23	80	0.2875000
NODE_1234_length_2099_cov_40.603500	1089	1169	10	28	80	0.3500000
NODE_1234_length_2099_cov_40.603500	1142	1222	1	6	80	0.0750000
NODE_1234_length_2099_cov_40.603500	1142	1222	2	4	80	0.0500000
NODE_1234_length_2099_cov_40.603500	1142	1222	3	9	80	0.1125000
NODE_1234_length_2099_cov_40.603500	1142	1222	4	13	80	0.1625000
NODE_1234_length_2099_cov_40.603500	1142	1222	5	48	80	0.6000000
NODE_1235_length_2098_cov_62.733867	1042	1122	0	3	80	0.0375000
NODE_1235_length_2098_cov_62.733867	1042	1122	2	77	80	0.9625000
NODE_1235_length_2098_cov_62.733867	1095	1175	0	56	80	0.7000000
NODE_1235_length_2098_cov_62.733867	1095	1175	2	24	80	0.3000000
NODE_1235_length_2098_cov_62.733867	1171	1251	0	26	80	0.3250000
NODE_1235_length_2098_cov_62.733867	1171	1251	2	54	80	0.6750000
NODE_1235_length_2098_cov_62.733867	1224	1304	2	80	80	1.0000000
NODE_1236_length_2098_cov_20.220110	550	630	2	32	80	0.4000000
NODE_1236_length_2098_cov_20.220110	550	630	3	43	80	0.5375000
NODE_1236_length_2098_cov_20.220110	550	630	4	5	80	0.0625000
NODE_1236_length_2098_cov_20.220110	603	683	3	80	80	1.0000000
NODE_1236_length_2098_cov_20.220110	1571	1651	2	28	80	0.3500000
NODE_1236_length_2098_cov_20.220110	1571	1651	3	27	80	0.3375000
NODE_1236_length_2098_cov_20.220110	1571	1651	4	25	80	0.3125000
NODE_1236_length_2098_cov_20.220110	1624	1704	1	15	80	0.1875000
NODE_1236_length_2098_cov_20.220110	1624	1704	2	65	80	0.8125000
NODE_1237_length_2098_cov_8.261631	324	404	0	65	80	0.8125000
NODE_1237_length_2098_cov_8.261631	324	404	1	15	80	0.1875000
NODE_1239_length_2095_cov_29.930862	1128	1209	118	1	81	0.0123457
NODE_1239_length_2095_cov_29.930862	1128	1209	121	1	81	0.0123457
NODE_1239_length_2095_cov_29.930862	1128	1209	131	1	81	0.0123457
NODE_1239_length_2095_cov_29.930862	1128	1209	135	1	81	0.0123457
NODE_1239_length_2095_cov_29.930862	1128	1209	136	1	81	0.0123457
NODE_1239_length_2095_cov_29.930862	1128	1209	140	1	81	0.0123457
NODE_1239_length_2095_cov_29.930862	1128	1209	143	1	81	0.0123457
NODE_1239_length_2095_cov_29.930862	1128	1209	149	1	81	0.0123457
NODE_1239_length_2095_cov_29.930862	1128	1209	156	1	81	0.0123457
NODE_1239_length_2095_cov_29.930862	1128	1209	157	1	81	0.0123457
NODE_1239_length_2095_cov_29.930862	1128	1209	162	1	81	0.0123457
NODE_1239_length_2095_cov_29.930862	1128	1209	165	1	81	0.0123457
NODE_1239_length_2095_cov_29.930862	1128	1209	169	1	81	0.0123457
NODE_1239_length_2095_cov_29.930862	1128	1209	173	1	81	0.0123457
NODE_1239_length_2095_cov_29.930862	1128	1209	176	1	81	0.0123457
NODE_1239_length_2095_cov_29.930862	1128	1209	178	1	81	0.0123457
NODE_1239_length_2095_cov_29.930862	1128	1209	180	1	81	0.0123457
NODE_1239_length_2095_cov_29.930862	1128	1209	181	1	81	0.0123457
NODE_1239_length_2095_cov_29.930862	1128	1209	182	1	81	0.0123457
NODE_1239_length_2095_cov_29.930862	1128	1209	184	1	81	0.0123457
NODE_1239_length_2095_cov_29.930862	1128	1209	185	1	81	0.0123457
NODE_1239_length_2095_cov_29.930862	1128	1209	189	3	81	0.0370370
NODE_1239_length_2095_cov_29.930862	1128	1209	190	1	81	0.0123457
NODE_1239_length_2095_cov_29.930862	1128	1209	192	1	81	0.0123457
NODE_1239_length_2095_cov_29.930862	1128	1209	199	1	81	0.0123457
NODE_1239_length_2095_cov_29.930862	1128	1209	205	1	81	0.0123457
NODE_1239_length_2095_cov_29.930862	1128	1209	211	1	81	0.0123457
NODE_1239_length_2095_cov_29.930862	1128	1209	216	1	81	0.0123457
NODE_1239_length_2095_cov_29.930862	1128	1209	217	1	81	0.0123457
NODE_1239_length_2095_cov_29.930862	1128	1209	218	1	81	0.0123457
NODE_1239_length_2095_cov_29.930862	1128	1209	222	1	81	0.0123457
NODE_1239_length_2095_cov_29.930862	1128	1209	223	1	81	0.0123457
NODE_1239_length_2095_cov_29.930862	1128	1209	224	1	81	0.0123457
NODE_1239_length_2095_cov_29.930862	1128	1209	228	1	81	0.0123457
NODE_1239_length_2095_cov_29.930862	1128	1209	232	1	81	0.0123457
NODE_1239_length_2095_cov_29.930862	1128	1209	233	1	81	0.0123457
NODE_1239_length_2095_cov_29.930862	1128	1209	236	2	81	0.0246914
NODE_1239_length_2095_cov_29.930862	1128	1209	237	1	81	0.0123457
NODE_1239_length_2095_cov_29.930862	1128	1209	238	1	81	0.0123457
NODE_1239_length_2095_cov_29.930862	1128	1209	239	1	81	0.0123457
NODE_1239_length_2095_cov_29.930862	1128	1209	240	1	81	0.0123457
NODE_1239_length_2095_cov_29.930862	1128	1209	243	2	81	0.0246914
NODE_1239_length_2095_cov_29.930862	1128	1209	246	2	81	0.0246914
NODE_1239_length_2095_cov_29.930862	1128	1209	249	1	81	0.0123457
NODE_1239_length_2095_cov_29.930862	1128	1209	255	1	81	0.0123457
NODE_1239_length_2095_cov_29.930862	1128	1209	260	1	81	0.0123457
NODE_1239_length_2095_cov_29.930862	1128	1209	264	1	81	0.0123457
NODE_1239_length_2095_cov_29.930862	1128	1209	267	1	81	0.0123457
NODE_1239_length_2095_cov_29.930862	1128	1209	269	1	81	0.0123457
NODE_1239_length_2095_cov_29.930862	1128	1209	270	1	81	0.0123457
NODE_1239_length_2095_cov_29.930862	1128	1209	273	2	81	0.0246914
NODE_1239_length_2095_cov_29.930862	1128	1209	275	1	81	0.0123457
NODE_1239_length_2095_cov_29.930862	1128	1209	282	1	81	0.0123457
NODE_1239_length_2095_cov_29.930862	1128	1209	284	1	81	0.0123457
NODE_1239_length_2095_cov_29.930862	1128	1209	287	1	81	0.0123457
NODE_1239_length_2095_cov_29.930862	1128	1209	291	1	81	0.0123457
NODE_1239_length_2095_cov_29.930862	1128	1209	296	1	81	0.0123457
NODE_1239_length_2095_cov_29.930862	1128	1209	301	2	81	0.0246914
NODE_1239_length_2095_cov_29.930862	1128	1209	303	1	81	0.0123457
NODE_1239_length_2095_cov_29.930862	1128	1209	313	1	81	0.0123457
NODE_1239_length_2095_cov_29.930862	1128	1209	320	2	81	0.0246914
NODE_1239_length_2095_cov_29.930862	1128	1209	321	2	81	0.0246914
NODE_1239_length_2095_cov_29.930862	1128	1209	323	1	81	0.0123457
NODE_1239_length_2095_cov_29.930862	1128	1209	325	2	81	0.0246914
NODE_1239_length_2095_cov_29.930862	1128	1209	326	2	81	0.0246914
NODE_1239_length_2095_cov_29.930862	1128	1209	331	1	81	0.0123457
NODE_1239_length_2095_cov_29.930862	1128	1209	335	2	81	0.0246914
NODE_1239_length_2095_cov_29.930862	1128	1209	344	1	81	0.0123457
NODE_1239_length_2095_cov_29.930862	1128	1209	346	1	81	0.0123457
NODE_1239_length_2095_cov_29.930862	1204	1258	331	1	54	0.0185185
NODE_1239_length_2095_cov_29.930862	1204	1258	335	2	54	0.0370370
NODE_1239_length_2095_cov_29.930862	1204	1258	344	1	54	0.0185185
NODE_1239_length_2095_cov_29.930862	1204	1258	346	1	54	0.0185185
NODE_1239_length_2095_cov_29.930862	1204	1258	348	2	54	0.0370370
NODE_1239_length_2095_cov_29.930862	1204	1258	349	1	54	0.0185185
NODE_1239_length_2095_cov_29.930862	1204	1258	352	2	54	0.0370370
NODE_1239_length_2095_cov_29.930862	1204	1258	353	2	54	0.0370370
NODE_1239_length_2095_cov_29.930862	1204	1258	354	4	54	0.0740741
NODE_1239_length_2095_cov_29.930862	1204	1258	355	3	54	0.0555556
NODE_1239_length_2095_cov_29.930862	1204	1258	357	1	54	0.0185185
NODE_1239_length_2095_cov_29.930862	1204	1258	358	1	54	0.0185185
NODE_1239_length_2095_cov_29.930862	1204	1258	359	2	54	0.0370370
NODE_1239_length_2095_cov_29.930862	1204	1258	360	2	54	0.0370370
NODE_1239_length_2095_cov_29.930862	1204	1258	361	2	54	0.0370370
NODE_1239_length_2095_cov_29.930862	1204	1258	362	3	54	0.0555556
NODE_1239_length_2095_cov_29.930862	1204	1258	364	1	54	0.0185185
NODE_1239_length_2095_cov_29.930862	1204	1258	365	1	54	0.0185185
NODE_1239_length_2095_cov_29.930862	1204	1258	367	2	54	0.0370370
NODE_1239_length_2095_cov_29.930862	1204	1258	368	4	54	0.0740741
NODE_1239_length_2095_cov_29.930862	1204	1258	369	3	54	0.0555556
NODE_1239_length_2095_cov_29.930862	1204	1258	370	2	54	0.0370370
NODE_1239_length_2095_cov_29.930862	1204	1258	371	1	54	0.0185185
NODE_1239_length_2095_cov_29.930862	1204	1258	372	2	54	0.0370370
NODE_1239_length_2095_cov_29.930862	1204	1258	374	3	54	0.0555556
NODE_1239_length_2095_cov_29.930862	1204	1258	375	5	54	0.0925926
NODE_1251_length_2084_cov_1.720403	959	1039	0	8	80	0.1000000
NODE_1251_length_2084_cov_1.720403	959	1039	2	60	80	0.7500000
NODE_1251_length_2084_cov_1.720403	959	1039	3	12	80	0.1500000
NODE_1251_length_2084_cov_1.720403	1012	1092	0	61	80	0.7625000
NODE_1251_length_2084_cov_1.720403	1012	1092	2	19	80	0.2375000
NODE_1252_length_2083_cov_5.864415	419	499	4	80	80	1.0000000
NODE_1252_length_2083_cov_5.864415	472	552	2	11	80	0.1375000
NODE_1252_length_2083_cov_5.864415	472	552	3	21	80	0.2625000
NODE_1252_length_2083_cov_5.864415	472	552	4	48	80	0.6000000
NODE_1252_length_2083_cov_5.864415	548	628	2	80	80	1.0000000
NODE_1252_length_2083_cov_5.864415	601	681	1	5	80	0.0625000
NODE_1252_length_2083_cov_5.864415	601	681	2	75	80	0.9375000
NODE_1256_length_2078_cov_47.394644	311	391	0	80	80	1.0000000
NODE_1256_length_2078_cov_47.394644	364	444	0	49	80	0.6125000
NODE_1256_length_2078_cov_47.394644	364	444	2	23	80	0.2875000
NODE_1256_length_2078_cov_47.394644	364	444	3	8	80	0.1000000
NODE_1256_length_2078_cov_47.394644	440	520	3	11	80	0.1375000
NODE_1256_length_2078_cov_47.394644	440	520	4	14	80	0.1750000
NODE_1256_length_2078_cov_47.394644	440	520	5	33	80	0.4125000
NODE_1256_length_2078_cov_47.394644	440	520	6	22	80	0.2750000
NODE_1256_length_2078_cov_47.394644	493	573	4	43	80	0.5375000
NODE_1256_length_2078_cov_47.394644	493	573	5	5	80	0.0625000
NODE_1256_length_2078_cov_47.394644	493	573	6	32	80	0.4000000
NODE_1267_length_2067_cov_13.647866	1349	1429	3	11	80	0.1375000
NODE_1267_length_2067_cov_13.647866	1349	1429	4	34	80	0.4250000
NODE_1267_length_2067_cov_13.647866	1349	1429	5	34	80	0.4250000
NODE_1267_length_2067_cov_13.647866	1349	1429	6	1	80	0.0125000
NODE_1267_length_2067_cov_13.647866	1402	1482	3	39	80	0.4875000
NODE_1267_length_2067_cov_13.647866	1402	1482	4	41	80	0.5125000
NODE_1269_length_2066_cov_19.127605	1497	1577	7	5	80	0.0625000
NODE_1269_length_2066_cov_19.127605	1497	1577	8	1	80	0.0125000
NODE_1269_length_2066_cov_19.127605	1497	1577	9	1	80	0.0125000
NODE_1269_length_2066_cov_19.127605	1497	1577	10	6	80	0.0750000
NODE_1269_length_2066_cov_19.127605	1497	1577	11	5	80	0.0625000
NODE_1269_length_2066_cov_19.127605	1497	1577	12	14	80	0.1750000
NODE_1269_length_2066_cov_19.127605	1497	1577	13	30	80	0.3750000
NODE_1269_length_2066_cov_19.127605	1497	1577	14	9	80	0.1125000
NODE_1269_length_2066_cov_19.127605	1497	1577	15	9	80	0.1125000
NODE_1269_length_2066_cov_19.127605	1550	1630	12	15	80	0.1875000
NODE_1269_length_2066_cov_19.127605	1550	1630	13	16	80	0.2000000
NODE_1269_length_2066_cov_19.127605	1550	1630	14	13	80	0.1625000
NODE_1269_length_2066_cov_19.127605	1550	1630	15	31	80	0.3875000
NODE_1269_length_2066_cov_19.127605	1550	1630	16	5	80	0.0625000
NODE_1274_length_2061_cov_43.187054	364	444	3	3	80	0.0375000
NODE_1274_length_2061_cov_43.187054	364	444	4	44	80	0.5500000
NODE_1274_length_2061_cov_43.187054	364	444	5	33	80	0.4125000
NODE_1274_length_2061_cov_43.187054	417	497	4	26	80	0.3250000
NODE_1274_length_2061_cov_43.187054	417	497	5	5	80	0.0625000
NODE_1274_length_2061_cov_43.187054	417	497	6	22	80	0.2750000
NODE_1274_length_2061_cov_43.187054	417	497	7	22	80	0.2750000
NODE_1274_length_2061_cov_43.187054	417	497	8	5	80	0.0625000
NODE_1275_length_2061_cov_3.251784	981	1033	0	30	52	0.5769231
NODE_1275_length_2061_cov_3.251784	981	1033	1	7	52	0.1346154
NODE_1275_length_2061_cov_3.251784	981	1033	2	15	52	0.2884615
NODE_1275_length_2061_cov_3.251784	1006	1086	0	5	80	0.0625000
NODE_1275_length_2061_cov_3.251784	1006	1086	1	7	80	0.0875000
NODE_1275_length_2061_cov_3.251784	1006	1086	2	68	80	0.8500000
NODE_1277_length_2058_cov_4.531394	1844	1875	2	4	31	0.1290323
NODE_1277_length_2058_cov_4.531394	1844	1875	4	1	31	0.0322581
NODE_1277_length_2058_cov_4.531394	1844	1875	7	8	31	0.2580645
NODE_1277_length_2058_cov_4.531394	1844	1875	9	18	31	0.5806451
NODE_1277_length_2058_cov_4.531394	1848	1928	4	1	80	0.0125000
NODE_1277_length_2058_cov_4.531394	1848	1928	7	8	80	0.1000000
NODE_1277_length_2058_cov_4.531394	1848	1928	9	71	80	0.8875000
NODE_1279_length_2056_cov_20.525805	749	829	2	25	80	0.3125000
NODE_1279_length_2056_cov_20.525805	749	829	3	6	80	0.0750000
NODE_1279_length_2056_cov_20.525805	749	829	4	49	80	0.6125000
NODE_1279_length_2056_cov_20.525805	802	882	2	20	80	0.2500000
NODE_1279_length_2056_cov_20.525805	802	882	3	6	80	0.0750000
NODE_1279_length_2056_cov_20.525805	802	882	4	50	80	0.6250000
NODE_1279_length_2056_cov_20.525805	802	882	5	4	80	0.0500000
NODE_1279_length_2056_cov_20.525805	878	958	4	26	80	0.3250000
NODE_1279_length_2056_cov_20.525805	878	958	5	54	80	0.6750000
NODE_1279_length_2056_cov_20.525805	931	1011	1	4	80	0.0500000
NODE_1279_length_2056_cov_20.525805	931	1011	2	12	80	0.1500000
NODE_1279_length_2056_cov_20.525805	931	1011	3	17	80	0.2125000
NODE_1279_length_2056_cov_20.525805	931	1011	4	6	80	0.0750000
NODE_1279_length_2056_cov_20.525805	931	1011	5	41	80	0.5125000
NODE_1281_length_2055_cov_10.047546	1468	1548	2	1	80	0.0125000
NODE_1281_length_2055_cov_10.047546	1468	1548	3	64	80	0.8000000
NODE_1281_length_2055_cov_10.047546	1468	1548	4	15	80	0.1875000
NODE_1281_length_2055_cov_10.047546	1521	1601	2	36	80	0.4500000
NODE_1281_length_2055_cov_10.047546	1521	1601	3	13	80	0.1625000
NODE_1281_length_2055_cov_10.047546	1521	1601	4	31	80	0.3875000
NODE_1286_length_2049_cov_6.846154	270	350	0	80	80	1.0000000
NODE_1286_length_2049_cov_6.846154	323	403	0	80	80	1.0000000
NODE_1286_length_2049_cov_6.846154	1595	1674	1	21	79	0.2658228
NODE_1286_length_2049_cov_6.846154	1595	1674	2	52	79	0.6582279
NODE_1286_length_2049_cov_6.846154	1595	1674	3	6	79	0.0759494
NODE_1286_length_2049_cov_6.846154	1648	1712	0	9	64	0.1406250
NODE_1286_length_2049_cov_6.846154	1648	1712	2	55	64	0.8593750
NODE_1293_length_2045_cov_46.790339	876	956	17	11	80	0.1375000
NODE_1293_length_2045_cov_46.790339	876	956	19	23	80	0.2875000
NODE_1293_length_2045_cov_46.790339	876	956	20	33	80	0.4125000
NODE_1293_length_2045_cov_46.790339	876	956	21	10	80	0.1250000
NODE_1293_length_2045_cov_46.790339	876	956	22	3	80	0.0375000
NODE_1293_length_2045_cov_46.790339	929	1009	11	5	80	0.0625000
NODE_1293_length_2045_cov_46.790339	929	1009	13	29	80	0.3625000
NODE_1293_length_2045_cov_46.790339	929	1009	14	2	80	0.0250000
NODE_1293_length_2045_cov_46.790339	929	1009	15	1	80	0.0125000
NODE_1293_length_2045_cov_46.790339	929	1009	16	2	80	0.0250000
NODE_1293_length_2045_cov_46.790339	929	1009	17	3	80	0.0375000
NODE_1293_length_2045_cov_46.790339	929	1009	19	20	80	0.2500000
NODE_1293_length_2045_cov_46.790339	929	1009	20	9	80	0.1125000
NODE_1293_length_2045_cov_46.790339	929	1009	21	6	80	0.0750000
NODE_1293_length_2045_cov_46.790339	929	1009	22	3	80	0.0375000
NODE_1293_length_2045_cov_46.790339	1005	1085	9	8	80	0.1000000
NODE_1293_length_2045_cov_46.790339	1005	1085	10	6	80	0.0750000
NODE_1293_length_2045_cov_46.790339	1005	1085	11	36	80	0.4500000
NODE_1293_length_2045_cov_46.790339	1005	1085	12	13	80	0.1625000
NODE_1293_length_2045_cov_46.790339	1005	1085	13	17	80	0.2125000
NODE_1293_length_2045_cov_46.790339	1058	1138	9	31	80	0.3875000
NODE_1293_length_2045_cov_46.790339	1058	1138	10	8	80	0.1000000
NODE_1293_length_2045_cov_46.790339	1058	1138	11	2	80	0.0250000
NODE_1293_length_2045_cov_46.790339	1058	1138	12	11	80	0.1375000
NODE_1293_length_2045_cov_46.790339	1058	1138	13	27	80	0.3375000
NODE_1293_length_2045_cov_46.790339	1058	1138	14	1	80	0.0125000
NODE_1298_length_2042_cov_4.447761	241	315	0	74	74	1.0000000
NODE_1301_length_2040_cov_30.109737	1760	1844	165	1	84	0.0119048
NODE_1301_length_2040_cov_30.109737	1760	1844	166	2	84	0.0238095
NODE_1301_length_2040_cov_30.109737	1760	1844	167	2	84	0.0238095
NODE_1301_length_2040_cov_30.109737	1760	1844	168	6	84	0.0714286
NODE_1301_length_2040_cov_30.109737	1760	1844	169	3	84	0.0357143
NODE_1301_length_2040_cov_30.109737	1760	1844	170	6	84	0.0714286
NODE_1301_length_2040_cov_30.109737	1760	1844	171	4	84	0.0476190
NODE_1301_length_2040_cov_30.109737	1760	1844	172	2	84	0.0238095
NODE_1301_length_2040_cov_30.109737	1760	1844	173	7	84	0.0833333
NODE_1301_length_2040_cov_30.109737	1760	1844	174	12	84	0.1428571
NODE_1301_length_2040_cov_30.109737	1760	1844	175	9	84	0.1071429
NODE_1301_length_2040_cov_30.109737	1760	1844	176	9	84	0.1071429
NODE_1301_length_2040_cov_30.109737	1760	1844	177	8	84	0.0952381
NODE_1301_length_2040_cov_30.109737	1760	1844	178	9	84	0.1071429
NODE_1301_length_2040_cov_30.109737	1760	1844	179	4	84	0.0476190
NODE_1306_length_2036_cov_11.672173	369	449	3	10	80	0.1250000
NODE_1306_length_2036_cov_11.672173	369	449	4	61	80	0.7625000
NODE_1306_length_2036_cov_11.672173	369	449	5	9	80	0.1125000
NODE_1306_length_2036_cov_11.672173	422	502	0	1	80	0.0125000
NODE_1306_length_2036_cov_11.672173	422	502	1	15	80	0.1875000
NODE_1306_length_2036_cov_11.672173	422	502	3	18	80	0.2250000
NODE_1306_length_2036_cov_11.672173	422	502	4	46	80	0.5750000
NODE_1312_length_2032_cov_11.188308	416	496	2	61	80	0.7625000
NODE_1312_length_2032_cov_11.188308	416	496	4	7	80	0.0875000
NODE_1312_length_2032_cov_11.188308	416	496	5	12	80	0.1500000
NODE_1312_length_2032_cov_11.188308	469	549	2	8	80	0.1000000
NODE_1312_length_2032_cov_11.188308	469	549	4	28	80	0.3500000
NODE_1312_length_2032_cov_11.188308	469	549	5	44	80	0.5500000
NODE_1318_length_2027_cov_43.702282	1129	1209	1	37	80	0.4625000
NODE_1318_length_2027_cov_43.702282	1129	1209	2	13	80	0.1625000
NODE_1318_length_2027_cov_43.702282	1129	1209	3	7	80	0.0875000
NODE_1318_length_2027_cov_43.702282	1129	1209	4	23	80	0.2875000
NODE_1318_length_2027_cov_43.702282	1182	1262	3	6	80	0.0750000
NODE_1318_length_2027_cov_43.702282	1182	1262	4	65	80	0.8125000
NODE_1318_length_2027_cov_43.702282	1182	1262	5	9	80	0.1125000
NODE_1318_length_2027_cov_43.702282	1258	1338	3	2	80	0.0250000
NODE_1318_length_2027_cov_43.702282	1258	1338	4	7	80	0.0875000
NODE_1318_length_2027_cov_43.702282	1258	1338	5	30	80	0.3750000
NODE_1318_length_2027_cov_43.702282	1258	1338	6	41	80	0.5125000
NODE_1318_length_2027_cov_43.702282	1311	1391	3	55	80	0.6875000
NODE_1318_length_2027_cov_43.702282	1311	1391	4	7	80	0.0875000
NODE_1318_length_2027_cov_43.702282	1311	1391	5	13	80	0.1625000
NODE_1318_length_2027_cov_43.702282	1311	1391	6	5	80	0.0625000
NODE_1319_length_2027_cov_6.558610	229	303	0	74	74	1.0000000
NODE_1319_length_2027_cov_6.558610	229	303	0	74	74	1.0000000
NODE_1319_length_2027_cov_6.558610	276	356	0	79	80	0.9875000
NODE_1319_length_2027_cov_6.558610	276	356	1	1	80	0.0125000
NODE_1320_length_2026_cov_18.457706	688	768	8	11	80	0.1375000
NODE_1320_length_2026_cov_18.457706	688	768	9	2	80	0.0250000
NODE_1320_length_2026_cov_18.457706	688	768	10	34	80	0.4250000
NODE_1320_length_2026_cov_18.457706	688	768	12	33	80	0.4125000
NODE_1320_length_2026_cov_18.457706	741	821	8	21	80	0.2625000
NODE_1320_length_2026_cov_18.457706	741	821	10	8	80	0.1000000
NODE_1320_length_2026_cov_18.457706	741	821	11	4	80	0.0500000
NODE_1320_length_2026_cov_18.457706	741	821	12	42	80	0.5250000
NODE_1320_length_2026_cov_18.457706	741	821	13	5	80	0.0625000
NODE_1324_length_2025_cov_10.711319	617	697	3	6	80	0.0750000
NODE_1324_length_2025_cov_10.711319	617	697	4	46	80	0.5750000
NODE_1324_length_2025_cov_10.711319	617	697	5	1	80	0.0125000
NODE_1324_length_2025_cov_10.711319	617	697	6	1	80	0.0125000
NODE_1324_length_2025_cov_10.711319	617	697	7	26	80	0.3250000
NODE_1324_length_2025_cov_10.711319	712	783	5	17	71	0.2394366
NODE_1324_length_2025_cov_10.711319	712	783	6	54	71	0.7605634
NODE_1324_length_2025_cov_10.711319	756	829	5	50	73	0.6849315
NODE_1324_length_2025_cov_10.711319	756	829	6	13	73	0.1780822
NODE_1324_length_2025_cov_10.711319	756	829	7	7	73	0.0958904
NODE_1324_length_2025_cov_10.711319	756	829	8	3	73	0.0410959
NODE_1325_length_2024_cov_33.891948	1045	1125	2	37	80	0.4625000
NODE_1325_length_2024_cov_33.891948	1045	1125	3	1	80	0.0125000
NODE_1325_length_2024_cov_33.891948	1045	1125	4	42	80	0.5250000
NODE_1325_length_2024_cov_33.891948	1098	1178	2	25	80	0.3125000
NODE_1325_length_2024_cov_33.891948	1098	1178	4	55	80	0.6875000
NODE_1331_length_2018_cov_33.742053	1215	1295	180	1	80	0.0125000
NODE_1331_length_2018_cov_33.742053	1215	1295	181	3	80	0.0375000
NODE_1331_length_2018_cov_33.742053	1215	1295	182	1	80	0.0125000
NODE_1331_length_2018_cov_33.742053	1215	1295	183	2	80	0.0250000
NODE_1331_length_2018_cov_33.742053	1215	1295	184	10	80	0.1250000
NODE_1331_length_2018_cov_33.742053	1215	1295	185	7	80	0.0875000
NODE_1331_length_2018_cov_33.742053	1215	1295	186	2	80	0.0250000
NODE_1331_length_2018_cov_33.742053	1215	1295	187	1	80	0.0125000
NODE_1331_length_2018_cov_33.742053	1215	1295	188	1	80	0.0125000
NODE_1331_length_2018_cov_33.742053	1215	1295	190	4	80	0.0500000
NODE_1331_length_2018_cov_33.742053	1215	1295	191	2	80	0.0250000
NODE_1331_length_2018_cov_33.742053	1215	1295	192	1	80	0.0125000
NODE_1331_length_2018_cov_33.742053	1215	1295	193	3	80	0.0375000
NODE_1331_length_2018_cov_33.742053	1215	1295	194	10	80	0.1250000
NODE_1331_length_2018_cov_33.742053	1215	1295	195	4	80	0.0500000
NODE_1331_length_2018_cov_33.742053	1215	1295	196	3	80	0.0375000
NODE_1331_length_2018_cov_33.742053	1215	1295	197	5	80	0.0625000
NODE_1331_length_2018_cov_33.742053	1215	1295	198	8	80	0.1000000
NODE_1331_length_2018_cov_33.742053	1215	1295	199	2	80	0.0250000
NODE_1331_length_2018_cov_33.742053	1215	1295	200	4	80	0.0500000
NODE_1331_length_2018_cov_33.742053	1215	1295	203	2	80	0.0250000
NODE_1331_length_2018_cov_33.742053	1215	1295	204	1	80	0.0125000
NODE_1331_length_2018_cov_33.742053	1215	1295	205	3	80	0.0375000
NODE_1331_length_2018_cov_33.742053	1268	1298	171	1	30	0.0333333
NODE_1331_length_2018_cov_33.742053	1268	1298	174	1	30	0.0333333
NODE_1331_length_2018_cov_33.742053	1268	1298	177	1	30	0.0333333
NODE_1331_length_2018_cov_33.742053	1268	1298	180	1	30	0.0333333
NODE_1331_length_2018_cov_33.742053	1268	1298	181	3	30	0.1000000
NODE_1331_length_2018_cov_33.742053	1268	1298	182	1	30	0.0333333
NODE_1331_length_2018_cov_33.742053	1268	1298	183	2	30	0.0666667
NODE_1331_length_2018_cov_33.742053	1268	1298	184	10	30	0.3333333
NODE_1331_length_2018_cov_33.742053	1268	1298	185	7	30	0.2333333
NODE_1331_length_2018_cov_33.742053	1268	1298	186	2	30	0.0666667
NODE_1331_length_2018_cov_33.742053	1268	1298	188	1	30	0.0333333
NODE_1331_length_2018_cov_33.742053	1876	1942	94	2	66	0.0303030
NODE_1331_length_2018_cov_33.742053	1876	1942	96	1	66	0.0151515
NODE_1331_length_2018_cov_33.742053	1876	1942	98	1	66	0.0151515
NODE_1331_length_2018_cov_33.742053	1876	1942	100	1	66	0.0151515
NODE_1331_length_2018_cov_33.742053	1876	1942	103	2	66	0.0303030
NODE_1331_length_2018_cov_33.742053	1876	1942	104	2	66	0.0303030
NODE_1331_length_2018_cov_33.742053	1876	1942	109	1	66	0.0151515
NODE_1331_length_2018_cov_33.742053	1876	1942	110	1	66	0.0151515
NODE_1331_length_2018_cov_33.742053	1876	1942	114	2	66	0.0303030
NODE_1331_length_2018_cov_33.742053	1876	1942	115	2	66	0.0303030
NODE_1331_length_2018_cov_33.742053	1876	1942	116	2	66	0.0303030
NODE_1331_length_2018_cov_33.742053	1876	1942	118	1	66	0.0151515
NODE_1331_length_2018_cov_33.742053	1876	1942	119	2	66	0.0303030
NODE_1331_length_2018_cov_33.742053	1876	1942	122	1	66	0.0151515
NODE_1331_length_2018_cov_33.742053	1876	1942	123	2	66	0.0303030
NODE_1331_length_2018_cov_33.742053	1876	1942	124	3	66	0.0454545
NODE_1331_length_2018_cov_33.742053	1876	1942	125	1	66	0.0151515
NODE_1331_length_2018_cov_33.742053	1876	1942	127	1	66	0.0151515
NODE_1331_length_2018_cov_33.742053	1876	1942	128	2	66	0.0303030
NODE_1331_length_2018_cov_33.742053	1876	1942	130	3	66	0.0454545
NODE_1331_length_2018_cov_33.742053	1876	1942	131	1	66	0.0151515
NODE_1331_length_2018_cov_33.742053	1876	1942	132	1	66	0.0151515
NODE_1331_length_2018_cov_33.742053	1876	1942	135	1	66	0.0151515
NODE_1331_length_2018_cov_33.742053	1876	1942	137	1	66	0.0151515
NODE_1331_length_2018_cov_33.742053	1876	1942	139	1	66	0.0151515
NODE_1331_length_2018_cov_33.742053	1876	1942	140	1	66	0.0151515
NODE_1331_length_2018_cov_33.742053	1876	1942	141	3	66	0.0454545
NODE_1331_length_2018_cov_33.742053	1876	1942	144	1	66	0.0151515
NODE_1331_length_2018_cov_33.742053	1876	1942	145	1	66	0.0151515
NODE_1331_length_2018_cov_33.742053	1876	1942	146	1	66	0.0151515
NODE_1331_length_2018_cov_33.742053	1876	1942	150	2	66	0.0303030
NODE_1331_length_2018_cov_33.742053	1876	1942	152	3	66	0.0454545
NODE_1331_length_2018_cov_33.742053	1876	1942	153	1	66	0.0151515
NODE_1331_length_2018_cov_33.742053	1876	1942	158	1	66	0.0151515
NODE_1331_length_2018_cov_33.742053	1876	1942	159	2	66	0.0303030
NODE_1331_length_2018_cov_33.742053	1876	1942	161	1	66	0.0151515
NODE_1331_length_2018_cov_33.742053	1876	1942	163	3	66	0.0454545
NODE_1331_length_2018_cov_33.742053	1876	1942	164	2	66	0.0303030
NODE_1331_length_2018_cov_33.742053	1876	1942	165	1	66	0.0151515
NODE_1331_length_2018_cov_33.742053	1876	1942	169	1	66	0.0151515
NODE_1331_length_2018_cov_33.742053	1876	1942	171	1	66	0.0151515
NODE_1331_length_2018_cov_33.742053	1876	1942	173	2	66	0.0303030
NODE_1331_length_2018_cov_33.742053	1876	1942	175	1	66	0.0151515
NODE_1331_length_2018_cov_33.742053	1915	1995	19	4	80	0.0500000
NODE_1331_length_2018_cov_33.742053	1915	1995	31	1	80	0.0125000
NODE_1331_length_2018_cov_33.742053	1915	1995	34	1	80	0.0125000
NODE_1331_length_2018_cov_33.742053	1915	1995	37	3	80	0.0375000
NODE_1331_length_2018_cov_33.742053	1915	1995	41	1	80	0.0125000
NODE_1331_length_2018_cov_33.742053	1915	1995	44	1	80	0.0125000
NODE_1331_length_2018_cov_33.742053	1915	1995	47	1	80	0.0125000
NODE_1331_length_2018_cov_33.742053	1915	1995	48	1	80	0.0125000
NODE_1331_length_2018_cov_33.742053	1915	1995	51	1	80	0.0125000
NODE_1331_length_2018_cov_33.742053	1915	1995	53	1	80	0.0125000
NODE_1331_length_2018_cov_33.742053	1915	1995	54	3	80	0.0375000
NODE_1331_length_2018_cov_33.742053	1915	1995	55	1	80	0.0125000
NODE_1331_length_2018_cov_33.742053	1915	1995	60	1	80	0.0125000
NODE_1331_length_2018_cov_33.742053	1915	1995	61	1	80	0.0125000
NODE_1331_length_2018_cov_33.742053	1915	1995	64	1	80	0.0125000
NODE_1331_length_2018_cov_33.742053	1915	1995	66	1	80	0.0125000
NODE_1331_length_2018_cov_33.742053	1915	1995	67	4	80	0.0500000
NODE_1331_length_2018_cov_33.742053	1915	1995	68	4	80	0.0500000
NODE_1331_length_2018_cov_33.742053	1915	1995	70	1	80	0.0125000
NODE_1331_length_2018_cov_33.742053	1915	1995	71	2	80	0.0250000
NODE_1331_length_2018_cov_33.742053	1915	1995	74	1	80	0.0125000
NODE_1331_length_2018_cov_33.742053	1915	1995	76	1	80	0.0125000
NODE_1331_length_2018_cov_33.742053	1915	1995	78	2	80	0.0250000
NODE_1331_length_2018_cov_33.742053	1915	1995	80	1	80	0.0125000
NODE_1331_length_2018_cov_33.742053	1915	1995	82	2	80	0.0250000
NODE_1331_length_2018_cov_33.742053	1915	1995	84	1	80	0.0125000
NODE_1331_length_2018_cov_33.742053	1915	1995	85	2	80	0.0250000
NODE_1331_length_2018_cov_33.742053	1915	1995	86	4	80	0.0500000
NODE_1331_length_2018_cov_33.742053	1915	1995	87	2	80	0.0250000
NODE_1331_length_2018_cov_33.742053	1915	1995	91	1	80	0.0125000
NODE_1331_length_2018_cov_33.742053	1915	1995	92	2	80	0.0250000
NODE_1331_length_2018_cov_33.742053	1915	1995	94	2	80	0.0250000
NODE_1331_length_2018_cov_33.742053	1915	1995	96	1	80	0.0125000
NODE_1331_length_2018_cov_33.742053	1915	1995	98	1	80	0.0125000
NODE_1331_length_2018_cov_33.742053	1915	1995	100	1	80	0.0125000
NODE_1331_length_2018_cov_33.742053	1915	1995	103	2	80	0.0250000
NODE_1331_length_2018_cov_33.742053	1915	1995	104	2	80	0.0250000
NODE_1331_length_2018_cov_33.742053	1915	1995	109	1	80	0.0125000
NODE_1331_length_2018_cov_33.742053	1915	1995	110	1	80	0.0125000
NODE_1331_length_2018_cov_33.742053	1915	1995	114	2	80	0.0250000
NODE_1331_length_2018_cov_33.742053	1915	1995	115	2	80	0.0250000
NODE_1331_length_2018_cov_33.742053	1915	1995	116	2	80	0.0250000
NODE_1331_length_2018_cov_33.742053	1915	1995	118	1	80	0.0125000
NODE_1331_length_2018_cov_33.742053	1915	1995	119	2	80	0.0250000
NODE_1331_length_2018_cov_33.742053	1915	1995	122	1	80	0.0125000
NODE_1331_length_2018_cov_33.742053	1915	1995	123	2	80	0.0250000
NODE_1331_length_2018_cov_33.742053	1915	1995	124	3	80	0.0375000
NODE_1331_length_2018_cov_33.742053	1915	1995	125	1	80	0.0125000
NODE_1337_length_2011_cov_22.430439	434	514	1	6	80	0.0750000
NODE_1337_length_2011_cov_22.430439	434	514	2	74	80	0.9250000
NODE_1337_length_2011_cov_22.430439	487	567	2	49	80	0.6125000
NODE_1337_length_2011_cov_22.430439	487	567	3	31	80	0.3875000
NODE_1337_length_2011_cov_22.430439	1124	1204	2	42	80	0.5250000
NODE_1337_length_2011_cov_22.430439	1124	1204	3	38	80	0.4750000
NODE_1337_length_2011_cov_22.430439	1177	1257	2	24	80	0.3000000
NODE_1337_length_2011_cov_22.430439	1177	1257	3	56	80	0.7000000
NODE_1343_length_2001_cov_10.416404	692	772	1	35	80	0.4375000
NODE_1343_length_2001_cov_10.416404	692	772	2	45	80	0.5625000
NODE_1343_length_2001_cov_10.416404	745	825	0	9	80	0.1125000
NODE_1343_length_2001_cov_10.416404	745	825	1	71	80	0.8875000
NODE_1350_length_1991_cov_112.926533	212	292	176	1	80	0.0125000
NODE_1350_length_1991_cov_112.926533	212	292	177	1	80	0.0125000
NODE_1350_length_1991_cov_112.926533	212	292	178	1	80	0.0125000
NODE_1350_length_1991_cov_112.926533	212	292	180	1	80	0.0125000
NODE_1350_length_1991_cov_112.926533	212	292	182	1	80	0.0125000
NODE_1350_length_1991_cov_112.926533	212	292	186	2	80	0.0250000
NODE_1350_length_1991_cov_112.926533	212	292	187	1	80	0.0125000
NODE_1350_length_1991_cov_112.926533	212	292	188	4	80	0.0500000
NODE_1350_length_1991_cov_112.926533	212	292	189	1	80	0.0125000
NODE_1350_length_1991_cov_112.926533	212	292	192	2	80	0.0250000
NODE_1350_length_1991_cov_112.926533	212	292	197	1	80	0.0125000
NODE_1350_length_1991_cov_112.926533	212	292	198	2	80	0.0250000
NODE_1350_length_1991_cov_112.926533	212	292	199	1	80	0.0125000
NODE_1350_length_1991_cov_112.926533	212	292	200	3	80	0.0375000
NODE_1350_length_1991_cov_112.926533	212	292	201	3	80	0.0375000
NODE_1350_length_1991_cov_112.926533	212	292	203	1	80	0.0125000
NODE_1350_length_1991_cov_112.926533	212	292	206	1	80	0.0125000
NODE_1350_length_1991_cov_112.926533	212	292	207	1	80	0.0125000
NODE_1350_length_1991_cov_112.926533	212	292	208	1	80	0.0125000
NODE_1350_length_1991_cov_112.926533	212	292	209	2	80	0.0250000
NODE_1350_length_1991_cov_112.926533	212	292	210	1	80	0.0125000
NODE_1350_length_1991_cov_112.926533	212	292	211	1	80	0.0125000
NODE_1350_length_1991_cov_112.926533	212	292	212	2	80	0.0250000
NODE_1350_length_1991_cov_112.926533	212	292	214	3	80	0.0375000
NODE_1350_length_1991_cov_112.926533	212	292	215	1	80	0.0125000
NODE_1350_length_1991_cov_112.926533	212	292	216	1	80	0.0125000
NODE_1350_length_1991_cov_112.926533	212	292	217	1	80	0.0125000
NODE_1350_length_1991_cov_112.926533	212	292	218	3	80	0.0375000
NODE_1350_length_1991_cov_112.926533	212	292	219	3	80	0.0375000
NODE_1350_length_1991_cov_112.926533	212	292	220	1	80	0.0125000
NODE_1350_length_1991_cov_112.926533	212	292	221	1	80	0.0125000
NODE_1350_length_1991_cov_112.926533	212	292	222	2	80	0.0250000
NODE_1350_length_1991_cov_112.926533	212	292	223	2	80	0.0250000
NODE_1350_length_1991_cov_112.926533	212	292	224	2	80	0.0250000
NODE_1350_length_1991_cov_112.926533	212	292	225	6	80	0.0750000
NODE_1350_length_1991_cov_112.926533	212	292	226	1	80	0.0125000
NODE_1350_length_1991_cov_112.926533	212	292	227	2	80	0.0250000
NODE_1350_length_1991_cov_112.926533	212	292	228	9	80	0.1125000
NODE_1350_length_1991_cov_112.926533	212	292	229	2	80	0.0250000
NODE_1350_length_1991_cov_112.926533	212	292	230	4	80	0.0500000
NODE_1350_length_1991_cov_112.926533	212	292	231	1	80	0.0125000
NODE_1352_length_1988_cov_13.736368	865	945	3	6	80	0.0750000
NODE_1352_length_1988_cov_13.736368	865	945	4	19	80	0.2375000
NODE_1352_length_1988_cov_13.736368	865	945	5	19	80	0.2375000
NODE_1352_length_1988_cov_13.736368	865	945	6	36	80	0.4500000
NODE_1352_length_1988_cov_13.736368	918	998	3	46	80	0.5750000
NODE_1352_length_1988_cov_13.736368	918	998	4	19	80	0.2375000
NODE_1352_length_1988_cov_13.736368	918	998	5	12	80	0.1500000
NODE_1352_length_1988_cov_13.736368	918	998	6	3	80	0.0375000
NODE_1353_length_1988_cov_9.980413	1616	1696	0	5	80	0.0625000
NODE_1353_length_1988_cov_9.980413	1616	1696	2	75	80	0.9375000
NODE_1353_length_1988_cov_9.980413	1669	1749	0	58	80	0.7250000
NODE_1353_length_1988_cov_9.980413	1669	1749	2	22	80	0.2750000
NODE_1356_length_1983_cov_17.332803	494	574	0	8	80	0.1000000
NODE_1356_length_1983_cov_17.332803	494	574	1	26	80	0.3250000
NODE_1356_length_1983_cov_17.332803	494	574	2	46	80	0.5750000
NODE_1356_length_1983_cov_17.332803	547	627	2	64	80	0.8000000
NODE_1356_length_1983_cov_17.332803	547	627	3	16	80	0.2000000
NODE_1356_length_1983_cov_17.332803	1600	1680	0	38	80	0.4750000
NODE_1356_length_1983_cov_17.332803	1600	1680	1	37	80	0.4625000
NODE_1356_length_1983_cov_17.332803	1600	1680	2	5	80	0.0625000
NODE_1356_length_1983_cov_17.332803	1653	1733	1	22	80	0.2750000
NODE_1356_length_1983_cov_17.332803	1653	1733	2	58	80	0.7250000
NODE_1359_length_1982_cov_17.164100	457	537	0	80	80	1.0000000
NODE_1359_length_1982_cov_17.164100	510	590	0	80	80	1.0000000
NODE_1359_length_1982_cov_17.164100	586	666	0	80	80	1.0000000
NODE_1359_length_1982_cov_17.164100	639	723	0	84	84	1.0000000
NODE_1360_length_1981_cov_46.444208	0	70	2	6	70	0.0857143
NODE_1360_length_1981_cov_46.444208	0	70	3	23	70	0.3285714
NODE_1360_length_1981_cov_46.444208	0	70	4	2	70	0.0285714
NODE_1360_length_1981_cov_46.444208	0	70	5	16	70	0.2285714
NODE_1360_length_1981_cov_46.444208	0	70	6	2	70	0.0285714
NODE_1360_length_1981_cov_46.444208	0	70	7	9	70	0.1285714
NODE_1360_length_1981_cov_46.444208	0	70	8	1	70	0.0142857
NODE_1360_length_1981_cov_46.444208	0	70	9	3	70	0.0428571
NODE_1360_length_1981_cov_46.444208	0	70	10	5	70	0.0714286
NODE_1360_length_1981_cov_46.444208	0	70	12	1	70	0.0142857
NODE_1360_length_1981_cov_46.444208	0	70	13	2	70	0.0285714
NODE_1362_length_1979_cov_1.630851	1554	1634	0	80	80	1.0000000
NODE_1364_length_1976_cov_1.959510	154	215	2	7	61	0.1147541
NODE_1364_length_1976_cov_1.959510	154	215	3	54	61	0.8852459
NODE_1364_length_1976_cov_1.959510	154	215	2	7	61	0.1147541
NODE_1364_length_1976_cov_1.959510	154	215	3	54	61	0.8852459
NODE_1364_length_1976_cov_1.959510	154	213	2	5	59	0.0847458
NODE_1364_length_1976_cov_1.959510	154	213	3	54	59	0.9152542
NODE_1365_length_1974_cov_8.058133	617	697	8	19	80	0.2375000
NODE_1365_length_1974_cov_8.058133	617	697	9	8	80	0.1000000
NODE_1365_length_1974_cov_8.058133	617	697	10	4	80	0.0500000
NODE_1365_length_1974_cov_8.058133	617	697	11	5	80	0.0625000
NODE_1365_length_1974_cov_8.058133	617	697	12	22	80	0.2750000
NODE_1365_length_1974_cov_8.058133	617	697	13	7	80	0.0875000
NODE_1365_length_1974_cov_8.058133	617	697	14	15	80	0.1875000
NODE_1365_length_1974_cov_8.058133	670	750	9	9	80	0.1125000
NODE_1365_length_1974_cov_8.058133	670	750	10	10	80	0.1250000
NODE_1365_length_1974_cov_8.058133	670	750	11	26	80	0.3250000
NODE_1365_length_1974_cov_8.058133	670	750	12	24	80	0.3000000
NODE_1365_length_1974_cov_8.058133	670	750	13	7	80	0.0875000
NODE_1365_length_1974_cov_8.058133	670	750	14	4	80	0.0500000
NODE_1366_length_1973_cov_14.885272	640	726	1	3	86	0.0348837
NODE_1366_length_1973_cov_14.885272	640	726	2	4	86	0.0465116
NODE_1366_length_1973_cov_14.885272	640	726	4	36	86	0.4186046
NODE_1366_length_1973_cov_14.885272	640	726	5	7	86	0.0813954
NODE_1366_length_1973_cov_14.885272	640	726	6	36	86	0.4186046
NODE_1366_length_1973_cov_14.885272	699	779	6	27	80	0.3375000
NODE_1366_length_1973_cov_14.885272	699	779	7	45	80	0.5625000
NODE_1366_length_1973_cov_14.885272	699	779	8	8	80	0.1000000
NODE_1366_length_1973_cov_14.885272	1389	1469	3	38	80	0.4750000
NODE_1366_length_1973_cov_14.885272	1389	1469	4	24	80	0.3000000
NODE_1366_length_1973_cov_14.885272	1389	1469	5	18	80	0.2250000
NODE_1366_length_1973_cov_14.885272	1442	1522	3	24	80	0.3000000
NODE_1366_length_1973_cov_14.885272	1442	1522	4	56	80	0.7000000
NODE_1372_length_1971_cov_3.126068	1662	1742	6	13	80	0.1625000
NODE_1372_length_1971_cov_3.126068	1662	1742	8	27	80	0.3375000
NODE_1372_length_1971_cov_3.126068	1662	1742	9	6	80	0.0750000
NODE_1372_length_1971_cov_3.126068	1662	1742	10	17	80	0.2125000
NODE_1372_length_1971_cov_3.126068	1662	1742	12	15	80	0.1875000
NODE_1372_length_1971_cov_3.126068	1662	1742	13	2	80	0.0250000
NODE_1372_length_1971_cov_3.126068	1715	1799	10	10	84	0.1190476
NODE_1372_length_1971_cov_3.126068	1715	1799	12	15	84	0.1785714
NODE_1372_length_1971_cov_3.126068	1715	1799	13	2	84	0.0238095
NODE_1372_length_1971_cov_3.126068	1715	1799	15	12	84	0.1428571
NODE_1372_length_1971_cov_3.126068	1715	1799	16	9	84	0.1071429
NODE_1372_length_1971_cov_3.126068	1715	1799	17	16	84	0.1904762
NODE_1372_length_1971_cov_3.126068	1715	1799	18	4	84	0.0476190
NODE_1372_length_1971_cov_3.126068	1715	1799	19	2	84	0.0238095
NODE_1372_length_1971_cov_3.126068	1715	1799	20	14	84	0.1666667
NODE_1386_length_1962_cov_23.774557	281	311	2	9	30	0.3000000
NODE_1386_length_1962_cov_23.774557	281	311	3	21	30	0.7000000
NODE_1386_length_1962_cov_23.774557	329	355	4	10	26	0.3846154
NODE_1386_length_1962_cov_23.774557	329	355	5	3	26	0.1153846
NODE_1386_length_1962_cov_23.774557	329	355	6	8	26	0.3076923
NODE_1386_length_1962_cov_23.774557	329	355	7	5	26	0.1923077
NODE_1386_length_1962_cov_23.774557	408	487	3	2	79	0.0253165
NODE_1386_length_1962_cov_23.774557	408	487	4	8	79	0.1012658
NODE_1386_length_1962_cov_23.774557	408	487	6	12	79	0.1518987
NODE_1386_length_1962_cov_23.774557	408	487	7	33	79	0.4177215
NODE_1386_length_1962_cov_23.774557	408	487	8	24	79	0.3037975
NODE_1386_length_1962_cov_23.774557	460	540	2	4	80	0.0500000
NODE_1386_length_1962_cov_23.774557	460	540	3	51	80	0.6375000
NODE_1386_length_1962_cov_23.774557	460	540	4	8	80	0.1000000
NODE_1386_length_1962_cov_23.774557	460	540	6	12	80	0.1500000
NODE_1386_length_1962_cov_23.774557	460	540	7	5	80	0.0625000
NODE_1386_length_1962_cov_23.774557	1417	1497	0	80	80	1.0000000
NODE_1386_length_1962_cov_23.774557	1470	1550	0	80	80	1.0000000
NODE_1386_length_1962_cov_23.774557	1607	1640	0	33	33	1.0000000
NODE_1395_length_1953_cov_26.183927	1	81	0	17	80	0.2125000
NODE_1395_length_1953_cov_26.183927	1	81	2	30	80	0.3750000
NODE_1395_length_1953_cov_26.183927	1	81	3	33	80	0.4125000
NODE_1395_length_1953_cov_26.183927	6	28	0	12	22	0.5454546
NODE_1395_length_1953_cov_26.183927	6	28	2	10	22	0.4545455
NODE_1395_length_1953_cov_26.183927	152	232	1	34	80	0.4250000
NODE_1395_length_1953_cov_26.183927	152	232	2	46	80	0.5750000
NODE_1395_length_1953_cov_26.183927	205	257	0	9	52	0.1730769
NODE_1395_length_1953_cov_26.183927	205	257	1	40	52	0.7692308
NODE_1395_length_1953_cov_26.183927	205	257	2	1	52	0.0192308
NODE_1395_length_1953_cov_26.183927	205	257	8	1	52	0.0192308
NODE_1395_length_1953_cov_26.183927	205	257	18	1	52	0.0192308
NODE_1405_length_1943_cov_11.218547	516	596	0	80	80	1.0000000
NODE_1405_length_1943_cov_11.218547	569	649	0	35	80	0.4375000
NODE_1405_length_1943_cov_11.218547	569	649	1	45	80	0.5625000
NODE_1408_length_1941_cov_14.407709	891	921	2	13	30	0.4333333
NODE_1408_length_1941_cov_14.407709	891	921	3	17	30	0.5666667
NODE_1408_length_1941_cov_14.407709	894	964	2	10	70	0.1428571
NODE_1408_length_1941_cov_14.407709	894	964	3	54	70	0.7714286
NODE_1408_length_1941_cov_14.407709	894	964	4	6	70	0.0857143
NODE_1408_length_1941_cov_14.407709	1878	1941	0	63	63	1.0000000
NODE_1409_length_1941_cov_9.632465	139	213	14	11	74	0.1486486
NODE_1409_length_1941_cov_9.632465	139	213	15	7	74	0.0945946
NODE_1409_length_1941_cov_9.632465	139	213	17	14	74	0.1891892
NODE_1409_length_1941_cov_9.632465	139	213	19	13	74	0.1756757
NODE_1409_length_1941_cov_9.632465	139	213	21	6	74	0.0810811
NODE_1409_length_1941_cov_9.632465	139	213	24	1	74	0.0135135
NODE_1409_length_1941_cov_9.632465	139	213	26	6	74	0.0810811
NODE_1409_length_1941_cov_9.632465	139	213	27	12	74	0.1621622
NODE_1409_length_1941_cov_9.632465	139	213	30	2	74	0.0270270
NODE_1409_length_1941_cov_9.632465	139	213	31	2	74	0.0270270
NODE_1409_length_1941_cov_9.632465	139	219	14	11	80	0.1375000
NODE_1409_length_1941_cov_9.632465	139	219	15	7	80	0.0875000
NODE_1409_length_1941_cov_9.632465	139	219	17	14	80	0.1750000
NODE_1409_length_1941_cov_9.632465	139	219	19	13	80	0.1625000
NODE_1409_length_1941_cov_9.632465	139	219	21	6	80	0.0750000
NODE_1409_length_1941_cov_9.632465	139	219	24	1	80	0.0125000
NODE_1409_length_1941_cov_9.632465	139	219	26	6	80	0.0750000
NODE_1409_length_1941_cov_9.632465	139	219	27	12	80	0.1500000
NODE_1409_length_1941_cov_9.632465	139	219	30	8	80	0.1000000
NODE_1409_length_1941_cov_9.632465	139	219	31	2	80	0.0250000
NODE_1409_length_1941_cov_9.632465	139	194	14	11	55	0.2000000
NODE_1409_length_1941_cov_9.632465	139	194	15	7	55	0.1272727
NODE_1409_length_1941_cov_9.632465	139	194	17	14	55	0.2545455
NODE_1409_length_1941_cov_9.632465	139	194	19	13	55	0.2363636
NODE_1409_length_1941_cov_9.632465	139	194	21	6	55	0.1090909
NODE_1409_length_1941_cov_9.632465	139	194	24	1	55	0.0181818
NODE_1409_length_1941_cov_9.632465	139	194	26	3	55	0.0545455
NODE_1409_length_1941_cov_9.632465	192	272	19	1	80	0.0125000
NODE_1409_length_1941_cov_9.632465	192	272	24	8	80	0.1000000
NODE_1409_length_1941_cov_9.632465	192	272	25	6	80	0.0750000
NODE_1409_length_1941_cov_9.632465	192	272	26	10	80	0.1250000
NODE_1409_length_1941_cov_9.632465	192	272	27	20	80	0.2500000
NODE_1409_length_1941_cov_9.632465	192	272	28	6	80	0.0750000
NODE_1409_length_1941_cov_9.632465	192	272	29	7	80	0.0875000
NODE_1409_length_1941_cov_9.632465	192	272	30	20	80	0.2500000
NODE_1409_length_1941_cov_9.632465	192	272	31	2	80	0.0250000
NODE_1414_length_1936_cov_13.338596	679	759	0	43	80	0.5375000
NODE_1414_length_1936_cov_13.338596	679	759	2	37	80	0.4625000
NODE_1414_length_1936_cov_13.338596	732	812	0	80	80	1.0000000
NODE_1414_length_1936_cov_13.338596	738	812	0	74	74	1.0000000
NODE_1414_length_1936_cov_13.338596	738	759	0	21	21	1.0000000
NODE_1415_length_1936_cov_12.592814	102	153	0	51	51	1.0000000
NODE_1415_length_1936_cov_12.592814	154	230	3	5	76	0.0657895
NODE_1415_length_1936_cov_12.592814	154	230	6	1	76	0.0131579
NODE_1415_length_1936_cov_12.592814	154	230	9	6	76	0.0789474
NODE_1415_length_1936_cov_12.592814	154	230	10	33	76	0.4342105
NODE_1415_length_1936_cov_12.592814	154	230	11	2	76	0.0263158
NODE_1415_length_1936_cov_12.592814	154	230	12	23	76	0.3026316
NODE_1415_length_1936_cov_12.592814	154	230	13	6	76	0.0789474
NODE_1415_length_1936_cov_12.592814	211	251	11	11	40	0.2750000
NODE_1415_length_1936_cov_12.592814	211	251	12	13	40	0.3250000
NODE_1415_length_1936_cov_12.592814	211	251	13	16	40	0.4000000
NODE_1416_length_1933_cov_86.724646	1044	1124	12	12	80	0.1500000
NODE_1416_length_1933_cov_86.724646	1044	1124	13	5	80	0.0625000
NODE_1416_length_1933_cov_86.724646	1044	1124	14	5	80	0.0625000
NODE_1416_length_1933_cov_86.724646	1044	1124	15	4	80	0.0500000
NODE_1416_length_1933_cov_86.724646	1044	1124	16	12	80	0.1500000
NODE_1416_length_1933_cov_86.724646	1044	1124	17	3	80	0.0375000
NODE_1416_length_1933_cov_86.724646	1044	1124	18	1	80	0.0125000
NODE_1416_length_1933_cov_86.724646	1044	1124	20	5	80	0.0625000
NODE_1416_length_1933_cov_86.724646	1044	1124	22	9	80	0.1125000
NODE_1416_length_1933_cov_86.724646	1044	1124	23	6	80	0.0750000
NODE_1416_length_1933_cov_86.724646	1044	1124	24	1	80	0.0125000
NODE_1416_length_1933_cov_86.724646	1044	1124	25	9	80	0.1125000
NODE_1416_length_1933_cov_86.724646	1044	1124	26	5	80	0.0625000
NODE_1416_length_1933_cov_86.724646	1044	1124	27	3	80	0.0375000
NODE_1416_length_1933_cov_86.724646	1097	1177	22	3	80	0.0375000
NODE_1416_length_1933_cov_86.724646	1097	1177	23	6	80	0.0750000
NODE_1416_length_1933_cov_86.724646	1097	1177	24	1	80	0.0125000
NODE_1416_length_1933_cov_86.724646	1097	1177	25	9	80	0.1125000
NODE_1416_length_1933_cov_86.724646	1097	1177	26	5	80	0.0625000
NODE_1416_length_1933_cov_86.724646	1097	1177	27	5	80	0.0625000
NODE_1416_length_1933_cov_86.724646	1097	1177	28	5	80	0.0625000
NODE_1416_length_1933_cov_86.724646	1097	1177	29	20	80	0.2500000
NODE_1416_length_1933_cov_86.724646	1097	1177	30	12	80	0.1500000
NODE_1416_length_1933_cov_86.724646	1097	1177	31	12	80	0.1500000
NODE_1416_length_1933_cov_86.724646	1097	1177	32	2	80	0.0250000
NODE_1416_length_1933_cov_86.724646	1173	1253	17	4	80	0.0500000
NODE_1416_length_1933_cov_86.724646	1173	1253	18	8	80	0.1000000
NODE_1416_length_1933_cov_86.724646	1173	1253	20	6	80	0.0750000
NODE_1416_length_1933_cov_86.724646	1173	1253	21	3	80	0.0375000
NODE_1416_length_1933_cov_86.724646	1173	1253	22	6	80	0.0750000
NODE_1416_length_1933_cov_86.724646	1173	1253	23	7	80	0.0875000
NODE_1416_length_1933_cov_86.724646	1173	1253	24	6	80	0.0750000
NODE_1416_length_1933_cov_86.724646	1173	1253	25	14	80	0.1750000
NODE_1416_length_1933_cov_86.724646	1173	1253	26	10	80	0.1250000
NODE_1416_length_1933_cov_86.724646	1173	1253	27	10	80	0.1250000
NODE_1416_length_1933_cov_86.724646	1173	1253	28	6	80	0.0750000
NODE_1416_length_1933_cov_86.724646	1226	1306	8	11	80	0.1375000
NODE_1416_length_1933_cov_86.724646	1226	1306	9	2	80	0.0250000
NODE_1416_length_1933_cov_86.724646	1226	1306	10	1	80	0.0125000
NODE_1416_length_1933_cov_86.724646	1226	1306	11	15	80	0.1875000
NODE_1416_length_1933_cov_86.724646	1226	1306	12	1	80	0.0125000
NODE_1416_length_1933_cov_86.724646	1226	1306	13	5	80	0.0625000
NODE_1416_length_1933_cov_86.724646	1226	1306	14	9	80	0.1125000
NODE_1416_length_1933_cov_86.724646	1226	1306	15	6	80	0.0750000
NODE_1416_length_1933_cov_86.724646	1226	1306	16	3	80	0.0375000
NODE_1416_length_1933_cov_86.724646	1226	1306	17	4	80	0.0500000
NODE_1416_length_1933_cov_86.724646	1226	1306	18	8	80	0.1000000
NODE_1416_length_1933_cov_86.724646	1226	1306	20	6	80	0.0750000
NODE_1416_length_1933_cov_86.724646	1226	1306	21	3	80	0.0375000
NODE_1416_length_1933_cov_86.724646	1226	1306	22	6	80	0.0750000
NODE_1419_length_1932_cov_5.905074	1534	1614	15	20	80	0.2500000
NODE_1419_length_1932_cov_5.905074	1534	1614	16	22	80	0.2750000
NODE_1419_length_1932_cov_5.905074	1534	1614	17	30	80	0.3750000
NODE_1419_length_1932_cov_5.905074	1534	1614	18	8	80	0.1000000
NODE_1422_length_1930_cov_3.005461	1700	1780	23	1	80	0.0125000
NODE_1422_length_1930_cov_3.005461	1700	1780	26	4	80	0.0500000
NODE_1422_length_1930_cov_3.005461	1700	1780	28	9	80	0.1125000
NODE_1422_length_1930_cov_3.005461	1700	1780	30	4	80	0.0500000
NODE_1422_length_1930_cov_3.005461	1700	1780	31	15	80	0.1875000
NODE_1422_length_1930_cov_3.005461	1700	1780	32	20	80	0.2500000
NODE_1422_length_1930_cov_3.005461	1700	1780	33	27	80	0.3375000
NODE_1427_length_1928_cov_2.580098	74	131	8	18	57	0.3157895
NODE_1427_length_1928_cov_2.580098	74	131	9	12	57	0.2105263
NODE_1427_length_1928_cov_2.580098	74	131	10	27	57	0.4736842
NODE_1427_length_1928_cov_2.580098	127	184	1	2	57	0.0350877
NODE_1427_length_1928_cov_2.580098	127	184	2	5	57	0.0877193
NODE_1427_length_1928_cov_2.580098	127	184	4	8	57	0.1403509
NODE_1427_length_1928_cov_2.580098	127	184	5	13	57	0.2280702
NODE_1427_length_1928_cov_2.580098	127	184	6	4	57	0.0701754
NODE_1427_length_1928_cov_2.580098	127	184	7	2	57	0.0350877
NODE_1427_length_1928_cov_2.580098	127	184	8	19	57	0.3333333
NODE_1427_length_1928_cov_2.580098	127	184	9	4	57	0.0701754
NODE_1434_length_1919_cov_17.901099	454	529	5	10	75	0.1333333
NODE_1434_length_1919_cov_17.901099	454	529	6	3	75	0.0400000
NODE_1434_length_1919_cov_17.901099	454	529	7	29	75	0.3866667
NODE_1434_length_1919_cov_17.901099	454	529	8	33	75	0.4400000
NODE_1434_length_1919_cov_17.901099	507	558	4	10	51	0.1960784
NODE_1434_length_1919_cov_17.901099	507	558	6	22	51	0.4313726
NODE_1434_length_1919_cov_17.901099	507	558	7	19	51	0.3725490
NODE_1436_length_1918_cov_14.876855	314	396	3	75	82	0.9146342
NODE_1436_length_1918_cov_14.876855	314	396	4	7	82	0.0853659
NODE_1438_length_1918_cov_3.493128	9	55	0	46	46	1.0000000
NODE_1438_length_1918_cov_3.493128	1480	1561	1	47	81	0.5802469
NODE_1438_length_1918_cov_3.493128	1480	1561	2	34	81	0.4197531
NODE_1440_length_1916_cov_4.426527	162	192	1	30	30	1.0000000
NODE_1442_length_1915_cov_35.787996	106	186	25	1	80	0.0125000
NODE_1442_length_1915_cov_35.787996	106	186	26	2	80	0.0250000
NODE_1442_length_1915_cov_35.787996	106	186	28	2	80	0.0250000
NODE_1442_length_1915_cov_35.787996	106	186	29	4	80	0.0500000
NODE_1442_length_1915_cov_35.787996	106	186	30	1	80	0.0125000
NODE_1442_length_1915_cov_35.787996	106	186	31	2	80	0.0250000
NODE_1442_length_1915_cov_35.787996	106	186	36	5	80	0.0625000
NODE_1442_length_1915_cov_35.787996	106	186	38	1	80	0.0125000
NODE_1442_length_1915_cov_35.787996	106	186	40	1	80	0.0125000
NODE_1442_length_1915_cov_35.787996	106	186	42	1	80	0.0125000
NODE_1442_length_1915_cov_35.787996	106	186	44	2	80	0.0250000
NODE_1442_length_1915_cov_35.787996	106	186	45	4	80	0.0500000
NODE_1442_length_1915_cov_35.787996	106	186	46	1	80	0.0125000
NODE_1442_length_1915_cov_35.787996	106	186	47	7	80	0.0875000
NODE_1442_length_1915_cov_35.787996	106	186	49	2	80	0.0250000
NODE_1442_length_1915_cov_35.787996	106	186	51	5	80	0.0625000
NODE_1442_length_1915_cov_35.787996	106	186	52	3	80	0.0375000
NODE_1442_length_1915_cov_35.787996	106	186	55	2	80	0.0250000
NODE_1442_length_1915_cov_35.787996	106	186	57	1	80	0.0125000
NODE_1442_length_1915_cov_35.787996	106	186	59	2	80	0.0250000
NODE_1442_length_1915_cov_35.787996	106	186	61	1	80	0.0125000
NODE_1442_length_1915_cov_35.787996	106	186	63	1	80	0.0125000
NODE_1442_length_1915_cov_35.787996	106	186	64	7	80	0.0875000
NODE_1442_length_1915_cov_35.787996	106	186	66	21	80	0.2625000
NODE_1442_length_1915_cov_35.787996	106	186	68	1	80	0.0125000
NODE_1451_length_1905_cov_18.464563	740	820	2	21	80	0.2625000
NODE_1451_length_1905_cov_18.464563	740	820	3	31	80	0.3875000
NODE_1451_length_1905_cov_18.464563	740	820	4	28	80	0.3500000
NODE_1451_length_1905_cov_18.464563	793	873	4	49	80	0.6125000
NODE_1451_length_1905_cov_18.464563	793	873	5	31	80	0.3875000
NODE_1451_length_1905_cov_18.464563	869	949	1	7	80	0.0875000
NODE_1451_length_1905_cov_18.464563	869	949	2	31	80	0.3875000
NODE_1451_length_1905_cov_18.464563	869	949	3	21	80	0.2625000
NODE_1451_length_1905_cov_18.464563	869	949	4	1	80	0.0125000
NODE_1451_length_1905_cov_18.464563	869	949	5	20	80	0.2500000
NODE_1451_length_1905_cov_18.464563	922	1010	1	62	88	0.7045454
NODE_1451_length_1905_cov_18.464563	922	1010	2	26	88	0.2954545
NODE_1452_length_1905_cov_7.197121	596	676	2	8	80	0.1000000
NODE_1452_length_1905_cov_7.197121	596	676	3	13	80	0.1625000
NODE_1452_length_1905_cov_7.197121	596	676	4	35	80	0.4375000
NODE_1452_length_1905_cov_7.197121	596	676	5	24	80	0.3000000
NODE_1452_length_1905_cov_7.197121	649	682	4	21	33	0.6363636
NODE_1452_length_1905_cov_7.197121	649	682	5	12	33	0.3636364
NODE_1455_length_1902_cov_1.633943	1728	1792	0	7	64	0.1093750
NODE_1455_length_1902_cov_1.633943	1728	1792	2	6	64	0.0937500
NODE_1455_length_1902_cov_1.633943	1728	1792	4	9	64	0.1406250
NODE_1455_length_1902_cov_1.633943	1728	1792	6	18	64	0.2812500
NODE_1455_length_1902_cov_1.633943	1728	1792	8	2	64	0.0312500
NODE_1455_length_1902_cov_1.633943	1728	1792	10	22	64	0.3437500
NODE_1458_length_1900_cov_1.081066	1805	1851	0	46	46	1.0000000
NODE_1458_length_1900_cov_1.081066	1824	1900	0	76	76	1.0000000
NODE_1461_length_1895_cov_17.940980	1070	1150	17	1	80	0.0125000
NODE_1461_length_1895_cov_17.940980	1070	1150	18	7	80	0.0875000
NODE_1461_length_1895_cov_17.940980	1070	1150	19	4	80	0.0500000
NODE_1461_length_1895_cov_17.940980	1070	1150	20	7	80	0.0875000
NODE_1461_length_1895_cov_17.940980	1070	1150	21	8	80	0.1000000
NODE_1461_length_1895_cov_17.940980	1070	1150	22	2	80	0.0250000
NODE_1461_length_1895_cov_17.940980	1070	1150	23	18	80	0.2250000
NODE_1461_length_1895_cov_17.940980	1070	1150	24	4	80	0.0500000
NODE_1461_length_1895_cov_17.940980	1070	1150	25	8	80	0.1000000
NODE_1461_length_1895_cov_17.940980	1070	1150	26	9	80	0.1125000
NODE_1461_length_1895_cov_17.940980	1070	1150	27	12	80	0.1500000
NODE_1461_length_1895_cov_17.940980	1123	1203	17	1	80	0.0125000
NODE_1461_length_1895_cov_17.940980	1123	1203	18	17	80	0.2125000
NODE_1461_length_1895_cov_17.940980	1123	1203	21	4	80	0.0500000
NODE_1461_length_1895_cov_17.940980	1123	1203	22	3	80	0.0375000
NODE_1461_length_1895_cov_17.940980	1123	1203	23	5	80	0.0625000
NODE_1461_length_1895_cov_17.940980	1123	1203	24	4	80	0.0500000
NODE_1461_length_1895_cov_17.940980	1123	1203	25	9	80	0.1125000
NODE_1461_length_1895_cov_17.940980	1123	1203	26	20	80	0.2500000
NODE_1461_length_1895_cov_17.940980	1123	1203	27	17	80	0.2125000
NODE_1466_length_1893_cov_3.299331	918	998	2	60	80	0.7500000
NODE_1466_length_1893_cov_3.299331	918	998	4	20	80	0.2500000
NODE_1467_length_1892_cov_5.158394	317	397	2	10	80	0.1250000
NODE_1467_length_1892_cov_5.158394	317	397	4	70	80	0.8750000
NODE_1467_length_1892_cov_5.158394	370	445	2	20	75	0.2666667
NODE_1467_length_1892_cov_5.158394	370	445	4	55	75	0.7333333
NODE_1469_length_1889_cov_4.049162	1652	1686	3	34	34	1.0000000
NODE_1470_length_1889_cov_3.888268	960	1040	1	27	80	0.3375000
NODE_1470_length_1889_cov_3.888268	960	1040	2	53	80	0.6625000
NODE_1470_length_1889_cov_3.888268	1013	1093	2	80	80	1.0000000
NODE_1472_length_1888_cov_17.106764	15	96	11	6	81	0.0740741
NODE_1472_length_1888_cov_17.106764	15	96	12	2	81	0.0246914
NODE_1472_length_1888_cov_17.106764	15	96	14	3	81	0.0370370
NODE_1472_length_1888_cov_17.106764	15	96	15	2	81	0.0246914
NODE_1472_length_1888_cov_17.106764	15	96	17	1	81	0.0123457
NODE_1472_length_1888_cov_17.106764	15	96	18	6	81	0.0740741
NODE_1472_length_1888_cov_17.106764	15	96	21	3	81	0.0370370
NODE_1472_length_1888_cov_17.106764	15	96	22	5	81	0.0617284
NODE_1472_length_1888_cov_17.106764	15	96	23	13	81	0.1604938
NODE_1472_length_1888_cov_17.106764	15	96	24	14	81	0.1728395
NODE_1472_length_1888_cov_17.106764	15	96	26	12	81	0.1481481
NODE_1472_length_1888_cov_17.106764	15	96	27	14	81	0.1728395
NODE_1472_length_1888_cov_17.106764	68	143	19	12	75	0.1600000
NODE_1472_length_1888_cov_17.106764	68	143	23	2	75	0.0266667
NODE_1472_length_1888_cov_17.106764	68	143	24	9	75	0.1200000
NODE_1472_length_1888_cov_17.106764	68	143	25	4	75	0.0533333
NODE_1472_length_1888_cov_17.106764	68	143	26	19	75	0.2533333
NODE_1472_length_1888_cov_17.106764	68	143	27	17	75	0.2266667
NODE_1472_length_1888_cov_17.106764	68	143	28	12	75	0.1600000
NODE_1477_length_1885_cov_4.439530	441	521	2	44	80	0.5500000
NODE_1477_length_1885_cov_4.439530	441	521	3	36	80	0.4500000
NODE_1477_length_1885_cov_4.439530	494	574	1	7	80	0.0875000
NODE_1477_length_1885_cov_4.439530	494	574	2	73	80	0.9125000
NODE_1483_length_1882_cov_5.884464	1499	1579	0	80	80	1.0000000
NODE_1483_length_1882_cov_5.884464	1552	1632	0	80	80	1.0000000
NODE_1493_length_1875_cov_3.974662	1650	1730	17	6	80	0.0750000
NODE_1493_length_1875_cov_3.974662	1650	1730	19	7	80	0.0875000
NODE_1493_length_1875_cov_3.974662	1650	1730	21	2	80	0.0250000
NODE_1493_length_1875_cov_3.974662	1650	1730	22	9	80	0.1125000
NODE_1493_length_1875_cov_3.974662	1650	1730	23	8	80	0.1000000
NODE_1493_length_1875_cov_3.974662	1650	1730	24	20	80	0.2500000
NODE_1493_length_1875_cov_3.974662	1650	1730	25	24	80	0.3000000
NODE_1493_length_1875_cov_3.974662	1650	1730	26	1	80	0.0125000
NODE_1493_length_1875_cov_3.974662	1650	1730	27	3	80	0.0375000
NODE_1497_length_1872_cov_21.355330	153	201	0	48	48	1.0000000
NODE_1503_length_1868_cov_96.046919	1018	1098	50	1	80	0.0125000
NODE_1503_length_1868_cov_96.046919	1018	1098	52	1	80	0.0125000
NODE_1503_length_1868_cov_96.046919	1018	1098	54	1	80	0.0125000
NODE_1503_length_1868_cov_96.046919	1018	1098	55	1	80	0.0125000
NODE_1503_length_1868_cov_96.046919	1018	1098	58	3	80	0.0375000
NODE_1503_length_1868_cov_96.046919	1018	1098	59	1	80	0.0125000
NODE_1503_length_1868_cov_96.046919	1018	1098	60	4	80	0.0500000
NODE_1503_length_1868_cov_96.046919	1018	1098	62	2	80	0.0250000
NODE_1503_length_1868_cov_96.046919	1018	1098	63	1	80	0.0125000
NODE_1503_length_1868_cov_96.046919	1018	1098	64	4	80	0.0500000
NODE_1503_length_1868_cov_96.046919	1018	1098	65	1	80	0.0125000
NODE_1503_length_1868_cov_96.046919	1018	1098	66	6	80	0.0750000
NODE_1503_length_1868_cov_96.046919	1018	1098	69	2	80	0.0250000
NODE_1503_length_1868_cov_96.046919	1018	1098	70	3	80	0.0375000
NODE_1503_length_1868_cov_96.046919	1018	1098	71	1	80	0.0125000
NODE_1503_length_1868_cov_96.046919	1018	1098	72	2	80	0.0250000
NODE_1503_length_1868_cov_96.046919	1018	1098	73	1	80	0.0125000
NODE_1503_length_1868_cov_96.046919	1018	1098	77	2	80	0.0250000
NODE_1503_length_1868_cov_96.046919	1018	1098	78	1	80	0.0125000
NODE_1503_length_1868_cov_96.046919	1018	1098	79	1	80	0.0125000
NODE_1503_length_1868_cov_96.046919	1018	1098	80	3	80	0.0375000
NODE_1503_length_1868_cov_96.046919	1018	1098	81	4	80	0.0500000
NODE_1503_length_1868_cov_96.046919	1018	1098	84	1	80	0.0125000
NODE_1503_length_1868_cov_96.046919	1018	1098	85	1	80	0.0125000
NODE_1503_length_1868_cov_96.046919	1018	1098	86	2	80	0.0250000
NODE_1503_length_1868_cov_96.046919	1018	1098	88	1	80	0.0125000
NODE_1503_length_1868_cov_96.046919	1018	1098	89	6	80	0.0750000
NODE_1503_length_1868_cov_96.046919	1018	1098	90	4	80	0.0500000
NODE_1503_length_1868_cov_96.046919	1018	1098	91	2	80	0.0250000
NODE_1503_length_1868_cov_96.046919	1018	1098	92	1	80	0.0125000
NODE_1503_length_1868_cov_96.046919	1018	1098	93	1	80	0.0125000
NODE_1503_length_1868_cov_96.046919	1018	1098	94	2	80	0.0250000
NODE_1503_length_1868_cov_96.046919	1018	1098	95	3	80	0.0375000
NODE_1503_length_1868_cov_96.046919	1018	1098	96	5	80	0.0625000
NODE_1503_length_1868_cov_96.046919	1018	1098	98	3	80	0.0375000
NODE_1503_length_1868_cov_96.046919	1018	1098	100	2	80	0.0250000
NODE_1503_length_1868_cov_96.046919	1071	1151	75	5	80	0.0625000
NODE_1503_length_1868_cov_96.046919	1071	1151	76	1	80	0.0125000
NODE_1503_length_1868_cov_96.046919	1071	1151	80	1	80	0.0125000
NODE_1503_length_1868_cov_96.046919	1071	1151	81	2	80	0.0250000
NODE_1503_length_1868_cov_96.046919	1071	1151	82	1	80	0.0125000
NODE_1503_length_1868_cov_96.046919	1071	1151	83	5	80	0.0625000
NODE_1503_length_1868_cov_96.046919	1071	1151	84	1	80	0.0125000
NODE_1503_length_1868_cov_96.046919	1071	1151	85	4	80	0.0500000
NODE_1503_length_1868_cov_96.046919	1071	1151	87	2	80	0.0250000
NODE_1503_length_1868_cov_96.046919	1071	1151	88	2	80	0.0250000
NODE_1503_length_1868_cov_96.046919	1071	1151	89	4	80	0.0500000
NODE_1503_length_1868_cov_96.046919	1071	1151	90	5	80	0.0625000
NODE_1503_length_1868_cov_96.046919	1071	1151	91	2	80	0.0250000
NODE_1503_length_1868_cov_96.046919	1071	1151	92	3	80	0.0375000
NODE_1503_length_1868_cov_96.046919	1071	1151	93	6	80	0.0750000
NODE_1503_length_1868_cov_96.046919	1071	1151	94	14	80	0.1750000
NODE_1503_length_1868_cov_96.046919	1071	1151	95	6	80	0.0750000
NODE_1503_length_1868_cov_96.046919	1071	1151	96	7	80	0.0875000
NODE_1503_length_1868_cov_96.046919	1071	1151	97	1	80	0.0125000
NODE_1503_length_1868_cov_96.046919	1071	1151	98	5	80	0.0625000
NODE_1503_length_1868_cov_96.046919	1071	1151	99	1	80	0.0125000
NODE_1503_length_1868_cov_96.046919	1071	1151	100	2	80	0.0250000
NODE_1508_length_1866_cov_53.869270	1149	1229	1	2	80	0.0250000
NODE_1508_length_1866_cov_53.869270	1149	1229	3	7	80	0.0875000
NODE_1508_length_1866_cov_53.869270	1149	1229	4	3	80	0.0375000
NODE_1508_length_1866_cov_53.869270	1149	1229	5	6	80	0.0750000
NODE_1508_length_1866_cov_53.869270	1149	1229	6	21	80	0.2625000
NODE_1508_length_1866_cov_53.869270	1149	1229	7	12	80	0.1500000
NODE_1508_length_1866_cov_53.869270	1149	1229	8	29	80	0.3625000
NODE_1508_length_1866_cov_53.869270	1202	1282	8	27	80	0.3375000
NODE_1508_length_1866_cov_53.869270	1202	1282	9	39	80	0.4875000
NODE_1508_length_1866_cov_53.869270	1202	1282	10	14	80	0.1750000
NODE_1508_length_1866_cov_53.869270	1278	1358	3	8	80	0.1000000
NODE_1508_length_1866_cov_53.869270	1278	1358	4	25	80	0.3125000
NODE_1508_length_1866_cov_53.869270	1278	1358	5	14	80	0.1750000
NODE_1508_length_1866_cov_53.869270	1278	1358	6	3	80	0.0375000
NODE_1508_length_1866_cov_53.869270	1278	1358	7	7	80	0.0875000
NODE_1508_length_1866_cov_53.869270	1278	1358	9	4	80	0.0500000
NODE_1508_length_1866_cov_53.869270	1278	1358	10	19	80	0.2375000
NODE_1508_length_1866_cov_53.869270	1331	1411	2	32	80	0.4000000
NODE_1508_length_1866_cov_53.869270	1331	1411	3	29	80	0.3625000
NODE_1508_length_1866_cov_53.869270	1331	1411	4	12	80	0.1500000
NODE_1508_length_1866_cov_53.869270	1331	1411	5	7	80	0.0875000
NODE_1510_length_1866_cov_3.347482	888	966	0	78	78	1.0000000
NODE_1510_length_1866_cov_3.347482	939	1019	0	80	80	1.0000000
NODE_1513_length_1863_cov_11.265306	698	778	1	4	80	0.0500000
NODE_1513_length_1863_cov_11.265306	698	778	2	12	80	0.1500000
NODE_1513_length_1863_cov_11.265306	698	778	3	35	80	0.4375000
NODE_1513_length_1863_cov_11.265306	698	778	4	29	80	0.3625000
NODE_1513_length_1863_cov_11.265306	751	831	2	11	80	0.1375000
NODE_1513_length_1863_cov_11.265306	751	831	3	8	80	0.1000000
NODE_1513_length_1863_cov_11.265306	751	831	4	43	80	0.5375000
NODE_1513_length_1863_cov_11.265306	751	831	5	18	80	0.2250000
NODE_1518_length_1858_cov_19.019329	23	85	4	43	62	0.6935484
NODE_1518_length_1858_cov_19.019329	23	85	5	19	62	0.3064516
NODE_1518_length_1858_cov_19.019329	1125	1205	1	8	80	0.1000000
NODE_1518_length_1858_cov_19.019329	1125	1205	3	4	80	0.0500000
NODE_1518_length_1858_cov_19.019329	1125	1205	4	64	80	0.8000000
NODE_1518_length_1858_cov_19.019329	1125	1205	5	4	80	0.0500000
NODE_1518_length_1858_cov_19.019329	1178	1256	3	2	78	0.0256410
NODE_1518_length_1858_cov_19.019329	1178	1256	4	56	78	0.7179487
NODE_1518_length_1858_cov_19.019329	1178	1256	5	20	78	0.2564103
NODE_1518_length_1858_cov_19.019329	1387	1464	6	3	77	0.0389610
NODE_1518_length_1858_cov_19.019329	1387	1464	7	7	77	0.0909091
NODE_1518_length_1858_cov_19.019329	1387	1464	9	2	77	0.0259740
NODE_1518_length_1858_cov_19.019329	1387	1464	10	24	77	0.3116883
NODE_1518_length_1858_cov_19.019329	1387	1464	11	9	77	0.1168831
NODE_1518_length_1858_cov_19.019329	1387	1464	13	12	77	0.1558442
NODE_1518_length_1858_cov_19.019329	1387	1464	15	20	77	0.2597403
NODE_1518_length_1858_cov_19.019329	1440	1503	11	9	63	0.1428571
NODE_1518_length_1858_cov_19.019329	1440	1503	13	4	63	0.0634921
NODE_1518_length_1858_cov_19.019329	1440	1503	14	9	63	0.1428571
NODE_1518_length_1858_cov_19.019329	1440	1503	15	41	63	0.6507937
NODE_1519_length_1857_cov_18.402730	1282	1348	0	66	66	1.0000000
NODE_1519_length_1857_cov_18.402730	1321	1401	0	80	80	1.0000000
NODE_1519_length_1857_cov_18.402730	1397	1477	0	60	80	0.7500000
NODE_1519_length_1857_cov_18.402730	1397	1477	2	20	80	0.2500000
NODE_1519_length_1857_cov_18.402730	1450	1530	0	8	80	0.1000000
NODE_1519_length_1857_cov_18.402730	1450	1530	2	72	80	0.9000000
NODE_1531_length_1845_cov_12.653494	473	553	0	12	80	0.1500000
NODE_1531_length_1845_cov_12.653494	473	553	1	7	80	0.0875000
NODE_1531_length_1845_cov_12.653494	473	553	2	61	80	0.7625000
NODE_1531_length_1845_cov_12.653494	526	606	2	80	80	1.0000000
NODE_1546_length_1833_cov_31.337947	810	888	0	14	78	0.1794872
NODE_1546_length_1833_cov_31.337947	810	888	1	64	78	0.8205128
NODE_1546_length_1833_cov_31.337947	861	941	1	74	80	0.9250000
NODE_1546_length_1833_cov_31.337947	861	941	2	6	80	0.0750000
NODE_1546_length_1833_cov_31.337947	937	1017	1	43	80	0.5375000
NODE_1546_length_1833_cov_31.337947	937	1017	2	37	80	0.4625000
NODE_1546_length_1833_cov_31.337947	990	1070	1	80	80	1.0000000
NODE_1550_length_1831_cov_3.065820	112	154	0	1	42	0.0238095
NODE_1550_length_1831_cov_3.065820	112	154	2	1	42	0.0238095
NODE_1550_length_1831_cov_3.065820	112	154	4	16	42	0.3809524
NODE_1550_length_1831_cov_3.065820	112	154	6	2	42	0.0476190
NODE_1550_length_1831_cov_3.065820	112	154	8	6	42	0.1428571
NODE_1550_length_1831_cov_3.065820	112	154	10	2	42	0.0476190
NODE_1550_length_1831_cov_3.065820	112	154	12	8	42	0.1904762
NODE_1550_length_1831_cov_3.065820	112	154	14	6	42	0.1428571
NODE_1553_length_1830_cov_2.512998	123	203	0	3	80	0.0375000
NODE_1553_length_1830_cov_2.512998	123	203	1	28	80	0.3500000
NODE_1553_length_1830_cov_2.512998	123	203	3	49	80	0.6125000
NODE_1553_length_1830_cov_2.512998	176	256	1	11	80	0.1375000
NODE_1553_length_1830_cov_2.512998	176	256	3	69	80	0.8625000
NODE_1553_length_1830_cov_2.512998	308	357	1	49	49	1.0000000
NODE_1554_length_1828_cov_40.437825	789	869	4	62	80	0.7750000
NODE_1554_length_1828_cov_40.437825	789	869	5	18	80	0.2250000
NODE_1554_length_1828_cov_40.437825	842	922	4	9	80	0.1125000
NODE_1554_length_1828_cov_40.437825	842	922	5	18	80	0.2250000
NODE_1554_length_1828_cov_40.437825	842	922	6	7	80	0.0875000
NODE_1554_length_1828_cov_40.437825	842	922	7	24	80	0.3000000
NODE_1554_length_1828_cov_40.437825	842	922	8	22	80	0.2750000
NODE_1554_length_1828_cov_40.437825	918	998	7	4	80	0.0500000
NODE_1554_length_1828_cov_40.437825	918	998	8	17	80	0.2125000
NODE_1554_length_1828_cov_40.437825	918	998	9	29	80	0.3625000
NODE_1554_length_1828_cov_40.437825	918	998	10	2	80	0.0250000
NODE_1554_length_1828_cov_40.437825	918	998	11	28	80	0.3500000
NODE_1554_length_1828_cov_40.437825	971	1051	9	14	80	0.1750000
NODE_1554_length_1828_cov_40.437825	971	1051	10	25	80	0.3125000
NODE_1554_length_1828_cov_40.437825	971	1051	11	22	80	0.2750000
NODE_1554_length_1828_cov_40.437825	971	1051	13	18	80	0.2250000
NODE_1554_length_1828_cov_40.437825	971	1051	14	1	80	0.0125000
NODE_1559_length_1825_cov_6.652955	641	689	2	9	48	0.1875000
NODE_1559_length_1825_cov_6.652955	641	689	4	39	48	0.8125000
NODE_1559_length_1825_cov_6.652955	694	744	2	2	50	0.0400000
NODE_1559_length_1825_cov_6.652955	694	744	4	48	50	0.9600000
NODE_1562_length_1824_cov_10.152464	685	765	16	3	80	0.0375000
NODE_1562_length_1824_cov_10.152464	685	765	17	18	80	0.2250000
NODE_1562_length_1824_cov_10.152464	685	765	18	49	80	0.6125000
NODE_1562_length_1824_cov_10.152464	685	765	19	10	80	0.1250000
NODE_1562_length_1824_cov_10.152464	738	818	7	4	80	0.0500000
NODE_1562_length_1824_cov_10.152464	738	818	8	6	80	0.0750000
NODE_1562_length_1824_cov_10.152464	738	818	10	6	80	0.0750000
NODE_1562_length_1824_cov_10.152464	738	818	12	6	80	0.0750000
NODE_1562_length_1824_cov_10.152464	738	818	14	3	80	0.0375000
NODE_1562_length_1824_cov_10.152464	738	818	16	5	80	0.0625000
NODE_1562_length_1824_cov_10.152464	738	818	17	3	80	0.0375000
NODE_1562_length_1824_cov_10.152464	738	818	18	27	80	0.3375000
NODE_1562_length_1824_cov_10.152464	738	818	19	20	80	0.2500000
NODE_1562_length_1824_cov_10.152464	1412	1433	5	17	21	0.8095238
NODE_1562_length_1824_cov_10.152464	1412	1433	6	4	21	0.1904762
NODE_1564_length_1821_cov_7.682346	953	1033	0	80	80	1.0000000
NODE_1564_length_1821_cov_7.682346	1006	1086	0	55	80	0.6875000
NODE_1564_length_1821_cov_7.682346	1006	1086	1	25	80	0.3125000
NODE_1566_length_1820_cov_12.061592	477	557	0	61	80	0.7625000
NODE_1566_length_1820_cov_12.061592	477	557	2	19	80	0.2375000
NODE_1566_length_1820_cov_12.061592	530	610	0	8	80	0.1000000
NODE_1566_length_1820_cov_12.061592	530	610	2	72	80	0.9000000
NODE_1566_length_1820_cov_12.061592	1232	1312	1	37	80	0.4625000
NODE_1566_length_1820_cov_12.061592	1232	1312	2	43	80	0.5375000
NODE_1566_length_1820_cov_12.061592	1285	1365	1	62	80	0.7750000
NODE_1566_length_1820_cov_12.061592	1285	1365	2	18	80	0.2250000
NODE_1572_length_1817_cov_8.302095	63	122	0	5	59	0.0847458
NODE_1572_length_1817_cov_8.302095	63	122	1	20	59	0.3389831
NODE_1572_length_1817_cov_8.302095	63	122	2	7	59	0.1186441
NODE_1572_length_1817_cov_8.302095	63	122	4	27	59	0.4576271
NODE_1572_length_1817_cov_8.302095	1195	1275	0	34	80	0.4250000
NODE_1572_length_1817_cov_8.302095	1195	1275	1	46	80	0.5750000
NODE_1572_length_1817_cov_8.302095	1248	1328	0	50	80	0.6250000
NODE_1572_length_1817_cov_8.302095	1248	1328	2	30	80	0.3750000
NODE_1573_length_1816_cov_25.489225	1059	1139	1	24	80	0.3000000
NODE_1573_length_1816_cov_25.489225	1059	1139	2	45	80	0.5625000
NODE_1573_length_1816_cov_25.489225	1059	1139	3	11	80	0.1375000
NODE_1573_length_1816_cov_25.489225	1112	1192	1	16	80	0.2000000
NODE_1573_length_1816_cov_25.489225	1112	1192	2	12	80	0.1500000
NODE_1573_length_1816_cov_25.489225	1112	1192	3	52	80	0.6500000
NODE_1578_length_1812_cov_11.453006	398	427	0	27	29	0.9310345
NODE_1578_length_1812_cov_11.453006	398	427	1	2	29	0.0689655
NODE_1578_length_1812_cov_11.453006	400	480	0	80	80	1.0000000
NODE_1586_length_1807_cov_3.977752	1743	1807	0	64	64	1.0000000
NODE_1590_length_1806_cov_2.681312	1461	1541	0	2	80	0.0250000
NODE_1590_length_1806_cov_2.681312	1461	1541	1	4	80	0.0500000
NODE_1590_length_1806_cov_2.681312	1461	1541	3	4	80	0.0500000
NODE_1590_length_1806_cov_2.681312	1461	1541	4	1	80	0.0125000
NODE_1590_length_1806_cov_2.681312	1461	1541	5	2	80	0.0250000
NODE_1590_length_1806_cov_2.681312	1461	1541	7	4	80	0.0500000
NODE_1590_length_1806_cov_2.681312	1461	1541	9	6	80	0.0750000
NODE_1590_length_1806_cov_2.681312	1461	1541	11	14	80	0.1750000
NODE_1590_length_1806_cov_2.681312	1461	1541	13	19	80	0.2375000
NODE_1590_length_1806_cov_2.681312	1461	1541	15	22	80	0.2750000
NODE_1590_length_1806_cov_2.681312	1461	1541	17	2	80	0.0250000
NODE_1590_length_1806_cov_2.681312	1517	1594	0	55	77	0.7142857
NODE_1590_length_1806_cov_2.681312	1517	1594	1	4	77	0.0519481
NODE_1590_length_1806_cov_2.681312	1517	1594	3	4	77	0.0519481
NODE_1590_length_1806_cov_2.681312	1517	1594	4	1	77	0.0129870
NODE_1590_length_1806_cov_2.681312	1517	1594	5	2	77	0.0259740
NODE_1590_length_1806_cov_2.681312	1517	1594	7	4	77	0.0519481
NODE_1590_length_1806_cov_2.681312	1517	1594	9	6	77	0.0779221
NODE_1590_length_1806_cov_2.681312	1517	1594	11	1	77	0.0129870
NODE_1593_length_1805_cov_10.271395	258	329	2	71	71	1.0000000
NODE_1593_length_1805_cov_10.271395	311	391	1	55	80	0.6875000
NODE_1593_length_1805_cov_10.271395	311	391	2	25	80	0.3125000
NODE_1598_length_1802_cov_11.546682	1284	1364	0	80	80	1.0000000
NODE_1598_length_1802_cov_11.546682	1337	1417	0	80	80	1.0000000
NODE_1600_length_1801_cov_12.145711	85	165	19	2	80	0.0250000
NODE_1600_length_1801_cov_12.145711	85	165	20	5	80	0.0625000
NODE_1600_length_1801_cov_12.145711	85	165	22	8	80	0.1000000
NODE_1600_length_1801_cov_12.145711	85	165	24	3	80	0.0375000
NODE_1600_length_1801_cov_12.145711	85	165	25	1	80	0.0125000
NODE_1600_length_1801_cov_12.145711	85	165	26	2	80	0.0250000
NODE_1600_length_1801_cov_12.145711	85	165	27	7	80	0.0875000
NODE_1600_length_1801_cov_12.145711	85	165	29	3	80	0.0375000
NODE_1600_length_1801_cov_12.145711	85	165	30	2	80	0.0250000
NODE_1600_length_1801_cov_12.145711	85	165	33	1	80	0.0125000
NODE_1600_length_1801_cov_12.145711	85	165	34	21	80	0.2625000
NODE_1600_length_1801_cov_12.145711	85	165	35	1	80	0.0125000
NODE_1600_length_1801_cov_12.145711	85	165	36	21	80	0.2625000
NODE_1600_length_1801_cov_12.145711	85	165	37	3	80	0.0375000
NODE_1600_length_1801_cov_12.145711	138	218	23	2	80	0.0250000
NODE_1600_length_1801_cov_12.145711	138	218	26	4	80	0.0500000
NODE_1600_length_1801_cov_12.145711	138	218	28	2	80	0.0250000
NODE_1600_length_1801_cov_12.145711	138	218	29	2	80	0.0250000
NODE_1600_length_1801_cov_12.145711	138	218	31	5	80	0.0625000
NODE_1600_length_1801_cov_12.145711	138	218	32	1	80	0.0125000
NODE_1600_length_1801_cov_12.145711	138	218	33	10	80	0.1250000
NODE_1600_length_1801_cov_12.145711	138	218	34	2	80	0.0250000
NODE_1600_length_1801_cov_12.145711	138	218	35	5	80	0.0625000
NODE_1600_length_1801_cov_12.145711	138	218	36	33	80	0.4125000
NODE_1600_length_1801_cov_12.145711	138	218	37	14	80	0.1750000
NODE_1601_length_1801_cov_9.793184	1010	1090	1	41	80	0.5125000
NODE_1601_length_1801_cov_9.793184	1010	1090	2	39	80	0.4875000
NODE_1601_length_1801_cov_9.793184	1063	1143	1	22	80	0.2750000
NODE_1601_length_1801_cov_9.793184	1063	1143	2	51	80	0.6375000
NODE_1601_length_1801_cov_9.793184	1063	1143	3	7	80	0.0875000
NODE_1604_length_1800_cov_15.074662	695	775	0	80	80	1.0000000
NODE_1604_length_1800_cov_15.074662	755	826	0	71	71	1.0000000
NODE_1605_length_1800_cov_7.281599	10	74	12	1	64	0.0156250
NODE_1605_length_1800_cov_7.281599	10	74	13	4	64	0.0625000
NODE_1605_length_1800_cov_7.281599	10	74	15	7	64	0.1093750
NODE_1605_length_1800_cov_7.281599	10	74	17	2	64	0.0312500
NODE_1605_length_1800_cov_7.281599	10	74	19	4	64	0.0625000
NODE_1605_length_1800_cov_7.281599	10	74	20	1	64	0.0156250
NODE_1605_length_1800_cov_7.281599	10	74	22	2	64	0.0312500
NODE_1605_length_1800_cov_7.281599	10	74	23	15	64	0.2343750
NODE_1605_length_1800_cov_7.281599	10	74	24	5	64	0.0781250
NODE_1605_length_1800_cov_7.281599	10	74	25	2	64	0.0312500
NODE_1605_length_1800_cov_7.281599	10	74	26	8	64	0.1250000
NODE_1605_length_1800_cov_7.281599	10	74	28	13	64	0.2031250
NODE_1605_length_1800_cov_7.281599	10	74	12	1	64	0.0156250
NODE_1605_length_1800_cov_7.281599	10	74	13	4	64	0.0625000
NODE_1605_length_1800_cov_7.281599	10	74	15	7	64	0.1093750
NODE_1605_length_1800_cov_7.281599	10	74	17	2	64	0.0312500
NODE_1605_length_1800_cov_7.281599	10	74	19	4	64	0.0625000
NODE_1605_length_1800_cov_7.281599	10	74	20	1	64	0.0156250
NODE_1605_length_1800_cov_7.281599	10	74	22	2	64	0.0312500
NODE_1605_length_1800_cov_7.281599	10	74	23	15	64	0.2343750
NODE_1605_length_1800_cov_7.281599	10	74	24	5	64	0.0781250
NODE_1605_length_1800_cov_7.281599	10	74	25	2	64	0.0312500
NODE_1605_length_1800_cov_7.281599	10	74	26	8	64	0.1250000
NODE_1605_length_1800_cov_7.281599	10	74	28	13	64	0.2031250
NODE_1605_length_1800_cov_7.281599	10	74	12	1	64	0.0156250
NODE_1605_length_1800_cov_7.281599	10	74	13	4	64	0.0625000
NODE_1605_length_1800_cov_7.281599	10	74	15	7	64	0.1093750
NODE_1605_length_1800_cov_7.281599	10	74	17	2	64	0.0312500
NODE_1605_length_1800_cov_7.281599	10	74	19	4	64	0.0625000
NODE_1605_length_1800_cov_7.281599	10	74	20	1	64	0.0156250
NODE_1605_length_1800_cov_7.281599	10	74	22	2	64	0.0312500
NODE_1605_length_1800_cov_7.281599	10	74	23	15	64	0.2343750
NODE_1605_length_1800_cov_7.281599	10	74	24	5	64	0.0781250
NODE_1605_length_1800_cov_7.281599	10	74	25	2	64	0.0312500
NODE_1605_length_1800_cov_7.281599	10	74	26	8	64	0.1250000
NODE_1605_length_1800_cov_7.281599	10	74	28	13	64	0.2031250
NODE_1605_length_1800_cov_7.281599	47	127	24	5	80	0.0625000
NODE_1605_length_1800_cov_7.281599	47	127	25	2	80	0.0250000
NODE_1605_length_1800_cov_7.281599	47	127	26	10	80	0.1250000
NODE_1605_length_1800_cov_7.281599	47	127	27	20	80	0.2500000
NODE_1605_length_1800_cov_7.281599	47	127	28	38	80	0.4750000
NODE_1605_length_1800_cov_7.281599	47	127	29	5	80	0.0625000
NODE_1605_length_1800_cov_7.281599	63	126	26	2	63	0.0317460
NODE_1605_length_1800_cov_7.281599	63	126	27	20	63	0.3174603
NODE_1605_length_1800_cov_7.281599	63	126	28	36	63	0.5714286
NODE_1605_length_1800_cov_7.281599	63	126	29	5	63	0.0793651
NODE_1616_length_1793_cov_16.161157	539	619	4	37	80	0.4625000
NODE_1616_length_1793_cov_16.161157	539	619	6	11	80	0.1375000
NODE_1616_length_1793_cov_16.161157	539	619	7	28	80	0.3500000
NODE_1616_length_1793_cov_16.161157	539	619	8	4	80	0.0500000
NODE_1616_length_1793_cov_16.161157	592	672	5	6	80	0.0750000
NODE_1616_length_1793_cov_16.161157	592	672	6	24	80	0.3000000
NODE_1616_length_1793_cov_16.161157	592	672	7	46	80	0.5750000
NODE_1616_length_1793_cov_16.161157	592	672	8	4	80	0.0500000
NODE_1616_length_1793_cov_16.161157	1202	1281	0	79	79	1.0000000
NODE_1616_length_1793_cov_16.161157	1254	1335	0	81	81	1.0000000
NODE_1617_length_1793_cov_14.322904	521	601	0	80	80	1.0000000
NODE_1617_length_1793_cov_14.322904	574	654	0	80	80	1.0000000
NODE_1617_length_1793_cov_14.322904	1230	1310	0	12	80	0.1500000
NODE_1617_length_1793_cov_14.322904	1230	1310	1	21	80	0.2625000
NODE_1617_length_1793_cov_14.322904	1230	1310	3	16	80	0.2000000
NODE_1617_length_1793_cov_14.322904	1230	1310	4	31	80	0.3875000
NODE_1618_length_1791_cov_5.516548	1190	1261	0	71	71	1.0000000
NODE_1621_length_1790_cov_4.282082	684	764	0	63	80	0.7875000
NODE_1621_length_1790_cov_4.282082	684	764	1	17	80	0.2125000
NODE_1621_length_1790_cov_4.282082	737	817	0	10	80	0.1250000
NODE_1621_length_1790_cov_4.282082	737	817	1	70	80	0.8750000
NODE_1623_length_1788_cov_39.558911	385	465	0	80	80	1.0000000
NODE_1623_length_1788_cov_39.558911	438	518	0	80	80	1.0000000
NODE_1623_length_1788_cov_39.558911	514	594	0	44	80	0.5500000
NODE_1623_length_1788_cov_39.558911	514	594	2	29	80	0.3625000
NODE_1623_length_1788_cov_39.558911	514	594	4	7	80	0.0875000
NODE_1623_length_1788_cov_39.558911	567	647	2	20	80	0.2500000
NODE_1623_length_1788_cov_39.558911	567	647	4	60	80	0.7500000
NODE_1624_length_1787_cov_44.927133	530	610	110	1	80	0.0125000
NODE_1624_length_1787_cov_44.927133	530	610	111	1	80	0.0125000
NODE_1624_length_1787_cov_44.927133	530	610	113	1	80	0.0125000
NODE_1624_length_1787_cov_44.927133	530	610	114	7	80	0.0875000
NODE_1624_length_1787_cov_44.927133	530	610	115	7	80	0.0875000
NODE_1624_length_1787_cov_44.927133	530	610	116	7	80	0.0875000
NODE_1624_length_1787_cov_44.927133	530	610	117	6	80	0.0750000
NODE_1624_length_1787_cov_44.927133	530	610	118	16	80	0.2000000
NODE_1624_length_1787_cov_44.927133	530	610	119	7	80	0.0875000
NODE_1624_length_1787_cov_44.927133	530	610	120	3	80	0.0375000
NODE_1624_length_1787_cov_44.927133	530	610	121	3	80	0.0375000
NODE_1624_length_1787_cov_44.927133	530	610	122	1	80	0.0125000
NODE_1624_length_1787_cov_44.927133	530	610	123	7	80	0.0875000
NODE_1624_length_1787_cov_44.927133	530	610	124	1	80	0.0125000
NODE_1624_length_1787_cov_44.927133	530	610	125	1	80	0.0125000
NODE_1624_length_1787_cov_44.927133	530	610	126	3	80	0.0375000
NODE_1624_length_1787_cov_44.927133	530	610	127	7	80	0.0875000
NODE_1624_length_1787_cov_44.927133	530	610	129	1	80	0.0125000
NODE_1625_length_1787_cov_2.752370	675	755	2	9	80	0.1125000
NODE_1625_length_1787_cov_2.752370	675	755	4	71	80	0.8875000
NODE_1625_length_1787_cov_2.752370	728	806	2	34	78	0.4358974
NODE_1625_length_1787_cov_2.752370	728	806	4	44	78	0.5641026
NODE_1626_length_1786_cov_13.459395	523	603	2	80	80	1.0000000
NODE_1626_length_1786_cov_13.459395	576	656	2	80	80	1.0000000
NODE_1633_length_1784_cov_40.769733	358	438	2	80	80	1.0000000
NODE_1633_length_1784_cov_40.769733	411	491	2	80	80	1.0000000
NODE_1633_length_1784_cov_40.769733	1057	1137	1	80	80	1.0000000
NODE_1633_length_1784_cov_40.769733	1110	1190	0	18	80	0.2250000
NODE_1633_length_1784_cov_40.769733	1110	1190	1	47	80	0.5875000
NODE_1633_length_1784_cov_40.769733	1110	1190	2	15	80	0.1875000
NODE_1633_length_1784_cov_40.769733	1186	1266	2	4	80	0.0500000
NODE_1633_length_1784_cov_40.769733	1186	1266	3	1	80	0.0125000
NODE_1633_length_1784_cov_40.769733	1186	1266	4	49	80	0.6125000
NODE_1633_length_1784_cov_40.769733	1186	1266	5	26	80	0.3250000
NODE_1633_length_1784_cov_40.769733	1239	1319	4	1	80	0.0125000
NODE_1633_length_1784_cov_40.769733	1239	1319	5	44	80	0.5500000
NODE_1633_length_1784_cov_40.769733	1239	1319	6	15	80	0.1875000
NODE_1633_length_1784_cov_40.769733	1239	1319	7	20	80	0.2500000
NODE_1634_length_1784_cov_6.049258	1646	1725	1	79	79	1.0000000
NODE_1637_length_1783_cov_45.569477	600	680	11	12	80	0.1500000
NODE_1637_length_1783_cov_45.569477	600	680	12	12	80	0.1500000
NODE_1637_length_1783_cov_45.569477	600	680	13	7	80	0.0875000
NODE_1637_length_1783_cov_45.569477	600	680	14	5	80	0.0625000
NODE_1637_length_1783_cov_45.569477	600	680	15	8	80	0.1000000
NODE_1637_length_1783_cov_45.569477	600	680	16	11	80	0.1375000
NODE_1637_length_1783_cov_45.569477	600	680	18	25	80	0.3125000
NODE_1637_length_1783_cov_45.569477	653	733	7	5	80	0.0625000
NODE_1637_length_1783_cov_45.569477	653	733	8	4	80	0.0500000
NODE_1637_length_1783_cov_45.569477	653	733	9	7	80	0.0875000
NODE_1637_length_1783_cov_45.569477	653	733	10	3	80	0.0375000
NODE_1637_length_1783_cov_45.569477	653	733	11	2	80	0.0250000
NODE_1637_length_1783_cov_45.569477	653	733	13	11	80	0.1375000
NODE_1637_length_1783_cov_45.569477	653	733	15	19	80	0.2375000
NODE_1637_length_1783_cov_45.569477	653	733	16	3	80	0.0375000
NODE_1637_length_1783_cov_45.569477	653	733	18	26	80	0.3250000
NODE_1640_length_1780_cov_21.089233	361	441	1	57	80	0.7125000
NODE_1640_length_1780_cov_21.089233	361	441	2	7	80	0.0875000
NODE_1640_length_1780_cov_21.089233	361	441	3	16	80	0.2000000
NODE_1640_length_1780_cov_21.089233	414	494	1	4	80	0.0500000
NODE_1640_length_1780_cov_21.089233	414	494	2	7	80	0.0875000
NODE_1640_length_1780_cov_21.089233	414	494	3	37	80	0.4625000
NODE_1640_length_1780_cov_21.089233	414	494	5	18	80	0.2250000
NODE_1640_length_1780_cov_21.089233	414	494	6	14	80	0.1750000
NODE_1640_length_1780_cov_21.089233	1031	1104	7	9	73	0.1232877
NODE_1640_length_1780_cov_21.089233	1031	1104	8	12	73	0.1643836
NODE_1640_length_1780_cov_21.089233	1031	1104	9	8	73	0.1095890
NODE_1640_length_1780_cov_21.089233	1031	1104	11	2	73	0.0273973
NODE_1640_length_1780_cov_21.089233	1031	1104	12	1	73	0.0136986
NODE_1640_length_1780_cov_21.089233	1031	1104	13	2	73	0.0273973
NODE_1640_length_1780_cov_21.089233	1031	1104	17	5	73	0.0684932
NODE_1640_length_1780_cov_21.089233	1031	1104	18	7	73	0.0958904
NODE_1640_length_1780_cov_21.089233	1031	1104	20	1	73	0.0136986
NODE_1640_length_1780_cov_21.089233	1031	1104	21	1	73	0.0136986
NODE_1640_length_1780_cov_21.089233	1031	1104	22	8	73	0.1095890
NODE_1640_length_1780_cov_21.089233	1031	1104	23	1	73	0.0136986
NODE_1640_length_1780_cov_21.089233	1031	1104	27	4	73	0.0547945
NODE_1640_length_1780_cov_21.089233	1031	1104	28	2	73	0.0273973
NODE_1640_length_1780_cov_21.089233	1031	1104	33	1	73	0.0136986
NODE_1640_length_1780_cov_21.089233	1031	1104	34	1	73	0.0136986
NODE_1640_length_1780_cov_21.089233	1031	1104	35	3	73	0.0410959
NODE_1640_length_1780_cov_21.089233	1031	1104	37	1	73	0.0136986
NODE_1640_length_1780_cov_21.089233	1031	1104	38	2	73	0.0273973
NODE_1640_length_1780_cov_21.089233	1031	1104	40	1	73	0.0136986
NODE_1640_length_1780_cov_21.089233	1031	1104	41	1	73	0.0136986
NODE_1640_length_1780_cov_21.089233	1071	1112	18	6	41	0.1463415
NODE_1640_length_1780_cov_21.089233	1071	1112	20	1	41	0.0243902
NODE_1640_length_1780_cov_21.089233	1071	1112	21	1	41	0.0243902
NODE_1640_length_1780_cov_21.089233	1071	1112	22	8	41	0.1951219
NODE_1640_length_1780_cov_21.089233	1071	1112	23	1	41	0.0243902
NODE_1640_length_1780_cov_21.089233	1071	1112	27	4	41	0.0975610
NODE_1640_length_1780_cov_21.089233	1071	1112	28	2	41	0.0487805
NODE_1640_length_1780_cov_21.089233	1071	1112	33	1	41	0.0243902
NODE_1640_length_1780_cov_21.089233	1071	1112	34	1	41	0.0243902
NODE_1640_length_1780_cov_21.089233	1071	1112	35	3	41	0.0731707
NODE_1640_length_1780_cov_21.089233	1071	1112	37	1	41	0.0243902
NODE_1640_length_1780_cov_21.089233	1071	1112	38	2	41	0.0487805
NODE_1640_length_1780_cov_21.089233	1071	1112	40	1	41	0.0243902
NODE_1640_length_1780_cov_21.089233	1071	1112	41	2	41	0.0487805
NODE_1640_length_1780_cov_21.089233	1071	1112	42	1	41	0.0243902
NODE_1640_length_1780_cov_21.089233	1071	1112	43	1	41	0.0243902
NODE_1640_length_1780_cov_21.089233	1071	1112	44	3	41	0.0731707
NODE_1640_length_1780_cov_21.089233	1071	1112	47	2	41	0.0487805
NODE_1641_length_1780_cov_7.837597	1682	1747	0	65	65	1.0000000
NODE_1649_length_1778_cov_52.804050	1528	1568	7	2	40	0.0500000
NODE_1649_length_1778_cov_52.804050	1528	1568	9	2	40	0.0500000
NODE_1649_length_1778_cov_52.804050	1528	1568	10	1	40	0.0250000
NODE_1649_length_1778_cov_52.804050	1528	1568	12	4	40	0.1000000
NODE_1649_length_1778_cov_52.804050	1528	1568	13	3	40	0.0750000
NODE_1649_length_1778_cov_52.804050	1528	1568	14	1	40	0.0250000
NODE_1649_length_1778_cov_52.804050	1528	1568	16	1	40	0.0250000
NODE_1649_length_1778_cov_52.804050	1528	1568	18	1	40	0.0250000
NODE_1649_length_1778_cov_52.804050	1528	1568	20	1	40	0.0250000
NODE_1649_length_1778_cov_52.804050	1528	1568	24	1	40	0.0250000
NODE_1649_length_1778_cov_52.804050	1528	1568	27	2	40	0.0500000
NODE_1649_length_1778_cov_52.804050	1528	1568	28	6	40	0.1500000
NODE_1649_length_1778_cov_52.804050	1528	1568	30	2	40	0.0500000
NODE_1649_length_1778_cov_52.804050	1528	1568	32	1	40	0.0250000
NODE_1649_length_1778_cov_52.804050	1528	1568	33	3	40	0.0750000
NODE_1649_length_1778_cov_52.804050	1528	1568	35	3	40	0.0750000
NODE_1649_length_1778_cov_52.804050	1528	1568	37	1	40	0.0250000
NODE_1649_length_1778_cov_52.804050	1528	1568	38	2	40	0.0500000
NODE_1649_length_1778_cov_52.804050	1528	1568	39	3	40	0.0750000
NODE_1649_length_1778_cov_52.804050	1541	1621	16	1	80	0.0125000
NODE_1649_length_1778_cov_52.804050	1541	1621	18	1	80	0.0125000
NODE_1649_length_1778_cov_52.804050	1541	1621	20	1	80	0.0125000
NODE_1649_length_1778_cov_52.804050	1541	1621	24	1	80	0.0125000
NODE_1649_length_1778_cov_52.804050	1541	1621	27	2	80	0.0250000
NODE_1649_length_1778_cov_52.804050	1541	1621	28	6	80	0.0750000
NODE_1649_length_1778_cov_52.804050	1541	1621	30	2	80	0.0250000
NODE_1649_length_1778_cov_52.804050	1541	1621	32	1	80	0.0125000
NODE_1649_length_1778_cov_52.804050	1541	1621	33	3	80	0.0375000
NODE_1649_length_1778_cov_52.804050	1541	1621	35	3	80	0.0375000
NODE_1649_length_1778_cov_52.804050	1541	1621	37	1	80	0.0125000
NODE_1649_length_1778_cov_52.804050	1541	1621	38	2	80	0.0250000
NODE_1649_length_1778_cov_52.804050	1541	1621	39	8	80	0.1000000
NODE_1649_length_1778_cov_52.804050	1541	1621	40	4	80	0.0500000
NODE_1649_length_1778_cov_52.804050	1541	1621	41	1	80	0.0125000
NODE_1649_length_1778_cov_52.804050	1541	1621	42	6	80	0.0750000
NODE_1649_length_1778_cov_52.804050	1541	1621	43	6	80	0.0750000
NODE_1649_length_1778_cov_52.804050	1541	1621	44	6	80	0.0750000
NODE_1649_length_1778_cov_52.804050	1541	1621	45	6	80	0.0750000
NODE_1649_length_1778_cov_52.804050	1541	1621	46	18	80	0.2250000
NODE_1649_length_1778_cov_52.804050	1541	1621	48	1	80	0.0125000
NODE_1649_length_1778_cov_52.804050	1541	1621	16	1	80	0.0125000
NODE_1649_length_1778_cov_52.804050	1541	1621	18	1	80	0.0125000
NODE_1649_length_1778_cov_52.804050	1541	1621	20	1	80	0.0125000
NODE_1649_length_1778_cov_52.804050	1541	1621	24	1	80	0.0125000
NODE_1649_length_1778_cov_52.804050	1541	1621	27	2	80	0.0250000
NODE_1649_length_1778_cov_52.804050	1541	1621	28	6	80	0.0750000
NODE_1649_length_1778_cov_52.804050	1541	1621	30	2	80	0.0250000
NODE_1649_length_1778_cov_52.804050	1541	1621	32	1	80	0.0125000
NODE_1649_length_1778_cov_52.804050	1541	1621	33	3	80	0.0375000
NODE_1649_length_1778_cov_52.804050	1541	1621	35	3	80	0.0375000
NODE_1649_length_1778_cov_52.804050	1541	1621	37	1	80	0.0125000
NODE_1649_length_1778_cov_52.804050	1541	1621	38	2	80	0.0250000
NODE_1649_length_1778_cov_52.804050	1541	1621	39	8	80	0.1000000
NODE_1649_length_1778_cov_52.804050	1541	1621	40	4	80	0.0500000
NODE_1649_length_1778_cov_52.804050	1541	1621	41	1	80	0.0125000
NODE_1649_length_1778_cov_52.804050	1541	1621	42	6	80	0.0750000
NODE_1649_length_1778_cov_52.804050	1541	1621	43	6	80	0.0750000
NODE_1649_length_1778_cov_52.804050	1541	1621	44	6	80	0.0750000
NODE_1649_length_1778_cov_52.804050	1541	1621	45	6	80	0.0750000
NODE_1649_length_1778_cov_52.804050	1541	1621	46	18	80	0.2250000
NODE_1649_length_1778_cov_52.804050	1541	1621	48	1	80	0.0125000
NODE_1649_length_1778_cov_52.804050	1541	1621	16	1	80	0.0125000
NODE_1649_length_1778_cov_52.804050	1541	1621	18	1	80	0.0125000
NODE_1649_length_1778_cov_52.804050	1541	1621	20	1	80	0.0125000
NODE_1649_length_1778_cov_52.804050	1541	1621	24	1	80	0.0125000
NODE_1649_length_1778_cov_52.804050	1541	1621	27	2	80	0.0250000
NODE_1649_length_1778_cov_52.804050	1541	1621	28	6	80	0.0750000
NODE_1649_length_1778_cov_52.804050	1541	1621	30	2	80	0.0250000
NODE_1649_length_1778_cov_52.804050	1541	1621	32	1	80	0.0125000
NODE_1649_length_1778_cov_52.804050	1541	1621	33	3	80	0.0375000
NODE_1649_length_1778_cov_52.804050	1541	1621	35	3	80	0.0375000
NODE_1649_length_1778_cov_52.804050	1541	1621	37	1	80	0.0125000
NODE_1649_length_1778_cov_52.804050	1541	1621	38	2	80	0.0250000
NODE_1649_length_1778_cov_52.804050	1541	1621	39	8	80	0.1000000
NODE_1649_length_1778_cov_52.804050	1541	1621	40	4	80	0.0500000
NODE_1649_length_1778_cov_52.804050	1541	1621	41	1	80	0.0125000
NODE_1649_length_1778_cov_52.804050	1541	1621	42	6	80	0.0750000
NODE_1649_length_1778_cov_52.804050	1541	1621	43	6	80	0.0750000
NODE_1649_length_1778_cov_52.804050	1541	1621	44	6	80	0.0750000
NODE_1649_length_1778_cov_52.804050	1541	1621	45	6	80	0.0750000
NODE_1649_length_1778_cov_52.804050	1541	1621	46	18	80	0.2250000
NODE_1649_length_1778_cov_52.804050	1541	1621	48	1	80	0.0125000
NODE_1649_length_1778_cov_52.804050	1541	1621	16	1	80	0.0125000
NODE_1649_length_1778_cov_52.804050	1541	1621	18	1	80	0.0125000
NODE_1649_length_1778_cov_52.804050	1541	1621	20	1	80	0.0125000
NODE_1649_length_1778_cov_52.804050	1541	1621	24	1	80	0.0125000
NODE_1649_length_1778_cov_52.804050	1541	1621	27	2	80	0.0250000
NODE_1649_length_1778_cov_52.804050	1541	1621	28	6	80	0.0750000
NODE_1649_length_1778_cov_52.804050	1541	1621	30	2	80	0.0250000
NODE_1649_length_1778_cov_52.804050	1541	1621	32	1	80	0.0125000
NODE_1649_length_1778_cov_52.804050	1541	1621	33	3	80	0.0375000
NODE_1649_length_1778_cov_52.804050	1541	1621	35	3	80	0.0375000
NODE_1649_length_1778_cov_52.804050	1541	1621	37	1	80	0.0125000
NODE_1649_length_1778_cov_52.804050	1541	1621	38	2	80	0.0250000
NODE_1649_length_1778_cov_52.804050	1541	1621	39	8	80	0.1000000
NODE_1649_length_1778_cov_52.804050	1541	1621	40	4	80	0.0500000
NODE_1649_length_1778_cov_52.804050	1541	1621	41	1	80	0.0125000
NODE_1649_length_1778_cov_52.804050	1541	1621	42	6	80	0.0750000
NODE_1649_length_1778_cov_52.804050	1541	1621	43	6	80	0.0750000
NODE_1649_length_1778_cov_52.804050	1541	1621	44	6	80	0.0750000
NODE_1649_length_1778_cov_52.804050	1541	1621	45	6	80	0.0750000
NODE_1649_length_1778_cov_52.804050	1541	1621	46	18	80	0.2250000
NODE_1649_length_1778_cov_52.804050	1541	1621	48	1	80	0.0125000
NODE_1649_length_1778_cov_52.804050	1541	1621	16	1	80	0.0125000
NODE_1649_length_1778_cov_52.804050	1541	1621	18	1	80	0.0125000
NODE_1649_length_1778_cov_52.804050	1541	1621	20	1	80	0.0125000
NODE_1649_length_1778_cov_52.804050	1541	1621	24	1	80	0.0125000
NODE_1649_length_1778_cov_52.804050	1541	1621	27	2	80	0.0250000
NODE_1649_length_1778_cov_52.804050	1541	1621	28	6	80	0.0750000
NODE_1649_length_1778_cov_52.804050	1541	1621	30	2	80	0.0250000
NODE_1649_length_1778_cov_52.804050	1541	1621	32	1	80	0.0125000
NODE_1649_length_1778_cov_52.804050	1541	1621	33	3	80	0.0375000
NODE_1649_length_1778_cov_52.804050	1541	1621	35	3	80	0.0375000
NODE_1649_length_1778_cov_52.804050	1541	1621	37	1	80	0.0125000
NODE_1649_length_1778_cov_52.804050	1541	1621	38	2	80	0.0250000
NODE_1649_length_1778_cov_52.804050	1541	1621	39	8	80	0.1000000
NODE_1649_length_1778_cov_52.804050	1541	1621	40	4	80	0.0500000
NODE_1649_length_1778_cov_52.804050	1541	1621	41	1	80	0.0125000
NODE_1649_length_1778_cov_52.804050	1541	1621	42	6	80	0.0750000
NODE_1649_length_1778_cov_52.804050	1541	1621	43	6	80	0.0750000
NODE_1649_length_1778_cov_52.804050	1541	1621	44	6	80	0.0750000
NODE_1649_length_1778_cov_52.804050	1541	1621	45	6	80	0.0750000
NODE_1649_length_1778_cov_52.804050	1541	1621	46	18	80	0.2250000
NODE_1649_length_1778_cov_52.804050	1541	1621	48	1	80	0.0125000
NODE_1649_length_1778_cov_52.804050	1541	1621	16	1	80	0.0125000
NODE_1649_length_1778_cov_52.804050	1541	1621	18	1	80	0.0125000
NODE_1649_length_1778_cov_52.804050	1541	1621	20	1	80	0.0125000
NODE_1649_length_1778_cov_52.804050	1541	1621	24	1	80	0.0125000
NODE_1649_length_1778_cov_52.804050	1541	1621	27	2	80	0.0250000
NODE_1649_length_1778_cov_52.804050	1541	1621	28	6	80	0.0750000
NODE_1649_length_1778_cov_52.804050	1541	1621	30	2	80	0.0250000
NODE_1649_length_1778_cov_52.804050	1541	1621	32	1	80	0.0125000
NODE_1649_length_1778_cov_52.804050	1541	1621	33	3	80	0.0375000
NODE_1649_length_1778_cov_52.804050	1541	1621	35	3	80	0.0375000
NODE_1649_length_1778_cov_52.804050	1541	1621	37	1	80	0.0125000
NODE_1649_length_1778_cov_52.804050	1541	1621	38	2	80	0.0250000
NODE_1649_length_1778_cov_52.804050	1541	1621	39	8	80	0.1000000
NODE_1649_length_1778_cov_52.804050	1541	1621	40	4	80	0.0500000
NODE_1649_length_1778_cov_52.804050	1541	1621	41	1	80	0.0125000
NODE_1649_length_1778_cov_52.804050	1541	1621	42	6	80	0.0750000
NODE_1649_length_1778_cov_52.804050	1541	1621	43	6	80	0.0750000
NODE_1649_length_1778_cov_52.804050	1541	1621	44	6	80	0.0750000
NODE_1649_length_1778_cov_52.804050	1541	1621	45	6	80	0.0750000
NODE_1649_length_1778_cov_52.804050	1541	1621	46	18	80	0.2250000
NODE_1649_length_1778_cov_52.804050	1541	1621	48	1	80	0.0125000
NODE_1649_length_1778_cov_52.804050	1617	1697	33	2	80	0.0250000
NODE_1649_length_1778_cov_52.804050	1617	1697	34	3	80	0.0375000
NODE_1649_length_1778_cov_52.804050	1617	1697	36	1	80	0.0125000
NODE_1649_length_1778_cov_52.804050	1617	1697	38	1	80	0.0125000
NODE_1649_length_1778_cov_52.804050	1617	1697	39	1	80	0.0125000
NODE_1649_length_1778_cov_52.804050	1617	1697	41	2	80	0.0250000
NODE_1649_length_1778_cov_52.804050	1617	1697	42	4	80	0.0500000
NODE_1649_length_1778_cov_52.804050	1617	1697	44	3	80	0.0375000
NODE_1649_length_1778_cov_52.804050	1617	1697	46	3	80	0.0375000
NODE_1649_length_1778_cov_52.804050	1617	1697	47	3	80	0.0375000
NODE_1649_length_1778_cov_52.804050	1617	1697	48	1	80	0.0125000
NODE_1649_length_1778_cov_52.804050	1617	1697	50	4	80	0.0500000
NODE_1649_length_1778_cov_52.804050	1617	1697	51	1	80	0.0125000
NODE_1649_length_1778_cov_52.804050	1617	1697	53	4	80	0.0500000
NODE_1649_length_1778_cov_52.804050	1617	1697	54	3	80	0.0375000
NODE_1649_length_1778_cov_52.804050	1617	1697	55	1	80	0.0125000
NODE_1649_length_1778_cov_52.804050	1617	1697	56	1	80	0.0125000
NODE_1649_length_1778_cov_52.804050	1617	1697	57	4	80	0.0500000
NODE_1649_length_1778_cov_52.804050	1617	1697	58	5	80	0.0625000
NODE_1649_length_1778_cov_52.804050	1617	1697	59	2	80	0.0250000
NODE_1649_length_1778_cov_52.804050	1617	1697	60	8	80	0.1000000
NODE_1649_length_1778_cov_52.804050	1617	1697	61	18	80	0.2250000
NODE_1649_length_1778_cov_52.804050	1617	1697	62	5	80	0.0625000
NODE_1649_length_1778_cov_52.804050	1617	1697	33	2	80	0.0250000
NODE_1649_length_1778_cov_52.804050	1617	1697	34	3	80	0.0375000
NODE_1649_length_1778_cov_52.804050	1617	1697	36	1	80	0.0125000
NODE_1649_length_1778_cov_52.804050	1617	1697	38	1	80	0.0125000
NODE_1649_length_1778_cov_52.804050	1617	1697	39	1	80	0.0125000
NODE_1649_length_1778_cov_52.804050	1617	1697	41	2	80	0.0250000
NODE_1649_length_1778_cov_52.804050	1617	1697	42	4	80	0.0500000
NODE_1649_length_1778_cov_52.804050	1617	1697	44	3	80	0.0375000
NODE_1649_length_1778_cov_52.804050	1617	1697	46	3	80	0.0375000
NODE_1649_length_1778_cov_52.804050	1617	1697	47	3	80	0.0375000
NODE_1649_length_1778_cov_52.804050	1617	1697	48	1	80	0.0125000
NODE_1649_length_1778_cov_52.804050	1617	1697	50	4	80	0.0500000
NODE_1649_length_1778_cov_52.804050	1617	1697	51	1	80	0.0125000
NODE_1649_length_1778_cov_52.804050	1617	1697	53	4	80	0.0500000
NODE_1649_length_1778_cov_52.804050	1617	1697	54	3	80	0.0375000
NODE_1649_length_1778_cov_52.804050	1617	1697	55	1	80	0.0125000
NODE_1649_length_1778_cov_52.804050	1617	1697	56	1	80	0.0125000
NODE_1649_length_1778_cov_52.804050	1617	1697	57	4	80	0.0500000
NODE_1649_length_1778_cov_52.804050	1617	1697	58	5	80	0.0625000
NODE_1649_length_1778_cov_52.804050	1617	1697	59	2	80	0.0250000
NODE_1649_length_1778_cov_52.804050	1617	1697	60	8	80	0.1000000
NODE_1649_length_1778_cov_52.804050	1617	1697	61	18	80	0.2250000
NODE_1649_length_1778_cov_52.804050	1617	1697	62	5	80	0.0625000
NODE_1649_length_1778_cov_52.804050	1617	1697	33	2	80	0.0250000
NODE_1649_length_1778_cov_52.804050	1617	1697	34	3	80	0.0375000
NODE_1649_length_1778_cov_52.804050	1617	1697	36	1	80	0.0125000
NODE_1649_length_1778_cov_52.804050	1617	1697	38	1	80	0.0125000
NODE_1649_length_1778_cov_52.804050	1617	1697	39	1	80	0.0125000
NODE_1649_length_1778_cov_52.804050	1617	1697	41	2	80	0.0250000
NODE_1649_length_1778_cov_52.804050	1617	1697	42	4	80	0.0500000
NODE_1649_length_1778_cov_52.804050	1617	1697	44	3	80	0.0375000
NODE_1649_length_1778_cov_52.804050	1617	1697	46	3	80	0.0375000
NODE_1649_length_1778_cov_52.804050	1617	1697	47	3	80	0.0375000
NODE_1649_length_1778_cov_52.804050	1617	1697	48	1	80	0.0125000
NODE_1649_length_1778_cov_52.804050	1617	1697	50	4	80	0.0500000
NODE_1649_length_1778_cov_52.804050	1617	1697	51	1	80	0.0125000
NODE_1649_length_1778_cov_52.804050	1617	1697	53	4	80	0.0500000
NODE_1649_length_1778_cov_52.804050	1617	1697	54	3	80	0.0375000
NODE_1649_length_1778_cov_52.804050	1617	1697	55	1	80	0.0125000
NODE_1649_length_1778_cov_52.804050	1617	1697	56	1	80	0.0125000
NODE_1649_length_1778_cov_52.804050	1617	1697	57	4	80	0.0500000
NODE_1649_length_1778_cov_52.804050	1617	1697	58	5	80	0.0625000
NODE_1649_length_1778_cov_52.804050	1617	1697	59	2	80	0.0250000
NODE_1649_length_1778_cov_52.804050	1617	1697	60	8	80	0.1000000
NODE_1649_length_1778_cov_52.804050	1617	1697	61	18	80	0.2250000
NODE_1649_length_1778_cov_52.804050	1617	1697	62	5	80	0.0625000
NODE_1649_length_1778_cov_52.804050	1617	1697	33	2	80	0.0250000
NODE_1649_length_1778_cov_52.804050	1617	1697	34	3	80	0.0375000
NODE_1649_length_1778_cov_52.804050	1617	1697	36	1	80	0.0125000
NODE_1649_length_1778_cov_52.804050	1617	1697	38	1	80	0.0125000
NODE_1649_length_1778_cov_52.804050	1617	1697	39	1	80	0.0125000
NODE_1649_length_1778_cov_52.804050	1617	1697	41	2	80	0.0250000
NODE_1649_length_1778_cov_52.804050	1617	1697	42	4	80	0.0500000
NODE_1649_length_1778_cov_52.804050	1617	1697	44	3	80	0.0375000
NODE_1649_length_1778_cov_52.804050	1617	1697	46	3	80	0.0375000
NODE_1649_length_1778_cov_52.804050	1617	1697	47	3	80	0.0375000
NODE_1649_length_1778_cov_52.804050	1617	1697	48	1	80	0.0125000
NODE_1649_length_1778_cov_52.804050	1617	1697	50	4	80	0.0500000
NODE_1649_length_1778_cov_52.804050	1617	1697	51	1	80	0.0125000
NODE_1649_length_1778_cov_52.804050	1617	1697	53	4	80	0.0500000
NODE_1649_length_1778_cov_52.804050	1617	1697	54	3	80	0.0375000
NODE_1649_length_1778_cov_52.804050	1617	1697	55	1	80	0.0125000
NODE_1649_length_1778_cov_52.804050	1617	1697	56	1	80	0.0125000
NODE_1649_length_1778_cov_52.804050	1617	1697	57	4	80	0.0500000
NODE_1649_length_1778_cov_52.804050	1617	1697	58	5	80	0.0625000
NODE_1649_length_1778_cov_52.804050	1617	1697	59	2	80	0.0250000
NODE_1649_length_1778_cov_52.804050	1617	1697	60	8	80	0.1000000
NODE_1649_length_1778_cov_52.804050	1617	1697	61	18	80	0.2250000
NODE_1649_length_1778_cov_52.804050	1617	1697	62	5	80	0.0625000
NODE_1649_length_1778_cov_52.804050	1670	1750	13	4	80	0.0500000
NODE_1649_length_1778_cov_52.804050	1670	1750	14	5	80	0.0625000
NODE_1649_length_1778_cov_52.804050	1670	1750	17	1	80	0.0125000
NODE_1649_length_1778_cov_52.804050	1670	1750	19	6	80	0.0750000
NODE_1649_length_1778_cov_52.804050	1670	1750	20	6	80	0.0750000
NODE_1649_length_1778_cov_52.804050	1670	1750	21	1	80	0.0125000
NODE_1649_length_1778_cov_52.804050	1670	1750	22	4	80	0.0500000
NODE_1649_length_1778_cov_52.804050	1670	1750	23	8	80	0.1000000
NODE_1649_length_1778_cov_52.804050	1670	1750	24	2	80	0.0250000
NODE_1649_length_1778_cov_52.804050	1670	1750	25	1	80	0.0125000
NODE_1649_length_1778_cov_52.804050	1670	1750	27	6	80	0.0750000
NODE_1649_length_1778_cov_52.804050	1670	1750	28	3	80	0.0375000
NODE_1649_length_1778_cov_52.804050	1670	1750	32	6	80	0.0750000
NODE_1649_length_1778_cov_52.804050	1670	1750	33	2	80	0.0250000
NODE_1649_length_1778_cov_52.804050	1670	1750	34	3	80	0.0375000
NODE_1649_length_1778_cov_52.804050	1670	1750	36	1	80	0.0125000
NODE_1649_length_1778_cov_52.804050	1670	1750	38	1	80	0.0125000
NODE_1649_length_1778_cov_52.804050	1670	1750	39	1	80	0.0125000
NODE_1649_length_1778_cov_52.804050	1670	1750	41	2	80	0.0250000
NODE_1649_length_1778_cov_52.804050	1670	1750	42	4	80	0.0500000
NODE_1649_length_1778_cov_52.804050	1670	1750	44	3	80	0.0375000
NODE_1649_length_1778_cov_52.804050	1670	1750	47	3	80	0.0375000
NODE_1649_length_1778_cov_52.804050	1670	1750	53	1	80	0.0125000
NODE_1649_length_1778_cov_52.804050	1670	1750	55	1	80	0.0125000
NODE_1649_length_1778_cov_52.804050	1670	1750	57	4	80	0.0500000
NODE_1649_length_1778_cov_52.804050	1670	1750	59	1	80	0.0125000
NODE_1649_length_1778_cov_52.804050	1670	1750	13	4	80	0.0500000
NODE_1649_length_1778_cov_52.804050	1670	1750	14	5	80	0.0625000
NODE_1649_length_1778_cov_52.804050	1670	1750	17	1	80	0.0125000
NODE_1649_length_1778_cov_52.804050	1670	1750	19	6	80	0.0750000
NODE_1649_length_1778_cov_52.804050	1670	1750	20	6	80	0.0750000
NODE_1649_length_1778_cov_52.804050	1670	1750	21	1	80	0.0125000
NODE_1649_length_1778_cov_52.804050	1670	1750	22	4	80	0.0500000
NODE_1649_length_1778_cov_52.804050	1670	1750	23	8	80	0.1000000
NODE_1649_length_1778_cov_52.804050	1670	1750	24	2	80	0.0250000
NODE_1649_length_1778_cov_52.804050	1670	1750	25	1	80	0.0125000
NODE_1649_length_1778_cov_52.804050	1670	1750	27	6	80	0.0750000
NODE_1649_length_1778_cov_52.804050	1670	1750	28	3	80	0.0375000
NODE_1649_length_1778_cov_52.804050	1670	1750	32	6	80	0.0750000
NODE_1649_length_1778_cov_52.804050	1670	1750	33	2	80	0.0250000
NODE_1649_length_1778_cov_52.804050	1670	1750	34	3	80	0.0375000
NODE_1649_length_1778_cov_52.804050	1670	1750	36	1	80	0.0125000
NODE_1649_length_1778_cov_52.804050	1670	1750	38	1	80	0.0125000
NODE_1649_length_1778_cov_52.804050	1670	1750	39	1	80	0.0125000
NODE_1649_length_1778_cov_52.804050	1670	1750	41	2	80	0.0250000
NODE_1649_length_1778_cov_52.804050	1670	1750	42	4	80	0.0500000
NODE_1649_length_1778_cov_52.804050	1670	1750	44	3	80	0.0375000
NODE_1649_length_1778_cov_52.804050	1670	1750	47	3	80	0.0375000
NODE_1649_length_1778_cov_52.804050	1670	1750	53	1	80	0.0125000
NODE_1649_length_1778_cov_52.804050	1670	1750	55	1	80	0.0125000
NODE_1649_length_1778_cov_52.804050	1670	1750	57	4	80	0.0500000
NODE_1649_length_1778_cov_52.804050	1670	1750	59	1	80	0.0125000
NODE_1649_length_1778_cov_52.804050	1670	1750	13	4	80	0.0500000
NODE_1649_length_1778_cov_52.804050	1670	1750	14	5	80	0.0625000
NODE_1649_length_1778_cov_52.804050	1670	1750	17	1	80	0.0125000
NODE_1649_length_1778_cov_52.804050	1670	1750	19	6	80	0.0750000
NODE_1649_length_1778_cov_52.804050	1670	1750	20	6	80	0.0750000
NODE_1649_length_1778_cov_52.804050	1670	1750	21	1	80	0.0125000
NODE_1649_length_1778_cov_52.804050	1670	1750	22	4	80	0.0500000
NODE_1649_length_1778_cov_52.804050	1670	1750	23	8	80	0.1000000
NODE_1649_length_1778_cov_52.804050	1670	1750	24	2	80	0.0250000
NODE_1649_length_1778_cov_52.804050	1670	1750	25	1	80	0.0125000
NODE_1649_length_1778_cov_52.804050	1670	1750	27	6	80	0.0750000
NODE_1649_length_1778_cov_52.804050	1670	1750	28	3	80	0.0375000
NODE_1649_length_1778_cov_52.804050	1670	1750	32	6	80	0.0750000
NODE_1649_length_1778_cov_52.804050	1670	1750	33	2	80	0.0250000
NODE_1649_length_1778_cov_52.804050	1670	1750	34	3	80	0.0375000
NODE_1649_length_1778_cov_52.804050	1670	1750	36	1	80	0.0125000
NODE_1649_length_1778_cov_52.804050	1670	1750	38	1	80	0.0125000
NODE_1649_length_1778_cov_52.804050	1670	1750	39	1	80	0.0125000
NODE_1649_length_1778_cov_52.804050	1670	1750	41	2	80	0.0250000
NODE_1649_length_1778_cov_52.804050	1670	1750	42	4	80	0.0500000
NODE_1649_length_1778_cov_52.804050	1670	1750	44	3	80	0.0375000
NODE_1649_length_1778_cov_52.804050	1670	1750	47	3	80	0.0375000
NODE_1649_length_1778_cov_52.804050	1670	1750	53	1	80	0.0125000
NODE_1649_length_1778_cov_52.804050	1670	1750	55	1	80	0.0125000
NODE_1649_length_1778_cov_52.804050	1670	1750	57	4	80	0.0500000
NODE_1649_length_1778_cov_52.804050	1670	1750	59	1	80	0.0125000
NODE_1649_length_1778_cov_52.804050	1670	1741	17	1	71	0.0140845
NODE_1649_length_1778_cov_52.804050	1670	1741	19	6	71	0.0845070
NODE_1649_length_1778_cov_52.804050	1670	1741	20	6	71	0.0845070
NODE_1649_length_1778_cov_52.804050	1670	1741	21	1	71	0.0140845
NODE_1649_length_1778_cov_52.804050	1670	1741	22	4	71	0.0563380
NODE_1649_length_1778_cov_52.804050	1670	1741	23	8	71	0.1126761
NODE_1649_length_1778_cov_52.804050	1670	1741	24	2	71	0.0281690
NODE_1649_length_1778_cov_52.804050	1670	1741	25	1	71	0.0140845
NODE_1649_length_1778_cov_52.804050	1670	1741	27	6	71	0.0845070
NODE_1649_length_1778_cov_52.804050	1670	1741	28	3	71	0.0422535
NODE_1649_length_1778_cov_52.804050	1670	1741	32	6	71	0.0845070
NODE_1649_length_1778_cov_52.804050	1670	1741	33	2	71	0.0281690
NODE_1649_length_1778_cov_52.804050	1670	1741	34	3	71	0.0422535
NODE_1649_length_1778_cov_52.804050	1670	1741	36	1	71	0.0140845
NODE_1649_length_1778_cov_52.804050	1670	1741	38	1	71	0.0140845
NODE_1649_length_1778_cov_52.804050	1670	1741	39	1	71	0.0140845
NODE_1649_length_1778_cov_52.804050	1670	1741	41	2	71	0.0281690
NODE_1649_length_1778_cov_52.804050	1670	1741	42	4	71	0.0563380
NODE_1649_length_1778_cov_52.804050	1670	1741	44	3	71	0.0422535
NODE_1649_length_1778_cov_52.804050	1670	1741	47	3	71	0.0422535
NODE_1649_length_1778_cov_52.804050	1670	1741	53	1	71	0.0140845
NODE_1649_length_1778_cov_52.804050	1670	1741	55	1	71	0.0140845
NODE_1649_length_1778_cov_52.804050	1670	1741	57	4	71	0.0563380
NODE_1649_length_1778_cov_52.804050	1670	1741	59	1	71	0.0140845
NODE_1649_length_1778_cov_52.804050	1673	1743	14	2	70	0.0285714
NODE_1649_length_1778_cov_52.804050	1673	1743	17	1	70	0.0142857
NODE_1649_length_1778_cov_52.804050	1673	1743	19	6	70	0.0857143
NODE_1649_length_1778_cov_52.804050	1673	1743	20	6	70	0.0857143
NODE_1649_length_1778_cov_52.804050	1673	1743	21	1	70	0.0142857
NODE_1649_length_1778_cov_52.804050	1673	1743	22	4	70	0.0571429
NODE_1649_length_1778_cov_52.804050	1673	1743	23	8	70	0.1142857
NODE_1649_length_1778_cov_52.804050	1673	1743	24	2	70	0.0285714
NODE_1649_length_1778_cov_52.804050	1673	1743	25	1	70	0.0142857
NODE_1649_length_1778_cov_52.804050	1673	1743	27	6	70	0.0857143
NODE_1649_length_1778_cov_52.804050	1673	1743	28	3	70	0.0428571
NODE_1649_length_1778_cov_52.804050	1673	1743	32	6	70	0.0857143
NODE_1649_length_1778_cov_52.804050	1673	1743	33	2	70	0.0285714
NODE_1649_length_1778_cov_52.804050	1673	1743	34	3	70	0.0428571
NODE_1649_length_1778_cov_52.804050	1673	1743	36	1	70	0.0142857
NODE_1649_length_1778_cov_52.804050	1673	1743	38	1	70	0.0142857
NODE_1649_length_1778_cov_52.804050	1673	1743	39	1	70	0.0142857
NODE_1649_length_1778_cov_52.804050	1673	1743	41	2	70	0.0285714
NODE_1649_length_1778_cov_52.804050	1673	1743	42	4	70	0.0571429
NODE_1649_length_1778_cov_52.804050	1673	1743	44	3	70	0.0428571
NODE_1649_length_1778_cov_52.804050	1673	1743	47	3	70	0.0428571
NODE_1649_length_1778_cov_52.804050	1673	1743	53	1	70	0.0142857
NODE_1649_length_1778_cov_52.804050	1673	1743	55	1	70	0.0142857
NODE_1649_length_1778_cov_52.804050	1673	1743	57	2	70	0.0285714
NODE_1649_length_1778_cov_52.804050	1679	1750	13	4	71	0.0563380
NODE_1649_length_1778_cov_52.804050	1679	1750	14	5	71	0.0704225
NODE_1649_length_1778_cov_52.804050	1679	1750	17	1	71	0.0140845
NODE_1649_length_1778_cov_52.804050	1679	1750	19	6	71	0.0845070
NODE_1649_length_1778_cov_52.804050	1679	1750	20	6	71	0.0845070
NODE_1649_length_1778_cov_52.804050	1679	1750	21	1	71	0.0140845
NODE_1649_length_1778_cov_52.804050	1679	1750	22	4	71	0.0563380
NODE_1649_length_1778_cov_52.804050	1679	1750	23	8	71	0.1126761
NODE_1649_length_1778_cov_52.804050	1679	1750	24	2	71	0.0281690
NODE_1649_length_1778_cov_52.804050	1679	1750	25	1	71	0.0140845
NODE_1649_length_1778_cov_52.804050	1679	1750	27	6	71	0.0845070
NODE_1649_length_1778_cov_52.804050	1679	1750	28	3	71	0.0422535
NODE_1649_length_1778_cov_52.804050	1679	1750	32	6	71	0.0845070
NODE_1649_length_1778_cov_52.804050	1679	1750	33	2	71	0.0281690
NODE_1649_length_1778_cov_52.804050	1679	1750	34	3	71	0.0422535
NODE_1649_length_1778_cov_52.804050	1679	1750	36	1	71	0.0140845
NODE_1649_length_1778_cov_52.804050	1679	1750	38	1	71	0.0140845
NODE_1649_length_1778_cov_52.804050	1679	1750	39	1	71	0.0140845
NODE_1649_length_1778_cov_52.804050	1679	1750	41	2	71	0.0281690
NODE_1649_length_1778_cov_52.804050	1679	1750	42	4	71	0.0563380
NODE_1649_length_1778_cov_52.804050	1679	1750	44	3	71	0.0422535
NODE_1649_length_1778_cov_52.804050	1679	1750	47	1	71	0.0140845
NODE_1651_length_1776_cov_43.081694	1246	1308	6	11	62	0.1774193
NODE_1651_length_1776_cov_43.081694	1246	1308	7	24	62	0.3870968
NODE_1651_length_1776_cov_43.081694	1246	1308	8	20	62	0.3225806
NODE_1651_length_1776_cov_43.081694	1246	1308	10	2	62	0.0322581
NODE_1651_length_1776_cov_43.081694	1246	1308	14	4	62	0.0645161
NODE_1651_length_1776_cov_43.081694	1246	1308	35	1	62	0.0161290
NODE_1651_length_1776_cov_43.081694	1281	1361	7	14	80	0.1750000
NODE_1651_length_1776_cov_43.081694	1281	1361	8	26	80	0.3250000
NODE_1651_length_1776_cov_43.081694	1281	1361	9	32	80	0.4000000
NODE_1651_length_1776_cov_43.081694	1281	1361	10	8	80	0.1000000
NODE_1652_length_1776_cov_9.256410	1120	1200	2	50	80	0.6250000
NODE_1652_length_1776_cov_9.256410	1120	1200	3	30	80	0.3750000
NODE_1652_length_1776_cov_9.256410	1173	1253	1	6	80	0.0750000
NODE_1652_length_1776_cov_9.256410	1173	1253	2	72	80	0.9000000
NODE_1652_length_1776_cov_9.256410	1173	1253	3	2	80	0.0250000
NODE_1652_length_1776_cov_9.256410	1249	1329	1	80	80	1.0000000
NODE_1652_length_1776_cov_9.256410	1302	1382	0	9	80	0.1125000
NODE_1652_length_1776_cov_9.256410	1302	1382	1	71	80	0.8875000
NODE_1657_length_1775_cov_54.208234	1103	1167	46	2	64	0.0312500
NODE_1657_length_1775_cov_54.208234	1103	1167	47	4	64	0.0625000
NODE_1657_length_1775_cov_54.208234	1103	1167	49	1	64	0.0156250
NODE_1657_length_1775_cov_54.208234	1103	1167	50	1	64	0.0156250
NODE_1657_length_1775_cov_54.208234	1103	1167	53	1	64	0.0156250
NODE_1657_length_1775_cov_54.208234	1103	1167	55	1	64	0.0156250
NODE_1657_length_1775_cov_54.208234	1103	1167	57	1	64	0.0156250
NODE_1657_length_1775_cov_54.208234	1103	1167	58	1	64	0.0156250
NODE_1657_length_1775_cov_54.208234	1103	1167	60	2	64	0.0312500
NODE_1657_length_1775_cov_54.208234	1103	1167	62	1	64	0.0156250
NODE_1657_length_1775_cov_54.208234	1103	1167	64	6	64	0.0937500
NODE_1657_length_1775_cov_54.208234	1103	1167	65	1	64	0.0156250
NODE_1657_length_1775_cov_54.208234	1103	1167	68	2	64	0.0312500
NODE_1657_length_1775_cov_54.208234	1103	1167	70	4	64	0.0625000
NODE_1657_length_1775_cov_54.208234	1103	1167	71	10	64	0.1562500
NODE_1657_length_1775_cov_54.208234	1103	1167	72	2	64	0.0312500
NODE_1657_length_1775_cov_54.208234	1103	1167	73	2	64	0.0312500
NODE_1657_length_1775_cov_54.208234	1103	1167	74	9	64	0.1406250
NODE_1657_length_1775_cov_54.208234	1103	1167	75	4	64	0.0625000
NODE_1657_length_1775_cov_54.208234	1103	1167	76	5	64	0.0781250
NODE_1657_length_1775_cov_54.208234	1103	1167	77	1	64	0.0156250
NODE_1657_length_1775_cov_54.208234	1103	1167	78	3	64	0.0468750
NODE_1657_length_1775_cov_54.208234	1103	1167	46	2	64	0.0312500
NODE_1657_length_1775_cov_54.208234	1103	1167	47	4	64	0.0625000
NODE_1657_length_1775_cov_54.208234	1103	1167	49	1	64	0.0156250
NODE_1657_length_1775_cov_54.208234	1103	1167	50	1	64	0.0156250
NODE_1657_length_1775_cov_54.208234	1103	1167	53	1	64	0.0156250
NODE_1657_length_1775_cov_54.208234	1103	1167	55	1	64	0.0156250
NODE_1657_length_1775_cov_54.208234	1103	1167	57	1	64	0.0156250
NODE_1657_length_1775_cov_54.208234	1103	1167	58	1	64	0.0156250
NODE_1657_length_1775_cov_54.208234	1103	1167	60	2	64	0.0312500
NODE_1657_length_1775_cov_54.208234	1103	1167	62	1	64	0.0156250
NODE_1657_length_1775_cov_54.208234	1103	1167	64	6	64	0.0937500
NODE_1657_length_1775_cov_54.208234	1103	1167	65	1	64	0.0156250
NODE_1657_length_1775_cov_54.208234	1103	1167	68	2	64	0.0312500
NODE_1657_length_1775_cov_54.208234	1103	1167	70	4	64	0.0625000
NODE_1657_length_1775_cov_54.208234	1103	1167	71	10	64	0.1562500
NODE_1657_length_1775_cov_54.208234	1103	1167	72	2	64	0.0312500
NODE_1657_length_1775_cov_54.208234	1103	1167	73	2	64	0.0312500
NODE_1657_length_1775_cov_54.208234	1103	1167	74	9	64	0.1406250
NODE_1657_length_1775_cov_54.208234	1103	1167	75	4	64	0.0625000
NODE_1657_length_1775_cov_54.208234	1103	1167	76	5	64	0.0781250
NODE_1657_length_1775_cov_54.208234	1103	1167	77	1	64	0.0156250
NODE_1657_length_1775_cov_54.208234	1103	1167	78	3	64	0.0468750
NODE_1657_length_1775_cov_54.208234	1140	1200	41	2	60	0.0333333
NODE_1657_length_1775_cov_54.208234	1140	1200	42	7	60	0.1166667
NODE_1657_length_1775_cov_54.208234	1140	1200	43	4	60	0.0666667
NODE_1657_length_1775_cov_54.208234	1140	1200	44	5	60	0.0833333
NODE_1657_length_1775_cov_54.208234	1140	1200	45	5	60	0.0833333
NODE_1657_length_1775_cov_54.208234	1140	1200	46	8	60	0.1333333
NODE_1657_length_1775_cov_54.208234	1140	1200	47	6	60	0.1000000
NODE_1657_length_1775_cov_54.208234	1140	1200	48	2	60	0.0333333
NODE_1657_length_1775_cov_54.208234	1140	1200	49	1	60	0.0166667
NODE_1657_length_1775_cov_54.208234	1140	1200	50	1	60	0.0166667
NODE_1657_length_1775_cov_54.208234	1140	1200	53	1	60	0.0166667
NODE_1657_length_1775_cov_54.208234	1140	1200	55	1	60	0.0166667
NODE_1657_length_1775_cov_54.208234	1140	1200	57	1	60	0.0166667
NODE_1657_length_1775_cov_54.208234	1140	1200	58	1	60	0.0166667
NODE_1657_length_1775_cov_54.208234	1140	1200	60	2	60	0.0333333
NODE_1657_length_1775_cov_54.208234	1140	1200	62	1	60	0.0166667
NODE_1657_length_1775_cov_54.208234	1140	1200	64	6	60	0.1000000
NODE_1657_length_1775_cov_54.208234	1140	1200	65	1	60	0.0166667
NODE_1657_length_1775_cov_54.208234	1140	1200	68	2	60	0.0333333
NODE_1657_length_1775_cov_54.208234	1140	1200	71	3	60	0.0500000
NODE_1658_length_1775_cov_13.181981	1170	1250	0	80	80	1.0000000
NODE_1658_length_1775_cov_13.181981	1223	1303	0	80	80	1.0000000
NODE_1659_length_1775_cov_4.218974	1304	1384	1	22	80	0.2750000
NODE_1659_length_1775_cov_4.218974	1304	1384	2	55	80	0.6875000
NODE_1659_length_1775_cov_4.218974	1304	1384	3	3	80	0.0375000
NODE_1659_length_1775_cov_4.218974	1357	1437	1	75	80	0.9375000
NODE_1659_length_1775_cov_4.218974	1357	1437	2	5	80	0.0625000
NODE_1660_length_1774_cov_48.617313	345	425	2	80	80	1.0000000
NODE_1660_length_1774_cov_48.617313	398	478	0	28	80	0.3500000
NODE_1660_length_1774_cov_48.617313	398	478	2	52	80	0.6500000
NODE_1660_length_1774_cov_48.617313	474	554	0	80	80	1.0000000
NODE_1660_length_1774_cov_48.617313	527	607	0	80	80	1.0000000
NODE_1660_length_1774_cov_48.617313	1027	1107	6	6	80	0.0750000
NODE_1660_length_1774_cov_48.617313	1027	1107	7	66	80	0.8250000
NODE_1660_length_1774_cov_48.617313	1027	1107	8	8	80	0.1000000
NODE_1660_length_1774_cov_48.617313	1080	1160	6	22	80	0.2750000
NODE_1660_length_1774_cov_48.617313	1080	1160	7	21	80	0.2625000
NODE_1660_length_1774_cov_48.617313	1080	1160	8	30	80	0.3750000
NODE_1660_length_1774_cov_48.617313	1080	1160	9	7	80	0.0875000
NODE_1660_length_1774_cov_48.617313	1156	1236	4	60	80	0.7500000
NODE_1660_length_1774_cov_48.617313	1156	1236	5	1	80	0.0125000
NODE_1660_length_1774_cov_48.617313	1156	1236	6	19	80	0.2375000
NODE_1660_length_1774_cov_48.617313	1209	1289	1	10	80	0.1250000
NODE_1660_length_1774_cov_48.617313	1209	1289	2	30	80	0.3750000
NODE_1660_length_1774_cov_48.617313	1209	1289	3	5	80	0.0625000
NODE_1660_length_1774_cov_48.617313	1209	1289	4	35	80	0.4375000
NODE_1662_length_1774_cov_8.011343	1655	1735	0	80	80	1.0000000
NODE_1663_length_1773_cov_5.547192	433	513	1	56	80	0.7000000
NODE_1663_length_1773_cov_5.547192	433	513	3	24	80	0.3000000
NODE_1663_length_1773_cov_5.547192	486	566	1	3	80	0.0375000
NODE_1663_length_1773_cov_5.547192	486	566	2	20	80	0.2500000
NODE_1663_length_1773_cov_5.547192	486	566	3	57	80	0.7125000
NODE_1664_length_1773_cov_3.925329	267	347	2	4	80	0.0500000
NODE_1664_length_1773_cov_3.925329	267	347	4	9	80	0.1125000
NODE_1664_length_1773_cov_3.925329	267	347	6	67	80	0.8375000
NODE_1664_length_1773_cov_3.925329	320	400	0	18	80	0.2250000
NODE_1664_length_1773_cov_3.925329	320	400	1	32	80	0.4000000
NODE_1664_length_1773_cov_3.925329	320	400	2	7	80	0.0875000
NODE_1664_length_1773_cov_3.925329	320	400	4	9	80	0.1125000
NODE_1664_length_1773_cov_3.925329	320	400	6	14	80	0.1750000
NODE_1666_length_1770_cov_9.912029	369	437	2	35	68	0.5147059
NODE_1666_length_1770_cov_9.912029	369	437	4	33	68	0.4852941
NODE_1666_length_1770_cov_9.912029	388	431	2	29	43	0.6744186
NODE_1666_length_1770_cov_9.912029	388	431	4	14	43	0.3255814
NODE_1666_length_1770_cov_9.912029	509	577	3	6	68	0.0882353
NODE_1666_length_1770_cov_9.912029	509	577	5	62	68	0.9117647
NODE_1666_length_1770_cov_9.912029	515	571	5	56	56	1.0000000
NODE_1666_length_1770_cov_9.912029	579	618	0	39	39	1.0000000
NODE_1666_length_1770_cov_9.912029	697	776	0	41	79	0.5189874
NODE_1666_length_1770_cov_9.912029	697	776	2	17	79	0.2151899
NODE_1666_length_1770_cov_9.912029	697	776	4	21	79	0.2658228
NODE_1666_length_1770_cov_9.912029	714	794	0	24	80	0.3000000
NODE_1666_length_1770_cov_9.912029	714	794	2	17	80	0.2125000
NODE_1666_length_1770_cov_9.912029	714	794	4	39	80	0.4875000
NODE_1666_length_1770_cov_9.912029	767	819	4	30	52	0.5769231
NODE_1666_length_1770_cov_9.912029	767	819	5	22	52	0.4230769
NODE_1666_length_1770_cov_9.912029	785	819	4	12	34	0.3529412
NODE_1666_length_1770_cov_9.912029	785	819	5	22	34	0.6470588
NODE_1667_length_1768_cov_9.134811	687	736	40	1	49	0.0204082
NODE_1667_length_1768_cov_9.134811	687	736	41	2	49	0.0408163
NODE_1667_length_1768_cov_9.134811	687	736	42	12	49	0.2448980
NODE_1667_length_1768_cov_9.134811	687	736	43	10	49	0.2040816
NODE_1667_length_1768_cov_9.134811	687	736	44	5	49	0.1020408
NODE_1667_length_1768_cov_9.134811	687	736	45	14	49	0.2857143
NODE_1667_length_1768_cov_9.134811	687	736	46	3	49	0.0612245
NODE_1667_length_1768_cov_9.134811	687	736	47	2	49	0.0408163
NODE_1668_length_1768_cov_6.605153	1207	1287	1	80	80	1.0000000
NODE_1668_length_1768_cov_6.605153	1260	1340	1	80	80	1.0000000
NODE_1668_length_1768_cov_6.605153	1336	1416	1	15	80	0.1875000
NODE_1668_length_1768_cov_6.605153	1336	1416	2	61	80	0.7625000
NODE_1668_length_1768_cov_6.605153	1336	1416	3	4	80	0.0500000
NODE_1668_length_1768_cov_6.605153	1389	1469	2	80	80	1.0000000
NODE_1669_length_1767_cov_5.475420	508	588	19	2	80	0.0250000
NODE_1669_length_1767_cov_5.475420	508	588	20	6	80	0.0750000
NODE_1669_length_1767_cov_5.475420	508	588	21	13	80	0.1625000
NODE_1669_length_1767_cov_5.475420	508	588	22	5	80	0.0625000
NODE_1669_length_1767_cov_5.475420	508	588	23	46	80	0.5750000
NODE_1669_length_1767_cov_5.475420	508	588	25	8	80	0.1000000
NODE_1680_length_1762_cov_18.673482	606	686	0	1	80	0.0125000
NODE_1680_length_1762_cov_18.673482	606	686	1	79	80	0.9875000
NODE_1680_length_1762_cov_18.673482	659	739	1	34	80	0.4250000
NODE_1680_length_1762_cov_18.673482	659	739	2	46	80	0.5750000
NODE_1680_length_1762_cov_18.673482	735	815	1	59	80	0.7375000
NODE_1680_length_1762_cov_18.673482	735	815	2	21	80	0.2625000
NODE_1680_length_1762_cov_18.673482	788	868	0	45	80	0.5625000
NODE_1680_length_1762_cov_18.673482	788	868	1	35	80	0.4375000
NODE_1681_length_1762_cov_6.760072	1033	1113	1	6	80	0.0750000
NODE_1681_length_1762_cov_6.760072	1033	1113	2	17	80	0.2125000
NODE_1681_length_1762_cov_6.760072	1033	1113	3	57	80	0.7125000
NODE_1681_length_1762_cov_6.760072	1086	1166	1	38	80	0.4750000
NODE_1681_length_1762_cov_6.760072	1086	1166	2	22	80	0.2750000
NODE_1681_length_1762_cov_6.760072	1086	1166	3	20	80	0.2500000
NODE_1685_length_1760_cov_8.064419	941	1021	1	38	80	0.4750000
NODE_1685_length_1760_cov_8.064419	941	1021	2	42	80	0.5250000
NODE_1685_length_1760_cov_8.064419	994	1074	2	63	80	0.7875000
NODE_1685_length_1760_cov_8.064419	994	1074	3	17	80	0.2125000
NODE_1692_length_1758_cov_99.869198	599	679	10	8	80	0.1000000
NODE_1692_length_1758_cov_99.869198	599	679	11	17	80	0.2125000
NODE_1692_length_1758_cov_99.869198	599	679	12	22	80	0.2750000
NODE_1692_length_1758_cov_99.869198	599	679	13	33	80	0.4125000
NODE_1692_length_1758_cov_99.869198	652	732	10	8	80	0.1000000
NODE_1692_length_1758_cov_99.869198	652	732	11	10	80	0.1250000
NODE_1692_length_1758_cov_99.869198	652	732	12	15	80	0.1875000
NODE_1692_length_1758_cov_99.869198	652	732	13	6	80	0.0750000
NODE_1692_length_1758_cov_99.869198	652	732	14	3	80	0.0375000
NODE_1692_length_1758_cov_99.869198	652	732	15	6	80	0.0750000
NODE_1692_length_1758_cov_99.869198	652	732	16	16	80	0.2000000
NODE_1692_length_1758_cov_99.869198	652	732	17	14	80	0.1750000
NODE_1692_length_1758_cov_99.869198	652	732	18	2	80	0.0250000
NODE_1692_length_1758_cov_99.869198	728	808	17	3	80	0.0375000
NODE_1692_length_1758_cov_99.869198	728	808	18	2	80	0.0250000
NODE_1692_length_1758_cov_99.869198	728	808	19	8	80	0.1000000
NODE_1692_length_1758_cov_99.869198	728	808	20	2	80	0.0250000
NODE_1692_length_1758_cov_99.869198	728	808	21	5	80	0.0625000
NODE_1692_length_1758_cov_99.869198	728	808	22	14	80	0.1750000
NODE_1692_length_1758_cov_99.869198	728	808	23	15	80	0.1875000
NODE_1692_length_1758_cov_99.869198	728	808	24	10	80	0.1250000
NODE_1692_length_1758_cov_99.869198	728	808	25	3	80	0.0375000
NODE_1692_length_1758_cov_99.869198	728	808	26	15	80	0.1875000
NODE_1692_length_1758_cov_99.869198	728	808	27	3	80	0.0375000
NODE_1692_length_1758_cov_99.869198	781	861	16	1	80	0.0125000
NODE_1692_length_1758_cov_99.869198	781	861	17	9	80	0.1125000
NODE_1692_length_1758_cov_99.869198	781	861	18	4	80	0.0500000
NODE_1692_length_1758_cov_99.869198	781	861	19	6	80	0.0750000
NODE_1692_length_1758_cov_99.869198	781	861	21	6	80	0.0750000
NODE_1692_length_1758_cov_99.869198	781	861	23	16	80	0.2000000
NODE_1692_length_1758_cov_99.869198	781	861	24	13	80	0.1625000
NODE_1692_length_1758_cov_99.869198	781	861	25	4	80	0.0500000
NODE_1692_length_1758_cov_99.869198	781	861	26	18	80	0.2250000
NODE_1692_length_1758_cov_99.869198	781	861	27	3	80	0.0375000
NODE_1693_length_1757_cov_3.126659	49	121	2	72	72	1.0000000
NODE_1696_length_1755_cov_9.938406	231	311	1	4	80	0.0500000
NODE_1696_length_1755_cov_9.938406	231	311	3	23	80	0.2875000
NODE_1696_length_1755_cov_9.938406	231	311	4	53	80	0.6625000
NODE_1696_length_1755_cov_9.938406	284	364	1	17	80	0.2125000
NODE_1696_length_1755_cov_9.938406	284	364	2	9	80	0.1125000
NODE_1696_length_1755_cov_9.938406	284	364	3	54	80	0.6750000
NODE_1698_length_1755_cov_3.614130	171	222	2	5	51	0.0980392
NODE_1698_length_1755_cov_3.614130	171	222	3	7	51	0.1372549
NODE_1698_length_1755_cov_3.614130	171	222	5	5	51	0.0980392
NODE_1698_length_1755_cov_3.614130	171	222	6	5	51	0.0980392
NODE_1698_length_1755_cov_3.614130	171	222	7	8	51	0.1568628
NODE_1698_length_1755_cov_3.614130	171	222	8	14	51	0.2745098
NODE_1698_length_1755_cov_3.614130	171	222	9	7	51	0.1372549
NODE_1699_length_1754_cov_8.523263	0	77	0	77	77	1.0000000
NODE_1699_length_1754_cov_8.523263	0	77	0	77	77	1.0000000
NODE_1699_length_1754_cov_8.523263	0	77	0	77	77	1.0000000
NODE_1699_length_1754_cov_8.523263	50	99	0	49	49	1.0000000
NODE_1699_length_1754_cov_8.523263	53	99	0	46	46	1.0000000
NODE_1699_length_1754_cov_8.523263	55	99	0	44	44	1.0000000
NODE_1700_length_1753_cov_26.851874	356	436	0	26	80	0.3250000
NODE_1700_length_1753_cov_26.851874	356	436	2	54	80	0.6750000
NODE_1700_length_1753_cov_26.851874	409	489	2	80	80	1.0000000
NODE_1701_length_1753_cov_12.297461	355	435	0	80	80	1.0000000
NODE_1701_length_1753_cov_12.297461	408	488	0	80	80	1.0000000
NODE_1705_length_1750_cov_90.732283	1191	1254	392	2	63	0.0317460
NODE_1705_length_1750_cov_90.732283	1191	1254	393	2	63	0.0317460
NODE_1705_length_1750_cov_90.732283	1191	1254	394	1	63	0.0158730
NODE_1705_length_1750_cov_90.732283	1191	1254	395	1	63	0.0158730
NODE_1705_length_1750_cov_90.732283	1191	1254	398	3	63	0.0476190
NODE_1705_length_1750_cov_90.732283	1191	1254	399	2	63	0.0317460
NODE_1705_length_1750_cov_90.732283	1191	1254	400	2	63	0.0317460
NODE_1705_length_1750_cov_90.732283	1191	1254	401	2	63	0.0317460
NODE_1705_length_1750_cov_90.732283	1191	1254	402	4	63	0.0634921
NODE_1705_length_1750_cov_90.732283	1191	1254	403	2	63	0.0317460
NODE_1705_length_1750_cov_90.732283	1191	1254	404	1	63	0.0158730
NODE_1705_length_1750_cov_90.732283	1191	1254	405	2	63	0.0317460
NODE_1705_length_1750_cov_90.732283	1191	1254	406	2	63	0.0317460
NODE_1705_length_1750_cov_90.732283	1191	1254	407	1	63	0.0158730
NODE_1705_length_1750_cov_90.732283	1191	1254	408	8	63	0.1269841
NODE_1705_length_1750_cov_90.732283	1191	1254	410	3	63	0.0476190
NODE_1705_length_1750_cov_90.732283	1191	1254	411	2	63	0.0317460
NODE_1705_length_1750_cov_90.732283	1191	1254	412	2	63	0.0317460
NODE_1705_length_1750_cov_90.732283	1191	1254	415	1	63	0.0158730
NODE_1705_length_1750_cov_90.732283	1191	1254	416	2	63	0.0317460
NODE_1705_length_1750_cov_90.732283	1191	1254	417	2	63	0.0317460
NODE_1705_length_1750_cov_90.732283	1191	1254	418	2	63	0.0317460
NODE_1705_length_1750_cov_90.732283	1191	1254	419	1	63	0.0158730
NODE_1705_length_1750_cov_90.732283	1191	1254	421	1	63	0.0158730
NODE_1705_length_1750_cov_90.732283	1191	1254	423	1	63	0.0158730
NODE_1705_length_1750_cov_90.732283	1191	1254	426	1	63	0.0158730
NODE_1705_length_1750_cov_90.732283	1191	1254	428	3	63	0.0476190
NODE_1705_length_1750_cov_90.732283	1191	1254	429	2	63	0.0317460
NODE_1705_length_1750_cov_90.732283	1191	1254	432	1	63	0.0158730
NODE_1705_length_1750_cov_90.732283	1191	1254	433	1	63	0.0158730
NODE_1705_length_1750_cov_90.732283	1191	1254	434	2	63	0.0317460
NODE_1705_length_1750_cov_90.732283	1191	1254	435	1	63	0.0158730
NODE_1705_length_1750_cov_90.732283	1239	1310	372	1	71	0.0140845
NODE_1705_length_1750_cov_90.732283	1239	1310	373	1	71	0.0140845
NODE_1705_length_1750_cov_90.732283	1239	1310	378	1	71	0.0140845
NODE_1705_length_1750_cov_90.732283	1239	1310	380	2	71	0.0281690
NODE_1705_length_1750_cov_90.732283	1239	1310	381	3	71	0.0422535
NODE_1705_length_1750_cov_90.732283	1239	1310	382	5	71	0.0704225
NODE_1705_length_1750_cov_90.732283	1239	1310	383	1	71	0.0140845
NODE_1705_length_1750_cov_90.732283	1239	1310	384	4	71	0.0563380
NODE_1705_length_1750_cov_90.732283	1239	1310	385	4	71	0.0563380
NODE_1705_length_1750_cov_90.732283	1239	1310	386	2	71	0.0281690
NODE_1705_length_1750_cov_90.732283	1239	1310	387	2	71	0.0281690
NODE_1705_length_1750_cov_90.732283	1239	1310	389	1	71	0.0140845
NODE_1705_length_1750_cov_90.732283	1239	1310	390	1	71	0.0140845
NODE_1705_length_1750_cov_90.732283	1239	1310	391	2	71	0.0281690
NODE_1705_length_1750_cov_90.732283	1239	1310	392	1	71	0.0140845
NODE_1705_length_1750_cov_90.732283	1239	1310	393	4	71	0.0563380
NODE_1705_length_1750_cov_90.732283	1239	1310	394	2	71	0.0281690
NODE_1705_length_1750_cov_90.732283	1239	1310	395	1	71	0.0140845
NODE_1705_length_1750_cov_90.732283	1239	1310	397	1	71	0.0140845
NODE_1705_length_1750_cov_90.732283	1239	1310	399	1	71	0.0140845
NODE_1705_length_1750_cov_90.732283	1239	1310	400	1	71	0.0140845
NODE_1705_length_1750_cov_90.732283	1239	1310	401	3	71	0.0422535
NODE_1705_length_1750_cov_90.732283	1239	1310	402	4	71	0.0563380
NODE_1705_length_1750_cov_90.732283	1239	1310	403	5	71	0.0704225
NODE_1705_length_1750_cov_90.732283	1239	1310	404	1	71	0.0140845
NODE_1705_length_1750_cov_90.732283	1239	1310	406	5	71	0.0704225
NODE_1705_length_1750_cov_90.732283	1239	1310	412	1	71	0.0140845
NODE_1705_length_1750_cov_90.732283	1239	1310	418	1	71	0.0140845
NODE_1705_length_1750_cov_90.732283	1239	1310	426	1	71	0.0140845
NODE_1705_length_1750_cov_90.732283	1239	1310	428	3	71	0.0422535
NODE_1705_length_1750_cov_90.732283	1239	1310	429	1	71	0.0140845
NODE_1705_length_1750_cov_90.732283	1239	1310	432	1	71	0.0140845
NODE_1705_length_1750_cov_90.732283	1239	1310	433	1	71	0.0140845
NODE_1705_length_1750_cov_90.732283	1239	1310	434	2	71	0.0281690
NODE_1705_length_1750_cov_90.732283	1239	1310	435	1	71	0.0140845
NODE_1711_length_1746_cov_3.095932	458	524	0	11	66	0.1666667
NODE_1711_length_1746_cov_3.095932	458	524	1	35	66	0.5303030
NODE_1711_length_1746_cov_3.095932	458	524	2	12	66	0.1818182
NODE_1711_length_1746_cov_3.095932	458	524	3	8	66	0.1212121
NODE_1712_length_1745_cov_7.646416	430	510	0	80	80	1.0000000
NODE_1712_length_1745_cov_7.646416	483	563	0	80	80	1.0000000
NODE_1715_length_1744_cov_10.144681	1213	1289	7	31	76	0.4078947
NODE_1715_length_1744_cov_10.144681	1213	1289	8	8	76	0.1052632
NODE_1715_length_1744_cov_10.144681	1213	1289	9	37	76	0.4868421
NODE_1715_length_1744_cov_10.144681	1262	1342	4	3	80	0.0375000
NODE_1715_length_1744_cov_10.144681	1262	1342	5	15	80	0.1875000
NODE_1715_length_1744_cov_10.144681	1262	1342	6	5	80	0.0625000
NODE_1715_length_1744_cov_10.144681	1262	1342	7	43	80	0.5375000
NODE_1715_length_1744_cov_10.144681	1262	1342	9	14	80	0.1750000
NODE_1719_length_1742_cov_18.923311	699	776	0	77	77	1.0000000
NODE_1719_length_1742_cov_18.923311	749	829	0	80	80	1.0000000
NODE_1722_length_1741_cov_7.657734	1234	1314	2	23	80	0.2875000
NODE_1722_length_1741_cov_7.657734	1234	1314	3	36	80	0.4500000
NODE_1722_length_1741_cov_7.657734	1234	1314	4	8	80	0.1000000
NODE_1722_length_1741_cov_7.657734	1234	1314	5	13	80	0.1625000
NODE_1722_length_1741_cov_7.657734	1287	1367	3	6	80	0.0750000
NODE_1722_length_1741_cov_7.657734	1287	1367	4	46	80	0.5750000
NODE_1722_length_1741_cov_7.657734	1287	1367	5	28	80	0.3500000
NODE_1722_length_1741_cov_7.657734	1363	1443	2	36	80	0.4500000
NODE_1722_length_1741_cov_7.657734	1363	1443	3	30	80	0.3750000
NODE_1722_length_1741_cov_7.657734	1363	1443	4	14	80	0.1750000
NODE_1722_length_1741_cov_7.657734	1416	1496	0	45	80	0.5625000
NODE_1722_length_1741_cov_7.657734	1416	1496	1	8	80	0.1000000
NODE_1722_length_1741_cov_7.657734	1416	1496	2	27	80	0.3375000
NODE_1726_length_1740_cov_38.411335	517	597	7	3	80	0.0375000
NODE_1726_length_1740_cov_38.411335	517	597	8	6	80	0.0750000
NODE_1726_length_1740_cov_38.411335	517	597	10	46	80	0.5750000
NODE_1726_length_1740_cov_38.411335	517	597	11	17	80	0.2125000
NODE_1726_length_1740_cov_38.411335	517	597	12	8	80	0.1000000
NODE_1726_length_1740_cov_38.411335	570	650	8	8	80	0.1000000
NODE_1726_length_1740_cov_38.411335	570	650	9	8	80	0.1000000
NODE_1726_length_1740_cov_38.411335	570	650	10	33	80	0.4125000
NODE_1726_length_1740_cov_38.411335	570	650	11	11	80	0.1375000
NODE_1726_length_1740_cov_38.411335	570	650	12	9	80	0.1125000
NODE_1726_length_1740_cov_38.411335	570	650	13	11	80	0.1375000
NODE_1726_length_1740_cov_38.411335	646	726	4	1	80	0.0125000
NODE_1726_length_1740_cov_38.411335	646	726	5	42	80	0.5250000
NODE_1726_length_1740_cov_38.411335	646	726	7	13	80	0.1625000
NODE_1726_length_1740_cov_38.411335	646	726	8	24	80	0.3000000
NODE_1726_length_1740_cov_38.411335	699	779	1	2	80	0.0250000
NODE_1726_length_1740_cov_38.411335	699	779	2	28	80	0.3500000
NODE_1726_length_1740_cov_38.411335	699	779	3	9	80	0.1125000
NODE_1726_length_1740_cov_38.411335	699	779	4	3	80	0.0375000
NODE_1726_length_1740_cov_38.411335	699	779	5	38	80	0.4750000
NODE_1727_length_1740_cov_10.843388	552	632	0	11	80	0.1375000
NODE_1727_length_1740_cov_10.843388	552	632	2	17	80	0.2125000
NODE_1727_length_1740_cov_10.843388	552	632	6	52	80	0.6500000
NODE_1727_length_1740_cov_10.843388	708	788	0	4	80	0.0500000
NODE_1727_length_1740_cov_10.843388	708	788	2	61	80	0.7625000
NODE_1727_length_1740_cov_10.843388	708	788	4	15	80	0.1875000
NODE_1727_length_1740_cov_10.843388	708	788	0	4	80	0.0500000
NODE_1727_length_1740_cov_10.843388	708	788	2	61	80	0.7625000
NODE_1727_length_1740_cov_10.843388	708	788	4	15	80	0.1875000
NODE_1727_length_1740_cov_10.843388	708	788	0	4	80	0.0500000
NODE_1727_length_1740_cov_10.843388	708	788	2	61	80	0.7625000
NODE_1727_length_1740_cov_10.843388	708	788	4	15	80	0.1875000
NODE_1727_length_1740_cov_10.843388	761	841	0	10	80	0.1250000
NODE_1727_length_1740_cov_10.843388	761	841	1	47	80	0.5875000
NODE_1727_length_1740_cov_10.843388	761	841	2	23	80	0.2875000
NODE_1727_length_1740_cov_10.843388	761	808	0	10	47	0.2127660
NODE_1727_length_1740_cov_10.843388	761	808	1	14	47	0.2978723
NODE_1727_length_1740_cov_10.843388	761	808	2	23	47	0.4893617
NODE_1727_length_1740_cov_10.843388	761	808	0	10	47	0.2127660
NODE_1727_length_1740_cov_10.843388	761	808	1	14	47	0.2978723
NODE_1727_length_1740_cov_10.843388	761	808	2	23	47	0.4893617
NODE_1737_length_1736_cov_71.959682	841	901	102	2	60	0.0333333
NODE_1737_length_1736_cov_71.959682	841	901	103	8	60	0.1333333
NODE_1737_length_1736_cov_71.959682	841	901	104	5	60	0.0833333
NODE_1737_length_1736_cov_71.959682	841	901	105	2	60	0.0333333
NODE_1737_length_1736_cov_71.959682	841	901	106	7	60	0.1166667
NODE_1737_length_1736_cov_71.959682	841	901	107	4	60	0.0666667
NODE_1737_length_1736_cov_71.959682	841	901	108	4	60	0.0666667
NODE_1737_length_1736_cov_71.959682	841	901	109	1	60	0.0166667
NODE_1737_length_1736_cov_71.959682	841	901	110	4	60	0.0666667
NODE_1737_length_1736_cov_71.959682	841	901	111	5	60	0.0833333
NODE_1737_length_1736_cov_71.959682	841	901	112	1	60	0.0166667
NODE_1737_length_1736_cov_71.959682	841	901	113	2	60	0.0333333
NODE_1737_length_1736_cov_71.959682	841	901	114	7	60	0.1166667
NODE_1737_length_1736_cov_71.959682	841	901	115	2	60	0.0333333
NODE_1737_length_1736_cov_71.959682	841	901	116	6	60	0.1000000
NODE_1738_length_1736_cov_29.174710	1361	1390	71	1	29	0.0344828
NODE_1738_length_1736_cov_29.174710	1361	1390	72	7	29	0.2413793
NODE_1738_length_1736_cov_29.174710	1361	1390	73	2	29	0.0689655
NODE_1738_length_1736_cov_29.174710	1361	1390	74	4	29	0.1379310
NODE_1738_length_1736_cov_29.174710	1361	1390	75	7	29	0.2413793
NODE_1738_length_1736_cov_29.174710	1361	1390	77	2	29	0.0689655
NODE_1738_length_1736_cov_29.174710	1361	1390	78	2	29	0.0689655
NODE_1738_length_1736_cov_29.174710	1361	1390	80	2	29	0.0689655
NODE_1738_length_1736_cov_29.174710	1361	1390	81	2	29	0.0689655
NODE_1738_length_1736_cov_29.174710	1566	1628	94	9	62	0.1451613
NODE_1738_length_1736_cov_29.174710	1566	1628	95	1	62	0.0161290
NODE_1738_length_1736_cov_29.174710	1566	1628	96	1	62	0.0161290
NODE_1738_length_1736_cov_29.174710	1566	1628	97	3	62	0.0483871
NODE_1738_length_1736_cov_29.174710	1566	1628	98	1	62	0.0161290
NODE_1738_length_1736_cov_29.174710	1566	1628	99	1	62	0.0161290
NODE_1738_length_1736_cov_29.174710	1566	1628	100	2	62	0.0322581
NODE_1738_length_1736_cov_29.174710	1566	1628	101	5	62	0.0806452
NODE_1738_length_1736_cov_29.174710	1566	1628	102	3	62	0.0483871
NODE_1738_length_1736_cov_29.174710	1566	1628	103	1	62	0.0161290
NODE_1738_length_1736_cov_29.174710	1566	1628	105	1	62	0.0161290
NODE_1738_length_1736_cov_29.174710	1566	1628	106	2	62	0.0322581
NODE_1738_length_1736_cov_29.174710	1566	1628	107	4	62	0.0645161
NODE_1738_length_1736_cov_29.174710	1566	1628	108	11	62	0.1774193
NODE_1738_length_1736_cov_29.174710	1566	1628	109	7	62	0.1129032
NODE_1738_length_1736_cov_29.174710	1566	1628	110	4	62	0.0645161
NODE_1738_length_1736_cov_29.174710	1566	1628	111	5	62	0.0806452
NODE_1738_length_1736_cov_29.174710	1566	1628	112	1	62	0.0161290
NODE_1743_length_1732_cov_6.162890	807	887	0	9	80	0.1125000
NODE_1743_length_1732_cov_6.162890	807	887	1	17	80	0.2125000
NODE_1743_length_1732_cov_6.162890	807	887	2	54	80	0.6750000
NODE_1743_length_1732_cov_6.162890	860	940	2	80	80	1.0000000
NODE_1749_length_1729_cov_23.708589	364	443	1	76	79	0.9620253
NODE_1749_length_1729_cov_23.708589	364	443	2	3	79	0.0379747
NODE_1749_length_1729_cov_23.708589	416	496	1	47	80	0.5875000
NODE_1749_length_1729_cov_23.708589	416	496	2	33	80	0.4125000
NODE_1749_length_1729_cov_23.708589	492	572	1	61	80	0.7625000
NODE_1749_length_1729_cov_23.708589	492	572	3	19	80	0.2375000
NODE_1749_length_1729_cov_23.708589	545	625	1	8	80	0.1000000
NODE_1749_length_1729_cov_23.708589	545	625	3	30	80	0.3750000
NODE_1749_length_1729_cov_23.708589	545	625	4	18	80	0.2250000
NODE_1749_length_1729_cov_23.708589	545	625	5	24	80	0.3000000
NODE_1753_length_1728_cov_26.505832	259	339	0	40	80	0.5000000
NODE_1753_length_1728_cov_26.505832	259	339	1	40	80	0.5000000
NODE_1753_length_1728_cov_26.505832	312	392	0	80	80	1.0000000
NODE_1757_length_1725_cov_142.158057	767	814	392	1	47	0.0212766
NODE_1757_length_1725_cov_142.158057	767	814	393	1	47	0.0212766
NODE_1757_length_1725_cov_142.158057	767	814	394	1	47	0.0212766
NODE_1757_length_1725_cov_142.158057	767	814	400	1	47	0.0212766
NODE_1757_length_1725_cov_142.158057	767	814	405	2	47	0.0425532
NODE_1757_length_1725_cov_142.158057	767	814	406	2	47	0.0425532
NODE_1757_length_1725_cov_142.158057	767	814	409	1	47	0.0212766
NODE_1757_length_1725_cov_142.158057	767	814	414	1	47	0.0212766
NODE_1757_length_1725_cov_142.158057	767	814	419	1	47	0.0212766
NODE_1757_length_1725_cov_142.158057	767	814	420	1	47	0.0212766
NODE_1757_length_1725_cov_142.158057	767	814	426	1	47	0.0212766
NODE_1757_length_1725_cov_142.158057	767	814	429	2	47	0.0425532
NODE_1757_length_1725_cov_142.158057	767	814	430	2	47	0.0425532
NODE_1757_length_1725_cov_142.158057	767	814	431	1	47	0.0212766
NODE_1757_length_1725_cov_142.158057	767	814	432	2	47	0.0425532
NODE_1757_length_1725_cov_142.158057	767	814	433	1	47	0.0212766
NODE_1757_length_1725_cov_142.158057	767	814	440	1	47	0.0212766
NODE_1757_length_1725_cov_142.158057	767	814	441	1	47	0.0212766
NODE_1757_length_1725_cov_142.158057	767	814	442	1	47	0.0212766
NODE_1757_length_1725_cov_142.158057	767	814	450	1	47	0.0212766
NODE_1757_length_1725_cov_142.158057	767	814	459	1	47	0.0212766
NODE_1757_length_1725_cov_142.158057	767	814	463	1	47	0.0212766
NODE_1757_length_1725_cov_142.158057	767	814	464	2	47	0.0425532
NODE_1757_length_1725_cov_142.158057	767	814	465	2	47	0.0425532
NODE_1757_length_1725_cov_142.158057	767	814	466	4	47	0.0851064
NODE_1757_length_1725_cov_142.158057	767	814	467	4	47	0.0851064
NODE_1757_length_1725_cov_142.158057	767	814	468	3	47	0.0638298
NODE_1757_length_1725_cov_142.158057	767	814	469	1	47	0.0212766
NODE_1757_length_1725_cov_142.158057	767	814	470	2	47	0.0425532
NODE_1757_length_1725_cov_142.158057	767	814	472	2	47	0.0425532
NODE_1757_length_1725_cov_142.158057	803	867	447	1	64	0.0156250
NODE_1757_length_1725_cov_142.158057	803	867	448	1	64	0.0156250
NODE_1757_length_1725_cov_142.158057	803	867	449	1	64	0.0156250
NODE_1757_length_1725_cov_142.158057	803	867	455	1	64	0.0156250
NODE_1757_length_1725_cov_142.158057	803	867	459	1	64	0.0156250
NODE_1757_length_1725_cov_142.158057	803	867	462	4	64	0.0625000
NODE_1757_length_1725_cov_142.158057	803	867	463	2	64	0.0312500
NODE_1757_length_1725_cov_142.158057	803	867	464	2	64	0.0312500
NODE_1757_length_1725_cov_142.158057	803	867	465	2	64	0.0312500
NODE_1757_length_1725_cov_142.158057	803	867	466	3	64	0.0468750
NODE_1757_length_1725_cov_142.158057	803	867	467	3	64	0.0468750
NODE_1757_length_1725_cov_142.158057	803	867	468	1	64	0.0156250
NODE_1757_length_1725_cov_142.158057	803	867	469	3	64	0.0468750
NODE_1757_length_1725_cov_142.158057	803	867	470	2	64	0.0312500
NODE_1757_length_1725_cov_142.158057	803	867	471	2	64	0.0312500
NODE_1757_length_1725_cov_142.158057	803	867	472	2	64	0.0312500
NODE_1757_length_1725_cov_142.158057	803	867	473	1	64	0.0156250
NODE_1757_length_1725_cov_142.158057	803	867	474	2	64	0.0312500
NODE_1757_length_1725_cov_142.158057	803	867	475	5	64	0.0781250
NODE_1757_length_1725_cov_142.158057	803	867	476	3	64	0.0468750
NODE_1757_length_1725_cov_142.158057	803	867	477	1	64	0.0156250
NODE_1757_length_1725_cov_142.158057	803	867	479	1	64	0.0156250
NODE_1757_length_1725_cov_142.158057	803	867	480	3	64	0.0468750
NODE_1757_length_1725_cov_142.158057	803	867	481	3	64	0.0468750
NODE_1757_length_1725_cov_142.158057	803	867	482	2	64	0.0312500
NODE_1757_length_1725_cov_142.158057	803	867	483	1	64	0.0156250
NODE_1757_length_1725_cov_142.158057	803	867	484	1	64	0.0156250
NODE_1757_length_1725_cov_142.158057	803	867	485	1	64	0.0156250
NODE_1757_length_1725_cov_142.158057	803	867	486	1	64	0.0156250
NODE_1757_length_1725_cov_142.158057	803	867	487	2	64	0.0312500
NODE_1757_length_1725_cov_142.158057	803	867	488	1	64	0.0156250
NODE_1757_length_1725_cov_142.158057	803	867	490	2	64	0.0312500
NODE_1757_length_1725_cov_142.158057	803	867	491	3	64	0.0468750
NODE_1759_length_1724_cov_17.931077	677	746	0	21	69	0.3043478
NODE_1759_length_1724_cov_17.931077	677	746	1	9	69	0.1304348
NODE_1759_length_1724_cov_17.931077	677	746	2	30	69	0.4347826
NODE_1759_length_1724_cov_17.931077	677	746	3	9	69	0.1304348
NODE_1759_length_1724_cov_17.931077	788	850	3	62	62	1.0000000
NODE_1761_length_1723_cov_35.355296	1174	1254	0	11	80	0.1375000
NODE_1761_length_1723_cov_35.355296	1174	1254	2	64	80	0.8000000
NODE_1761_length_1723_cov_35.355296	1174	1254	3	5	80	0.0625000
NODE_1761_length_1723_cov_35.355296	1227	1307	0	11	80	0.1375000
NODE_1761_length_1723_cov_35.355296	1227	1307	1	53	80	0.6625000
NODE_1761_length_1723_cov_35.355296	1227	1307	2	16	80	0.2000000
NODE_1763_length_1722_cov_13.235367	708	788	4	8	80	0.1000000
NODE_1763_length_1722_cov_13.235367	708	788	5	37	80	0.4625000
NODE_1763_length_1722_cov_13.235367	708	788	6	35	80	0.4375000
NODE_1763_length_1722_cov_13.235367	761	841	2	3	80	0.0375000
NODE_1763_length_1722_cov_13.235367	761	841	3	50	80	0.6250000
NODE_1763_length_1722_cov_13.235367	761	841	4	8	80	0.1000000
NODE_1763_length_1722_cov_13.235367	761	841	5	15	80	0.1875000
NODE_1763_length_1722_cov_13.235367	761	841	6	4	80	0.0500000
NODE_1763_length_1722_cov_13.235367	1319	1399	0	80	80	1.0000000
NODE_1763_length_1722_cov_13.235367	1372	1452	0	80	80	1.0000000
NODE_1765_length_1720_cov_27.328192	1248	1307	56	1	59	0.0169492
NODE_1765_length_1720_cov_27.328192	1248	1307	58	1	59	0.0169492
NODE_1765_length_1720_cov_27.328192	1248	1307	61	2	59	0.0338983
NODE_1765_length_1720_cov_27.328192	1248	1307	62	4	59	0.0677966
NODE_1765_length_1720_cov_27.328192	1248	1307	63	10	59	0.1694915
NODE_1765_length_1720_cov_27.328192	1248	1307	64	18	59	0.3050847
NODE_1765_length_1720_cov_27.328192	1248	1307	65	3	59	0.0508475
NODE_1765_length_1720_cov_27.328192	1248	1307	66	13	59	0.2203390
NODE_1765_length_1720_cov_27.328192	1248	1307	67	7	59	0.1186441
NODE_1765_length_1720_cov_27.328192	1280	1360	44	1	80	0.0125000
NODE_1765_length_1720_cov_27.328192	1280	1360	45	5	80	0.0625000
NODE_1765_length_1720_cov_27.328192	1280	1360	46	4	80	0.0500000
NODE_1765_length_1720_cov_27.328192	1280	1360	47	6	80	0.0750000
NODE_1765_length_1720_cov_27.328192	1280	1360	48	3	80	0.0375000
NODE_1765_length_1720_cov_27.328192	1280	1360	49	3	80	0.0375000
NODE_1765_length_1720_cov_27.328192	1280	1360	50	3	80	0.0375000
NODE_1765_length_1720_cov_27.328192	1280	1360	51	3	80	0.0375000
NODE_1765_length_1720_cov_27.328192	1280	1360	52	2	80	0.0250000
NODE_1765_length_1720_cov_27.328192	1280	1360	53	5	80	0.0625000
NODE_1765_length_1720_cov_27.328192	1280	1360	55	1	80	0.0125000
NODE_1765_length_1720_cov_27.328192	1280	1360	57	5	80	0.0625000
NODE_1765_length_1720_cov_27.328192	1280	1360	58	4	80	0.0500000
NODE_1765_length_1720_cov_27.328192	1280	1360	60	2	80	0.0250000
NODE_1765_length_1720_cov_27.328192	1280	1360	62	2	80	0.0250000
NODE_1765_length_1720_cov_27.328192	1280	1360	63	3	80	0.0375000
NODE_1765_length_1720_cov_27.328192	1280	1360	64	6	80	0.0750000
NODE_1765_length_1720_cov_27.328192	1280	1360	65	2	80	0.0250000
NODE_1765_length_1720_cov_27.328192	1280	1360	66	13	80	0.1625000
NODE_1765_length_1720_cov_27.328192	1280	1360	67	7	80	0.0875000
NODE_1766_length_1720_cov_4.129550	241	321	6	1	80	0.0125000
NODE_1766_length_1720_cov_4.129550	241	321	8	20	80	0.2500000
NODE_1766_length_1720_cov_4.129550	241	321	9	15	80	0.1875000
NODE_1766_length_1720_cov_4.129550	241	321	10	12	80	0.1500000
NODE_1766_length_1720_cov_4.129550	241	321	11	14	80	0.1750000
NODE_1766_length_1720_cov_4.129550	241	321	12	15	80	0.1875000
NODE_1766_length_1720_cov_4.129550	241	321	13	3	80	0.0375000
NODE_1766_length_1720_cov_4.129550	294	374	9	7	80	0.0875000
NODE_1766_length_1720_cov_4.129550	294	374	11	29	80	0.3625000
NODE_1766_length_1720_cov_4.129550	294	374	12	41	80	0.5125000
NODE_1766_length_1720_cov_4.129550	294	374	13	3	80	0.0375000
NODE_1768_length_1719_cov_9.878395	410	490	0	56	80	0.7000000
NODE_1768_length_1719_cov_9.878395	410	490	1	24	80	0.3000000
NODE_1768_length_1719_cov_9.878395	463	543	0	3	80	0.0375000
NODE_1768_length_1719_cov_9.878395	463	543	1	77	80	0.9625000
NODE_1768_length_1719_cov_9.878395	539	619	1	15	80	0.1875000
NODE_1768_length_1719_cov_9.878395	539	619	2	5	80	0.0625000
NODE_1768_length_1719_cov_9.878395	539	619	3	44	80	0.5500000
NODE_1768_length_1719_cov_9.878395	539	619	4	16	80	0.2000000
NODE_1768_length_1719_cov_9.878395	592	672	3	64	80	0.8000000
NODE_1768_length_1719_cov_9.878395	592	672	4	16	80	0.2000000
NODE_1772_length_1717_cov_5.159456	145	219	0	3	74	0.0405405
NODE_1772_length_1717_cov_5.159456	145	219	1	4	74	0.0540541
NODE_1772_length_1717_cov_5.159456	145	219	8	18	74	0.2432432
NODE_1772_length_1717_cov_5.159456	145	219	16	2	74	0.0270270
NODE_1772_length_1717_cov_5.159456	145	219	17	8	74	0.1081081
NODE_1772_length_1717_cov_5.159456	145	219	19	2	74	0.0270270
NODE_1772_length_1717_cov_5.159456	145	219	21	7	74	0.0945946
NODE_1772_length_1717_cov_5.159456	145	219	22	3	74	0.0405405
NODE_1772_length_1717_cov_5.159456	145	219	23	8	74	0.1081081
NODE_1772_length_1717_cov_5.159456	145	219	25	12	74	0.1621622
NODE_1772_length_1717_cov_5.159456	145	219	26	7	74	0.0945946
NODE_1772_length_1717_cov_5.159456	1450	1508	12	1	58	0.0172414
NODE_1772_length_1717_cov_5.159456	1450	1508	13	41	58	0.7068965
NODE_1772_length_1717_cov_5.159456	1450	1508	14	7	58	0.1206897
NODE_1772_length_1717_cov_5.159456	1450	1508	16	9	58	0.1551724
NODE_1772_length_1717_cov_5.159456	1503	1561	8	3	58	0.0517241
NODE_1772_length_1717_cov_5.159456	1503	1561	10	3	58	0.0517241
NODE_1772_length_1717_cov_5.159456	1503	1561	11	9	58	0.1551724
NODE_1772_length_1717_cov_5.159456	1503	1561	12	24	58	0.4137931
NODE_1772_length_1717_cov_5.159456	1503	1561	13	10	58	0.1724138
NODE_1772_length_1717_cov_5.159456	1503	1561	15	2	58	0.0344828
NODE_1772_length_1717_cov_5.159456	1503	1561	16	7	58	0.1206897
NODE_1778_length_1715_cov_12.607054	555	635	1	6	80	0.0750000
NODE_1778_length_1715_cov_12.607054	555	635	3	66	80	0.8250000
NODE_1778_length_1715_cov_12.607054	555	635	4	8	80	0.1000000
NODE_1778_length_1715_cov_12.607054	608	688	3	80	80	1.0000000
NODE_1778_length_1715_cov_12.607054	684	764	0	38	80	0.4750000
NODE_1778_length_1715_cov_12.607054	684	764	1	24	80	0.3000000
NODE_1778_length_1715_cov_12.607054	684	764	3	18	80	0.2250000
NODE_1778_length_1715_cov_12.607054	737	817	0	80	80	1.0000000
NODE_1788_length_1707_cov_16.909204	397	477	2	36	80	0.4500000
NODE_1788_length_1707_cov_16.909204	397	477	3	44	80	0.5500000
NODE_1788_length_1707_cov_16.909204	450	530	2	61	80	0.7625000
NODE_1788_length_1707_cov_16.909204	450	530	3	19	80	0.2375000
NODE_1788_length_1707_cov_16.909204	1151	1231	3	37	80	0.4625000
NODE_1788_length_1707_cov_16.909204	1151	1231	4	9	80	0.1125000
NODE_1788_length_1707_cov_16.909204	1151	1231	5	34	80	0.4250000
NODE_1788_length_1707_cov_16.909204	1204	1284	1	17	80	0.2125000
NODE_1788_length_1707_cov_16.909204	1204	1284	2	26	80	0.3250000
NODE_1788_length_1707_cov_16.909204	1204	1284	4	19	80	0.2375000
NODE_1788_length_1707_cov_16.909204	1204	1284	5	18	80	0.2250000
NODE_1792_length_1705_cov_19.645081	451	531	3	7	80	0.0875000
NODE_1792_length_1705_cov_19.645081	451	531	4	9	80	0.1125000
NODE_1792_length_1705_cov_19.645081	451	531	5	14	80	0.1750000
NODE_1792_length_1705_cov_19.645081	451	531	7	39	80	0.4875000
NODE_1792_length_1705_cov_19.645081	451	531	8	11	80	0.1375000
NODE_1792_length_1705_cov_19.645081	504	584	6	3	80	0.0375000
NODE_1792_length_1705_cov_19.645081	504	584	7	58	80	0.7250000
NODE_1792_length_1705_cov_19.645081	504	584	8	19	80	0.2375000
NODE_1792_length_1705_cov_19.645081	580	660	2	24	80	0.3000000
NODE_1792_length_1705_cov_19.645081	580	660	3	5	80	0.0625000
NODE_1792_length_1705_cov_19.645081	580	660	5	14	80	0.1750000
NODE_1792_length_1705_cov_19.645081	580	660	7	37	80	0.4625000
NODE_1792_length_1705_cov_19.645081	633	714	0	18	81	0.2222222
NODE_1792_length_1705_cov_19.645081	633	714	1	10	81	0.1234568
NODE_1792_length_1705_cov_19.645081	633	714	2	50	81	0.6172839
NODE_1792_length_1705_cov_19.645081	633	714	3	3	81	0.0370370
NODE_1792_length_1705_cov_19.645081	1315	1395	0	80	80	1.0000000
NODE_1792_length_1705_cov_19.645081	1368	1448	0	80	80	1.0000000
NODE_1796_length_1703_cov_26.016833	1201	1264	3	11	63	0.1746032
NODE_1796_length_1703_cov_26.016833	1201	1264	4	10	63	0.1587302
NODE_1796_length_1703_cov_26.016833	1201	1264	5	10	63	0.1587302
NODE_1796_length_1703_cov_26.016833	1201	1264	6	17	63	0.2698413
NODE_1796_length_1703_cov_26.016833	1201	1264	7	1	63	0.0158730
NODE_1796_length_1703_cov_26.016833	1201	1264	9	1	63	0.0158730
NODE_1796_length_1703_cov_26.016833	1201	1264	12	1	63	0.0158730
NODE_1796_length_1703_cov_26.016833	1201	1264	17	1	63	0.0158730
NODE_1796_length_1703_cov_26.016833	1201	1264	33	1	63	0.0158730
NODE_1796_length_1703_cov_26.016833	1201	1264	42	1	63	0.0158730
NODE_1796_length_1703_cov_26.016833	1201	1264	51	1	63	0.0158730
NODE_1796_length_1703_cov_26.016833	1201	1264	110	1	63	0.0158730
NODE_1796_length_1703_cov_26.016833	1201	1264	117	1	63	0.0158730
NODE_1796_length_1703_cov_26.016833	1201	1264	121	1	63	0.0158730
NODE_1796_length_1703_cov_26.016833	1201	1264	124	1	63	0.0158730
NODE_1796_length_1703_cov_26.016833	1201	1264	125	1	63	0.0158730
NODE_1796_length_1703_cov_26.016833	1201	1264	128	1	63	0.0158730
NODE_1796_length_1703_cov_26.016833	1201	1264	129	1	63	0.0158730
NODE_1796_length_1703_cov_26.016833	1201	1264	132	1	63	0.0158730
NODE_1796_length_1703_cov_26.016833	1207	1264	3	11	57	0.1929825
NODE_1796_length_1703_cov_26.016833	1207	1264	4	10	57	0.1754386
NODE_1796_length_1703_cov_26.016833	1207	1264	5	10	57	0.1754386
NODE_1796_length_1703_cov_26.016833	1207	1264	6	17	57	0.2982456
NODE_1796_length_1703_cov_26.016833	1207	1264	7	1	57	0.0175439
NODE_1796_length_1703_cov_26.016833	1207	1264	9	1	57	0.0175439
NODE_1796_length_1703_cov_26.016833	1207	1264	12	1	57	0.0175439
NODE_1796_length_1703_cov_26.016833	1207	1264	17	1	57	0.0175439
NODE_1796_length_1703_cov_26.016833	1207	1264	33	1	57	0.0175439
NODE_1796_length_1703_cov_26.016833	1207	1264	42	1	57	0.0175439
NODE_1796_length_1703_cov_26.016833	1207	1264	51	1	57	0.0175439
NODE_1796_length_1703_cov_26.016833	1207	1264	110	1	57	0.0175439
NODE_1796_length_1703_cov_26.016833	1207	1264	117	1	57	0.0175439
NODE_1796_length_1703_cov_26.016833	1207	1264	3	11	57	0.1929825
NODE_1796_length_1703_cov_26.016833	1207	1264	4	10	57	0.1754386
NODE_1796_length_1703_cov_26.016833	1207	1264	5	10	57	0.1754386
NODE_1796_length_1703_cov_26.016833	1207	1264	6	17	57	0.2982456
NODE_1796_length_1703_cov_26.016833	1207	1264	7	1	57	0.0175439
NODE_1796_length_1703_cov_26.016833	1207	1264	9	1	57	0.0175439
NODE_1796_length_1703_cov_26.016833	1207	1264	12	1	57	0.0175439
NODE_1796_length_1703_cov_26.016833	1207	1264	17	1	57	0.0175439
NODE_1796_length_1703_cov_26.016833	1207	1264	33	1	57	0.0175439
NODE_1796_length_1703_cov_26.016833	1207	1264	42	1	57	0.0175439
NODE_1796_length_1703_cov_26.016833	1207	1264	51	1	57	0.0175439
NODE_1796_length_1703_cov_26.016833	1207	1264	110	1	57	0.0175439
NODE_1796_length_1703_cov_26.016833	1207	1264	117	1	57	0.0175439
NODE_1799_length_1701_cov_15.969413	1490	1565	8	4	75	0.0533333
NODE_1799_length_1701_cov_15.969413	1490	1565	9	6	75	0.0800000
NODE_1799_length_1701_cov_15.969413	1490	1565	11	1	75	0.0133333
NODE_1799_length_1701_cov_15.969413	1490	1565	13	7	75	0.0933333
NODE_1799_length_1701_cov_15.969413	1490	1565	17	5	75	0.0666667
NODE_1799_length_1701_cov_15.969413	1490	1565	19	1	75	0.0133333
NODE_1799_length_1701_cov_15.969413	1490	1565	20	3	75	0.0400000
NODE_1799_length_1701_cov_15.969413	1490	1565	21	1	75	0.0133333
NODE_1799_length_1701_cov_15.969413	1490	1565	22	2	75	0.0266667
NODE_1799_length_1701_cov_15.969413	1490	1565	23	3	75	0.0400000
NODE_1799_length_1701_cov_15.969413	1490	1565	27	2	75	0.0266667
NODE_1799_length_1701_cov_15.969413	1490	1565	29	4	75	0.0533333
NODE_1799_length_1701_cov_15.969413	1490	1565	32	2	75	0.0266667
NODE_1799_length_1701_cov_15.969413	1490	1565	33	11	75	0.1466667
NODE_1799_length_1701_cov_15.969413	1490	1565	35	1	75	0.0133333
NODE_1799_length_1701_cov_15.969413	1490	1565	36	1	75	0.0133333
NODE_1799_length_1701_cov_15.969413	1490	1565	38	1	75	0.0133333
NODE_1799_length_1701_cov_15.969413	1490	1565	39	6	75	0.0800000
NODE_1799_length_1701_cov_15.969413	1490	1565	41	9	75	0.1200000
NODE_1799_length_1701_cov_15.969413	1490	1565	43	2	75	0.0266667
NODE_1799_length_1701_cov_15.969413	1490	1565	45	1	75	0.0133333
NODE_1799_length_1701_cov_15.969413	1490	1565	46	2	75	0.0266667
NODE_1799_length_1701_cov_15.969413	1538	1603	33	4	65	0.0615385
NODE_1799_length_1701_cov_15.969413	1538	1603	35	1	65	0.0153846
NODE_1799_length_1701_cov_15.969413	1538	1603	36	1	65	0.0153846
NODE_1799_length_1701_cov_15.969413	1538	1603	38	1	65	0.0153846
NODE_1799_length_1701_cov_15.969413	1538	1603	39	6	65	0.0923077
NODE_1799_length_1701_cov_15.969413	1538	1603	41	9	65	0.1384615
NODE_1799_length_1701_cov_15.969413	1538	1603	43	2	65	0.0307692
NODE_1799_length_1701_cov_15.969413	1538	1603	45	1	65	0.0153846
NODE_1799_length_1701_cov_15.969413	1538	1603	46	15	65	0.2307692
NODE_1799_length_1701_cov_15.969413	1538	1603	48	4	65	0.0615385
NODE_1799_length_1701_cov_15.969413	1538	1603	50	5	65	0.0769231
NODE_1799_length_1701_cov_15.969413	1538	1603	52	3	65	0.0461538
NODE_1799_length_1701_cov_15.969413	1538	1603	54	13	65	0.2000000
NODE_1800_length_1701_cov_13.549313	607	687	0	80	80	1.0000000
NODE_1800_length_1701_cov_13.549313	660	740	0	80	80	1.0000000
NODE_1805_length_1700_cov_20.003123	1168	1197	337	1	29	0.0344828
NODE_1805_length_1700_cov_20.003123	1168	1197	338	2	29	0.0689655
NODE_1805_length_1700_cov_20.003123	1168	1197	341	1	29	0.0344828
NODE_1805_length_1700_cov_20.003123	1168	1197	342	1	29	0.0344828
NODE_1805_length_1700_cov_20.003123	1168	1197	343	2	29	0.0689655
NODE_1805_length_1700_cov_20.003123	1168	1197	344	1	29	0.0344828
NODE_1805_length_1700_cov_20.003123	1168	1197	350	1	29	0.0344828
NODE_1805_length_1700_cov_20.003123	1168	1197	352	1	29	0.0344828
NODE_1805_length_1700_cov_20.003123	1168	1197	355	1	29	0.0344828
NODE_1805_length_1700_cov_20.003123	1168	1197	357	1	29	0.0344828
NODE_1805_length_1700_cov_20.003123	1168	1197	360	1	29	0.0344828
NODE_1805_length_1700_cov_20.003123	1168	1197	361	1	29	0.0344828
NODE_1805_length_1700_cov_20.003123	1168	1197	364	1	29	0.0344828
NODE_1805_length_1700_cov_20.003123	1168	1197	367	1	29	0.0344828
NODE_1805_length_1700_cov_20.003123	1168	1197	369	2	29	0.0689655
NODE_1805_length_1700_cov_20.003123	1168	1197	379	1	29	0.0344828
NODE_1805_length_1700_cov_20.003123	1168	1197	383	2	29	0.0689655
NODE_1805_length_1700_cov_20.003123	1168	1197	389	2	29	0.0689655
NODE_1805_length_1700_cov_20.003123	1168	1197	394	1	29	0.0344828
NODE_1805_length_1700_cov_20.003123	1168	1197	395	1	29	0.0344828
NODE_1805_length_1700_cov_20.003123	1168	1197	403	1	29	0.0344828
NODE_1805_length_1700_cov_20.003123	1168	1197	405	1	29	0.0344828
NODE_1805_length_1700_cov_20.003123	1168	1197	410	2	29	0.0689655
NODE_1805_length_1700_cov_20.003123	1184	1263	250	1	79	0.0126582
NODE_1805_length_1700_cov_20.003123	1184	1263	251	1	79	0.0126582
NODE_1805_length_1700_cov_20.003123	1184	1263	252	1	79	0.0126582
NODE_1805_length_1700_cov_20.003123	1184	1263	254	1	79	0.0126582
NODE_1805_length_1700_cov_20.003123	1184	1263	259	1	79	0.0126582
NODE_1805_length_1700_cov_20.003123	1184	1263	263	3	79	0.0379747
NODE_1805_length_1700_cov_20.003123	1184	1263	264	1	79	0.0126582
NODE_1805_length_1700_cov_20.003123	1184	1263	265	3	79	0.0379747
NODE_1805_length_1700_cov_20.003123	1184	1263	266	1	79	0.0126582
NODE_1805_length_1700_cov_20.003123	1184	1263	267	5	79	0.0632911
NODE_1805_length_1700_cov_20.003123	1184	1263	271	1	79	0.0126582
NODE_1805_length_1700_cov_20.003123	1184	1263	277	2	79	0.0253165
NODE_1805_length_1700_cov_20.003123	1184	1263	282	1	79	0.0126582
NODE_1805_length_1700_cov_20.003123	1184	1263	283	1	79	0.0126582
NODE_1805_length_1700_cov_20.003123	1184	1263	291	1	79	0.0126582
NODE_1805_length_1700_cov_20.003123	1184	1263	292	1	79	0.0126582
NODE_1805_length_1700_cov_20.003123	1184	1263	294	1	79	0.0126582
NODE_1805_length_1700_cov_20.003123	1184	1263	296	1	79	0.0126582
NODE_1805_length_1700_cov_20.003123	1184	1263	303	1	79	0.0126582
NODE_1805_length_1700_cov_20.003123	1184	1263	305	3	79	0.0379747
NODE_1805_length_1700_cov_20.003123	1184	1263	307	1	79	0.0126582
NODE_1805_length_1700_cov_20.003123	1184	1263	308	1	79	0.0126582
NODE_1805_length_1700_cov_20.003123	1184	1263	311	1	79	0.0126582
NODE_1805_length_1700_cov_20.003123	1184	1263	312	2	79	0.0253165
NODE_1805_length_1700_cov_20.003123	1184	1263	314	3	79	0.0379747
NODE_1805_length_1700_cov_20.003123	1184	1263	315	2	79	0.0253165
NODE_1805_length_1700_cov_20.003123	1184	1263	316	2	79	0.0253165
NODE_1805_length_1700_cov_20.003123	1184	1263	317	7	79	0.0886076
NODE_1805_length_1700_cov_20.003123	1184	1263	318	4	79	0.0506329
NODE_1805_length_1700_cov_20.003123	1184	1263	320	1	79	0.0126582
NODE_1805_length_1700_cov_20.003123	1184	1263	321	2	79	0.0253165
NODE_1805_length_1700_cov_20.003123	1184	1263	322	1	79	0.0126582
NODE_1805_length_1700_cov_20.003123	1184	1263	323	2	79	0.0253165
NODE_1805_length_1700_cov_20.003123	1184	1263	324	3	79	0.0379747
NODE_1805_length_1700_cov_20.003123	1184	1263	325	1	79	0.0126582
NODE_1805_length_1700_cov_20.003123	1184	1263	331	2	79	0.0253165
NODE_1805_length_1700_cov_20.003123	1184	1263	337	1	79	0.0126582
NODE_1805_length_1700_cov_20.003123	1184	1263	338	2	79	0.0253165
NODE_1805_length_1700_cov_20.003123	1184	1263	341	1	79	0.0126582
NODE_1805_length_1700_cov_20.003123	1184	1263	342	1	79	0.0126582
NODE_1805_length_1700_cov_20.003123	1184	1263	343	2	79	0.0253165
NODE_1805_length_1700_cov_20.003123	1184	1263	344	1	79	0.0126582
NODE_1805_length_1700_cov_20.003123	1184	1263	350	1	79	0.0126582
NODE_1805_length_1700_cov_20.003123	1184	1263	352	1	79	0.0126582
NODE_1805_length_1700_cov_20.003123	1184	1263	355	1	79	0.0126582
NODE_1805_length_1700_cov_20.003123	1184	1263	357	1	79	0.0126582
NODE_1805_length_1700_cov_20.003123	1184	1263	360	1	79	0.0126582
NODE_1810_length_1698_cov_19.175735	1001	1081	0	55	80	0.6875000
NODE_1810_length_1698_cov_19.175735	1001	1081	2	25	80	0.3125000
NODE_1810_length_1698_cov_19.175735	1054	1134	0	2	80	0.0250000
NODE_1810_length_1698_cov_19.175735	1054	1134	2	78	80	0.9750000
NODE_1814_length_1696_cov_11.494678	590	670	3	48	80	0.6000000
NODE_1814_length_1696_cov_11.494678	590	670	5	14	80	0.1750000
NODE_1814_length_1696_cov_11.494678	590	670	6	18	80	0.2250000
NODE_1814_length_1696_cov_11.494678	643	723	5	34	80	0.4250000
NODE_1814_length_1696_cov_11.494678	643	723	6	46	80	0.5750000
NODE_1815_length_1696_cov_6.620539	369	449	3	33	80	0.4125000
NODE_1815_length_1696_cov_6.620539	369	449	5	15	80	0.1875000
NODE_1815_length_1696_cov_6.620539	369	449	6	29	80	0.3625000
NODE_1815_length_1696_cov_6.620539	369	449	7	3	80	0.0375000
NODE_1815_length_1696_cov_6.620539	422	502	2	4	80	0.0500000
NODE_1815_length_1696_cov_6.620539	422	502	3	2	80	0.0250000
NODE_1815_length_1696_cov_6.620539	422	502	5	20	80	0.2500000
NODE_1815_length_1696_cov_6.620539	422	502	6	51	80	0.6375000
NODE_1815_length_1696_cov_6.620539	422	502	7	3	80	0.0375000
NODE_1816_length_1695_cov_27.783208	399	479	3	55	80	0.6875000
NODE_1816_length_1695_cov_27.783208	399	479	4	25	80	0.3125000
NODE_1816_length_1695_cov_27.783208	452	532	0	23	80	0.2875000
NODE_1816_length_1695_cov_27.783208	452	532	1	10	80	0.1250000
NODE_1816_length_1695_cov_27.783208	452	532	2	18	80	0.2250000
NODE_1816_length_1695_cov_27.783208	452	532	3	29	80	0.3625000
NODE_1817_length_1695_cov_12.084586	1047	1127	4	8	80	0.1000000
NODE_1817_length_1695_cov_12.084586	1047	1127	5	23	80	0.2875000
NODE_1817_length_1695_cov_12.084586	1047	1127	6	49	80	0.6125000
NODE_1817_length_1695_cov_12.084586	1100	1180	3	16	80	0.2000000
NODE_1817_length_1695_cov_12.084586	1100	1180	4	22	80	0.2750000
NODE_1817_length_1695_cov_12.084586	1100	1180	6	42	80	0.5250000
NODE_1825_length_1692_cov_4.557439	727	807	2	5	80	0.0625000
NODE_1825_length_1692_cov_4.557439	727	807	3	57	80	0.7125000
NODE_1825_length_1692_cov_4.557439	727	807	5	18	80	0.2250000
NODE_1825_length_1692_cov_4.557439	780	860	3	9	80	0.1125000
NODE_1825_length_1692_cov_4.557439	780	860	5	71	80	0.8875000
NODE_1830_length_1689_cov_5.844025	1210	1285	3	17	75	0.2266667
NODE_1830_length_1689_cov_5.844025	1210	1285	4	18	75	0.2400000
NODE_1830_length_1689_cov_5.844025	1210	1285	5	40	75	0.5333334
NODE_1830_length_1689_cov_5.844025	1260	1338	3	54	78	0.6923077
NODE_1830_length_1689_cov_5.844025	1260	1338	4	24	78	0.3076923
NODE_1837_length_1682_cov_14.416930	1183	1263	4	36	80	0.4500000
NODE_1837_length_1682_cov_14.416930	1183	1263	5	44	80	0.5500000
NODE_1837_length_1682_cov_14.416930	1236	1315	2	14	79	0.1772152
NODE_1837_length_1682_cov_14.416930	1236	1315	4	65	79	0.8227848
NODE_1843_length_1678_cov_23.965168	636	716	1	80	80	1.0000000
NODE_1843_length_1678_cov_23.965168	689	769	0	46	80	0.5750000
NODE_1843_length_1678_cov_23.965168	689	769	1	34	80	0.4250000
NODE_1843_length_1678_cov_23.965168	1145	1225	2	21	80	0.2625000
NODE_1843_length_1678_cov_23.965168	1145	1225	3	13	80	0.1625000
NODE_1843_length_1678_cov_23.965168	1145	1225	4	46	80	0.5750000
NODE_1843_length_1678_cov_23.965168	1198	1278	3	28	80	0.3500000
NODE_1843_length_1678_cov_23.965168	1198	1278	4	28	80	0.3500000
NODE_1843_length_1678_cov_23.965168	1198	1278	5	24	80	0.3000000
NODE_1846_length_1677_cov_3.578580	407	487	1	22	80	0.2750000
NODE_1846_length_1677_cov_3.578580	407	487	3	2	80	0.0250000
NODE_1846_length_1677_cov_3.578580	407	487	4	13	80	0.1625000
NODE_1846_length_1677_cov_3.578580	407	487	5	43	80	0.5375000
NODE_1846_length_1677_cov_3.578580	460	530	1	65	70	0.9285714
NODE_1846_length_1677_cov_3.578580	460	530	3	2	70	0.0285714
NODE_1846_length_1677_cov_3.578580	460	530	5	3	70	0.0428571
NODE_1846_length_1677_cov_3.578580	666	724	0	58	58	1.0000000
NODE_1856_length_1670_cov_29.264163	741	821	0	68	80	0.8500000
NODE_1856_length_1670_cov_29.264163	741	821	2	12	80	0.1500000
NODE_1856_length_1670_cov_29.264163	794	874	0	28	80	0.3500000
NODE_1856_length_1670_cov_29.264163	794	874	2	52	80	0.6500000
NODE_1857_length_1669_cov_5.913376	246	326	2	29	80	0.3625000
NODE_1857_length_1669_cov_5.913376	246	326	3	22	80	0.2750000
NODE_1857_length_1669_cov_5.913376	246	326	4	29	80	0.3625000
NODE_1857_length_1669_cov_5.913376	299	379	0	4	80	0.0500000
NODE_1857_length_1669_cov_5.913376	299	379	1	18	80	0.2250000
NODE_1857_length_1669_cov_5.913376	299	379	2	58	80	0.7250000
NODE_1860_length_1668_cov_18.372212	1100	1180	4	21	80	0.2625000
NODE_1860_length_1668_cov_18.372212	1100	1180	6	27	80	0.3375000
NODE_1860_length_1668_cov_18.372212	1100	1180	7	32	80	0.4000000
NODE_1860_length_1668_cov_18.372212	1153	1233	3	36	80	0.4500000
NODE_1860_length_1668_cov_18.372212	1153	1233	5	8	80	0.1000000
NODE_1860_length_1668_cov_18.372212	1153	1233	7	36	80	0.4500000
NODE_1861_length_1667_cov_15.651786	902	982	3	4	80	0.0500000
NODE_1861_length_1667_cov_15.651786	902	982	4	29	80	0.3625000
NODE_1861_length_1667_cov_15.651786	902	982	5	47	80	0.5875000
NODE_1861_length_1667_cov_15.651786	955	1035	4	12	80	0.1500000
NODE_1861_length_1667_cov_15.651786	955	1035	5	30	80	0.3750000
NODE_1861_length_1667_cov_15.651786	955	1035	6	9	80	0.1125000
NODE_1861_length_1667_cov_15.651786	955	1035	7	29	80	0.3625000
NODE_1862_length_1667_cov_3.661352	649	679	0	30	30	1.0000000
NODE_1865_length_1666_cov_4.601149	1541	1623	0	58	82	0.7073171
NODE_1865_length_1666_cov_4.601149	1541	1623	3	24	82	0.2926829
NODE_1865_length_1666_cov_4.601149	1553	1613	0	48	60	0.8000000
NODE_1865_length_1666_cov_4.601149	1553	1613	3	12	60	0.2000000
NODE_1865_length_1666_cov_4.601149	1553	1613	0	48	60	0.8000000
NODE_1865_length_1666_cov_4.601149	1553	1613	3	12	60	0.2000000
NODE_1865_length_1666_cov_4.601149	1557	1623	0	58	66	0.8787879
NODE_1865_length_1666_cov_4.601149	1557	1623	3	8	66	0.1212121
NODE_1865_length_1666_cov_4.601149	1596	1666	0	70	70	1.0000000
NODE_1865_length_1666_cov_4.601149	1596	1666	0	70	70	1.0000000
NODE_1865_length_1666_cov_4.601149	1596	1666	0	70	70	1.0000000
NODE_1872_length_1662_cov_16.638516	538	618	2	11	80	0.1375000
NODE_1872_length_1662_cov_16.638516	538	618	3	5	80	0.0625000
NODE_1872_length_1662_cov_16.638516	538	618	5	34	80	0.4250000
NODE_1872_length_1662_cov_16.638516	538	618	7	30	80	0.3750000
NODE_1872_length_1662_cov_16.638516	591	671	5	22	80	0.2750000
NODE_1872_length_1662_cov_16.638516	591	671	6	1	80	0.0125000
NODE_1872_length_1662_cov_16.638516	591	671	7	57	80	0.7125000
NODE_1872_length_1662_cov_16.638516	667	747	1	48	80	0.6000000
NODE_1872_length_1662_cov_16.638516	667	747	2	15	80	0.1875000
NODE_1872_length_1662_cov_16.638516	667	747	3	3	80	0.0375000
NODE_1872_length_1662_cov_16.638516	667	747	4	1	80	0.0125000
NODE_1872_length_1662_cov_16.638516	667	747	5	13	80	0.1625000
NODE_1872_length_1662_cov_16.638516	720	800	1	80	80	1.0000000
NODE_1876_length_1660_cov_28.297886	415	495	1	80	80	1.0000000
NODE_1876_length_1660_cov_28.297886	468	548	0	46	80	0.5750000
NODE_1876_length_1660_cov_28.297886	468	548	1	34	80	0.4250000
NODE_1886_length_1654_cov_17.245016	631	711	0	80	80	1.0000000
NODE_1886_length_1654_cov_17.245016	684	764	0	80	80	1.0000000
NODE_1888_length_1653_cov_34.827542	0	41	0	5	41	0.1219512
NODE_1888_length_1653_cov_34.827542	0	41	1	36	41	0.8780488
NODE_1888_length_1653_cov_34.827542	14	44	1	29	30	0.9666666
NODE_1888_length_1653_cov_34.827542	14	44	2	1	30	0.0333333
NODE_1888_length_1653_cov_34.827542	1081	1161	10	2	80	0.0250000
NODE_1888_length_1653_cov_34.827542	1081	1161	11	3	80	0.0375000
NODE_1888_length_1653_cov_34.827542	1081	1161	12	4	80	0.0500000
NODE_1888_length_1653_cov_34.827542	1081	1161	13	10	80	0.1250000
NODE_1888_length_1653_cov_34.827542	1081	1161	14	6	80	0.0750000
NODE_1888_length_1653_cov_34.827542	1081	1161	16	7	80	0.0875000
NODE_1888_length_1653_cov_34.827542	1081	1161	17	3	80	0.0375000
NODE_1888_length_1653_cov_34.827542	1081	1161	18	3	80	0.0375000
NODE_1888_length_1653_cov_34.827542	1081	1161	20	7	80	0.0875000
NODE_1888_length_1653_cov_34.827542	1081	1161	22	1	80	0.0125000
NODE_1888_length_1653_cov_34.827542	1081	1161	23	2	80	0.0250000
NODE_1888_length_1653_cov_34.827542	1081	1161	25	1	80	0.0125000
NODE_1888_length_1653_cov_34.827542	1081	1161	27	7	80	0.0875000
NODE_1888_length_1653_cov_34.827542	1081	1161	28	10	80	0.1250000
NODE_1888_length_1653_cov_34.827542	1081	1161	29	3	80	0.0375000
NODE_1888_length_1653_cov_34.827542	1081	1161	30	2	80	0.0250000
NODE_1888_length_1653_cov_34.827542	1081	1161	31	2	80	0.0250000
NODE_1888_length_1653_cov_34.827542	1081	1161	33	2	80	0.0250000
NODE_1888_length_1653_cov_34.827542	1081	1161	35	1	80	0.0125000
NODE_1888_length_1653_cov_34.827542	1081	1161	37	3	80	0.0375000
NODE_1888_length_1653_cov_34.827542	1081	1161	38	1	80	0.0125000
NODE_1888_length_1653_cov_34.827542	1134	1214	27	3	80	0.0375000
NODE_1888_length_1653_cov_34.827542	1134	1214	28	10	80	0.1250000
NODE_1888_length_1653_cov_34.827542	1134	1214	29	3	80	0.0375000
NODE_1888_length_1653_cov_34.827542	1134	1214	30	2	80	0.0250000
NODE_1888_length_1653_cov_34.827542	1134	1214	31	2	80	0.0250000
NODE_1888_length_1653_cov_34.827542	1134	1214	33	2	80	0.0250000
NODE_1888_length_1653_cov_34.827542	1134	1214	35	1	80	0.0125000
NODE_1888_length_1653_cov_34.827542	1134	1214	37	3	80	0.0375000
NODE_1888_length_1653_cov_34.827542	1134	1214	38	2	80	0.0250000
NODE_1888_length_1653_cov_34.827542	1134	1214	40	10	80	0.1250000
NODE_1888_length_1653_cov_34.827542	1134	1214	41	1	80	0.0125000
NODE_1888_length_1653_cov_34.827542	1134	1214	42	1	80	0.0125000
NODE_1888_length_1653_cov_34.827542	1134	1214	43	8	80	0.1000000
NODE_1888_length_1653_cov_34.827542	1134	1214	44	7	80	0.0875000
NODE_1888_length_1653_cov_34.827542	1134	1214	45	5	80	0.0625000
NODE_1888_length_1653_cov_34.827542	1134	1214	46	7	80	0.0875000
NODE_1888_length_1653_cov_34.827542	1134	1214	47	10	80	0.1250000
NODE_1888_length_1653_cov_34.827542	1134	1214	48	3	80	0.0375000
NODE_1888_length_1653_cov_34.827542	1210	1290	21	6	80	0.0750000
NODE_1888_length_1653_cov_34.827542	1210	1290	22	1	80	0.0125000
NODE_1888_length_1653_cov_34.827542	1210	1290	23	3	80	0.0375000
NODE_1888_length_1653_cov_34.827542	1210	1290	24	8	80	0.1000000
NODE_1888_length_1653_cov_34.827542	1210	1290	25	3	80	0.0375000
NODE_1888_length_1653_cov_34.827542	1210	1290	26	1	80	0.0125000
NODE_1888_length_1653_cov_34.827542	1210	1290	27	2	80	0.0250000
NODE_1888_length_1653_cov_34.827542	1210	1290	30	1	80	0.0125000
NODE_1888_length_1653_cov_34.827542	1210	1290	32	2	80	0.0250000
NODE_1888_length_1653_cov_34.827542	1210	1290	33	5	80	0.0625000
NODE_1888_length_1653_cov_34.827542	1210	1290	35	4	80	0.0500000
NODE_1888_length_1653_cov_34.827542	1210	1290	36	6	80	0.0750000
NODE_1888_length_1653_cov_34.827542	1210	1290	37	9	80	0.1125000
NODE_1888_length_1653_cov_34.827542	1210	1290	39	1	80	0.0125000
NODE_1888_length_1653_cov_34.827542	1210	1290	40	2	80	0.0250000
NODE_1888_length_1653_cov_34.827542	1210	1290	42	1	80	0.0125000
NODE_1888_length_1653_cov_34.827542	1210	1290	43	6	80	0.0750000
NODE_1888_length_1653_cov_34.827542	1210	1290	44	5	80	0.0625000
NODE_1888_length_1653_cov_34.827542	1210	1290	45	2	80	0.0250000
NODE_1888_length_1653_cov_34.827542	1210	1290	46	3	80	0.0375000
NODE_1888_length_1653_cov_34.827542	1210	1290	47	9	80	0.1125000
NODE_1888_length_1653_cov_34.827542	1263	1339	10	7	76	0.0921053
NODE_1888_length_1653_cov_34.827542	1263	1339	11	8	76	0.1052632
NODE_1888_length_1653_cov_34.827542	1263	1339	12	11	76	0.1447368
NODE_1888_length_1653_cov_34.827542	1263	1339	13	1	76	0.0131579
NODE_1888_length_1653_cov_34.827542	1263	1339	16	5	76	0.0657895
NODE_1888_length_1653_cov_34.827542	1263	1339	17	2	76	0.0263158
NODE_1888_length_1653_cov_34.827542	1263	1339	18	1	76	0.0131579
NODE_1888_length_1653_cov_34.827542	1263	1339	19	7	76	0.0921053
NODE_1888_length_1653_cov_34.827542	1263	1339	20	3	76	0.0394737
NODE_1888_length_1653_cov_34.827542	1263	1339	21	9	76	0.1184211
NODE_1888_length_1653_cov_34.827542	1263	1339	22	2	76	0.0263158
NODE_1888_length_1653_cov_34.827542	1263	1339	23	3	76	0.0394737
NODE_1888_length_1653_cov_34.827542	1263	1339	24	8	76	0.1052632
NODE_1888_length_1653_cov_34.827542	1263	1339	25	3	76	0.0394737
NODE_1888_length_1653_cov_34.827542	1263	1339	26	1	76	0.0131579
NODE_1888_length_1653_cov_34.827542	1263	1339	27	2	76	0.0263158
NODE_1888_length_1653_cov_34.827542	1263	1339	30	1	76	0.0131579
NODE_1888_length_1653_cov_34.827542	1263	1339	32	2	76	0.0263158
NODE_1892_length_1652_cov_23.939472	1352	1432	16	1	80	0.0125000
NODE_1892_length_1652_cov_23.939472	1352	1432	17	1	80	0.0125000
NODE_1892_length_1652_cov_23.939472	1352	1432	18	38	80	0.4750000
NODE_1892_length_1652_cov_23.939472	1352	1432	19	18	80	0.2250000
NODE_1892_length_1652_cov_23.939472	1352	1432	20	6	80	0.0750000
NODE_1892_length_1652_cov_23.939472	1352	1432	21	6	80	0.0750000
NODE_1892_length_1652_cov_23.939472	1352	1432	22	6	80	0.0750000
NODE_1892_length_1652_cov_23.939472	1352	1432	23	4	80	0.0500000
NODE_1892_length_1652_cov_23.939472	1405	1485	12	20	80	0.2500000
NODE_1892_length_1652_cov_23.939472	1405	1485	13	15	80	0.1875000
NODE_1892_length_1652_cov_23.939472	1405	1485	14	9	80	0.1125000
NODE_1892_length_1652_cov_23.939472	1405	1485	15	2	80	0.0250000
NODE_1892_length_1652_cov_23.939472	1405	1485	16	2	80	0.0250000
NODE_1892_length_1652_cov_23.939472	1405	1485	17	6	80	0.0750000
NODE_1892_length_1652_cov_23.939472	1405	1485	19	4	80	0.0500000
NODE_1892_length_1652_cov_23.939472	1405	1485	20	6	80	0.0750000
NODE_1892_length_1652_cov_23.939472	1405	1485	21	6	80	0.0750000
NODE_1892_length_1652_cov_23.939472	1405	1485	22	6	80	0.0750000
NODE_1892_length_1652_cov_23.939472	1405	1485	23	4	80	0.0500000
NODE_1894_length_1651_cov_3.916881	1552	1617	0	65	65	1.0000000
NODE_1899_length_1649_cov_7.480000	774	854	2	26	80	0.3250000
NODE_1899_length_1649_cov_7.480000	774	854	3	54	80	0.6750000
NODE_1899_length_1649_cov_7.480000	827	907	2	20	80	0.2500000
NODE_1899_length_1649_cov_7.480000	827	907	3	48	80	0.6000000
NODE_1899_length_1649_cov_7.480000	827	907	4	12	80	0.1500000
NODE_1903_length_1647_cov_3.534238	1012	1075	5	1	63	0.0158730
NODE_1903_length_1647_cov_3.534238	1012	1075	6	7	63	0.1111111
NODE_1903_length_1647_cov_3.534238	1012	1075	7	49	63	0.7777778
NODE_1903_length_1647_cov_3.534238	1012	1075	8	6	63	0.0952381
NODE_1906_length_1645_cov_16.040103	155	235	0	80	80	1.0000000
NODE_1906_length_1645_cov_16.040103	208	288	0	80	80	1.0000000
NODE_1906_length_1645_cov_16.040103	1090	1170	7	14	80	0.1750000
NODE_1906_length_1645_cov_16.040103	1090	1170	8	38	80	0.4750000
NODE_1906_length_1645_cov_16.040103	1090	1170	9	17	80	0.2125000
NODE_1906_length_1645_cov_16.040103	1090	1170	10	11	80	0.1375000
NODE_1906_length_1645_cov_16.040103	1143	1222	8	25	79	0.3164557
NODE_1906_length_1645_cov_16.040103	1143	1222	9	52	79	0.6582279
NODE_1906_length_1645_cov_16.040103	1143	1222	10	2	79	0.0253165
NODE_1908_length_1644_cov_2.902913	1160	1240	1	1	80	0.0125000
NODE_1908_length_1644_cov_2.902913	1160	1240	3	17	80	0.2125000
NODE_1908_length_1644_cov_2.902913	1160	1240	4	19	80	0.2375000
NODE_1908_length_1644_cov_2.902913	1160	1240	5	6	80	0.0750000
NODE_1908_length_1644_cov_2.902913	1160	1240	7	10	80	0.1250000
NODE_1908_length_1644_cov_2.902913	1160	1240	8	8	80	0.1000000
NODE_1908_length_1644_cov_2.902913	1160	1240	9	9	80	0.1125000
NODE_1908_length_1644_cov_2.902913	1160	1240	10	10	80	0.1250000
NODE_1917_length_1641_cov_34.032425	487	567	0	70	80	0.8750000
NODE_1917_length_1641_cov_34.032425	487	567	1	10	80	0.1250000
NODE_1917_length_1641_cov_34.032425	540	620	0	56	80	0.7000000
NODE_1917_length_1641_cov_34.032425	540	620	1	24	80	0.3000000
NODE_1917_length_1641_cov_34.032425	616	696	1	22	80	0.2750000
NODE_1917_length_1641_cov_34.032425	616	696	2	58	80	0.7250000
NODE_1917_length_1641_cov_34.032425	669	749	1	3	80	0.0375000
NODE_1917_length_1641_cov_34.032425	669	749	2	77	80	0.9625000
NODE_1917_length_1641_cov_34.032425	1168	1248	2	26	80	0.3250000
NODE_1917_length_1641_cov_34.032425	1168	1248	3	3	80	0.0375000
NODE_1917_length_1641_cov_34.032425	1168	1248	5	51	80	0.6375000
NODE_1917_length_1641_cov_34.032425	1219	1301	2	30	82	0.3658537
NODE_1917_length_1641_cov_34.032425	1219	1301	3	5	82	0.0609756
NODE_1917_length_1641_cov_34.032425	1219	1301	4	17	82	0.2073171
NODE_1917_length_1641_cov_34.032425	1219	1301	5	30	82	0.3658537
NODE_1918_length_1641_cov_7.042802	339	390	6	2	51	0.0392157
NODE_1918_length_1641_cov_7.042802	339	390	7	49	51	0.9607843
NODE_1922_length_1640_cov_33.097339	943	1023	3	80	80	1.0000000
NODE_1922_length_1640_cov_33.097339	996	1076	1	44	80	0.5500000
NODE_1922_length_1640_cov_33.097339	996	1076	3	36	80	0.4500000
NODE_1922_length_1640_cov_33.097339	1072	1152	0	74	80	0.9250000
NODE_1922_length_1640_cov_33.097339	1072	1152	1	6	80	0.0750000
NODE_1922_length_1640_cov_33.097339	1125	1206	0	81	81	1.0000000
NODE_1923_length_1640_cov_18.519143	471	551	6	4	80	0.0500000
NODE_1923_length_1640_cov_18.519143	471	551	7	26	80	0.3250000
NODE_1923_length_1640_cov_18.519143	471	551	8	45	80	0.5625000
NODE_1923_length_1640_cov_18.519143	471	551	9	5	80	0.0625000
NODE_1923_length_1640_cov_18.519143	524	604	4	10	80	0.1250000
NODE_1923_length_1640_cov_18.519143	524	604	6	10	80	0.1250000
NODE_1923_length_1640_cov_18.519143	524	604	7	2	80	0.0250000
NODE_1923_length_1640_cov_18.519143	524	604	8	58	80	0.7250000
NODE_1925_length_1639_cov_6.585714	975	1056	0	8	81	0.0987654
NODE_1925_length_1639_cov_6.585714	975	1056	1	73	81	0.9012346
NODE_1925_length_1639_cov_6.585714	1028	1109	0	2	81	0.0246914
NODE_1925_length_1639_cov_6.585714	1028	1109	1	79	81	0.9753087
NODE_1926_length_1639_cov_2.163636	1260	1334	0	74	74	1.0000000
NODE_1926_length_1639_cov_2.163636	1312	1387	0	75	75	1.0000000
NODE_1928_length_1638_cov_18.598441	443	523	1	5	80	0.0625000
NODE_1928_length_1638_cov_18.598441	443	523	2	6	80	0.0750000
NODE_1928_length_1638_cov_18.598441	443	523	3	4	80	0.0500000
NODE_1928_length_1638_cov_18.598441	443	523	5	15	80	0.1875000
NODE_1928_length_1638_cov_18.598441	443	523	6	16	80	0.2000000
NODE_1928_length_1638_cov_18.598441	443	523	7	34	80	0.4250000
NODE_1928_length_1638_cov_18.598441	496	576	4	28	80	0.3500000
NODE_1928_length_1638_cov_18.598441	496	576	6	36	80	0.4500000
NODE_1928_length_1638_cov_18.598441	496	576	7	16	80	0.2000000
NODE_1928_length_1638_cov_18.598441	1157	1237	0	80	80	1.0000000
NODE_1928_length_1638_cov_18.598441	1210	1290	0	36	80	0.4500000
NODE_1928_length_1638_cov_18.598441	1210	1290	1	13	80	0.1625000
NODE_1928_length_1638_cov_18.598441	1210	1290	2	31	80	0.3875000
NODE_1932_length_1637_cov_12.048765	410	490	4	80	80	1.0000000
NODE_1932_length_1637_cov_12.048765	463	543	2	4	80	0.0500000
NODE_1932_length_1637_cov_12.048765	463	543	4	76	80	0.9500000
NODE_1932_length_1637_cov_12.048765	1081	1161	1	21	80	0.2625000
NODE_1932_length_1637_cov_12.048765	1081	1161	2	59	80	0.7375000
NODE_1932_length_1637_cov_12.048765	1134	1214	0	31	80	0.3875000
NODE_1932_length_1637_cov_12.048765	1134	1214	1	43	80	0.5375000
NODE_1932_length_1637_cov_12.048765	1134	1214	2	6	80	0.0750000
NODE_1934_length_1635_cov_21.022786	958	1038	0	80	80	1.0000000
NODE_1934_length_1635_cov_21.022786	1011	1091	0	29	80	0.3625000
NODE_1934_length_1635_cov_21.022786	1011	1091	1	51	80	0.6375000
NODE_1934_length_1635_cov_21.022786	1087	1167	1	65	80	0.8125000
NODE_1934_length_1635_cov_21.022786	1087	1167	2	15	80	0.1875000
NODE_1934_length_1635_cov_21.022786	1140	1220	1	25	80	0.3125000
NODE_1934_length_1635_cov_21.022786	1140	1220	2	38	80	0.4750000
NODE_1934_length_1635_cov_21.022786	1140	1220	3	17	80	0.2125000
NODE_1936_length_1633_cov_16.743807	1067	1147	3	25	80	0.3125000
NODE_1936_length_1633_cov_16.743807	1067	1147	4	55	80	0.6875000
NODE_1936_length_1633_cov_16.743807	1120	1200	2	15	80	0.1875000
NODE_1936_length_1633_cov_16.743807	1120	1200	3	3	80	0.0375000
NODE_1936_length_1633_cov_16.743807	1120	1200	4	44	80	0.5500000
NODE_1936_length_1633_cov_16.743807	1120	1200	5	18	80	0.2250000
NODE_1937_length_1633_cov_14.271838	977	1057	0	80	80	1.0000000
NODE_1937_length_1633_cov_14.271838	1030	1110	0	80	80	1.0000000
NODE_1937_length_1633_cov_14.271838	1106	1186	0	34	80	0.4250000
NODE_1937_length_1633_cov_14.271838	1106	1186	2	46	80	0.5750000
NODE_1937_length_1633_cov_14.271838	1159	1239	2	80	80	1.0000000
NODE_1939_length_1631_cov_25.881201	424	504	0	8	80	0.1000000
NODE_1939_length_1631_cov_25.881201	424	504	1	39	80	0.4875000
NODE_1939_length_1631_cov_25.881201	424	504	2	22	80	0.2750000
NODE_1939_length_1631_cov_25.881201	424	504	3	11	80	0.1375000
NODE_1939_length_1631_cov_25.881201	477	557	2	16	80	0.2000000
NODE_1939_length_1631_cov_25.881201	477	557	3	11	80	0.1375000
NODE_1939_length_1631_cov_25.881201	477	557	4	53	80	0.6625000
NODE_1939_length_1631_cov_25.881201	553	633	3	3	80	0.0375000
NODE_1939_length_1631_cov_25.881201	553	633	4	16	80	0.2000000
NODE_1939_length_1631_cov_25.881201	553	633	5	61	80	0.7625000
NODE_1939_length_1631_cov_25.881201	606	686	3	32	80	0.4000000
NODE_1939_length_1631_cov_25.881201	606	686	4	11	80	0.1375000
NODE_1939_length_1631_cov_25.881201	606	686	5	37	80	0.4625000
NODE_1943_length_1629_cov_32.733987	518	598	3	60	80	0.7500000
NODE_1943_length_1629_cov_32.733987	518	598	4	20	80	0.2500000
NODE_1943_length_1629_cov_32.733987	635	715	8	21	80	0.2625000
NODE_1943_length_1629_cov_32.733987	635	715	9	35	80	0.4375000
NODE_1943_length_1629_cov_32.733987	635	715	10	1	80	0.0125000
NODE_1943_length_1629_cov_32.733987	635	715	11	23	80	0.2875000
NODE_1943_length_1629_cov_32.733987	688	768	9	4	80	0.0500000
NODE_1943_length_1629_cov_32.733987	688	768	10	4	80	0.0500000
NODE_1943_length_1629_cov_32.733987	688	768	11	27	80	0.3375000
NODE_1943_length_1629_cov_32.733987	688	768	12	4	80	0.0500000
NODE_1943_length_1629_cov_32.733987	688	768	13	9	80	0.1125000
NODE_1943_length_1629_cov_32.733987	688	768	14	31	80	0.3875000
NODE_1943_length_1629_cov_32.733987	688	768	15	1	80	0.0125000
NODE_1946_length_1628_cov_15.551995	1454	1518	29	4	64	0.0625000
NODE_1946_length_1628_cov_15.551995	1454	1518	31	2	64	0.0312500
NODE_1946_length_1628_cov_15.551995	1454	1518	32	1	64	0.0156250
NODE_1946_length_1628_cov_15.551995	1454	1518	34	1	64	0.0156250
NODE_1946_length_1628_cov_15.551995	1454	1518	36	1	64	0.0156250
NODE_1946_length_1628_cov_15.551995	1454	1518	38	2	64	0.0312500
NODE_1946_length_1628_cov_15.551995	1454	1518	40	3	64	0.0468750
NODE_1946_length_1628_cov_15.551995	1454	1518	42	4	64	0.0625000
NODE_1946_length_1628_cov_15.551995	1454	1518	43	1	64	0.0156250
NODE_1946_length_1628_cov_15.551995	1454	1518	44	1	64	0.0156250
NODE_1946_length_1628_cov_15.551995	1454	1518	45	2	64	0.0312500
NODE_1946_length_1628_cov_15.551995	1454	1518	46	1	64	0.0156250
NODE_1946_length_1628_cov_15.551995	1454	1518	48	2	64	0.0312500
NODE_1946_length_1628_cov_15.551995	1454	1518	50	1	64	0.0156250
NODE_1946_length_1628_cov_15.551995	1454	1518	54	1	64	0.0156250
NODE_1946_length_1628_cov_15.551995	1454	1518	55	1	64	0.0156250
NODE_1946_length_1628_cov_15.551995	1454	1518	59	5	64	0.0781250
NODE_1946_length_1628_cov_15.551995	1454	1518	61	9	64	0.1406250
NODE_1946_length_1628_cov_15.551995	1454	1518	63	6	64	0.0937500
NODE_1946_length_1628_cov_15.551995	1454	1518	65	6	64	0.0937500
NODE_1946_length_1628_cov_15.551995	1454	1518	67	2	64	0.0312500
NODE_1946_length_1628_cov_15.551995	1454	1518	69	8	64	0.1250000
NODE_1947_length_1628_cov_4.852845	81	163	9	11	82	0.1341463
NODE_1947_length_1628_cov_4.852845	81	163	10	2	82	0.0243902
NODE_1947_length_1628_cov_4.852845	81	163	11	1	82	0.0121951
NODE_1947_length_1628_cov_4.852845	81	163	12	42	82	0.5121951
NODE_1947_length_1628_cov_4.852845	81	163	13	9	82	0.1097561
NODE_1947_length_1628_cov_4.852845	81	163	14	17	82	0.2073171
NODE_1952_length_1626_cov_20.549443	495	575	2	50	80	0.6250000
NODE_1952_length_1626_cov_20.549443	495	575	3	25	80	0.3125000
NODE_1952_length_1626_cov_20.549443	495	575	4	5	80	0.0625000
NODE_1952_length_1626_cov_20.549443	548	628	3	78	80	0.9750000
NODE_1952_length_1626_cov_20.549443	548	628	4	2	80	0.0250000
NODE_1953_length_1626_cov_6.552718	1189	1269	2	13	80	0.1625000
NODE_1953_length_1626_cov_6.552718	1189	1269	3	2	80	0.0250000
NODE_1953_length_1626_cov_6.552718	1189	1269	4	65	80	0.8125000
NODE_1953_length_1626_cov_6.552718	1242	1321	2	65	79	0.8227848
NODE_1953_length_1626_cov_6.552718	1242	1321	4	14	79	0.1772152
NODE_1954_length_1626_cov_4.728880	247	329	4	3	82	0.0365854
NODE_1954_length_1626_cov_4.728880	247	329	6	7	82	0.0853659
NODE_1954_length_1626_cov_4.728880	247	329	7	4	82	0.0487805
NODE_1954_length_1626_cov_4.728880	247	329	8	26	82	0.3170732
NODE_1954_length_1626_cov_4.728880	247	329	9	42	82	0.5121951
NODE_1954_length_1626_cov_4.728880	302	382	4	39	80	0.4875000
NODE_1954_length_1626_cov_4.728880	302	382	5	12	80	0.1500000
NODE_1954_length_1626_cov_4.728880	302	382	6	12	80	0.1500000
NODE_1954_length_1626_cov_4.728880	302	382	7	4	80	0.0500000
NODE_1954_length_1626_cov_4.728880	302	382	8	12	80	0.1500000
NODE_1954_length_1626_cov_4.728880	302	382	9	1	80	0.0125000
NODE_1956_length_1625_cov_20.598952	938	1018	4	39	80	0.4875000
NODE_1956_length_1625_cov_20.598952	938	1018	5	41	80	0.5125000
NODE_1956_length_1625_cov_20.598952	991	1071	3	14	80	0.1750000
NODE_1956_length_1625_cov_20.598952	991	1071	4	63	80	0.7875000
NODE_1956_length_1625_cov_20.598952	991	1071	5	3	80	0.0375000
NODE_1962_length_1623_cov_28.551181	416	486	24	4	70	0.0571429
NODE_1962_length_1623_cov_28.551181	416	486	25	2	70	0.0285714
NODE_1962_length_1623_cov_28.551181	416	486	27	1	70	0.0142857
NODE_1962_length_1623_cov_28.551181	416	486	29	20	70	0.2857143
NODE_1962_length_1623_cov_28.551181	416	486	30	6	70	0.0857143
NODE_1962_length_1623_cov_28.551181	416	486	31	3	70	0.0428571
NODE_1962_length_1623_cov_28.551181	416	486	32	1	70	0.0142857
NODE_1962_length_1623_cov_28.551181	416	486	35	7	70	0.1000000
NODE_1962_length_1623_cov_28.551181	416	486	36	13	70	0.1857143
NODE_1962_length_1623_cov_28.551181	416	486	38	9	70	0.1285714
NODE_1962_length_1623_cov_28.551181	416	486	40	4	70	0.0571429
NODE_1962_length_1623_cov_28.551181	459	507	20	2	48	0.0416667
NODE_1962_length_1623_cov_28.551181	459	507	21	3	48	0.0625000
NODE_1962_length_1623_cov_28.551181	459	507	22	7	48	0.1458333
NODE_1962_length_1623_cov_28.551181	459	507	23	3	48	0.0625000
NODE_1962_length_1623_cov_28.551181	459	507	24	7	48	0.1458333
NODE_1962_length_1623_cov_28.551181	459	507	25	2	48	0.0416667
NODE_1962_length_1623_cov_28.551181	459	507	27	1	48	0.0208333
NODE_1962_length_1623_cov_28.551181	459	507	29	20	48	0.4166667
NODE_1962_length_1623_cov_28.551181	459	507	32	2	48	0.0416667
NODE_1962_length_1623_cov_28.551181	459	507	34	1	48	0.0208333
NODE_1965_length_1622_cov_7.969140	645	725	1	61	80	0.7625000
NODE_1965_length_1622_cov_7.969140	645	725	2	19	80	0.2375000
NODE_1965_length_1622_cov_7.969140	698	778	0	23	80	0.2875000
NODE_1965_length_1622_cov_7.969140	698	778	1	57	80	0.7125000
NODE_1970_length_1621_cov_2.192510	330	401	1	9	71	0.1267606
NODE_1970_length_1621_cov_2.192510	330	401	2	20	71	0.2816902
NODE_1970_length_1621_cov_2.192510	330	401	3	10	71	0.1408451
NODE_1970_length_1621_cov_2.192510	330	401	6	1	71	0.0140845
NODE_1970_length_1621_cov_2.192510	330	401	7	1	71	0.0140845
NODE_1970_length_1621_cov_2.192510	330	401	8	2	71	0.0281690
NODE_1970_length_1621_cov_2.192510	330	401	9	14	71	0.1971831
NODE_1970_length_1621_cov_2.192510	330	401	10	14	71	0.1971831
NODE_1975_length_1618_cov_44.138907	361	441	0	10	80	0.1250000
NODE_1975_length_1618_cov_44.138907	361	441	4	18	80	0.2250000
NODE_1975_length_1618_cov_44.138907	361	441	6	52	80	0.6500000
NODE_1975_length_1618_cov_44.138907	414	494	4	19	80	0.2375000
NODE_1975_length_1618_cov_44.138907	414	494	6	61	80	0.7625000
NODE_1975_length_1618_cov_44.138907	1063	1143	4	23	80	0.2875000
NODE_1975_length_1618_cov_44.138907	1063	1143	5	1	80	0.0125000
NODE_1975_length_1618_cov_44.138907	1063	1143	6	27	80	0.3375000
NODE_1975_length_1618_cov_44.138907	1063	1143	7	2	80	0.0250000
NODE_1975_length_1618_cov_44.138907	1063	1143	8	27	80	0.3375000
NODE_1975_length_1618_cov_44.138907	1116	1196	6	7	80	0.0875000
NODE_1975_length_1618_cov_44.138907	1116	1196	7	6	80	0.0750000
NODE_1975_length_1618_cov_44.138907	1116	1196	8	46	80	0.5750000
NODE_1975_length_1618_cov_44.138907	1116	1196	9	21	80	0.2625000
NODE_1976_length_1618_cov_5.779460	332	414	0	10	82	0.1219512
NODE_1976_length_1618_cov_5.779460	332	414	1	72	82	0.8780488
NODE_1976_length_1618_cov_5.779460	387	467	0	63	80	0.7875000
NODE_1976_length_1618_cov_5.779460	387	467	1	17	80	0.2125000
NODE_1976_length_1618_cov_5.779460	972	1028	1	3	56	0.0535714
NODE_1976_length_1618_cov_5.779460	972	1028	3	53	56	0.9464286
NODE_1980_length_1616_cov_5.313777	589	669	0	80	80	1.0000000
NODE_1980_length_1616_cov_5.313777	642	722	0	80	80	1.0000000
NODE_1981_length_1615_cov_12.575858	1032	1112	3	26	80	0.3250000
NODE_1981_length_1615_cov_12.575858	1032	1112	4	3	80	0.0375000
NODE_1981_length_1615_cov_12.575858	1032	1112	5	34	80	0.4250000
NODE_1981_length_1615_cov_12.575858	1032	1112	6	17	80	0.2125000
NODE_1981_length_1615_cov_12.575858	1085	1162	5	44	77	0.5714286
NODE_1981_length_1615_cov_12.575858	1085	1162	6	33	77	0.4285714
NODE_1981_length_1615_cov_12.575858	1158	1238	1	24	80	0.3000000
NODE_1981_length_1615_cov_12.575858	1158	1238	2	6	80	0.0750000
NODE_1981_length_1615_cov_12.575858	1158	1238	3	3	80	0.0375000
NODE_1981_length_1615_cov_12.575858	1158	1238	4	29	80	0.3625000
NODE_1981_length_1615_cov_12.575858	1158	1238	5	18	80	0.2250000
NODE_1981_length_1615_cov_12.575858	1211	1291	0	28	80	0.3500000
NODE_1981_length_1615_cov_12.575858	1211	1291	1	49	80	0.6125000
NODE_1981_length_1615_cov_12.575858	1211	1291	2	3	80	0.0375000
NODE_1983_length_1614_cov_94.900990	0	46	3	2	46	0.0434783
NODE_1983_length_1614_cov_94.900990	0	46	4	29	46	0.6304348
NODE_1983_length_1614_cov_94.900990	0	46	6	15	46	0.3260870
NODE_1983_length_1614_cov_94.900990	23	99	4	8	76	0.1052632
NODE_1983_length_1614_cov_94.900990	23	99	6	68	76	0.8947368
NODE_1984_length_1614_cov_18.799340	655	735	2	24	80	0.3000000
NODE_1984_length_1614_cov_18.799340	655	735	3	56	80	0.7000000
NODE_1984_length_1614_cov_18.799340	708	788	1	22	80	0.2750000
NODE_1984_length_1614_cov_18.799340	708	788	3	58	80	0.7250000
NODE_1986_length_1613_cov_6.865258	1128	1203	3	7	75	0.0933333
NODE_1986_length_1613_cov_6.865258	1128	1203	5	7	75	0.0933333
NODE_1986_length_1613_cov_6.865258	1128	1203	7	14	75	0.1866667
NODE_1986_length_1613_cov_6.865258	1128	1203	9	37	75	0.4933333
NODE_1986_length_1613_cov_6.865258	1128	1203	10	10	75	0.1333333
NODE_1986_length_1613_cov_6.865258	1176	1256	6	12	80	0.1500000
NODE_1986_length_1613_cov_6.865258	1176	1256	8	18	80	0.2250000
NODE_1986_length_1613_cov_6.865258	1176	1256	9	17	80	0.2125000
NODE_1986_length_1613_cov_6.865258	1176	1256	10	33	80	0.4125000
NODE_1993_length_1610_cov_18.014560	1035	1115	2	20	80	0.2500000
NODE_1993_length_1610_cov_18.014560	1035	1115	4	33	80	0.4125000
NODE_1993_length_1610_cov_18.014560	1035	1115	5	27	80	0.3375000
NODE_1993_length_1610_cov_18.014560	1088	1168	3	18	80	0.2250000
NODE_1993_length_1610_cov_18.014560	1088	1168	4	44	80	0.5500000
NODE_1993_length_1610_cov_18.014560	1088	1168	5	18	80	0.2250000
NODE_2001_length_1603_cov_9.128324	1109	1189	1	1	80	0.0125000
NODE_2001_length_1603_cov_9.128324	1109	1189	2	12	80	0.1500000
NODE_2001_length_1603_cov_9.128324	1109	1189	4	67	80	0.8375000
NODE_2001_length_1603_cov_9.128324	1162	1242	4	28	80	0.3500000
NODE_2001_length_1603_cov_9.128324	1162	1242	5	49	80	0.6125000
NODE_2001_length_1603_cov_9.128324	1162	1242	6	3	80	0.0375000
NODE_2003_length_1602_cov_79.840319	1378	1445	57	3	67	0.0447761
NODE_2003_length_1602_cov_79.840319	1378	1445	58	1	67	0.0149254
NODE_2003_length_1602_cov_79.840319	1378	1445	60	1	67	0.0149254
NODE_2003_length_1602_cov_79.840319	1378	1445	63	3	67	0.0447761
NODE_2003_length_1602_cov_79.840319	1378	1445	64	1	67	0.0149254
NODE_2003_length_1602_cov_79.840319	1378	1445	65	4	67	0.0597015
NODE_2003_length_1602_cov_79.840319	1378	1445	67	5	67	0.0746269
NODE_2003_length_1602_cov_79.840319	1378	1445	68	1	67	0.0149254
NODE_2003_length_1602_cov_79.840319	1378	1445	69	3	67	0.0447761
NODE_2003_length_1602_cov_79.840319	1378	1445	70	1	67	0.0149254
NODE_2003_length_1602_cov_79.840319	1378	1445	71	1	67	0.0149254
NODE_2003_length_1602_cov_79.840319	1378	1445	74	2	67	0.0298507
NODE_2003_length_1602_cov_79.840319	1378	1445	75	2	67	0.0298507
NODE_2003_length_1602_cov_79.840319	1378	1445	76	3	67	0.0447761
NODE_2003_length_1602_cov_79.840319	1378	1445	78	1	67	0.0149254
NODE_2003_length_1602_cov_79.840319	1378	1445	80	2	67	0.0298507
NODE_2003_length_1602_cov_79.840319	1378	1445	81	1	67	0.0149254
NODE_2003_length_1602_cov_79.840319	1378	1445	82	1	67	0.0149254
NODE_2003_length_1602_cov_79.840319	1378	1445	86	3	67	0.0447761
NODE_2003_length_1602_cov_79.840319	1378	1445	87	1	67	0.0149254
NODE_2003_length_1602_cov_79.840319	1378	1445	90	1	67	0.0149254
NODE_2003_length_1602_cov_79.840319	1378	1445	93	1	67	0.0149254
NODE_2003_length_1602_cov_79.840319	1378	1445	94	2	67	0.0298507
NODE_2003_length_1602_cov_79.840319	1378	1445	95	1	67	0.0149254
NODE_2003_length_1602_cov_79.840319	1378	1445	96	1	67	0.0149254
NODE_2003_length_1602_cov_79.840319	1378	1445	97	4	67	0.0597015
NODE_2003_length_1602_cov_79.840319	1378	1445	98	2	67	0.0298507
NODE_2003_length_1602_cov_79.840319	1378	1445	99	1	67	0.0149254
NODE_2003_length_1602_cov_79.840319	1378	1445	103	1	67	0.0149254
NODE_2003_length_1602_cov_79.840319	1378	1445	104	1	67	0.0149254
NODE_2003_length_1602_cov_79.840319	1378	1445	105	1	67	0.0149254
NODE_2003_length_1602_cov_79.840319	1378	1445	106	2	67	0.0298507
NODE_2003_length_1602_cov_79.840319	1378	1445	107	2	67	0.0298507
NODE_2003_length_1602_cov_79.840319	1378	1445	108	2	67	0.0298507
NODE_2003_length_1602_cov_79.840319	1378	1445	109	2	67	0.0298507
NODE_2003_length_1602_cov_79.840319	1378	1445	110	1	67	0.0149254
NODE_2003_length_1602_cov_79.840319	1378	1445	111	2	67	0.0298507
NODE_2003_length_1602_cov_79.840319	1462	1508	11	2	46	0.0434783
NODE_2003_length_1602_cov_79.840319	1462	1508	13	1	46	0.0217391
NODE_2003_length_1602_cov_79.840319	1462	1508	14	7	46	0.1521739
NODE_2003_length_1602_cov_79.840319	1462	1508	16	1	46	0.0217391
NODE_2003_length_1602_cov_79.840319	1462	1508	18	1	46	0.0217391
NODE_2003_length_1602_cov_79.840319	1462	1508	19	3	46	0.0652174
NODE_2003_length_1602_cov_79.840319	1462	1508	24	2	46	0.0434783
NODE_2003_length_1602_cov_79.840319	1462	1508	27	2	46	0.0434783
NODE_2003_length_1602_cov_79.840319	1462	1508	28	2	46	0.0434783
NODE_2003_length_1602_cov_79.840319	1462	1508	29	2	46	0.0434783
NODE_2003_length_1602_cov_79.840319	1462	1508	31	4	46	0.0869565
NODE_2003_length_1602_cov_79.840319	1462	1508	32	1	46	0.0217391
NODE_2003_length_1602_cov_79.840319	1462	1508	34	4	46	0.0869565
NODE_2003_length_1602_cov_79.840319	1462	1508	39	1	46	0.0217391
NODE_2003_length_1602_cov_79.840319	1462	1508	40	1	46	0.0217391
NODE_2003_length_1602_cov_79.840319	1462	1508	41	2	46	0.0434783
NODE_2003_length_1602_cov_79.840319	1462	1508	42	3	46	0.0652174
NODE_2003_length_1602_cov_79.840319	1462	1508	43	2	46	0.0434783
NODE_2003_length_1602_cov_79.840319	1462	1508	44	1	46	0.0217391
NODE_2003_length_1602_cov_79.840319	1462	1508	45	3	46	0.0652174
NODE_2003_length_1602_cov_79.840319	1462	1508	46	1	46	0.0217391
NODE_2004_length_1602_cov_2.701264	1490	1570	2	80	80	1.0000000
NODE_2009_length_1600_cov_34.988008	785	865	8	5	80	0.0625000
NODE_2009_length_1600_cov_34.988008	785	865	9	42	80	0.5250000
NODE_2009_length_1600_cov_34.988008	785	865	10	22	80	0.2750000
NODE_2009_length_1600_cov_34.988008	785	865	11	11	80	0.1375000
NODE_2009_length_1600_cov_34.988008	838	918	5	10	80	0.1250000
NODE_2009_length_1600_cov_34.988008	838	918	6	5	80	0.0625000
NODE_2009_length_1600_cov_34.988008	838	918	7	20	80	0.2500000
NODE_2009_length_1600_cov_34.988008	838	918	8	23	80	0.2875000
NODE_2009_length_1600_cov_34.988008	838	918	9	11	80	0.1375000
NODE_2009_length_1600_cov_34.988008	838	918	11	11	80	0.1375000
NODE_2009_length_1600_cov_34.988008	914	994	3	6	80	0.0750000
NODE_2009_length_1600_cov_34.988008	914	994	4	14	80	0.1750000
NODE_2009_length_1600_cov_34.988008	914	994	5	60	80	0.7500000
NODE_2009_length_1600_cov_34.988008	967	1047	3	13	80	0.1625000
NODE_2009_length_1600_cov_34.988008	967	1047	4	10	80	0.1250000
NODE_2009_length_1600_cov_34.988008	967	1047	5	18	80	0.2250000
NODE_2009_length_1600_cov_34.988008	967	1047	6	39	80	0.4875000
NODE_2011_length_1600_cov_11.383744	0	72	0	19	72	0.2638889
NODE_2011_length_1600_cov_11.383744	0	72	1	53	72	0.7361111
NODE_2011_length_1600_cov_11.383744	45	99	1	54	54	1.0000000
NODE_2011_length_1600_cov_11.383744	891	971	5	10	80	0.1250000
NODE_2011_length_1600_cov_11.383744	891	971	6	48	80	0.6000000
NODE_2011_length_1600_cov_11.383744	891	971	7	15	80	0.1875000
NODE_2011_length_1600_cov_11.383744	891	971	8	7	80	0.0875000
NODE_2011_length_1600_cov_11.383744	944	1024	1	18	80	0.2250000
NODE_2011_length_1600_cov_11.383744	944	1024	2	6	80	0.0750000
NODE_2011_length_1600_cov_11.383744	944	1024	3	23	80	0.2875000
NODE_2011_length_1600_cov_11.383744	944	1024	4	1	80	0.0125000
NODE_2011_length_1600_cov_11.383744	944	1024	5	15	80	0.1875000
NODE_2011_length_1600_cov_11.383744	944	1024	6	17	80	0.2125000
NODE_2013_length_1600_cov_7.236509	1037	1109	0	72	72	1.0000000
NODE_2013_length_1600_cov_7.236509	1090	1160	0	70	70	1.0000000
NODE_2018_length_1598_cov_29.337558	335	415	9	8	80	0.1000000
NODE_2018_length_1598_cov_29.337558	335	415	10	18	80	0.2250000
NODE_2018_length_1598_cov_29.337558	335	415	11	54	80	0.6750000
NODE_2018_length_1598_cov_29.337558	388	468	5	5	80	0.0625000
NODE_2018_length_1598_cov_29.337558	388	468	6	20	80	0.2500000
NODE_2018_length_1598_cov_29.337558	388	468	7	8	80	0.1000000
NODE_2018_length_1598_cov_29.337558	388	468	8	4	80	0.0500000
NODE_2018_length_1598_cov_29.337558	388	468	9	3	80	0.0375000
NODE_2018_length_1598_cov_29.337558	388	468	10	4	80	0.0500000
NODE_2018_length_1598_cov_29.337558	388	468	11	29	80	0.3625000
NODE_2018_length_1598_cov_29.337558	388	468	12	3	80	0.0375000
NODE_2018_length_1598_cov_29.337558	388	468	13	3	80	0.0375000
NODE_2018_length_1598_cov_29.337558	388	468	15	1	80	0.0125000
NODE_2018_length_1598_cov_29.337558	464	516	13	8	52	0.1538462
NODE_2018_length_1598_cov_29.337558	464	516	14	14	52	0.2692308
NODE_2018_length_1598_cov_29.337558	464	516	15	12	52	0.2307692
NODE_2018_length_1598_cov_29.337558	464	516	16	18	52	0.3461539
NODE_2018_length_1598_cov_29.337558	1026	1106	2	34	80	0.4250000
NODE_2018_length_1598_cov_29.337558	1026	1106	3	46	80	0.5750000
NODE_2018_length_1598_cov_29.337558	1079	1159	2	9	80	0.1125000
NODE_2018_length_1598_cov_29.337558	1079	1159	3	66	80	0.8250000
NODE_2018_length_1598_cov_29.337558	1079	1159	4	5	80	0.0625000
NODE_2019_length_1598_cov_3.730487	1117	1197	0	80	80	1.0000000
NODE_2021_length_1597_cov_7.434579	1373	1453	6	8	80	0.1000000
NODE_2021_length_1597_cov_7.434579	1373	1453	8	23	80	0.2875000
NODE_2021_length_1597_cov_7.434579	1373	1453	10	9	80	0.1125000
NODE_2021_length_1597_cov_7.434579	1373	1453	11	5	80	0.0625000
NODE_2021_length_1597_cov_7.434579	1373	1453	12	3	80	0.0375000
NODE_2021_length_1597_cov_7.434579	1373	1453	13	3	80	0.0375000
NODE_2021_length_1597_cov_7.434579	1373	1453	14	2	80	0.0250000
NODE_2021_length_1597_cov_7.434579	1373	1453	15	8	80	0.1000000
NODE_2021_length_1597_cov_7.434579	1373	1453	18	2	80	0.0250000
NODE_2021_length_1597_cov_7.434579	1373	1453	19	4	80	0.0500000
NODE_2021_length_1597_cov_7.434579	1373	1453	23	2	80	0.0250000
NODE_2021_length_1597_cov_7.434579	1373	1453	26	1	80	0.0125000
NODE_2021_length_1597_cov_7.434579	1373	1453	27	1	80	0.0125000
NODE_2021_length_1597_cov_7.434579	1373	1453	29	1	80	0.0125000
NODE_2021_length_1597_cov_7.434579	1373	1453	32	4	80	0.0500000
NODE_2021_length_1597_cov_7.434579	1373	1453	33	4	80	0.0500000
NODE_2021_length_1597_cov_7.434579	1382	1453	8	22	71	0.3098592
NODE_2021_length_1597_cov_7.434579	1382	1453	10	9	71	0.1267606
NODE_2021_length_1597_cov_7.434579	1382	1453	11	5	71	0.0704225
NODE_2021_length_1597_cov_7.434579	1382	1453	12	3	71	0.0422535
NODE_2021_length_1597_cov_7.434579	1382	1453	13	3	71	0.0422535
NODE_2021_length_1597_cov_7.434579	1382	1453	14	2	71	0.0281690
NODE_2021_length_1597_cov_7.434579	1382	1453	15	8	71	0.1126761
NODE_2021_length_1597_cov_7.434579	1382	1453	18	2	71	0.0281690
NODE_2021_length_1597_cov_7.434579	1382	1453	19	4	71	0.0563380
NODE_2021_length_1597_cov_7.434579	1382	1453	23	2	71	0.0281690
NODE_2021_length_1597_cov_7.434579	1382	1453	26	1	71	0.0140845
NODE_2021_length_1597_cov_7.434579	1382	1453	27	1	71	0.0140845
NODE_2021_length_1597_cov_7.434579	1382	1453	29	1	71	0.0140845
NODE_2021_length_1597_cov_7.434579	1382	1453	32	4	71	0.0563380
NODE_2021_length_1597_cov_7.434579	1382	1453	33	4	71	0.0563380
NODE_2022_length_1595_cov_16.788770	215	267	11	3	52	0.0576923
NODE_2022_length_1595_cov_16.788770	215	267	12	1	52	0.0192308
NODE_2022_length_1595_cov_16.788770	215	267	13	9	52	0.1730769
NODE_2022_length_1595_cov_16.788770	215	267	15	17	52	0.3269231
NODE_2022_length_1595_cov_16.788770	215	267	16	21	52	0.4038461
NODE_2022_length_1595_cov_16.788770	215	267	17	1	52	0.0192308
NODE_2022_length_1595_cov_16.788770	614	673	13	2	59	0.0338983
NODE_2022_length_1595_cov_16.788770	614	673	15	20	59	0.3389831
NODE_2022_length_1595_cov_16.788770	614	673	16	4	59	0.0677966
NODE_2022_length_1595_cov_16.788770	614	673	17	13	59	0.2203390
NODE_2022_length_1595_cov_16.788770	614	673	18	9	59	0.1525424
NODE_2022_length_1595_cov_16.788770	614	673	19	11	59	0.1864407
NODE_2025_length_1593_cov_22.412316	144	224	3	13	80	0.1625000
NODE_2025_length_1593_cov_22.412316	144	224	4	8	80	0.1000000
NODE_2025_length_1593_cov_22.412316	144	224	5	7	80	0.0875000
NODE_2025_length_1593_cov_22.412316	144	224	6	52	80	0.6500000
NODE_2025_length_1593_cov_22.412316	197	277	3	7	80	0.0875000
NODE_2025_length_1593_cov_22.412316	197	277	5	19	80	0.2375000
NODE_2025_length_1593_cov_22.412316	197	277	6	54	80	0.6750000
NODE_2025_length_1593_cov_22.412316	1192	1272	9	8	80	0.1000000
NODE_2025_length_1593_cov_22.412316	1192	1272	10	38	80	0.4750000
NODE_2025_length_1593_cov_22.412316	1192	1272	11	23	80	0.2875000
NODE_2025_length_1593_cov_22.412316	1192	1272	12	3	80	0.0375000
NODE_2025_length_1593_cov_22.412316	1192	1272	13	8	80	0.1000000
NODE_2025_length_1593_cov_22.412316	1245	1325	7	10	80	0.1250000
NODE_2025_length_1593_cov_22.412316	1245	1325	8	1	80	0.0125000
NODE_2025_length_1593_cov_22.412316	1245	1325	10	23	80	0.2875000
NODE_2025_length_1593_cov_22.412316	1245	1325	11	16	80	0.2000000
NODE_2025_length_1593_cov_22.412316	1245	1325	12	15	80	0.1875000
NODE_2025_length_1593_cov_22.412316	1245	1325	13	15	80	0.1875000
NODE_2026_length_1593_cov_14.092369	357	437	2	30	80	0.3750000
NODE_2026_length_1593_cov_14.092369	357	437	3	50	80	0.6250000
NODE_2026_length_1593_cov_14.092369	410	490	1	49	80	0.6125000
NODE_2026_length_1593_cov_14.092369	410	490	2	23	80	0.2875000
NODE_2026_length_1593_cov_14.092369	410	490	3	8	80	0.1000000
NODE_2026_length_1593_cov_14.092369	1061	1141	1	17	80	0.2125000
NODE_2026_length_1593_cov_14.092369	1061	1141	2	63	80	0.7875000
NODE_2026_length_1593_cov_14.092369	1114	1194	1	43	80	0.5375000
NODE_2026_length_1593_cov_14.092369	1114	1194	2	37	80	0.4625000
NODE_2031_length_1592_cov_4.576691	277	357	2	80	80	1.0000000
NODE_2031_length_1592_cov_4.576691	330	410	0	33	80	0.4125000
NODE_2031_length_1592_cov_4.576691	330	410	2	47	80	0.5875000
NODE_2034_length_1591_cov_15.481233	841	921	5	15	80	0.1875000
NODE_2034_length_1591_cov_15.481233	841	921	6	9	80	0.1125000
NODE_2034_length_1591_cov_15.481233	841	921	7	4	80	0.0500000
NODE_2034_length_1591_cov_15.481233	841	921	9	18	80	0.2250000
NODE_2034_length_1591_cov_15.481233	841	921	10	16	80	0.2000000
NODE_2034_length_1591_cov_15.481233	841	921	11	11	80	0.1375000
NODE_2034_length_1591_cov_15.481233	841	921	12	7	80	0.0875000
NODE_2034_length_1591_cov_15.481233	894	974	7	7	80	0.0875000
NODE_2034_length_1591_cov_15.481233	894	974	8	2	80	0.0250000
NODE_2034_length_1591_cov_15.481233	894	974	9	5	80	0.0625000
NODE_2034_length_1591_cov_15.481233	894	974	10	32	80	0.4000000
NODE_2034_length_1591_cov_15.481233	894	974	11	14	80	0.1750000
NODE_2034_length_1591_cov_15.481233	894	974	12	20	80	0.2500000
NODE_2035_length_1591_cov_4.040885	35	65	0	30	30	1.0000000
NODE_2035_length_1591_cov_4.040885	38	99	0	59	61	0.9672131
NODE_2035_length_1591_cov_4.040885	38	99	2	1	61	0.0163934
NODE_2035_length_1591_cov_4.040885	38	99	7	1	61	0.0163934
NODE_2042_length_1589_cov_10.184564	379	459	0	20	80	0.2500000
NODE_2042_length_1589_cov_10.184564	379	459	1	17	80	0.2125000
NODE_2042_length_1589_cov_10.184564	379	459	2	43	80	0.5375000
NODE_2042_length_1589_cov_10.184564	432	512	2	80	80	1.0000000
NODE_2042_length_1589_cov_10.184564	473	512	2	39	39	1.0000000
NODE_2042_length_1589_cov_10.184564	508	588	1	37	80	0.4625000
NODE_2042_length_1589_cov_10.184564	508	588	2	43	80	0.5375000
NODE_2042_length_1589_cov_10.184564	561	641	1	80	80	1.0000000
NODE_2043_length_1588_cov_9.955675	415	495	0	80	80	1.0000000
NODE_2043_length_1588_cov_9.955675	468	548	0	80	80	1.0000000
NODE_2046_length_1587_cov_7.942204	710	790	5	5	80	0.0625000
NODE_2046_length_1587_cov_7.942204	710	790	6	3	80	0.0375000
NODE_2046_length_1587_cov_7.942204	710	790	8	2	80	0.0250000
NODE_2046_length_1587_cov_7.942204	710	790	9	12	80	0.1500000
NODE_2046_length_1587_cov_7.942204	710	790	10	31	80	0.3875000
NODE_2046_length_1587_cov_7.942204	710	790	11	1	80	0.0125000
NODE_2046_length_1587_cov_7.942204	710	790	12	3	80	0.0375000
NODE_2046_length_1587_cov_7.942204	710	790	13	12	80	0.1500000
NODE_2046_length_1587_cov_7.942204	710	790	14	6	80	0.0750000
NODE_2046_length_1587_cov_7.942204	710	790	15	5	80	0.0625000
NODE_2046_length_1587_cov_7.942204	763	843	1	13	80	0.1625000
NODE_2046_length_1587_cov_7.942204	763	843	3	39	80	0.4875000
NODE_2046_length_1587_cov_7.942204	763	843	5	6	80	0.0750000
NODE_2046_length_1587_cov_7.942204	763	843	6	3	80	0.0375000
NODE_2046_length_1587_cov_7.942204	763	843	8	2	80	0.0250000
NODE_2046_length_1587_cov_7.942204	763	843	9	12	80	0.1500000
NODE_2046_length_1587_cov_7.942204	763	843	10	5	80	0.0625000
NODE_2049_length_1586_cov_6.488231	447	474	1	1	27	0.0370370
NODE_2049_length_1586_cov_6.488231	447	474	3	26	27	0.9629630
NODE_2049_length_1586_cov_6.488231	447	527	1	1	80	0.0125000
NODE_2049_length_1586_cov_6.488231	447	527	3	79	80	0.9875000
NODE_2049_length_1586_cov_6.488231	500	580	0	7	80	0.0875000
NODE_2049_length_1586_cov_6.488231	500	580	2	36	80	0.4500000
NODE_2049_length_1586_cov_6.488231	500	580	3	37	80	0.4625000
NODE_2056_length_1583_cov_27.825472	800	880	3	4	80	0.0500000
NODE_2056_length_1583_cov_27.825472	800	880	4	25	80	0.3125000
NODE_2056_length_1583_cov_27.825472	800	880	5	51	80	0.6375000
NODE_2056_length_1583_cov_27.825472	853	933	5	80	80	1.0000000
NODE_2056_length_1583_cov_27.825472	929	1009	1	30	80	0.3750000
NODE_2056_length_1583_cov_27.825472	929	1009	2	25	80	0.3125000
NODE_2056_length_1583_cov_27.825472	929	1009	3	5	80	0.0625000
NODE_2056_length_1583_cov_27.825472	929	1009	4	14	80	0.1750000
NODE_2056_length_1583_cov_27.825472	929	1009	5	6	80	0.0750000
NODE_2056_length_1583_cov_27.825472	982	1062	1	80	80	1.0000000
NODE_2060_length_1581_cov_10.610661	457	537	3	12	80	0.1500000
NODE_2060_length_1581_cov_10.610661	457	537	6	68	80	0.8500000
NODE_2060_length_1581_cov_10.610661	510	590	0	3	80	0.0375000
NODE_2060_length_1581_cov_10.610661	510	590	3	62	80	0.7750000
NODE_2060_length_1581_cov_10.610661	510	590	6	15	80	0.1875000
NODE_2065_length_1579_cov_7.395946	5	80	0	75	75	1.0000000
NODE_2065_length_1579_cov_7.395946	58	126	0	68	68	1.0000000
NODE_2066_length_1579_cov_7.152027	1331	1409	3	21	78	0.2692308
NODE_2066_length_1579_cov_7.152027	1331	1409	4	9	78	0.1153846
NODE_2066_length_1579_cov_7.152027	1331	1409	5	8	78	0.1025641
NODE_2066_length_1579_cov_7.152027	1331	1409	6	40	78	0.5128205
NODE_2066_length_1579_cov_7.152027	1382	1462	4	11	80	0.1375000
NODE_2066_length_1579_cov_7.152027	1382	1462	5	50	80	0.6250000
NODE_2066_length_1579_cov_7.152027	1382	1462	6	19	80	0.2375000
NODE_2067_length_1579_cov_6.741892	4	52	5	37	48	0.7708333
NODE_2067_length_1579_cov_6.741892	4	52	6	11	48	0.2291667
NODE_2067_length_1579_cov_6.741892	4	52	5	37	48	0.7708333
NODE_2067_length_1579_cov_6.741892	4	52	6	11	48	0.2291667
NODE_2067_length_1579_cov_6.741892	4	52	5	37	48	0.7708333
NODE_2067_length_1579_cov_6.741892	4	52	6	11	48	0.2291667
NODE_2067_length_1579_cov_6.741892	25	105	5	16	80	0.2000000
NODE_2067_length_1579_cov_6.741892	25	105	6	27	80	0.3375000
NODE_2067_length_1579_cov_6.741892	25	105	7	5	80	0.0625000
NODE_2067_length_1579_cov_6.741892	25	105	8	12	80	0.1500000
NODE_2067_length_1579_cov_6.741892	25	105	9	20	80	0.2500000
NODE_2067_length_1579_cov_6.741892	25	91	5	16	66	0.2424242
NODE_2067_length_1579_cov_6.741892	25	91	6	27	66	0.4090909
NODE_2067_length_1579_cov_6.741892	25	91	7	5	66	0.0757576
NODE_2067_length_1579_cov_6.741892	25	91	8	12	66	0.1818182
NODE_2067_length_1579_cov_6.741892	25	91	9	6	66	0.0909091
NODE_2067_length_1579_cov_6.741892	25	96	5	16	71	0.2253521
NODE_2067_length_1579_cov_6.741892	25	96	6	27	71	0.3802817
NODE_2067_length_1579_cov_6.741892	25	96	7	5	71	0.0704225
NODE_2067_length_1579_cov_6.741892	25	96	8	12	71	0.1690141
NODE_2067_length_1579_cov_6.741892	25	96	9	11	71	0.1549296
NODE_2076_length_1575_cov_4.250000	993	1073	1	80	80	1.0000000
NODE_2076_length_1575_cov_4.250000	1046	1126	0	8	80	0.1000000
NODE_2076_length_1575_cov_4.250000	1046	1126	1	72	80	0.9000000
NODE_2078_length_1574_cov_40.682034	551	631	7	17	80	0.2125000
NODE_2078_length_1574_cov_40.682034	551	631	8	63	80	0.7875000
NODE_2078_length_1574_cov_40.682034	604	684	4	17	80	0.2125000
NODE_2078_length_1574_cov_40.682034	604	684	5	8	80	0.1000000
NODE_2078_length_1574_cov_40.682034	604	684	6	3	80	0.0375000
NODE_2078_length_1574_cov_40.682034	604	684	7	28	80	0.3500000
NODE_2078_length_1574_cov_40.682034	604	684	8	24	80	0.3000000
NODE_2078_length_1574_cov_40.682034	680	760	2	49	80	0.6125000
NODE_2078_length_1574_cov_40.682034	680	760	3	23	80	0.2875000
NODE_2078_length_1574_cov_40.682034	680	760	4	8	80	0.1000000
NODE_2078_length_1574_cov_40.682034	733	813	2	80	80	1.0000000
NODE_2079_length_1574_cov_7.572203	1306	1386	0	20	80	0.2500000
NODE_2079_length_1574_cov_7.572203	1306	1386	2	60	80	0.7500000
NODE_2079_length_1574_cov_7.572203	1359	1439	2	80	80	1.0000000
NODE_2081_length_1573_cov_16.107191	437	512	1	12	75	0.1600000
NODE_2081_length_1573_cov_16.107191	437	512	2	33	75	0.4400000
NODE_2081_length_1573_cov_16.107191	437	512	3	30	75	0.4000000
NODE_2081_length_1573_cov_16.107191	485	565	2	62	80	0.7750000
NODE_2081_length_1573_cov_16.107191	485	565	3	18	80	0.2250000
NODE_2081_length_1573_cov_16.107191	561	639	0	16	78	0.2051282
NODE_2081_length_1573_cov_16.107191	561	639	1	26	78	0.3333333
NODE_2081_length_1573_cov_16.107191	561	639	2	36	78	0.4615385
NODE_2081_length_1573_cov_16.107191	612	692	0	41	80	0.5125000
NODE_2081_length_1573_cov_16.107191	612	692	1	39	80	0.4875000
NODE_2085_length_1572_cov_25.966735	359	404	196	1	45	0.0222222
NODE_2085_length_1572_cov_25.966735	359	404	197	2	45	0.0444444
NODE_2085_length_1572_cov_25.966735	359	404	198	1	45	0.0222222
NODE_2085_length_1572_cov_25.966735	359	404	200	2	45	0.0444444
NODE_2085_length_1572_cov_25.966735	359	404	202	1	45	0.0222222
NODE_2085_length_1572_cov_25.966735	359	404	203	3	45	0.0666667
NODE_2085_length_1572_cov_25.966735	359	404	205	6	45	0.1333333
NODE_2085_length_1572_cov_25.966735	359	404	206	3	45	0.0666667
NODE_2085_length_1572_cov_25.966735	359	404	207	10	45	0.2222222
NODE_2085_length_1572_cov_25.966735	359	404	208	3	45	0.0666667
NODE_2085_length_1572_cov_25.966735	359	404	209	5	45	0.1111111
NODE_2085_length_1572_cov_25.966735	359	404	210	6	45	0.1333333
NODE_2085_length_1572_cov_25.966735	359	404	211	2	45	0.0444444
NODE_2085_length_1572_cov_25.966735	405	477	161	1	72	0.0138889
NODE_2085_length_1572_cov_25.966735	405	477	163	2	72	0.0277778
NODE_2085_length_1572_cov_25.966735	405	477	165	1	72	0.0138889
NODE_2085_length_1572_cov_25.966735	405	477	166	2	72	0.0277778
NODE_2085_length_1572_cov_25.966735	405	477	168	2	72	0.0277778
NODE_2085_length_1572_cov_25.966735	405	477	169	1	72	0.0138889
NODE_2085_length_1572_cov_25.966735	405	477	170	2	72	0.0277778
NODE_2085_length_1572_cov_25.966735	405	477	173	1	72	0.0138889
NODE_2085_length_1572_cov_25.966735	405	477	177	3	72	0.0416667
NODE_2085_length_1572_cov_25.966735	405	477	179	1	72	0.0138889
NODE_2085_length_1572_cov_25.966735	405	477	183	1	72	0.0138889
NODE_2085_length_1572_cov_25.966735	405	477	184	1	72	0.0138889
NODE_2085_length_1572_cov_25.966735	405	477	185	2	72	0.0277778
NODE_2085_length_1572_cov_25.966735	405	477	186	4	72	0.0555556
NODE_2085_length_1572_cov_25.966735	405	477	187	4	72	0.0555556
NODE_2085_length_1572_cov_25.966735	405	477	188	1	72	0.0138889
NODE_2085_length_1572_cov_25.966735	405	477	189	1	72	0.0138889
NODE_2085_length_1572_cov_25.966735	405	477	190	1	72	0.0138889
NODE_2085_length_1572_cov_25.966735	405	477	192	1	72	0.0138889
NODE_2085_length_1572_cov_25.966735	405	477	193	2	72	0.0277778
NODE_2085_length_1572_cov_25.966735	405	477	195	2	72	0.0277778
NODE_2085_length_1572_cov_25.966735	405	477	201	1	72	0.0138889
NODE_2085_length_1572_cov_25.966735	405	477	202	1	72	0.0138889
NODE_2085_length_1572_cov_25.966735	405	477	203	4	72	0.0555556
NODE_2085_length_1572_cov_25.966735	405	477	204	5	72	0.0694444
NODE_2085_length_1572_cov_25.966735	405	477	205	5	72	0.0694444
NODE_2085_length_1572_cov_25.966735	405	477	206	8	72	0.1111111
NODE_2085_length_1572_cov_25.966735	405	477	207	7	72	0.0972222
NODE_2085_length_1572_cov_25.966735	405	477	208	1	72	0.0138889
NODE_2085_length_1572_cov_25.966735	405	477	209	3	72	0.0416667
NODE_2085_length_1572_cov_25.966735	405	477	212	1	72	0.0138889
NODE_2085_length_1572_cov_25.966735	1016	1096	1	55	80	0.6875000
NODE_2085_length_1572_cov_25.966735	1016	1096	2	1	80	0.0125000
NODE_2085_length_1572_cov_25.966735	1016	1096	3	21	80	0.2625000
NODE_2085_length_1572_cov_25.966735	1016	1096	4	3	80	0.0375000
NODE_2085_length_1572_cov_25.966735	1069	1149	1	3	80	0.0375000
NODE_2085_length_1572_cov_25.966735	1069	1149	3	21	80	0.2625000
NODE_2085_length_1572_cov_25.966735	1069	1149	4	51	80	0.6375000
NODE_2085_length_1572_cov_25.966735	1069	1149	5	5	80	0.0625000
NODE_2086_length_1572_cov_3.513238	1386	1462	13	2	76	0.0263158
NODE_2086_length_1572_cov_3.513238	1386	1462	14	1	76	0.0131579
NODE_2086_length_1572_cov_3.513238	1386	1462	15	5	76	0.0657895
NODE_2086_length_1572_cov_3.513238	1386	1462	16	6	76	0.0789474
NODE_2086_length_1572_cov_3.513238	1386	1462	17	34	76	0.4473684
NODE_2086_length_1572_cov_3.513238	1386	1462	18	6	76	0.0789474
NODE_2086_length_1572_cov_3.513238	1386	1462	19	8	76	0.1052632
NODE_2086_length_1572_cov_3.513238	1386	1462	21	14	76	0.1842105
NODE_2090_length_1570_cov_21.745071	700	780	2	15	80	0.1875000
NODE_2090_length_1570_cov_21.745071	700	780	3	61	80	0.7625000
NODE_2090_length_1570_cov_21.745071	700	780	4	4	80	0.0500000
NODE_2090_length_1570_cov_21.745071	753	833	3	80	80	1.0000000
NODE_2091_length_1570_cov_3.276003	387	467	0	80	80	1.0000000
NODE_2091_length_1570_cov_3.276003	440	520	0	80	80	1.0000000
NODE_2093_length_1569_cov_53.941497	741	821	4	8	80	0.1000000
NODE_2093_length_1569_cov_53.941497	741	821	5	3	80	0.0375000
NODE_2093_length_1569_cov_53.941497	741	821	6	12	80	0.1500000
NODE_2093_length_1569_cov_53.941497	741	821	8	32	80	0.4000000
NODE_2093_length_1569_cov_53.941497	741	821	9	25	80	0.3125000
NODE_2093_length_1569_cov_53.941497	794	874	8	38	80	0.4750000
NODE_2093_length_1569_cov_53.941497	794	874	9	37	80	0.4625000
NODE_2093_length_1569_cov_53.941497	794	874	10	5	80	0.0625000
NODE_2093_length_1569_cov_53.941497	870	950	2	5	80	0.0625000
NODE_2093_length_1569_cov_53.941497	870	950	3	19	80	0.2375000
NODE_2093_length_1569_cov_53.941497	870	950	4	16	80	0.2000000
NODE_2093_length_1569_cov_53.941497	870	950	6	11	80	0.1375000
NODE_2093_length_1569_cov_53.941497	870	950	7	14	80	0.1750000
NODE_2093_length_1569_cov_53.941497	870	950	9	15	80	0.1875000
NODE_2093_length_1569_cov_53.941497	923	1003	1	13	80	0.1625000
NODE_2093_length_1569_cov_53.941497	923	1003	2	45	80	0.5625000
NODE_2093_length_1569_cov_53.941497	923	1003	3	19	80	0.2375000
NODE_2093_length_1569_cov_53.941497	923	1003	4	3	80	0.0375000
NODE_2094_length_1569_cov_12.426531	640	720	0	29	80	0.3625000
NODE_2094_length_1569_cov_12.426531	640	720	1	51	80	0.6375000
NODE_2094_length_1569_cov_12.426531	693	773	1	49	80	0.6125000
NODE_2094_length_1569_cov_12.426531	693	773	2	16	80	0.2000000
NODE_2094_length_1569_cov_12.426531	693	773	3	15	80	0.1875000
NODE_2094_length_1569_cov_12.426531	769	849	2	31	80	0.3875000
NODE_2094_length_1569_cov_12.426531	769	849	3	49	80	0.6125000
NODE_2094_length_1569_cov_12.426531	822	902	1	10	80	0.1250000
NODE_2094_length_1569_cov_12.426531	822	902	2	70	80	0.8750000
NODE_2095_length_1569_cov_12.365986	450	530	9	9	80	0.1125000
NODE_2095_length_1569_cov_12.365986	450	530	12	10	80	0.1250000
NODE_2095_length_1569_cov_12.365986	450	530	13	48	80	0.6000000
NODE_2095_length_1569_cov_12.365986	450	530	14	13	80	0.1625000
NODE_2095_length_1569_cov_12.365986	450	530	9	9	80	0.1125000
NODE_2095_length_1569_cov_12.365986	450	530	12	10	80	0.1250000
NODE_2095_length_1569_cov_12.365986	450	530	13	48	80	0.6000000
NODE_2095_length_1569_cov_12.365986	450	530	14	13	80	0.1625000
NODE_2095_length_1569_cov_12.365986	503	564	9	3	61	0.0491803
NODE_2095_length_1569_cov_12.365986	503	564	10	22	61	0.3606557
NODE_2095_length_1569_cov_12.365986	503	564	11	4	61	0.0655738
NODE_2095_length_1569_cov_12.365986	503	564	13	19	61	0.3114754
NODE_2095_length_1569_cov_12.365986	503	564	14	13	61	0.2131148
NODE_2095_length_1569_cov_12.365986	503	556	10	17	53	0.3207547
NODE_2095_length_1569_cov_12.365986	503	556	11	4	53	0.0754717
NODE_2095_length_1569_cov_12.365986	503	556	13	19	53	0.3584906
NODE_2095_length_1569_cov_12.365986	503	556	14	13	53	0.2452830
NODE_2096_length_1569_cov_11.599320	798	878	2	46	80	0.5750000
NODE_2096_length_1569_cov_11.599320	798	878	3	34	80	0.4250000
NODE_2096_length_1569_cov_11.599320	851	931	1	4	80	0.0500000
NODE_2096_length_1569_cov_11.599320	851	931	3	76	80	0.9500000
NODE_2097_length_1569_cov_10.917687	521	601	2	80	80	1.0000000
NODE_2097_length_1569_cov_10.917687	574	654	1	15	80	0.1875000
NODE_2097_length_1569_cov_10.917687	574	654	2	65	80	0.8125000
NODE_2108_length_1563_cov_15.357240	590	670	4	39	80	0.4875000
NODE_2108_length_1563_cov_15.357240	590	670	5	41	80	0.5125000
NODE_2108_length_1563_cov_15.357240	643	723	2	2	80	0.0250000
NODE_2108_length_1563_cov_15.357240	643	723	3	22	80	0.2750000
NODE_2108_length_1563_cov_15.357240	643	723	4	23	80	0.2875000
NODE_2108_length_1563_cov_15.357240	643	723	5	33	80	0.4125000
NODE_2110_length_1561_cov_18.420657	354	434	1	41	80	0.5125000
NODE_2110_length_1561_cov_18.420657	354	434	2	39	80	0.4875000
NODE_2110_length_1561_cov_18.420657	407	487	0	6	80	0.0750000
NODE_2110_length_1561_cov_18.420657	407	487	1	49	80	0.6125000
NODE_2110_length_1561_cov_18.420657	407	487	3	25	80	0.3125000
NODE_2110_length_1561_cov_18.420657	483	563	3	21	80	0.2625000
NODE_2110_length_1561_cov_18.420657	483	563	5	59	80	0.7375000
NODE_2110_length_1561_cov_18.420657	536	616	0	7	80	0.0875000
NODE_2110_length_1561_cov_18.420657	536	616	2	7	80	0.0875000
NODE_2110_length_1561_cov_18.420657	536	616	3	7	80	0.0875000
NODE_2110_length_1561_cov_18.420657	536	616	5	59	80	0.7375000
NODE_2116_length_1559_cov_7.071233	347	427	2	73	80	0.9125000
NODE_2116_length_1559_cov_7.071233	347	427	3	7	80	0.0875000
NODE_2116_length_1559_cov_7.071233	400	478	0	29	78	0.3717949
NODE_2116_length_1559_cov_7.071233	400	478	2	49	78	0.6282051
NODE_2116_length_1559_cov_7.071233	1187	1238	0	4	51	0.0784314
NODE_2116_length_1559_cov_7.071233	1187	1238	2	47	51	0.9215686
NODE_2118_length_1558_cov_3.486635	338	418	0	79	80	0.9875000
NODE_2118_length_1558_cov_3.486635	338	418	1	1	80	0.0125000
NODE_2118_length_1558_cov_3.486635	391	471	0	80	80	1.0000000
NODE_2119_length_1557_cov_17.089163	542	622	8	27	80	0.3375000
NODE_2119_length_1557_cov_17.089163	542	622	9	11	80	0.1375000
NODE_2119_length_1557_cov_17.089163	542	622	10	35	80	0.4375000
NODE_2119_length_1557_cov_17.089163	542	622	11	7	80	0.0875000
NODE_2119_length_1557_cov_17.089163	595	675	4	6	80	0.0750000
NODE_2119_length_1557_cov_17.089163	595	675	5	28	80	0.3500000
NODE_2119_length_1557_cov_17.089163	595	675	6	12	80	0.1500000
NODE_2119_length_1557_cov_17.089163	595	675	8	32	80	0.4000000
NODE_2119_length_1557_cov_17.089163	595	675	9	2	80	0.0250000
NODE_2120_length_1557_cov_4.639918	0	56	0	12	56	0.2142857
NODE_2120_length_1557_cov_4.639918	0	56	1	20	56	0.3571429
NODE_2120_length_1557_cov_4.639918	0	56	2	4	56	0.0714286
NODE_2120_length_1557_cov_4.639918	0	56	3	18	56	0.3214286
NODE_2120_length_1557_cov_4.639918	0	56	4	2	56	0.0357143
NODE_2120_length_1557_cov_4.639918	49	112	3	5	63	0.0793651
NODE_2120_length_1557_cov_4.639918	49	112	4	9	63	0.1428571
NODE_2120_length_1557_cov_4.639918	49	112	5	10	63	0.1587302
NODE_2120_length_1557_cov_4.639918	49	112	6	27	63	0.4285714
NODE_2120_length_1557_cov_4.639918	49	112	8	11	63	0.1746032
NODE_2120_length_1557_cov_4.639918	49	112	9	1	63	0.0158730
NODE_2120_length_1557_cov_4.639918	85	161	6	15	76	0.1973684
NODE_2120_length_1557_cov_4.639918	85	161	8	11	76	0.1447368
NODE_2120_length_1557_cov_4.639918	85	161	9	50	76	0.6578947
NODE_2123_length_1556_cov_23.289636	456	536	1	14	80	0.1750000
NODE_2123_length_1556_cov_23.289636	456	536	2	2	80	0.0250000
NODE_2123_length_1556_cov_23.289636	456	536	4	29	80	0.3625000
NODE_2123_length_1556_cov_23.289636	456	536	6	35	80	0.4375000
NODE_2123_length_1556_cov_23.289636	509	589	6	39	80	0.4875000
NODE_2123_length_1556_cov_23.289636	509	589	7	5	80	0.0625000
NODE_2123_length_1556_cov_23.289636	509	589	8	36	80	0.4500000
NODE_2123_length_1556_cov_23.289636	681	761	0	80	80	1.0000000
NODE_2123_length_1556_cov_23.289636	734	814	0	80	80	1.0000000
NODE_2123_length_1556_cov_23.289636	1445	1525	10	2	80	0.0250000
NODE_2123_length_1556_cov_23.289636	1445	1525	11	15	80	0.1875000
NODE_2123_length_1556_cov_23.289636	1445	1525	12	63	80	0.7875000
NODE_2124_length_1556_cov_7.494166	300	380	1	5	80	0.0625000
NODE_2124_length_1556_cov_7.494166	300	380	2	7	80	0.0875000
NODE_2124_length_1556_cov_7.494166	300	380	3	15	80	0.1875000
NODE_2124_length_1556_cov_7.494166	300	380	5	35	80	0.4375000
NODE_2124_length_1556_cov_7.494166	300	380	6	18	80	0.2250000
NODE_2124_length_1556_cov_7.494166	353	433	3	2	80	0.0250000
NODE_2124_length_1556_cov_7.494166	353	433	4	11	80	0.1375000
NODE_2124_length_1556_cov_7.494166	353	433	5	9	80	0.1125000
NODE_2124_length_1556_cov_7.494166	353	433	6	58	80	0.7250000
NODE_2126_length_1555_cov_13.461538	666	746	6	30	80	0.3750000
NODE_2126_length_1555_cov_13.461538	666	746	7	50	80	0.6250000
NODE_2126_length_1555_cov_13.461538	719	799	0	15	80	0.1875000
NODE_2126_length_1555_cov_13.461538	719	799	2	27	80	0.3375000
NODE_2126_length_1555_cov_13.461538	719	799	4	1	80	0.0125000
NODE_2126_length_1555_cov_13.461538	719	799	6	37	80	0.4625000
NODE_2127_length_1554_cov_30.239175	144	226	4	27	82	0.3292683
NODE_2127_length_1554_cov_30.239175	144	226	5	11	82	0.1341463
NODE_2127_length_1554_cov_30.239175	144	226	7	3	82	0.0365854
NODE_2127_length_1554_cov_30.239175	144	226	8	20	82	0.2439024
NODE_2127_length_1554_cov_30.239175	144	226	9	9	82	0.1097561
NODE_2127_length_1554_cov_30.239175	144	226	10	4	82	0.0487805
NODE_2127_length_1554_cov_30.239175	144	226	11	5	82	0.0609756
NODE_2127_length_1554_cov_30.239175	144	226	13	3	82	0.0365854
NODE_2127_length_1554_cov_30.239175	199	279	8	13	80	0.1625000
NODE_2127_length_1554_cov_30.239175	199	279	9	2	80	0.0250000
NODE_2127_length_1554_cov_30.239175	199	279	10	4	80	0.0500000
NODE_2127_length_1554_cov_30.239175	199	279	11	5	80	0.0625000
NODE_2127_length_1554_cov_30.239175	199	279	13	4	80	0.0500000
NODE_2127_length_1554_cov_30.239175	199	279	14	2	80	0.0250000
NODE_2127_length_1554_cov_30.239175	199	279	16	3	80	0.0375000
NODE_2127_length_1554_cov_30.239175	199	279	17	3	80	0.0375000
NODE_2127_length_1554_cov_30.239175	199	279	18	2	80	0.0250000
NODE_2127_length_1554_cov_30.239175	199	279	19	6	80	0.0750000
NODE_2127_length_1554_cov_30.239175	199	279	20	1	80	0.0125000
NODE_2127_length_1554_cov_30.239175	199	279	21	2	80	0.0250000
NODE_2127_length_1554_cov_30.239175	199	279	23	3	80	0.0375000
NODE_2127_length_1554_cov_30.239175	199	279	24	1	80	0.0125000
NODE_2127_length_1554_cov_30.239175	199	279	26	1	80	0.0125000
NODE_2127_length_1554_cov_30.239175	199	279	27	3	80	0.0375000
NODE_2127_length_1554_cov_30.239175	199	279	28	1	80	0.0125000
NODE_2127_length_1554_cov_30.239175	199	279	29	1	80	0.0125000
NODE_2127_length_1554_cov_30.239175	199	279	31	4	80	0.0500000
NODE_2127_length_1554_cov_30.239175	199	279	33	1	80	0.0125000
NODE_2127_length_1554_cov_30.239175	199	279	35	1	80	0.0125000
NODE_2127_length_1554_cov_30.239175	199	279	39	4	80	0.0500000
NODE_2127_length_1554_cov_30.239175	199	279	41	1	80	0.0125000
NODE_2127_length_1554_cov_30.239175	199	279	42	10	80	0.1250000
NODE_2127_length_1554_cov_30.239175	199	279	43	1	80	0.0125000
NODE_2127_length_1554_cov_30.239175	199	279	49	1	80	0.0125000
NODE_2127_length_1554_cov_30.239175	877	903	1	25	26	0.9615384
NODE_2127_length_1554_cov_30.239175	877	903	2	1	26	0.0384615
NODE_2127_length_1554_cov_30.239175	930	1010	1	20	80	0.2500000
NODE_2127_length_1554_cov_30.239175	930	1010	2	52	80	0.6500000
NODE_2127_length_1554_cov_30.239175	930	1010	4	8	80	0.1000000
NODE_2127_length_1554_cov_30.239175	983	1063	2	19	80	0.2375000
NODE_2127_length_1554_cov_30.239175	983	1063	3	39	80	0.4875000
NODE_2127_length_1554_cov_30.239175	983	1063	4	22	80	0.2750000
NODE_2128_length_1554_cov_5.381443	1494	1554	7	16	60	0.2666667
NODE_2128_length_1554_cov_5.381443	1494	1554	8	38	60	0.6333333
NODE_2128_length_1554_cov_5.381443	1494	1554	10	6	60	0.1000000
NODE_2132_length_1552_cov_11.367515	379	445	0	66	66	1.0000000
NODE_2132_length_1552_cov_11.367515	418	484	0	66	66	1.0000000
NODE_2138_length_1549_cov_15.480000	1288	1368	1	41	80	0.5125000
NODE_2138_length_1549_cov_15.480000	1288	1368	2	39	80	0.4875000
NODE_2138_length_1549_cov_15.480000	1341	1421	0	19	80	0.2375000
NODE_2138_length_1549_cov_15.480000	1341	1421	1	58	80	0.7250000
NODE_2138_length_1549_cov_15.480000	1341	1421	2	3	80	0.0375000
NODE_2142_length_1548_cov_12.789510	770	850	1	57	80	0.7125000
NODE_2142_length_1548_cov_12.789510	770	850	2	16	80	0.2000000
NODE_2142_length_1548_cov_12.789510	770	850	4	7	80	0.0875000
NODE_2142_length_1548_cov_12.789510	823	903	1	4	80	0.0500000
NODE_2142_length_1548_cov_12.789510	823	903	2	16	80	0.2000000
NODE_2142_length_1548_cov_12.789510	823	903	3	18	80	0.2250000
NODE_2142_length_1548_cov_12.789510	823	903	4	42	80	0.5250000
NODE_2149_length_1546_cov_24.069800	775	855	1	29	80	0.3625000
NODE_2149_length_1546_cov_24.069800	775	855	2	51	80	0.6375000
NODE_2149_length_1546_cov_24.069800	828	908	0	18	80	0.2250000
NODE_2149_length_1546_cov_24.069800	828	908	1	62	80	0.7750000
NODE_2150_length_1546_cov_10.911541	417	497	2	80	80	1.0000000
NODE_2150_length_1546_cov_10.911541	470	550	0	40	80	0.5000000
NODE_2150_length_1546_cov_10.911541	470	550	2	40	80	0.5000000
NODE_2150_length_1546_cov_10.911541	1065	1145	0	17	80	0.2125000
NODE_2150_length_1546_cov_10.911541	1065	1145	1	31	80	0.3875000
NODE_2150_length_1546_cov_10.911541	1065	1145	2	32	80	0.4000000
NODE_2150_length_1546_cov_10.911541	1118	1198	2	64	80	0.8000000
NODE_2150_length_1546_cov_10.911541	1118	1198	3	16	80	0.2000000
NODE_2155_length_1543_cov_10.400970	480	560	0	80	80	1.0000000
NODE_2155_length_1543_cov_10.400970	533	613	0	80	80	1.0000000
NODE_2156_length_1543_cov_4.532548	43	98	0	55	55	1.0000000
NODE_2162_length_1541_cov_7.316921	523	603	6	1	80	0.0125000
NODE_2162_length_1541_cov_7.316921	523	603	8	35	80	0.4375000
NODE_2162_length_1541_cov_7.316921	523	603	9	11	80	0.1375000
NODE_2162_length_1541_cov_7.316921	523	603	10	33	80	0.4125000
NODE_2162_length_1541_cov_7.316921	576	658	6	24	82	0.2926829
NODE_2162_length_1541_cov_7.316921	576	658	7	24	82	0.2926829
NODE_2162_length_1541_cov_7.316921	576	658	8	8	82	0.0975610
NODE_2162_length_1541_cov_7.316921	576	658	10	26	82	0.3170732
NODE_2165_length_1539_cov_19.067361	334	414	0	60	80	0.7500000
NODE_2165_length_1539_cov_19.067361	334	414	1	20	80	0.2500000
NODE_2165_length_1539_cov_19.067361	387	467	0	7	80	0.0875000
NODE_2165_length_1539_cov_19.067361	387	467	1	73	80	0.9125000
NODE_2165_length_1539_cov_19.067361	463	543	0	18	80	0.2250000
NODE_2165_length_1539_cov_19.067361	463	543	1	42	80	0.5250000
NODE_2165_length_1539_cov_19.067361	463	543	3	6	80	0.0750000
NODE_2165_length_1539_cov_19.067361	463	543	4	1	80	0.0125000
NODE_2165_length_1539_cov_19.067361	463	543	5	13	80	0.1625000
NODE_2165_length_1539_cov_19.067361	516	596	0	6	80	0.0750000
NODE_2165_length_1539_cov_19.067361	516	596	1	1	80	0.0125000
NODE_2165_length_1539_cov_19.067361	516	596	3	6	80	0.0750000
NODE_2165_length_1539_cov_19.067361	516	596	4	1	80	0.0125000
NODE_2165_length_1539_cov_19.067361	516	596	5	66	80	0.8250000
NODE_2171_length_1538_cov_68.273801	604	684	7	11	80	0.1375000
NODE_2171_length_1538_cov_68.273801	604	684	8	29	80	0.3625000
NODE_2171_length_1538_cov_68.273801	604	684	9	40	80	0.5000000
NODE_2171_length_1538_cov_68.273801	657	737	5	22	80	0.2750000
NODE_2171_length_1538_cov_68.273801	657	737	6	14	80	0.1750000
NODE_2171_length_1538_cov_68.273801	657	737	8	29	80	0.3625000
NODE_2171_length_1538_cov_68.273801	657	737	9	15	80	0.1875000
NODE_2172_length_1538_cov_2.402363	1456	1499	0	43	43	1.0000000
NODE_2173_length_1537_cov_39.413074	782	862	1	25	80	0.3125000
NODE_2173_length_1537_cov_39.413074	782	862	2	55	80	0.6875000
NODE_2173_length_1537_cov_39.413074	835	915	1	40	80	0.5000000
NODE_2173_length_1537_cov_39.413074	835	915	2	32	80	0.4000000
NODE_2173_length_1537_cov_39.413074	835	915	4	8	80	0.1000000
NODE_2173_length_1537_cov_39.413074	911	991	4	4	80	0.0500000
NODE_2173_length_1537_cov_39.413074	911	991	5	2	80	0.0250000
NODE_2173_length_1537_cov_39.413074	911	991	6	12	80	0.1500000
NODE_2173_length_1537_cov_39.413074	911	991	7	29	80	0.3625000
NODE_2173_length_1537_cov_39.413074	911	991	8	4	80	0.0500000
NODE_2173_length_1537_cov_39.413074	911	991	10	9	80	0.1125000
NODE_2173_length_1537_cov_39.413074	911	991	12	3	80	0.0375000
NODE_2173_length_1537_cov_39.413074	911	991	13	5	80	0.0625000
NODE_2173_length_1537_cov_39.413074	911	991	14	12	80	0.1500000
NODE_2173_length_1537_cov_39.413074	964	1044	10	7	80	0.0875000
NODE_2173_length_1537_cov_39.413074	964	1044	12	39	80	0.4875000
NODE_2173_length_1537_cov_39.413074	964	1044	13	5	80	0.0625000
NODE_2173_length_1537_cov_39.413074	964	1044	14	29	80	0.3625000
NODE_2174_length_1537_cov_30.412378	739	819	5	14	80	0.1750000
NODE_2174_length_1537_cov_30.412378	739	819	6	12	80	0.1500000
NODE_2174_length_1537_cov_30.412378	739	819	7	14	80	0.1750000
NODE_2174_length_1537_cov_30.412378	739	819	9	5	80	0.0625000
NODE_2174_length_1537_cov_30.412378	739	819	10	35	80	0.4375000
NODE_2174_length_1537_cov_30.412378	792	872	6	4	80	0.0500000
NODE_2174_length_1537_cov_30.412378	792	872	7	15	80	0.1875000
NODE_2174_length_1537_cov_30.412378	792	872	9	1	80	0.0125000
NODE_2174_length_1537_cov_30.412378	792	872	10	60	80	0.7500000
NODE_2174_length_1537_cov_30.412378	868	948	2	14	80	0.1750000
NODE_2174_length_1537_cov_30.412378	868	948	3	19	80	0.2375000
NODE_2174_length_1537_cov_30.412378	868	948	4	17	80	0.2125000
NODE_2174_length_1537_cov_30.412378	868	948	5	4	80	0.0500000
NODE_2174_length_1537_cov_30.412378	868	948	6	14	80	0.1750000
NODE_2174_length_1537_cov_30.412378	868	948	7	12	80	0.1500000
NODE_2174_length_1537_cov_30.412378	921	1001	2	67	80	0.8375000
NODE_2174_length_1537_cov_30.412378	921	1001	3	13	80	0.1625000
NODE_2175_length_1537_cov_18.707232	669	749	3	3	80	0.0375000
NODE_2175_length_1537_cov_18.707232	669	749	5	7	80	0.0875000
NODE_2175_length_1537_cov_18.707232	669	749	6	23	80	0.2875000
NODE_2175_length_1537_cov_18.707232	669	749	7	23	80	0.2875000
NODE_2175_length_1537_cov_18.707232	669	749	8	24	80	0.3000000
NODE_2175_length_1537_cov_18.707232	722	802	0	6	80	0.0750000
NODE_2175_length_1537_cov_18.707232	722	802	2	35	80	0.4375000
NODE_2175_length_1537_cov_18.707232	722	802	3	15	80	0.1875000
NODE_2175_length_1537_cov_18.707232	722	802	5	7	80	0.0875000
NODE_2175_length_1537_cov_18.707232	722	802	6	17	80	0.2125000
NODE_2176_length_1536_cov_24.991649	832	912	1	11	80	0.1375000
NODE_2176_length_1536_cov_24.991649	832	912	2	69	80	0.8625000
NODE_2176_length_1536_cov_24.991649	885	965	1	15	80	0.1875000
NODE_2176_length_1536_cov_24.991649	885	965	2	65	80	0.8125000
NODE_2176_length_1536_cov_24.991649	961	1041	2	33	80	0.4125000
NODE_2176_length_1536_cov_24.991649	961	1041	3	47	80	0.5875000
NODE_2176_length_1536_cov_24.991649	1014	1094	1	24	80	0.3000000
NODE_2176_length_1536_cov_24.991649	1014	1094	2	21	80	0.2625000
NODE_2176_length_1536_cov_24.991649	1014	1094	3	35	80	0.4375000
NODE_2183_length_1535_cov_46.662256	992	1072	1	18	80	0.2250000
NODE_2183_length_1535_cov_46.662256	992	1072	2	3	80	0.0375000
NODE_2183_length_1535_cov_46.662256	992	1072	3	51	80	0.6375000
NODE_2183_length_1535_cov_46.662256	992	1072	4	8	80	0.1000000
NODE_2183_length_1535_cov_46.662256	1045	1125	3	50	80	0.6250000
NODE_2183_length_1535_cov_46.662256	1045	1125	4	28	80	0.3500000
NODE_2183_length_1535_cov_46.662256	1045	1125	5	2	80	0.0250000
NODE_2183_length_1535_cov_46.662256	1127	1203	1	26	76	0.3421053
NODE_2183_length_1535_cov_46.662256	1127	1203	2	1	76	0.0131579
NODE_2183_length_1535_cov_46.662256	1127	1203	3	49	76	0.6447368
NODE_2183_length_1535_cov_46.662256	1176	1256	1	79	80	0.9875000
NODE_2183_length_1535_cov_46.662256	1176	1256	3	1	80	0.0125000
NODE_2184_length_1535_cov_32.610724	992	1072	2	10	80	0.1250000
NODE_2184_length_1535_cov_32.610724	992	1072	3	11	80	0.1375000
NODE_2184_length_1535_cov_32.610724	992	1072	5	21	80	0.2625000
NODE_2184_length_1535_cov_32.610724	992	1072	7	38	80	0.4750000
NODE_2184_length_1535_cov_32.610724	1045	1125	2	37	80	0.4625000
NODE_2184_length_1535_cov_32.610724	1045	1125	3	28	80	0.3500000
NODE_2184_length_1535_cov_32.610724	1045	1125	4	9	80	0.1125000
NODE_2184_length_1535_cov_32.610724	1045	1125	7	6	80	0.0750000
NODE_2184_length_1535_cov_32.610724	1121	1201	2	25	80	0.3125000
NODE_2184_length_1535_cov_32.610724	1121	1201	3	20	80	0.2500000
NODE_2184_length_1535_cov_32.610724	1121	1201	4	35	80	0.4375000
NODE_2184_length_1535_cov_32.610724	1174	1254	3	1	80	0.0125000
NODE_2184_length_1535_cov_32.610724	1174	1254	4	37	80	0.4625000
NODE_2184_length_1535_cov_32.610724	1174	1254	7	17	80	0.2125000
NODE_2184_length_1535_cov_32.610724	1174	1254	8	25	80	0.3125000
NODE_2185_length_1535_cov_25.406685	619	699	1	13	80	0.1625000
NODE_2185_length_1535_cov_25.406685	619	699	2	56	80	0.7000000
NODE_2185_length_1535_cov_25.406685	619	699	4	11	80	0.1375000
NODE_2185_length_1535_cov_25.406685	672	752	2	16	80	0.2000000
NODE_2185_length_1535_cov_25.406685	672	752	3	17	80	0.2125000
NODE_2185_length_1535_cov_25.406685	672	752	4	47	80	0.5875000
NODE_2190_length_1534_cov_13.542857	439	519	0	80	80	1.0000000
NODE_2190_length_1534_cov_13.542857	492	567	0	75	75	1.0000000
NODE_2197_length_1531_cov_17.336592	324	404	0	58	80	0.7250000
NODE_2197_length_1531_cov_17.336592	324	404	1	19	80	0.2375000
NODE_2197_length_1531_cov_17.336592	324	404	3	3	80	0.0375000
NODE_2198_length_1531_cov_6.267458	606	686	1	63	80	0.7875000
NODE_2198_length_1531_cov_6.267458	606	686	3	17	80	0.2125000
NODE_2198_length_1531_cov_6.267458	659	739	1	10	80	0.1250000
NODE_2198_length_1531_cov_6.267458	659	739	3	32	80	0.4000000
NODE_2198_length_1531_cov_6.267458	659	739	4	9	80	0.1125000
NODE_2198_length_1531_cov_6.267458	659	739	5	25	80	0.3125000
NODE_2198_length_1531_cov_6.267458	659	739	6	4	80	0.0500000
NODE_2199_length_1530_cov_13.514326	323	403	2	58	80	0.7250000
NODE_2199_length_1530_cov_13.514326	323	403	3	22	80	0.2750000
NODE_2199_length_1530_cov_13.514326	376	456	2	13	80	0.1625000
NODE_2199_length_1530_cov_13.514326	376	456	3	65	80	0.8125000
NODE_2199_length_1530_cov_13.514326	376	456	4	2	80	0.0250000
NODE_2199_length_1530_cov_13.514326	1465	1513	0	48	48	1.0000000
NODE_2200_length_1530_cov_9.012579	637	717	0	80	80	1.0000000
NODE_2200_length_1530_cov_9.012579	690	770	0	80	80	1.0000000
NODE_2203_length_1529_cov_21.061538	983	1063	2	4	80	0.0500000
NODE_2203_length_1529_cov_21.061538	983	1063	4	76	80	0.9500000
NODE_2203_length_1529_cov_21.061538	1036	1116	1	16	80	0.2000000
NODE_2203_length_1529_cov_21.061538	1036	1116	2	11	80	0.1375000
NODE_2203_length_1529_cov_21.061538	1036	1116	4	53	80	0.6625000
NODE_2205_length_1529_cov_1.380420	219	282	0	63	63	1.0000000
NODE_2205_length_1529_cov_1.380420	272	323	0	51	51	1.0000000
NODE_2206_length_1528_cov_8.578027	449	529	0	52	80	0.6500000
NODE_2206_length_1528_cov_8.578027	449	529	2	28	80	0.3500000
NODE_2206_length_1528_cov_8.578027	502	582	0	6	80	0.0750000
NODE_2206_length_1528_cov_8.578027	502	582	2	74	80	0.9250000
NODE_2210_length_1526_cov_92.265592	986	1066	5	42	80	0.5250000
NODE_2210_length_1526_cov_92.265592	986	1066	6	33	80	0.4125000
NODE_2210_length_1526_cov_92.265592	986	1066	7	5	80	0.0625000
NODE_2210_length_1526_cov_92.265592	1039	1119	2	10	80	0.1250000
NODE_2210_length_1526_cov_92.265592	1039	1119	3	33	80	0.4125000
NODE_2210_length_1526_cov_92.265592	1039	1119	4	5	80	0.0625000
NODE_2210_length_1526_cov_92.265592	1039	1119	5	29	80	0.3625000
NODE_2210_length_1526_cov_92.265592	1039	1119	6	2	80	0.0250000
NODE_2210_length_1526_cov_92.265592	1039	1119	7	1	80	0.0125000
NODE_2211_length_1526_cov_4.051857	291	370	4	78	79	0.9873418
NODE_2211_length_1526_cov_4.051857	291	370	5	1	79	0.0126582
NODE_2213_length_1525_cov_20.232118	1014	1090	60	3	76	0.0394737
NODE_2213_length_1525_cov_20.232118	1014	1090	61	2	76	0.0263158
NODE_2213_length_1525_cov_20.232118	1014	1090	63	1	76	0.0131579
NODE_2213_length_1525_cov_20.232118	1014	1090	65	1	76	0.0131579
NODE_2213_length_1525_cov_20.232118	1014	1090	67	2	76	0.0263158
NODE_2213_length_1525_cov_20.232118	1014	1090	68	1	76	0.0131579
NODE_2213_length_1525_cov_20.232118	1014	1090	70	2	76	0.0263158
NODE_2213_length_1525_cov_20.232118	1014	1090	72	2	76	0.0263158
NODE_2213_length_1525_cov_20.232118	1014	1090	74	1	76	0.0131579
NODE_2213_length_1525_cov_20.232118	1014	1090	77	2	76	0.0263158
NODE_2213_length_1525_cov_20.232118	1014	1090	78	5	76	0.0657895
NODE_2213_length_1525_cov_20.232118	1014	1090	79	1	76	0.0131579
NODE_2213_length_1525_cov_20.232118	1014	1090	80	1	76	0.0131579
NODE_2213_length_1525_cov_20.232118	1014	1090	83	2	76	0.0263158
NODE_2213_length_1525_cov_20.232118	1014	1090	86	1	76	0.0131579
NODE_2213_length_1525_cov_20.232118	1014	1090	88	2	76	0.0263158
NODE_2213_length_1525_cov_20.232118	1014	1090	89	2	76	0.0263158
NODE_2213_length_1525_cov_20.232118	1014	1090	90	7	76	0.0921053
NODE_2213_length_1525_cov_20.232118	1014	1090	91	2	76	0.0263158
NODE_2213_length_1525_cov_20.232118	1014	1090	93	3	76	0.0394737
NODE_2213_length_1525_cov_20.232118	1014	1090	96	1	76	0.0131579
NODE_2213_length_1525_cov_20.232118	1014	1090	97	2	76	0.0263158
NODE_2213_length_1525_cov_20.232118	1014	1090	98	5	76	0.0657895
NODE_2213_length_1525_cov_20.232118	1014	1090	99	12	76	0.1578947
NODE_2213_length_1525_cov_20.232118	1014	1090	100	5	76	0.0657895
NODE_2213_length_1525_cov_20.232118	1014	1090	102	1	76	0.0131579
NODE_2213_length_1525_cov_20.232118	1014	1090	104	2	76	0.0263158
NODE_2213_length_1525_cov_20.232118	1014	1090	105	2	76	0.0263158
NODE_2213_length_1525_cov_20.232118	1014	1090	107	2	76	0.0263158
NODE_2213_length_1525_cov_20.232118	1014	1090	110	1	76	0.0131579
NODE_2213_length_1525_cov_20.232118	1281	1338	0	57	57	1.0000000
NODE_2214_length_1525_cov_11.421459	804	884	2	64	80	0.8000000
NODE_2214_length_1525_cov_11.421459	804	884	3	1	80	0.0125000
NODE_2214_length_1525_cov_11.421459	804	884	4	15	80	0.1875000
NODE_2214_length_1525_cov_11.421459	857	937	2	80	80	1.0000000
NODE_2217_length_1524_cov_130.874386	171	243	271	1	72	0.0138889
NODE_2217_length_1524_cov_130.874386	171	243	274	2	72	0.0277778
NODE_2217_length_1524_cov_130.874386	171	243	280	1	72	0.0138889
NODE_2217_length_1524_cov_130.874386	171	243	284	1	72	0.0138889
NODE_2217_length_1524_cov_130.874386	171	243	285	1	72	0.0138889
NODE_2217_length_1524_cov_130.874386	171	243	286	2	72	0.0277778
NODE_2217_length_1524_cov_130.874386	171	243	287	1	72	0.0138889
NODE_2217_length_1524_cov_130.874386	171	243	288	2	72	0.0277778
NODE_2217_length_1524_cov_130.874386	171	243	294	1	72	0.0138889
NODE_2217_length_1524_cov_130.874386	171	243	296	1	72	0.0138889
NODE_2217_length_1524_cov_130.874386	171	243	297	1	72	0.0138889
NODE_2217_length_1524_cov_130.874386	171	243	299	1	72	0.0138889
NODE_2217_length_1524_cov_130.874386	171	243	305	1	72	0.0138889
NODE_2217_length_1524_cov_130.874386	171	243	306	2	72	0.0277778
NODE_2217_length_1524_cov_130.874386	171	243	308	1	72	0.0138889
NODE_2217_length_1524_cov_130.874386	171	243	312	2	72	0.0277778
NODE_2217_length_1524_cov_130.874386	171	243	322	1	72	0.0138889
NODE_2217_length_1524_cov_130.874386	171	243	324	1	72	0.0138889
NODE_2217_length_1524_cov_130.874386	171	243	331	1	72	0.0138889
NODE_2217_length_1524_cov_130.874386	171	243	334	1	72	0.0138889
NODE_2217_length_1524_cov_130.874386	171	243	338	1	72	0.0138889
NODE_2217_length_1524_cov_130.874386	171	243	342	1	72	0.0138889
NODE_2217_length_1524_cov_130.874386	171	243	343	1	72	0.0138889
NODE_2217_length_1524_cov_130.874386	171	243	344	1	72	0.0138889
NODE_2217_length_1524_cov_130.874386	171	243	345	1	72	0.0138889
NODE_2217_length_1524_cov_130.874386	171	243	346	1	72	0.0138889
NODE_2217_length_1524_cov_130.874386	171	243	350	1	72	0.0138889
NODE_2217_length_1524_cov_130.874386	171	243	352	1	72	0.0138889
NODE_2217_length_1524_cov_130.874386	171	243	354	1	72	0.0138889
NODE_2217_length_1524_cov_130.874386	171	243	355	1	72	0.0138889
NODE_2217_length_1524_cov_130.874386	171	243	358	1	72	0.0138889
NODE_2217_length_1524_cov_130.874386	171	243	359	4	72	0.0555556
NODE_2217_length_1524_cov_130.874386	171	243	360	4	72	0.0555556
NODE_2217_length_1524_cov_130.874386	171	243	361	4	72	0.0555556
NODE_2217_length_1524_cov_130.874386	171	243	362	1	72	0.0138889
NODE_2217_length_1524_cov_130.874386	171	243	363	2	72	0.0277778
NODE_2217_length_1524_cov_130.874386	171	243	364	3	72	0.0416667
NODE_2217_length_1524_cov_130.874386	171	243	365	5	72	0.0694444
NODE_2217_length_1524_cov_130.874386	171	243	366	7	72	0.0972222
NODE_2217_length_1524_cov_130.874386	171	243	367	4	72	0.0555556
NODE_2217_length_1524_cov_130.874386	171	243	368	2	72	0.0277778
NODE_2217_length_1524_cov_130.874386	191	247	312	1	56	0.0178571
NODE_2217_length_1524_cov_130.874386	191	247	322	1	56	0.0178571
NODE_2217_length_1524_cov_130.874386	191	247	324	1	56	0.0178571
NODE_2217_length_1524_cov_130.874386	191	247	331	1	56	0.0178571
NODE_2217_length_1524_cov_130.874386	191	247	334	1	56	0.0178571
NODE_2217_length_1524_cov_130.874386	191	247	338	1	56	0.0178571
NODE_2217_length_1524_cov_130.874386	191	247	342	1	56	0.0178571
NODE_2217_length_1524_cov_130.874386	191	247	343	1	56	0.0178571
NODE_2217_length_1524_cov_130.874386	191	247	344	1	56	0.0178571
NODE_2217_length_1524_cov_130.874386	191	247	345	1	56	0.0178571
NODE_2217_length_1524_cov_130.874386	191	247	346	1	56	0.0178571
NODE_2217_length_1524_cov_130.874386	191	247	350	1	56	0.0178571
NODE_2217_length_1524_cov_130.874386	191	247	352	1	56	0.0178571
NODE_2217_length_1524_cov_130.874386	191	247	354	1	56	0.0178571
NODE_2217_length_1524_cov_130.874386	191	247	355	3	56	0.0535714
NODE_2217_length_1524_cov_130.874386	191	247	356	2	56	0.0357143
NODE_2217_length_1524_cov_130.874386	191	247	358	1	56	0.0178571
NODE_2217_length_1524_cov_130.874386	191	247	359	4	56	0.0714286
NODE_2217_length_1524_cov_130.874386	191	247	360	4	56	0.0714286
NODE_2217_length_1524_cov_130.874386	191	247	361	4	56	0.0714286
NODE_2217_length_1524_cov_130.874386	191	247	362	1	56	0.0178571
NODE_2217_length_1524_cov_130.874386	191	247	363	2	56	0.0357143
NODE_2217_length_1524_cov_130.874386	191	247	364	3	56	0.0535714
NODE_2217_length_1524_cov_130.874386	191	247	365	5	56	0.0892857
NODE_2217_length_1524_cov_130.874386	191	247	366	7	56	0.1250000
NODE_2217_length_1524_cov_130.874386	191	247	367	4	56	0.0714286
NODE_2217_length_1524_cov_130.874386	191	247	368	2	56	0.0357143
NODE_2217_length_1524_cov_130.874386	219	296	271	1	77	0.0129870
NODE_2217_length_1524_cov_130.874386	219	296	276	1	77	0.0129870
NODE_2217_length_1524_cov_130.874386	219	296	283	1	77	0.0129870
NODE_2217_length_1524_cov_130.874386	219	296	285	1	77	0.0129870
NODE_2217_length_1524_cov_130.874386	219	296	287	1	77	0.0129870
NODE_2217_length_1524_cov_130.874386	219	296	289	1	77	0.0129870
NODE_2217_length_1524_cov_130.874386	219	296	293	1	77	0.0129870
NODE_2217_length_1524_cov_130.874386	219	296	297	1	77	0.0129870
NODE_2217_length_1524_cov_130.874386	219	296	302	1	77	0.0129870
NODE_2217_length_1524_cov_130.874386	219	296	305	1	77	0.0129870
NODE_2217_length_1524_cov_130.874386	219	296	308	1	77	0.0129870
NODE_2217_length_1524_cov_130.874386	219	296	315	4	77	0.0519481
NODE_2217_length_1524_cov_130.874386	219	296	316	3	77	0.0389610
NODE_2217_length_1524_cov_130.874386	219	296	320	2	77	0.0259740
NODE_2217_length_1524_cov_130.874386	219	296	321	1	77	0.0129870
NODE_2217_length_1524_cov_130.874386	219	296	322	2	77	0.0259740
NODE_2217_length_1524_cov_130.874386	219	296	323	3	77	0.0389610
NODE_2217_length_1524_cov_130.874386	219	296	325	4	77	0.0519481
NODE_2217_length_1524_cov_130.874386	219	296	330	1	77	0.0129870
NODE_2217_length_1524_cov_130.874386	219	296	332	1	77	0.0129870
NODE_2217_length_1524_cov_130.874386	219	296	333	1	77	0.0129870
NODE_2217_length_1524_cov_130.874386	219	296	338	1	77	0.0129870
NODE_2217_length_1524_cov_130.874386	219	296	340	2	77	0.0259740
NODE_2217_length_1524_cov_130.874386	219	296	341	1	77	0.0129870
NODE_2217_length_1524_cov_130.874386	219	296	342	2	77	0.0259740
NODE_2217_length_1524_cov_130.874386	219	296	343	4	77	0.0519481
NODE_2217_length_1524_cov_130.874386	219	296	344	1	77	0.0129870
NODE_2217_length_1524_cov_130.874386	219	296	347	1	77	0.0129870
NODE_2217_length_1524_cov_130.874386	219	296	349	1	77	0.0129870
NODE_2217_length_1524_cov_130.874386	219	296	354	3	77	0.0389610
NODE_2217_length_1524_cov_130.874386	219	296	355	3	77	0.0389610
NODE_2217_length_1524_cov_130.874386	219	296	356	2	77	0.0259740
NODE_2217_length_1524_cov_130.874386	219	296	358	1	77	0.0129870
NODE_2217_length_1524_cov_130.874386	219	296	359	1	77	0.0129870
NODE_2217_length_1524_cov_130.874386	219	296	360	2	77	0.0259740
NODE_2217_length_1524_cov_130.874386	219	296	361	1	77	0.0129870
NODE_2217_length_1524_cov_130.874386	219	296	363	1	77	0.0129870
NODE_2217_length_1524_cov_130.874386	219	296	364	2	77	0.0259740
NODE_2217_length_1524_cov_130.874386	219	296	365	2	77	0.0259740
NODE_2217_length_1524_cov_130.874386	219	296	366	7	77	0.0909091
NODE_2217_length_1524_cov_130.874386	219	296	367	4	77	0.0519481
NODE_2217_length_1524_cov_130.874386	219	296	368	2	77	0.0259740
NODE_2217_length_1524_cov_130.874386	253	333	164	1	80	0.0125000
NODE_2217_length_1524_cov_130.874386	253	333	170	3	80	0.0375000
NODE_2217_length_1524_cov_130.874386	253	333	172	2	80	0.0250000
NODE_2217_length_1524_cov_130.874386	253	333	174	1	80	0.0125000
NODE_2217_length_1524_cov_130.874386	253	333	177	1	80	0.0125000
NODE_2217_length_1524_cov_130.874386	253	333	179	1	80	0.0125000
NODE_2217_length_1524_cov_130.874386	253	333	182	1	80	0.0125000
NODE_2217_length_1524_cov_130.874386	253	333	183	1	80	0.0125000
NODE_2217_length_1524_cov_130.874386	253	333	187	1	80	0.0125000
NODE_2217_length_1524_cov_130.874386	253	333	194	1	80	0.0125000
NODE_2217_length_1524_cov_130.874386	253	333	195	3	80	0.0375000
NODE_2217_length_1524_cov_130.874386	253	333	196	1	80	0.0125000
NODE_2217_length_1524_cov_130.874386	253	333	199	1	80	0.0125000
NODE_2217_length_1524_cov_130.874386	253	333	204	2	80	0.0250000
NODE_2217_length_1524_cov_130.874386	253	333	205	1	80	0.0125000
NODE_2217_length_1524_cov_130.874386	253	333	209	1	80	0.0125000
NODE_2217_length_1524_cov_130.874386	253	333	218	1	80	0.0125000
NODE_2217_length_1524_cov_130.874386	253	333	223	1	80	0.0125000
NODE_2217_length_1524_cov_130.874386	253	333	227	2	80	0.0250000
NODE_2217_length_1524_cov_130.874386	253	333	230	1	80	0.0125000
NODE_2217_length_1524_cov_130.874386	253	333	232	1	80	0.0125000
NODE_2217_length_1524_cov_130.874386	253	333	235	1	80	0.0125000
NODE_2217_length_1524_cov_130.874386	253	333	239	1	80	0.0125000
NODE_2217_length_1524_cov_130.874386	253	333	245	1	80	0.0125000
NODE_2217_length_1524_cov_130.874386	253	333	249	1	80	0.0125000
NODE_2217_length_1524_cov_130.874386	253	333	251	2	80	0.0250000
NODE_2217_length_1524_cov_130.874386	253	333	252	1	80	0.0125000
NODE_2217_length_1524_cov_130.874386	253	333	260	1	80	0.0125000
NODE_2217_length_1524_cov_130.874386	253	333	265	1	80	0.0125000
NODE_2217_length_1524_cov_130.874386	253	333	271	1	80	0.0125000
NODE_2217_length_1524_cov_130.874386	253	333	276	1	80	0.0125000
NODE_2217_length_1524_cov_130.874386	253	333	283	1	80	0.0125000
NODE_2217_length_1524_cov_130.874386	253	333	285	1	80	0.0125000
NODE_2217_length_1524_cov_130.874386	253	333	287	1	80	0.0125000
NODE_2217_length_1524_cov_130.874386	253	333	289	1	80	0.0125000
NODE_2217_length_1524_cov_130.874386	253	333	293	1	80	0.0125000
NODE_2217_length_1524_cov_130.874386	253	333	297	1	80	0.0125000
NODE_2217_length_1524_cov_130.874386	253	333	302	1	80	0.0125000
NODE_2217_length_1524_cov_130.874386	253	333	305	1	80	0.0125000
NODE_2217_length_1524_cov_130.874386	253	333	308	1	80	0.0125000
NODE_2217_length_1524_cov_130.874386	253	333	315	4	80	0.0500000
NODE_2217_length_1524_cov_130.874386	253	333	316	3	80	0.0375000
NODE_2217_length_1524_cov_130.874386	253	333	320	2	80	0.0250000
NODE_2217_length_1524_cov_130.874386	253	333	321	1	80	0.0125000
NODE_2217_length_1524_cov_130.874386	253	333	322	2	80	0.0250000
NODE_2217_length_1524_cov_130.874386	253	333	323	3	80	0.0375000
NODE_2217_length_1524_cov_130.874386	253	333	325	4	80	0.0500000
NODE_2217_length_1524_cov_130.874386	253	333	330	1	80	0.0125000
NODE_2217_length_1524_cov_130.874386	253	333	332	1	80	0.0125000
NODE_2217_length_1524_cov_130.874386	253	333	333	1	80	0.0125000
NODE_2217_length_1524_cov_130.874386	253	333	338	1	80	0.0125000
NODE_2217_length_1524_cov_130.874386	253	333	340	2	80	0.0250000
NODE_2217_length_1524_cov_130.874386	253	333	341	1	80	0.0125000
NODE_2217_length_1524_cov_130.874386	253	333	342	2	80	0.0250000
NODE_2217_length_1524_cov_130.874386	253	333	343	3	80	0.0375000
NODE_2217_length_1524_cov_130.874386	253	333	344	1	80	0.0125000
NODE_2217_length_1524_cov_130.874386	306	386	49	1	80	0.0125000
NODE_2217_length_1524_cov_130.874386	306	386	51	1	80	0.0125000
NODE_2217_length_1524_cov_130.874386	306	386	54	2	80	0.0250000
NODE_2217_length_1524_cov_130.874386	306	386	56	1	80	0.0125000
NODE_2217_length_1524_cov_130.874386	306	386	57	3	80	0.0375000
NODE_2217_length_1524_cov_130.874386	306	386	59	1	80	0.0125000
NODE_2217_length_1524_cov_130.874386	306	386	60	1	80	0.0125000
NODE_2217_length_1524_cov_130.874386	306	386	64	2	80	0.0250000
NODE_2217_length_1524_cov_130.874386	306	386	67	1	80	0.0125000
NODE_2217_length_1524_cov_130.874386	306	386	73	1	80	0.0125000
NODE_2217_length_1524_cov_130.874386	306	386	74	1	80	0.0125000
NODE_2217_length_1524_cov_130.874386	306	386	81	3	80	0.0375000
NODE_2217_length_1524_cov_130.874386	306	386	82	1	80	0.0125000
NODE_2217_length_1524_cov_130.874386	306	386	83	1	80	0.0125000
NODE_2217_length_1524_cov_130.874386	306	386	84	1	80	0.0125000
NODE_2217_length_1524_cov_130.874386	306	386	86	2	80	0.0250000
NODE_2217_length_1524_cov_130.874386	306	386	87	1	80	0.0125000
NODE_2217_length_1524_cov_130.874386	306	386	89	1	80	0.0125000
NODE_2217_length_1524_cov_130.874386	306	386	91	1	80	0.0125000
NODE_2217_length_1524_cov_130.874386	306	386	93	1	80	0.0125000
NODE_2217_length_1524_cov_130.874386	306	386	94	1	80	0.0125000
NODE_2217_length_1524_cov_130.874386	306	386	98	1	80	0.0125000
NODE_2217_length_1524_cov_130.874386	306	386	100	1	80	0.0125000
NODE_2217_length_1524_cov_130.874386	306	386	101	1	80	0.0125000
NODE_2217_length_1524_cov_130.874386	306	386	102	1	80	0.0125000
NODE_2217_length_1524_cov_130.874386	306	386	104	1	80	0.0125000
NODE_2217_length_1524_cov_130.874386	306	386	105	1	80	0.0125000
NODE_2217_length_1524_cov_130.874386	306	386	106	1	80	0.0125000
NODE_2217_length_1524_cov_130.874386	306	386	107	1	80	0.0125000
NODE_2217_length_1524_cov_130.874386	306	386	111	1	80	0.0125000
NODE_2217_length_1524_cov_130.874386	306	386	112	1	80	0.0125000
NODE_2217_length_1524_cov_130.874386	306	386	116	1	80	0.0125000
NODE_2217_length_1524_cov_130.874386	306	386	123	1	80	0.0125000
NODE_2217_length_1524_cov_130.874386	306	386	125	2	80	0.0250000
NODE_2217_length_1524_cov_130.874386	306	386	136	1	80	0.0125000
NODE_2217_length_1524_cov_130.874386	306	386	138	1	80	0.0125000
NODE_2217_length_1524_cov_130.874386	306	386	144	2	80	0.0250000
NODE_2217_length_1524_cov_130.874386	306	386	151	1	80	0.0125000
NODE_2217_length_1524_cov_130.874386	306	386	153	1	80	0.0125000
NODE_2217_length_1524_cov_130.874386	306	386	154	1	80	0.0125000
NODE_2217_length_1524_cov_130.874386	306	386	158	1	80	0.0125000
NODE_2217_length_1524_cov_130.874386	306	386	160	1	80	0.0125000
NODE_2217_length_1524_cov_130.874386	306	386	163	1	80	0.0125000
NODE_2217_length_1524_cov_130.874386	306	386	164	2	80	0.0250000
NODE_2217_length_1524_cov_130.874386	306	386	170	3	80	0.0375000
NODE_2217_length_1524_cov_130.874386	306	386	172	2	80	0.0250000
NODE_2217_length_1524_cov_130.874386	306	386	174	1	80	0.0125000
NODE_2217_length_1524_cov_130.874386	306	386	177	1	80	0.0125000
NODE_2217_length_1524_cov_130.874386	306	386	179	1	80	0.0125000
NODE_2217_length_1524_cov_130.874386	306	386	182	1	80	0.0125000
NODE_2217_length_1524_cov_130.874386	306	386	183	1	80	0.0125000
NODE_2217_length_1524_cov_130.874386	306	386	187	1	80	0.0125000
NODE_2217_length_1524_cov_130.874386	306	386	194	1	80	0.0125000
NODE_2217_length_1524_cov_130.874386	306	386	195	3	80	0.0375000
NODE_2217_length_1524_cov_130.874386	306	386	196	1	80	0.0125000
NODE_2217_length_1524_cov_130.874386	306	386	199	1	80	0.0125000
NODE_2217_length_1524_cov_130.874386	306	386	204	2	80	0.0250000
NODE_2217_length_1524_cov_130.874386	306	386	205	1	80	0.0125000
NODE_2217_length_1524_cov_130.874386	306	386	209	1	80	0.0125000
NODE_2217_length_1524_cov_130.874386	306	386	218	1	80	0.0125000
NODE_2217_length_1524_cov_130.874386	306	386	223	1	80	0.0125000
NODE_2217_length_1524_cov_130.874386	306	386	227	2	80	0.0250000
NODE_2217_length_1524_cov_130.874386	306	386	230	1	80	0.0125000
NODE_2219_length_1523_cov_24.115169	366	446	2	56	80	0.7000000
NODE_2219_length_1523_cov_24.115169	366	446	3	5	80	0.0625000
NODE_2219_length_1523_cov_24.115169	366	446	4	19	80	0.2375000
NODE_2219_length_1523_cov_24.115169	419	499	2	22	80	0.2750000
NODE_2219_length_1523_cov_24.115169	419	499	3	5	80	0.0625000
NODE_2219_length_1523_cov_24.115169	419	499	4	53	80	0.6625000
NODE_2219_length_1523_cov_24.115169	495	575	3	3	80	0.0375000
NODE_2219_length_1523_cov_24.115169	495	575	4	77	80	0.9625000
NODE_2219_length_1523_cov_24.115169	548	628	0	24	80	0.3000000
NODE_2219_length_1523_cov_24.115169	548	628	2	27	80	0.3375000
NODE_2219_length_1523_cov_24.115169	548	628	3	5	80	0.0625000
NODE_2219_length_1523_cov_24.115169	548	628	4	24	80	0.3000000
NODE_2223_length_1522_cov_13.278988	361	441	2	59	80	0.7375000
NODE_2223_length_1522_cov_13.278988	361	441	4	21	80	0.2625000
NODE_2223_length_1522_cov_13.278988	414	494	2	6	80	0.0750000
NODE_2223_length_1522_cov_13.278988	414	494	4	74	80	0.9250000
NODE_2225_length_1521_cov_20.965541	772	852	1	6	80	0.0750000
NODE_2225_length_1521_cov_20.965541	772	852	2	21	80	0.2625000
NODE_2225_length_1521_cov_20.965541	772	852	3	53	80	0.6625000
NODE_2225_length_1521_cov_20.965541	825	905	2	74	80	0.9250000
NODE_2225_length_1521_cov_20.965541	825	905	3	6	80	0.0750000
NODE_2226_length_1521_cov_15.381153	907	987	12	10	80	0.1250000
NODE_2226_length_1521_cov_15.381153	907	987	13	21	80	0.2625000
NODE_2226_length_1521_cov_15.381153	907	987	14	6	80	0.0750000
NODE_2226_length_1521_cov_15.381153	907	987	15	7	80	0.0875000
NODE_2226_length_1521_cov_15.381153	907	987	16	18	80	0.2250000
NODE_2226_length_1521_cov_15.381153	907	987	17	18	80	0.2250000
NODE_2226_length_1521_cov_15.381153	960	1040	13	20	80	0.2500000
NODE_2226_length_1521_cov_15.381153	960	1040	14	15	80	0.1875000
NODE_2226_length_1521_cov_15.381153	960	1040	15	16	80	0.2000000
NODE_2226_length_1521_cov_15.381153	960	1040	16	28	80	0.3500000
NODE_2226_length_1521_cov_15.381153	960	1040	17	1	80	0.0125000
NODE_2226_length_1521_cov_15.381153	988	1040	13	9	52	0.1730769
NODE_2226_length_1521_cov_15.381153	988	1040	14	8	52	0.1538462
NODE_2226_length_1521_cov_15.381153	988	1040	15	11	52	0.2115385
NODE_2226_length_1521_cov_15.381153	988	1040	16	24	52	0.4615385
NODE_2227_length_1521_cov_7.682138	525	605	4	12	80	0.1500000
NODE_2227_length_1521_cov_7.682138	525	605	5	68	80	0.8500000
NODE_2227_length_1521_cov_7.682138	578	658	1	23	80	0.2875000
NODE_2227_length_1521_cov_7.682138	578	658	3	17	80	0.2125000
NODE_2227_length_1521_cov_7.682138	578	658	4	14	80	0.1750000
NODE_2227_length_1521_cov_7.682138	578	658	5	26	80	0.3250000
NODE_2236_length_1519_cov_20.792958	714	794	4	3	80	0.0375000
NODE_2236_length_1519_cov_20.792958	714	794	5	32	80	0.4000000
NODE_2236_length_1519_cov_20.792958	714	794	7	45	80	0.5625000
NODE_2236_length_1519_cov_20.792958	767	847	3	2	80	0.0250000
NODE_2236_length_1519_cov_20.792958	767	847	4	38	80	0.4750000
NODE_2236_length_1519_cov_20.792958	767	847	5	20	80	0.2500000
NODE_2236_length_1519_cov_20.792958	767	847	7	20	80	0.2500000
NODE_2239_length_1517_cov_24.074048	413	450	0	37	37	1.0000000
NODE_2239_length_1517_cov_24.074048	842	922	0	1	80	0.0125000
NODE_2239_length_1517_cov_24.074048	842	922	2	79	80	0.9875000
NODE_2239_length_1517_cov_24.074048	895	975	2	80	80	1.0000000
NODE_2240_length_1517_cov_22.897743	383	463	6	18	80	0.2250000
NODE_2240_length_1517_cov_22.897743	383	463	7	19	80	0.2375000
NODE_2240_length_1517_cov_22.897743	383	463	8	36	80	0.4500000
NODE_2240_length_1517_cov_22.897743	383	463	9	6	80	0.0750000
NODE_2240_length_1517_cov_22.897743	383	463	10	1	80	0.0125000
NODE_2240_length_1517_cov_22.897743	436	516	6	8	80	0.1000000
NODE_2240_length_1517_cov_22.897743	436	516	7	19	80	0.2375000
NODE_2240_length_1517_cov_22.897743	436	516	8	10	80	0.1250000
NODE_2240_length_1517_cov_22.897743	436	516	9	29	80	0.3625000
NODE_2240_length_1517_cov_22.897743	436	516	10	14	80	0.1750000
NODE_2241_length_1517_cov_11.781382	381	461	0	8	80	0.1000000
NODE_2241_length_1517_cov_11.781382	381	461	1	48	80	0.6000000
NODE_2241_length_1517_cov_11.781382	381	461	2	24	80	0.3000000
NODE_2241_length_1517_cov_11.781382	434	514	0	17	80	0.2125000
NODE_2241_length_1517_cov_11.781382	434	514	1	63	80	0.7875000
NODE_2243_length_1517_cov_4.944993	393	473	0	11	80	0.1375000
NODE_2243_length_1517_cov_4.944993	393	473	2	69	80	0.8625000
NODE_2243_length_1517_cov_4.944993	446	526	0	25	80	0.3125000
NODE_2243_length_1517_cov_4.944993	446	526	2	55	80	0.6875000
NODE_2247_length_1516_cov_11.177135	230	310	1	19	80	0.2375000
NODE_2247_length_1516_cov_11.177135	230	310	2	61	80	0.7625000
NODE_2247_length_1516_cov_11.177135	283	363	2	63	80	0.7875000
NODE_2247_length_1516_cov_11.177135	283	363	3	17	80	0.2125000
NODE_2248_length_1516_cov_8.608327	580	660	0	80	80	1.0000000
NODE_2248_length_1516_cov_8.608327	633	713	0	80	80	1.0000000
NODE_2250_length_1515_cov_16.990819	333	413	8	10	80	0.1250000
NODE_2250_length_1515_cov_16.990819	333	413	9	2	80	0.0250000
NODE_2250_length_1515_cov_16.990819	333	413	10	12	80	0.1500000
NODE_2250_length_1515_cov_16.990819	333	413	11	8	80	0.1000000
NODE_2250_length_1515_cov_16.990819	333	413	12	1	80	0.0125000
NODE_2250_length_1515_cov_16.990819	333	413	13	4	80	0.0500000
NODE_2250_length_1515_cov_16.990819	333	413	14	1	80	0.0125000
NODE_2250_length_1515_cov_16.990819	333	413	16	1	80	0.0125000
NODE_2250_length_1515_cov_16.990819	333	413	19	4	80	0.0500000
NODE_2250_length_1515_cov_16.990819	333	413	20	3	80	0.0375000
NODE_2250_length_1515_cov_16.990819	333	413	22	3	80	0.0375000
NODE_2250_length_1515_cov_16.990819	333	413	24	1	80	0.0125000
NODE_2250_length_1515_cov_16.990819	333	413	26	1	80	0.0125000
NODE_2250_length_1515_cov_16.990819	333	413	28	3	80	0.0375000
NODE_2250_length_1515_cov_16.990819	333	413	29	4	80	0.0500000
NODE_2250_length_1515_cov_16.990819	333	413	32	1	80	0.0125000
NODE_2250_length_1515_cov_16.990819	333	413	33	2	80	0.0250000
NODE_2250_length_1515_cov_16.990819	333	413	35	1	80	0.0125000
NODE_2250_length_1515_cov_16.990819	333	413	36	1	80	0.0125000
NODE_2250_length_1515_cov_16.990819	333	413	38	1	80	0.0125000
NODE_2250_length_1515_cov_16.990819	333	413	39	3	80	0.0375000
NODE_2250_length_1515_cov_16.990819	333	413	40	2	80	0.0250000
NODE_2250_length_1515_cov_16.990819	333	413	41	9	80	0.1125000
NODE_2250_length_1515_cov_16.990819	333	413	42	1	80	0.0125000
NODE_2250_length_1515_cov_16.990819	333	413	43	1	80	0.0125000
NODE_2250_length_1515_cov_16.990819	386	448	3	18	62	0.2903226
NODE_2250_length_1515_cov_16.990819	386	448	4	2	62	0.0322581
NODE_2250_length_1515_cov_16.990819	386	448	5	2	62	0.0322581
NODE_2250_length_1515_cov_16.990819	386	448	6	12	62	0.1935484
NODE_2250_length_1515_cov_16.990819	386	448	8	11	62	0.1774193
NODE_2250_length_1515_cov_16.990819	386	448	9	2	62	0.0322581
NODE_2250_length_1515_cov_16.990819	386	448	10	12	62	0.1935484
NODE_2250_length_1515_cov_16.990819	386	448	11	3	62	0.0483871
NODE_2258_length_1512_cov_5.111819	506	560	1	54	54	1.0000000
NODE_2258_length_1512_cov_5.111819	677	698	0	21	21	1.0000000
NODE_2258_length_1512_cov_5.111819	677	698	0	21	21	1.0000000
NODE_2258_length_1512_cov_5.111819	1057	1137	0	1	80	0.0125000
NODE_2258_length_1512_cov_5.111819	1057	1137	2	79	80	0.9875000
NODE_2258_length_1512_cov_5.111819	1110	1190	1	2	80	0.0250000
NODE_2258_length_1512_cov_5.111819	1110	1190	2	55	80	0.6875000
NODE_2258_length_1512_cov_5.111819	1110	1190	3	23	80	0.2875000
NODE_2258_length_1512_cov_5.111819	1144	1190	1	2	46	0.0434783
NODE_2258_length_1512_cov_5.111819	1144	1190	2	21	46	0.4565217
NODE_2258_length_1512_cov_5.111819	1144	1190	3	23	46	0.5000000
NODE_2259_length_1512_cov_4.251946	132	204	0	72	72	1.0000000
NODE_2262_length_1511_cov_30.963173	787	867	4	80	80	1.0000000
NODE_2262_length_1511_cov_30.963173	840	920	0	11	80	0.1375000
NODE_2262_length_1511_cov_30.963173	840	920	1	4	80	0.0500000
NODE_2262_length_1511_cov_30.963173	840	920	2	13	80	0.1625000
NODE_2262_length_1511_cov_30.963173	840	920	3	24	80	0.3000000
NODE_2262_length_1511_cov_30.963173	840	920	4	28	80	0.3500000
NODE_2262_length_1511_cov_30.963173	916	996	0	23	80	0.2875000
NODE_2262_length_1511_cov_30.963173	916	996	2	14	80	0.1750000
NODE_2262_length_1511_cov_30.963173	916	996	3	43	80	0.5375000
NODE_2262_length_1511_cov_30.963173	969	1059	3	90	90	1.0000000
NODE_2265_length_1510_cov_24.184975	434	514	1	46	80	0.5750000
NODE_2265_length_1510_cov_24.184975	434	514	2	34	80	0.4250000
NODE_2265_length_1510_cov_24.184975	487	567	1	54	80	0.6750000
NODE_2265_length_1510_cov_24.184975	487	567	2	25	80	0.3125000
NODE_2265_length_1510_cov_24.184975	487	567	3	1	80	0.0125000
NODE_2265_length_1510_cov_24.184975	563	643	2	3	80	0.0375000
NODE_2265_length_1510_cov_24.184975	563	643	3	13	80	0.1625000
NODE_2265_length_1510_cov_24.184975	563	643	4	62	80	0.7750000
NODE_2265_length_1510_cov_24.184975	563	643	5	2	80	0.0250000
NODE_2265_length_1510_cov_24.184975	616	696	4	80	80	1.0000000
NODE_2269_length_1509_cov_51.836170	655	735	1	1	80	0.0125000
NODE_2269_length_1509_cov_51.836170	655	735	2	26	80	0.3250000
NODE_2269_length_1509_cov_51.836170	655	735	3	20	80	0.2500000
NODE_2269_length_1509_cov_51.836170	655	735	4	33	80	0.4125000
NODE_2269_length_1509_cov_51.836170	708	788	4	52	80	0.6500000
NODE_2269_length_1509_cov_51.836170	708	788	5	22	80	0.2750000
NODE_2269_length_1509_cov_51.836170	708	788	6	6	80	0.0750000
NODE_2269_length_1509_cov_51.836170	784	864	5	3	80	0.0375000
NODE_2269_length_1509_cov_51.836170	784	864	6	38	80	0.4750000
NODE_2269_length_1509_cov_51.836170	784	864	7	39	80	0.4875000
NODE_2269_length_1509_cov_51.836170	837	917	5	7	80	0.0875000
NODE_2269_length_1509_cov_51.836170	837	917	6	60	80	0.7500000
NODE_2269_length_1509_cov_51.836170	837	917	7	13	80	0.1625000
NODE_2270_length_1509_cov_16.010638	497	577	2	44	80	0.5500000
NODE_2270_length_1509_cov_16.010638	497	577	4	36	80	0.4500000
NODE_2270_length_1509_cov_16.010638	550	630	0	8	80	0.1000000
NODE_2270_length_1509_cov_16.010638	550	630	2	67	80	0.8375000
NODE_2270_length_1509_cov_16.010638	550	630	4	5	80	0.0625000
NODE_2270_length_1509_cov_16.010638	626	706	0	6	80	0.0750000
NODE_2270_length_1509_cov_16.010638	626	706	1	74	80	0.9250000
NODE_2270_length_1509_cov_16.010638	679	759	1	41	80	0.5125000
NODE_2270_length_1509_cov_16.010638	679	759	2	39	80	0.4875000
NODE_2271_length_1509_cov_8.883688	252	332	0	17	80	0.2125000
NODE_2271_length_1509_cov_8.883688	252	332	2	63	80	0.7875000
NODE_2271_length_1509_cov_8.883688	305	385	0	13	80	0.1625000
NODE_2271_length_1509_cov_8.883688	305	385	2	67	80	0.8375000
NODE_2271_length_1509_cov_8.883688	327	385	0	13	58	0.2241379
NODE_2271_length_1509_cov_8.883688	327	385	2	45	58	0.7758621
NODE_2271_length_1509_cov_8.883688	381	461	0	80	80	1.0000000
NODE_2271_length_1509_cov_8.883688	434	514	0	80	80	1.0000000
NODE_2272_length_1509_cov_5.826950	1029	1109	4	80	80	1.0000000
NODE_2272_length_1509_cov_5.826950	1082	1162	0	12	80	0.1500000
NODE_2272_length_1509_cov_5.826950	1082	1162	1	20	80	0.2500000
NODE_2272_length_1509_cov_5.826950	1082	1162	3	6	80	0.0750000
NODE_2272_length_1509_cov_5.826950	1082	1162	4	42	80	0.5250000
NODE_2277_length_1508_cov_24.176011	765	845	2	23	80	0.2875000
NODE_2277_length_1508_cov_24.176011	765	845	3	57	80	0.7125000
NODE_2277_length_1508_cov_24.176011	818	898	2	10	80	0.1250000
NODE_2277_length_1508_cov_24.176011	818	898	3	70	80	0.8750000
NODE_2290_length_1504_cov_17.449822	596	676	1	43	80	0.5375000
NODE_2290_length_1504_cov_17.449822	596	676	2	37	80	0.4625000
NODE_2290_length_1504_cov_17.449822	649	729	0	45	80	0.5625000
NODE_2290_length_1504_cov_17.449822	649	729	1	35	80	0.4375000
NODE_2293_length_1502_cov_42.989309	559	639	7	2	80	0.0250000
NODE_2293_length_1502_cov_42.989309	559	639	8	1	80	0.0125000
NODE_2293_length_1502_cov_42.989309	559	639	9	42	80	0.5250000
NODE_2293_length_1502_cov_42.989309	559	639	10	19	80	0.2375000
NODE_2293_length_1502_cov_42.989309	559	639	11	16	80	0.2000000
NODE_2293_length_1502_cov_42.989309	612	692	3	20	80	0.2500000
NODE_2293_length_1502_cov_42.989309	612	692	5	10	80	0.1250000
NODE_2293_length_1502_cov_42.989309	612	692	7	6	80	0.0750000
NODE_2293_length_1502_cov_42.989309	612	692	9	35	80	0.4375000
NODE_2293_length_1502_cov_42.989309	612	692	10	3	80	0.0375000
NODE_2293_length_1502_cov_42.989309	612	692	11	6	80	0.0750000
NODE_2294_length_1501_cov_22.828816	421	500	2	79	79	1.0000000
NODE_2294_length_1501_cov_22.828816	473	553	0	16	80	0.2000000
NODE_2294_length_1501_cov_22.828816	473	553	2	64	80	0.8000000
NODE_2294_length_1501_cov_22.828816	549	629	0	80	80	1.0000000
NODE_2294_length_1501_cov_22.828816	602	682	0	80	80	1.0000000
NODE_2295_length_1501_cov_14.422254	973	1053	6	17	80	0.2125000
NODE_2295_length_1501_cov_14.422254	973	1053	7	22	80	0.2750000
NODE_2295_length_1501_cov_14.422254	973	1053	8	41	80	0.5125000
NODE_2295_length_1501_cov_14.422254	1026	1106	1	22	80	0.2750000
NODE_2295_length_1501_cov_14.422254	1026	1106	2	7	80	0.0875000
NODE_2295_length_1501_cov_14.422254	1026	1106	3	1	80	0.0125000
NODE_2295_length_1501_cov_14.422254	1026	1106	5	8	80	0.1000000
NODE_2295_length_1501_cov_14.422254	1026	1106	7	37	80	0.4625000
NODE_2295_length_1501_cov_14.422254	1026	1106	8	5	80	0.0625000
NODE_2296_length_1501_cov_14.060628	225	305	0	18	80	0.2250000
NODE_2296_length_1501_cov_14.060628	225	305	1	51	80	0.6375000
NODE_2296_length_1501_cov_14.060628	225	305	2	11	80	0.1375000
NODE_2296_length_1501_cov_14.060628	278	358	0	16	80	0.2000000
NODE_2296_length_1501_cov_14.060628	278	358	2	42	80	0.5250000
NODE_2296_length_1501_cov_14.060628	278	358	4	22	80	0.2750000
NODE_2296_length_1501_cov_14.060628	986	1066	0	80	80	1.0000000
NODE_2296_length_1501_cov_14.060628	1039	1119	0	80	80	1.0000000
NODE_2300_length_1500_cov_40.056388	619	699	0	4	80	0.0500000
NODE_2300_length_1500_cov_40.056388	619	699	1	25	80	0.3125000
NODE_2300_length_1500_cov_40.056388	619	699	2	8	80	0.1000000
NODE_2300_length_1500_cov_40.056388	619	699	3	43	80	0.5375000
NODE_2300_length_1500_cov_40.056388	672	752	3	70	80	0.8750000
NODE_2300_length_1500_cov_40.056388	672	752	4	10	80	0.1250000
NODE_2305_length_1497_cov_38.344063	1401	1481	35	1	80	0.0125000
NODE_2305_length_1497_cov_38.344063	1401	1481	38	1	80	0.0125000
NODE_2305_length_1497_cov_38.344063	1401	1481	42	1	80	0.0125000
NODE_2305_length_1497_cov_38.344063	1401	1481	44	2	80	0.0250000
NODE_2305_length_1497_cov_38.344063	1401	1481	47	2	80	0.0250000
NODE_2305_length_1497_cov_38.344063	1401	1481	49	2	80	0.0250000
NODE_2305_length_1497_cov_38.344063	1401	1481	53	2	80	0.0250000
NODE_2305_length_1497_cov_38.344063	1401	1481	58	1	80	0.0125000
NODE_2305_length_1497_cov_38.344063	1401	1481	59	3	80	0.0375000
NODE_2305_length_1497_cov_38.344063	1401	1481	60	1	80	0.0125000
NODE_2305_length_1497_cov_38.344063	1401	1481	64	3	80	0.0375000
NODE_2305_length_1497_cov_38.344063	1401	1481	67	2	80	0.0250000
NODE_2305_length_1497_cov_38.344063	1401	1481	68	6	80	0.0750000
NODE_2305_length_1497_cov_38.344063	1401	1481	69	1	80	0.0125000
NODE_2305_length_1497_cov_38.344063	1401	1481	71	2	80	0.0250000
NODE_2305_length_1497_cov_38.344063	1401	1481	74	3	80	0.0375000
NODE_2305_length_1497_cov_38.344063	1401	1481	75	1	80	0.0125000
NODE_2305_length_1497_cov_38.344063	1401	1481	76	2	80	0.0250000
NODE_2305_length_1497_cov_38.344063	1401	1481	78	1	80	0.0125000
NODE_2305_length_1497_cov_38.344063	1401	1481	80	2	80	0.0250000
NODE_2305_length_1497_cov_38.344063	1401	1481	81	1	80	0.0125000
NODE_2305_length_1497_cov_38.344063	1401	1481	86	2	80	0.0250000
NODE_2305_length_1497_cov_38.344063	1401	1481	88	1	80	0.0125000
NODE_2305_length_1497_cov_38.344063	1401	1481	89	3	80	0.0375000
NODE_2305_length_1497_cov_38.344063	1401	1481	90	1	80	0.0125000
NODE_2305_length_1497_cov_38.344063	1401	1481	93	1	80	0.0125000
NODE_2305_length_1497_cov_38.344063	1401	1481	95	1	80	0.0125000
NODE_2305_length_1497_cov_38.344063	1401	1481	96	3	80	0.0375000
NODE_2305_length_1497_cov_38.344063	1401	1481	97	1	80	0.0125000
NODE_2305_length_1497_cov_38.344063	1401	1481	98	1	80	0.0125000
NODE_2305_length_1497_cov_38.344063	1401	1481	99	1	80	0.0125000
NODE_2305_length_1497_cov_38.344063	1401	1481	103	4	80	0.0500000
NODE_2305_length_1497_cov_38.344063	1401	1481	104	1	80	0.0125000
NODE_2305_length_1497_cov_38.344063	1401	1481	105	1	80	0.0125000
NODE_2305_length_1497_cov_38.344063	1401	1481	106	2	80	0.0250000
NODE_2305_length_1497_cov_38.344063	1401	1481	107	1	80	0.0125000
NODE_2305_length_1497_cov_38.344063	1401	1481	108	3	80	0.0375000
NODE_2305_length_1497_cov_38.344063	1401	1481	109	1	80	0.0125000
NODE_2305_length_1497_cov_38.344063	1401	1481	111	1	80	0.0125000
NODE_2305_length_1497_cov_38.344063	1401	1481	114	1	80	0.0125000
NODE_2305_length_1497_cov_38.344063	1401	1481	116	3	80	0.0375000
NODE_2305_length_1497_cov_38.344063	1401	1481	117	2	80	0.0250000
NODE_2305_length_1497_cov_38.344063	1401	1481	118	4	80	0.0500000
NODE_2305_length_1497_cov_38.344063	1401	1481	122	1	80	0.0125000
NODE_2308_length_1496_cov_3.936292	0	44	0	44	44	1.0000000
NODE_2308_length_1496_cov_3.936292	17	97	0	80	80	1.0000000
NODE_2311_length_1496_cov_1.103794	405	428	2	23	23	1.0000000
NODE_2313_length_1494_cov_65.437276	460	540	2	80	80	1.0000000
NODE_2313_length_1494_cov_65.437276	513	594	0	32	81	0.3950617
NODE_2313_length_1494_cov_65.437276	513	594	1	1	81	0.0123457
NODE_2313_length_1494_cov_65.437276	513	594	2	48	81	0.5925926
NODE_2313_length_1494_cov_65.437276	787	854	2	38	67	0.5671642
NODE_2313_length_1494_cov_65.437276	787	854	3	29	67	0.4328358
NODE_2313_length_1494_cov_65.437276	827	907	1	25	80	0.3125000
NODE_2313_length_1494_cov_65.437276	827	907	2	46	80	0.5750000
NODE_2313_length_1494_cov_65.437276	827	907	3	9	80	0.1125000
NODE_2316_length_1493_cov_100.467719	947	1028	145	1	81	0.0123457
NODE_2316_length_1493_cov_100.467719	947	1028	146	1	81	0.0123457
NODE_2316_length_1493_cov_100.467719	947	1028	148	1	81	0.0123457
NODE_2316_length_1493_cov_100.467719	947	1028	149	3	81	0.0370370
NODE_2316_length_1493_cov_100.467719	947	1028	150	2	81	0.0246914
NODE_2316_length_1493_cov_100.467719	947	1028	155	1	81	0.0123457
NODE_2316_length_1493_cov_100.467719	947	1028	161	1	81	0.0123457
NODE_2316_length_1493_cov_100.467719	947	1028	162	1	81	0.0123457
NODE_2316_length_1493_cov_100.467719	947	1028	164	3	81	0.0370370
NODE_2316_length_1493_cov_100.467719	947	1028	169	2	81	0.0246914
NODE_2316_length_1493_cov_100.467719	947	1028	170	2	81	0.0246914
NODE_2316_length_1493_cov_100.467719	947	1028	172	3	81	0.0370370
NODE_2316_length_1493_cov_100.467719	947	1028	173	4	81	0.0493827
NODE_2316_length_1493_cov_100.467719	947	1028	175	5	81	0.0617284
NODE_2316_length_1493_cov_100.467719	947	1028	176	3	81	0.0370370
NODE_2316_length_1493_cov_100.467719	947	1028	178	2	81	0.0246914
NODE_2316_length_1493_cov_100.467719	947	1028	179	1	81	0.0123457
NODE_2316_length_1493_cov_100.467719	947	1028	181	1	81	0.0123457
NODE_2316_length_1493_cov_100.467719	947	1028	188	1	81	0.0123457
NODE_2316_length_1493_cov_100.467719	947	1028	192	2	81	0.0246914
NODE_2316_length_1493_cov_100.467719	947	1028	194	2	81	0.0246914
NODE_2316_length_1493_cov_100.467719	947	1028	195	1	81	0.0123457
NODE_2316_length_1493_cov_100.467719	947	1028	198	1	81	0.0123457
NODE_2316_length_1493_cov_100.467719	947	1028	199	1	81	0.0123457
NODE_2316_length_1493_cov_100.467719	947	1028	200	6	81	0.0740741
NODE_2316_length_1493_cov_100.467719	947	1028	201	2	81	0.0246914
NODE_2316_length_1493_cov_100.467719	947	1028	202	1	81	0.0123457
NODE_2316_length_1493_cov_100.467719	947	1028	203	1	81	0.0123457
NODE_2316_length_1493_cov_100.467719	947	1028	204	2	81	0.0246914
NODE_2316_length_1493_cov_100.467719	947	1028	208	1	81	0.0123457
NODE_2316_length_1493_cov_100.467719	947	1028	209	1	81	0.0123457
NODE_2316_length_1493_cov_100.467719	947	1028	211	1	81	0.0123457
NODE_2316_length_1493_cov_100.467719	947	1028	220	1	81	0.0123457
NODE_2316_length_1493_cov_100.467719	947	1028	222	2	81	0.0246914
NODE_2316_length_1493_cov_100.467719	947	1028	224	1	81	0.0123457
NODE_2316_length_1493_cov_100.467719	947	1028	230	1	81	0.0123457
NODE_2316_length_1493_cov_100.467719	947	1028	235	1	81	0.0123457
NODE_2316_length_1493_cov_100.467719	947	1028	236	1	81	0.0123457
NODE_2316_length_1493_cov_100.467719	947	1028	244	1	81	0.0123457
NODE_2316_length_1493_cov_100.467719	947	1028	245	2	81	0.0246914
NODE_2316_length_1493_cov_100.467719	947	1028	246	1	81	0.0123457
NODE_2316_length_1493_cov_100.467719	947	1028	249	3	81	0.0370370
NODE_2316_length_1493_cov_100.467719	947	1028	254	1	81	0.0123457
NODE_2316_length_1493_cov_100.467719	947	1028	255	2	81	0.0246914
NODE_2316_length_1493_cov_100.467719	947	1028	256	1	81	0.0123457
NODE_2316_length_1493_cov_100.467719	947	1028	258	3	81	0.0370370
NODE_2316_length_1493_cov_100.467719	1001	1071	203	1	70	0.0142857
NODE_2316_length_1493_cov_100.467719	1001	1071	204	2	70	0.0285714
NODE_2316_length_1493_cov_100.467719	1001	1071	208	1	70	0.0142857
NODE_2316_length_1493_cov_100.467719	1001	1071	209	1	70	0.0142857
NODE_2316_length_1493_cov_100.467719	1001	1071	211	1	70	0.0142857
NODE_2316_length_1493_cov_100.467719	1001	1071	220	1	70	0.0142857
NODE_2316_length_1493_cov_100.467719	1001	1071	222	2	70	0.0285714
NODE_2316_length_1493_cov_100.467719	1001	1071	224	1	70	0.0142857
NODE_2316_length_1493_cov_100.467719	1001	1071	230	1	70	0.0142857
NODE_2316_length_1493_cov_100.467719	1001	1071	235	1	70	0.0142857
NODE_2316_length_1493_cov_100.467719	1001	1071	236	1	70	0.0142857
NODE_2316_length_1493_cov_100.467719	1001	1071	244	1	70	0.0142857
NODE_2316_length_1493_cov_100.467719	1001	1071	245	2	70	0.0285714
NODE_2316_length_1493_cov_100.467719	1001	1071	246	1	70	0.0142857
NODE_2316_length_1493_cov_100.467719	1001	1071	249	3	70	0.0428571
NODE_2316_length_1493_cov_100.467719	1001	1071	254	1	70	0.0142857
NODE_2316_length_1493_cov_100.467719	1001	1071	255	2	70	0.0285714
NODE_2316_length_1493_cov_100.467719	1001	1071	256	1	70	0.0142857
NODE_2316_length_1493_cov_100.467719	1001	1071	258	4	70	0.0571429
NODE_2316_length_1493_cov_100.467719	1001	1071	260	1	70	0.0142857
NODE_2316_length_1493_cov_100.467719	1001	1071	261	2	70	0.0285714
NODE_2316_length_1493_cov_100.467719	1001	1071	262	1	70	0.0142857
NODE_2316_length_1493_cov_100.467719	1001	1071	263	1	70	0.0142857
NODE_2316_length_1493_cov_100.467719	1001	1071	266	1	70	0.0142857
NODE_2316_length_1493_cov_100.467719	1001	1071	268	1	70	0.0142857
NODE_2316_length_1493_cov_100.467719	1001	1071	269	1	70	0.0142857
NODE_2316_length_1493_cov_100.467719	1001	1071	270	1	70	0.0142857
NODE_2316_length_1493_cov_100.467719	1001	1071	272	2	70	0.0285714
NODE_2316_length_1493_cov_100.467719	1001	1071	273	4	70	0.0571429
NODE_2316_length_1493_cov_100.467719	1001	1071	274	4	70	0.0571429
NODE_2316_length_1493_cov_100.467719	1001	1071	277	1	70	0.0142857
NODE_2316_length_1493_cov_100.467719	1001	1071	284	1	70	0.0142857
NODE_2316_length_1493_cov_100.467719	1001	1071	285	1	70	0.0142857
NODE_2316_length_1493_cov_100.467719	1001	1071	287	1	70	0.0142857
NODE_2316_length_1493_cov_100.467719	1001	1071	288	2	70	0.0285714
NODE_2316_length_1493_cov_100.467719	1001	1071	290	1	70	0.0142857
NODE_2316_length_1493_cov_100.467719	1001	1071	294	1	70	0.0142857
NODE_2316_length_1493_cov_100.467719	1001	1071	297	2	70	0.0285714
NODE_2316_length_1493_cov_100.467719	1001	1071	298	3	70	0.0428571
NODE_2316_length_1493_cov_100.467719	1001	1071	299	1	70	0.0142857
NODE_2316_length_1493_cov_100.467719	1001	1071	302	1	70	0.0142857
NODE_2316_length_1493_cov_100.467719	1001	1071	303	1	70	0.0142857
NODE_2316_length_1493_cov_100.467719	1001	1071	304	3	70	0.0428571
NODE_2316_length_1493_cov_100.467719	1001	1071	314	1	70	0.0142857
NODE_2316_length_1493_cov_100.467719	1001	1071	316	1	70	0.0142857
NODE_2316_length_1493_cov_100.467719	1001	1071	318	1	70	0.0142857
NODE_2316_length_1493_cov_100.467719	1001	1071	319	1	70	0.0142857
NODE_2316_length_1493_cov_100.467719	1077	1157	314	1	80	0.0125000
NODE_2316_length_1493_cov_100.467719	1077	1157	315	2	80	0.0250000
NODE_2316_length_1493_cov_100.467719	1077	1157	317	1	80	0.0125000
NODE_2316_length_1493_cov_100.467719	1077	1157	318	1	80	0.0125000
NODE_2316_length_1493_cov_100.467719	1077	1157	319	1	80	0.0125000
NODE_2316_length_1493_cov_100.467719	1077	1157	320	2	80	0.0250000
NODE_2316_length_1493_cov_100.467719	1077	1157	323	1	80	0.0125000
NODE_2316_length_1493_cov_100.467719	1077	1157	324	1	80	0.0125000
NODE_2316_length_1493_cov_100.467719	1077	1157	326	1	80	0.0125000
NODE_2316_length_1493_cov_100.467719	1077	1157	328	1	80	0.0125000
NODE_2316_length_1493_cov_100.467719	1077	1157	330	1	80	0.0125000
NODE_2316_length_1493_cov_100.467719	1077	1157	331	1	80	0.0125000
NODE_2316_length_1493_cov_100.467719	1077	1157	333	2	80	0.0250000
NODE_2316_length_1493_cov_100.467719	1077	1157	334	1	80	0.0125000
NODE_2316_length_1493_cov_100.467719	1077	1157	335	1	80	0.0125000
NODE_2316_length_1493_cov_100.467719	1077	1157	336	1	80	0.0125000
NODE_2316_length_1493_cov_100.467719	1077	1157	344	2	80	0.0250000
NODE_2316_length_1493_cov_100.467719	1077	1157	345	1	80	0.0125000
NODE_2316_length_1493_cov_100.467719	1077	1157	346	1	80	0.0125000
NODE_2316_length_1493_cov_100.467719	1077	1157	348	1	80	0.0125000
NODE_2316_length_1493_cov_100.467719	1077	1157	350	1	80	0.0125000
NODE_2316_length_1493_cov_100.467719	1077	1157	352	1	80	0.0125000
NODE_2316_length_1493_cov_100.467719	1077	1157	353	2	80	0.0250000
NODE_2316_length_1493_cov_100.467719	1077	1157	354	1	80	0.0125000
NODE_2316_length_1493_cov_100.467719	1077	1157	355	5	80	0.0625000
NODE_2316_length_1493_cov_100.467719	1077	1157	356	5	80	0.0625000
NODE_2316_length_1493_cov_100.467719	1077	1157	357	1	80	0.0125000
NODE_2316_length_1493_cov_100.467719	1077	1157	358	2	80	0.0250000
NODE_2316_length_1493_cov_100.467719	1077	1157	359	1	80	0.0125000
NODE_2316_length_1493_cov_100.467719	1077	1157	360	6	80	0.0750000
NODE_2316_length_1493_cov_100.467719	1077	1157	361	4	80	0.0500000
NODE_2316_length_1493_cov_100.467719	1077	1157	362	2	80	0.0250000
NODE_2316_length_1493_cov_100.467719	1077	1157	363	4	80	0.0500000
NODE_2316_length_1493_cov_100.467719	1077	1157	364	3	80	0.0375000
NODE_2316_length_1493_cov_100.467719	1077	1157	365	2	80	0.0250000
NODE_2316_length_1493_cov_100.467719	1077	1157	366	7	80	0.0875000
NODE_2316_length_1493_cov_100.467719	1077	1157	367	3	80	0.0375000
NODE_2316_length_1493_cov_100.467719	1077	1157	370	1	80	0.0125000
NODE_2316_length_1493_cov_100.467719	1077	1157	374	1	80	0.0125000
NODE_2316_length_1493_cov_100.467719	1077	1157	375	1	80	0.0125000
NODE_2316_length_1493_cov_100.467719	1077	1157	376	1	80	0.0125000
NODE_2316_length_1493_cov_100.467719	1077	1157	377	2	80	0.0250000
NODE_2316_length_1493_cov_100.467719	1130	1210	333	2	80	0.0250000
NODE_2316_length_1493_cov_100.467719	1130	1210	334	1	80	0.0125000
NODE_2316_length_1493_cov_100.467719	1130	1210	335	1	80	0.0125000
NODE_2316_length_1493_cov_100.467719	1130	1210	336	3	80	0.0375000
NODE_2316_length_1493_cov_100.467719	1130	1210	337	2	80	0.0250000
NODE_2316_length_1493_cov_100.467719	1130	1210	338	2	80	0.0250000
NODE_2316_length_1493_cov_100.467719	1130	1210	339	1	80	0.0125000
NODE_2316_length_1493_cov_100.467719	1130	1210	340	1	80	0.0125000
NODE_2316_length_1493_cov_100.467719	1130	1210	342	1	80	0.0125000
NODE_2316_length_1493_cov_100.467719	1130	1210	343	2	80	0.0250000
NODE_2316_length_1493_cov_100.467719	1130	1210	344	2	80	0.0250000
NODE_2316_length_1493_cov_100.467719	1130	1210	345	3	80	0.0375000
NODE_2316_length_1493_cov_100.467719	1130	1210	346	1	80	0.0125000
NODE_2316_length_1493_cov_100.467719	1130	1210	347	1	80	0.0125000
NODE_2316_length_1493_cov_100.467719	1130	1210	348	1	80	0.0125000
NODE_2316_length_1493_cov_100.467719	1130	1210	350	1	80	0.0125000
NODE_2316_length_1493_cov_100.467719	1130	1210	351	1	80	0.0125000
NODE_2316_length_1493_cov_100.467719	1130	1210	353	4	80	0.0500000
NODE_2316_length_1493_cov_100.467719	1130	1210	354	3	80	0.0375000
NODE_2316_length_1493_cov_100.467719	1130	1210	355	3	80	0.0375000
NODE_2316_length_1493_cov_100.467719	1130	1210	356	4	80	0.0500000
NODE_2316_length_1493_cov_100.467719	1130	1210	357	2	80	0.0250000
NODE_2316_length_1493_cov_100.467719	1130	1210	358	3	80	0.0375000
NODE_2316_length_1493_cov_100.467719	1130	1210	359	5	80	0.0625000
NODE_2316_length_1493_cov_100.467719	1130	1210	360	2	80	0.0250000
NODE_2316_length_1493_cov_100.467719	1130	1210	362	1	80	0.0125000
NODE_2316_length_1493_cov_100.467719	1130	1210	363	2	80	0.0250000
NODE_2316_length_1493_cov_100.467719	1130	1210	364	4	80	0.0500000
NODE_2316_length_1493_cov_100.467719	1130	1210	365	3	80	0.0375000
NODE_2316_length_1493_cov_100.467719	1130	1210	366	7	80	0.0875000
NODE_2316_length_1493_cov_100.467719	1130	1210	367	2	80	0.0250000
NODE_2316_length_1493_cov_100.467719	1130	1210	369	1	80	0.0125000
NODE_2316_length_1493_cov_100.467719	1130	1210	370	2	80	0.0250000
NODE_2316_length_1493_cov_100.467719	1130	1210	372	1	80	0.0125000
NODE_2316_length_1493_cov_100.467719	1130	1210	374	1	80	0.0125000
NODE_2316_length_1493_cov_100.467719	1130	1210	375	1	80	0.0125000
NODE_2316_length_1493_cov_100.467719	1130	1210	376	1	80	0.0125000
NODE_2316_length_1493_cov_100.467719	1130	1210	377	2	80	0.0250000
NODE_2321_length_1493_cov_1.138451	1341	1420	2	31	79	0.3924051
NODE_2321_length_1493_cov_1.138451	1341	1420	4	15	79	0.1898734
NODE_2321_length_1493_cov_1.138451	1341	1420	5	1	79	0.0126582
NODE_2321_length_1493_cov_1.138451	1341	1420	6	29	79	0.3670886
NODE_2321_length_1493_cov_1.138451	1341	1420	7	3	79	0.0379747
NODE_2321_length_1493_cov_1.138451	1341	1420	2	31	79	0.3924051
NODE_2321_length_1493_cov_1.138451	1341	1420	4	15	79	0.1898734
NODE_2321_length_1493_cov_1.138451	1341	1420	5	1	79	0.0126582
NODE_2321_length_1493_cov_1.138451	1341	1420	6	29	79	0.3670886
NODE_2321_length_1493_cov_1.138451	1341	1420	7	3	79	0.0379747
NODE_2321_length_1493_cov_1.138451	1393	1459	2	66	66	1.0000000
NODE_2332_length_1490_cov_5.726096	233	295	1	25	62	0.4032258
NODE_2332_length_1490_cov_5.726096	233	295	2	37	62	0.5967742
NODE_2332_length_1490_cov_5.726096	1065	1149	0	78	84	0.9285714
NODE_2332_length_1490_cov_5.726096	1065	1149	2	6	84	0.0714286
NODE_2333_length_1490_cov_4.687275	318	399	0	81	81	1.0000000
NODE_2333_length_1490_cov_4.687275	372	452	0	80	80	1.0000000
NODE_2338_length_1488_cov_3.734341	1141	1221	0	63	80	0.7875000
NODE_2338_length_1488_cov_3.734341	1141	1221	2	17	80	0.2125000
NODE_2340_length_1487_cov_19.332133	673	753	0	33	80	0.4125000
NODE_2340_length_1487_cov_19.332133	673	753	1	2	80	0.0250000
NODE_2340_length_1487_cov_19.332133	673	753	2	33	80	0.4125000
NODE_2340_length_1487_cov_19.332133	673	753	3	12	80	0.1500000
NODE_2340_length_1487_cov_19.332133	726	806	2	15	80	0.1875000
NODE_2340_length_1487_cov_19.332133	726	806	3	65	80	0.8125000
NODE_2348_length_1484_cov_38.342960	706	786	2	1	80	0.0125000
NODE_2348_length_1484_cov_38.342960	706	786	3	12	80	0.1500000
NODE_2348_length_1484_cov_38.342960	706	786	5	67	80	0.8375000
NODE_2348_length_1484_cov_38.342960	759	839	3	1	80	0.0125000
NODE_2348_length_1484_cov_38.342960	759	839	5	79	80	0.9875000
NODE_2349_length_1484_cov_21.260650	348	428	0	2	80	0.0250000
NODE_2349_length_1484_cov_21.260650	348	428	1	78	80	0.9750000
NODE_2349_length_1484_cov_21.260650	401	481	0	55	80	0.6875000
NODE_2349_length_1484_cov_21.260650	401	481	1	25	80	0.3125000
NODE_2349_length_1484_cov_21.260650	978	1058	0	65	80	0.8125000
NODE_2349_length_1484_cov_21.260650	978	1058	2	15	80	0.1875000
NODE_2349_length_1484_cov_21.260650	1031	1111	0	12	80	0.1500000
NODE_2349_length_1484_cov_21.260650	1031	1111	2	31	80	0.3875000
NODE_2349_length_1484_cov_21.260650	1031	1111	3	10	80	0.1250000
NODE_2349_length_1484_cov_21.260650	1031	1111	4	27	80	0.3375000
NODE_2350_length_1484_cov_19.243321	952	1032	4	1	80	0.0125000
NODE_2350_length_1484_cov_19.243321	952	1032	5	3	80	0.0375000
NODE_2350_length_1484_cov_19.243321	952	1032	7	3	80	0.0375000
NODE_2350_length_1484_cov_19.243321	952	1032	8	53	80	0.6625000
NODE_2350_length_1484_cov_19.243321	952	1032	9	20	80	0.2500000
NODE_2350_length_1484_cov_19.243321	1005	1085	6	1	80	0.0125000
NODE_2350_length_1484_cov_19.243321	1005	1085	7	22	80	0.2750000
NODE_2350_length_1484_cov_19.243321	1005	1085	8	47	80	0.5875000
NODE_2350_length_1484_cov_19.243321	1005	1085	9	10	80	0.1250000
NODE_2351_length_1484_cov_9.085199	314	394	4	33	80	0.4125000
NODE_2351_length_1484_cov_9.085199	314	394	5	47	80	0.5875000
NODE_2351_length_1484_cov_9.085199	367	447	2	4	80	0.0500000
NODE_2351_length_1484_cov_9.085199	367	447	3	4	80	0.0500000
NODE_2351_length_1484_cov_9.085199	367	447	4	60	80	0.7500000
NODE_2351_length_1484_cov_9.085199	367	447	5	12	80	0.1500000
NODE_2353_length_1483_cov_21.207370	555	635	2	80	80	1.0000000
NODE_2353_length_1483_cov_21.207370	608	688	2	80	80	1.0000000
NODE_2359_length_1482_cov_20.177874	430	510	3	16	80	0.2000000
NODE_2359_length_1482_cov_20.177874	430	510	4	34	80	0.4250000
NODE_2359_length_1482_cov_20.177874	430	510	5	1	80	0.0125000
NODE_2359_length_1482_cov_20.177874	430	510	6	29	80	0.3625000
NODE_2359_length_1482_cov_20.177874	483	563	5	4	80	0.0500000
NODE_2359_length_1482_cov_20.177874	483	563	6	76	80	0.9500000
NODE_2359_length_1482_cov_20.177874	559	639	5	10	80	0.1250000
NODE_2359_length_1482_cov_20.177874	559	639	6	16	80	0.2000000
NODE_2359_length_1482_cov_20.177874	559	639	7	54	80	0.6750000
NODE_2359_length_1482_cov_20.177874	612	692	3	1	80	0.0125000
NODE_2359_length_1482_cov_20.177874	612	692	5	34	80	0.4250000
NODE_2359_length_1482_cov_20.177874	612	692	6	13	80	0.1625000
NODE_2359_length_1482_cov_20.177874	612	692	7	32	80	0.4000000
NODE_2360_length_1482_cov_13.644252	1000	1080	3	80	80	1.0000000
NODE_2360_length_1482_cov_13.644252	1053	1133	0	21	80	0.2625000
NODE_2360_length_1482_cov_13.644252	1053	1133	1	4	80	0.0500000
NODE_2360_length_1482_cov_13.644252	1053	1133	2	8	80	0.1000000
NODE_2360_length_1482_cov_13.644252	1053	1133	3	47	80	0.5875000
NODE_2361_length_1482_cov_6.157628	525	605	2	27	80	0.3375000
NODE_2361_length_1482_cov_6.157628	525	605	3	30	80	0.3750000
NODE_2361_length_1482_cov_6.157628	525	605	4	23	80	0.2875000
NODE_2361_length_1482_cov_6.157628	578	658	2	62	80	0.7750000
NODE_2361_length_1482_cov_6.157628	578	658	4	18	80	0.2250000
NODE_2361_length_1482_cov_6.157628	1306	1388	9	7	82	0.0853659
NODE_2361_length_1482_cov_6.157628	1306	1388	11	3	82	0.0365854
NODE_2361_length_1482_cov_6.157628	1306	1388	12	1	82	0.0121951
NODE_2361_length_1482_cov_6.157628	1306	1388	13	6	82	0.0731707
NODE_2361_length_1482_cov_6.157628	1306	1388	14	15	82	0.1829268
NODE_2361_length_1482_cov_6.157628	1306	1388	16	8	82	0.0975610
NODE_2361_length_1482_cov_6.157628	1306	1388	19	22	82	0.2682927
NODE_2361_length_1482_cov_6.157628	1306	1388	20	20	82	0.2439024
NODE_2364_length_1481_cov_19.238784	480	560	2	19	80	0.2375000
NODE_2364_length_1481_cov_19.238784	480	560	3	61	80	0.7625000
NODE_2364_length_1481_cov_19.238784	533	613	1	52	80	0.6500000
NODE_2364_length_1481_cov_19.238784	533	613	3	28	80	0.3500000
NODE_2365_length_1481_cov_18.139653	706	786	0	7	80	0.0875000
NODE_2365_length_1481_cov_18.139653	706	786	2	22	80	0.2750000
NODE_2365_length_1481_cov_18.139653	706	786	3	40	80	0.5000000
NODE_2365_length_1481_cov_18.139653	706	786	4	11	80	0.1375000
NODE_2365_length_1481_cov_18.139653	759	839	0	60	80	0.7500000
NODE_2365_length_1481_cov_18.139653	759	839	2	20	80	0.2500000
NODE_2367_length_1480_cov_27.552498	762	842	2	80	80	1.0000000
NODE_2367_length_1480_cov_27.552498	815	895	0	45	80	0.5625000
NODE_2367_length_1480_cov_27.552498	815	895	2	35	80	0.4375000
NODE_2367_length_1480_cov_27.552498	891	971	0	80	80	1.0000000
NODE_2367_length_1480_cov_27.552498	944	1024	0	80	80	1.0000000
NODE_2367_length_1480_cov_27.552498	1171	1222	16	1	51	0.0196078
NODE_2367_length_1480_cov_27.552498	1171	1222	18	1	51	0.0196078
NODE_2367_length_1480_cov_27.552498	1171	1222	20	1	51	0.0196078
NODE_2367_length_1480_cov_27.552498	1171	1222	22	3	51	0.0588235
NODE_2367_length_1480_cov_27.552498	1171	1222	24	1	51	0.0196078
NODE_2367_length_1480_cov_27.552498	1171	1222	25	4	51	0.0784314
NODE_2367_length_1480_cov_27.552498	1171	1222	26	3	51	0.0588235
NODE_2367_length_1480_cov_27.552498	1171	1222	29	1	51	0.0196078
NODE_2367_length_1480_cov_27.552498	1171	1222	32	1	51	0.0196078
NODE_2367_length_1480_cov_27.552498	1171	1222	33	1	51	0.0196078
NODE_2367_length_1480_cov_27.552498	1171	1222	35	2	51	0.0392157
NODE_2367_length_1480_cov_27.552498	1171	1222	37	1	51	0.0196078
NODE_2367_length_1480_cov_27.552498	1171	1222	41	1	51	0.0196078
NODE_2367_length_1480_cov_27.552498	1171	1222	49	1	51	0.0196078
NODE_2367_length_1480_cov_27.552498	1171	1222	51	1	51	0.0196078
NODE_2367_length_1480_cov_27.552498	1171	1222	56	3	51	0.0588235
NODE_2367_length_1480_cov_27.552498	1171	1222	63	1	51	0.0196078
NODE_2367_length_1480_cov_27.552498	1171	1222	70	2	51	0.0392157
NODE_2367_length_1480_cov_27.552498	1171	1222	71	1	51	0.0196078
NODE_2367_length_1480_cov_27.552498	1171	1222	73	1	51	0.0196078
NODE_2367_length_1480_cov_27.552498	1171	1222	74	5	51	0.0980392
NODE_2367_length_1480_cov_27.552498	1171	1222	77	4	51	0.0784314
NODE_2367_length_1480_cov_27.552498	1171	1222	82	3	51	0.0588235
NODE_2367_length_1480_cov_27.552498	1171	1222	87	2	51	0.0392157
NODE_2367_length_1480_cov_27.552498	1171	1222	88	2	51	0.0392157
NODE_2367_length_1480_cov_27.552498	1171	1222	89	1	51	0.0196078
NODE_2367_length_1480_cov_27.552498	1171	1222	91	1	51	0.0196078
NODE_2367_length_1480_cov_27.552498	1171	1222	92	2	51	0.0392157
NODE_2369_length_1480_cov_12.535844	466	546	3	1	80	0.0125000
NODE_2369_length_1480_cov_12.535844	466	546	4	20	80	0.2500000
NODE_2369_length_1480_cov_12.535844	466	546	5	4	80	0.0500000
NODE_2369_length_1480_cov_12.535844	466	546	6	12	80	0.1500000
NODE_2369_length_1480_cov_12.535844	466	546	7	43	80	0.5375000
NODE_2369_length_1480_cov_12.535844	519	599	5	9	80	0.1125000
NODE_2369_length_1480_cov_12.535844	519	599	6	54	80	0.6750000
NODE_2369_length_1480_cov_12.535844	519	599	7	17	80	0.2125000
NODE_2373_length_1479_cov_17.035507	708	788	1	49	80	0.6125000
NODE_2373_length_1479_cov_17.035507	708	788	2	31	80	0.3875000
NODE_2373_length_1479_cov_17.035507	761	841	1	62	80	0.7750000
NODE_2373_length_1479_cov_17.035507	761	841	2	18	80	0.2250000
NODE_2373_length_1479_cov_17.035507	837	917	0	19	80	0.2375000
NODE_2373_length_1479_cov_17.035507	837	917	1	61	80	0.7625000
NODE_2373_length_1479_cov_17.035507	890	970	0	72	80	0.9000000
NODE_2373_length_1479_cov_17.035507	890	970	1	8	80	0.1000000
NODE_2374_length_1479_cov_16.448551	908	988	2	17	80	0.2125000
NODE_2374_length_1479_cov_16.448551	908	988	3	10	80	0.1250000
NODE_2374_length_1479_cov_16.448551	908	988	4	53	80	0.6625000
NODE_2374_length_1479_cov_16.448551	961	1041	0	13	80	0.1625000
NODE_2374_length_1479_cov_16.448551	961	1041	1	5	80	0.0625000
NODE_2374_length_1479_cov_16.448551	961	1041	2	52	80	0.6500000
NODE_2374_length_1479_cov_16.448551	961	1041	3	10	80	0.1250000
NODE_2375_length_1479_cov_5.285507	123	185	0	42	62	0.6774194
NODE_2375_length_1479_cov_5.285507	123	185	1	2	62	0.0322581
NODE_2375_length_1479_cov_5.285507	123	185	2	18	62	0.2903226
NODE_2376_length_1479_cov_2.018841	881	967	0	86	86	1.0000000
NODE_2377_length_1478_cov_32.050761	411	491	1	54	80	0.6750000
NODE_2377_length_1478_cov_32.050761	411	491	2	26	80	0.3250000
NODE_2377_length_1478_cov_32.050761	464	544	1	58	80	0.7250000
NODE_2377_length_1478_cov_32.050761	464	544	2	13	80	0.1625000
NODE_2377_length_1478_cov_32.050761	464	544	3	9	80	0.1125000
NODE_2377_length_1478_cov_32.050761	540	620	1	21	80	0.2625000
NODE_2377_length_1478_cov_32.050761	540	620	2	3	80	0.0375000
NODE_2377_length_1478_cov_32.050761	540	620	3	56	80	0.7000000
NODE_2377_length_1478_cov_32.050761	593	673	1	74	80	0.9250000
NODE_2377_length_1478_cov_32.050761	593	673	3	6	80	0.0750000
NODE_2378_length_1478_cov_27.414793	817	897	0	4	80	0.0500000
NODE_2378_length_1478_cov_27.414793	817	897	2	48	80	0.6000000
NODE_2378_length_1478_cov_27.414793	817	897	3	12	80	0.1500000
NODE_2378_length_1478_cov_27.414793	817	897	4	16	80	0.2000000
NODE_2378_length_1478_cov_27.414793	870	950	2	31	80	0.3875000
NODE_2378_length_1478_cov_27.414793	870	950	3	14	80	0.1750000
NODE_2378_length_1478_cov_27.414793	870	950	4	35	80	0.4375000
NODE_2379_length_1478_cov_23.472081	1212	1241	93	2	29	0.0689655
NODE_2379_length_1478_cov_23.472081	1212	1241	94	1	29	0.0344828
NODE_2379_length_1478_cov_23.472081	1212	1241	96	1	29	0.0344828
NODE_2379_length_1478_cov_23.472081	1212	1241	98	5	29	0.1724138
NODE_2379_length_1478_cov_23.472081	1212	1241	99	1	29	0.0344828
NODE_2379_length_1478_cov_23.472081	1212	1241	100	2	29	0.0689655
NODE_2379_length_1478_cov_23.472081	1212	1241	101	4	29	0.1379310
NODE_2379_length_1478_cov_23.472081	1212	1241	102	2	29	0.0689655
NODE_2379_length_1478_cov_23.472081	1212	1241	103	1	29	0.0344828
NODE_2379_length_1478_cov_23.472081	1212	1241	104	4	29	0.1379310
NODE_2379_length_1478_cov_23.472081	1212	1241	105	1	29	0.0344828
NODE_2379_length_1478_cov_23.472081	1212	1241	106	5	29	0.1724138
NODE_2380_length_1478_cov_10.746193	678	758	2	80	80	1.0000000
NODE_2380_length_1478_cov_10.746193	731	811	0	34	80	0.4250000
NODE_2380_length_1478_cov_10.746193	731	811	2	46	80	0.5750000
NODE_2380_length_1478_cov_10.746193	807	892	0	85	85	1.0000000
NODE_2380_length_1478_cov_10.746193	860	945	0	85	85	1.0000000
NODE_2384_length_1476_cov_6.522150	791	871	0	59	80	0.7375000
NODE_2384_length_1476_cov_6.522150	791	871	1	21	80	0.2625000
NODE_2384_length_1476_cov_6.522150	844	924	0	6	80	0.0750000
NODE_2384_length_1476_cov_6.522150	844	924	1	74	80	0.9250000
NODE_2392_length_1474_cov_11.209455	515	595	2	66	80	0.8250000
NODE_2392_length_1474_cov_11.209455	515	595	4	14	80	0.1750000
NODE_2392_length_1474_cov_11.209455	568	648	2	72	80	0.9000000
NODE_2392_length_1474_cov_11.209455	568	648	4	8	80	0.1000000
NODE_2397_length_1472_cov_22.159505	428	508	7	9	80	0.1125000
NODE_2397_length_1472_cov_22.159505	428	508	8	5	80	0.0625000
NODE_2397_length_1472_cov_22.159505	428	508	9	13	80	0.1625000
NODE_2397_length_1472_cov_22.159505	428	508	10	5	80	0.0625000
NODE_2397_length_1472_cov_22.159505	428	508	11	3	80	0.0375000
NODE_2397_length_1472_cov_22.159505	428	508	12	10	80	0.1250000
NODE_2397_length_1472_cov_22.159505	428	508	13	1	80	0.0125000
NODE_2397_length_1472_cov_22.159505	428	508	15	1	80	0.0125000
NODE_2397_length_1472_cov_22.159505	428	508	17	4	80	0.0500000
NODE_2397_length_1472_cov_22.159505	428	508	21	6	80	0.0750000
NODE_2397_length_1472_cov_22.159505	428	508	23	4	80	0.0500000
NODE_2397_length_1472_cov_22.159505	428	508	25	3	80	0.0375000
NODE_2397_length_1472_cov_22.159505	428	508	26	16	80	0.2000000
NODE_2397_length_1472_cov_22.159505	428	508	7	9	80	0.1125000
NODE_2397_length_1472_cov_22.159505	428	508	8	5	80	0.0625000
NODE_2397_length_1472_cov_22.159505	428	508	9	13	80	0.1625000
NODE_2397_length_1472_cov_22.159505	428	508	10	5	80	0.0625000
NODE_2397_length_1472_cov_22.159505	428	508	11	3	80	0.0375000
NODE_2397_length_1472_cov_22.159505	428	508	12	10	80	0.1250000
NODE_2397_length_1472_cov_22.159505	428	508	13	1	80	0.0125000
NODE_2397_length_1472_cov_22.159505	428	508	15	1	80	0.0125000
NODE_2397_length_1472_cov_22.159505	428	508	17	4	80	0.0500000
NODE_2397_length_1472_cov_22.159505	428	508	21	6	80	0.0750000
NODE_2397_length_1472_cov_22.159505	428	508	23	4	80	0.0500000
NODE_2397_length_1472_cov_22.159505	428	508	25	3	80	0.0375000
NODE_2397_length_1472_cov_22.159505	428	508	26	16	80	0.2000000
NODE_2397_length_1472_cov_22.159505	481	561	1	27	80	0.3375000
NODE_2397_length_1472_cov_22.159505	481	561	3	1	80	0.0125000
NODE_2397_length_1472_cov_22.159505	481	561	5	7	80	0.0875000
NODE_2397_length_1472_cov_22.159505	481	561	6	3	80	0.0375000
NODE_2397_length_1472_cov_22.159505	481	561	7	12	80	0.1500000
NODE_2397_length_1472_cov_22.159505	481	561	8	5	80	0.0625000
NODE_2397_length_1472_cov_22.159505	481	561	9	13	80	0.1625000
NODE_2397_length_1472_cov_22.159505	481	561	10	7	80	0.0875000
NODE_2397_length_1472_cov_22.159505	481	561	11	5	80	0.0625000
NODE_2397_length_1472_cov_22.159505	913	993	7	37	80	0.4625000
NODE_2397_length_1472_cov_22.159505	913	993	8	19	80	0.2375000
NODE_2397_length_1472_cov_22.159505	913	993	9	24	80	0.3000000
NODE_2397_length_1472_cov_22.159505	966	1046	6	16	80	0.2000000
NODE_2397_length_1472_cov_22.159505	966	1046	7	19	80	0.2375000
NODE_2397_length_1472_cov_22.159505	966	1046	8	5	80	0.0625000
NODE_2397_length_1472_cov_22.159505	966	1046	9	40	80	0.5000000
NODE_2397_length_1472_cov_22.159505	1042	1122	1	3	80	0.0375000
NODE_2397_length_1472_cov_22.159505	1042	1122	2	39	80	0.4875000
NODE_2397_length_1472_cov_22.159505	1042	1122	3	20	80	0.2500000
NODE_2397_length_1472_cov_22.159505	1042	1122	4	3	80	0.0375000
NODE_2397_length_1472_cov_22.159505	1042	1122	5	1	80	0.0125000
NODE_2397_length_1472_cov_22.159505	1042	1122	6	14	80	0.1750000
NODE_2397_length_1472_cov_22.159505	1095	1175	1	56	80	0.7000000
NODE_2397_length_1472_cov_22.159505	1095	1175	2	19	80	0.2375000
NODE_2397_length_1472_cov_22.159505	1095	1175	3	5	80	0.0625000
NODE_2398_length_1472_cov_22.018208	523	590	2	66	67	0.9850746
NODE_2398_length_1472_cov_22.018208	523	590	3	1	67	0.0149254
NODE_2398_length_1472_cov_22.018208	563	643	0	20	80	0.2500000
NODE_2398_length_1472_cov_22.018208	563	643	1	19	80	0.2375000
NODE_2398_length_1472_cov_22.018208	563	643	2	41	80	0.5125000
NODE_2398_length_1472_cov_22.018208	639	719	1	54	80	0.6750000
NODE_2398_length_1472_cov_22.018208	639	719	3	18	80	0.2250000
NODE_2398_length_1472_cov_22.018208	639	719	4	8	80	0.1000000
NODE_2398_length_1472_cov_22.018208	692	772	1	1	80	0.0125000
NODE_2398_length_1472_cov_22.018208	692	772	3	18	80	0.2250000
NODE_2398_length_1472_cov_22.018208	692	772	4	12	80	0.1500000
NODE_2398_length_1472_cov_22.018208	692	772	5	2	80	0.0250000
NODE_2398_length_1472_cov_22.018208	692	772	6	47	80	0.5875000
NODE_2404_length_1470_cov_7.042305	5	57	4	7	52	0.1346154
NODE_2404_length_1470_cov_7.042305	5	57	6	2	52	0.0384615
NODE_2404_length_1470_cov_7.042305	5	57	8	11	52	0.2115385
NODE_2404_length_1470_cov_7.042305	5	57	9	1	52	0.0192308
NODE_2404_length_1470_cov_7.042305	5	57	10	1	52	0.0192308
NODE_2404_length_1470_cov_7.042305	5	57	12	30	52	0.5769231
NODE_2405_length_1470_cov_2.185266	199	245	2	46	46	1.0000000
NODE_2407_length_1469_cov_5.683942	834	914	1	80	80	1.0000000
NODE_2407_length_1469_cov_5.683942	887	967	0	18	80	0.2250000
NODE_2407_length_1469_cov_5.683942	887	967	1	62	80	0.7750000
NODE_2410_length_1467_cov_31.231725	1048	1131	4	22	83	0.2650602
NODE_2410_length_1467_cov_31.231725	1048	1131	5	19	83	0.2289157
NODE_2410_length_1467_cov_31.231725	1048	1131	6	42	83	0.5060241
NODE_2411_length_1467_cov_19.731725	485	565	0	34	80	0.4250000
NODE_2411_length_1467_cov_19.731725	485	565	1	46	80	0.5750000
NODE_2411_length_1467_cov_19.731725	538	618	1	80	80	1.0000000
NODE_2412_length_1467_cov_11.807749	180	242	2	35	62	0.5645161
NODE_2412_length_1467_cov_11.807749	180	242	3	26	62	0.4193548
NODE_2412_length_1467_cov_11.807749	180	242	4	1	62	0.0161290
NODE_2412_length_1467_cov_11.807749	264	293	2	29	29	1.0000000
NODE_2412_length_1467_cov_11.807749	930	1010	0	80	80	1.0000000
NODE_2412_length_1467_cov_11.807749	983	1063	0	80	80	1.0000000
NODE_2414_length_1466_cov_41.326993	664	744	4	23	80	0.2875000
NODE_2414_length_1466_cov_41.326993	664	744	5	23	80	0.2875000
NODE_2414_length_1466_cov_41.326993	664	744	6	34	80	0.4250000
NODE_2414_length_1466_cov_41.326993	717	797	4	7	80	0.0875000
NODE_2414_length_1466_cov_41.326993	717	797	5	25	80	0.3125000
NODE_2414_length_1466_cov_41.326993	717	797	6	48	80	0.6000000
NODE_2414_length_1466_cov_41.326993	793	873	4	18	80	0.2250000
NODE_2414_length_1466_cov_41.326993	793	873	5	36	80	0.4500000
NODE_2414_length_1466_cov_41.326993	793	873	6	26	80	0.3250000
NODE_2414_length_1466_cov_41.326993	846	926	4	11	80	0.1375000
NODE_2414_length_1466_cov_41.326993	846	926	5	40	80	0.5000000
NODE_2414_length_1466_cov_41.326993	846	926	6	25	80	0.3125000
NODE_2414_length_1466_cov_41.326993	846	926	7	4	80	0.0500000
NODE_2420_length_1464_cov_6.726740	137	204	6	2	67	0.0298507
NODE_2420_length_1464_cov_6.726740	137	204	7	65	67	0.9701493
NODE_2422_length_1464_cov_2.198535	1301	1363	3	13	62	0.2096774
NODE_2422_length_1464_cov_2.198535	1301	1363	4	49	62	0.7903226
NODE_2425_length_1463_cov_15.345308	314	394	2	80	80	1.0000000
NODE_2425_length_1463_cov_15.345308	367	447	0	9	80	0.1125000
NODE_2425_length_1463_cov_15.345308	367	447	1	39	80	0.4875000
NODE_2425_length_1463_cov_15.345308	367	447	2	32	80	0.4000000
NODE_2427_length_1462_cov_18.082172	418	498	1	15	80	0.1875000
NODE_2427_length_1462_cov_18.082172	418	498	2	65	80	0.8125000
NODE_2427_length_1462_cov_18.082172	471	551	1	6	80	0.0750000
NODE_2427_length_1462_cov_18.082172	471	551	2	74	80	0.9250000
NODE_2427_length_1462_cov_18.082172	1036	1116	1	15	80	0.1875000
NODE_2427_length_1462_cov_18.082172	1036	1116	2	1	80	0.0125000
NODE_2427_length_1462_cov_18.082172	1036	1116	3	51	80	0.6375000
NODE_2427_length_1462_cov_18.082172	1036	1116	4	13	80	0.1625000
NODE_2427_length_1462_cov_18.082172	1089	1169	3	14	80	0.1750000
NODE_2427_length_1462_cov_18.082172	1089	1169	4	66	80	0.8250000
NODE_2428_length_1462_cov_1.792370	1247	1319	0	72	72	1.0000000
NODE_2428_length_1462_cov_1.792370	1305	1374	0	69	69	1.0000000
NODE_2433_length_1460_cov_23.927994	852	932	5	9	80	0.1125000
NODE_2433_length_1460_cov_23.927994	852	932	6	2	80	0.0250000
NODE_2433_length_1460_cov_23.927994	852	932	7	7	80	0.0875000
NODE_2433_length_1460_cov_23.927994	852	932	9	25	80	0.3125000
NODE_2433_length_1460_cov_23.927994	852	932	10	30	80	0.3750000
NODE_2433_length_1460_cov_23.927994	852	932	11	7	80	0.0875000
NODE_2433_length_1460_cov_23.927994	905	985	4	8	80	0.1000000
NODE_2433_length_1460_cov_23.927994	905	985	7	24	80	0.3000000
NODE_2433_length_1460_cov_23.927994	905	985	9	6	80	0.0750000
NODE_2433_length_1460_cov_23.927994	905	985	10	20	80	0.2500000
NODE_2433_length_1460_cov_23.927994	905	985	11	22	80	0.2750000
NODE_2436_length_1459_cov_43.600000	535	615	7	7	80	0.0875000
NODE_2436_length_1459_cov_43.600000	535	615	8	1	80	0.0125000
NODE_2436_length_1459_cov_43.600000	535	615	9	38	80	0.4750000
NODE_2436_length_1459_cov_43.600000	535	615	10	30	80	0.3750000
NODE_2436_length_1459_cov_43.600000	535	615	11	4	80	0.0500000
NODE_2436_length_1459_cov_43.600000	588	668	5	33	80	0.4125000
NODE_2436_length_1459_cov_43.600000	588	668	6	2	80	0.0250000
NODE_2436_length_1459_cov_43.600000	588	668	7	13	80	0.1625000
NODE_2436_length_1459_cov_43.600000	588	668	9	32	80	0.4000000
NODE_2436_length_1459_cov_43.600000	664	744	0	19	80	0.2375000
NODE_2436_length_1459_cov_43.600000	664	744	1	30	80	0.3750000
NODE_2436_length_1459_cov_43.600000	664	744	2	2	80	0.0250000
NODE_2436_length_1459_cov_43.600000	664	744	3	1	80	0.0125000
NODE_2436_length_1459_cov_43.600000	664	744	4	16	80	0.2000000
NODE_2436_length_1459_cov_43.600000	664	744	5	12	80	0.1500000
NODE_2436_length_1459_cov_43.600000	717	797	0	72	80	0.9000000
NODE_2436_length_1459_cov_43.600000	717	797	1	8	80	0.1000000
NODE_2437_length_1459_cov_32.276471	865	945	5	9	80	0.1125000
NODE_2437_length_1459_cov_32.276471	865	945	6	4	80	0.0500000
NODE_2437_length_1459_cov_32.276471	865	945	7	20	80	0.2500000
NODE_2437_length_1459_cov_32.276471	865	945	8	47	80	0.5875000
NODE_2437_length_1459_cov_32.276471	918	998	2	8	80	0.1000000
NODE_2437_length_1459_cov_32.276471	918	998	3	11	80	0.1375000
NODE_2437_length_1459_cov_32.276471	918	998	4	23	80	0.2875000
NODE_2437_length_1459_cov_32.276471	918	998	5	20	80	0.2500000
NODE_2437_length_1459_cov_32.276471	918	998	6	4	80	0.0500000
NODE_2437_length_1459_cov_32.276471	918	998	7	14	80	0.1750000
NODE_2437_length_1459_cov_32.276471	994	1074	1	27	80	0.3375000
NODE_2437_length_1459_cov_32.276471	994	1074	2	53	80	0.6625000
NODE_2437_length_1459_cov_32.276471	1047	1127	0	41	80	0.5125000
NODE_2437_length_1459_cov_32.276471	1047	1127	1	39	80	0.4875000
NODE_2441_length_1458_cov_2.184695	1361	1441	0	80	80	1.0000000
NODE_2442_length_1457_cov_19.687040	834	914	2	44	80	0.5500000
NODE_2442_length_1457_cov_19.687040	834	914	4	27	80	0.3375000
NODE_2442_length_1457_cov_19.687040	834	914	5	2	80	0.0250000
NODE_2442_length_1457_cov_19.687040	834	914	6	7	80	0.0875000
NODE_2442_length_1457_cov_19.687040	887	967	2	29	80	0.3625000
NODE_2442_length_1457_cov_19.687040	887	967	4	37	80	0.4625000
NODE_2442_length_1457_cov_19.687040	887	967	5	2	80	0.0250000
NODE_2442_length_1457_cov_19.687040	887	967	6	12	80	0.1500000
NODE_2442_length_1457_cov_19.687040	963	1043	2	80	80	1.0000000
NODE_2442_length_1457_cov_19.687040	1016	1096	0	30	80	0.3750000
NODE_2442_length_1457_cov_19.687040	1016	1096	1	2	80	0.0250000
NODE_2442_length_1457_cov_19.687040	1016	1096	2	48	80	0.6000000
NODE_2444_length_1457_cov_14.944772	754	834	1	75	80	0.9375000
NODE_2444_length_1457_cov_14.944772	754	834	2	5	80	0.0625000
NODE_2444_length_1457_cov_14.944772	807	887	1	80	80	1.0000000
NODE_2445_length_1457_cov_10.168630	827	907	0	80	80	1.0000000
NODE_2445_length_1457_cov_10.168630	880	960	0	58	80	0.7250000
NODE_2445_length_1457_cov_10.168630	880	960	2	22	80	0.2750000
NODE_2445_length_1457_cov_10.168630	956	1036	2	80	80	1.0000000
NODE_2445_length_1457_cov_10.168630	1009	1089	0	15	80	0.1875000
NODE_2445_length_1457_cov_10.168630	1009	1089	2	65	80	0.8125000
NODE_2448_length_1456_cov_13.675755	557	637	0	80	80	1.0000000
NODE_2448_length_1456_cov_13.675755	610	690	0	38	80	0.4750000
NODE_2448_length_1456_cov_13.675755	610	690	4	42	80	0.5250000
NODE_2449_length_1456_cov_11.109064	951	1031	2	80	80	1.0000000
NODE_2449_length_1456_cov_11.109064	1004	1084	0	27	80	0.3375000
NODE_2449_length_1456_cov_11.109064	1004	1084	2	53	80	0.6625000
NODE_2452_length_1456_cov_3.137067	374	410	0	2	36	0.0555556
NODE_2452_length_1456_cov_3.137067	374	410	1	5	36	0.1388889
NODE_2452_length_1456_cov_3.137067	374	410	2	3	36	0.0833333
NODE_2452_length_1456_cov_3.137067	374	410	5	21	36	0.5833333
NODE_2452_length_1456_cov_3.137067	374	410	6	5	36	0.1388889
NODE_2454_length_1456_cov_1.889462	35	99	0	64	64	1.0000000
NODE_2456_length_1455_cov_60.874631	369	449	1	80	80	1.0000000
NODE_2456_length_1455_cov_60.874631	422	502	1	58	80	0.7250000
NODE_2456_length_1455_cov_60.874631	422	502	2	8	80	0.1000000
NODE_2456_length_1455_cov_60.874631	422	502	3	14	80	0.1750000
NODE_2456_length_1455_cov_60.874631	498	578	3	5	80	0.0625000
NODE_2456_length_1455_cov_60.874631	498	578	5	34	80	0.4250000
NODE_2456_length_1455_cov_60.874631	498	578	7	41	80	0.5125000
NODE_2456_length_1455_cov_60.874631	551	631	4	15	80	0.1875000
NODE_2456_length_1455_cov_60.874631	551	631	5	2	80	0.0250000
NODE_2456_length_1455_cov_60.874631	551	631	7	63	80	0.7875000
NODE_2458_length_1455_cov_35.253687	615	695	1	13	80	0.1625000
NODE_2458_length_1455_cov_35.253687	615	695	5	31	80	0.3875000
NODE_2458_length_1455_cov_35.253687	615	695	6	21	80	0.2625000
NODE_2458_length_1455_cov_35.253687	615	695	8	15	80	0.1875000
NODE_2458_length_1455_cov_35.253687	668	748	3	1	80	0.0125000
NODE_2458_length_1455_cov_35.253687	668	748	4	4	80	0.0500000
NODE_2458_length_1455_cov_35.253687	668	748	5	18	80	0.2250000
NODE_2458_length_1455_cov_35.253687	668	748	6	29	80	0.3625000
NODE_2458_length_1455_cov_35.253687	668	748	7	5	80	0.0625000
NODE_2458_length_1455_cov_35.253687	668	748	8	23	80	0.2875000
NODE_2458_length_1455_cov_35.253687	744	824	3	32	80	0.4000000
NODE_2458_length_1455_cov_35.253687	744	824	4	15	80	0.1875000
NODE_2458_length_1455_cov_35.253687	744	824	5	18	80	0.2250000
NODE_2458_length_1455_cov_35.253687	744	824	6	15	80	0.1875000
NODE_2458_length_1455_cov_35.253687	797	877	4	13	80	0.1625000
NODE_2458_length_1455_cov_35.253687	797	877	5	47	80	0.5875000
NODE_2458_length_1455_cov_35.253687	797	877	6	20	80	0.2500000
NODE_2465_length_1452_cov_7.101256	976	1056	2	80	80	1.0000000
NODE_2465_length_1452_cov_7.101256	1029	1109	0	24	80	0.3000000
NODE_2465_length_1452_cov_7.101256	1029	1109	1	3	80	0.0375000
NODE_2465_length_1452_cov_7.101256	1029	1109	2	53	80	0.6625000
NODE_2465_length_1452_cov_7.101256	1105	1185	0	80	80	1.0000000
NODE_2465_length_1452_cov_7.101256	1158	1238	0	80	80	1.0000000
NODE_2470_length_1451_cov_23.880178	439	520	0	1	81	0.0123457
NODE_2470_length_1451_cov_23.880178	439	520	2	80	81	0.9876543
NODE_2470_length_1451_cov_23.880178	493	573	2	80	80	1.0000000
NODE_2471_length_1451_cov_16.249260	422	502	8	3	80	0.0375000
NODE_2471_length_1451_cov_16.249260	422	502	9	9	80	0.1125000
NODE_2471_length_1451_cov_16.249260	422	502	10	37	80	0.4625000
NODE_2471_length_1451_cov_16.249260	422	502	11	12	80	0.1500000
NODE_2471_length_1451_cov_16.249260	422	502	12	19	80	0.2375000
NODE_2471_length_1451_cov_16.249260	475	555	9	1	80	0.0125000
NODE_2471_length_1451_cov_16.249260	475	555	10	62	80	0.7750000
NODE_2471_length_1451_cov_16.249260	475	555	11	9	80	0.1125000
NODE_2471_length_1451_cov_16.249260	475	555	12	8	80	0.1000000
NODE_2472_length_1451_cov_8.663462	908	988	0	11	80	0.1375000
NODE_2472_length_1451_cov_8.663462	908	988	2	69	80	0.8625000
NODE_2472_length_1451_cov_8.663462	961	1040	0	4	79	0.0506329
NODE_2472_length_1451_cov_8.663462	961	1040	2	75	79	0.9493671
NODE_2474_length_1451_cov_5.219675	897	977	0	4	80	0.0500000
NODE_2474_length_1451_cov_5.219675	897	977	2	76	80	0.9500000
NODE_2474_length_1451_cov_5.219675	950	1030	2	80	80	1.0000000
NODE_2477_length_1450_cov_20.371577	611	691	2	25	80	0.3125000
NODE_2477_length_1450_cov_20.371577	611	691	5	12	80	0.1500000
NODE_2477_length_1450_cov_20.371577	611	691	6	27	80	0.3375000
NODE_2477_length_1450_cov_20.371577	611	691	7	16	80	0.2000000
NODE_2477_length_1450_cov_20.371577	664	744	5	2	80	0.0250000
NODE_2477_length_1450_cov_20.371577	664	744	6	9	80	0.1125000
NODE_2477_length_1450_cov_20.371577	664	744	7	69	80	0.8625000
NODE_2482_length_1449_cov_24.665926	432	512	0	80	80	1.0000000
NODE_2482_length_1449_cov_24.665926	485	565	0	80	80	1.0000000
NODE_2482_length_1449_cov_24.665926	561	643	0	82	82	1.0000000
NODE_2482_length_1449_cov_24.665926	616	696	0	80	80	1.0000000
NODE_2485_length_1448_cov_20.587102	904	984	2	18	80	0.2250000
NODE_2485_length_1448_cov_20.587102	904	984	3	1	80	0.0125000
NODE_2485_length_1448_cov_20.587102	904	984	4	25	80	0.3125000
NODE_2485_length_1448_cov_20.587102	904	984	5	36	80	0.4500000
NODE_2485_length_1448_cov_20.587102	957	1037	3	27	80	0.3375000
NODE_2485_length_1448_cov_20.587102	957	1037	4	11	80	0.1375000
NODE_2485_length_1448_cov_20.587102	957	1037	5	42	80	0.5250000
NODE_2487_length_1448_cov_8.693847	537	617	5	66	80	0.8250000
NODE_2487_length_1448_cov_8.693847	537	617	6	14	80	0.1750000
NODE_2487_length_1448_cov_8.693847	590	670	2	11	80	0.1375000
NODE_2487_length_1448_cov_8.693847	590	670	3	5	80	0.0625000
NODE_2487_length_1448_cov_8.693847	590	670	4	22	80	0.2750000
NODE_2487_length_1448_cov_8.693847	590	670	5	28	80	0.3500000
NODE_2487_length_1448_cov_8.693847	590	670	6	14	80	0.1750000
NODE_2488_length_1447_cov_21.391691	519	599	0	80	80	1.0000000
NODE_2488_length_1447_cov_21.391691	572	652	0	80	80	1.0000000
NODE_2488_length_1447_cov_21.391691	648	728	0	56	80	0.7000000
NODE_2488_length_1447_cov_21.391691	648	728	1	11	80	0.1375000
NODE_2488_length_1447_cov_21.391691	648	728	2	13	80	0.1625000
NODE_2488_length_1447_cov_21.391691	701	781	0	3	80	0.0375000
NODE_2488_length_1447_cov_21.391691	701	781	1	11	80	0.1375000
NODE_2488_length_1447_cov_21.391691	701	781	2	66	80	0.8250000
NODE_2491_length_1447_cov_2.262611	1268	1325	7	4	57	0.0701754
NODE_2491_length_1447_cov_2.262611	1268	1325	9	3	57	0.0526316
NODE_2491_length_1447_cov_2.262611	1268	1325	11	2	57	0.0350877
NODE_2491_length_1447_cov_2.262611	1268	1325	13	1	57	0.0175439
NODE_2491_length_1447_cov_2.262611	1268	1325	14	8	57	0.1403509
NODE_2491_length_1447_cov_2.262611	1268	1325	18	1	57	0.0175439
NODE_2491_length_1447_cov_2.262611	1268	1325	20	2	57	0.0350877
NODE_2491_length_1447_cov_2.262611	1268	1325	22	11	57	0.1929825
NODE_2491_length_1447_cov_2.262611	1268	1325	24	8	57	0.1403509
NODE_2491_length_1447_cov_2.262611	1268	1325	26	1	57	0.0175439
NODE_2491_length_1447_cov_2.262611	1268	1325	27	1	57	0.0175439
NODE_2491_length_1447_cov_2.262611	1268	1325	29	3	57	0.0526316
NODE_2491_length_1447_cov_2.262611	1268	1325	31	3	57	0.0526316
NODE_2491_length_1447_cov_2.262611	1268	1325	33	9	57	0.1578947
NODE_2491_length_1447_cov_2.262611	1321	1378	33	4	57	0.0701754
NODE_2491_length_1447_cov_2.262611	1321	1378	34	8	57	0.1403509
NODE_2491_length_1447_cov_2.262611	1321	1378	35	6	57	0.1052632
NODE_2491_length_1447_cov_2.262611	1321	1378	36	4	57	0.0701754
NODE_2491_length_1447_cov_2.262611	1321	1378	37	11	57	0.1929825
NODE_2491_length_1447_cov_2.262611	1321	1378	38	24	57	0.4210526
NODE_2494_length_1445_cov_22.052006	759	839	9	12	80	0.1500000
NODE_2494_length_1445_cov_22.052006	759	839	10	10	80	0.1250000
NODE_2494_length_1445_cov_22.052006	759	839	11	6	80	0.0750000
NODE_2494_length_1445_cov_22.052006	759	839	12	18	80	0.2250000
NODE_2494_length_1445_cov_22.052006	759	839	13	14	80	0.1750000
NODE_2494_length_1445_cov_22.052006	759	839	14	20	80	0.2500000
NODE_2494_length_1445_cov_22.052006	812	892	0	33	80	0.4125000
NODE_2494_length_1445_cov_22.052006	812	892	6	2	80	0.0250000
NODE_2494_length_1445_cov_22.052006	812	892	7	17	80	0.2125000
NODE_2494_length_1445_cov_22.052006	812	892	9	13	80	0.1625000
NODE_2494_length_1445_cov_22.052006	812	892	10	8	80	0.1000000
NODE_2494_length_1445_cov_22.052006	812	892	11	6	80	0.0750000
NODE_2494_length_1445_cov_22.052006	812	892	12	1	80	0.0125000
NODE_2494_length_1445_cov_22.052006	888	968	0	80	80	1.0000000
NODE_2494_length_1445_cov_22.052006	941	1021	0	80	80	1.0000000
NODE_2495_length_1445_cov_13.378900	584	664	3	23	80	0.2875000
NODE_2495_length_1445_cov_13.378900	584	664	4	57	80	0.7125000
NODE_2495_length_1445_cov_13.378900	637	717	2	20	80	0.2500000
NODE_2495_length_1445_cov_13.378900	637	717	3	56	80	0.7000000
NODE_2495_length_1445_cov_13.378900	637	717	4	4	80	0.0500000
NODE_2501_length_1443_cov_7.628720	480	560	0	80	80	1.0000000
NODE_2501_length_1443_cov_7.628720	533	613	0	57	80	0.7125000
NODE_2501_length_1443_cov_7.628720	533	613	2	23	80	0.2875000
NODE_2501_length_1443_cov_7.628720	609	689	2	80	80	1.0000000
NODE_2501_length_1443_cov_7.628720	662	742	0	25	80	0.3125000
NODE_2501_length_1443_cov_7.628720	662	742	2	55	80	0.6875000
NODE_2502_length_1443_cov_4.843006	924	1004	0	80	80	1.0000000
NODE_2502_length_1443_cov_4.843006	977	1057	0	80	80	1.0000000
NODE_2508_length_1442_cov_24.551750	427	507	1	5	80	0.0625000
NODE_2508_length_1442_cov_24.551750	427	507	2	15	80	0.1875000
NODE_2508_length_1442_cov_24.551750	427	507	3	21	80	0.2625000
NODE_2508_length_1442_cov_24.551750	427	507	4	32	80	0.4000000
NODE_2508_length_1442_cov_24.551750	427	507	5	1	80	0.0125000
NODE_2508_length_1442_cov_24.551750	427	507	7	6	80	0.0750000
NODE_2508_length_1442_cov_24.551750	480	560	4	20	80	0.2500000
NODE_2508_length_1442_cov_24.551750	480	560	5	1	80	0.0125000
NODE_2508_length_1442_cov_24.551750	480	560	6	12	80	0.1500000
NODE_2508_length_1442_cov_24.551750	480	560	7	47	80	0.5875000
NODE_2508_length_1442_cov_24.551750	556	636	5	19	80	0.2375000
NODE_2508_length_1442_cov_24.551750	556	636	6	18	80	0.2250000
NODE_2508_length_1442_cov_24.551750	556	636	7	19	80	0.2375000
NODE_2508_length_1442_cov_24.551750	556	636	8	23	80	0.2875000
NODE_2508_length_1442_cov_24.551750	556	636	9	1	80	0.0125000
NODE_2508_length_1442_cov_24.551750	609	689	5	2	80	0.0250000
NODE_2508_length_1442_cov_24.551750	609	689	6	1	80	0.0125000
NODE_2508_length_1442_cov_24.551750	609	689	8	33	80	0.4125000
NODE_2508_length_1442_cov_24.551750	609	689	9	1	80	0.0125000
NODE_2508_length_1442_cov_24.551750	609	689	10	39	80	0.4875000
NODE_2508_length_1442_cov_24.551750	609	689	11	4	80	0.0500000
NODE_2509_length_1442_cov_24.032762	424	504	0	14	80	0.1750000
NODE_2509_length_1442_cov_24.032762	424	504	2	29	80	0.3625000
NODE_2509_length_1442_cov_24.032762	424	504	3	1	80	0.0125000
NODE_2509_length_1442_cov_24.032762	424	504	4	36	80	0.4500000
NODE_2509_length_1442_cov_24.032762	477	557	4	80	80	1.0000000
NODE_2511_length_1441_cov_16.528316	963	1043	5	3	80	0.0375000
NODE_2511_length_1441_cov_16.528316	963	1043	6	47	80	0.5875000
NODE_2511_length_1441_cov_16.528316	963	1043	8	27	80	0.3375000
NODE_2511_length_1441_cov_16.528316	963	1043	9	3	80	0.0375000
NODE_2511_length_1441_cov_16.528316	1016	1096	4	5	80	0.0625000
NODE_2511_length_1441_cov_16.528316	1016	1096	5	1	80	0.0125000
NODE_2511_length_1441_cov_16.528316	1016	1096	6	74	80	0.9250000
NODE_2512_length_1441_cov_3.781669	80	156	2	34	76	0.4473684
NODE_2512_length_1441_cov_3.781669	80	156	3	33	76	0.4342105
NODE_2512_length_1441_cov_3.781669	80	156	4	6	76	0.0789474
NODE_2512_length_1441_cov_3.781669	80	156	5	3	76	0.0394737
NODE_2512_length_1441_cov_3.781669	129	209	3	21	80	0.2625000
NODE_2512_length_1441_cov_3.781669	129	209	4	56	80	0.7000000
NODE_2512_length_1441_cov_3.781669	129	209	5	3	80	0.0375000
NODE_2515_length_1440_cov_34.523490	446	526	0	1	80	0.0125000
NODE_2515_length_1440_cov_34.523490	446	526	2	1	80	0.0125000
NODE_2515_length_1440_cov_34.523490	446	526	3	55	80	0.6875000
NODE_2515_length_1440_cov_34.523490	446	526	5	23	80	0.2875000
NODE_2515_length_1440_cov_34.523490	499	576	3	4	77	0.0519481
NODE_2515_length_1440_cov_34.523490	499	576	5	73	77	0.9480519
NODE_2515_length_1440_cov_34.523490	576	654	2	54	78	0.6923077
NODE_2515_length_1440_cov_34.523490	576	654	4	3	78	0.0384615
NODE_2515_length_1440_cov_34.523490	576	654	5	20	78	0.2564103
NODE_2515_length_1440_cov_34.523490	576	654	6	1	78	0.0128205
NODE_2515_length_1440_cov_34.523490	627	707	2	80	80	1.0000000
NODE_2516_length_1440_cov_20.372110	776	856	0	7	80	0.0875000
NODE_2516_length_1440_cov_20.372110	776	856	1	10	80	0.1250000
NODE_2516_length_1440_cov_20.372110	776	856	2	46	80	0.5750000
NODE_2516_length_1440_cov_20.372110	776	856	3	17	80	0.2125000
NODE_2516_length_1440_cov_20.372110	829	909	2	10	80	0.1250000
NODE_2516_length_1440_cov_20.372110	829	909	3	53	80	0.6625000
NODE_2516_length_1440_cov_20.372110	829	909	4	17	80	0.2125000
NODE_2516_length_1440_cov_20.372110	905	985	3	22	80	0.2750000
NODE_2516_length_1440_cov_20.372110	905	985	4	37	80	0.4625000
NODE_2516_length_1440_cov_20.372110	905	985	5	21	80	0.2625000
NODE_2516_length_1440_cov_20.372110	958	1038	3	56	80	0.7000000
NODE_2516_length_1440_cov_20.372110	958	1038	4	24	80	0.3000000
NODE_2517_length_1440_cov_14.476510	586	615	10	10	29	0.3448276
NODE_2517_length_1440_cov_14.476510	586	615	11	19	29	0.6551724
NODE_2517_length_1440_cov_14.476510	666	695	5	3	29	0.1034483
NODE_2517_length_1440_cov_14.476510	666	695	6	2	29	0.0689655
NODE_2517_length_1440_cov_14.476510	666	695	8	17	29	0.5862069
NODE_2517_length_1440_cov_14.476510	666	695	9	7	29	0.2413793
NODE_2517_length_1440_cov_14.476510	1295	1359	47	3	64	0.0468750
NODE_2517_length_1440_cov_14.476510	1295	1359	49	3	64	0.0468750
NODE_2517_length_1440_cov_14.476510	1295	1359	51	4	64	0.0625000
NODE_2517_length_1440_cov_14.476510	1295	1359	52	5	64	0.0781250
NODE_2517_length_1440_cov_14.476510	1295	1359	54	14	64	0.2187500
NODE_2517_length_1440_cov_14.476510	1295	1359	56	1	64	0.0156250
NODE_2517_length_1440_cov_14.476510	1295	1359	62	1	64	0.0156250
NODE_2517_length_1440_cov_14.476510	1295	1359	63	5	64	0.0781250
NODE_2517_length_1440_cov_14.476510	1295	1359	64	17	64	0.2656250
NODE_2517_length_1440_cov_14.476510	1295	1359	65	11	64	0.1718750
NODE_2518_length_1440_cov_9.049217	384	464	0	80	80	1.0000000
NODE_2518_length_1440_cov_9.049217	437	517	0	80	80	1.0000000
NODE_2520_length_1439_cov_11.784328	898	978	2	80	80	1.0000000
NODE_2520_length_1439_cov_11.784328	951	1031	0	51	80	0.6375000
NODE_2520_length_1439_cov_11.784328	951	1031	2	29	80	0.3625000
NODE_2525_length_1438_cov_41.481703	671	751	1	4	80	0.0500000
NODE_2525_length_1438_cov_41.481703	671	751	3	7	80	0.0875000
NODE_2525_length_1438_cov_41.481703	671	751	4	69	80	0.8625000
NODE_2525_length_1438_cov_41.481703	724	804	2	4	80	0.0500000
NODE_2525_length_1438_cov_41.481703	724	804	4	76	80	0.9500000
NODE_2529_length_1437_cov_14.449178	815	895	0	27	80	0.3375000
NODE_2529_length_1437_cov_14.449178	815	895	1	53	80	0.6625000
NODE_2529_length_1437_cov_14.449178	868	948	0	80	80	1.0000000
NODE_2529_length_1437_cov_14.449178	944	1024	0	80	80	1.0000000
NODE_2529_length_1437_cov_14.449178	997	1077	0	80	80	1.0000000
NODE_2532_length_1436_cov_96.256545	1145	1225	26	2	80	0.0250000
NODE_2532_length_1436_cov_96.256545	1145	1225	27	2	80	0.0250000
NODE_2532_length_1436_cov_96.256545	1145	1225	28	4	80	0.0500000
NODE_2532_length_1436_cov_96.256545	1145	1225	30	7	80	0.0875000
NODE_2532_length_1436_cov_96.256545	1145	1225	33	7	80	0.0875000
NODE_2532_length_1436_cov_96.256545	1145	1225	35	13	80	0.1625000
NODE_2532_length_1436_cov_96.256545	1145	1225	36	6	80	0.0750000
NODE_2532_length_1436_cov_96.256545	1145	1225	37	6	80	0.0750000
NODE_2532_length_1436_cov_96.256545	1145	1225	38	2	80	0.0250000
NODE_2532_length_1436_cov_96.256545	1145	1225	39	11	80	0.1375000
NODE_2532_length_1436_cov_96.256545	1145	1225	40	8	80	0.1000000
NODE_2532_length_1436_cov_96.256545	1145	1225	41	9	80	0.1125000
NODE_2532_length_1436_cov_96.256545	1145	1225	43	2	80	0.0250000
NODE_2532_length_1436_cov_96.256545	1145	1225	46	1	80	0.0125000
NODE_2532_length_1436_cov_96.256545	1198	1278	39	11	80	0.1375000
NODE_2532_length_1436_cov_96.256545	1198	1278	40	4	80	0.0500000
NODE_2532_length_1436_cov_96.256545	1198	1278	41	9	80	0.1125000
NODE_2532_length_1436_cov_96.256545	1198	1278	43	4	80	0.0500000
NODE_2532_length_1436_cov_96.256545	1198	1278	44	5	80	0.0625000
NODE_2532_length_1436_cov_96.256545	1198	1278	46	1	80	0.0125000
NODE_2532_length_1436_cov_96.256545	1198	1278	47	8	80	0.1000000
NODE_2532_length_1436_cov_96.256545	1198	1278	48	6	80	0.0750000
NODE_2532_length_1436_cov_96.256545	1198	1278	49	3	80	0.0375000
NODE_2532_length_1436_cov_96.256545	1198	1278	50	9	80	0.1125000
NODE_2532_length_1436_cov_96.256545	1198	1278	51	3	80	0.0375000
NODE_2532_length_1436_cov_96.256545	1198	1278	52	4	80	0.0500000
NODE_2532_length_1436_cov_96.256545	1198	1278	53	8	80	0.1000000
NODE_2532_length_1436_cov_96.256545	1198	1278	54	5	80	0.0625000
NODE_2532_length_1436_cov_96.256545	1274	1354	31	2	80	0.0250000
NODE_2532_length_1436_cov_96.256545	1274	1354	33	3	80	0.0375000
NODE_2532_length_1436_cov_96.256545	1274	1354	34	7	80	0.0875000
NODE_2532_length_1436_cov_96.256545	1274	1354	35	6	80	0.0750000
NODE_2532_length_1436_cov_96.256545	1274	1354	36	2	80	0.0250000
NODE_2532_length_1436_cov_96.256545	1274	1354	37	9	80	0.1125000
NODE_2532_length_1436_cov_96.256545	1274	1354	38	9	80	0.1125000
NODE_2532_length_1436_cov_96.256545	1274	1354	39	10	80	0.1250000
NODE_2532_length_1436_cov_96.256545	1274	1354	40	3	80	0.0375000
NODE_2532_length_1436_cov_96.256545	1274	1354	41	1	80	0.0125000
NODE_2532_length_1436_cov_96.256545	1274	1354	42	3	80	0.0375000
NODE_2532_length_1436_cov_96.256545	1274	1354	43	4	80	0.0500000
NODE_2532_length_1436_cov_96.256545	1274	1354	44	8	80	0.1000000
NODE_2532_length_1436_cov_96.256545	1274	1354	45	2	80	0.0250000
NODE_2532_length_1436_cov_96.256545	1274	1354	46	3	80	0.0375000
NODE_2532_length_1436_cov_96.256545	1274	1354	47	1	80	0.0125000
NODE_2532_length_1436_cov_96.256545	1274	1354	48	3	80	0.0375000
NODE_2532_length_1436_cov_96.256545	1274	1354	49	4	80	0.0500000
NODE_2532_length_1436_cov_96.256545	1327	1407	8	3	80	0.0375000
NODE_2532_length_1436_cov_96.256545	1327	1407	10	3	80	0.0375000
NODE_2532_length_1436_cov_96.256545	1327	1407	11	7	80	0.0875000
NODE_2532_length_1436_cov_96.256545	1327	1407	12	1	80	0.0125000
NODE_2532_length_1436_cov_96.256545	1327	1407	15	1	80	0.0125000
NODE_2532_length_1436_cov_96.256545	1327	1407	16	2	80	0.0250000
NODE_2532_length_1436_cov_96.256545	1327	1407	17	8	80	0.1000000
NODE_2532_length_1436_cov_96.256545	1327	1407	18	5	80	0.0625000
NODE_2532_length_1436_cov_96.256545	1327	1407	19	3	80	0.0375000
NODE_2532_length_1436_cov_96.256545	1327	1407	24	2	80	0.0250000
NODE_2532_length_1436_cov_96.256545	1327	1407	26	1	80	0.0125000
NODE_2532_length_1436_cov_96.256545	1327	1407	28	3	80	0.0375000
NODE_2532_length_1436_cov_96.256545	1327	1407	29	2	80	0.0250000
NODE_2532_length_1436_cov_96.256545	1327	1407	31	14	80	0.1750000
NODE_2532_length_1436_cov_96.256545	1327	1407	33	3	80	0.0375000
NODE_2532_length_1436_cov_96.256545	1327	1407	34	7	80	0.0875000
NODE_2532_length_1436_cov_96.256545	1327	1407	35	6	80	0.0750000
NODE_2532_length_1436_cov_96.256545	1327	1407	36	2	80	0.0250000
NODE_2532_length_1436_cov_96.256545	1327	1407	37	7	80	0.0875000
NODE_2536_length_1435_cov_21.468563	783	863	3	36	80	0.4500000
NODE_2536_length_1435_cov_21.468563	783	863	4	30	80	0.3750000
NODE_2536_length_1435_cov_21.468563	783	863	5	14	80	0.1750000
NODE_2536_length_1435_cov_21.468563	836	916	3	3	80	0.0375000
NODE_2536_length_1435_cov_21.468563	836	916	4	10	80	0.1250000
NODE_2536_length_1435_cov_21.468563	836	916	5	20	80	0.2500000
NODE_2536_length_1435_cov_21.468563	836	916	6	15	80	0.1875000
NODE_2536_length_1435_cov_21.468563	836	916	7	3	80	0.0375000
NODE_2536_length_1435_cov_21.468563	836	916	8	16	80	0.2000000
NODE_2536_length_1435_cov_21.468563	836	916	11	13	80	0.1625000
NODE_2536_length_1435_cov_21.468563	912	992	7	16	80	0.2000000
NODE_2536_length_1435_cov_21.468563	912	992	8	2	80	0.0250000
NODE_2536_length_1435_cov_21.468563	912	992	9	8	80	0.1000000
NODE_2536_length_1435_cov_21.468563	912	992	10	16	80	0.2000000
NODE_2536_length_1435_cov_21.468563	912	992	11	38	80	0.4750000
NODE_2536_length_1435_cov_21.468563	965	1045	1	26	80	0.3250000
NODE_2536_length_1435_cov_21.468563	965	1045	2	3	80	0.0375000
NODE_2536_length_1435_cov_21.468563	965	1045	5	1	80	0.0125000
NODE_2536_length_1435_cov_21.468563	965	1045	6	2	80	0.0250000
NODE_2536_length_1435_cov_21.468563	965	1045	7	37	80	0.4625000
NODE_2536_length_1435_cov_21.468563	965	1045	8	2	80	0.0250000
NODE_2536_length_1435_cov_21.468563	965	1045	9	8	80	0.1000000
NODE_2536_length_1435_cov_21.468563	965	1045	10	1	80	0.0125000
NODE_2537_length_1435_cov_18.593563	1123	1203	9	5	80	0.0625000
NODE_2537_length_1435_cov_18.593563	1123	1203	10	8	80	0.1000000
NODE_2537_length_1435_cov_18.593563	1123	1203	11	26	80	0.3250000
NODE_2537_length_1435_cov_18.593563	1123	1203	12	14	80	0.1750000
NODE_2537_length_1435_cov_18.593563	1123	1203	17	9	80	0.1125000
NODE_2537_length_1435_cov_18.593563	1123	1203	19	5	80	0.0625000
NODE_2537_length_1435_cov_18.593563	1123	1203	20	4	80	0.0500000
NODE_2537_length_1435_cov_18.593563	1123	1203	22	1	80	0.0125000
NODE_2537_length_1435_cov_18.593563	1123	1203	23	8	80	0.1000000
NODE_2537_length_1435_cov_18.593563	1176	1256	4	18	80	0.2250000
NODE_2537_length_1435_cov_18.593563	1176	1256	5	17	80	0.2125000
NODE_2537_length_1435_cov_18.593563	1176	1256	7	7	80	0.0875000
NODE_2537_length_1435_cov_18.593563	1176	1256	9	16	80	0.2000000
NODE_2537_length_1435_cov_18.593563	1176	1256	10	4	80	0.0500000
NODE_2537_length_1435_cov_18.593563	1176	1256	11	7	80	0.0875000
NODE_2537_length_1435_cov_18.593563	1176	1256	12	11	80	0.1375000
NODE_2538_length_1435_cov_5.828593	299	379	0	80	80	1.0000000
NODE_2538_length_1435_cov_5.828593	352	432	0	80	80	1.0000000
NODE_2540_length_1434_cov_17.610487	1023	1103	3	7	80	0.0875000
NODE_2540_length_1434_cov_17.610487	1023	1103	4	73	80	0.9125000
NODE_2540_length_1434_cov_17.610487	1076	1156	2	19	80	0.2375000
NODE_2540_length_1434_cov_17.610487	1076	1156	4	61	80	0.7625000
NODE_2540_length_1434_cov_17.610487	1152	1232	0	52	80	0.6500000
NODE_2540_length_1434_cov_17.610487	1152	1232	1	22	80	0.2750000
NODE_2540_length_1434_cov_17.610487	1152	1232	2	6	80	0.0750000
NODE_2540_length_1434_cov_17.610487	1205	1285	0	80	80	1.0000000
NODE_2541_length_1434_cov_9.845693	846	926	4	5	80	0.0625000
NODE_2541_length_1434_cov_9.845693	846	926	5	60	80	0.7500000
NODE_2541_length_1434_cov_9.845693	846	926	6	15	80	0.1875000
NODE_2541_length_1434_cov_9.845693	899	978	4	34	79	0.4303797
NODE_2541_length_1434_cov_9.845693	899	978	5	12	79	0.1518987
NODE_2541_length_1434_cov_9.845693	899	978	6	16	79	0.2025317
NODE_2541_length_1434_cov_9.845693	899	978	7	17	79	0.2151899
NODE_2544_length_1433_cov_36.452774	538	618	4	2	80	0.0250000
NODE_2544_length_1433_cov_36.452774	538	618	5	65	80	0.8125000
NODE_2544_length_1433_cov_36.452774	538	618	6	4	80	0.0500000
NODE_2544_length_1433_cov_36.452774	538	618	7	9	80	0.1125000
NODE_2544_length_1433_cov_36.452774	591	671	5	45	80	0.5625000
NODE_2544_length_1433_cov_36.452774	591	671	6	13	80	0.1625000
NODE_2544_length_1433_cov_36.452774	591	671	7	22	80	0.2750000
NODE_2544_length_1433_cov_36.452774	667	747	4	13	80	0.1625000
NODE_2544_length_1433_cov_36.452774	667	747	5	8	80	0.1000000
NODE_2544_length_1433_cov_36.452774	667	747	6	26	80	0.3250000
NODE_2544_length_1433_cov_36.452774	667	747	7	12	80	0.1500000
NODE_2544_length_1433_cov_36.452774	667	747	8	21	80	0.2625000
NODE_2544_length_1433_cov_36.452774	720	800	5	8	80	0.1000000
NODE_2544_length_1433_cov_36.452774	720	800	6	33	80	0.4125000
NODE_2544_length_1433_cov_36.452774	720	800	7	22	80	0.2750000
NODE_2544_length_1433_cov_36.452774	720	800	8	17	80	0.2125000
NODE_2550_length_1431_cov_7.409159	513	593	0	80	80	1.0000000
NODE_2550_length_1431_cov_7.409159	566	646	0	80	80	1.0000000
NODE_2551_length_1431_cov_6.721471	1074	1154	0	80	80	1.0000000
NODE_2551_length_1431_cov_6.721471	1127	1207	0	80	80	1.0000000
NODE_2552_length_1430_cov_32.643877	753	833	3	20	80	0.2500000
NODE_2552_length_1430_cov_32.643877	753	833	6	5	80	0.0625000
NODE_2552_length_1430_cov_32.643877	753	833	8	42	80	0.5250000
NODE_2552_length_1430_cov_32.643877	753	833	9	13	80	0.1625000
NODE_2552_length_1430_cov_32.643877	806	886	7	2	80	0.0250000
NODE_2552_length_1430_cov_32.643877	806	886	8	51	80	0.6375000
NODE_2552_length_1430_cov_32.643877	806	886	9	27	80	0.3375000
NODE_2552_length_1430_cov_32.643877	882	962	4	8	80	0.1000000
NODE_2552_length_1430_cov_32.643877	882	962	5	15	80	0.1875000
NODE_2552_length_1430_cov_32.643877	882	962	6	7	80	0.0875000
NODE_2552_length_1430_cov_32.643877	882	962	7	29	80	0.3625000
NODE_2552_length_1430_cov_32.643877	882	962	8	19	80	0.2375000
NODE_2552_length_1430_cov_32.643877	882	962	9	2	80	0.0250000
NODE_2552_length_1430_cov_32.643877	935	1016	5	4	81	0.0493827
NODE_2552_length_1430_cov_32.643877	935	1016	6	3	81	0.0370370
NODE_2552_length_1430_cov_32.643877	935	1016	7	8	81	0.0987654
NODE_2552_length_1430_cov_32.643877	935	1016	8	66	81	0.8148148
NODE_2557_length_1428_cov_5.895410	340	416	0	46	76	0.6052632
NODE_2557_length_1428_cov_5.895410	340	416	1	30	76	0.3947369
NODE_2557_length_1428_cov_5.895410	393	476	1	83	83	1.0000000
NODE_2560_length_1427_cov_38.919428	707	787	0	80	80	1.0000000
NODE_2560_length_1427_cov_38.919428	760	840	0	80	80	1.0000000
NODE_2560_length_1427_cov_38.919428	836	916	0	80	80	1.0000000
NODE_2560_length_1427_cov_38.919428	889	969	0	80	80	1.0000000
NODE_2561_length_1427_cov_19.442771	808	888	6	61	80	0.7625000
NODE_2561_length_1427_cov_19.442771	808	888	8	18	80	0.2250000
NODE_2561_length_1427_cov_19.442771	808	888	9	1	80	0.0125000
NODE_2561_length_1427_cov_19.442771	861	941	6	8	80	0.1000000
NODE_2561_length_1427_cov_19.442771	861	941	8	18	80	0.2250000
NODE_2561_length_1427_cov_19.442771	861	941	9	17	80	0.2125000
NODE_2561_length_1427_cov_19.442771	861	941	10	10	80	0.1250000
NODE_2561_length_1427_cov_19.442771	861	941	11	2	80	0.0250000
NODE_2561_length_1427_cov_19.442771	861	941	12	6	80	0.0750000
NODE_2561_length_1427_cov_19.442771	861	941	13	19	80	0.2375000
NODE_2561_length_1427_cov_19.442771	937	1017	5	4	80	0.0500000
NODE_2561_length_1427_cov_19.442771	937	1017	7	55	80	0.6875000
NODE_2561_length_1427_cov_19.442771	937	1017	8	2	80	0.0250000
NODE_2561_length_1427_cov_19.442771	937	1017	9	4	80	0.0500000
NODE_2561_length_1427_cov_19.442771	937	1017	10	9	80	0.1125000
NODE_2561_length_1427_cov_19.442771	937	1017	11	4	80	0.0500000
NODE_2561_length_1427_cov_19.442771	937	1017	12	2	80	0.0250000
NODE_2561_length_1427_cov_19.442771	990	1070	1	6	80	0.0750000
NODE_2561_length_1427_cov_19.442771	990	1070	2	16	80	0.2000000
NODE_2561_length_1427_cov_19.442771	990	1070	3	13	80	0.1625000
NODE_2561_length_1427_cov_19.442771	990	1070	5	22	80	0.2750000
NODE_2561_length_1427_cov_19.442771	990	1070	7	23	80	0.2875000
NODE_2562_length_1427_cov_10.490964	728	808	0	8	80	0.1000000
NODE_2562_length_1427_cov_10.490964	728	808	1	35	80	0.4375000
NODE_2562_length_1427_cov_10.490964	728	808	2	2	80	0.0250000
NODE_2562_length_1427_cov_10.490964	728	808	3	35	80	0.4375000
NODE_2562_length_1427_cov_10.490964	781	861	3	80	80	1.0000000
NODE_2562_length_1427_cov_10.490964	857	937	1	14	80	0.1750000
NODE_2562_length_1427_cov_10.490964	857	937	2	20	80	0.2500000
NODE_2562_length_1427_cov_10.490964	857	937	3	46	80	0.5750000
NODE_2562_length_1427_cov_10.490964	910	990	1	67	80	0.8375000
NODE_2562_length_1427_cov_10.490964	910	990	2	2	80	0.0250000
NODE_2562_length_1427_cov_10.490964	910	990	3	11	80	0.1375000
NODE_2563_length_1427_cov_9.929217	646	726	0	80	80	1.0000000
NODE_2563_length_1427_cov_9.929217	699	779	0	80	80	1.0000000
NODE_2563_length_1427_cov_9.929217	775	855	0	69	80	0.8625000
NODE_2563_length_1427_cov_9.929217	775	855	2	11	80	0.1375000
NODE_2563_length_1427_cov_9.929217	828	908	0	16	80	0.2000000
NODE_2563_length_1427_cov_9.929217	828	908	2	64	80	0.8000000
NODE_2563_length_1427_cov_9.929217	1248	1324	1	7	76	0.0921053
NODE_2563_length_1427_cov_9.929217	1248	1324	2	38	76	0.5000000
NODE_2563_length_1427_cov_9.929217	1248	1324	4	31	76	0.4078947
NODE_2563_length_1427_cov_9.929217	1301	1376	4	75	75	1.0000000
NODE_2564_length_1427_cov_3.122741	1336	1399	0	63	63	1.0000000
NODE_2570_length_1426_cov_36.580256	422	502	4	21	80	0.2625000
NODE_2570_length_1426_cov_36.580256	422	502	5	16	80	0.2000000
NODE_2570_length_1426_cov_36.580256	422	502	6	4	80	0.0500000
NODE_2570_length_1426_cov_36.580256	422	502	7	17	80	0.2125000
NODE_2570_length_1426_cov_36.580256	422	502	8	22	80	0.2750000
NODE_2570_length_1426_cov_36.580256	475	555	6	9	80	0.1125000
NODE_2570_length_1426_cov_36.580256	475	555	7	43	80	0.5375000
NODE_2570_length_1426_cov_36.580256	475	555	8	10	80	0.1250000
NODE_2570_length_1426_cov_36.580256	475	555	9	18	80	0.2250000
NODE_2570_length_1426_cov_36.580256	551	631	3	18	80	0.2250000
NODE_2570_length_1426_cov_36.580256	551	631	4	4	80	0.0500000
NODE_2570_length_1426_cov_36.580256	551	631	6	19	80	0.2375000
NODE_2570_length_1426_cov_36.580256	551	631	7	18	80	0.2250000
NODE_2570_length_1426_cov_36.580256	551	631	8	8	80	0.1000000
NODE_2570_length_1426_cov_36.580256	551	631	9	13	80	0.1625000
NODE_2570_length_1426_cov_36.580256	604	684	2	21	80	0.2625000
NODE_2570_length_1426_cov_36.580256	604	684	3	50	80	0.6250000
NODE_2570_length_1426_cov_36.580256	604	684	4	4	80	0.0500000
NODE_2570_length_1426_cov_36.580256	604	684	6	5	80	0.0625000
NODE_2574_length_1425_cov_25.524133	561	641	0	10	80	0.1250000
NODE_2574_length_1425_cov_25.524133	561	641	2	7	80	0.0875000
NODE_2574_length_1425_cov_25.524133	561	641	4	63	80	0.7875000
NODE_2574_length_1425_cov_25.524133	614	694	4	50	80	0.6250000
NODE_2574_length_1425_cov_25.524133	614	694	6	30	80	0.3750000
NODE_2575_length_1425_cov_10.175716	361	441	4	7	80	0.0875000
NODE_2575_length_1425_cov_10.175716	361	441	5	2	80	0.0250000
NODE_2575_length_1425_cov_10.175716	361	441	6	32	80	0.4000000
NODE_2575_length_1425_cov_10.175716	361	441	7	39	80	0.4875000
NODE_2575_length_1425_cov_10.175716	414	494	4	2	80	0.0250000
NODE_2575_length_1425_cov_10.175716	414	494	5	5	80	0.0625000
NODE_2575_length_1425_cov_10.175716	414	494	6	38	80	0.4750000
NODE_2575_length_1425_cov_10.175716	414	494	7	35	80	0.4375000
NODE_2587_length_1423_cov_31.158610	862	942	0	80	80	1.0000000
NODE_2587_length_1423_cov_31.158610	915	995	0	80	80	1.0000000
NODE_2588_length_1423_cov_30.731873	764	844	1	9	80	0.1125000
NODE_2588_length_1423_cov_30.731873	764	844	5	9	80	0.1125000
NODE_2588_length_1423_cov_30.731873	764	844	6	24	80	0.3000000
NODE_2588_length_1423_cov_30.731873	764	844	8	38	80	0.4750000
NODE_2588_length_1423_cov_30.731873	817	897	8	47	80	0.5875000
NODE_2588_length_1423_cov_30.731873	817	897	10	33	80	0.4125000
NODE_2596_length_1421_cov_8.285930	136	212	130	2	76	0.0263158
NODE_2596_length_1421_cov_8.285930	136	212	132	4	76	0.0526316
NODE_2596_length_1421_cov_8.285930	136	212	134	1	76	0.0131579
NODE_2596_length_1421_cov_8.285930	136	212	139	2	76	0.0263158
NODE_2596_length_1421_cov_8.285930	136	212	141	2	76	0.0263158
NODE_2596_length_1421_cov_8.285930	136	212	142	2	76	0.0263158
NODE_2596_length_1421_cov_8.285930	136	212	145	1	76	0.0131579
NODE_2596_length_1421_cov_8.285930	136	212	148	1	76	0.0131579
NODE_2596_length_1421_cov_8.285930	136	212	151	2	76	0.0263158
NODE_2596_length_1421_cov_8.285930	136	212	154	1	76	0.0131579
NODE_2596_length_1421_cov_8.285930	136	212	156	3	76	0.0394737
NODE_2596_length_1421_cov_8.285930	136	212	159	2	76	0.0263158
NODE_2596_length_1421_cov_8.285930	136	212	161	1	76	0.0131579
NODE_2596_length_1421_cov_8.285930	136	212	164	2	76	0.0263158
NODE_2596_length_1421_cov_8.285930	136	212	165	2	76	0.0263158
NODE_2596_length_1421_cov_8.285930	136	212	166	2	76	0.0263158
NODE_2596_length_1421_cov_8.285930	136	212	167	4	76	0.0526316
NODE_2596_length_1421_cov_8.285930	136	212	169	2	76	0.0263158
NODE_2596_length_1421_cov_8.285930	136	212	170	3	76	0.0394737
NODE_2596_length_1421_cov_8.285930	136	212	171	1	76	0.0131579
NODE_2596_length_1421_cov_8.285930	136	212	172	2	76	0.0263158
NODE_2596_length_1421_cov_8.285930	136	212	174	3	76	0.0394737
NODE_2596_length_1421_cov_8.285930	136	212	175	1	76	0.0131579
NODE_2596_length_1421_cov_8.285930	136	212	176	1	76	0.0131579
NODE_2596_length_1421_cov_8.285930	136	212	177	1	76	0.0131579
NODE_2596_length_1421_cov_8.285930	136	212	178	3	76	0.0394737
NODE_2596_length_1421_cov_8.285930	136	212	179	11	76	0.1447368
NODE_2596_length_1421_cov_8.285930	136	212	180	1	76	0.0131579
NODE_2596_length_1421_cov_8.285930	136	212	181	2	76	0.0263158
NODE_2596_length_1421_cov_8.285930	136	212	182	3	76	0.0394737
NODE_2596_length_1421_cov_8.285930	136	212	183	4	76	0.0526316
NODE_2596_length_1421_cov_8.285930	136	212	185	1	76	0.0131579
NODE_2596_length_1421_cov_8.285930	136	212	186	1	76	0.0131579
NODE_2596_length_1421_cov_8.285930	136	212	187	2	76	0.0263158
NODE_2598_length_1421_cov_2.574130	22	102	0	80	80	1.0000000
NODE_2598_length_1421_cov_2.574130	75	132	0	57	57	1.0000000
NODE_2599_length_1420_cov_256.442846	60	140	8	4	80	0.0500000
NODE_2599_length_1420_cov_256.442846	60	140	10	2	80	0.0250000
NODE_2599_length_1420_cov_256.442846	60	140	11	1	80	0.0125000
NODE_2599_length_1420_cov_256.442846	60	140	12	5	80	0.0625000
NODE_2599_length_1420_cov_256.442846	60	140	13	7	80	0.0875000
NODE_2599_length_1420_cov_256.442846	60	140	14	1	80	0.0125000
NODE_2599_length_1420_cov_256.442846	60	140	17	6	80	0.0750000
NODE_2599_length_1420_cov_256.442846	60	140	18	7	80	0.0875000
NODE_2599_length_1420_cov_256.442846	60	140	20	1	80	0.0125000
NODE_2599_length_1420_cov_256.442846	60	140	22	20	80	0.2500000
NODE_2599_length_1420_cov_256.442846	60	140	23	1	80	0.0125000
NODE_2599_length_1420_cov_256.442846	60	140	24	25	80	0.3125000
NODE_2599_length_1420_cov_256.442846	1294	1360	11	14	66	0.2121212
NODE_2599_length_1420_cov_256.442846	1294	1360	12	7	66	0.1060606
NODE_2599_length_1420_cov_256.442846	1294	1360	13	2	66	0.0303030
NODE_2599_length_1420_cov_256.442846	1294	1360	14	43	66	0.6515151
NODE_2600_length_1420_cov_7.547313	628	708	1	10	80	0.1250000
NODE_2600_length_1420_cov_7.547313	628	708	2	21	80	0.2625000
NODE_2600_length_1420_cov_7.547313	628	708	3	8	80	0.1000000
NODE_2600_length_1420_cov_7.547313	628	708	4	41	80	0.5125000
NODE_2600_length_1420_cov_7.547313	681	761	3	34	80	0.4250000
NODE_2600_length_1420_cov_7.547313	681	761	4	46	80	0.5750000
NODE_2602_length_1420_cov_2.051476	972	1039	2	17	67	0.2537313
NODE_2602_length_1420_cov_2.051476	972	1039	3	49	67	0.7313433
NODE_2602_length_1420_cov_2.051476	972	1039	4	1	67	0.0149254
NODE_2604_length_1419_cov_46.997727	1230	1305	0	37	75	0.4933333
NODE_2604_length_1419_cov_46.997727	1230	1305	1	4	75	0.0533333
NODE_2604_length_1419_cov_46.997727	1230	1305	2	34	75	0.4533333
NODE_2604_length_1419_cov_46.997727	1278	1332	0	54	54	1.0000000
NODE_2609_length_1418_cov_11.373010	432	512	1	33	80	0.4125000
NODE_2609_length_1418_cov_11.373010	432	512	2	47	80	0.5875000
NODE_2609_length_1418_cov_11.373010	485	556	1	32	71	0.4507042
NODE_2609_length_1418_cov_11.373010	485	556	2	39	71	0.5492958
NODE_2615_length_1417_cov_12.477997	354	399	0	17	45	0.3777778
NODE_2615_length_1417_cov_12.477997	354	399	1	28	45	0.6222222
NODE_2616_length_1417_cov_11.120637	794	874	1	23	80	0.2875000
NODE_2616_length_1417_cov_11.120637	794	874	2	26	80	0.3250000
NODE_2616_length_1417_cov_11.120637	794	874	3	5	80	0.0625000
NODE_2616_length_1417_cov_11.120637	794	874	4	26	80	0.3250000
NODE_2616_length_1417_cov_11.120637	847	927	3	36	80	0.4500000
NODE_2616_length_1417_cov_11.120637	847	927	4	44	80	0.5500000
NODE_2625_length_1415_cov_51.375380	423	503	2	20	80	0.2500000
NODE_2625_length_1415_cov_51.375380	423	503	3	10	80	0.1250000
NODE_2625_length_1415_cov_51.375380	423	503	4	50	80	0.6250000
NODE_2625_length_1415_cov_51.375380	476	556	3	6	80	0.0750000
NODE_2625_length_1415_cov_51.375380	476	556	4	66	80	0.8250000
NODE_2625_length_1415_cov_51.375380	476	556	5	8	80	0.1000000
NODE_2625_length_1415_cov_51.375380	552	632	4	2	80	0.0250000
NODE_2625_length_1415_cov_51.375380	552	632	5	5	80	0.0625000
NODE_2625_length_1415_cov_51.375380	552	632	6	1	80	0.0125000
NODE_2625_length_1415_cov_51.375380	552	632	7	7	80	0.0875000
NODE_2625_length_1415_cov_51.375380	552	632	8	54	80	0.6750000
NODE_2625_length_1415_cov_51.375380	552	632	9	4	80	0.0500000
NODE_2625_length_1415_cov_51.375380	552	632	10	7	80	0.0875000
NODE_2625_length_1415_cov_51.375380	605	683	6	24	78	0.3076923
NODE_2625_length_1415_cov_51.375380	605	683	7	7	78	0.0897436
NODE_2625_length_1415_cov_51.375380	605	683	8	47	78	0.6025641
NODE_2626_length_1415_cov_38.272036	513	593	5	54	80	0.6750000
NODE_2626_length_1415_cov_38.272036	513	593	6	26	80	0.3250000
NODE_2626_length_1415_cov_38.272036	566	646	1	23	80	0.2875000
NODE_2626_length_1415_cov_38.272036	566	646	5	57	80	0.7125000
NODE_2627_length_1415_cov_17.232523	642	722	0	26	80	0.3250000
NODE_2627_length_1415_cov_17.232523	642	722	1	25	80	0.3125000
NODE_2627_length_1415_cov_17.232523	642	722	3	29	80	0.3625000
NODE_2627_length_1415_cov_17.232523	695	775	3	80	80	1.0000000
NODE_2629_length_1414_cov_5.307985	1026	1106	0	80	80	1.0000000
NODE_2629_length_1414_cov_5.307985	1079	1159	0	80	80	1.0000000
NODE_2637_length_1412_cov_17.723534	875	955	1	5	80	0.0625000
NODE_2637_length_1412_cov_17.723534	875	955	2	43	80	0.5375000
NODE_2637_length_1412_cov_17.723534	875	955	3	32	80	0.4000000
NODE_2637_length_1412_cov_17.723534	928	1008	2	80	80	1.0000000
NODE_2641_length_1411_cov_34.004573	516	596	8	6	80	0.0750000
NODE_2641_length_1411_cov_34.004573	516	596	9	5	80	0.0625000
NODE_2641_length_1411_cov_34.004573	516	596	10	11	80	0.1375000
NODE_2641_length_1411_cov_34.004573	516	596	11	10	80	0.1250000
NODE_2641_length_1411_cov_34.004573	516	596	12	42	80	0.5250000
NODE_2641_length_1411_cov_34.004573	516	596	13	3	80	0.0375000
NODE_2641_length_1411_cov_34.004573	516	596	14	3	80	0.0375000
NODE_2641_length_1411_cov_34.004573	569	649	7	30	80	0.3750000
NODE_2641_length_1411_cov_34.004573	569	649	8	2	80	0.0250000
NODE_2641_length_1411_cov_34.004573	569	649	10	4	80	0.0500000
NODE_2641_length_1411_cov_34.004573	569	649	11	23	80	0.2875000
NODE_2641_length_1411_cov_34.004573	569	649	12	21	80	0.2625000
NODE_2641_length_1411_cov_34.004573	645	725	6	32	80	0.4000000
NODE_2641_length_1411_cov_34.004573	645	725	7	36	80	0.4500000
NODE_2641_length_1411_cov_34.004573	645	725	9	12	80	0.1500000
NODE_2641_length_1411_cov_34.004573	698	778	5	30	80	0.3750000
NODE_2641_length_1411_cov_34.004573	698	778	6	26	80	0.3250000
NODE_2641_length_1411_cov_34.004573	698	778	7	24	80	0.3000000
NODE_2643_length_1409_cov_25.380153	828	908	2	8	80	0.1000000
NODE_2643_length_1409_cov_25.380153	828	908	3	60	80	0.7500000
NODE_2643_length_1409_cov_25.380153	828	908	4	12	80	0.1500000
NODE_2643_length_1409_cov_25.380153	881	961	3	33	80	0.4125000
NODE_2643_length_1409_cov_25.380153	881	961	5	35	80	0.4375000
NODE_2643_length_1409_cov_25.380153	881	961	6	8	80	0.1000000
NODE_2643_length_1409_cov_25.380153	881	961	8	4	80	0.0500000
NODE_2644_length_1409_cov_13.028244	349	405	15	11	56	0.1964286
NODE_2644_length_1409_cov_13.028244	349	405	16	1	56	0.0178571
NODE_2644_length_1409_cov_13.028244	349	405	19	2	56	0.0357143
NODE_2644_length_1409_cov_13.028244	349	405	20	2	56	0.0357143
NODE_2644_length_1409_cov_13.028244	349	405	21	1	56	0.0178571
NODE_2644_length_1409_cov_13.028244	349	405	22	1	56	0.0178571
NODE_2644_length_1409_cov_13.028244	349	405	23	18	56	0.3214286
NODE_2644_length_1409_cov_13.028244	349	405	25	20	56	0.3571429
NODE_2644_length_1409_cov_13.028244	416	482	19	3	66	0.0454545
NODE_2644_length_1409_cov_13.028244	416	482	20	12	66	0.1818182
NODE_2644_length_1409_cov_13.028244	416	482	21	1	66	0.0151515
NODE_2644_length_1409_cov_13.028244	416	482	22	6	66	0.0909091
NODE_2644_length_1409_cov_13.028244	416	482	23	23	66	0.3484848
NODE_2644_length_1409_cov_13.028244	416	482	24	19	66	0.2878788
NODE_2644_length_1409_cov_13.028244	416	482	25	2	66	0.0303030
NODE_2648_length_1408_cov_6.261268	492	572	2	9	80	0.1125000
NODE_2648_length_1408_cov_6.261268	492	572	3	39	80	0.4875000
NODE_2648_length_1408_cov_6.261268	492	572	4	32	80	0.4000000
NODE_2648_length_1408_cov_6.261268	545	625	3	34	80	0.4250000
NODE_2648_length_1408_cov_6.261268	545	625	4	39	80	0.4875000
NODE_2648_length_1408_cov_6.261268	545	625	5	7	80	0.0875000
NODE_2652_length_1407_cov_27.711009	772	852	2	27	80	0.3375000
NODE_2652_length_1407_cov_27.711009	772	852	3	53	80	0.6625000
NODE_2652_length_1407_cov_27.711009	825	905	1	44	80	0.5500000
NODE_2652_length_1407_cov_27.711009	825	905	3	36	80	0.4500000
NODE_2653_length_1407_cov_24.387615	586	666	2	17	80	0.2125000
NODE_2653_length_1407_cov_24.387615	586	666	3	18	80	0.2250000
NODE_2653_length_1407_cov_24.387615	586	666	4	3	80	0.0375000
NODE_2653_length_1407_cov_24.387615	586	666	5	21	80	0.2625000
NODE_2653_length_1407_cov_24.387615	586	666	6	3	80	0.0375000
NODE_2653_length_1407_cov_24.387615	586	666	7	12	80	0.1500000
NODE_2653_length_1407_cov_24.387615	586	666	8	6	80	0.0750000
NODE_2653_length_1407_cov_24.387615	639	719	5	6	80	0.0750000
NODE_2653_length_1407_cov_24.387615	639	719	6	38	80	0.4750000
NODE_2653_length_1407_cov_24.387615	639	719	7	12	80	0.1500000
NODE_2653_length_1407_cov_24.387615	639	719	8	24	80	0.3000000
NODE_2653_length_1407_cov_24.387615	715	795	3	21	80	0.2625000
NODE_2653_length_1407_cov_24.387615	715	795	4	3	80	0.0375000
NODE_2653_length_1407_cov_24.387615	715	795	5	18	80	0.2250000
NODE_2653_length_1407_cov_24.387615	715	795	6	38	80	0.4750000
NODE_2653_length_1407_cov_24.387615	768	848	1	40	80	0.5000000
NODE_2653_length_1407_cov_24.387615	768	848	2	12	80	0.1500000
NODE_2653_length_1407_cov_24.387615	768	848	3	22	80	0.2750000
NODE_2653_length_1407_cov_24.387615	768	848	4	3	80	0.0375000
NODE_2653_length_1407_cov_24.387615	768	848	5	3	80	0.0375000
NODE_2654_length_1407_cov_19.022936	551	629	1	10	78	0.1282051
NODE_2654_length_1407_cov_19.022936	551	629	2	16	78	0.2051282
NODE_2654_length_1407_cov_19.022936	551	629	3	52	78	0.6666667
NODE_2654_length_1407_cov_19.022936	602	665	1	31	63	0.4920635
NODE_2654_length_1407_cov_19.022936	602	665	2	15	63	0.2380952
NODE_2654_length_1407_cov_19.022936	602	665	3	17	63	0.2698413
NODE_2655_length_1407_cov_11.266820	813	893	0	80	80	1.0000000
NODE_2655_length_1407_cov_11.266820	866	946	0	80	80	1.0000000
NODE_2655_length_1407_cov_11.266820	942	1022	0	80	80	1.0000000
NODE_2655_length_1407_cov_11.266820	995	1075	0	80	80	1.0000000
NODE_2657_length_1406_cov_7.247896	761	841	0	80	80	1.0000000
NODE_2657_length_1406_cov_7.247896	814	894	0	80	80	1.0000000
NODE_2659_length_1404_cov_23.406130	826	906	5	5	80	0.0625000
NODE_2659_length_1404_cov_23.406130	826	906	6	45	80	0.5625000
NODE_2659_length_1404_cov_23.406130	826	906	7	9	80	0.1125000
NODE_2659_length_1404_cov_23.406130	826	906	8	21	80	0.2625000
NODE_2659_length_1404_cov_23.406130	879	959	5	19	80	0.2375000
NODE_2659_length_1404_cov_23.406130	879	959	6	10	80	0.1250000
NODE_2659_length_1404_cov_23.406130	879	959	7	32	80	0.4000000
NODE_2659_length_1404_cov_23.406130	879	959	8	19	80	0.2375000
NODE_2659_length_1404_cov_23.406130	955	1035	3	9	80	0.1125000
NODE_2659_length_1404_cov_23.406130	955	1035	4	4	80	0.0500000
NODE_2659_length_1404_cov_23.406130	955	1035	5	37	80	0.4625000
NODE_2659_length_1404_cov_23.406130	955	1035	6	30	80	0.3750000
NODE_2659_length_1404_cov_23.406130	1008	1088	3	10	80	0.1250000
NODE_2659_length_1404_cov_23.406130	1008	1088	4	8	80	0.1000000
NODE_2659_length_1404_cov_23.406130	1008	1088	5	62	80	0.7750000
NODE_2666_length_1403_cov_14.331288	325	405	1	24	80	0.3000000
NODE_2666_length_1403_cov_14.331288	325	405	2	20	80	0.2500000
NODE_2666_length_1403_cov_14.331288	325	405	3	9	80	0.1125000
NODE_2666_length_1403_cov_14.331288	325	405	4	27	80	0.3375000
NODE_2666_length_1403_cov_14.331288	378	458	4	80	80	1.0000000
NODE_2666_length_1403_cov_14.331288	454	534	0	2	80	0.0250000
NODE_2666_length_1403_cov_14.331288	454	534	1	9	80	0.1125000
NODE_2666_length_1403_cov_14.331288	454	534	2	24	80	0.3000000
NODE_2666_length_1403_cov_14.331288	454	534	3	32	80	0.4000000
NODE_2666_length_1403_cov_14.331288	454	534	4	13	80	0.1625000
NODE_2666_length_1403_cov_14.331288	454	534	0	2	80	0.0250000
NODE_2666_length_1403_cov_14.331288	454	534	1	9	80	0.1125000
NODE_2666_length_1403_cov_14.331288	454	534	2	24	80	0.3000000
NODE_2666_length_1403_cov_14.331288	454	534	3	32	80	0.4000000
NODE_2666_length_1403_cov_14.331288	454	534	4	13	80	0.1625000
NODE_2666_length_1403_cov_14.331288	454	524	1	5	70	0.0714286
NODE_2666_length_1403_cov_14.331288	454	524	2	20	70	0.2857143
NODE_2666_length_1403_cov_14.331288	454	524	3	32	70	0.4571429
NODE_2666_length_1403_cov_14.331288	454	524	4	13	70	0.1857143
NODE_2666_length_1403_cov_14.331288	507	587	0	2	80	0.0250000
NODE_2666_length_1403_cov_14.331288	507	587	1	9	80	0.1125000
NODE_2666_length_1403_cov_14.331288	507	587	2	68	80	0.8500000
NODE_2666_length_1403_cov_14.331288	507	587	3	1	80	0.0125000
NODE_2666_length_1403_cov_14.331288	507	579	0	2	72	0.0277778
NODE_2666_length_1403_cov_14.331288	507	579	1	9	72	0.1250000
NODE_2666_length_1403_cov_14.331288	507	579	2	61	72	0.8472222
NODE_2668_length_1402_cov_29.095165	610	690	5	17	80	0.2125000
NODE_2668_length_1402_cov_29.095165	610	690	6	22	80	0.2750000
NODE_2668_length_1402_cov_29.095165	610	690	7	20	80	0.2500000
NODE_2668_length_1402_cov_29.095165	610	690	8	20	80	0.2500000
NODE_2668_length_1402_cov_29.095165	610	690	9	1	80	0.0125000
NODE_2668_length_1402_cov_29.095165	663	743	7	15	80	0.1875000
NODE_2668_length_1402_cov_29.095165	663	743	8	64	80	0.8000000
NODE_2668_length_1402_cov_29.095165	663	743	9	1	80	0.0125000
NODE_2669_length_1402_cov_23.411358	528	608	0	28	80	0.3500000
NODE_2669_length_1402_cov_23.411358	528	608	1	8	80	0.1000000
NODE_2669_length_1402_cov_23.411358	528	608	2	44	80	0.5500000
NODE_2669_length_1402_cov_23.411358	581	661	2	28	80	0.3500000
NODE_2669_length_1402_cov_23.411358	581	661	3	6	80	0.0750000
NODE_2669_length_1402_cov_23.411358	581	661	5	41	80	0.5125000
NODE_2669_length_1402_cov_23.411358	581	661	6	5	80	0.0625000
NODE_2669_length_1402_cov_23.411358	657	737	6	29	80	0.3625000
NODE_2669_length_1402_cov_23.411358	657	737	7	48	80	0.6000000
NODE_2669_length_1402_cov_23.411358	657	737	8	3	80	0.0375000
NODE_2669_length_1402_cov_23.411358	710	790	5	32	80	0.4000000
NODE_2669_length_1402_cov_23.411358	710	790	6	39	80	0.4875000
NODE_2669_length_1402_cov_23.411358	710	790	7	4	80	0.0500000
NODE_2669_length_1402_cov_23.411358	710	790	8	5	80	0.0625000
NODE_2670_length_1402_cov_11.732924	661	741	2	25	80	0.3125000
NODE_2670_length_1402_cov_11.732924	661	741	4	55	80	0.6875000
NODE_2670_length_1402_cov_11.732924	714	794	2	10	80	0.1250000
NODE_2670_length_1402_cov_11.732924	714	794	4	38	80	0.4750000
NODE_2670_length_1402_cov_11.732924	714	794	6	32	80	0.4000000
NODE_2671_length_1402_cov_9.929394	766	846	0	80	80	1.0000000
NODE_2671_length_1402_cov_9.929394	819	899	0	80	80	1.0000000
NODE_2677_length_1401_cov_35.754992	825	905	6	4	80	0.0500000
NODE_2677_length_1401_cov_35.754992	825	905	7	10	80	0.1250000
NODE_2677_length_1401_cov_35.754992	825	905	9	1	80	0.0125000
NODE_2677_length_1401_cov_35.754992	825	905	10	2	80	0.0250000
NODE_2677_length_1401_cov_35.754992	825	905	11	30	80	0.3750000
NODE_2677_length_1401_cov_35.754992	825	905	12	19	80	0.2375000
NODE_2677_length_1401_cov_35.754992	825	905	13	4	80	0.0500000
NODE_2677_length_1401_cov_35.754992	825	905	14	10	80	0.1250000
NODE_2677_length_1401_cov_35.754992	878	958	7	11	80	0.1375000
NODE_2677_length_1401_cov_35.754992	878	958	9	2	80	0.0250000
NODE_2677_length_1401_cov_35.754992	878	958	11	2	80	0.0250000
NODE_2677_length_1401_cov_35.754992	878	958	12	56	80	0.7000000
NODE_2677_length_1401_cov_35.754992	878	958	13	4	80	0.0500000
NODE_2677_length_1401_cov_35.754992	878	958	14	5	80	0.0625000
NODE_2678_length_1401_cov_10.811828	539	619	0	24	80	0.3000000
NODE_2678_length_1401_cov_10.811828	539	619	1	1	80	0.0125000
NODE_2678_length_1401_cov_10.811828	539	619	2	55	80	0.6875000
NODE_2678_length_1401_cov_10.811828	592	672	1	26	80	0.3250000
NODE_2678_length_1401_cov_10.811828	592	672	2	54	80	0.6750000
NODE_2679_length_1401_cov_5.438556	241	321	3	29	80	0.3625000
NODE_2679_length_1401_cov_5.438556	241	321	4	51	80	0.6375000
NODE_2679_length_1401_cov_5.438556	294	374	2	35	80	0.4375000
NODE_2679_length_1401_cov_5.438556	294	374	3	42	80	0.5250000
NODE_2679_length_1401_cov_5.438556	294	374	4	3	80	0.0375000
NODE_2683_length_1400_cov_16.680246	813	893	1	80	80	1.0000000
NODE_2683_length_1400_cov_16.680246	866	946	1	80	80	1.0000000
NODE_2684_length_1400_cov_8.166795	53	133	6	16	80	0.2000000
NODE_2684_length_1400_cov_8.166795	53	133	7	26	80	0.3250000
NODE_2684_length_1400_cov_8.166795	53	133	9	38	80	0.4750000
NODE_2684_length_1400_cov_8.166795	106	186	3	26	80	0.3250000
NODE_2684_length_1400_cov_8.166795	106	186	4	7	80	0.0875000
NODE_2684_length_1400_cov_8.166795	106	186	6	12	80	0.1500000
NODE_2684_length_1400_cov_8.166795	106	186	7	17	80	0.2125000
NODE_2684_length_1400_cov_8.166795	106	186	9	18	80	0.2250000
NODE_2694_length_1397_cov_25.549307	869	918	0	49	49	1.0000000
NODE_2694_length_1397_cov_25.549307	891	971	0	80	80	1.0000000
NODE_2695_length_1397_cov_14.395223	672	752	1	5	80	0.0625000
NODE_2695_length_1397_cov_14.395223	672	752	2	7	80	0.0875000
NODE_2695_length_1397_cov_14.395223	672	752	3	25	80	0.3125000
NODE_2695_length_1397_cov_14.395223	672	752	4	43	80	0.5375000
NODE_2695_length_1397_cov_14.395223	725	805	4	80	80	1.0000000
NODE_2695_length_1397_cov_14.395223	801	881	0	22	80	0.2750000
NODE_2695_length_1397_cov_14.395223	801	881	1	25	80	0.3125000
NODE_2695_length_1397_cov_14.395223	801	881	2	7	80	0.0875000
NODE_2695_length_1397_cov_14.395223	801	881	3	19	80	0.2375000
NODE_2695_length_1397_cov_14.395223	801	881	4	7	80	0.0875000
NODE_2695_length_1397_cov_14.395223	854	934	0	75	80	0.9375000
NODE_2695_length_1397_cov_14.395223	854	934	1	5	80	0.0625000
NODE_2699_length_1396_cov_21.656130	825	905	0	19	80	0.2375000
NODE_2699_length_1396_cov_21.656130	825	905	2	61	80	0.7625000
NODE_2699_length_1396_cov_21.656130	878	958	0	72	80	0.9000000
NODE_2699_length_1396_cov_21.656130	878	958	2	8	80	0.1000000
NODE_2700_length_1396_cov_18.108712	560	640	1	56	80	0.7000000
NODE_2700_length_1396_cov_18.108712	560	640	2	24	80	0.3000000
NODE_2700_length_1396_cov_18.108712	613	693	1	12	80	0.1500000
NODE_2700_length_1396_cov_18.108712	613	693	2	68	80	0.8500000
NODE_2701_length_1396_cov_16.208944	136	198	1	11	62	0.1774193
NODE_2701_length_1396_cov_16.208944	136	198	2	51	62	0.8225806
NODE_2701_length_1396_cov_16.208944	848	928	0	7	80	0.0875000
NODE_2701_length_1396_cov_16.208944	848	928	1	38	80	0.4750000
NODE_2701_length_1396_cov_16.208944	848	928	2	25	80	0.3125000
NODE_2701_length_1396_cov_16.208944	848	928	3	10	80	0.1250000
NODE_2701_length_1396_cov_16.208944	901	981	2	17	80	0.2125000
NODE_2701_length_1396_cov_16.208944	901	981	3	22	80	0.2750000
NODE_2701_length_1396_cov_16.208944	901	981	5	33	80	0.4125000
NODE_2701_length_1396_cov_16.208944	901	981	6	8	80	0.1000000
NODE_2701_length_1396_cov_16.208944	977	1057	6	19	80	0.2375000
NODE_2701_length_1396_cov_16.208944	977	1057	7	8	80	0.1000000
NODE_2701_length_1396_cov_16.208944	977	1057	8	3	80	0.0375000
NODE_2701_length_1396_cov_16.208944	977	1057	9	18	80	0.2250000
NODE_2701_length_1396_cov_16.208944	977	1057	10	15	80	0.1875000
NODE_2701_length_1396_cov_16.208944	977	1057	11	17	80	0.2125000
NODE_2701_length_1396_cov_16.208944	1030	1110	6	9	80	0.1125000
NODE_2701_length_1396_cov_16.208944	1030	1110	8	33	80	0.4125000
NODE_2701_length_1396_cov_16.208944	1030	1110	9	5	80	0.0625000
NODE_2701_length_1396_cov_16.208944	1030	1110	10	17	80	0.2125000
NODE_2701_length_1396_cov_16.208944	1030	1110	11	16	80	0.2000000
NODE_2702_length_1396_cov_9.196608	428	508	1	35	80	0.4375000
NODE_2702_length_1396_cov_9.196608	428	508	2	45	80	0.5625000
NODE_2702_length_1396_cov_9.196608	481	561	2	27	80	0.3375000
NODE_2702_length_1396_cov_9.196608	481	561	3	34	80	0.4250000
NODE_2702_length_1396_cov_9.196608	481	561	4	19	80	0.2375000
NODE_2712_length_1394_cov_29.602317	349	415	1	1	66	0.0151515
NODE_2712_length_1394_cov_29.602317	349	415	3	1	66	0.0151515
NODE_2712_length_1394_cov_29.602317	349	415	4	38	66	0.5757576
NODE_2712_length_1394_cov_29.602317	349	415	5	21	66	0.3181818
NODE_2712_length_1394_cov_29.602317	349	415	7	5	66	0.0757576
NODE_2712_length_1394_cov_29.602317	349	416	0	1	67	0.0149254
NODE_2712_length_1394_cov_29.602317	349	416	1	1	67	0.0149254
NODE_2712_length_1394_cov_29.602317	349	416	3	1	67	0.0149254
NODE_2712_length_1394_cov_29.602317	349	416	4	38	67	0.5671642
NODE_2712_length_1394_cov_29.602317	349	416	5	21	67	0.3134328
NODE_2712_length_1394_cov_29.602317	349	416	7	5	67	0.0746269
NODE_2712_length_1394_cov_29.602317	1117	1197	0	80	80	1.0000000
NODE_2712_length_1394_cov_29.602317	1170	1250	0	80	80	1.0000000
NODE_2713_length_1394_cov_6.291892	313	393	1	5	80	0.0625000
NODE_2713_length_1394_cov_6.291892	313	393	2	42	80	0.5250000
NODE_2713_length_1394_cov_6.291892	313	393	3	21	80	0.2625000
NODE_2713_length_1394_cov_6.291892	313	393	4	12	80	0.1500000
NODE_2713_length_1394_cov_6.291892	366	446	3	15	80	0.1875000
NODE_2713_length_1394_cov_6.291892	366	446	4	65	80	0.8125000
NODE_2716_length_1393_cov_14.635240	1286	1339	2	52	53	0.9811321
NODE_2716_length_1393_cov_14.635240	1286	1339	4	1	53	0.0188679
NODE_2717_length_1393_cov_12.032457	737	817	0	36	80	0.4500000
NODE_2717_length_1393_cov_12.032457	737	817	2	2	80	0.0250000
NODE_2717_length_1393_cov_12.032457	737	817	3	42	80	0.5250000
NODE_2717_length_1393_cov_12.032457	790	870	3	80	80	1.0000000
NODE_2720_length_1392_cov_5.898685	270	350	1	63	80	0.7875000
NODE_2720_length_1392_cov_5.898685	270	350	2	17	80	0.2125000
NODE_2720_length_1392_cov_5.898685	323	399	1	76	76	1.0000000
NODE_2723_length_1391_cov_35.921827	415	495	0	64	80	0.8000000
NODE_2723_length_1391_cov_35.921827	415	495	2	16	80	0.2000000
NODE_2723_length_1391_cov_35.921827	468	548	0	11	80	0.1375000
NODE_2723_length_1391_cov_35.921827	468	548	2	53	80	0.6625000
NODE_2723_length_1391_cov_35.921827	468	548	3	1	80	0.0125000
NODE_2723_length_1391_cov_35.921827	468	548	4	15	80	0.1875000
NODE_2723_length_1391_cov_35.921827	544	624	4	20	80	0.2500000
NODE_2723_length_1391_cov_35.921827	544	624	6	60	80	0.7500000
NODE_2723_length_1391_cov_35.921827	597	677	4	48	80	0.6000000
NODE_2723_length_1391_cov_35.921827	597	677	6	32	80	0.4000000
NODE_2729_length_1390_cov_16.326878	550	630	3	55	80	0.6875000
NODE_2729_length_1390_cov_16.326878	550	630	4	25	80	0.3125000
NODE_2729_length_1390_cov_16.326878	603	683	1	13	80	0.1625000
NODE_2729_length_1390_cov_16.326878	603	683	3	67	80	0.8375000
NODE_2731_length_1389_cov_29.772093	780	860	3	65	80	0.8125000
NODE_2731_length_1389_cov_29.772093	780	860	4	15	80	0.1875000
NODE_2731_length_1389_cov_29.772093	833	913	1	12	80	0.1500000
NODE_2731_length_1389_cov_29.772093	833	913	2	9	80	0.1125000
NODE_2731_length_1389_cov_29.772093	833	913	3	19	80	0.2375000
NODE_2731_length_1389_cov_29.772093	833	913	4	40	80	0.5000000
NODE_2732_length_1389_cov_12.858140	821	901	0	80	80	1.0000000
NODE_2732_length_1389_cov_12.858140	874	954	0	80	80	1.0000000
NODE_2735_length_1388_cov_14.641583	529	610	0	81	81	1.0000000
NODE_2735_length_1388_cov_14.641583	583	660	0	77	77	1.0000000
NODE_2736_length_1388_cov_5.168348	427	499	9	16	72	0.2222222
NODE_2736_length_1388_cov_5.168348	427	499	11	5	72	0.0694444
NODE_2736_length_1388_cov_5.168348	427	499	12	7	72	0.0972222
NODE_2736_length_1388_cov_5.168348	427	499	13	2	72	0.0277778
NODE_2736_length_1388_cov_5.168348	427	499	14	1	72	0.0138889
NODE_2736_length_1388_cov_5.168348	427	499	15	1	72	0.0138889
NODE_2736_length_1388_cov_5.168348	427	499	16	7	72	0.0972222
NODE_2736_length_1388_cov_5.168348	427	499	17	2	72	0.0277778
NODE_2736_length_1388_cov_5.168348	427	499	18	4	72	0.0555556
NODE_2736_length_1388_cov_5.168348	427	499	19	24	72	0.3333333
NODE_2736_length_1388_cov_5.168348	427	499	20	3	72	0.0416667
NODE_2742_length_1386_cov_55.384615	559	639	2	45	80	0.5625000
NODE_2742_length_1386_cov_55.384615	559	639	3	35	80	0.4375000
NODE_2742_length_1386_cov_55.384615	612	692	1	3	80	0.0375000
NODE_2742_length_1386_cov_55.384615	612	692	2	33	80	0.4125000
NODE_2742_length_1386_cov_55.384615	612	692	3	38	80	0.4750000
NODE_2742_length_1386_cov_55.384615	612	692	4	6	80	0.0750000
NODE_2742_length_1386_cov_55.384615	688	768	4	37	80	0.4625000
NODE_2742_length_1386_cov_55.384615	688	768	5	28	80	0.3500000
NODE_2742_length_1386_cov_55.384615	688	768	6	15	80	0.1875000
NODE_2742_length_1386_cov_55.384615	741	821	3	8	80	0.1000000
NODE_2742_length_1386_cov_55.384615	741	821	4	16	80	0.2000000
NODE_2742_length_1386_cov_55.384615	741	821	5	55	80	0.6875000
NODE_2742_length_1386_cov_55.384615	741	821	6	1	80	0.0125000
NODE_2744_length_1386_cov_13.181041	549	629	0	5	80	0.0625000
NODE_2744_length_1386_cov_13.181041	549	629	1	39	80	0.4875000
NODE_2744_length_1386_cov_13.181041	549	629	2	36	80	0.4500000
NODE_2744_length_1386_cov_13.181041	602	682	2	80	80	1.0000000
NODE_2748_length_1385_cov_41.636081	968	1048	8	4	80	0.0500000
NODE_2748_length_1385_cov_41.636081	968	1048	9	12	80	0.1500000
NODE_2748_length_1385_cov_41.636081	968	1048	10	3	80	0.0375000
NODE_2748_length_1385_cov_41.636081	968	1048	12	42	80	0.5250000
NODE_2748_length_1385_cov_41.636081	968	1048	13	19	80	0.2375000
NODE_2748_length_1385_cov_41.636081	1021	1101	5	5	80	0.0625000
NODE_2748_length_1385_cov_41.636081	1021	1101	6	10	80	0.1250000
NODE_2748_length_1385_cov_41.636081	1021	1101	7	7	80	0.0875000
NODE_2748_length_1385_cov_41.636081	1021	1101	9	3	80	0.0375000
NODE_2748_length_1385_cov_41.636081	1021	1101	10	11	80	0.1375000
NODE_2748_length_1385_cov_41.636081	1021	1101	12	25	80	0.3125000
NODE_2748_length_1385_cov_41.636081	1021	1101	13	19	80	0.2375000
NODE_2749_length_1385_cov_38.877138	707	787	3	12	80	0.1500000
NODE_2749_length_1385_cov_38.877138	707	787	4	12	80	0.1500000
NODE_2749_length_1385_cov_38.877138	707	787	5	16	80	0.2000000
NODE_2749_length_1385_cov_38.877138	707	787	6	1	80	0.0125000
NODE_2749_length_1385_cov_38.877138	707	787	7	39	80	0.4875000
NODE_2749_length_1385_cov_38.877138	760	840	4	19	80	0.2375000
NODE_2749_length_1385_cov_38.877138	760	840	5	31	80	0.3875000
NODE_2749_length_1385_cov_38.877138	760	840	6	5	80	0.0625000
NODE_2749_length_1385_cov_38.877138	760	840	7	25	80	0.3125000
NODE_2749_length_1385_cov_38.877138	836	916	1	35	80	0.4375000
NODE_2749_length_1385_cov_38.877138	836	916	2	12	80	0.1500000
NODE_2749_length_1385_cov_38.877138	836	916	3	15	80	0.1875000
NODE_2749_length_1385_cov_38.877138	836	916	4	18	80	0.2250000
NODE_2749_length_1385_cov_38.877138	889	969	0	2	80	0.0250000
NODE_2749_length_1385_cov_38.877138	889	969	1	78	80	0.9750000
NODE_2751_length_1385_cov_4.608865	844	904	0	27	60	0.4500000
NODE_2751_length_1385_cov_4.608865	844	904	1	7	60	0.1166667
NODE_2751_length_1385_cov_4.608865	844	904	2	26	60	0.4333333
NODE_2758_length_1384_cov_10.574319	865	922	4	17	57	0.2982456
NODE_2758_length_1384_cov_10.574319	865	922	5	7	57	0.1228070
NODE_2758_length_1384_cov_10.574319	865	922	6	33	57	0.5789474
NODE_2758_length_1384_cov_10.574319	933	1013	1	2	80	0.0250000
NODE_2758_length_1384_cov_10.574319	933	1013	2	78	80	0.9750000
NODE_2758_length_1384_cov_10.574319	986	1066	0	36	80	0.4500000
NODE_2758_length_1384_cov_10.574319	986	1066	1	19	80	0.2375000
NODE_2758_length_1384_cov_10.574319	986	1066	2	25	80	0.3125000
NODE_2759_length_1383_cov_10.710280	414	493	1	1	79	0.0126582
NODE_2759_length_1383_cov_10.710280	414	493	2	29	79	0.3670886
NODE_2759_length_1383_cov_10.710280	414	493	3	49	79	0.6202531
NODE_2759_length_1383_cov_10.710280	466	546	2	63	80	0.7875000
NODE_2759_length_1383_cov_10.710280	466	546	3	17	80	0.2125000
NODE_2763_length_1382_cov_12.521434	837	917	5	1	80	0.0125000
NODE_2763_length_1382_cov_12.521434	837	917	6	53	80	0.6625000
NODE_2763_length_1382_cov_12.521434	837	917	7	10	80	0.1250000
NODE_2763_length_1382_cov_12.521434	837	917	8	16	80	0.2000000
NODE_2763_length_1382_cov_12.521434	890	970	5	7	80	0.0875000
NODE_2763_length_1382_cov_12.521434	890	970	6	67	80	0.8375000
NODE_2763_length_1382_cov_12.521434	890	970	7	6	80	0.0750000
NODE_2764_length_1382_cov_5.074045	1028	1108	1	80	80	1.0000000
NODE_2764_length_1382_cov_5.074045	1081	1161	1	31	80	0.3875000
NODE_2764_length_1382_cov_5.074045	1081	1161	2	49	80	0.6125000
NODE_2771_length_1381_cov_7.796412	307	387	0	80	80	1.0000000
NODE_2771_length_1381_cov_7.796412	360	440	0	80	80	1.0000000
NODE_2775_length_1380_cov_12.804059	835	915	3	4	80	0.0500000
NODE_2775_length_1380_cov_12.804059	835	915	4	5	80	0.0625000
NODE_2775_length_1380_cov_12.804059	835	915	6	47	80	0.5875000
NODE_2775_length_1380_cov_12.804059	835	915	7	12	80	0.1500000
NODE_2775_length_1380_cov_12.804059	835	915	8	12	80	0.1500000
NODE_2775_length_1380_cov_12.804059	888	968	3	8	80	0.1000000
NODE_2775_length_1380_cov_12.804059	888	968	4	38	80	0.4750000
NODE_2775_length_1380_cov_12.804059	888	968	6	34	80	0.4250000
NODE_2782_length_1378_cov_25.362002	368	448	0	41	80	0.5125000
NODE_2782_length_1378_cov_25.362002	368	448	2	39	80	0.4875000
NODE_2782_length_1378_cov_25.362002	421	501	0	6	80	0.0750000
NODE_2782_length_1378_cov_25.362002	421	501	1	24	80	0.3000000
NODE_2782_length_1378_cov_25.362002	421	501	2	50	80	0.6250000
NODE_2782_length_1378_cov_25.362002	497	577	1	5	80	0.0625000
NODE_2782_length_1378_cov_25.362002	497	577	2	12	80	0.1500000
NODE_2782_length_1378_cov_25.362002	497	577	3	40	80	0.5000000
NODE_2782_length_1378_cov_25.362002	497	577	4	17	80	0.2125000
NODE_2782_length_1378_cov_25.362002	497	577	6	6	80	0.0750000
NODE_2782_length_1378_cov_25.362002	550	630	3	4	80	0.0500000
NODE_2782_length_1378_cov_25.362002	550	630	4	17	80	0.2125000
NODE_2782_length_1378_cov_25.362002	550	630	6	13	80	0.1625000
NODE_2782_length_1378_cov_25.362002	550	630	7	2	80	0.0250000
NODE_2782_length_1378_cov_25.362002	550	630	8	44	80	0.5500000
NODE_2783_length_1378_cov_20.508210	318	338	18	7	20	0.3500000
NODE_2783_length_1378_cov_20.508210	318	338	19	2	20	0.1000000
NODE_2783_length_1378_cov_20.508210	318	338	20	1	20	0.0500000
NODE_2783_length_1378_cov_20.508210	318	338	21	10	20	0.5000000
NODE_2783_length_1378_cov_20.508210	318	391	18	7	73	0.0958904
NODE_2783_length_1378_cov_20.508210	318	391	19	2	73	0.0273973
NODE_2783_length_1378_cov_20.508210	318	391	20	1	73	0.0136986
NODE_2783_length_1378_cov_20.508210	318	391	21	10	73	0.1369863
NODE_2783_length_1378_cov_20.508210	318	391	22	8	73	0.1095890
NODE_2783_length_1378_cov_20.508210	318	391	23	2	73	0.0273973
NODE_2783_length_1378_cov_20.508210	318	391	24	1	73	0.0136986
NODE_2783_length_1378_cov_20.508210	318	391	26	14	73	0.1917808
NODE_2783_length_1378_cov_20.508210	318	391	27	1	73	0.0136986
NODE_2783_length_1378_cov_20.508210	318	391	28	4	73	0.0547945
NODE_2783_length_1378_cov_20.508210	318	391	29	4	73	0.0547945
NODE_2783_length_1378_cov_20.508210	318	391	30	1	73	0.0136986
NODE_2783_length_1378_cov_20.508210	318	391	31	9	73	0.1232877
NODE_2783_length_1378_cov_20.508210	318	391	32	6	73	0.0821918
NODE_2783_length_1378_cov_20.508210	318	391	33	3	73	0.0410959
NODE_2785_length_1377_cov_103.832551	1259	1299	111	1	40	0.0250000
NODE_2785_length_1377_cov_103.832551	1259	1299	113	6	40	0.1500000
NODE_2785_length_1377_cov_103.832551	1259	1299	115	1	40	0.0250000
NODE_2785_length_1377_cov_103.832551	1259	1299	116	1	40	0.0250000
NODE_2785_length_1377_cov_103.832551	1259	1299	117	1	40	0.0250000
NODE_2785_length_1377_cov_103.832551	1259	1299	118	2	40	0.0500000
NODE_2785_length_1377_cov_103.832551	1259	1299	121	1	40	0.0250000
NODE_2785_length_1377_cov_103.832551	1259	1299	122	1	40	0.0250000
NODE_2785_length_1377_cov_103.832551	1259	1299	123	1	40	0.0250000
NODE_2785_length_1377_cov_103.832551	1259	1299	125	1	40	0.0250000
NODE_2785_length_1377_cov_103.832551	1259	1299	130	1	40	0.0250000
NODE_2785_length_1377_cov_103.832551	1259	1299	134	1	40	0.0250000
NODE_2785_length_1377_cov_103.832551	1259	1299	135	1	40	0.0250000
NODE_2785_length_1377_cov_103.832551	1259	1299	138	1	40	0.0250000
NODE_2785_length_1377_cov_103.832551	1259	1299	140	7	40	0.1750000
NODE_2785_length_1377_cov_103.832551	1259	1299	141	10	40	0.2500000
NODE_2785_length_1377_cov_103.832551	1259	1299	142	1	40	0.0250000
NODE_2785_length_1377_cov_103.832551	1259	1299	144	2	40	0.0500000
NODE_2788_length_1376_cov_7.967110	904	984	1	49	80	0.6125000
NODE_2788_length_1376_cov_7.967110	904	984	3	31	80	0.3875000
NODE_2788_length_1376_cov_7.967110	957	1037	0	37	80	0.4625000
NODE_2788_length_1376_cov_7.967110	957	1037	1	7	80	0.0875000
NODE_2788_length_1376_cov_7.967110	957	1037	3	36	80	0.4500000
NODE_2798_length_1373_cov_52.691523	524	606	2	5	82	0.0609756
NODE_2798_length_1373_cov_52.691523	524	606	3	13	82	0.1585366
NODE_2798_length_1373_cov_52.691523	524	606	4	28	82	0.3414634
NODE_2798_length_1373_cov_52.691523	524	606	5	36	82	0.4390244
NODE_2798_length_1373_cov_52.691523	579	659	3	7	80	0.0875000
NODE_2798_length_1373_cov_52.691523	579	659	4	73	80	0.9125000
NODE_2799_length_1373_cov_20.880691	987	1067	6	12	80	0.1500000
NODE_2799_length_1373_cov_20.880691	987	1067	7	32	80	0.4000000
NODE_2799_length_1373_cov_20.880691	987	1067	8	32	80	0.4000000
NODE_2799_length_1373_cov_20.880691	987	1067	9	4	80	0.0500000
NODE_2799_length_1373_cov_20.880691	1116	1195	1	28	79	0.3544304
NODE_2799_length_1373_cov_20.880691	1116	1195	2	24	79	0.3037975
NODE_2799_length_1373_cov_20.880691	1116	1195	3	27	79	0.3417721
NODE_2799_length_1373_cov_20.880691	1168	1248	1	77	80	0.9625000
NODE_2799_length_1373_cov_20.880691	1168	1248	2	3	80	0.0375000
NODE_2800_length_1373_cov_12.694662	94	167	32	3	73	0.0410959
NODE_2800_length_1373_cov_12.694662	94	167	33	5	73	0.0684932
NODE_2800_length_1373_cov_12.694662	94	167	36	1	73	0.0136986
NODE_2800_length_1373_cov_12.694662	94	167	37	7	73	0.0958904
NODE_2800_length_1373_cov_12.694662	94	167	38	2	73	0.0273973
NODE_2800_length_1373_cov_12.694662	94	167	40	6	73	0.0821918
NODE_2800_length_1373_cov_12.694662	94	167	41	3	73	0.0410959
NODE_2800_length_1373_cov_12.694662	94	167	42	1	73	0.0136986
NODE_2800_length_1373_cov_12.694662	94	167	43	2	73	0.0273973
NODE_2800_length_1373_cov_12.694662	94	167	44	6	73	0.0821918
NODE_2800_length_1373_cov_12.694662	94	167	45	1	73	0.0136986
NODE_2800_length_1373_cov_12.694662	94	167	47	1	73	0.0136986
NODE_2800_length_1373_cov_12.694662	94	167	48	5	73	0.0684932
NODE_2800_length_1373_cov_12.694662	94	167	49	2	73	0.0273973
NODE_2800_length_1373_cov_12.694662	94	167	50	11	73	0.1506849
NODE_2800_length_1373_cov_12.694662	94	167	51	6	73	0.0821918
NODE_2800_length_1373_cov_12.694662	94	167	52	4	73	0.0547945
NODE_2800_length_1373_cov_12.694662	94	167	53	7	73	0.0958904
NODE_2800_length_1373_cov_12.694662	140	224	48	1	84	0.0119048
NODE_2800_length_1373_cov_12.694662	140	224	50	9	84	0.1071429
NODE_2800_length_1373_cov_12.694662	140	224	51	6	84	0.0714286
NODE_2800_length_1373_cov_12.694662	140	224	52	4	84	0.0476190
NODE_2800_length_1373_cov_12.694662	140	224	53	7	84	0.0833333
NODE_2800_length_1373_cov_12.694662	140	224	54	3	84	0.0357143
NODE_2800_length_1373_cov_12.694662	140	224	55	13	84	0.1547619
NODE_2800_length_1373_cov_12.694662	140	224	56	11	84	0.1309524
NODE_2800_length_1373_cov_12.694662	140	224	57	10	84	0.1190476
NODE_2800_length_1373_cov_12.694662	140	224	58	8	84	0.0952381
NODE_2800_length_1373_cov_12.694662	140	224	59	3	84	0.0357143
NODE_2800_length_1373_cov_12.694662	140	224	60	3	84	0.0357143
NODE_2800_length_1373_cov_12.694662	140	224	62	1	84	0.0119048
NODE_2800_length_1373_cov_12.694662	140	224	63	3	84	0.0357143
NODE_2800_length_1373_cov_12.694662	140	224	64	1	84	0.0119048
NODE_2800_length_1373_cov_12.694662	140	224	67	1	84	0.0119048
NODE_2800_length_1373_cov_12.694662	1214	1286	1	28	72	0.3888889
NODE_2800_length_1373_cov_12.694662	1214	1286	2	44	72	0.6111111
NODE_2800_length_1373_cov_12.694662	1267	1339	0	8	72	0.1111111
NODE_2800_length_1373_cov_12.694662	1267	1339	1	64	72	0.8888889
NODE_2801_length_1372_cov_25.408484	665	745	4	5	80	0.0625000
NODE_2801_length_1372_cov_25.408484	665	745	5	6	80	0.0750000
NODE_2801_length_1372_cov_25.408484	665	745	7	69	80	0.8625000
NODE_2801_length_1372_cov_25.408484	718	798	0	11	80	0.1375000
NODE_2801_length_1372_cov_25.408484	718	798	2	41	80	0.5125000
NODE_2801_length_1372_cov_25.408484	718	798	4	6	80	0.0750000
NODE_2801_length_1372_cov_25.408484	718	798	5	6	80	0.0750000
NODE_2801_length_1372_cov_25.408484	718	798	7	16	80	0.2000000
NODE_2802_length_1372_cov_17.123331	647	727	4	14	80	0.1750000
NODE_2802_length_1372_cov_17.123331	647	727	5	14	80	0.1750000
NODE_2802_length_1372_cov_17.123331	647	727	6	52	80	0.6500000
NODE_2802_length_1372_cov_17.123331	700	780	1	5	80	0.0625000
NODE_2802_length_1372_cov_17.123331	700	780	2	9	80	0.1125000
NODE_2802_length_1372_cov_17.123331	700	780	4	17	80	0.2125000
NODE_2802_length_1372_cov_17.123331	700	780	5	36	80	0.4500000
NODE_2802_length_1372_cov_17.123331	700	780	6	13	80	0.1625000
NODE_2802_length_1372_cov_17.123331	776	856	1	26	80	0.3250000
NODE_2802_length_1372_cov_17.123331	776	856	2	30	80	0.3750000
NODE_2802_length_1372_cov_17.123331	776	856	4	24	80	0.3000000
NODE_2802_length_1372_cov_17.123331	829	909	2	3	80	0.0375000
NODE_2802_length_1372_cov_17.123331	829	909	3	43	80	0.5375000
NODE_2802_length_1372_cov_17.123331	829	909	4	34	80	0.4250000
NODE_2803_length_1372_cov_14.418696	211	291	1	54	80	0.6750000
NODE_2803_length_1372_cov_14.418696	211	291	2	26	80	0.3250000
NODE_2803_length_1372_cov_14.418696	264	344	1	20	80	0.2500000
NODE_2803_length_1372_cov_14.418696	264	344	2	60	80	0.7500000
NODE_2806_length_1371_cov_39.366352	715	795	2	50	80	0.6250000
NODE_2806_length_1371_cov_39.366352	715	795	3	16	80	0.2000000
NODE_2806_length_1371_cov_39.366352	715	795	5	12	80	0.1500000
NODE_2806_length_1371_cov_39.366352	715	795	7	2	80	0.0250000
NODE_2806_length_1371_cov_39.366352	768	848	3	13	80	0.1625000
NODE_2806_length_1371_cov_39.366352	768	848	5	13	80	0.1625000
NODE_2806_length_1371_cov_39.366352	768	848	7	54	80	0.6750000
NODE_2807_length_1371_cov_36.961478	371	455	0	14	84	0.1666667
NODE_2807_length_1371_cov_36.961478	371	455	2	70	84	0.8333333
NODE_2807_length_1371_cov_36.961478	424	508	0	11	84	0.1309524
NODE_2807_length_1371_cov_36.961478	424	508	2	73	84	0.8690476
NODE_2807_length_1371_cov_36.961478	504	584	0	35	80	0.4375000
NODE_2807_length_1371_cov_36.961478	504	584	1	5	80	0.0625000
NODE_2807_length_1371_cov_36.961478	504	584	2	21	80	0.2625000
NODE_2807_length_1371_cov_36.961478	504	584	3	17	80	0.2125000
NODE_2807_length_1371_cov_36.961478	504	584	4	2	80	0.0250000
NODE_2807_length_1371_cov_36.961478	557	637	2	8	80	0.1000000
NODE_2807_length_1371_cov_36.961478	557	637	3	17	80	0.2125000
NODE_2807_length_1371_cov_36.961478	557	637	4	55	80	0.6875000
NODE_2808_length_1371_cov_16.944182	459	539	0	20	80	0.2500000
NODE_2808_length_1371_cov_16.944182	459	539	4	60	80	0.7500000
NODE_2808_length_1371_cov_16.944182	512	592	4	80	80	1.0000000
NODE_2808_length_1371_cov_16.944182	588	668	0	61	80	0.7625000
NODE_2808_length_1371_cov_16.944182	588	668	4	19	80	0.2375000
NODE_2808_length_1371_cov_16.944182	641	721	0	80	80	1.0000000
NODE_2812_length_1370_cov_11.627065	502	582	0	2	80	0.0250000
NODE_2812_length_1370_cov_11.627065	502	582	1	38	80	0.4750000
NODE_2812_length_1370_cov_11.627065	502	582	2	6	80	0.0750000
NODE_2812_length_1370_cov_11.627065	502	582	3	34	80	0.4250000
NODE_2812_length_1370_cov_11.627065	555	635	3	35	80	0.4375000
NODE_2812_length_1370_cov_11.627065	555	635	4	2	80	0.0250000
NODE_2812_length_1370_cov_11.627065	555	635	5	26	80	0.3250000
NODE_2812_length_1370_cov_11.627065	555	635	6	17	80	0.2125000
NODE_2812_length_1370_cov_11.627065	631	711	4	12	80	0.1500000
NODE_2812_length_1370_cov_11.627065	631	711	5	36	80	0.4500000
NODE_2812_length_1370_cov_11.627065	631	711	6	32	80	0.4000000
NODE_2812_length_1370_cov_11.627065	684	764	3	16	80	0.2000000
NODE_2812_length_1370_cov_11.627065	684	764	4	8	80	0.1000000
NODE_2812_length_1370_cov_11.627065	684	764	5	48	80	0.6000000
NODE_2812_length_1370_cov_11.627065	684	764	6	8	80	0.1000000
NODE_2813_length_1369_cov_27.937795	597	677	1	55	80	0.6875000
NODE_2813_length_1369_cov_27.937795	597	677	2	25	80	0.3125000
NODE_2813_length_1369_cov_27.937795	650	730	1	4	80	0.0500000
NODE_2813_length_1369_cov_27.937795	650	730	2	76	80	0.9500000
NODE_2820_length_1368_cov_35.148148	546	626	2	80	80	1.0000000
NODE_2820_length_1368_cov_35.148148	599	679	0	46	80	0.5750000
NODE_2820_length_1368_cov_35.148148	599	679	2	34	80	0.4250000
NODE_2821_length_1368_cov_27.847912	486	559	0	73	73	1.0000000
NODE_2821_length_1368_cov_27.847912	532	612	0	80	80	1.0000000
NODE_2821_length_1368_cov_27.847912	608	688	0	80	80	1.0000000
NODE_2821_length_1368_cov_27.847912	661	741	0	80	80	1.0000000
NODE_2822_length_1368_cov_26.832151	458	538	1	79	80	0.9875000
NODE_2822_length_1368_cov_26.832151	458	538	2	1	80	0.0125000
NODE_2822_length_1368_cov_26.832151	511	591	1	52	80	0.6500000
NODE_2822_length_1368_cov_26.832151	511	591	2	28	80	0.3500000
NODE_2822_length_1368_cov_26.832151	587	667	1	68	80	0.8500000
NODE_2822_length_1368_cov_26.832151	587	667	2	12	80	0.1500000
NODE_2822_length_1368_cov_26.832151	640	720	1	33	80	0.4125000
NODE_2822_length_1368_cov_26.832151	640	720	2	47	80	0.5875000
NODE_2823_length_1368_cov_18.205674	603	683	0	1	80	0.0125000
NODE_2823_length_1368_cov_18.205674	603	683	1	17	80	0.2125000
NODE_2823_length_1368_cov_18.205674	603	683	2	62	80	0.7750000
NODE_2823_length_1368_cov_18.205674	656	736	0	54	80	0.6750000
NODE_2823_length_1368_cov_18.205674	656	736	1	17	80	0.2125000
NODE_2823_length_1368_cov_18.205674	656	736	2	9	80	0.1125000
NODE_2826_length_1367_cov_576.769716	799	879	329	1	80	0.0125000
NODE_2826_length_1367_cov_576.769716	799	879	330	3	80	0.0375000
NODE_2826_length_1367_cov_576.769716	799	879	331	1	80	0.0125000
NODE_2826_length_1367_cov_576.769716	799	879	332	1	80	0.0125000
NODE_2826_length_1367_cov_576.769716	799	879	333	4	80	0.0500000
NODE_2826_length_1367_cov_576.769716	799	879	334	2	80	0.0250000
NODE_2826_length_1367_cov_576.769716	799	879	336	5	80	0.0625000
NODE_2826_length_1367_cov_576.769716	799	879	337	2	80	0.0250000
NODE_2826_length_1367_cov_576.769716	799	879	338	2	80	0.0250000
NODE_2826_length_1367_cov_576.769716	799	879	339	1	80	0.0125000
NODE_2826_length_1367_cov_576.769716	799	879	344	1	80	0.0125000
NODE_2826_length_1367_cov_576.769716	799	879	345	1	80	0.0125000
NODE_2826_length_1367_cov_576.769716	799	879	348	2	80	0.0250000
NODE_2826_length_1367_cov_576.769716	799	879	357	1	80	0.0125000
NODE_2826_length_1367_cov_576.769716	799	879	360	1	80	0.0125000
NODE_2826_length_1367_cov_576.769716	799	879	368	1	80	0.0125000
NODE_2826_length_1367_cov_576.769716	799	879	374	1	80	0.0125000
NODE_2826_length_1367_cov_576.769716	799	879	376	1	80	0.0125000
NODE_2826_length_1367_cov_576.769716	799	879	379	1	80	0.0125000
NODE_2826_length_1367_cov_576.769716	799	879	382	1	80	0.0125000
NODE_2826_length_1367_cov_576.769716	799	879	383	2	80	0.0250000
NODE_2826_length_1367_cov_576.769716	799	879	384	2	80	0.0250000
NODE_2826_length_1367_cov_576.769716	799	879	392	2	80	0.0250000
NODE_2826_length_1367_cov_576.769716	799	879	396	1	80	0.0125000
NODE_2826_length_1367_cov_576.769716	799	879	400	1	80	0.0125000
NODE_2826_length_1367_cov_576.769716	799	879	402	1	80	0.0125000
NODE_2826_length_1367_cov_576.769716	799	879	404	1	80	0.0125000
NODE_2826_length_1367_cov_576.769716	799	879	409	1	80	0.0125000
NODE_2826_length_1367_cov_576.769716	799	879	410	1	80	0.0125000
NODE_2826_length_1367_cov_576.769716	799	879	411	4	80	0.0500000
NODE_2826_length_1367_cov_576.769716	799	879	414	1	80	0.0125000
NODE_2826_length_1367_cov_576.769716	799	879	415	2	80	0.0250000
NODE_2826_length_1367_cov_576.769716	799	879	416	1	80	0.0125000
NODE_2826_length_1367_cov_576.769716	799	879	422	1	80	0.0125000
NODE_2826_length_1367_cov_576.769716	799	879	426	1	80	0.0125000
NODE_2826_length_1367_cov_576.769716	799	879	437	1	80	0.0125000
NODE_2826_length_1367_cov_576.769716	799	879	443	1	80	0.0125000
NODE_2826_length_1367_cov_576.769716	799	879	445	1	80	0.0125000
NODE_2826_length_1367_cov_576.769716	799	879	452	1	80	0.0125000
NODE_2826_length_1367_cov_576.769716	799	879	455	1	80	0.0125000
NODE_2826_length_1367_cov_576.769716	799	879	456	1	80	0.0125000
NODE_2826_length_1367_cov_576.769716	799	879	465	2	80	0.0250000
NODE_2826_length_1367_cov_576.769716	799	879	466	1	80	0.0125000
NODE_2826_length_1367_cov_576.769716	799	879	479	1	80	0.0125000
NODE_2826_length_1367_cov_576.769716	799	879	482	1	80	0.0125000
NODE_2826_length_1367_cov_576.769716	799	879	485	1	80	0.0125000
NODE_2826_length_1367_cov_576.769716	799	879	492	1	80	0.0125000
NODE_2826_length_1367_cov_576.769716	799	879	495	1	80	0.0125000
NODE_2826_length_1367_cov_576.769716	799	879	498	1	80	0.0125000
NODE_2826_length_1367_cov_576.769716	799	879	504	1	80	0.0125000
NODE_2826_length_1367_cov_576.769716	799	879	509	1	80	0.0125000
NODE_2826_length_1367_cov_576.769716	799	879	521	1	80	0.0125000
NODE_2826_length_1367_cov_576.769716	799	879	527	1	80	0.0125000
NODE_2826_length_1367_cov_576.769716	799	879	530	2	80	0.0250000
NODE_2826_length_1367_cov_576.769716	799	879	531	1	80	0.0125000
NODE_2826_length_1367_cov_576.769716	799	879	532	1	80	0.0125000
NODE_2826_length_1367_cov_576.769716	799	879	533	2	80	0.0250000
NODE_2826_length_1367_cov_576.769716	852	932	422	1	80	0.0125000
NODE_2826_length_1367_cov_576.769716	852	932	426	1	80	0.0125000
NODE_2826_length_1367_cov_576.769716	852	932	437	1	80	0.0125000
NODE_2826_length_1367_cov_576.769716	852	932	443	1	80	0.0125000
NODE_2826_length_1367_cov_576.769716	852	932	445	1	80	0.0125000
NODE_2826_length_1367_cov_576.769716	852	932	452	1	80	0.0125000
NODE_2826_length_1367_cov_576.769716	852	932	455	1	80	0.0125000
NODE_2826_length_1367_cov_576.769716	852	932	456	1	80	0.0125000
NODE_2826_length_1367_cov_576.769716	852	932	465	2	80	0.0250000
NODE_2826_length_1367_cov_576.769716	852	932	466	1	80	0.0125000
NODE_2826_length_1367_cov_576.769716	852	932	479	1	80	0.0125000
NODE_2826_length_1367_cov_576.769716	852	932	482	1	80	0.0125000
NODE_2826_length_1367_cov_576.769716	852	932	485	1	80	0.0125000
NODE_2826_length_1367_cov_576.769716	852	932	489	1	80	0.0125000
NODE_2826_length_1367_cov_576.769716	852	932	492	2	80	0.0250000
NODE_2826_length_1367_cov_576.769716	852	932	495	1	80	0.0125000
NODE_2826_length_1367_cov_576.769716	852	932	498	3	80	0.0375000
NODE_2826_length_1367_cov_576.769716	852	932	499	2	80	0.0250000
NODE_2826_length_1367_cov_576.769716	852	932	504	2	80	0.0250000
NODE_2826_length_1367_cov_576.769716	852	932	509	1	80	0.0125000
NODE_2826_length_1367_cov_576.769716	852	932	510	1	80	0.0125000
NODE_2826_length_1367_cov_576.769716	852	932	513	1	80	0.0125000
NODE_2826_length_1367_cov_576.769716	852	932	515	2	80	0.0250000
NODE_2826_length_1367_cov_576.769716	852	932	518	1	80	0.0125000
NODE_2826_length_1367_cov_576.769716	852	932	521	1	80	0.0125000
NODE_2826_length_1367_cov_576.769716	852	932	523	1	80	0.0125000
NODE_2826_length_1367_cov_576.769716	852	932	524	1	80	0.0125000
NODE_2826_length_1367_cov_576.769716	852	932	527	3	80	0.0375000
NODE_2826_length_1367_cov_576.769716	852	932	529	2	80	0.0250000
NODE_2826_length_1367_cov_576.769716	852	932	530	4	80	0.0500000
NODE_2826_length_1367_cov_576.769716	852	932	531	2	80	0.0250000
NODE_2826_length_1367_cov_576.769716	852	932	532	4	80	0.0500000
NODE_2826_length_1367_cov_576.769716	852	932	533	3	80	0.0375000
NODE_2826_length_1367_cov_576.769716	852	932	534	1	80	0.0125000
NODE_2826_length_1367_cov_576.769716	852	932	535	1	80	0.0125000
NODE_2826_length_1367_cov_576.769716	852	932	536	2	80	0.0250000
NODE_2826_length_1367_cov_576.769716	852	932	538	2	80	0.0250000
NODE_2826_length_1367_cov_576.769716	852	932	539	2	80	0.0250000
NODE_2826_length_1367_cov_576.769716	852	932	540	1	80	0.0125000
NODE_2826_length_1367_cov_576.769716	852	932	542	4	80	0.0500000
NODE_2826_length_1367_cov_576.769716	852	932	543	1	80	0.0125000
NODE_2826_length_1367_cov_576.769716	852	932	544	2	80	0.0250000
NODE_2826_length_1367_cov_576.769716	852	932	545	2	80	0.0250000
NODE_2826_length_1367_cov_576.769716	852	932	546	2	80	0.0250000
NODE_2826_length_1367_cov_576.769716	852	932	547	2	80	0.0250000
NODE_2826_length_1367_cov_576.769716	852	932	548	2	80	0.0250000
NODE_2826_length_1367_cov_576.769716	852	932	550	2	80	0.0250000
NODE_2826_length_1367_cov_576.769716	852	932	551	2	80	0.0250000
NODE_2826_length_1367_cov_576.769716	900	980	421	1	80	0.0125000
NODE_2826_length_1367_cov_576.769716	900	980	424	1	80	0.0125000
NODE_2826_length_1367_cov_576.769716	900	980	435	1	80	0.0125000
NODE_2826_length_1367_cov_576.769716	900	980	446	1	80	0.0125000
NODE_2826_length_1367_cov_576.769716	900	980	449	2	80	0.0250000
NODE_2826_length_1367_cov_576.769716	900	980	451	2	80	0.0250000
NODE_2826_length_1367_cov_576.769716	900	980	452	1	80	0.0125000
NODE_2826_length_1367_cov_576.769716	900	980	453	5	80	0.0625000
NODE_2826_length_1367_cov_576.769716	900	980	454	1	80	0.0125000
NODE_2826_length_1367_cov_576.769716	900	980	455	5	80	0.0625000
NODE_2826_length_1367_cov_576.769716	900	980	456	3	80	0.0375000
NODE_2826_length_1367_cov_576.769716	900	980	457	3	80	0.0375000
NODE_2826_length_1367_cov_576.769716	900	980	458	6	80	0.0750000
NODE_2826_length_1367_cov_576.769716	900	980	459	4	80	0.0500000
NODE_2826_length_1367_cov_576.769716	900	980	460	4	80	0.0500000
NODE_2826_length_1367_cov_576.769716	900	980	461	1	80	0.0125000
NODE_2826_length_1367_cov_576.769716	900	980	462	1	80	0.0125000
NODE_2826_length_1367_cov_576.769716	900	980	466	1	80	0.0125000
NODE_2826_length_1367_cov_576.769716	900	980	468	1	80	0.0125000
NODE_2826_length_1367_cov_576.769716	900	980	477	1	80	0.0125000
NODE_2826_length_1367_cov_576.769716	900	980	478	1	80	0.0125000
NODE_2826_length_1367_cov_576.769716	900	980	484	1	80	0.0125000
NODE_2826_length_1367_cov_576.769716	900	980	485	1	80	0.0125000
NODE_2826_length_1367_cov_576.769716	900	980	489	1	80	0.0125000
NODE_2826_length_1367_cov_576.769716	900	980	492	1	80	0.0125000
NODE_2826_length_1367_cov_576.769716	900	980	498	2	80	0.0250000
NODE_2826_length_1367_cov_576.769716	900	980	499	2	80	0.0250000
NODE_2826_length_1367_cov_576.769716	900	980	504	1	80	0.0125000
NODE_2826_length_1367_cov_576.769716	900	980	510	1	80	0.0125000
NODE_2826_length_1367_cov_576.769716	900	980	513	1	80	0.0125000
NODE_2826_length_1367_cov_576.769716	900	980	515	2	80	0.0250000
NODE_2826_length_1367_cov_576.769716	900	980	518	1	80	0.0125000
NODE_2826_length_1367_cov_576.769716	900	980	523	1	80	0.0125000
NODE_2826_length_1367_cov_576.769716	900	980	524	1	80	0.0125000
NODE_2826_length_1367_cov_576.769716	900	980	527	2	80	0.0250000
NODE_2826_length_1367_cov_576.769716	900	980	530	1	80	0.0125000
NODE_2826_length_1367_cov_576.769716	900	980	532	1	80	0.0125000
NODE_2826_length_1367_cov_576.769716	900	980	534	1	80	0.0125000
NODE_2826_length_1367_cov_576.769716	900	980	538	1	80	0.0125000
NODE_2826_length_1367_cov_576.769716	900	980	542	2	80	0.0250000
NODE_2826_length_1367_cov_576.769716	900	980	543	1	80	0.0125000
NODE_2826_length_1367_cov_576.769716	900	980	544	1	80	0.0125000
NODE_2826_length_1367_cov_576.769716	900	980	545	2	80	0.0250000
NODE_2826_length_1367_cov_576.769716	900	980	546	2	80	0.0250000
NODE_2826_length_1367_cov_576.769716	900	980	547	1	80	0.0125000
NODE_2826_length_1367_cov_576.769716	900	980	548	1	80	0.0125000
NODE_2826_length_1367_cov_576.769716	900	980	550	1	80	0.0125000
NODE_2826_length_1367_cov_576.769716	900	980	551	1	80	0.0125000
NODE_2826_length_1367_cov_576.769716	905	927	499	1	22	0.0454545
NODE_2826_length_1367_cov_576.769716	905	927	504	1	22	0.0454545
NODE_2826_length_1367_cov_576.769716	905	927	510	1	22	0.0454545
NODE_2826_length_1367_cov_576.769716	905	927	513	1	22	0.0454545
NODE_2826_length_1367_cov_576.769716	905	927	515	2	22	0.0909091
NODE_2826_length_1367_cov_576.769716	905	927	518	1	22	0.0454545
NODE_2826_length_1367_cov_576.769716	905	927	523	1	22	0.0454545
NODE_2826_length_1367_cov_576.769716	905	927	524	1	22	0.0454545
NODE_2826_length_1367_cov_576.769716	905	927	527	2	22	0.0909091
NODE_2826_length_1367_cov_576.769716	905	927	530	1	22	0.0454545
NODE_2826_length_1367_cov_576.769716	905	927	532	1	22	0.0454545
NODE_2826_length_1367_cov_576.769716	905	927	534	1	22	0.0454545
NODE_2826_length_1367_cov_576.769716	905	927	538	1	22	0.0454545
NODE_2826_length_1367_cov_576.769716	905	927	542	1	22	0.0454545
NODE_2826_length_1367_cov_576.769716	905	927	543	1	22	0.0454545
NODE_2826_length_1367_cov_576.769716	905	927	544	1	22	0.0454545
NODE_2826_length_1367_cov_576.769716	905	927	545	2	22	0.0909091
NODE_2826_length_1367_cov_576.769716	905	927	546	1	22	0.0454545
NODE_2826_length_1367_cov_576.769716	905	927	547	1	22	0.0454545
NODE_2826_length_1367_cov_576.769716	1051	1131	297	1	80	0.0125000
NODE_2826_length_1367_cov_576.769716	1051	1131	298	2	80	0.0250000
NODE_2826_length_1367_cov_576.769716	1051	1131	299	1	80	0.0125000
NODE_2826_length_1367_cov_576.769716	1051	1131	300	7	80	0.0875000
NODE_2826_length_1367_cov_576.769716	1051	1131	301	4	80	0.0500000
NODE_2826_length_1367_cov_576.769716	1051	1131	302	2	80	0.0250000
NODE_2826_length_1367_cov_576.769716	1051	1131	303	5	80	0.0625000
NODE_2826_length_1367_cov_576.769716	1051	1131	304	2	80	0.0250000
NODE_2826_length_1367_cov_576.769716	1051	1131	305	1	80	0.0125000
NODE_2826_length_1367_cov_576.769716	1051	1131	311	1	80	0.0125000
NODE_2826_length_1367_cov_576.769716	1051	1131	314	1	80	0.0125000
NODE_2826_length_1367_cov_576.769716	1051	1131	315	1	80	0.0125000
NODE_2826_length_1367_cov_576.769716	1051	1131	318	1	80	0.0125000
NODE_2826_length_1367_cov_576.769716	1051	1131	321	1	80	0.0125000
NODE_2826_length_1367_cov_576.769716	1051	1131	322	1	80	0.0125000
NODE_2826_length_1367_cov_576.769716	1051	1131	328	1	80	0.0125000
NODE_2826_length_1367_cov_576.769716	1051	1131	329	2	80	0.0250000
NODE_2826_length_1367_cov_576.769716	1051	1131	331	2	80	0.0250000
NODE_2826_length_1367_cov_576.769716	1051	1131	332	1	80	0.0125000
NODE_2826_length_1367_cov_576.769716	1051	1131	334	2	80	0.0250000
NODE_2826_length_1367_cov_576.769716	1051	1131	335	2	80	0.0250000
NODE_2826_length_1367_cov_576.769716	1051	1131	337	2	80	0.0250000
NODE_2826_length_1367_cov_576.769716	1051	1131	338	1	80	0.0125000
NODE_2826_length_1367_cov_576.769716	1051	1131	339	1	80	0.0125000
NODE_2826_length_1367_cov_576.769716	1051	1131	340	4	80	0.0500000
NODE_2826_length_1367_cov_576.769716	1051	1131	341	3	80	0.0375000
NODE_2826_length_1367_cov_576.769716	1051	1131	342	5	80	0.0625000
NODE_2826_length_1367_cov_576.769716	1051	1131	344	4	80	0.0500000
NODE_2826_length_1367_cov_576.769716	1051	1131	345	3	80	0.0375000
NODE_2826_length_1367_cov_576.769716	1051	1131	346	3	80	0.0375000
NODE_2826_length_1367_cov_576.769716	1051	1131	347	2	80	0.0250000
NODE_2826_length_1367_cov_576.769716	1051	1131	349	1	80	0.0125000
NODE_2826_length_1367_cov_576.769716	1051	1131	350	2	80	0.0250000
NODE_2826_length_1367_cov_576.769716	1051	1131	352	1	80	0.0125000
NODE_2826_length_1367_cov_576.769716	1051	1131	353	3	80	0.0375000
NODE_2826_length_1367_cov_576.769716	1051	1131	354	2	80	0.0250000
NODE_2826_length_1367_cov_576.769716	1051	1131	355	1	80	0.0125000
NODE_2826_length_1367_cov_576.769716	1051	1131	357	1	80	0.0125000
NODE_2826_length_1367_cov_576.769716	1104	1184	329	1	80	0.0125000
NODE_2826_length_1367_cov_576.769716	1104	1184	331	2	80	0.0250000
NODE_2826_length_1367_cov_576.769716	1104	1184	332	1	80	0.0125000
NODE_2826_length_1367_cov_576.769716	1104	1184	334	1	80	0.0125000
NODE_2826_length_1367_cov_576.769716	1104	1184	335	1	80	0.0125000
NODE_2826_length_1367_cov_576.769716	1104	1184	340	2	80	0.0250000
NODE_2826_length_1367_cov_576.769716	1104	1184	341	1	80	0.0125000
NODE_2826_length_1367_cov_576.769716	1104	1184	342	4	80	0.0500000
NODE_2826_length_1367_cov_576.769716	1104	1184	343	2	80	0.0250000
NODE_2826_length_1367_cov_576.769716	1104	1184	344	3	80	0.0375000
NODE_2826_length_1367_cov_576.769716	1104	1184	345	1	80	0.0125000
NODE_2826_length_1367_cov_576.769716	1104	1184	346	3	80	0.0375000
NODE_2826_length_1367_cov_576.769716	1104	1184	347	2	80	0.0250000
NODE_2826_length_1367_cov_576.769716	1104	1184	348	1	80	0.0125000
NODE_2826_length_1367_cov_576.769716	1104	1184	349	4	80	0.0500000
NODE_2826_length_1367_cov_576.769716	1104	1184	350	2	80	0.0250000
NODE_2826_length_1367_cov_576.769716	1104	1184	351	3	80	0.0375000
NODE_2826_length_1367_cov_576.769716	1104	1184	352	3	80	0.0375000
NODE_2826_length_1367_cov_576.769716	1104	1184	353	3	80	0.0375000
NODE_2826_length_1367_cov_576.769716	1104	1184	354	4	80	0.0500000
NODE_2826_length_1367_cov_576.769716	1104	1184	355	1	80	0.0125000
NODE_2826_length_1367_cov_576.769716	1104	1184	356	1	80	0.0125000
NODE_2826_length_1367_cov_576.769716	1104	1184	357	1	80	0.0125000
NODE_2826_length_1367_cov_576.769716	1104	1184	358	3	80	0.0375000
NODE_2826_length_1367_cov_576.769716	1104	1184	360	2	80	0.0250000
NODE_2826_length_1367_cov_576.769716	1104	1184	361	1	80	0.0125000
NODE_2826_length_1367_cov_576.769716	1104	1184	362	4	80	0.0500000
NODE_2826_length_1367_cov_576.769716	1104	1184	363	2	80	0.0250000
NODE_2826_length_1367_cov_576.769716	1104	1184	364	5	80	0.0625000
NODE_2826_length_1367_cov_576.769716	1104	1184	365	7	80	0.0875000
NODE_2826_length_1367_cov_576.769716	1104	1184	366	3	80	0.0375000
NODE_2826_length_1367_cov_576.769716	1104	1184	368	2	80	0.0250000
NODE_2826_length_1367_cov_576.769716	1104	1184	369	1	80	0.0125000
NODE_2826_length_1367_cov_576.769716	1104	1184	370	2	80	0.0250000
NODE_2826_length_1367_cov_576.769716	1104	1184	371	1	80	0.0125000
NODE_2827_length_1367_cov_152.824921	513	593	12	9	80	0.1125000
NODE_2827_length_1367_cov_152.824921	513	593	14	20	80	0.2500000
NODE_2827_length_1367_cov_152.824921	513	593	15	51	80	0.6375000
NODE_2827_length_1367_cov_152.824921	566	646	3	6	80	0.0750000
NODE_2827_length_1367_cov_152.824921	566	646	4	26	80	0.3250000
NODE_2827_length_1367_cov_152.824921	566	646	5	4	80	0.0500000
NODE_2827_length_1367_cov_152.824921	566	646	6	1	80	0.0125000
NODE_2827_length_1367_cov_152.824921	566	646	8	1	80	0.0125000
NODE_2827_length_1367_cov_152.824921	566	646	9	7	80	0.0875000
NODE_2827_length_1367_cov_152.824921	566	646	10	4	80	0.0500000
NODE_2827_length_1367_cov_152.824921	566	646	14	16	80	0.2000000
NODE_2827_length_1367_cov_152.824921	566	646	15	15	80	0.1875000
NODE_2827_length_1367_cov_152.824921	642	722	2	3	80	0.0375000
NODE_2827_length_1367_cov_152.824921	642	722	3	36	80	0.4500000
NODE_2827_length_1367_cov_152.824921	642	722	4	14	80	0.1750000
NODE_2827_length_1367_cov_152.824921	642	722	5	27	80	0.3375000
NODE_2827_length_1367_cov_152.824921	695	775	3	46	80	0.5750000
NODE_2827_length_1367_cov_152.824921	695	775	4	7	80	0.0875000
NODE_2827_length_1367_cov_152.824921	695	775	5	27	80	0.3375000
NODE_2829_length_1367_cov_2.947161	250	326	8	40	76	0.5263158
NODE_2829_length_1367_cov_2.947161	250	326	9	16	76	0.2105263
NODE_2829_length_1367_cov_2.947161	250	326	10	20	76	0.2631579
NODE_2831_length_1366_cov_82.742699	198	278	0	71	80	0.8875000
NODE_2831_length_1366_cov_82.742699	198	278	1	9	80	0.1125000
NODE_2831_length_1366_cov_82.742699	251	331	0	18	80	0.2250000
NODE_2831_length_1366_cov_82.742699	251	331	1	35	80	0.4375000
NODE_2831_length_1366_cov_82.742699	251	331	2	24	80	0.3000000
NODE_2831_length_1366_cov_82.742699	251	331	3	3	80	0.0375000
NODE_2832_length_1366_cov_36.659037	577	657	1	41	80	0.5125000
NODE_2832_length_1366_cov_36.659037	577	657	2	39	80	0.4875000
NODE_2832_length_1366_cov_36.659037	630	710	1	18	80	0.2250000
NODE_2832_length_1366_cov_36.659037	630	710	2	62	80	0.7750000
NODE_2834_length_1366_cov_2.320442	47	116	0	69	69	1.0000000
NODE_2834_length_1366_cov_2.320442	1122	1202	2	45	80	0.5625000
NODE_2834_length_1366_cov_2.320442	1122	1202	3	1	80	0.0125000
NODE_2834_length_1366_cov_2.320442	1122	1202	4	1	80	0.0125000
NODE_2834_length_1366_cov_2.320442	1122	1202	5	2	80	0.0250000
NODE_2834_length_1366_cov_2.320442	1122	1202	7	6	80	0.0750000
NODE_2834_length_1366_cov_2.320442	1122	1202	8	2	80	0.0250000
NODE_2834_length_1366_cov_2.320442	1122	1202	9	2	80	0.0250000
NODE_2834_length_1366_cov_2.320442	1122	1202	10	3	80	0.0375000
NODE_2834_length_1366_cov_2.320442	1122	1202	11	18	80	0.2250000
NODE_2834_length_1366_cov_2.320442	1175	1255	7	2	80	0.0250000
NODE_2834_length_1366_cov_2.320442	1175	1255	8	2	80	0.0250000
NODE_2834_length_1366_cov_2.320442	1175	1255	9	2	80	0.0250000
NODE_2834_length_1366_cov_2.320442	1175	1255	10	3	80	0.0375000
NODE_2834_length_1366_cov_2.320442	1175	1255	11	18	80	0.2250000
NODE_2834_length_1366_cov_2.320442	1175	1255	13	8	80	0.1000000
NODE_2834_length_1366_cov_2.320442	1175	1255	15	4	80	0.0500000
NODE_2834_length_1366_cov_2.320442	1175	1255	17	1	80	0.0125000
NODE_2834_length_1366_cov_2.320442	1175	1255	20	2	80	0.0250000
NODE_2834_length_1366_cov_2.320442	1175	1255	22	1	80	0.0125000
NODE_2834_length_1366_cov_2.320442	1175	1255	23	4	80	0.0500000
NODE_2834_length_1366_cov_2.320442	1175	1255	24	10	80	0.1250000
NODE_2834_length_1366_cov_2.320442	1175	1255	25	1	80	0.0125000
NODE_2834_length_1366_cov_2.320442	1175	1255	26	4	80	0.0500000
NODE_2834_length_1366_cov_2.320442	1175	1255	28	4	80	0.0500000
NODE_2834_length_1366_cov_2.320442	1175	1255	30	9	80	0.1125000
NODE_2834_length_1366_cov_2.320442	1175	1255	32	2	80	0.0250000
NODE_2834_length_1366_cov_2.320442	1175	1255	34	3	80	0.0375000
NODE_2834_length_1366_cov_2.320442	1251	1331	21	2	80	0.0250000
NODE_2834_length_1366_cov_2.320442	1251	1331	22	1	80	0.0125000
NODE_2834_length_1366_cov_2.320442	1251	1331	24	1	80	0.0125000
NODE_2834_length_1366_cov_2.320442	1251	1331	26	5	80	0.0625000
NODE_2834_length_1366_cov_2.320442	1251	1331	27	4	80	0.0500000
NODE_2834_length_1366_cov_2.320442	1251	1331	31	3	80	0.0375000
NODE_2834_length_1366_cov_2.320442	1251	1331	32	1	80	0.0125000
NODE_2834_length_1366_cov_2.320442	1251	1331	33	21	80	0.2625000
NODE_2834_length_1366_cov_2.320442	1251	1331	34	42	80	0.5250000
NODE_2835_length_1365_cov_25.540284	432	509	3	64	77	0.8311688
NODE_2835_length_1365_cov_25.540284	432	509	4	13	77	0.1688312
NODE_2835_length_1365_cov_25.540284	482	562	3	17	80	0.2125000
NODE_2835_length_1365_cov_25.540284	482	562	4	55	80	0.6875000
NODE_2835_length_1365_cov_25.540284	482	562	5	8	80	0.1000000
NODE_2835_length_1365_cov_25.540284	558	635	3	5	77	0.0649351
NODE_2835_length_1365_cov_25.540284	558	635	4	35	77	0.4545455
NODE_2835_length_1365_cov_25.540284	558	635	5	27	77	0.3506494
NODE_2835_length_1365_cov_25.540284	558	635	6	10	77	0.1298701
NODE_2835_length_1365_cov_25.540284	625	688	3	2	63	0.0317460
NODE_2835_length_1365_cov_25.540284	625	688	4	7	63	0.1111111
NODE_2835_length_1365_cov_25.540284	625	688	5	32	63	0.5079365
NODE_2835_length_1365_cov_25.540284	625	688	6	22	63	0.3492064
NODE_2838_length_1364_cov_15.222134	120	191	6	4	71	0.0563380
NODE_2838_length_1364_cov_15.222134	120	191	7	20	71	0.2816902
NODE_2838_length_1364_cov_15.222134	120	191	8	5	71	0.0704225
NODE_2838_length_1364_cov_15.222134	120	191	9	3	71	0.0422535
NODE_2838_length_1364_cov_15.222134	120	191	10	1	71	0.0140845
NODE_2838_length_1364_cov_15.222134	120	191	11	1	71	0.0140845
NODE_2838_length_1364_cov_15.222134	120	191	12	4	71	0.0563380
NODE_2838_length_1364_cov_15.222134	120	191	18	1	71	0.0140845
NODE_2838_length_1364_cov_15.222134	120	191	20	2	71	0.0281690
NODE_2838_length_1364_cov_15.222134	120	191	21	2	71	0.0281690
NODE_2838_length_1364_cov_15.222134	120	191	22	1	71	0.0140845
NODE_2838_length_1364_cov_15.222134	120	191	23	8	71	0.1126761
NODE_2838_length_1364_cov_15.222134	120	191	29	19	71	0.2676056
NODE_2839_length_1364_cov_7.456917	843	923	2	80	80	1.0000000
NODE_2839_length_1364_cov_7.456917	896	976	0	13	80	0.1625000
NODE_2839_length_1364_cov_7.456917	896	976	2	67	80	0.8375000
NODE_2840_length_1364_cov_5.055336	239	290	2	51	51	1.0000000
NODE_2840_length_1364_cov_5.055336	263	343	2	80	80	1.0000000
NODE_2846_length_1363_cov_19.442247	615	695	1	40	80	0.5000000
NODE_2846_length_1363_cov_19.442247	615	695	2	40	80	0.5000000
NODE_2846_length_1363_cov_19.442247	668	748	1	11	80	0.1375000
NODE_2846_length_1363_cov_19.442247	668	748	2	69	80	0.8625000
NODE_2847_length_1363_cov_13.575949	619	699	6	14	80	0.1750000
NODE_2847_length_1363_cov_13.575949	619	699	8	66	80	0.8250000
NODE_2847_length_1363_cov_13.575949	672	752	3	3	80	0.0375000
NODE_2847_length_1363_cov_13.575949	672	752	4	17	80	0.2125000
NODE_2847_length_1363_cov_13.575949	672	752	6	47	80	0.5875000
NODE_2847_length_1363_cov_13.575949	672	752	8	13	80	0.1625000
NODE_2850_length_1362_cov_15.796516	898	978	0	57	80	0.7125000
NODE_2850_length_1362_cov_15.796516	898	978	2	23	80	0.2875000
NODE_2850_length_1362_cov_15.796516	951	1031	0	4	80	0.0500000
NODE_2850_length_1362_cov_15.796516	951	1031	2	39	80	0.4875000
NODE_2850_length_1362_cov_15.796516	951	1031	3	37	80	0.4625000
NODE_2855_length_1361_cov_24.574485	528	608	5	7	80	0.0875000
NODE_2855_length_1361_cov_24.574485	528	608	6	25	80	0.3125000
NODE_2855_length_1361_cov_24.574485	528	608	7	1	80	0.0125000
NODE_2855_length_1361_cov_24.574485	528	608	8	6	80	0.0750000
NODE_2855_length_1361_cov_24.574485	528	608	9	2	80	0.0250000
NODE_2855_length_1361_cov_24.574485	528	608	10	39	80	0.4875000
NODE_2855_length_1361_cov_24.574485	581	661	7	29	80	0.3625000
NODE_2855_length_1361_cov_24.574485	581	661	8	29	80	0.3625000
NODE_2855_length_1361_cov_24.574485	581	661	10	22	80	0.2750000
NODE_2856_length_1361_cov_20.148970	866	946	2	31	80	0.3875000
NODE_2856_length_1361_cov_20.148970	866	946	3	36	80	0.4500000
NODE_2856_length_1361_cov_20.148970	866	946	4	13	80	0.1625000
NODE_2856_length_1361_cov_20.148970	919	999	2	1	80	0.0125000
NODE_2856_length_1361_cov_20.148970	919	999	3	66	80	0.8250000
NODE_2856_length_1361_cov_20.148970	919	999	4	13	80	0.1625000
NODE_2858_length_1361_cov_10.530903	1139	1219	6	1	80	0.0125000
NODE_2858_length_1361_cov_10.530903	1139	1219	7	24	80	0.3000000
NODE_2858_length_1361_cov_10.530903	1139	1219	8	10	80	0.1250000
NODE_2858_length_1361_cov_10.530903	1139	1219	9	36	80	0.4500000
NODE_2858_length_1361_cov_10.530903	1139	1219	10	9	80	0.1125000
NODE_2858_length_1361_cov_10.530903	1139	1219	6	1	80	0.0125000
NODE_2858_length_1361_cov_10.530903	1139	1219	7	24	80	0.3000000
NODE_2858_length_1361_cov_10.530903	1139	1219	8	10	80	0.1250000
NODE_2858_length_1361_cov_10.530903	1139	1219	9	36	80	0.4500000
NODE_2858_length_1361_cov_10.530903	1139	1219	10	9	80	0.1125000
NODE_2858_length_1361_cov_10.530903	1192	1277	3	18	85	0.2117647
NODE_2858_length_1361_cov_10.530903	1192	1277	4	14	85	0.1647059
NODE_2858_length_1361_cov_10.530903	1192	1277	5	10	85	0.1176471
NODE_2858_length_1361_cov_10.530903	1192	1277	6	1	85	0.0117647
NODE_2858_length_1361_cov_10.530903	1192	1277	7	40	85	0.4705882
NODE_2858_length_1361_cov_10.530903	1192	1277	8	2	85	0.0235294
NODE_2858_length_1361_cov_10.530903	1273	1353	1	26	80	0.3250000
NODE_2858_length_1361_cov_10.530903	1273	1353	2	40	80	0.5000000
NODE_2858_length_1361_cov_10.530903	1273	1353	3	14	80	0.1750000
NODE_2858_length_1361_cov_10.530903	1273	1353	1	26	80	0.3250000
NODE_2858_length_1361_cov_10.530903	1273	1353	2	40	80	0.5000000
NODE_2858_length_1361_cov_10.530903	1273	1353	3	14	80	0.1750000
NODE_2858_length_1361_cov_10.530903	1273	1353	1	26	80	0.3250000
NODE_2858_length_1361_cov_10.530903	1273	1353	2	40	80	0.5000000
NODE_2858_length_1361_cov_10.530903	1273	1353	3	14	80	0.1750000
NODE_2858_length_1361_cov_10.530903	1273	1353	1	26	80	0.3250000
NODE_2858_length_1361_cov_10.530903	1273	1353	2	40	80	0.5000000
NODE_2858_length_1361_cov_10.530903	1273	1353	3	14	80	0.1750000
NODE_2858_length_1361_cov_10.530903	1273	1353	1	26	80	0.3250000
NODE_2858_length_1361_cov_10.530903	1273	1353	2	40	80	0.5000000
NODE_2858_length_1361_cov_10.530903	1273	1353	3	14	80	0.1750000
NODE_2858_length_1361_cov_10.530903	1273	1353	1	26	80	0.3250000
NODE_2858_length_1361_cov_10.530903	1273	1353	2	40	80	0.5000000
NODE_2858_length_1361_cov_10.530903	1273	1353	3	14	80	0.1750000
NODE_2859_length_1360_cov_42.789056	351	431	2	15	80	0.1875000
NODE_2859_length_1360_cov_42.789056	351	431	4	30	80	0.3750000
NODE_2859_length_1360_cov_42.789056	351	431	5	35	80	0.4375000
NODE_2859_length_1360_cov_42.789056	404	484	4	10	80	0.1250000
NODE_2859_length_1360_cov_42.789056	404	484	5	46	80	0.5750000
NODE_2859_length_1360_cov_42.789056	404	484	6	24	80	0.3000000
NODE_2860_length_1360_cov_26.407613	531	611	2	46	80	0.5750000
NODE_2860_length_1360_cov_26.407613	531	611	3	30	80	0.3750000
NODE_2860_length_1360_cov_26.407613	531	611	4	4	80	0.0500000
NODE_2860_length_1360_cov_26.407613	584	669	2	37	85	0.4352941
NODE_2860_length_1360_cov_26.407613	584	669	3	36	85	0.4235294
NODE_2860_length_1360_cov_26.407613	584	669	4	12	85	0.1411765
NODE_2861_length_1360_cov_16.182395	796	876	2	23	80	0.2875000
NODE_2861_length_1360_cov_16.182395	796	876	4	29	80	0.3625000
NODE_2861_length_1360_cov_16.182395	796	876	5	28	80	0.3500000
NODE_2861_length_1360_cov_16.182395	849	929	4	34	80	0.4250000
NODE_2861_length_1360_cov_16.182395	849	929	5	46	80	0.5750000
NODE_2861_length_1360_cov_16.182395	925	1005	3	25	80	0.3125000
NODE_2861_length_1360_cov_16.182395	925	1005	4	54	80	0.6750000
NODE_2861_length_1360_cov_16.182395	925	1005	5	1	80	0.0125000
NODE_2861_length_1360_cov_16.182395	978	1058	2	29	80	0.3625000
NODE_2861_length_1360_cov_16.182395	978	1058	3	48	80	0.6000000
NODE_2861_length_1360_cov_16.182395	978	1058	4	3	80	0.0375000
NODE_2862_length_1360_cov_12.763680	582	662	0	80	80	1.0000000
NODE_2862_length_1360_cov_12.763680	635	715	0	80	80	1.0000000
NODE_2866_length_1359_cov_41.324603	674	754	4	71	80	0.8875000
NODE_2866_length_1359_cov_41.324603	674	754	5	9	80	0.1125000
NODE_2866_length_1359_cov_41.324603	727	807	3	4	80	0.0500000
NODE_2866_length_1359_cov_41.324603	727	807	4	63	80	0.7875000
NODE_2866_length_1359_cov_41.324603	727	807	5	13	80	0.1625000
NODE_2866_length_1359_cov_41.324603	803	883	3	22	80	0.2750000
NODE_2866_length_1359_cov_41.324603	803	883	4	46	80	0.5750000
NODE_2866_length_1359_cov_41.324603	803	883	5	10	80	0.1250000
NODE_2866_length_1359_cov_41.324603	803	883	6	2	80	0.0250000
NODE_2866_length_1359_cov_41.324603	856	936	3	25	80	0.3125000
NODE_2866_length_1359_cov_41.324603	856	936	4	55	80	0.6875000
NODE_2871_length_1358_cov_23.427323	292	372	1	66	80	0.8250000
NODE_2871_length_1358_cov_23.427323	292	372	2	12	80	0.1500000
NODE_2871_length_1358_cov_23.427323	292	372	3	2	80	0.0250000
NODE_2871_length_1358_cov_23.427323	345	425	1	13	80	0.1625000
NODE_2871_length_1358_cov_23.427323	345	425	2	19	80	0.2375000
NODE_2871_length_1358_cov_23.427323	345	425	3	48	80	0.6000000
NODE_2872_length_1358_cov_19.489277	411	491	1	16	80	0.2000000
NODE_2872_length_1358_cov_19.489277	411	491	2	64	80	0.8000000
NODE_2872_length_1358_cov_19.489277	464	544	1	69	80	0.8625000
NODE_2872_length_1358_cov_19.489277	464	544	2	11	80	0.1375000
NODE_2875_length_1357_cov_15.962639	732	812	1	76	80	0.9500000
NODE_2875_length_1357_cov_15.962639	732	812	2	4	80	0.0500000
NODE_2875_length_1357_cov_15.962639	785	865	0	34	80	0.4250000
NODE_2875_length_1357_cov_15.962639	785	865	1	46	80	0.5750000
NODE_2879_length_1354_cov_9.854980	735	815	0	74	80	0.9250000
NODE_2879_length_1354_cov_9.854980	735	815	1	6	80	0.0750000
NODE_2879_length_1354_cov_9.854980	788	868	0	66	80	0.8250000
NODE_2879_length_1354_cov_9.854980	788	868	2	14	80	0.1750000
NODE_2882_length_1353_cov_32.982456	708	788	7	18	80	0.2250000
NODE_2882_length_1353_cov_32.982456	708	788	8	12	80	0.1500000
NODE_2882_length_1353_cov_32.982456	708	788	9	30	80	0.3750000
NODE_2882_length_1353_cov_32.982456	708	788	10	20	80	0.2500000
NODE_2882_length_1353_cov_32.982456	761	841	2	1	80	0.0125000
NODE_2882_length_1353_cov_32.982456	761	841	3	20	80	0.2500000
NODE_2882_length_1353_cov_32.982456	761	841	4	9	80	0.1125000
NODE_2882_length_1353_cov_32.982456	761	841	7	2	80	0.0250000
NODE_2882_length_1353_cov_32.982456	761	841	9	48	80	0.6000000
NODE_2883_length_1353_cov_21.775120	493	573	6	3	80	0.0375000
NODE_2883_length_1353_cov_21.775120	493	573	7	27	80	0.3375000
NODE_2883_length_1353_cov_21.775120	493	573	8	42	80	0.5250000
NODE_2883_length_1353_cov_21.775120	493	573	9	8	80	0.1000000
NODE_2883_length_1353_cov_21.775120	546	626	5	8	80	0.1000000
NODE_2883_length_1353_cov_21.775120	546	626	6	25	80	0.3125000
NODE_2883_length_1353_cov_21.775120	546	626	7	30	80	0.3750000
NODE_2883_length_1353_cov_21.775120	546	626	8	17	80	0.2125000
NODE_2884_length_1353_cov_18.201754	696	776	1	3	80	0.0375000
NODE_2884_length_1353_cov_18.201754	696	776	2	9	80	0.1125000
NODE_2884_length_1353_cov_18.201754	696	776	3	18	80	0.2250000
NODE_2884_length_1353_cov_18.201754	696	776	4	50	80	0.6250000
NODE_2884_length_1353_cov_18.201754	749	829	0	52	80	0.6500000
NODE_2884_length_1353_cov_18.201754	749	829	1	4	80	0.0500000
NODE_2884_length_1353_cov_18.201754	749	829	2	9	80	0.1125000
NODE_2884_length_1353_cov_18.201754	749	829	3	15	80	0.1875000
NODE_2888_length_1352_cov_26.942538	455	535	1	10	80	0.1250000
NODE_2888_length_1352_cov_26.942538	455	535	2	30	80	0.3750000
NODE_2888_length_1352_cov_26.942538	455	535	3	20	80	0.2500000
NODE_2888_length_1352_cov_26.942538	455	535	4	20	80	0.2500000
NODE_2888_length_1352_cov_26.942538	508	588	2	5	80	0.0625000
NODE_2888_length_1352_cov_26.942538	508	588	3	15	80	0.1875000
NODE_2888_length_1352_cov_26.942538	508	588	4	60	80	0.7500000
NODE_2889_length_1352_cov_17.189944	717	797	0	1	80	0.0125000
NODE_2889_length_1352_cov_17.189944	717	797	1	27	80	0.3375000
NODE_2889_length_1352_cov_17.189944	717	797	2	30	80	0.3750000
NODE_2889_length_1352_cov_17.189944	717	797	3	22	80	0.2750000
NODE_2889_length_1352_cov_17.189944	770	850	2	5	80	0.0625000
NODE_2889_length_1352_cov_17.189944	770	850	3	46	80	0.5750000
NODE_2889_length_1352_cov_17.189944	770	850	5	29	80	0.3625000
NODE_2890_length_1352_cov_15.752594	640	720	0	80	80	1.0000000
NODE_2890_length_1352_cov_15.752594	693	773	0	80	80	1.0000000
NODE_2891_length_1352_cov_10.699920	237	317	0	56	80	0.7000000
NODE_2891_length_1352_cov_10.699920	237	317	2	24	80	0.3000000
NODE_2891_length_1352_cov_10.699920	290	370	0	19	80	0.2375000
NODE_2891_length_1352_cov_10.699920	290	370	2	61	80	0.7625000
NODE_2894_length_1351_cov_32.325879	561	641	5	2	80	0.0250000
NODE_2894_length_1351_cov_32.325879	561	641	6	11	80	0.1375000
NODE_2894_length_1351_cov_32.325879	561	641	7	26	80	0.3250000
NODE_2894_length_1351_cov_32.325879	561	641	8	41	80	0.5125000
NODE_2894_length_1351_cov_32.325879	614	694	6	4	80	0.0500000
NODE_2894_length_1351_cov_32.325879	614	694	7	33	80	0.4125000
NODE_2894_length_1351_cov_32.325879	614	694	8	43	80	0.5375000
NODE_2895_length_1351_cov_16.861022	97	162	3	2	65	0.0307692
NODE_2895_length_1351_cov_16.861022	97	162	5	2	65	0.0307692
NODE_2895_length_1351_cov_16.861022	97	162	7	4	65	0.0615385
NODE_2895_length_1351_cov_16.861022	97	162	9	2	65	0.0307692
NODE_2895_length_1351_cov_16.861022	97	162	13	1	65	0.0153846
NODE_2895_length_1351_cov_16.861022	97	162	14	8	65	0.1230769
NODE_2895_length_1351_cov_16.861022	97	162	16	3	65	0.0461538
NODE_2895_length_1351_cov_16.861022	97	162	18	20	65	0.3076923
NODE_2895_length_1351_cov_16.861022	97	162	22	23	65	0.3538462
NODE_2896_length_1351_cov_9.894569	331	411	0	80	80	1.0000000
NODE_2896_length_1351_cov_9.894569	384	464	0	80	80	1.0000000
NODE_2897_length_1351_cov_8.699681	1055	1137	0	12	82	0.1463415
NODE_2897_length_1351_cov_8.699681	1055	1137	1	3	82	0.0365854
NODE_2897_length_1351_cov_8.699681	1055	1137	2	18	82	0.2195122
NODE_2897_length_1351_cov_8.699681	1055	1137	3	14	82	0.1707317
NODE_2897_length_1351_cov_8.699681	1055	1137	4	14	82	0.1707317
NODE_2897_length_1351_cov_8.699681	1055	1137	6	1	82	0.0121951
NODE_2897_length_1351_cov_8.699681	1055	1137	7	2	82	0.0243902
NODE_2897_length_1351_cov_8.699681	1055	1137	8	8	82	0.0975610
NODE_2897_length_1351_cov_8.699681	1055	1137	10	3	82	0.0365854
NODE_2897_length_1351_cov_8.699681	1055	1137	17	2	82	0.0243902
NODE_2897_length_1351_cov_8.699681	1055	1137	19	2	82	0.0243902
NODE_2897_length_1351_cov_8.699681	1055	1137	21	1	82	0.0121951
NODE_2897_length_1351_cov_8.699681	1055	1137	23	2	82	0.0243902
NODE_2897_length_1351_cov_8.699681	1110	1175	4	13	65	0.2000000
NODE_2897_length_1351_cov_8.699681	1110	1175	6	1	65	0.0153846
NODE_2897_length_1351_cov_8.699681	1110	1175	7	2	65	0.0307692
NODE_2897_length_1351_cov_8.699681	1110	1175	8	8	65	0.1230769
NODE_2897_length_1351_cov_8.699681	1110	1175	10	41	65	0.6307693
NODE_2898_length_1351_cov_2.931310	68	148	14	4	80	0.0500000
NODE_2898_length_1351_cov_2.931310	68	148	16	8	80	0.1000000
NODE_2898_length_1351_cov_2.931310	68	148	17	4	80	0.0500000
NODE_2898_length_1351_cov_2.931310	68	148	18	1	80	0.0125000
NODE_2898_length_1351_cov_2.931310	68	148	19	3	80	0.0375000
NODE_2898_length_1351_cov_2.931310	68	148	21	6	80	0.0750000
NODE_2898_length_1351_cov_2.931310	68	148	22	7	80	0.0875000
NODE_2898_length_1351_cov_2.931310	68	148	25	1	80	0.0125000
NODE_2898_length_1351_cov_2.931310	68	148	27	5	80	0.0625000
NODE_2898_length_1351_cov_2.931310	68	148	28	2	80	0.0250000
NODE_2898_length_1351_cov_2.931310	68	148	29	7	80	0.0875000
NODE_2898_length_1351_cov_2.931310	68	148	32	3	80	0.0375000
NODE_2898_length_1351_cov_2.931310	68	148	33	4	80	0.0500000
NODE_2898_length_1351_cov_2.931310	68	148	34	1	80	0.0125000
NODE_2898_length_1351_cov_2.931310	68	148	40	1	80	0.0125000
NODE_2898_length_1351_cov_2.931310	68	148	41	4	80	0.0500000
NODE_2898_length_1351_cov_2.931310	68	148	42	7	80	0.0875000
NODE_2898_length_1351_cov_2.931310	68	148	47	2	80	0.0250000
NODE_2898_length_1351_cov_2.931310	68	148	48	4	80	0.0500000
NODE_2898_length_1351_cov_2.931310	68	148	50	6	80	0.0750000
NODE_2898_length_1351_cov_2.931310	495	528	1	13	33	0.3939394
NODE_2898_length_1351_cov_2.931310	495	528	2	19	33	0.5757576
NODE_2898_length_1351_cov_2.931310	495	528	4	1	33	0.0303030
NODE_2899_length_1350_cov_18.274181	424	504	0	80	80	1.0000000
NODE_2899_length_1350_cov_18.274181	477	557	0	43	80	0.5375000
NODE_2899_length_1350_cov_18.274181	477	557	1	37	80	0.4625000
NODE_2899_length_1350_cov_18.274181	553	633	1	11	80	0.1375000
NODE_2899_length_1350_cov_18.274181	553	633	2	15	80	0.1875000
NODE_2899_length_1350_cov_18.274181	553	633	4	23	80	0.2875000
NODE_2899_length_1350_cov_18.274181	553	633	6	31	80	0.3875000
NODE_2899_length_1350_cov_18.274181	606	686	3	11	80	0.1375000
NODE_2899_length_1350_cov_18.274181	606	686	5	5	80	0.0625000
NODE_2899_length_1350_cov_18.274181	606	686	6	64	80	0.8000000
NODE_2900_length_1350_cov_8.053557	737	817	4	13	80	0.1625000
NODE_2900_length_1350_cov_8.053557	737	817	5	67	80	0.8375000
NODE_2900_length_1350_cov_8.053557	790	870	1	14	80	0.1750000
NODE_2900_length_1350_cov_8.053557	790	870	2	5	80	0.0625000
NODE_2900_length_1350_cov_8.053557	790	870	3	10	80	0.1250000
NODE_2900_length_1350_cov_8.053557	790	870	4	37	80	0.4625000
NODE_2900_length_1350_cov_8.053557	790	870	5	14	80	0.1750000
NODE_2903_length_1349_cov_23.782400	839	919	1	4	80	0.0500000
NODE_2903_length_1349_cov_23.782400	839	919	2	21	80	0.2625000
NODE_2903_length_1349_cov_23.782400	839	919	3	55	80	0.6875000
NODE_2903_length_1349_cov_23.782400	892	972	1	24	80	0.3000000
NODE_2903_length_1349_cov_23.782400	892	972	2	52	80	0.6500000
NODE_2903_length_1349_cov_23.782400	892	972	3	4	80	0.0500000
NODE_2903_length_1349_cov_23.782400	968	1048	2	2	80	0.0250000
NODE_2903_length_1349_cov_23.782400	968	1048	3	17	80	0.2125000
NODE_2903_length_1349_cov_23.782400	968	1048	4	50	80	0.6250000
NODE_2903_length_1349_cov_23.782400	968	1048	5	11	80	0.1375000
NODE_2903_length_1349_cov_23.782400	1021	1101	4	28	80	0.3500000
NODE_2903_length_1349_cov_23.782400	1021	1101	5	52	80	0.6500000
NODE_2904_length_1349_cov_17.776800	811	891	2	27	80	0.3375000
NODE_2904_length_1349_cov_17.776800	811	891	3	22	80	0.2750000
NODE_2904_length_1349_cov_17.776800	811	891	4	31	80	0.3875000
NODE_2904_length_1349_cov_17.776800	864	944	0	12	80	0.1500000
NODE_2904_length_1349_cov_17.776800	864	944	2	3	80	0.0375000
NODE_2904_length_1349_cov_17.776800	864	944	3	60	80	0.7500000
NODE_2904_length_1349_cov_17.776800	864	944	4	5	80	0.0625000
NODE_2905_length_1349_cov_16.468800	828	908	0	32	80	0.4000000
NODE_2905_length_1349_cov_16.468800	828	908	1	6	80	0.0750000
NODE_2905_length_1349_cov_16.468800	828	908	2	42	80	0.5250000
NODE_2905_length_1349_cov_16.468800	881	961	2	80	80	1.0000000
NODE_2908_length_1348_cov_22.731785	468	548	0	32	80	0.4000000
NODE_2908_length_1348_cov_22.731785	468	548	2	48	80	0.6000000
NODE_2908_length_1348_cov_22.731785	521	601	2	80	80	1.0000000
NODE_2909_length_1348_cov_20.778223	517	597	0	1	80	0.0125000
NODE_2909_length_1348_cov_20.778223	517	597	1	17	80	0.2125000
NODE_2909_length_1348_cov_20.778223	517	597	2	62	80	0.7750000
NODE_2909_length_1348_cov_20.778223	570	650	2	80	80	1.0000000
NODE_2910_length_1348_cov_11.180144	673	753	1	15	80	0.1875000
NODE_2910_length_1348_cov_11.180144	673	753	2	65	80	0.8125000
NODE_2910_length_1348_cov_11.180144	726	806	0	38	80	0.4750000
NODE_2910_length_1348_cov_11.180144	726	806	1	30	80	0.3750000
NODE_2910_length_1348_cov_11.180144	726	806	2	12	80	0.1500000
NODE_2916_length_1347_cov_45.906250	683	763	3	25	80	0.3125000
NODE_2916_length_1347_cov_45.906250	683	763	4	49	80	0.6125000
NODE_2916_length_1347_cov_45.906250	683	763	5	6	80	0.0750000
NODE_2916_length_1347_cov_45.906250	736	816	3	8	80	0.1000000
NODE_2916_length_1347_cov_45.906250	736	816	4	15	80	0.1875000
NODE_2916_length_1347_cov_45.906250	736	816	5	19	80	0.2375000
NODE_2916_length_1347_cov_45.906250	736	816	6	23	80	0.2875000
NODE_2916_length_1347_cov_45.906250	736	816	7	15	80	0.1875000
NODE_2916_length_1347_cov_45.906250	812	892	5	24	80	0.3000000
NODE_2916_length_1347_cov_45.906250	812	892	6	40	80	0.5000000
NODE_2916_length_1347_cov_45.906250	812	892	7	16	80	0.2000000
NODE_2916_length_1347_cov_45.906250	865	945	2	14	80	0.1750000
NODE_2916_length_1347_cov_45.906250	865	945	3	3	80	0.0375000
NODE_2916_length_1347_cov_45.906250	865	945	4	28	80	0.3500000
NODE_2916_length_1347_cov_45.906250	865	945	5	19	80	0.2375000
NODE_2916_length_1347_cov_45.906250	865	945	7	16	80	0.2000000
NODE_2917_length_1347_cov_41.643429	439	519	14	56	80	0.7000000
NODE_2917_length_1347_cov_41.643429	439	519	15	11	80	0.1375000
NODE_2917_length_1347_cov_41.643429	439	519	16	13	80	0.1625000
NODE_2917_length_1347_cov_41.643429	492	572	9	9	80	0.1125000
NODE_2917_length_1347_cov_41.643429	492	572	10	33	80	0.4125000
NODE_2917_length_1347_cov_41.643429	492	572	13	2	80	0.0250000
NODE_2917_length_1347_cov_41.643429	492	572	14	17	80	0.2125000
NODE_2917_length_1347_cov_41.643429	492	572	15	6	80	0.0750000
NODE_2917_length_1347_cov_41.643429	492	572	16	13	80	0.1625000
NODE_2918_length_1347_cov_19.941506	458	538	1	80	80	1.0000000
NODE_2918_length_1347_cov_19.941506	511	591	1	53	80	0.6625000
NODE_2918_length_1347_cov_19.941506	511	591	2	27	80	0.3375000
NODE_2918_length_1347_cov_19.941506	587	667	2	80	80	1.0000000
NODE_2918_length_1347_cov_19.941506	640	720	2	68	80	0.8500000
NODE_2918_length_1347_cov_19.941506	640	720	3	12	80	0.1500000
NODE_2919_length_1347_cov_16.520833	713	793	0	51	80	0.6375000
NODE_2919_length_1347_cov_16.520833	713	793	1	29	80	0.3625000
NODE_2919_length_1347_cov_16.520833	766	846	0	80	80	1.0000000
NODE_2920_length_1347_cov_15.967147	638	718	7	9	80	0.1125000
NODE_2920_length_1347_cov_15.967147	638	718	8	27	80	0.3375000
NODE_2920_length_1347_cov_15.967147	638	718	9	7	80	0.0875000
NODE_2920_length_1347_cov_15.967147	638	718	10	28	80	0.3500000
NODE_2920_length_1347_cov_15.967147	638	718	11	9	80	0.1125000
NODE_2920_length_1347_cov_15.967147	691	771	2	14	80	0.1750000
NODE_2920_length_1347_cov_15.967147	691	771	3	11	80	0.1375000
NODE_2920_length_1347_cov_15.967147	691	771	4	1	80	0.0125000
NODE_2920_length_1347_cov_15.967147	691	771	5	22	80	0.2750000
NODE_2920_length_1347_cov_15.967147	691	771	7	14	80	0.1750000
NODE_2920_length_1347_cov_15.967147	691	771	8	18	80	0.2250000
NODE_2925_length_1346_cov_13.112269	429	509	1	20	80	0.2500000
NODE_2925_length_1346_cov_13.112269	429	509	2	1	80	0.0125000
NODE_2925_length_1346_cov_13.112269	429	509	3	59	80	0.7375000
NODE_2925_length_1346_cov_13.112269	482	562	2	54	80	0.6750000
NODE_2925_length_1346_cov_13.112269	482	562	3	26	80	0.3250000
NODE_2928_length_1345_cov_32.099518	629	709	0	80	80	1.0000000
NODE_2928_length_1345_cov_32.099518	682	762	0	80	80	1.0000000
NODE_2929_length_1345_cov_19.837881	723	803	2	63	80	0.7875000
NODE_2929_length_1345_cov_19.837881	723	803	4	17	80	0.2125000
NODE_2929_length_1345_cov_19.837881	776	856	1	21	80	0.2625000
NODE_2929_length_1345_cov_19.837881	776	856	2	59	80	0.7375000
NODE_2930_length_1345_cov_14.262440	361	441	2	80	80	1.0000000
NODE_2930_length_1345_cov_14.262440	414	494	0	53	80	0.6625000
NODE_2930_length_1345_cov_14.262440	414	494	2	27	80	0.3375000
NODE_2930_length_1345_cov_14.262440	490	570	0	80	80	1.0000000
NODE_2930_length_1345_cov_14.262440	543	623	0	80	80	1.0000000
NODE_2931_length_1345_cov_14.103531	950	1030	1	25	80	0.3125000
NODE_2931_length_1345_cov_14.103531	950	1030	3	55	80	0.6875000
NODE_2931_length_1345_cov_14.103531	1003	1083	1	4	80	0.0500000
NODE_2931_length_1345_cov_14.103531	1003	1083	2	35	80	0.4375000
NODE_2931_length_1345_cov_14.103531	1003	1083	3	41	80	0.5125000
NODE_2934_length_1344_cov_15.013655	345	425	0	18	80	0.2250000
NODE_2934_length_1344_cov_15.013655	345	425	1	62	80	0.7750000
NODE_2934_length_1344_cov_15.013655	398	478	1	80	80	1.0000000
NODE_2935_length_1344_cov_11.383133	519	599	1	17	80	0.2125000
NODE_2935_length_1344_cov_11.383133	519	599	2	50	80	0.6250000
NODE_2935_length_1344_cov_11.383133	519	599	3	13	80	0.1625000
NODE_2935_length_1344_cov_11.383133	572	652	0	24	80	0.3000000
NODE_2935_length_1344_cov_11.383133	572	652	1	46	80	0.5750000
NODE_2935_length_1344_cov_11.383133	572	652	2	10	80	0.1250000
NODE_2935_length_1344_cov_11.383133	648	728	0	52	80	0.6500000
NODE_2935_length_1344_cov_11.383133	648	728	1	28	80	0.3500000
NODE_2935_length_1344_cov_11.383133	701	781	1	80	80	1.0000000
NODE_2936_length_1344_cov_10.924498	529	609	0	80	80	1.0000000
NODE_2936_length_1344_cov_10.924498	582	662	0	80	80	1.0000000
NODE_2937_length_1344_cov_5.531727	920	975	0	55	55	1.0000000
NODE_2942_length_1343_cov_36.005627	150	230	36	9	80	0.1125000
NODE_2942_length_1343_cov_36.005627	150	230	37	2	80	0.0250000
NODE_2942_length_1343_cov_36.005627	150	230	40	1	80	0.0125000
NODE_2942_length_1343_cov_36.005627	150	230	41	1	80	0.0125000
NODE_2942_length_1343_cov_36.005627	150	230	42	10	80	0.1250000
NODE_2942_length_1343_cov_36.005627	150	230	43	3	80	0.0375000
NODE_2942_length_1343_cov_36.005627	150	230	50	1	80	0.0125000
NODE_2942_length_1343_cov_36.005627	150	230	51	1	80	0.0125000
NODE_2942_length_1343_cov_36.005627	150	230	52	1	80	0.0125000
NODE_2942_length_1343_cov_36.005627	150	230	56	4	80	0.0500000
NODE_2942_length_1343_cov_36.005627	150	230	57	2	80	0.0250000
NODE_2942_length_1343_cov_36.005627	150	230	59	1	80	0.0125000
NODE_2942_length_1343_cov_36.005627	150	230	60	2	80	0.0250000
NODE_2942_length_1343_cov_36.005627	150	230	62	2	80	0.0250000
NODE_2942_length_1343_cov_36.005627	150	230	63	3	80	0.0375000
NODE_2942_length_1343_cov_36.005627	150	230	64	4	80	0.0500000
NODE_2942_length_1343_cov_36.005627	150	230	65	1	80	0.0125000
NODE_2942_length_1343_cov_36.005627	150	230	68	4	80	0.0500000
NODE_2942_length_1343_cov_36.005627	150	230	69	1	80	0.0125000
NODE_2942_length_1343_cov_36.005627	150	230	70	1	80	0.0125000
NODE_2942_length_1343_cov_36.005627	150	230	71	6	80	0.0750000
NODE_2942_length_1343_cov_36.005627	150	230	72	10	80	0.1250000
NODE_2942_length_1343_cov_36.005627	150	230	73	8	80	0.1000000
NODE_2942_length_1343_cov_36.005627	150	230	74	2	80	0.0250000
NODE_2942_length_1343_cov_36.005627	286	366	1	1	80	0.0125000
NODE_2942_length_1343_cov_36.005627	286	366	2	53	80	0.6625000
NODE_2942_length_1343_cov_36.005627	286	366	3	26	80	0.3250000
NODE_2942_length_1343_cov_36.005627	339	419	1	54	80	0.6750000
NODE_2942_length_1343_cov_36.005627	339	419	2	26	80	0.3250000
NODE_2942_length_1343_cov_36.005627	415	495	0	56	80	0.7000000
NODE_2942_length_1343_cov_36.005627	415	495	1	24	80	0.3000000
NODE_2942_length_1343_cov_36.005627	468	548	0	73	80	0.9125000
NODE_2942_length_1343_cov_36.005627	468	548	1	7	80	0.0875000
NODE_2943_length_1343_cov_26.826367	782	862	0	80	80	1.0000000
NODE_2943_length_1343_cov_26.826367	835	915	0	80	80	1.0000000
NODE_2944_length_1343_cov_19.353698	799	879	5	11	80	0.1375000
NODE_2944_length_1343_cov_19.353698	799	879	6	56	80	0.7000000
NODE_2944_length_1343_cov_19.353698	799	879	7	13	80	0.1625000
NODE_2944_length_1343_cov_19.353698	852	932	1	12	80	0.1500000
NODE_2944_length_1343_cov_19.353698	852	932	2	35	80	0.4375000
NODE_2944_length_1343_cov_19.353698	852	932	3	6	80	0.0750000
NODE_2944_length_1343_cov_19.353698	852	932	5	11	80	0.1375000
NODE_2944_length_1343_cov_19.353698	852	932	6	16	80	0.2000000
NODE_2944_length_1343_cov_19.353698	928	1008	1	23	80	0.2875000
NODE_2944_length_1343_cov_19.353698	928	1008	2	15	80	0.1875000
NODE_2944_length_1343_cov_19.353698	928	1008	3	42	80	0.5250000
NODE_2944_length_1343_cov_19.353698	981	1061	3	58	80	0.7250000
NODE_2944_length_1343_cov_19.353698	981	1061	4	22	80	0.2750000
NODE_2945_length_1343_cov_15.717846	745	825	0	80	80	1.0000000
NODE_2945_length_1343_cov_15.717846	798	878	0	80	80	1.0000000
NODE_2949_length_1342_cov_30.491553	456	536	5	5	80	0.0625000
NODE_2949_length_1342_cov_30.491553	456	536	6	60	80	0.7500000
NODE_2949_length_1342_cov_30.491553	456	536	7	15	80	0.1875000
NODE_2949_length_1342_cov_30.491553	509	589	4	6	80	0.0750000
NODE_2949_length_1342_cov_30.491553	509	589	5	13	80	0.1625000
NODE_2949_length_1342_cov_30.491553	509	589	6	19	80	0.2375000
NODE_2949_length_1342_cov_30.491553	509	589	7	42	80	0.5250000
NODE_2949_length_1342_cov_30.491553	585	665	1	22	80	0.2750000
NODE_2949_length_1342_cov_30.491553	585	665	2	11	80	0.1375000
NODE_2949_length_1342_cov_30.491553	585	665	3	5	80	0.0625000
NODE_2949_length_1342_cov_30.491553	585	665	4	24	80	0.3000000
NODE_2949_length_1342_cov_30.491553	585	665	5	18	80	0.2250000
NODE_2949_length_1342_cov_30.491553	638	718	4	9	80	0.1125000
NODE_2949_length_1342_cov_30.491553	638	718	5	71	80	0.8875000
NODE_2950_length_1342_cov_26.796460	538	618	9	7	80	0.0875000
NODE_2950_length_1342_cov_26.796460	538	618	10	1	80	0.0125000
NODE_2950_length_1342_cov_26.796460	538	618	11	23	80	0.2875000
NODE_2950_length_1342_cov_26.796460	538	618	12	46	80	0.5750000
NODE_2950_length_1342_cov_26.796460	538	618	13	3	80	0.0375000
NODE_2950_length_1342_cov_26.796460	591	671	3	7	80	0.0875000
NODE_2950_length_1342_cov_26.796460	591	671	5	20	80	0.2500000
NODE_2950_length_1342_cov_26.796460	591	671	7	10	80	0.1250000
NODE_2950_length_1342_cov_26.796460	591	671	9	9	80	0.1125000
NODE_2950_length_1342_cov_26.796460	591	671	10	8	80	0.1000000
NODE_2950_length_1342_cov_26.796460	591	671	11	16	80	0.2000000
NODE_2950_length_1342_cov_26.796460	591	671	12	10	80	0.1250000
NODE_2950_length_1342_cov_26.796460	667	747	3	64	80	0.8000000
NODE_2950_length_1342_cov_26.796460	667	747	4	10	80	0.1250000
NODE_2950_length_1342_cov_26.796460	667	747	5	6	80	0.0750000
NODE_2950_length_1342_cov_26.796460	720	800	2	52	80	0.6500000
NODE_2950_length_1342_cov_26.796460	720	800	3	28	80	0.3500000
NODE_2951_length_1342_cov_22.769912	298	378	3	5	80	0.0625000
NODE_2951_length_1342_cov_22.769912	298	378	4	75	80	0.9375000
NODE_2951_length_1342_cov_22.769912	351	431	4	27	80	0.3375000
NODE_2951_length_1342_cov_22.769912	351	431	6	43	80	0.5375000
NODE_2951_length_1342_cov_22.769912	351	431	7	10	80	0.1250000
NODE_2951_length_1342_cov_22.769912	427	507	3	54	80	0.6750000
NODE_2951_length_1342_cov_22.769912	427	507	4	5	80	0.0625000
NODE_2951_length_1342_cov_22.769912	427	507	5	10	80	0.1250000
NODE_2951_length_1342_cov_22.769912	427	507	6	3	80	0.0375000
NODE_2951_length_1342_cov_22.769912	427	507	7	8	80	0.1000000
NODE_2951_length_1342_cov_22.769912	480	560	1	36	80	0.4500000
NODE_2951_length_1342_cov_22.769912	480	560	3	44	80	0.5500000
NODE_2953_length_1341_cov_22.449275	494	574	0	11	80	0.1375000
NODE_2953_length_1341_cov_22.449275	494	574	1	69	80	0.8625000
NODE_2953_length_1341_cov_22.449275	547	627	1	41	80	0.5125000
NODE_2953_length_1341_cov_22.449275	547	627	2	39	80	0.4875000
NODE_2953_length_1341_cov_22.449275	623	703	1	48	80	0.6000000
NODE_2953_length_1341_cov_22.449275	623	703	2	32	80	0.4000000
NODE_2953_length_1341_cov_22.449275	676	755	0	17	79	0.2151899
NODE_2953_length_1341_cov_22.449275	676	755	1	62	79	0.7848101
NODE_2954_length_1341_cov_14.497585	415	495	5	32	80	0.4000000
NODE_2954_length_1341_cov_14.497585	415	495	6	10	80	0.1250000
NODE_2954_length_1341_cov_14.497585	415	495	7	6	80	0.0750000
NODE_2954_length_1341_cov_14.497585	415	495	8	32	80	0.4000000
NODE_2954_length_1341_cov_14.497585	468	548	5	15	80	0.1875000
NODE_2954_length_1341_cov_14.497585	468	548	6	4	80	0.0500000
NODE_2954_length_1341_cov_14.497585	468	548	7	32	80	0.4000000
NODE_2954_length_1341_cov_14.497585	468	548	8	29	80	0.3625000
NODE_2954_length_1341_cov_14.497585	544	624	4	11	80	0.1375000
NODE_2954_length_1341_cov_14.497585	544	624	5	6	80	0.0750000
NODE_2954_length_1341_cov_14.497585	544	624	6	3	80	0.0375000
NODE_2954_length_1341_cov_14.497585	544	624	7	53	80	0.6625000
NODE_2954_length_1341_cov_14.497585	544	624	8	7	80	0.0875000
NODE_2954_length_1341_cov_14.497585	597	677	3	4	80	0.0500000
NODE_2954_length_1341_cov_14.497585	597	677	4	60	80	0.7500000
NODE_2954_length_1341_cov_14.497585	597	677	5	6	80	0.0750000
NODE_2954_length_1341_cov_14.497585	597	677	6	3	80	0.0375000
NODE_2954_length_1341_cov_14.497585	597	677	7	7	80	0.0875000
NODE_2960_length_1340_cov_9.460113	531	611	3	12	80	0.1500000
NODE_2960_length_1340_cov_9.460113	531	611	4	50	80	0.6250000
NODE_2960_length_1340_cov_9.460113	531	611	5	18	80	0.2250000
NODE_2960_length_1340_cov_9.460113	584	664	2	23	80	0.2875000
NODE_2960_length_1340_cov_9.460113	584	664	3	42	80	0.5250000
NODE_2960_length_1340_cov_9.460113	584	664	4	5	80	0.0625000
NODE_2960_length_1340_cov_9.460113	584	664	5	10	80	0.1250000
NODE_2961_length_1340_cov_6.511684	735	815	0	80	80	1.0000000
NODE_2961_length_1340_cov_6.511684	788	868	0	80	80	1.0000000
NODE_2966_length_1339_cov_22.725000	751	831	3	50	80	0.6250000
NODE_2966_length_1339_cov_22.725000	751	831	5	30	80	0.3750000
NODE_2966_length_1339_cov_22.725000	804	884	3	25	80	0.3125000
NODE_2966_length_1339_cov_22.725000	804	884	5	55	80	0.6875000
NODE_2967_length_1339_cov_9.322581	329	409	2	80	80	1.0000000
NODE_2967_length_1339_cov_9.322581	382	462	0	4	80	0.0500000
NODE_2967_length_1339_cov_9.322581	382	462	1	35	80	0.4375000
NODE_2967_length_1339_cov_9.322581	382	462	2	41	80	0.5125000
NODE_2970_length_1338_cov_31.740920	527	607	1	36	80	0.4500000
NODE_2970_length_1338_cov_31.740920	527	607	2	2	80	0.0250000
NODE_2970_length_1338_cov_31.740920	527	607	3	42	80	0.5250000
NODE_2970_length_1338_cov_31.740920	580	660	3	80	80	1.0000000
NODE_2970_length_1338_cov_31.740920	656	736	2	32	80	0.4000000
NODE_2970_length_1338_cov_31.740920	656	736	3	21	80	0.2625000
NODE_2970_length_1338_cov_31.740920	656	736	4	7	80	0.0875000
NODE_2970_length_1338_cov_31.740920	656	736	5	20	80	0.2500000
NODE_2970_length_1338_cov_31.740920	709	789	2	80	80	1.0000000
NODE_2971_length_1338_cov_21.254237	639	719	3	8	80	0.1000000
NODE_2971_length_1338_cov_21.254237	639	719	5	7	80	0.0875000
NODE_2971_length_1338_cov_21.254237	639	719	7	22	80	0.2750000
NODE_2971_length_1338_cov_21.254237	639	719	9	31	80	0.3875000
NODE_2971_length_1338_cov_21.254237	639	719	10	12	80	0.1500000
NODE_2971_length_1338_cov_21.254237	692	772	1	3	80	0.0375000
NODE_2971_length_1338_cov_21.254237	692	772	3	5	80	0.0625000
NODE_2971_length_1338_cov_21.254237	692	772	5	9	80	0.1125000
NODE_2971_length_1338_cov_21.254237	692	772	9	20	80	0.2500000
NODE_2971_length_1338_cov_21.254237	692	772	10	43	80	0.5375000
NODE_2974_length_1337_cov_32.307754	739	819	0	80	80	1.0000000
NODE_2974_length_1337_cov_32.307754	792	872	0	80	80	1.0000000
NODE_2975_length_1337_cov_30.412763	465	545	0	80	80	1.0000000
NODE_2975_length_1337_cov_30.412763	518	598	0	65	80	0.8125000
NODE_2975_length_1337_cov_30.412763	518	598	1	1	80	0.0125000
NODE_2975_length_1337_cov_30.412763	518	598	2	5	80	0.0625000
NODE_2975_length_1337_cov_30.412763	518	598	3	1	80	0.0125000
NODE_2975_length_1337_cov_30.412763	518	598	5	8	80	0.1000000
NODE_2976_length_1337_cov_12.760905	560	640	3	80	80	1.0000000
NODE_2976_length_1337_cov_12.760905	613	693	0	24	80	0.3000000
NODE_2976_length_1337_cov_12.760905	613	693	1	22	80	0.2750000
NODE_2976_length_1337_cov_12.760905	613	693	3	34	80	0.4250000
NODE_2977_length_1337_cov_9.463651	724	804	1	31	80	0.3875000
NODE_2977_length_1337_cov_9.463651	724	804	2	49	80	0.6125000
NODE_2977_length_1337_cov_9.463651	777	857	1	80	80	1.0000000
NODE_2979_length_1337_cov_4.540388	216	296	0	80	80	1.0000000
NODE_2979_length_1337_cov_4.540388	272	349	0	77	77	1.0000000
NODE_2981_length_1336_cov_28.161681	394	474	4	44	80	0.5500000
NODE_2981_length_1336_cov_28.161681	394	474	5	10	80	0.1250000
NODE_2981_length_1336_cov_28.161681	394	474	6	26	80	0.3250000
NODE_2981_length_1336_cov_28.161681	447	527	3	18	80	0.2250000
NODE_2981_length_1336_cov_28.161681	447	527	4	45	80	0.5625000
NODE_2981_length_1336_cov_28.161681	447	527	5	17	80	0.2125000
NODE_2981_length_1336_cov_28.161681	523	603	1	70	80	0.8750000
NODE_2981_length_1336_cov_28.161681	523	603	2	1	80	0.0125000
NODE_2981_length_1336_cov_28.161681	523	603	3	9	80	0.1125000
NODE_2981_length_1336_cov_28.161681	576	656	0	42	80	0.5250000
NODE_2981_length_1336_cov_28.161681	576	656	1	38	80	0.4750000
NODE_2982_length_1336_cov_7.860954	17	98	6	7	81	0.0864198
NODE_2982_length_1336_cov_7.860954	17	98	7	1	81	0.0123457
NODE_2982_length_1336_cov_7.860954	17	98	8	30	81	0.3703704
NODE_2982_length_1336_cov_7.860954	17	98	10	3	81	0.0370370
NODE_2982_length_1336_cov_7.860954	17	98	11	40	81	0.4938272
NODE_2984_length_1336_cov_1.689572	1229	1289	1	37	60	0.6166667
NODE_2984_length_1336_cov_1.689572	1229	1289	2	22	60	0.3666667
NODE_2984_length_1336_cov_1.689572	1229	1289	4	1	60	0.0166667
NODE_2984_length_1336_cov_1.689572	1262	1336	0	1	74	0.0135135
NODE_2984_length_1336_cov_1.689572	1262	1336	1	73	74	0.9864865
NODE_2985_length_1335_cov_19.547735	530	607	0	77	77	1.0000000
NODE_2985_length_1335_cov_19.547735	582	660	0	78	78	1.0000000
NODE_2985_length_1335_cov_19.547735	656	736	0	80	80	1.0000000
NODE_2985_length_1335_cov_19.547735	709	789	0	80	80	1.0000000
NODE_2986_length_1335_cov_15.383495	419	499	2	31	80	0.3875000
NODE_2986_length_1335_cov_15.383495	419	499	4	49	80	0.6125000
NODE_2986_length_1335_cov_15.383495	472	552	2	43	80	0.5375000
NODE_2986_length_1335_cov_15.383495	472	552	4	37	80	0.4625000
NODE_2986_length_1335_cov_15.383495	548	628	2	61	80	0.7625000
NODE_2986_length_1335_cov_15.383495	548	628	4	19	80	0.2375000
NODE_2986_length_1335_cov_15.383495	601	681	2	80	80	1.0000000
NODE_2991_length_1333_cov_27.372771	493	573	1	80	80	1.0000000
NODE_2991_length_1333_cov_27.372771	546	626	0	10	80	0.1250000
NODE_2991_length_1333_cov_27.372771	546	626	1	70	80	0.8750000
NODE_2996_length_1332_cov_18.978913	648	728	0	17	80	0.2125000
NODE_2996_length_1332_cov_18.978913	648	728	1	63	80	0.7875000
NODE_2996_length_1332_cov_18.978913	701	781	1	29	80	0.3625000
NODE_2996_length_1332_cov_18.978913	701	781	2	51	80	0.6375000
NODE_2996_length_1332_cov_18.978913	777	857	1	52	80	0.6500000
NODE_2996_length_1332_cov_18.978913	777	857	2	28	80	0.3500000
NODE_2996_length_1332_cov_18.978913	830	910	0	32	80	0.4000000
NODE_2996_length_1332_cov_18.978913	830	910	1	48	80	0.6000000
NODE_2997_length_1332_cov_3.112733	87	151	1	18	64	0.2812500
NODE_2997_length_1332_cov_3.112733	87	151	2	42	64	0.6562500
NODE_2997_length_1332_cov_3.112733	87	151	4	4	64	0.0625000
NODE_3000_length_1331_cov_16.831981	392	472	0	4	80	0.0500000
NODE_3000_length_1331_cov_16.831981	392	472	1	76	80	0.9500000
NODE_3000_length_1331_cov_16.831981	445	525	0	41	80	0.5125000
NODE_3000_length_1331_cov_16.831981	445	525	1	39	80	0.4875000
NODE_3000_length_1331_cov_16.831981	521	601	1	15	80	0.1875000
NODE_3000_length_1331_cov_16.831981	521	601	2	25	80	0.3125000
NODE_3000_length_1331_cov_16.831981	521	601	3	35	80	0.4375000
NODE_3000_length_1331_cov_16.831981	521	601	4	5	80	0.0625000
NODE_3000_length_1331_cov_16.831981	574	654	3	22	80	0.2750000
NODE_3000_length_1331_cov_16.831981	574	654	4	20	80	0.2500000
NODE_3000_length_1331_cov_16.831981	574	654	6	38	80	0.4750000
NODE_3001_length_1331_cov_12.841721	871	951	4	12	80	0.1500000
NODE_3001_length_1331_cov_12.841721	871	951	5	68	80	0.8500000
NODE_3001_length_1331_cov_12.841721	924	1004	4	13	80	0.1625000
NODE_3001_length_1331_cov_12.841721	924	1004	5	67	80	0.8375000
NODE_3004_length_1331_cov_2.090097	0	76	0	76	76	1.0000000
NODE_3004_length_1331_cov_2.090097	49	98	0	49	49	1.0000000
NODE_3007_length_1330_cov_48.993501	278	358	0	19	80	0.2375000
NODE_3007_length_1330_cov_48.993501	278	358	2	61	80	0.7625000
NODE_3007_length_1330_cov_48.993501	331	411	2	80	80	1.0000000
NODE_3007_length_1330_cov_48.993501	742	822	0	17	80	0.2125000
NODE_3007_length_1330_cov_48.993501	742	822	2	15	80	0.1875000
NODE_3007_length_1330_cov_48.993501	742	822	6	23	80	0.2875000
NODE_3007_length_1330_cov_48.993501	742	822	7	25	80	0.3125000
NODE_3007_length_1330_cov_48.993501	795	875	5	4	80	0.0500000
NODE_3007_length_1330_cov_48.993501	795	875	6	2	80	0.0250000
NODE_3007_length_1330_cov_48.993501	795	875	7	30	80	0.3750000
NODE_3007_length_1330_cov_48.993501	795	875	8	33	80	0.4125000
NODE_3007_length_1330_cov_48.993501	795	875	9	11	80	0.1375000
NODE_3008_length_1330_cov_11.037368	407	487	2	80	80	1.0000000
NODE_3008_length_1330_cov_11.037368	460	540	1	7	80	0.0875000
NODE_3008_length_1330_cov_11.037368	460	540	2	39	80	0.4875000
NODE_3008_length_1330_cov_11.037368	460	540	3	20	80	0.2500000
NODE_3008_length_1330_cov_11.037368	460	540	4	14	80	0.1750000
NODE_3008_length_1330_cov_11.037368	536	617	3	45	81	0.5555556
NODE_3008_length_1330_cov_11.037368	536	617	4	36	81	0.4444444
NODE_3008_length_1330_cov_11.037368	590	670	1	32	80	0.4000000
NODE_3008_length_1330_cov_11.037368	590	670	2	21	80	0.2625000
NODE_3008_length_1330_cov_11.037368	590	670	4	27	80	0.3375000
NODE_3009_length_1330_cov_9.026807	551	631	2	80	80	1.0000000
NODE_3009_length_1330_cov_9.026807	604	684	0	31	80	0.3875000
NODE_3009_length_1330_cov_9.026807	604	684	2	49	80	0.6125000
NODE_3011_length_1329_cov_17.036585	691	771	0	80	80	1.0000000
NODE_3011_length_1329_cov_17.036585	744	824	0	80	80	1.0000000
NODE_3011_length_1329_cov_17.036585	820	900	0	80	80	1.0000000
NODE_3011_length_1329_cov_17.036585	873	953	0	80	80	1.0000000
NODE_3012_length_1329_cov_16.341463	428	476	15	2	48	0.0416667
NODE_3012_length_1329_cov_16.341463	428	476	17	1	48	0.0208333
NODE_3012_length_1329_cov_16.341463	428	476	18	2	48	0.0416667
NODE_3012_length_1329_cov_16.341463	428	476	20	1	48	0.0208333
NODE_3012_length_1329_cov_16.341463	428	476	23	1	48	0.0208333
NODE_3012_length_1329_cov_16.341463	428	476	24	2	48	0.0416667
NODE_3012_length_1329_cov_16.341463	428	476	25	1	48	0.0208333
NODE_3012_length_1329_cov_16.341463	428	476	26	2	48	0.0416667
NODE_3012_length_1329_cov_16.341463	428	476	29	1	48	0.0208333
NODE_3012_length_1329_cov_16.341463	428	476	31	2	48	0.0416667
NODE_3012_length_1329_cov_16.341463	428	476	32	2	48	0.0416667
NODE_3012_length_1329_cov_16.341463	428	476	34	1	48	0.0208333
NODE_3012_length_1329_cov_16.341463	428	476	35	3	48	0.0625000
NODE_3012_length_1329_cov_16.341463	428	476	37	2	48	0.0416667
NODE_3012_length_1329_cov_16.341463	428	476	38	4	48	0.0833333
NODE_3012_length_1329_cov_16.341463	428	476	39	1	48	0.0208333
NODE_3012_length_1329_cov_16.341463	428	476	41	2	48	0.0416667
NODE_3012_length_1329_cov_16.341463	428	476	43	1	48	0.0208333
NODE_3012_length_1329_cov_16.341463	428	476	44	3	48	0.0625000
NODE_3012_length_1329_cov_16.341463	428	476	45	4	48	0.0833333
NODE_3012_length_1329_cov_16.341463	428	476	47	2	48	0.0416667
NODE_3012_length_1329_cov_16.341463	428	476	49	1	48	0.0208333
NODE_3012_length_1329_cov_16.341463	428	476	50	1	48	0.0208333
NODE_3012_length_1329_cov_16.341463	428	476	52	1	48	0.0208333
NODE_3012_length_1329_cov_16.341463	428	476	54	1	48	0.0208333
NODE_3012_length_1329_cov_16.341463	428	476	56	1	48	0.0208333
NODE_3012_length_1329_cov_16.341463	428	476	57	1	48	0.0208333
NODE_3012_length_1329_cov_16.341463	428	476	61	2	48	0.0416667
NODE_3013_length_1329_cov_5.620325	888	955	1	67	67	1.0000000
NODE_3013_length_1329_cov_5.620325	941	999	1	16	58	0.2758621
NODE_3013_length_1329_cov_5.620325	941	999	3	15	58	0.2586207
NODE_3013_length_1329_cov_5.620325	941	999	5	27	58	0.4655173
NODE_3017_length_1328_cov_12.954434	794	874	1	2	80	0.0250000
NODE_3017_length_1328_cov_12.954434	794	874	2	78	80	0.9750000
NODE_3017_length_1328_cov_12.954434	847	927	1	26	80	0.3250000
NODE_3017_length_1328_cov_12.954434	847	927	2	54	80	0.6750000
NODE_3018_length_1328_cov_8.810415	762	842	0	80	80	1.0000000
NODE_3018_length_1328_cov_8.810415	815	895	0	80	80	1.0000000
NODE_3021_length_1327_cov_15.938925	260	340	0	80	80	1.0000000
NODE_3021_length_1327_cov_15.938925	313	393	0	36	80	0.4500000
NODE_3021_length_1327_cov_15.938925	313	393	1	44	80	0.5500000
NODE_3022_length_1327_cov_7.274430	159	235	2	3	76	0.0394737
NODE_3022_length_1327_cov_7.274430	159	235	3	68	76	0.8947368
NODE_3022_length_1327_cov_7.274430	159	235	4	5	76	0.0657895
NODE_3022_length_1327_cov_7.274430	774	854	0	20	80	0.2500000
NODE_3022_length_1327_cov_7.274430	774	854	1	60	80	0.7500000
NODE_3022_length_1327_cov_7.274430	827	890	0	56	63	0.8888889
NODE_3022_length_1327_cov_7.274430	827	890	1	7	63	0.1111111
NODE_3023_length_1327_cov_6.486156	896	976	0	80	80	1.0000000
NODE_3023_length_1327_cov_6.486156	949	1029	0	80	80	1.0000000
NODE_3029_length_1326_cov_32.382233	571	651	2	6	80	0.0750000
NODE_3029_length_1326_cov_32.382233	571	651	3	4	80	0.0500000
NODE_3029_length_1326_cov_32.382233	571	651	5	4	80	0.0500000
NODE_3029_length_1326_cov_32.382233	571	651	7	18	80	0.2250000
NODE_3029_length_1326_cov_32.382233	571	651	8	1	80	0.0125000
NODE_3029_length_1326_cov_32.382233	571	651	9	3	80	0.0375000
NODE_3029_length_1326_cov_32.382233	571	651	10	1	80	0.0125000
NODE_3029_length_1326_cov_32.382233	571	651	11	2	80	0.0250000
NODE_3029_length_1326_cov_32.382233	571	651	13	18	80	0.2250000
NODE_3029_length_1326_cov_32.382233	571	651	14	23	80	0.2875000
NODE_3029_length_1326_cov_32.382233	624	704	12	4	80	0.0500000
NODE_3029_length_1326_cov_32.382233	624	704	13	4	80	0.0500000
NODE_3029_length_1326_cov_32.382233	624	704	14	40	80	0.5000000
NODE_3029_length_1326_cov_32.382233	624	704	15	28	80	0.3500000
NODE_3029_length_1326_cov_32.382233	624	704	16	4	80	0.0500000
NODE_3030_length_1326_cov_30.614507	760	840	3	74	80	0.9250000
NODE_3030_length_1326_cov_30.614507	760	840	4	6	80	0.0750000
NODE_3030_length_1326_cov_30.614507	813	893	0	10	80	0.1250000
NODE_3030_length_1326_cov_30.614507	813	893	1	17	80	0.2125000
NODE_3030_length_1326_cov_30.614507	813	893	2	11	80	0.1375000
NODE_3030_length_1326_cov_30.614507	813	893	3	42	80	0.5250000
NODE_3031_length_1326_cov_30.304808	488	568	3	3	80	0.0375000
NODE_3031_length_1326_cov_30.304808	488	568	5	14	80	0.1750000
NODE_3031_length_1326_cov_30.304808	488	568	6	25	80	0.3125000
NODE_3031_length_1326_cov_30.304808	488	568	7	38	80	0.4750000
NODE_3031_length_1326_cov_30.304808	541	621	6	57	80	0.7125000
NODE_3031_length_1326_cov_30.304808	541	621	7	23	80	0.2875000
NODE_3031_length_1326_cov_30.304808	617	697	1	3	80	0.0375000
NODE_3031_length_1326_cov_30.304808	617	697	3	14	80	0.1750000
NODE_3031_length_1326_cov_30.304808	617	697	4	43	80	0.5375000
NODE_3031_length_1326_cov_30.304808	617	697	5	16	80	0.2000000
NODE_3031_length_1326_cov_30.304808	617	697	7	4	80	0.0500000
NODE_3031_length_1326_cov_30.304808	670	750	2	8	80	0.1000000
NODE_3031_length_1326_cov_30.304808	670	750	4	72	80	0.9000000
NODE_3032_length_1326_cov_10.913610	238	318	0	19	80	0.2375000
NODE_3032_length_1326_cov_10.913610	238	318	1	22	80	0.2750000
NODE_3032_length_1326_cov_10.913610	238	318	2	39	80	0.4875000
NODE_3032_length_1326_cov_10.913610	291	371	2	80	80	1.0000000
NODE_3036_length_1325_cov_38.136215	0	46	1	5	46	0.1086956
NODE_3036_length_1325_cov_38.136215	0	46	3	1	46	0.0217391
NODE_3036_length_1325_cov_38.136215	0	46	4	1	46	0.0217391
NODE_3036_length_1325_cov_38.136215	0	46	6	9	46	0.1956522
NODE_3036_length_1325_cov_38.136215	0	46	8	14	46	0.3043478
NODE_3036_length_1325_cov_38.136215	0	46	9	4	46	0.0869565
NODE_3036_length_1325_cov_38.136215	0	46	11	12	46	0.2608696
NODE_3036_length_1325_cov_38.136215	19	99	8	11	80	0.1375000
NODE_3036_length_1325_cov_38.136215	19	99	9	4	80	0.0500000
NODE_3036_length_1325_cov_38.136215	19	99	11	30	80	0.3750000
NODE_3036_length_1325_cov_38.136215	19	99	12	21	80	0.2625000
NODE_3036_length_1325_cov_38.136215	19	99	13	12	80	0.1500000
NODE_3036_length_1325_cov_38.136215	19	99	14	2	80	0.0250000
NODE_3036_length_1325_cov_38.136215	948	1022	73	1	74	0.0135135
NODE_3036_length_1325_cov_38.136215	948	1022	75	1	74	0.0135135
NODE_3036_length_1325_cov_38.136215	948	1022	77	4	74	0.0540541
NODE_3036_length_1325_cov_38.136215	948	1022	78	3	74	0.0405405
NODE_3036_length_1325_cov_38.136215	948	1022	80	1	74	0.0135135
NODE_3036_length_1325_cov_38.136215	948	1022	82	1	74	0.0135135
NODE_3036_length_1325_cov_38.136215	948	1022	83	1	74	0.0135135
NODE_3036_length_1325_cov_38.136215	948	1022	84	4	74	0.0540541
NODE_3036_length_1325_cov_38.136215	948	1022	85	7	74	0.0945946
NODE_3036_length_1325_cov_38.136215	948	1022	87	2	74	0.0270270
NODE_3036_length_1325_cov_38.136215	948	1022	89	2	74	0.0270270
NODE_3036_length_1325_cov_38.136215	948	1022	90	2	74	0.0270270
NODE_3036_length_1325_cov_38.136215	948	1022	91	2	74	0.0270270
NODE_3036_length_1325_cov_38.136215	948	1022	93	1	74	0.0135135
NODE_3036_length_1325_cov_38.136215	948	1022	95	4	74	0.0540541
NODE_3036_length_1325_cov_38.136215	948	1022	96	4	74	0.0540541
NODE_3036_length_1325_cov_38.136215	948	1022	97	3	74	0.0405405
NODE_3036_length_1325_cov_38.136215	948	1022	98	2	74	0.0270270
NODE_3036_length_1325_cov_38.136215	948	1022	101	4	74	0.0540541
NODE_3036_length_1325_cov_38.136215	948	1022	102	7	74	0.0945946
NODE_3036_length_1325_cov_38.136215	948	1022	103	1	74	0.0135135
NODE_3036_length_1325_cov_38.136215	948	1022	109	1	74	0.0135135
NODE_3036_length_1325_cov_38.136215	948	1022	110	4	74	0.0540541
NODE_3036_length_1325_cov_38.136215	948	1022	111	1	74	0.0135135
NODE_3036_length_1325_cov_38.136215	948	1022	112	4	74	0.0540541
NODE_3036_length_1325_cov_38.136215	948	1022	113	1	74	0.0135135
NODE_3036_length_1325_cov_38.136215	948	1022	114	1	74	0.0135135
NODE_3036_length_1325_cov_38.136215	948	1022	115	1	74	0.0135135
NODE_3036_length_1325_cov_38.136215	948	1022	116	1	74	0.0135135
NODE_3036_length_1325_cov_38.136215	948	1022	118	1	74	0.0135135
NODE_3036_length_1325_cov_38.136215	948	1022	120	1	74	0.0135135
NODE_3036_length_1325_cov_38.136215	948	1022	121	1	74	0.0135135
NODE_3036_length_1325_cov_38.136215	1001	1063	102	3	62	0.0483871
NODE_3036_length_1325_cov_38.136215	1001	1063	103	1	62	0.0161290
NODE_3036_length_1325_cov_38.136215	1001	1063	109	1	62	0.0161290
NODE_3036_length_1325_cov_38.136215	1001	1063	110	4	62	0.0645161
NODE_3036_length_1325_cov_38.136215	1001	1063	111	1	62	0.0161290
NODE_3036_length_1325_cov_38.136215	1001	1063	112	4	62	0.0645161
NODE_3036_length_1325_cov_38.136215	1001	1063	113	1	62	0.0161290
NODE_3036_length_1325_cov_38.136215	1001	1063	114	1	62	0.0161290
NODE_3036_length_1325_cov_38.136215	1001	1063	115	1	62	0.0161290
NODE_3036_length_1325_cov_38.136215	1001	1063	116	1	62	0.0161290
NODE_3036_length_1325_cov_38.136215	1001	1063	118	1	62	0.0161290
NODE_3036_length_1325_cov_38.136215	1001	1063	120	4	62	0.0645161
NODE_3036_length_1325_cov_38.136215	1001	1063	121	8	62	0.1290323
NODE_3036_length_1325_cov_38.136215	1001	1063	122	2	62	0.0322581
NODE_3036_length_1325_cov_38.136215	1001	1063	123	1	62	0.0161290
NODE_3036_length_1325_cov_38.136215	1001	1063	124	5	62	0.0806452
NODE_3036_length_1325_cov_38.136215	1001	1063	125	4	62	0.0645161
NODE_3036_length_1325_cov_38.136215	1001	1063	126	10	62	0.1612903
NODE_3036_length_1325_cov_38.136215	1001	1063	127	8	62	0.1290323
NODE_3036_length_1325_cov_38.136215	1001	1063	128	1	62	0.0161290
NODE_3037_length_1325_cov_29.201468	613	693	0	18	80	0.2250000
NODE_3037_length_1325_cov_29.201468	613	693	1	62	80	0.7750000
NODE_3037_length_1325_cov_29.201468	666	746	0	71	80	0.8875000
NODE_3037_length_1325_cov_29.201468	666	746	1	9	80	0.1125000
NODE_3038_length_1325_cov_11.902121	697	777	0	21	80	0.2625000
NODE_3038_length_1325_cov_11.902121	697	777	1	59	80	0.7375000
NODE_3038_length_1325_cov_11.902121	750	830	1	80	80	1.0000000
NODE_3039_length_1325_cov_7.876835	645	725	1	33	80	0.4125000
NODE_3039_length_1325_cov_7.876835	645	725	2	47	80	0.5875000
NODE_3039_length_1325_cov_7.876835	698	778	0	11	80	0.1375000
NODE_3039_length_1325_cov_7.876835	698	778	1	69	80	0.8625000
NODE_3040_length_1325_cov_3.774062	1157	1218	4	1	61	0.0163934
NODE_3040_length_1325_cov_3.774062	1157	1218	5	5	61	0.0819672
NODE_3040_length_1325_cov_3.774062	1157	1218	6	34	61	0.5573770
NODE_3040_length_1325_cov_3.774062	1157	1218	7	21	61	0.3442623
NODE_3040_length_1325_cov_3.774062	1191	1271	4	47	80	0.5875000
NODE_3040_length_1325_cov_3.774062	1191	1271	6	33	80	0.4125000
NODE_3041_length_1325_cov_2.896411	0	58	0	58	58	1.0000000
NODE_3041_length_1325_cov_2.896411	8	67	0	59	59	1.0000000
NODE_3046_length_1324_cov_30.340408	939	1019	3	8	80	0.1000000
NODE_3046_length_1324_cov_30.340408	939	1019	4	24	80	0.3000000
NODE_3046_length_1324_cov_30.340408	939	1019	5	45	80	0.5625000
NODE_3046_length_1324_cov_30.340408	939	1019	6	3	80	0.0375000
NODE_3046_length_1324_cov_30.340408	992	1072	2	6	80	0.0750000
NODE_3046_length_1324_cov_30.340408	992	1072	3	35	80	0.4375000
NODE_3046_length_1324_cov_30.340408	992	1072	4	39	80	0.4875000
NODE_3047_length_1324_cov_7.391020	742	822	0	1	80	0.0125000
NODE_3047_length_1324_cov_7.391020	742	822	1	56	80	0.7000000
NODE_3047_length_1324_cov_7.391020	742	822	3	15	80	0.1875000
NODE_3047_length_1324_cov_7.391020	742	822	4	8	80	0.1000000
NODE_3047_length_1324_cov_7.391020	795	875	1	4	80	0.0500000
NODE_3047_length_1324_cov_7.391020	795	875	3	15	80	0.1875000
NODE_3047_length_1324_cov_7.391020	795	875	4	61	80	0.7625000
NODE_3053_length_1323_cov_30.600490	392	472	0	5	80	0.0625000
NODE_3053_length_1323_cov_30.600490	392	472	1	1	80	0.0125000
NODE_3053_length_1323_cov_30.600490	392	472	2	74	80	0.9250000
NODE_3053_length_1323_cov_30.600490	445	525	2	80	80	1.0000000
NODE_3053_length_1323_cov_30.600490	521	601	0	9	80	0.1125000
NODE_3053_length_1323_cov_30.600490	521	601	1	45	80	0.5625000
NODE_3053_length_1323_cov_30.600490	521	601	2	26	80	0.3250000
NODE_3053_length_1323_cov_30.600490	574	654	1	80	80	1.0000000
NODE_3054_length_1323_cov_20.888889	758	838	6	7	80	0.0875000
NODE_3054_length_1323_cov_20.888889	758	838	8	9	80	0.1125000
NODE_3054_length_1323_cov_20.888889	758	838	9	64	80	0.8000000
NODE_3054_length_1323_cov_20.888889	811	891	5	49	80	0.6125000
NODE_3054_length_1323_cov_20.888889	811	891	7	2	80	0.0250000
NODE_3054_length_1323_cov_20.888889	811	891	9	29	80	0.3625000
NODE_3061_length_1322_cov_8.988553	287	368	1	81	81	1.0000000
NODE_3061_length_1322_cov_8.988553	341	421	0	37	80	0.4625000
NODE_3061_length_1322_cov_8.988553	341	421	1	43	80	0.5375000
NODE_3061_length_1322_cov_8.988553	417	497	0	59	80	0.7375000
NODE_3061_length_1322_cov_8.988553	417	497	2	21	80	0.2625000
NODE_3061_length_1322_cov_8.988553	470	550	0	6	80	0.0750000
NODE_3061_length_1322_cov_8.988553	470	550	2	74	80	0.9250000
NODE_3068_length_1321_cov_57.885434	359	439	0	3	80	0.0375000
NODE_3068_length_1321_cov_57.885434	359	439	1	20	80	0.2500000
NODE_3068_length_1321_cov_57.885434	359	439	2	3	80	0.0375000
NODE_3068_length_1321_cov_57.885434	359	439	3	54	80	0.6750000
NODE_3068_length_1321_cov_57.885434	412	492	3	28	80	0.3500000
NODE_3068_length_1321_cov_57.885434	412	492	5	42	80	0.5250000
NODE_3068_length_1321_cov_57.885434	412	492	6	10	80	0.1250000
NODE_3068_length_1321_cov_57.885434	488	568	3	5	80	0.0625000
NODE_3068_length_1321_cov_57.885434	488	568	4	21	80	0.2625000
NODE_3068_length_1321_cov_57.885434	488	568	5	7	80	0.0875000
NODE_3068_length_1321_cov_57.885434	488	568	6	26	80	0.3250000
NODE_3068_length_1321_cov_57.885434	488	568	7	20	80	0.2500000
NODE_3068_length_1321_cov_57.885434	488	568	8	1	80	0.0125000
NODE_3068_length_1321_cov_57.885434	541	621	3	5	80	0.0625000
NODE_3068_length_1321_cov_57.885434	541	621	4	74	80	0.9250000
NODE_3068_length_1321_cov_57.885434	541	621	5	1	80	0.0125000
NODE_3071_length_1320_cov_70.753481	432	512	1	23	80	0.2875000
NODE_3071_length_1320_cov_70.753481	432	512	2	2	80	0.0250000
NODE_3071_length_1320_cov_70.753481	432	512	3	55	80	0.6875000
NODE_3071_length_1320_cov_70.753481	485	565	1	23	80	0.2875000
NODE_3071_length_1320_cov_70.753481	485	565	2	54	80	0.6750000
NODE_3071_length_1320_cov_70.753481	485	565	3	3	80	0.0375000
NODE_3071_length_1320_cov_70.753481	561	641	1	59	80	0.7375000
NODE_3071_length_1320_cov_70.753481	561	641	2	21	80	0.2625000
NODE_3071_length_1320_cov_70.753481	614	694	0	34	80	0.4250000
NODE_3071_length_1320_cov_70.753481	614	694	1	46	80	0.5750000
NODE_3072_length_1320_cov_39.149058	715	795	0	42	80	0.5250000
NODE_3072_length_1320_cov_39.149058	715	795	1	38	80	0.4750000
NODE_3072_length_1320_cov_39.149058	768	848	0	78	80	0.9750000
NODE_3072_length_1320_cov_39.149058	768	848	1	2	80	0.0250000
NODE_3072_length_1320_cov_39.149058	844	924	0	2	80	0.0250000
NODE_3072_length_1320_cov_39.149058	844	924	1	22	80	0.2750000
NODE_3072_length_1320_cov_39.149058	844	924	2	6	80	0.0750000
NODE_3072_length_1320_cov_39.149058	844	924	3	5	80	0.0625000
NODE_3072_length_1320_cov_39.149058	844	924	5	45	80	0.5625000
NODE_3072_length_1320_cov_39.149058	897	977	5	80	80	1.0000000
NODE_3073_length_1320_cov_19.175266	707	783	0	65	76	0.8552632
NODE_3073_length_1320_cov_19.175266	707	783	2	11	76	0.1447368
NODE_3073_length_1320_cov_19.175266	760	840	0	12	80	0.1500000
NODE_3073_length_1320_cov_19.175266	760	840	2	68	80	0.8500000
NODE_3074_length_1320_cov_11.224406	860	940	3	12	80	0.1500000
NODE_3074_length_1320_cov_11.224406	860	940	5	8	80	0.1000000
NODE_3074_length_1320_cov_11.224406	860	940	6	19	80	0.2375000
NODE_3074_length_1320_cov_11.224406	860	940	7	2	80	0.0250000
NODE_3074_length_1320_cov_11.224406	860	940	8	39	80	0.4875000
NODE_3074_length_1320_cov_11.224406	913	993	8	60	80	0.7500000
NODE_3074_length_1320_cov_11.224406	913	993	9	4	80	0.0500000
NODE_3074_length_1320_cov_11.224406	913	993	10	16	80	0.2000000
NODE_3075_length_1320_cov_11.036036	760	840	0	9	80	0.1125000
NODE_3075_length_1320_cov_11.036036	760	840	1	71	80	0.8875000
NODE_3075_length_1320_cov_11.036036	813	893	1	80	80	1.0000000
NODE_3076_length_1320_cov_8.357084	800	880	0	60	80	0.7500000
NODE_3076_length_1320_cov_8.357084	800	880	2	10	80	0.1250000
NODE_3076_length_1320_cov_8.357084	800	880	4	8	80	0.1000000
NODE_3076_length_1320_cov_8.357084	800	880	5	2	80	0.0250000
NODE_3076_length_1320_cov_8.357084	853	933	0	7	80	0.0875000
NODE_3076_length_1320_cov_8.357084	853	933	2	10	80	0.1250000
NODE_3076_length_1320_cov_8.357084	853	933	4	8	80	0.1000000
NODE_3076_length_1320_cov_8.357084	853	933	5	55	80	0.6875000
NODE_3080_length_1319_cov_27.098361	630	710	3	32	80	0.4000000
NODE_3080_length_1319_cov_27.098361	630	710	4	17	80	0.2125000
NODE_3080_length_1319_cov_27.098361	630	710	5	31	80	0.3875000
NODE_3080_length_1319_cov_27.098361	683	763	2	17	80	0.2125000
NODE_3080_length_1319_cov_27.098361	683	763	3	22	80	0.2750000
NODE_3080_length_1319_cov_27.098361	683	763	4	1	80	0.0125000
NODE_3080_length_1319_cov_27.098361	683	763	5	40	80	0.5000000
NODE_3081_length_1319_cov_22.992623	490	570	3	4	80	0.0500000
NODE_3081_length_1319_cov_22.992623	490	570	4	14	80	0.1750000
NODE_3081_length_1319_cov_22.992623	490	570	5	14	80	0.1750000
NODE_3081_length_1319_cov_22.992623	490	570	6	33	80	0.4125000
NODE_3081_length_1319_cov_22.992623	490	570	7	15	80	0.1875000
NODE_3081_length_1319_cov_22.992623	543	623	5	4	80	0.0500000
NODE_3081_length_1319_cov_22.992623	543	623	6	19	80	0.2375000
NODE_3081_length_1319_cov_22.992623	543	623	7	57	80	0.7125000
NODE_3086_length_1318_cov_13.624282	642	722	0	80	80	1.0000000
NODE_3086_length_1318_cov_13.624282	695	775	0	80	80	1.0000000
NODE_3086_length_1318_cov_13.624282	771	851	0	80	80	1.0000000
NODE_3086_length_1318_cov_13.624282	824	904	0	80	80	1.0000000
NODE_3089_length_1317_cov_162.041872	66	143	0	13	77	0.1688312
NODE_3089_length_1317_cov_162.041872	66	143	4	61	77	0.7922078
NODE_3089_length_1317_cov_162.041872	66	143	7	1	77	0.0129870
NODE_3089_length_1317_cov_162.041872	66	143	10	1	77	0.0129870
NODE_3089_length_1317_cov_162.041872	66	143	14	1	77	0.0129870
NODE_3090_length_1317_cov_19.736453	675	755	5	1	80	0.0125000
NODE_3090_length_1317_cov_19.736453	675	755	6	25	80	0.3125000
NODE_3090_length_1317_cov_19.736453	675	755	8	35	80	0.4375000
NODE_3090_length_1317_cov_19.736453	675	755	9	6	80	0.0750000
NODE_3090_length_1317_cov_19.736453	675	755	10	13	80	0.1625000
NODE_3090_length_1317_cov_19.736453	728	808	6	16	80	0.2000000
NODE_3090_length_1317_cov_19.736453	728	808	7	20	80	0.2500000
NODE_3090_length_1317_cov_19.736453	728	808	8	35	80	0.4375000
NODE_3090_length_1317_cov_19.736453	728	808	9	1	80	0.0125000
NODE_3090_length_1317_cov_19.736453	728	808	10	8	80	0.1000000
NODE_3090_length_1317_cov_19.736453	804	884	1	10	80	0.1250000
NODE_3090_length_1317_cov_19.736453	804	884	3	43	80	0.5375000
NODE_3090_length_1317_cov_19.736453	804	884	5	5	80	0.0625000
NODE_3090_length_1317_cov_19.736453	804	884	6	22	80	0.2750000
NODE_3090_length_1317_cov_19.736453	857	937	3	35	80	0.4375000
NODE_3090_length_1317_cov_19.736453	857	937	4	4	80	0.0500000
NODE_3090_length_1317_cov_19.736453	857	937	5	41	80	0.5125000
NODE_3092_length_1317_cov_2.203612	779	859	0	51	80	0.6375000
NODE_3092_length_1317_cov_2.203612	779	859	1	20	80	0.2500000
NODE_3092_length_1317_cov_2.203612	779	859	2	9	80	0.1125000
NODE_3095_length_1316_cov_25.377157	557	637	0	34	80	0.4250000
NODE_3095_length_1316_cov_25.377157	557	637	2	39	80	0.4875000
NODE_3095_length_1316_cov_25.377157	557	637	4	7	80	0.0875000
NODE_3095_length_1316_cov_25.377157	610	690	2	20	80	0.2500000
NODE_3095_length_1316_cov_25.377157	610	690	4	15	80	0.1875000
NODE_3095_length_1316_cov_25.377157	610	690	6	10	80	0.1250000
NODE_3095_length_1316_cov_25.377157	610	690	8	35	80	0.4375000
NODE_3096_length_1316_cov_15.891537	446	526	3	12	80	0.1500000
NODE_3096_length_1316_cov_15.891537	446	526	4	21	80	0.2625000
NODE_3096_length_1316_cov_15.891537	446	526	5	10	80	0.1250000
NODE_3096_length_1316_cov_15.891537	446	526	6	37	80	0.4625000
NODE_3096_length_1316_cov_15.891537	499	579	4	28	80	0.3500000
NODE_3096_length_1316_cov_15.891537	499	579	5	24	80	0.3000000
NODE_3096_length_1316_cov_15.891537	499	579	6	28	80	0.3500000
NODE_3096_length_1316_cov_15.891537	575	655	1	21	80	0.2625000
NODE_3096_length_1316_cov_15.891537	575	655	2	5	80	0.0625000
NODE_3096_length_1316_cov_15.891537	575	655	3	9	80	0.1125000
NODE_3096_length_1316_cov_15.891537	575	655	4	45	80	0.5625000
NODE_3096_length_1316_cov_15.891537	628	708	1	42	80	0.5250000
NODE_3096_length_1316_cov_15.891537	628	708	2	37	80	0.4625000
NODE_3096_length_1316_cov_15.891537	628	708	3	1	80	0.0125000
NODE_3101_length_1315_cov_24.136513	592	672	1	73	80	0.9125000
NODE_3101_length_1315_cov_24.136513	592	672	2	7	80	0.0875000
NODE_3101_length_1315_cov_24.136513	645	725	1	50	80	0.6250000
NODE_3101_length_1315_cov_24.136513	645	725	2	30	80	0.3750000
NODE_3105_length_1314_cov_38.391770	647	727	2	80	80	1.0000000
NODE_3105_length_1314_cov_38.391770	700	780	2	60	80	0.7500000
NODE_3105_length_1314_cov_38.391770	700	780	3	20	80	0.2500000
NODE_3105_length_1314_cov_38.391770	776	856	1	8	80	0.1000000
NODE_3105_length_1314_cov_38.391770	776	856	2	69	80	0.8625000
NODE_3105_length_1314_cov_38.391770	776	856	3	3	80	0.0375000
NODE_3105_length_1314_cov_38.391770	829	909	2	24	80	0.3000000
NODE_3105_length_1314_cov_38.391770	829	909	3	6	80	0.0750000
NODE_3105_length_1314_cov_38.391770	829	909	5	31	80	0.3875000
NODE_3105_length_1314_cov_38.391770	829	909	6	19	80	0.2375000
NODE_3106_length_1314_cov_30.167078	736	816	5	12	80	0.1500000
NODE_3106_length_1314_cov_30.167078	736	816	7	12	80	0.1500000
NODE_3106_length_1314_cov_30.167078	736	816	8	56	80	0.7000000
NODE_3106_length_1314_cov_30.167078	789	869	3	25	80	0.3125000
NODE_3106_length_1314_cov_30.167078	789	869	4	5	80	0.0625000
NODE_3106_length_1314_cov_30.167078	789	869	5	26	80	0.3250000
NODE_3106_length_1314_cov_30.167078	789	869	6	9	80	0.1125000
NODE_3106_length_1314_cov_30.167078	789	869	7	12	80	0.1500000
NODE_3106_length_1314_cov_30.167078	789	869	8	3	80	0.0375000
NODE_3107_length_1314_cov_11.221399	523	603	0	45	80	0.5625000
NODE_3107_length_1314_cov_11.221399	523	603	1	8	80	0.1000000
NODE_3107_length_1314_cov_11.221399	523	603	3	3	80	0.0375000
NODE_3107_length_1314_cov_11.221399	523	603	4	24	80	0.3000000
NODE_3107_length_1314_cov_11.221399	576	656	3	3	80	0.0375000
NODE_3107_length_1314_cov_11.221399	576	656	4	77	80	0.9625000
NODE_3114_length_1313_cov_29.315486	463	543	6	7	80	0.0875000
NODE_3114_length_1313_cov_29.315486	463	543	8	5	80	0.0625000
NODE_3114_length_1313_cov_29.315486	463	543	9	60	80	0.7500000
NODE_3114_length_1313_cov_29.315486	463	543	10	8	80	0.1000000
NODE_3114_length_1313_cov_29.315486	516	596	0	9	80	0.1125000
NODE_3114_length_1313_cov_29.315486	516	596	3	5	80	0.0625000
NODE_3114_length_1313_cov_29.315486	516	596	4	6	80	0.0750000
NODE_3114_length_1313_cov_29.315486	516	596	5	2	80	0.0250000
NODE_3114_length_1313_cov_29.315486	516	596	6	21	80	0.2625000
NODE_3114_length_1313_cov_29.315486	516	596	7	8	80	0.1000000
NODE_3114_length_1313_cov_29.315486	516	596	8	7	80	0.0875000
NODE_3114_length_1313_cov_29.315486	516	596	9	22	80	0.2750000
NODE_3115_length_1313_cov_25.144975	709	789	1	31	80	0.3875000
NODE_3115_length_1313_cov_25.144975	709	789	2	49	80	0.6125000
NODE_3115_length_1313_cov_25.144975	762	842	2	75	80	0.9375000
NODE_3115_length_1313_cov_25.144975	762	842	3	5	80	0.0625000
NODE_3115_length_1313_cov_25.144975	838	918	2	48	80	0.6000000
NODE_3115_length_1313_cov_25.144975	838	918	3	32	80	0.4000000
NODE_3115_length_1313_cov_25.144975	891	971	1	19	80	0.2375000
NODE_3115_length_1313_cov_25.144975	891	971	2	61	80	0.7625000
NODE_3118_length_1312_cov_20.378401	138	218	2	20	80	0.2500000
NODE_3118_length_1312_cov_20.378401	138	218	3	3	80	0.0375000
NODE_3118_length_1312_cov_20.378401	138	218	4	12	80	0.1500000
NODE_3118_length_1312_cov_20.378401	138	218	5	12	80	0.1500000
NODE_3118_length_1312_cov_20.378401	138	218	6	33	80	0.4125000
NODE_3118_length_1312_cov_20.378401	191	271	6	73	80	0.9125000
NODE_3118_length_1312_cov_20.378401	191	271	7	7	80	0.0875000
NODE_3121_length_1311_cov_38.468647	584	664	0	29	80	0.3625000
NODE_3121_length_1311_cov_38.468647	584	664	1	49	80	0.6125000
NODE_3121_length_1311_cov_38.468647	584	664	2	1	80	0.0125000
NODE_3121_length_1311_cov_38.468647	584	664	4	1	80	0.0125000
NODE_3121_length_1311_cov_38.468647	637	717	1	25	80	0.3125000
NODE_3121_length_1311_cov_38.468647	637	717	2	1	80	0.0125000
NODE_3121_length_1311_cov_38.468647	637	717	4	4	80	0.0500000
NODE_3121_length_1311_cov_38.468647	637	717	6	29	80	0.3625000
NODE_3121_length_1311_cov_38.468647	637	717	8	21	80	0.2625000
NODE_3121_length_1311_cov_38.468647	713	793	8	10	80	0.1250000
NODE_3121_length_1311_cov_38.468647	713	793	10	2	80	0.0250000
NODE_3121_length_1311_cov_38.468647	713	793	11	13	80	0.1625000
NODE_3121_length_1311_cov_38.468647	713	793	12	40	80	0.5000000
NODE_3121_length_1311_cov_38.468647	713	793	13	4	80	0.0500000
NODE_3121_length_1311_cov_38.468647	713	793	14	11	80	0.1375000
NODE_3121_length_1311_cov_38.468647	766	846	7	6	80	0.0750000
NODE_3121_length_1311_cov_38.468647	766	846	8	1	80	0.0125000
NODE_3121_length_1311_cov_38.468647	766	846	9	22	80	0.2750000
NODE_3121_length_1311_cov_38.468647	766	846	11	5	80	0.0625000
NODE_3121_length_1311_cov_38.468647	766	846	12	46	80	0.5750000
NODE_3125_length_1310_cov_37.739884	679	759	6	8	80	0.1000000
NODE_3125_length_1310_cov_37.739884	679	759	7	6	80	0.0750000
NODE_3125_length_1310_cov_37.739884	679	759	8	7	80	0.0875000
NODE_3125_length_1310_cov_37.739884	679	759	9	52	80	0.6500000
NODE_3125_length_1310_cov_37.739884	679	759	10	7	80	0.0875000
NODE_3125_length_1310_cov_37.739884	683	763	6	12	80	0.1500000
NODE_3125_length_1310_cov_37.739884	683	763	7	6	80	0.0750000
NODE_3125_length_1310_cov_37.739884	683	763	8	7	80	0.0875000
NODE_3125_length_1310_cov_37.739884	683	763	9	48	80	0.6000000
NODE_3125_length_1310_cov_37.739884	683	763	10	7	80	0.0875000
NODE_3125_length_1310_cov_37.739884	732	816	6	32	84	0.3809524
NODE_3125_length_1310_cov_37.739884	732	816	7	7	84	0.0833333
NODE_3125_length_1310_cov_37.739884	732	816	8	12	84	0.1428571
NODE_3125_length_1310_cov_37.739884	732	816	9	7	84	0.0833333
NODE_3125_length_1310_cov_37.739884	732	816	10	23	84	0.2738095
NODE_3125_length_1310_cov_37.739884	732	816	11	3	84	0.0357143
NODE_3125_length_1310_cov_37.739884	736	816	6	32	80	0.4000000
NODE_3125_length_1310_cov_37.739884	736	816	7	7	80	0.0875000
NODE_3125_length_1310_cov_37.739884	736	816	8	10	80	0.1250000
NODE_3125_length_1310_cov_37.739884	736	816	9	5	80	0.0625000
NODE_3125_length_1310_cov_37.739884	736	816	10	23	80	0.2875000
NODE_3125_length_1310_cov_37.739884	736	816	11	3	80	0.0375000
NODE_3125_length_1310_cov_37.739884	812	892	8	2	80	0.0250000
NODE_3125_length_1310_cov_37.739884	812	892	9	2	80	0.0250000
NODE_3125_length_1310_cov_37.739884	812	892	10	21	80	0.2625000
NODE_3125_length_1310_cov_37.739884	812	892	11	44	80	0.5500000
NODE_3125_length_1310_cov_37.739884	812	892	12	8	80	0.1000000
NODE_3125_length_1310_cov_37.739884	812	892	13	3	80	0.0375000
NODE_3125_length_1310_cov_37.739884	865	945	7	8	80	0.1000000
NODE_3125_length_1310_cov_37.739884	865	945	8	2	80	0.0250000
NODE_3125_length_1310_cov_37.739884	865	945	10	2	80	0.0250000
NODE_3125_length_1310_cov_37.739884	865	945	11	52	80	0.6500000
NODE_3125_length_1310_cov_37.739884	865	945	12	13	80	0.1625000
NODE_3125_length_1310_cov_37.739884	865	945	13	3	80	0.0375000
NODE_3126_length_1310_cov_12.245252	615	695	2	80	80	1.0000000
NODE_3126_length_1310_cov_12.245252	668	748	0	19	80	0.2375000
NODE_3126_length_1310_cov_12.245252	668	748	2	61	80	0.7625000
NODE_3127_length_1310_cov_10.184971	422	502	0	80	80	1.0000000
NODE_3127_length_1310_cov_10.184971	475	555	0	80	80	1.0000000
NODE_3128_length_1310_cov_3.186623	876	956	0	51	80	0.6375000
NODE_3128_length_1310_cov_3.186623	876	956	2	5	80	0.0625000
NODE_3128_length_1310_cov_3.186623	876	956	4	24	80	0.3000000
NODE_3128_length_1310_cov_3.186623	929	1009	2	3	80	0.0375000
NODE_3128_length_1310_cov_3.186623	929	1009	4	77	80	0.9625000
NODE_3131_length_1310_cov_0.757225	1255	1310	0	55	55	1.0000000
NODE_3132_length_1309_cov_34.942149	474	554	3	6	80	0.0750000
NODE_3132_length_1309_cov_34.942149	474	554	4	74	80	0.9250000
NODE_3132_length_1309_cov_34.942149	527	607	2	5	80	0.0625000
NODE_3132_length_1309_cov_34.942149	527	607	3	6	80	0.0750000
NODE_3132_length_1309_cov_34.942149	527	607	4	69	80	0.8625000
NODE_3132_length_1309_cov_34.942149	603	683	2	11	80	0.1375000
NODE_3132_length_1309_cov_34.942149	603	683	3	53	80	0.6625000
NODE_3132_length_1309_cov_34.942149	603	683	4	4	80	0.0500000
NODE_3132_length_1309_cov_34.942149	603	683	5	12	80	0.1500000
NODE_3132_length_1309_cov_34.942149	656	736	3	15	80	0.1875000
NODE_3132_length_1309_cov_34.942149	656	736	4	8	80	0.1000000
NODE_3132_length_1309_cov_34.942149	656	736	5	57	80	0.7125000
NODE_3133_length_1309_cov_10.571074	839	921	0	3	82	0.0365854
NODE_3133_length_1309_cov_10.571074	839	921	2	79	82	0.9634146
NODE_3133_length_1309_cov_10.571074	894	974	0	30	80	0.3750000
NODE_3133_length_1309_cov_10.571074	894	974	2	50	80	0.6250000
NODE_3135_length_1308_cov_43.461538	330	410	2	6	80	0.0750000
NODE_3135_length_1308_cov_43.461538	330	410	3	5	80	0.0625000
NODE_3135_length_1308_cov_43.461538	330	410	4	1	80	0.0125000
NODE_3135_length_1308_cov_43.461538	330	410	5	1	80	0.0125000
NODE_3135_length_1308_cov_43.461538	330	410	6	3	80	0.0375000
NODE_3135_length_1308_cov_43.461538	330	410	7	60	80	0.7500000
NODE_3135_length_1308_cov_43.461538	330	410	8	4	80	0.0500000
NODE_3135_length_1308_cov_43.461538	383	463	6	3	80	0.0375000
NODE_3135_length_1308_cov_43.461538	383	463	7	20	80	0.2500000
NODE_3135_length_1308_cov_43.461538	383	463	8	57	80	0.7125000
NODE_3145_length_1307_cov_11.290563	595	673	0	76	78	0.9743590
NODE_3145_length_1307_cov_11.290563	595	673	1	2	78	0.0256410
NODE_3145_length_1307_cov_11.290563	646	726	0	80	80	1.0000000
NODE_3146_length_1307_cov_8.653146	430	510	0	80	80	1.0000000
NODE_3146_length_1307_cov_8.653146	483	563	0	80	80	1.0000000
NODE_3153_length_1306_cov_26.813587	369	449	0	45	80	0.5625000
NODE_3153_length_1306_cov_26.813587	369	449	2	35	80	0.4375000
NODE_3153_length_1306_cov_26.813587	422	502	0	1	80	0.0125000
NODE_3153_length_1306_cov_26.813587	422	502	2	79	80	0.9875000
NODE_3153_length_1306_cov_26.813587	498	578	0	77	80	0.9625000
NODE_3153_length_1306_cov_26.813587	498	578	2	3	80	0.0375000
NODE_3153_length_1306_cov_26.813587	551	631	0	80	80	1.0000000
NODE_3154_length_1306_cov_24.904722	634	714	1	19	80	0.2375000
NODE_3154_length_1306_cov_24.904722	634	714	2	2	80	0.0250000
NODE_3154_length_1306_cov_24.904722	634	714	3	57	80	0.7125000
NODE_3154_length_1306_cov_24.904722	634	714	4	2	80	0.0250000
NODE_3154_length_1306_cov_24.904722	687	767	1	72	80	0.9000000
NODE_3154_length_1306_cov_24.904722	687	767	2	2	80	0.0250000
NODE_3154_length_1306_cov_24.904722	687	767	3	4	80	0.0500000
NODE_3154_length_1306_cov_24.904722	687	767	4	2	80	0.0250000
NODE_3155_length_1306_cov_18.274234	388	468	1	9	80	0.1125000
NODE_3155_length_1306_cov_18.274234	388	468	2	19	80	0.2375000
NODE_3155_length_1306_cov_18.274234	388	468	3	21	80	0.2625000
NODE_3155_length_1306_cov_18.274234	388	468	4	31	80	0.3875000
NODE_3155_length_1306_cov_18.274234	441	521	2	18	80	0.2250000
NODE_3155_length_1306_cov_18.274234	441	521	4	62	80	0.7750000
NODE_3156_length_1306_cov_15.176471	1214	1294	0	8	80	0.1000000
NODE_3156_length_1306_cov_15.176471	1214	1294	1	44	80	0.5500000
NODE_3156_length_1306_cov_15.176471	1214	1294	2	21	80	0.2625000
NODE_3156_length_1306_cov_15.176471	1214	1294	3	2	80	0.0250000
NODE_3156_length_1306_cov_15.176471	1214	1294	4	1	80	0.0125000
NODE_3156_length_1306_cov_15.176471	1214	1294	6	4	80	0.0500000
NODE_3157_length_1306_cov_12.699254	458	538	4	29	80	0.3625000
NODE_3157_length_1306_cov_12.699254	458	538	6	51	80	0.6375000
NODE_3157_length_1306_cov_12.699254	511	591	1	20	80	0.2500000
NODE_3157_length_1306_cov_12.699254	511	591	2	6	80	0.0750000
NODE_3157_length_1306_cov_12.699254	511	591	3	22	80	0.2750000
NODE_3157_length_1306_cov_12.699254	511	591	4	10	80	0.1250000
NODE_3157_length_1306_cov_12.699254	511	591	6	22	80	0.2750000
NODE_3158_length_1306_cov_9.958575	630	710	1	42	80	0.5250000
NODE_3158_length_1306_cov_9.958575	630	710	2	38	80	0.4750000
NODE_3158_length_1306_cov_9.958575	683	764	1	54	81	0.6666667
NODE_3158_length_1306_cov_9.958575	683	764	2	27	81	0.3333333
NODE_3159_length_1306_cov_2.739851	1206	1246	0	40	40	1.0000000
NODE_3168_length_1304_cov_28.444813	511	591	2	41	80	0.5125000
NODE_3168_length_1304_cov_28.444813	511	591	3	25	80	0.3125000
NODE_3168_length_1304_cov_28.444813	511	591	4	14	80	0.1750000
NODE_3168_length_1304_cov_28.444813	564	644	2	25	80	0.3125000
NODE_3168_length_1304_cov_28.444813	564	644	4	55	80	0.6875000
NODE_3168_length_1304_cov_28.444813	640	720	2	1	80	0.0125000
NODE_3168_length_1304_cov_28.444813	640	720	3	70	80	0.8750000
NODE_3168_length_1304_cov_28.444813	640	720	4	9	80	0.1125000
NODE_3168_length_1304_cov_28.444813	693	773	1	33	80	0.4125000
NODE_3168_length_1304_cov_28.444813	693	773	2	9	80	0.1125000
NODE_3168_length_1304_cov_28.444813	693	773	3	38	80	0.4750000
NODE_3169_length_1304_cov_27.137759	575	655	1	14	80	0.1750000
NODE_3169_length_1304_cov_27.137759	575	655	2	5	80	0.0625000
NODE_3169_length_1304_cov_27.137759	575	655	3	10	80	0.1250000
NODE_3169_length_1304_cov_27.137759	575	655	4	8	80	0.1000000
NODE_3169_length_1304_cov_27.137759	575	655	6	27	80	0.3375000
NODE_3169_length_1304_cov_27.137759	575	655	7	4	80	0.0500000
NODE_3169_length_1304_cov_27.137759	575	655	10	12	80	0.1500000
NODE_3169_length_1304_cov_27.137759	628	708	6	11	80	0.1375000
NODE_3169_length_1304_cov_27.137759	628	708	7	4	80	0.0500000
NODE_3169_length_1304_cov_27.137759	628	708	10	48	80	0.6000000
NODE_3169_length_1304_cov_27.137759	628	708	11	17	80	0.2125000
NODE_3169_length_1304_cov_27.137759	704	784	4	15	80	0.1875000
NODE_3169_length_1304_cov_27.137759	704	784	5	2	80	0.0250000
NODE_3169_length_1304_cov_27.137759	704	784	6	28	80	0.3500000
NODE_3169_length_1304_cov_27.137759	704	784	7	4	80	0.0500000
NODE_3169_length_1304_cov_27.137759	704	784	8	12	80	0.1500000
NODE_3169_length_1304_cov_27.137759	704	784	10	19	80	0.2375000
NODE_3169_length_1304_cov_27.137759	757	837	2	27	80	0.3375000
NODE_3169_length_1304_cov_27.137759	757	837	3	17	80	0.2125000
NODE_3169_length_1304_cov_27.137759	757	837	4	20	80	0.2500000
NODE_3169_length_1304_cov_27.137759	757	837	5	4	80	0.0500000
NODE_3169_length_1304_cov_27.137759	757	837	6	12	80	0.1500000
NODE_3171_length_1303_cov_36.546512	458	538	6	70	80	0.8750000
NODE_3171_length_1303_cov_36.546512	458	538	7	10	80	0.1250000
NODE_3171_length_1303_cov_36.546512	511	591	1	6	80	0.0750000
NODE_3171_length_1303_cov_36.546512	511	591	3	15	80	0.1875000
NODE_3171_length_1303_cov_36.546512	511	591	4	9	80	0.1125000
NODE_3171_length_1303_cov_36.546512	511	591	5	5	80	0.0625000
NODE_3171_length_1303_cov_36.546512	511	591	6	45	80	0.5625000
NODE_3171_length_1303_cov_36.546512	587	667	1	9	80	0.1125000
NODE_3171_length_1303_cov_36.546512	587	667	2	66	80	0.8250000
NODE_3171_length_1303_cov_36.546512	587	667	3	5	80	0.0625000
NODE_3171_length_1303_cov_36.546512	640	720	2	22	80	0.2750000
NODE_3171_length_1303_cov_36.546512	640	720	3	58	80	0.7250000
NODE_3174_length_1302_cov_22.265170	747	827	1	54	80	0.6750000
NODE_3174_length_1302_cov_22.265170	747	827	2	26	80	0.3250000
NODE_3174_length_1302_cov_22.265170	800	880	1	39	80	0.4875000
NODE_3174_length_1302_cov_22.265170	800	880	2	41	80	0.5125000
NODE_3175_length_1302_cov_16.199501	480	560	0	26	80	0.3250000
NODE_3175_length_1302_cov_16.199501	480	560	1	32	80	0.4000000
NODE_3175_length_1302_cov_16.199501	480	560	2	22	80	0.2750000
NODE_3175_length_1302_cov_16.199501	533	613	1	5	80	0.0625000
NODE_3175_length_1302_cov_16.199501	533	613	2	75	80	0.9375000
NODE_3176_length_1302_cov_6.953450	687	767	1	8	80	0.1000000
NODE_3176_length_1302_cov_6.953450	687	767	3	72	80	0.9000000
NODE_3176_length_1302_cov_6.953450	740	820	2	23	80	0.2875000
NODE_3176_length_1302_cov_6.953450	740	820	3	57	80	0.7125000
NODE_3179_length_1301_cov_31.711314	401	481	3	18	80	0.2250000
NODE_3179_length_1301_cov_31.711314	401	481	4	26	80	0.3250000
NODE_3179_length_1301_cov_31.711314	401	481	5	36	80	0.4500000
NODE_3179_length_1301_cov_31.711314	454	534	3	24	80	0.3000000
NODE_3179_length_1301_cov_31.711314	454	534	4	53	80	0.6625000
NODE_3179_length_1301_cov_31.711314	454	534	5	3	80	0.0375000
NODE_3181_length_1301_cov_5.529950	246	326	0	80	80	1.0000000
NODE_3181_length_1301_cov_5.529950	299	379	0	80	80	1.0000000
NODE_3186_length_1300_cov_39.109908	602	682	4	29	80	0.3625000
NODE_3186_length_1300_cov_39.109908	602	682	5	51	80	0.6375000
NODE_3186_length_1300_cov_39.109908	655	735	0	12	80	0.1500000
NODE_3186_length_1300_cov_39.109908	655	735	2	17	80	0.2125000
NODE_3186_length_1300_cov_39.109908	655	735	4	51	80	0.6375000
NODE_3187_length_1300_cov_34.360533	586	666	3	21	80	0.2625000
NODE_3187_length_1300_cov_34.360533	586	666	4	16	80	0.2000000
NODE_3187_length_1300_cov_34.360533	586	666	5	43	80	0.5375000
NODE_3187_length_1300_cov_34.360533	639	719	2	24	80	0.3000000
NODE_3187_length_1300_cov_34.360533	639	719	3	35	80	0.4375000
NODE_3187_length_1300_cov_34.360533	639	719	5	21	80	0.2625000
NODE_3188_length_1300_cov_4.659450	454	535	0	81	81	1.0000000
NODE_3188_length_1300_cov_4.659450	508	588	0	80	80	1.0000000
NODE_3189_length_1299_cov_29.071667	452	532	1	47	80	0.5875000
NODE_3189_length_1299_cov_29.071667	452	532	3	33	80	0.4125000
NODE_3190_length_1299_cov_23.600833	818	898	2	17	80	0.2125000
NODE_3190_length_1299_cov_23.600833	818	898	3	63	80	0.7875000
NODE_3190_length_1299_cov_23.600833	871	951	1	4	80	0.0500000
NODE_3190_length_1299_cov_23.600833	871	951	2	29	80	0.3625000
NODE_3190_length_1299_cov_23.600833	871	951	3	47	80	0.5875000
NODE_3191_length_1299_cov_23.169167	625	705	0	80	80	1.0000000
NODE_3191_length_1299_cov_23.169167	678	758	0	80	80	1.0000000
NODE_3191_length_1299_cov_23.169167	754	834	0	80	80	1.0000000
NODE_3191_length_1299_cov_23.169167	807	887	0	80	80	1.0000000
NODE_3192_length_1299_cov_19.315000	306	386	4	8	80	0.1000000
NODE_3192_length_1299_cov_19.315000	306	386	5	21	80	0.2625000
NODE_3192_length_1299_cov_19.315000	306	386	6	17	80	0.2125000
NODE_3192_length_1299_cov_19.315000	306	386	7	34	80	0.4250000
NODE_3192_length_1299_cov_19.315000	359	439	5	6	80	0.0750000
NODE_3192_length_1299_cov_19.315000	359	439	7	74	80	0.9250000
NODE_3192_length_1299_cov_19.315000	435	515	3	8	80	0.1000000
NODE_3192_length_1299_cov_19.315000	435	515	4	43	80	0.5375000
NODE_3192_length_1299_cov_19.315000	435	515	5	27	80	0.3375000
NODE_3192_length_1299_cov_19.315000	435	515	6	1	80	0.0125000
NODE_3192_length_1299_cov_19.315000	435	515	7	1	80	0.0125000
NODE_3192_length_1299_cov_19.315000	488	568	3	61	80	0.7625000
NODE_3192_length_1299_cov_19.315000	488	568	4	19	80	0.2375000
NODE_3193_length_1299_cov_13.691667	540	620	0	16	80	0.2000000
NODE_3193_length_1299_cov_13.691667	540	620	1	64	80	0.8000000
NODE_3193_length_1299_cov_13.691667	593	673	1	80	80	1.0000000
NODE_3195_length_1298_cov_58.277731	679	759	9	10	80	0.1250000
NODE_3195_length_1298_cov_58.277731	679	759	10	2	80	0.0250000
NODE_3195_length_1298_cov_58.277731	679	759	11	46	80	0.5750000
NODE_3195_length_1298_cov_58.277731	679	759	12	22	80	0.2750000
NODE_3195_length_1298_cov_58.277731	732	812	6	20	80	0.2500000
NODE_3195_length_1298_cov_58.277731	732	812	7	5	80	0.0625000
NODE_3195_length_1298_cov_58.277731	732	812	8	12	80	0.1500000
NODE_3195_length_1298_cov_58.277731	732	812	9	21	80	0.2625000
NODE_3195_length_1298_cov_58.277731	732	812	11	8	80	0.1000000
NODE_3195_length_1298_cov_58.277731	732	812	12	14	80	0.1750000
NODE_3195_length_1298_cov_58.277731	808	888	3	10	80	0.1250000
NODE_3195_length_1298_cov_58.277731	808	888	4	39	80	0.4875000
NODE_3195_length_1298_cov_58.277731	808	888	5	14	80	0.1750000
NODE_3195_length_1298_cov_58.277731	808	888	6	11	80	0.1375000
NODE_3195_length_1298_cov_58.277731	808	888	7	6	80	0.0750000
NODE_3195_length_1298_cov_58.277731	861	941	3	10	80	0.1250000
NODE_3195_length_1298_cov_58.277731	861	941	4	16	80	0.2000000
NODE_3195_length_1298_cov_58.277731	861	941	5	54	80	0.6750000
NODE_3196_length_1298_cov_31.319433	375	455	1	26	80	0.3250000
NODE_3196_length_1298_cov_31.319433	375	455	2	54	80	0.6750000
NODE_3196_length_1298_cov_31.319433	428	508	1	38	80	0.4750000
NODE_3196_length_1298_cov_31.319433	428	508	2	8	80	0.1000000
NODE_3196_length_1298_cov_31.319433	428	508	3	8	80	0.1000000
NODE_3196_length_1298_cov_31.319433	428	508	4	19	80	0.2375000
NODE_3196_length_1298_cov_31.319433	428	508	5	7	80	0.0875000
NODE_3196_length_1298_cov_31.319433	504	584	4	30	80	0.3750000
NODE_3196_length_1298_cov_31.319433	504	584	5	18	80	0.2250000
NODE_3196_length_1298_cov_31.319433	504	584	6	21	80	0.2625000
NODE_3196_length_1298_cov_31.319433	504	584	7	11	80	0.1375000
NODE_3196_length_1298_cov_31.319433	557	637	4	5	80	0.0625000
NODE_3196_length_1298_cov_31.319433	557	637	5	8	80	0.1000000
NODE_3196_length_1298_cov_31.319433	557	637	6	23	80	0.2875000
NODE_3196_length_1298_cov_31.319433	557	637	7	44	80	0.5500000
NODE_3197_length_1298_cov_2.158465	294	360	0	66	66	1.0000000
NODE_3201_length_1296_cov_34.778613	620	700	3	4	80	0.0500000
NODE_3201_length_1296_cov_34.778613	620	700	5	76	80	0.9500000
NODE_3201_length_1296_cov_34.778613	673	753	2	5	80	0.0625000
NODE_3201_length_1296_cov_34.778613	673	753	3	29	80	0.3625000
NODE_3201_length_1296_cov_34.778613	673	753	4	14	80	0.1750000
NODE_3201_length_1296_cov_34.778613	673	753	5	32	80	0.4000000
NODE_3202_length_1296_cov_28.726817	671	751	0	25	80	0.3125000
NODE_3202_length_1296_cov_28.726817	671	751	1	40	80	0.5000000
NODE_3202_length_1296_cov_28.726817	671	751	2	15	80	0.1875000
NODE_3202_length_1296_cov_28.726817	724	804	1	12	80	0.1500000
NODE_3202_length_1296_cov_28.726817	724	804	2	47	80	0.5875000
NODE_3202_length_1296_cov_28.726817	724	804	4	5	80	0.0625000
NODE_3202_length_1296_cov_28.726817	724	804	5	12	80	0.1500000
NODE_3202_length_1296_cov_28.726817	724	804	6	4	80	0.0500000
NODE_3202_length_1296_cov_28.726817	800	880	5	24	80	0.3000000
NODE_3202_length_1296_cov_28.726817	800	880	6	46	80	0.5750000
NODE_3202_length_1296_cov_28.726817	800	880	7	10	80	0.1250000
NODE_3202_length_1296_cov_28.726817	853	933	5	25	80	0.3125000
NODE_3202_length_1296_cov_28.726817	853	933	6	45	80	0.5625000
NODE_3202_length_1296_cov_28.726817	853	933	7	10	80	0.1250000
NODE_3205_length_1295_cov_10.661371	818	898	2	8	80	0.1000000
NODE_3205_length_1295_cov_10.661371	818	898	3	72	80	0.9000000
NODE_3205_length_1295_cov_10.661371	871	951	2	16	80	0.2000000
NODE_3205_length_1295_cov_10.661371	871	951	3	64	80	0.8000000
NODE_3211_length_1294_cov_15.098745	353	433	5	43	80	0.5375000
NODE_3211_length_1294_cov_15.098745	353	433	6	37	80	0.4625000
NODE_3211_length_1294_cov_15.098745	406	486	4	1	80	0.0125000
NODE_3211_length_1294_cov_15.098745	406	486	5	46	80	0.5750000
NODE_3211_length_1294_cov_15.098745	406	486	6	33	80	0.4125000
NODE_3216_length_1293_cov_26.580402	595	675	3	18	80	0.2250000
NODE_3216_length_1293_cov_26.580402	595	675	4	8	80	0.1000000
NODE_3216_length_1293_cov_26.580402	595	675	5	16	80	0.2000000
NODE_3216_length_1293_cov_26.580402	595	675	6	38	80	0.4750000
NODE_3216_length_1293_cov_26.580402	648	728	3	6	80	0.0750000
NODE_3216_length_1293_cov_26.580402	648	728	4	4	80	0.0500000
NODE_3216_length_1293_cov_26.580402	648	728	5	58	80	0.7250000
NODE_3216_length_1293_cov_26.580402	648	728	6	12	80	0.1500000
NODE_3216_length_1293_cov_26.580402	724	804	0	41	80	0.5125000
NODE_3216_length_1293_cov_26.580402	724	804	1	8	80	0.1000000
NODE_3216_length_1293_cov_26.580402	724	804	3	31	80	0.3875000
NODE_3216_length_1293_cov_26.580402	777	857	0	80	80	1.0000000
NODE_3217_length_1293_cov_9.252094	1187	1207	0	20	20	1.0000000
NODE_3220_length_1293_cov_2.118090	1131	1195	0	64	64	1.0000000
NODE_3220_length_1293_cov_2.118090	1184	1248	0	64	64	1.0000000
NODE_3224_length_1292_cov_50.158424	402	482	4	14	80	0.1750000
NODE_3224_length_1292_cov_50.158424	402	482	5	12	80	0.1500000
NODE_3224_length_1292_cov_50.158424	402	482	7	21	80	0.2625000
NODE_3224_length_1292_cov_50.158424	402	482	8	26	80	0.3250000
NODE_3224_length_1292_cov_50.158424	402	482	9	7	80	0.0875000
NODE_3224_length_1292_cov_50.158424	455	535	6	1	80	0.0125000
NODE_3224_length_1292_cov_50.158424	455	535	7	13	80	0.1625000
NODE_3224_length_1292_cov_50.158424	455	535	8	34	80	0.4250000
NODE_3224_length_1292_cov_50.158424	455	535	9	32	80	0.4000000
NODE_3224_length_1292_cov_50.158424	531	611	2	12	80	0.1500000
NODE_3224_length_1292_cov_50.158424	531	611	3	33	80	0.4125000
NODE_3224_length_1292_cov_50.158424	531	611	4	18	80	0.2250000
NODE_3224_length_1292_cov_50.158424	531	611	6	4	80	0.0500000
NODE_3224_length_1292_cov_50.158424	531	611	7	13	80	0.1625000
NODE_3224_length_1292_cov_50.158424	584	664	1	39	80	0.4875000
NODE_3224_length_1292_cov_50.158424	584	664	2	26	80	0.3250000
NODE_3224_length_1292_cov_50.158424	584	664	3	15	80	0.1875000
NODE_3225_length_1292_cov_36.535624	670	750	3	29	80	0.3625000
NODE_3225_length_1292_cov_36.535624	670	750	4	11	80	0.1375000
NODE_3225_length_1292_cov_36.535624	670	750	5	40	80	0.5000000
NODE_3225_length_1292_cov_36.535624	723	803	4	12	80	0.1500000
NODE_3225_length_1292_cov_36.535624	723	803	5	64	80	0.8000000
NODE_3225_length_1292_cov_36.535624	723	803	6	4	80	0.0500000
NODE_3226_length_1292_cov_24.523889	420	500	1	35	80	0.4375000
NODE_3226_length_1292_cov_24.523889	420	500	2	18	80	0.2250000
NODE_3226_length_1292_cov_24.523889	420	500	3	23	80	0.2875000
NODE_3226_length_1292_cov_24.523889	420	500	4	4	80	0.0500000
NODE_3226_length_1292_cov_24.523889	473	553	3	23	80	0.2875000
NODE_3226_length_1292_cov_24.523889	473	553	4	54	80	0.6750000
NODE_3226_length_1292_cov_24.523889	473	553	5	3	80	0.0375000
NODE_3232_length_1291_cov_8.734060	623	703	0	7	80	0.0875000
NODE_3232_length_1291_cov_8.734060	623	703	1	73	80	0.9125000
NODE_3232_length_1291_cov_8.734060	676	756	1	80	80	1.0000000
NODE_3233_length_1291_cov_8.625839	756	836	0	80	80	1.0000000
NODE_3233_length_1291_cov_8.625839	809	889	0	80	80	1.0000000
NODE_3236_length_1290_cov_24.120067	497	577	3	30	80	0.3750000
NODE_3236_length_1290_cov_24.120067	497	577	4	30	80	0.3750000
NODE_3236_length_1290_cov_24.120067	497	577	5	20	80	0.2500000
NODE_3236_length_1290_cov_24.120067	550	630	2	35	80	0.4375000
NODE_3236_length_1290_cov_24.120067	550	630	3	14	80	0.1750000
NODE_3236_length_1290_cov_24.120067	550	630	4	11	80	0.1375000
NODE_3236_length_1290_cov_24.120067	550	630	5	20	80	0.2500000
NODE_3236_length_1290_cov_24.120067	626	706	2	45	80	0.5625000
NODE_3236_length_1290_cov_24.120067	626	706	3	35	80	0.4375000
NODE_3236_length_1290_cov_24.120067	679	759	2	21	80	0.2625000
NODE_3236_length_1290_cov_24.120067	679	759	3	59	80	0.7375000
NODE_3237_length_1290_cov_18.874895	671	751	2	1	80	0.0125000
NODE_3237_length_1290_cov_18.874895	671	751	3	55	80	0.6875000
NODE_3237_length_1290_cov_18.874895	671	751	4	24	80	0.3000000
NODE_3237_length_1290_cov_18.874895	724	804	2	5	80	0.0625000
NODE_3237_length_1290_cov_18.874895	724	804	3	9	80	0.1125000
NODE_3237_length_1290_cov_18.874895	724	804	4	66	80	0.8250000
NODE_3238_length_1290_cov_11.627204	573	653	1	21	80	0.2625000
NODE_3238_length_1290_cov_11.627204	573	653	2	41	80	0.5125000
NODE_3238_length_1290_cov_11.627204	573	653	3	18	80	0.2250000
NODE_3238_length_1290_cov_11.627204	626	706	2	35	80	0.4375000
NODE_3238_length_1290_cov_11.627204	626	706	3	45	80	0.5625000
NODE_3239_length_1290_cov_11.215785	373	453	1	13	80	0.1625000
NODE_3239_length_1290_cov_11.215785	373	453	2	67	80	0.8375000
NODE_3239_length_1290_cov_11.215785	426	506	2	80	80	1.0000000
NODE_3240_length_1290_cov_8.752309	788	868	0	4	80	0.0500000
NODE_3240_length_1290_cov_8.752309	788	868	2	76	80	0.9500000
NODE_3240_length_1290_cov_8.752309	841	921	0	13	80	0.1625000
NODE_3240_length_1290_cov_8.752309	841	921	2	67	80	0.8375000
NODE_3242_length_1289_cov_47.476471	919	999	24	1	80	0.0125000
NODE_3242_length_1289_cov_47.476471	919	999	25	2	80	0.0250000
NODE_3242_length_1289_cov_47.476471	919	999	26	3	80	0.0375000
NODE_3242_length_1289_cov_47.476471	919	999	27	4	80	0.0500000
NODE_3242_length_1289_cov_47.476471	919	999	31	8	80	0.1000000
NODE_3242_length_1289_cov_47.476471	919	999	33	1	80	0.0125000
NODE_3242_length_1289_cov_47.476471	919	999	34	7	80	0.0875000
NODE_3242_length_1289_cov_47.476471	919	999	35	2	80	0.0250000
NODE_3242_length_1289_cov_47.476471	919	999	36	1	80	0.0125000
NODE_3242_length_1289_cov_47.476471	919	999	38	2	80	0.0250000
NODE_3242_length_1289_cov_47.476471	919	999	39	1	80	0.0125000
NODE_3242_length_1289_cov_47.476471	919	999	41	8	80	0.1000000
NODE_3242_length_1289_cov_47.476471	919	999	42	2	80	0.0250000
NODE_3242_length_1289_cov_47.476471	919	999	43	1	80	0.0125000
NODE_3242_length_1289_cov_47.476471	919	999	44	4	80	0.0500000
NODE_3242_length_1289_cov_47.476471	919	999	45	4	80	0.0500000
NODE_3242_length_1289_cov_47.476471	919	999	46	1	80	0.0125000
NODE_3242_length_1289_cov_47.476471	919	999	47	10	80	0.1250000
NODE_3242_length_1289_cov_47.476471	919	999	48	1	80	0.0125000
NODE_3242_length_1289_cov_47.476471	919	999	49	4	80	0.0500000
NODE_3242_length_1289_cov_47.476471	919	999	50	3	80	0.0375000
NODE_3242_length_1289_cov_47.476471	919	999	51	3	80	0.0375000
NODE_3242_length_1289_cov_47.476471	919	999	53	3	80	0.0375000
NODE_3242_length_1289_cov_47.476471	919	999	54	1	80	0.0125000
NODE_3242_length_1289_cov_47.476471	919	999	57	3	80	0.0375000
NODE_3242_length_1289_cov_47.476471	972	1052	44	5	80	0.0625000
NODE_3242_length_1289_cov_47.476471	972	1052	45	3	80	0.0375000
NODE_3242_length_1289_cov_47.476471	972	1052	46	9	80	0.1125000
NODE_3242_length_1289_cov_47.476471	972	1052	47	9	80	0.1125000
NODE_3242_length_1289_cov_47.476471	972	1052	48	3	80	0.0375000
NODE_3242_length_1289_cov_47.476471	972	1052	49	4	80	0.0500000
NODE_3242_length_1289_cov_47.476471	972	1052	50	3	80	0.0375000
NODE_3242_length_1289_cov_47.476471	972	1052	51	5	80	0.0625000
NODE_3242_length_1289_cov_47.476471	972	1052	52	5	80	0.0625000
NODE_3242_length_1289_cov_47.476471	972	1052	53	7	80	0.0875000
NODE_3242_length_1289_cov_47.476471	972	1052	54	7	80	0.0875000
NODE_3242_length_1289_cov_47.476471	972	1052	55	2	80	0.0250000
NODE_3242_length_1289_cov_47.476471	972	1052	56	9	80	0.1125000
NODE_3242_length_1289_cov_47.476471	972	1052	57	9	80	0.1125000
NODE_3243_length_1289_cov_18.497479	688	768	7	1	80	0.0125000
NODE_3243_length_1289_cov_18.497479	688	768	8	79	80	0.9875000
NODE_3243_length_1289_cov_18.497479	741	821	2	5	80	0.0625000
NODE_3243_length_1289_cov_18.497479	741	821	3	4	80	0.0500000
NODE_3243_length_1289_cov_18.497479	741	821	4	16	80	0.2000000
NODE_3243_length_1289_cov_18.497479	741	821	5	6	80	0.0750000
NODE_3243_length_1289_cov_18.497479	741	821	6	11	80	0.1375000
NODE_3243_length_1289_cov_18.497479	741	821	7	11	80	0.1375000
NODE_3243_length_1289_cov_18.497479	741	821	8	27	80	0.3375000
NODE_3243_length_1289_cov_18.497479	817	893	2	76	76	1.0000000
NODE_3243_length_1289_cov_18.497479	878	958	0	12	80	0.1500000
NODE_3243_length_1289_cov_18.497479	878	958	1	27	80	0.3375000
NODE_3243_length_1289_cov_18.497479	878	958	2	41	80	0.5125000
NODE_3244_length_1289_cov_11.692437	574	654	1	50	80	0.6250000
NODE_3244_length_1289_cov_11.692437	574	654	2	30	80	0.3750000
NODE_3244_length_1289_cov_11.692437	627	707	1	80	80	1.0000000
NODE_3244_length_1289_cov_11.692437	703	783	0	56	80	0.7000000
NODE_3244_length_1289_cov_11.692437	703	783	1	24	80	0.3000000
NODE_3244_length_1289_cov_11.692437	756	836	0	80	80	1.0000000
NODE_3249_length_1288_cov_29.369218	711	791	3	8	80	0.1000000
NODE_3249_length_1288_cov_29.369218	711	791	4	68	80	0.8500000
NODE_3249_length_1288_cov_29.369218	711	791	5	4	80	0.0500000
NODE_3249_length_1288_cov_29.369218	764	844	2	46	80	0.5750000
NODE_3249_length_1288_cov_29.369218	764	844	3	1	80	0.0125000
NODE_3249_length_1288_cov_29.369218	764	844	4	29	80	0.3625000
NODE_3249_length_1288_cov_29.369218	764	844	5	4	80	0.0500000
NODE_3250_length_1288_cov_6.207738	735	815	0	80	80	1.0000000
NODE_3250_length_1288_cov_6.207738	788	868	0	80	80	1.0000000
NODE_3255_length_1288_cov_1.731707	1017	1095	2	27	78	0.3461539
NODE_3255_length_1288_cov_1.731707	1017	1095	3	13	78	0.1666667
NODE_3255_length_1288_cov_1.731707	1017	1095	4	38	78	0.4871795
NODE_3261_length_1287_cov_29.186027	730	810	4	14	80	0.1750000
NODE_3261_length_1287_cov_29.186027	730	810	5	2	80	0.0250000
NODE_3261_length_1287_cov_29.186027	730	810	6	62	80	0.7750000
NODE_3261_length_1287_cov_29.186027	730	810	7	2	80	0.0250000
NODE_3261_length_1287_cov_29.186027	783	863	1	2	80	0.0250000
NODE_3261_length_1287_cov_29.186027	783	863	2	28	80	0.3500000
NODE_3261_length_1287_cov_29.186027	783	863	3	17	80	0.2125000
NODE_3261_length_1287_cov_29.186027	783	863	4	20	80	0.2500000
NODE_3261_length_1287_cov_29.186027	783	863	5	2	80	0.0250000
NODE_3261_length_1287_cov_29.186027	783	863	6	11	80	0.1375000
NODE_3262_length_1287_cov_22.747475	168	248	3	58	80	0.7250000
NODE_3262_length_1287_cov_22.747475	168	248	5	22	80	0.2750000
NODE_3262_length_1287_cov_22.747475	221	301	3	5	80	0.0625000
NODE_3262_length_1287_cov_22.747475	221	301	4	13	80	0.1625000
NODE_3262_length_1287_cov_22.747475	221	301	5	62	80	0.7750000
NODE_3263_length_1287_cov_19.478956	575	655	1	22	80	0.2750000
NODE_3263_length_1287_cov_19.478956	575	655	2	2	80	0.0250000
NODE_3263_length_1287_cov_19.478956	575	655	4	14	80	0.1750000
NODE_3263_length_1287_cov_19.478956	575	655	6	42	80	0.5250000
NODE_3263_length_1287_cov_19.478956	628	708	6	80	80	1.0000000
NODE_3266_length_1286_cov_27.128054	428	508	1	31	80	0.3875000
NODE_3266_length_1286_cov_27.128054	428	508	2	37	80	0.4625000
NODE_3266_length_1286_cov_27.128054	428	508	3	12	80	0.1500000
NODE_3266_length_1286_cov_27.128054	481	561	2	16	80	0.2000000
NODE_3266_length_1286_cov_27.128054	481	561	3	22	80	0.2750000
NODE_3266_length_1286_cov_27.128054	481	561	5	42	80	0.5250000
NODE_3266_length_1286_cov_27.128054	557	637	3	4	80	0.0500000
NODE_3266_length_1286_cov_27.128054	557	637	5	76	80	0.9500000
NODE_3266_length_1286_cov_27.128054	610	690	2	21	80	0.2625000
NODE_3266_length_1286_cov_27.128054	610	690	3	3	80	0.0375000
NODE_3266_length_1286_cov_27.128054	610	690	4	22	80	0.2750000
NODE_3266_length_1286_cov_27.128054	610	690	5	34	80	0.4250000
NODE_3267_length_1286_cov_12.192081	647	727	0	80	80	1.0000000
NODE_3267_length_1286_cov_12.192081	700	780	0	80	80	1.0000000
NODE_3267_length_1286_cov_12.192081	776	856	0	80	80	1.0000000
NODE_3267_length_1286_cov_12.192081	829	909	0	80	80	1.0000000
NODE_3268_length_1286_cov_8.338669	577	657	0	7	80	0.0875000
NODE_3268_length_1286_cov_8.338669	577	657	2	5	80	0.0625000
NODE_3268_length_1286_cov_8.338669	577	657	4	68	80	0.8500000
NODE_3268_length_1286_cov_8.338669	630	710	0	12	80	0.1500000
NODE_3268_length_1286_cov_8.338669	630	710	2	41	80	0.5125000
NODE_3268_length_1286_cov_8.338669	630	710	4	27	80	0.3375000
NODE_3273_length_1285_cov_40.282462	751	831	3	39	80	0.4875000
NODE_3273_length_1285_cov_40.282462	751	831	4	3	80	0.0375000
NODE_3273_length_1285_cov_40.282462	751	831	6	16	80	0.2000000
NODE_3273_length_1285_cov_40.282462	751	831	8	22	80	0.2750000
NODE_3273_length_1285_cov_40.282462	804	884	6	33	80	0.4125000
NODE_3273_length_1285_cov_40.282462	804	884	7	17	80	0.2125000
NODE_3273_length_1285_cov_40.282462	804	884	8	30	80	0.3750000
NODE_3274_length_1285_cov_15.422428	647	727	4	55	80	0.6875000
NODE_3274_length_1285_cov_15.422428	647	727	5	25	80	0.3125000
NODE_3274_length_1285_cov_15.422428	700	780	1	21	80	0.2625000
NODE_3274_length_1285_cov_15.422428	700	780	2	23	80	0.2875000
NODE_3274_length_1285_cov_15.422428	700	780	3	1	80	0.0125000
NODE_3274_length_1285_cov_15.422428	700	780	4	6	80	0.0750000
NODE_3274_length_1285_cov_15.422428	700	780	5	29	80	0.3625000
NODE_3275_length_1285_cov_6.620573	589	669	0	67	80	0.8375000
NODE_3275_length_1285_cov_6.620573	589	669	1	1	80	0.0125000
NODE_3275_length_1285_cov_6.620573	589	669	2	12	80	0.1500000
NODE_3275_length_1285_cov_6.620573	642	722	0	80	80	1.0000000
NODE_3279_length_1284_cov_5.637975	294	374	0	5	80	0.0625000
NODE_3279_length_1284_cov_5.637975	294	374	1	75	80	0.9375000
NODE_3279_length_1284_cov_5.637975	347	427	0	58	80	0.7250000
NODE_3279_length_1284_cov_5.637975	347	427	1	22	80	0.2750000
NODE_3283_length_1283_cov_10.070101	408	488	0	80	80	1.0000000
NODE_3283_length_1283_cov_10.070101	461	541	0	80	80	1.0000000
NODE_3288_length_1282_cov_37.786137	649	729	2	31	80	0.3875000
NODE_3288_length_1282_cov_37.786137	649	729	4	9	80	0.1125000
NODE_3288_length_1282_cov_37.786137	649	729	5	9	80	0.1125000
NODE_3288_length_1282_cov_37.786137	649	729	6	31	80	0.3875000
NODE_3288_length_1282_cov_37.786137	702	782	2	6	80	0.0750000
NODE_3288_length_1282_cov_37.786137	702	782	3	25	80	0.3125000
NODE_3288_length_1282_cov_37.786137	702	782	5	12	80	0.1500000
NODE_3288_length_1282_cov_37.786137	702	782	6	37	80	0.4625000
NODE_3288_length_1282_cov_37.786137	778	858	2	26	80	0.3250000
NODE_3288_length_1282_cov_37.786137	778	858	3	12	80	0.1500000
NODE_3288_length_1282_cov_37.786137	778	858	7	21	80	0.2625000
NODE_3288_length_1282_cov_37.786137	778	858	8	17	80	0.2125000
NODE_3288_length_1282_cov_37.786137	778	858	9	4	80	0.0500000
NODE_3288_length_1282_cov_37.786137	831	911	7	13	80	0.1625000
NODE_3288_length_1282_cov_37.786137	831	911	8	13	80	0.1625000
NODE_3288_length_1282_cov_37.786137	831	911	9	54	80	0.6750000
NODE_3289_length_1282_cov_25.900254	85	167	0	1	82	0.0121951
NODE_3289_length_1282_cov_25.900254	85	167	2	2	82	0.0243902
NODE_3289_length_1282_cov_25.900254	85	167	4	27	82	0.3292683
NODE_3289_length_1282_cov_25.900254	85	167	6	30	82	0.3658537
NODE_3289_length_1282_cov_25.900254	85	167	8	22	82	0.2682927
NODE_3289_length_1282_cov_25.900254	140	183	0	17	43	0.3953488
NODE_3289_length_1282_cov_25.900254	140	183	2	2	43	0.0465116
NODE_3289_length_1282_cov_25.900254	140	183	4	24	43	0.5581396
NODE_3289_length_1282_cov_25.900254	1006	1086	11	12	80	0.1500000
NODE_3289_length_1282_cov_25.900254	1006	1086	12	16	80	0.2000000
NODE_3289_length_1282_cov_25.900254	1006	1086	13	25	80	0.3125000
NODE_3289_length_1282_cov_25.900254	1006	1086	14	13	80	0.1625000
NODE_3289_length_1282_cov_25.900254	1006	1086	15	14	80	0.1750000
NODE_3289_length_1282_cov_25.900254	1006	1086	11	12	80	0.1500000
NODE_3289_length_1282_cov_25.900254	1006	1086	12	16	80	0.2000000
NODE_3289_length_1282_cov_25.900254	1006	1086	13	25	80	0.3125000
NODE_3289_length_1282_cov_25.900254	1006	1086	14	13	80	0.1625000
NODE_3289_length_1282_cov_25.900254	1006	1086	15	14	80	0.1750000
NODE_3289_length_1282_cov_25.900254	1015	1086	11	9	71	0.1267606
NODE_3289_length_1282_cov_25.900254	1015	1086	12	16	71	0.2253521
NODE_3289_length_1282_cov_25.900254	1015	1086	13	22	71	0.3098592
NODE_3289_length_1282_cov_25.900254	1015	1086	14	10	71	0.1408451
NODE_3289_length_1282_cov_25.900254	1015	1086	15	14	71	0.1971831
NODE_3290_length_1282_cov_14.600169	429	477	0	48	48	1.0000000
NODE_3290_length_1282_cov_14.600169	708	788	1	7	80	0.0875000
NODE_3290_length_1282_cov_14.600169	708	788	3	36	80	0.4500000
NODE_3290_length_1282_cov_14.600169	708	788	4	37	80	0.4625000
NODE_3291_length_1282_cov_8.017751	343	420	0	9	77	0.1168831
NODE_3291_length_1282_cov_8.017751	343	420	1	68	77	0.8831169
NODE_3292_length_1282_cov_5.092984	239	319	0	80	80	1.0000000
NODE_3292_length_1282_cov_5.092984	292	372	0	80	80	1.0000000
NODE_3295_length_1281_cov_31.342640	470	550	3	31	80	0.3875000
NODE_3295_length_1281_cov_31.342640	470	550	4	5	80	0.0625000
NODE_3295_length_1281_cov_31.342640	470	550	5	36	80	0.4500000
NODE_3295_length_1281_cov_31.342640	470	550	7	8	80	0.1000000
NODE_3295_length_1281_cov_31.342640	523	603	5	19	80	0.2375000
NODE_3295_length_1281_cov_31.342640	523	603	7	42	80	0.5250000
NODE_3295_length_1281_cov_31.342640	523	603	8	8	80	0.1000000
NODE_3295_length_1281_cov_31.342640	523	603	9	11	80	0.1375000
NODE_3295_length_1281_cov_31.342640	599	679	6	4	80	0.0500000
NODE_3295_length_1281_cov_31.342640	599	679	7	21	80	0.2625000
NODE_3295_length_1281_cov_31.342640	599	679	8	34	80	0.4250000
NODE_3295_length_1281_cov_31.342640	599	679	9	21	80	0.2625000
NODE_3295_length_1281_cov_31.342640	652	732	6	4	80	0.0500000
NODE_3295_length_1281_cov_31.342640	652	732	7	42	80	0.5250000
NODE_3295_length_1281_cov_31.342640	652	732	8	11	80	0.1375000
NODE_3295_length_1281_cov_31.342640	652	732	9	23	80	0.2875000
NODE_3296_length_1281_cov_25.482234	474	554	3	1	80	0.0125000
NODE_3296_length_1281_cov_25.482234	474	554	4	38	80	0.4750000
NODE_3296_length_1281_cov_25.482234	474	554	5	3	80	0.0375000
NODE_3296_length_1281_cov_25.482234	474	554	6	38	80	0.4750000
NODE_3296_length_1281_cov_25.482234	527	607	5	20	80	0.2500000
NODE_3296_length_1281_cov_25.482234	527	607	6	60	80	0.7500000
NODE_3297_length_1281_cov_14.617597	809	887	1	8	78	0.1025641
NODE_3297_length_1281_cov_14.617597	809	887	3	9	78	0.1153846
NODE_3297_length_1281_cov_14.617597	809	887	4	61	78	0.7820513
NODE_3297_length_1281_cov_14.617597	860	940	0	11	80	0.1375000
NODE_3297_length_1281_cov_14.617597	860	940	1	50	80	0.6250000
NODE_3297_length_1281_cov_14.617597	860	940	3	9	80	0.1125000
NODE_3297_length_1281_cov_14.617597	860	940	4	10	80	0.1250000
NODE_3298_length_1281_cov_12.065144	655	735	2	20	80	0.2500000
NODE_3298_length_1281_cov_12.065144	655	735	3	4	80	0.0500000
NODE_3298_length_1281_cov_12.065144	655	735	4	56	80	0.7000000
NODE_3298_length_1281_cov_12.065144	708	788	1	51	80	0.6375000
NODE_3298_length_1281_cov_12.065144	708	788	2	22	80	0.2750000
NODE_3298_length_1281_cov_12.065144	708	788	3	4	80	0.0500000
NODE_3298_length_1281_cov_12.065144	708	788	4	3	80	0.0375000
NODE_3299_length_1281_cov_9.235195	408	488	3	17	80	0.2125000
NODE_3299_length_1281_cov_9.235195	408	488	5	63	80	0.7875000
NODE_3299_length_1281_cov_9.235195	461	541	0	2	80	0.0250000
NODE_3299_length_1281_cov_9.235195	461	541	1	30	80	0.3750000
NODE_3299_length_1281_cov_9.235195	461	541	3	38	80	0.4750000
NODE_3299_length_1281_cov_9.235195	461	541	5	10	80	0.1250000
NODE_3300_length_1281_cov_7.153976	469	549	1	34	80	0.4250000
NODE_3300_length_1281_cov_7.153976	469	549	2	34	80	0.4250000
NODE_3300_length_1281_cov_7.153976	469	549	3	12	80	0.1500000
NODE_3300_length_1281_cov_7.153976	522	602	2	15	80	0.1875000
NODE_3300_length_1281_cov_7.153976	522	602	3	30	80	0.3750000
NODE_3300_length_1281_cov_7.153976	522	602	4	35	80	0.4375000
NODE_3307_length_1280_cov_24.231160	418	498	0	80	80	1.0000000
NODE_3307_length_1280_cov_24.231160	471	551	0	80	80	1.0000000
NODE_3307_length_1280_cov_24.231160	547	627	0	28	80	0.3500000
NODE_3307_length_1280_cov_24.231160	547	627	1	52	80	0.6500000
NODE_3307_length_1280_cov_24.231160	600	680	1	35	80	0.4375000
NODE_3307_length_1280_cov_24.231160	600	680	2	45	80	0.5625000
NODE_3308_length_1280_cov_5.908552	1077	1138	9	1	61	0.0163934
NODE_3308_length_1280_cov_5.908552	1077	1138	12	3	61	0.0491803
NODE_3308_length_1280_cov_5.908552	1077	1138	14	1	61	0.0163934
NODE_3308_length_1280_cov_5.908552	1077	1138	16	4	61	0.0655738
NODE_3308_length_1280_cov_5.908552	1077	1138	18	8	61	0.1311475
NODE_3308_length_1280_cov_5.908552	1077	1138	19	11	61	0.1803279
NODE_3308_length_1280_cov_5.908552	1077	1138	21	1	61	0.0163934
NODE_3308_length_1280_cov_5.908552	1077	1138	22	1	61	0.0163934
NODE_3308_length_1280_cov_5.908552	1077	1138	23	4	61	0.0655738
NODE_3308_length_1280_cov_5.908552	1077	1138	25	3	61	0.0491803
NODE_3308_length_1280_cov_5.908552	1077	1138	27	1	61	0.0163934
NODE_3308_length_1280_cov_5.908552	1077	1138	29	1	61	0.0163934
NODE_3308_length_1280_cov_5.908552	1077	1138	31	1	61	0.0163934
NODE_3308_length_1280_cov_5.908552	1077	1138	32	2	61	0.0327869
NODE_3308_length_1280_cov_5.908552	1077	1138	36	2	61	0.0327869
NODE_3308_length_1280_cov_5.908552	1077	1138	38	1	61	0.0163934
NODE_3308_length_1280_cov_5.908552	1077	1138	39	2	61	0.0327869
NODE_3308_length_1280_cov_5.908552	1077	1138	40	1	61	0.0163934
NODE_3308_length_1280_cov_5.908552	1077	1138	41	2	61	0.0327869
NODE_3308_length_1280_cov_5.908552	1077	1138	42	1	61	0.0163934
NODE_3308_length_1280_cov_5.908552	1077	1138	44	1	61	0.0163934
NODE_3308_length_1280_cov_5.908552	1077	1138	46	4	61	0.0655738
NODE_3308_length_1280_cov_5.908552	1077	1138	47	1	61	0.0163934
NODE_3308_length_1280_cov_5.908552	1077	1138	48	1	61	0.0163934
NODE_3308_length_1280_cov_5.908552	1077	1138	49	2	61	0.0327869
NODE_3308_length_1280_cov_5.908552	1077	1138	52	1	61	0.0163934
NODE_3311_length_1279_cov_16.840678	749	829	2	80	80	1.0000000
NODE_3311_length_1279_cov_16.840678	802	882	0	8	80	0.1000000
NODE_3311_length_1279_cov_16.840678	802	882	2	72	80	0.9000000
NODE_3312_length_1279_cov_3.772881	951	981	0	27	30	0.9000000
NODE_3312_length_1279_cov_3.772881	951	981	1	3	30	0.1000000
NODE_3317_length_1278_cov_45.991518	411	491	7	21	80	0.2625000
NODE_3317_length_1278_cov_45.991518	411	491	8	1	80	0.0125000
NODE_3317_length_1278_cov_45.991518	411	491	9	36	80	0.4500000
NODE_3317_length_1278_cov_45.991518	411	491	10	1	80	0.0125000
NODE_3317_length_1278_cov_45.991518	411	491	11	14	80	0.1750000
NODE_3317_length_1278_cov_45.991518	411	491	12	7	80	0.0875000
NODE_3317_length_1278_cov_45.991518	464	530	3	2	66	0.0303030
NODE_3317_length_1278_cov_45.991518	464	530	4	1	66	0.0151515
NODE_3317_length_1278_cov_45.991518	464	530	5	25	66	0.3787879
NODE_3317_length_1278_cov_45.991518	464	530	7	32	66	0.4848485
NODE_3317_length_1278_cov_45.991518	464	530	8	1	66	0.0151515
NODE_3317_length_1278_cov_45.991518	464	530	9	5	66	0.0757576
NODE_3318_length_1278_cov_37.164546	447	527	5	48	80	0.6000000
NODE_3318_length_1278_cov_37.164546	447	527	6	26	80	0.3250000
NODE_3318_length_1278_cov_37.164546	447	527	7	6	80	0.0750000
NODE_3318_length_1278_cov_37.164546	500	580	4	6	80	0.0750000
NODE_3318_length_1278_cov_37.164546	500	580	5	2	80	0.0250000
NODE_3318_length_1278_cov_37.164546	500	580	6	22	80	0.2750000
NODE_3318_length_1278_cov_37.164546	500	580	7	38	80	0.4750000
NODE_3318_length_1278_cov_37.164546	500	580	8	9	80	0.1125000
NODE_3318_length_1278_cov_37.164546	500	580	9	3	80	0.0375000
NODE_3318_length_1278_cov_37.164546	576	656	4	3	80	0.0375000
NODE_3318_length_1278_cov_37.164546	576	656	6	4	80	0.0500000
NODE_3318_length_1278_cov_37.164546	576	656	8	9	80	0.1125000
NODE_3318_length_1278_cov_37.164546	576	656	9	44	80	0.5500000
NODE_3318_length_1278_cov_37.164546	576	656	10	11	80	0.1375000
NODE_3318_length_1278_cov_37.164546	576	656	11	9	80	0.1125000
NODE_3318_length_1278_cov_37.164546	629	709	9	7	80	0.0875000
NODE_3318_length_1278_cov_37.164546	629	709	10	29	80	0.3625000
NODE_3318_length_1278_cov_37.164546	629	709	11	33	80	0.4125000
NODE_3318_length_1278_cov_37.164546	629	709	13	11	80	0.1375000
NODE_3319_length_1278_cov_12.505513	522	602	11	19	80	0.2375000
NODE_3319_length_1278_cov_12.505513	522	602	12	9	80	0.1125000
NODE_3319_length_1278_cov_12.505513	522	602	13	41	80	0.5125000
NODE_3319_length_1278_cov_12.505513	522	602	14	11	80	0.1375000
NODE_3319_length_1278_cov_12.505513	575	655	5	10	80	0.1250000
NODE_3319_length_1278_cov_12.505513	575	655	6	28	80	0.3500000
NODE_3319_length_1278_cov_12.505513	575	655	7	11	80	0.1375000
NODE_3319_length_1278_cov_12.505513	575	655	9	1	80	0.0125000
NODE_3319_length_1278_cov_12.505513	575	655	11	18	80	0.2250000
NODE_3319_length_1278_cov_12.505513	575	655	12	1	80	0.0125000
NODE_3319_length_1278_cov_12.505513	575	655	13	11	80	0.1375000
NODE_3320_length_1278_cov_12.171332	212	292	0	19	80	0.2375000
NODE_3320_length_1278_cov_12.171332	212	292	1	61	80	0.7625000
NODE_3320_length_1278_cov_12.171332	265	344	1	40	79	0.5063291
NODE_3320_length_1278_cov_12.171332	265	344	2	39	79	0.4936709
NODE_3329_length_1277_cov_21.407470	667	717	7	18	50	0.3600000
NODE_3329_length_1277_cov_21.407470	667	717	8	27	50	0.5400000
NODE_3329_length_1277_cov_21.407470	667	717	9	5	50	0.1000000
NODE_3329_length_1277_cov_21.407470	690	770	3	16	80	0.2000000
NODE_3329_length_1277_cov_21.407470	690	770	4	23	80	0.2875000
NODE_3329_length_1277_cov_21.407470	690	770	5	8	80	0.1000000
NODE_3329_length_1277_cov_21.407470	690	770	7	24	80	0.3000000
NODE_3329_length_1277_cov_21.407470	690	770	8	4	80	0.0500000
NODE_3329_length_1277_cov_21.407470	690	770	9	5	80	0.0625000
NODE_3330_length_1277_cov_18.111205	834	914	0	30	80	0.3750000
NODE_3330_length_1277_cov_18.111205	834	914	3	50	80	0.6250000
NODE_3330_length_1277_cov_18.111205	887	967	1	13	80	0.1625000
NODE_3330_length_1277_cov_18.111205	887	967	3	67	80	0.8375000
NODE_3331_length_1277_cov_12.449066	276	356	2	70	80	0.8750000
NODE_3331_length_1277_cov_12.449066	276	356	4	10	80	0.1250000
NODE_3331_length_1277_cov_12.449066	329	409	2	69	80	0.8625000
NODE_3331_length_1277_cov_12.449066	329	409	4	11	80	0.1375000
NODE_3331_length_1277_cov_12.449066	405	485	2	80	80	1.0000000
NODE_3331_length_1277_cov_12.449066	458	538	0	49	80	0.6125000
NODE_3331_length_1277_cov_12.449066	458	538	2	31	80	0.3875000
NODE_3337_length_1276_cov_21.446899	526	606	1	80	80	1.0000000
NODE_3337_length_1276_cov_21.446899	579	659	0	20	80	0.2500000
NODE_3337_length_1276_cov_21.446899	579	659	1	60	80	0.7500000
NODE_3337_length_1276_cov_21.446899	655	735	0	49	80	0.6125000
NODE_3337_length_1276_cov_21.446899	655	735	2	31	80	0.3875000
NODE_3337_length_1276_cov_21.446899	708	788	2	80	80	1.0000000
NODE_3346_length_1275_cov_35.471939	632	712	4	4	80	0.0500000
NODE_3346_length_1275_cov_35.471939	632	712	6	16	80	0.2000000
NODE_3346_length_1275_cov_35.471939	632	712	7	7	80	0.0875000
NODE_3346_length_1275_cov_35.471939	632	712	8	3	80	0.0375000
NODE_3346_length_1275_cov_35.471939	632	712	9	5	80	0.0625000
NODE_3346_length_1275_cov_35.471939	632	712	11	9	80	0.1125000
NODE_3346_length_1275_cov_35.471939	632	712	12	36	80	0.4500000
NODE_3346_length_1275_cov_35.471939	685	765	8	28	80	0.3500000
NODE_3346_length_1275_cov_35.471939	685	765	9	30	80	0.3750000
NODE_3346_length_1275_cov_35.471939	685	765	11	7	80	0.0875000
NODE_3346_length_1275_cov_35.471939	685	765	12	15	80	0.1875000
NODE_3347_length_1275_cov_19.910714	361	441	0	19	80	0.2375000
NODE_3347_length_1275_cov_19.910714	361	441	1	13	80	0.1625000
NODE_3347_length_1275_cov_19.910714	361	441	3	37	80	0.4625000
NODE_3347_length_1275_cov_19.910714	361	441	4	11	80	0.1375000
NODE_3347_length_1275_cov_19.910714	414	494	3	16	80	0.2000000
NODE_3347_length_1275_cov_19.910714	414	494	4	64	80	0.8000000
NODE_3347_length_1275_cov_19.910714	879	949	3	6	70	0.0857143
NODE_3347_length_1275_cov_19.910714	879	949	4	12	70	0.1714286
NODE_3347_length_1275_cov_19.910714	879	949	5	27	70	0.3857143
NODE_3347_length_1275_cov_19.910714	879	949	6	19	70	0.2714286
NODE_3347_length_1275_cov_19.910714	879	949	7	6	70	0.0857143
NODE_3351_length_1274_cov_23.404255	427	507	0	63	80	0.7875000
NODE_3351_length_1274_cov_23.404255	427	507	1	17	80	0.2125000
NODE_3351_length_1274_cov_23.404255	480	560	0	80	80	1.0000000
NODE_3351_length_1274_cov_23.404255	556	636	0	47	80	0.5875000
NODE_3351_length_1274_cov_23.404255	556	636	1	33	80	0.4125000
NODE_3351_length_1274_cov_23.404255	609	689	1	80	80	1.0000000
NODE_3352_length_1274_cov_20.178723	545	625	1	72	80	0.9000000
NODE_3352_length_1274_cov_20.178723	545	625	2	8	80	0.1000000
NODE_3352_length_1274_cov_20.178723	598	678	1	33	80	0.4125000
NODE_3352_length_1274_cov_20.178723	598	678	2	47	80	0.5875000
NODE_3354_length_1274_cov_2.019574	841	907	1	7	66	0.1060606
NODE_3354_length_1274_cov_2.019574	841	907	3	59	66	0.8939394
NODE_3354_length_1274_cov_2.019574	894	961	1	2	67	0.0298507
NODE_3354_length_1274_cov_2.019574	894	961	3	65	67	0.9701493
NODE_3361_length_1273_cov_42.349233	337	417	0	2	80	0.0250000
NODE_3361_length_1273_cov_42.349233	337	417	2	53	80	0.6625000
NODE_3361_length_1273_cov_42.349233	337	417	3	25	80	0.3125000
NODE_3361_length_1273_cov_42.349233	390	470	2	2	80	0.0250000
NODE_3361_length_1273_cov_42.349233	390	470	3	78	80	0.9750000
NODE_3361_length_1273_cov_42.349233	466	546	3	13	80	0.1625000
NODE_3361_length_1273_cov_42.349233	466	546	4	66	80	0.8250000
NODE_3361_length_1273_cov_42.349233	466	546	5	1	80	0.0125000
NODE_3361_length_1273_cov_42.349233	519	599	3	57	80	0.7125000
NODE_3361_length_1273_cov_42.349233	519	599	4	23	80	0.2875000
NODE_3364_length_1273_cov_4.404600	407	487	0	80	80	1.0000000
NODE_3364_length_1273_cov_4.404600	460	540	0	80	80	1.0000000
NODE_3368_length_1272_cov_28.887468	588	668	0	6	80	0.0750000
NODE_3368_length_1272_cov_28.887468	588	668	2	39	80	0.4875000
NODE_3368_length_1272_cov_28.887468	588	668	3	35	80	0.4375000
NODE_3368_length_1272_cov_28.887468	641	721	3	68	80	0.8500000
NODE_3368_length_1272_cov_28.887468	641	721	5	12	80	0.1500000
NODE_3369_length_1272_cov_11.290708	366	447	3	21	81	0.2592593
NODE_3369_length_1272_cov_11.290708	366	447	4	14	81	0.1728395
NODE_3369_length_1272_cov_11.290708	366	447	5	15	81	0.1851852
NODE_3369_length_1272_cov_11.290708	366	447	6	31	81	0.3827161
NODE_3375_length_1270_cov_13.617421	365	445	4	80	80	1.0000000
NODE_3375_length_1270_cov_13.617421	396	473	2	19	77	0.2467532
NODE_3375_length_1270_cov_13.617421	396	473	4	58	77	0.7532467
NODE_3375_length_1270_cov_13.617421	418	498	1	25	80	0.3125000
NODE_3375_length_1270_cov_13.617421	418	498	2	19	80	0.2375000
NODE_3375_length_1270_cov_13.617421	418	498	4	36	80	0.4500000
NODE_3375_length_1270_cov_13.617421	449	473	2	19	24	0.7916667
NODE_3375_length_1270_cov_13.617421	449	473	4	5	24	0.2083333
NODE_3375_length_1270_cov_13.617421	465	498	1	25	33	0.7575758
NODE_3375_length_1270_cov_13.617421	465	498	2	8	33	0.2424242
NODE_3376_length_1270_cov_11.645602	294	374	2	52	80	0.6500000
NODE_3376_length_1270_cov_11.645602	294	374	3	16	80	0.2000000
NODE_3376_length_1270_cov_11.645602	294	374	5	12	80	0.1500000
NODE_3376_length_1270_cov_11.645602	347	427	3	15	80	0.1875000
NODE_3376_length_1270_cov_11.645602	347	427	5	56	80	0.7000000
NODE_3376_length_1270_cov_11.645602	347	427	6	9	80	0.1125000
NODE_3377_length_1270_cov_2.495303	74	131	5	30	57	0.5263158
NODE_3377_length_1270_cov_2.495303	74	131	7	17	57	0.2982456
NODE_3377_length_1270_cov_2.495303	74	131	9	10	57	0.1754386
NODE_3378_length_1269_cov_55.070940	492	569	5	5	77	0.0649351
NODE_3378_length_1269_cov_55.070940	492	569	6	36	77	0.4675325
NODE_3378_length_1269_cov_55.070940	492	569	7	36	77	0.4675325
NODE_3378_length_1269_cov_55.070940	545	625	6	6	80	0.0750000
NODE_3378_length_1269_cov_55.070940	545	625	7	49	80	0.6125000
NODE_3378_length_1269_cov_55.070940	545	625	8	1	80	0.0125000
NODE_3378_length_1269_cov_55.070940	545	625	9	13	80	0.1625000
NODE_3378_length_1269_cov_55.070940	545	625	10	11	80	0.1375000
NODE_3378_length_1269_cov_55.070940	621	701	4	10	80	0.1250000
NODE_3378_length_1269_cov_55.070940	621	701	5	43	80	0.5375000
NODE_3378_length_1269_cov_55.070940	621	701	6	8	80	0.1000000
NODE_3378_length_1269_cov_55.070940	621	701	7	6	80	0.0750000
NODE_3378_length_1269_cov_55.070940	621	701	9	13	80	0.1625000
NODE_3378_length_1269_cov_55.070940	674	754	4	20	80	0.2500000
NODE_3378_length_1269_cov_55.070940	674	754	5	40	80	0.5000000
NODE_3378_length_1269_cov_55.070940	674	754	6	1	80	0.0125000
NODE_3378_length_1269_cov_55.070940	674	754	7	19	80	0.2375000
NODE_3379_length_1269_cov_22.154701	1152	1216	0	64	64	1.0000000
NODE_3379_length_1269_cov_22.154701	1152	1216	0	64	64	1.0000000
NODE_3379_length_1269_cov_22.154701	1152	1216	0	64	64	1.0000000
NODE_3379_length_1269_cov_22.154701	1189	1269	0	80	80	1.0000000
NODE_3379_length_1269_cov_22.154701	1189	1269	0	80	80	1.0000000
NODE_3380_length_1269_cov_18.753846	317	398	6	35	81	0.4320988
NODE_3380_length_1269_cov_18.753846	317	398	8	46	81	0.5679013
NODE_3381_length_1269_cov_12.637607	580	660	1	37	80	0.4625000
NODE_3381_length_1269_cov_12.637607	580	660	2	1	80	0.0125000
NODE_3381_length_1269_cov_12.637607	580	660	3	42	80	0.5250000
NODE_3381_length_1269_cov_12.637607	633	713	3	46	80	0.5750000
NODE_3381_length_1269_cov_12.637607	633	713	4	26	80	0.3250000
NODE_3381_length_1269_cov_12.637607	633	713	5	8	80	0.1000000
NODE_3381_length_1269_cov_12.637607	709	729	5	18	20	0.9000000
NODE_3381_length_1269_cov_12.637607	709	729	6	2	20	0.1000000
NODE_3381_length_1269_cov_12.637607	709	789	5	18	80	0.2250000
NODE_3381_length_1269_cov_12.637607	709	789	6	49	80	0.6125000
NODE_3381_length_1269_cov_12.637607	709	789	7	3	80	0.0375000
NODE_3381_length_1269_cov_12.637607	709	789	8	10	80	0.1250000
NODE_3381_length_1269_cov_12.637607	762	842	3	31	80	0.3875000
NODE_3381_length_1269_cov_12.637607	762	842	5	2	80	0.0250000
NODE_3381_length_1269_cov_12.637607	762	842	6	26	80	0.3250000
NODE_3381_length_1269_cov_12.637607	762	842	7	18	80	0.2250000
NODE_3381_length_1269_cov_12.637607	762	842	8	3	80	0.0375000
NODE_3382_length_1269_cov_10.552137	765	845	0	80	80	1.0000000
NODE_3382_length_1269_cov_10.552137	818	898	0	80	80	1.0000000
NODE_3391_length_1268_cov_12.862275	300	350	47	1	50	0.0200000
NODE_3391_length_1268_cov_12.862275	300	350	52	2	50	0.0400000
NODE_3391_length_1268_cov_12.862275	300	350	56	2	50	0.0400000
NODE_3391_length_1268_cov_12.862275	300	350	60	1	50	0.0200000
NODE_3391_length_1268_cov_12.862275	300	350	61	1	50	0.0200000
NODE_3391_length_1268_cov_12.862275	300	350	63	1	50	0.0200000
NODE_3391_length_1268_cov_12.862275	300	350	70	1	50	0.0200000
NODE_3391_length_1268_cov_12.862275	300	350	72	2	50	0.0400000
NODE_3391_length_1268_cov_12.862275	300	350	75	2	50	0.0400000
NODE_3391_length_1268_cov_12.862275	300	350	77	1	50	0.0200000
NODE_3391_length_1268_cov_12.862275	300	350	83	2	50	0.0400000
NODE_3391_length_1268_cov_12.862275	300	350	89	1	50	0.0200000
NODE_3391_length_1268_cov_12.862275	300	350	92	1	50	0.0200000
NODE_3391_length_1268_cov_12.862275	300	350	96	1	50	0.0200000
NODE_3391_length_1268_cov_12.862275	300	350	97	2	50	0.0400000
NODE_3391_length_1268_cov_12.862275	300	350	100	1	50	0.0200000
NODE_3391_length_1268_cov_12.862275	300	350	105	1	50	0.0200000
NODE_3391_length_1268_cov_12.862275	300	350	108	1	50	0.0200000
NODE_3391_length_1268_cov_12.862275	300	350	113	1	50	0.0200000
NODE_3391_length_1268_cov_12.862275	300	350	115	3	50	0.0600000
NODE_3391_length_1268_cov_12.862275	300	350	117	1	50	0.0200000
NODE_3391_length_1268_cov_12.862275	300	350	119	3	50	0.0600000
NODE_3391_length_1268_cov_12.862275	300	350	122	1	50	0.0200000
NODE_3391_length_1268_cov_12.862275	300	350	124	2	50	0.0400000
NODE_3391_length_1268_cov_12.862275	300	350	127	1	50	0.0200000
NODE_3391_length_1268_cov_12.862275	300	350	130	1	50	0.0200000
NODE_3391_length_1268_cov_12.862275	300	350	131	1	50	0.0200000
NODE_3391_length_1268_cov_12.862275	300	350	132	1	50	0.0200000
NODE_3391_length_1268_cov_12.862275	300	350	135	1	50	0.0200000
NODE_3391_length_1268_cov_12.862275	300	350	139	1	50	0.0200000
NODE_3391_length_1268_cov_12.862275	300	350	140	2	50	0.0400000
NODE_3391_length_1268_cov_12.862275	300	350	146	3	50	0.0600000
NODE_3391_length_1268_cov_12.862275	300	350	148	1	50	0.0200000
NODE_3391_length_1268_cov_12.862275	300	350	153	1	50	0.0200000
NODE_3391_length_1268_cov_12.862275	300	350	156	1	50	0.0200000
NODE_3391_length_1268_cov_12.862275	300	350	157	1	50	0.0200000
NODE_3392_length_1268_cov_9.523524	265	345	0	9	80	0.1125000
NODE_3392_length_1268_cov_9.523524	265	345	1	17	80	0.2125000
NODE_3392_length_1268_cov_9.523524	265	345	2	54	80	0.6750000
NODE_3392_length_1268_cov_9.523524	318	398	2	80	80	1.0000000
NODE_3393_length_1267_cov_21.315068	299	379	8	1	80	0.0125000
NODE_3393_length_1267_cov_21.315068	299	379	9	24	80	0.3000000
NODE_3393_length_1267_cov_21.315068	299	379	10	26	80	0.3250000
NODE_3393_length_1267_cov_21.315068	299	379	11	4	80	0.0500000
NODE_3393_length_1267_cov_21.315068	299	379	12	14	80	0.1750000
NODE_3393_length_1267_cov_21.315068	299	379	13	11	80	0.1375000
NODE_3393_length_1267_cov_21.315068	352	432	9	6	80	0.0750000
NODE_3393_length_1267_cov_21.315068	352	432	10	35	80	0.4375000
NODE_3393_length_1267_cov_21.315068	352	432	11	7	80	0.0875000
NODE_3393_length_1267_cov_21.315068	352	432	12	21	80	0.2625000
NODE_3393_length_1267_cov_21.315068	352	432	13	11	80	0.1375000
NODE_3393_length_1267_cov_21.315068	698	778	0	80	80	1.0000000
NODE_3393_length_1267_cov_21.315068	751	831	0	80	80	1.0000000
NODE_3394_length_1267_cov_14.880137	606	686	0	80	80	1.0000000
NODE_3394_length_1267_cov_14.880137	659	739	0	80	80	1.0000000
NODE_3397_length_1266_cov_20.584404	357	437	1	69	80	0.8625000
NODE_3397_length_1266_cov_20.584404	357	437	2	11	80	0.1375000
NODE_3397_length_1266_cov_20.584404	410	490	1	16	80	0.2000000
NODE_3397_length_1266_cov_20.584404	410	490	2	64	80	0.8000000
NODE_3398_length_1266_cov_16.571551	359	435	3	44	76	0.5789474
NODE_3398_length_1266_cov_16.571551	359	435	4	32	76	0.4210526
NODE_3398_length_1266_cov_16.571551	408	488	3	12	80	0.1500000
NODE_3398_length_1266_cov_16.571551	408	488	4	55	80	0.6875000
NODE_3398_length_1266_cov_16.571551	408	488	5	13	80	0.1625000
NODE_3399_length_1266_cov_14.218509	517	595	2	78	78	1.0000000
NODE_3399_length_1266_cov_14.218509	568	648	0	52	80	0.6500000
NODE_3399_length_1266_cov_14.218509	568	648	2	28	80	0.3500000
NODE_3399_length_1266_cov_14.218509	644	724	0	80	80	1.0000000
NODE_3399_length_1266_cov_14.218509	697	777	0	80	80	1.0000000
NODE_3403_length_1265_cov_9.807890	429	509	2	33	80	0.4125000
NODE_3403_length_1265_cov_9.807890	429	509	3	47	80	0.5875000
NODE_3403_length_1265_cov_9.807890	482	562	1	8	80	0.1000000
NODE_3403_length_1265_cov_9.807890	482	562	2	11	80	0.1375000
NODE_3403_length_1265_cov_9.807890	482	562	3	61	80	0.7625000
NODE_3404_length_1265_cov_8.233276	160	207	1	12	47	0.2553191
NODE_3404_length_1265_cov_8.233276	160	207	2	7	47	0.1489362
NODE_3404_length_1265_cov_8.233276	160	207	3	20	47	0.4255319
NODE_3404_length_1265_cov_8.233276	160	207	4	1	47	0.0212766
NODE_3404_length_1265_cov_8.233276	160	207	5	2	47	0.0425532
NODE_3404_length_1265_cov_8.233276	160	207	6	5	47	0.1063830
NODE_3404_length_1265_cov_8.233276	1004	1058	0	54	54	1.0000000
NODE_3406_length_1265_cov_3.941681	503	583	1	80	80	1.0000000
NODE_3406_length_1265_cov_3.941681	556	636	0	46	80	0.5750000
NODE_3406_length_1265_cov_3.941681	556	636	1	34	80	0.4250000
NODE_3408_length_1264_cov_8.024034	290	370	0	80	80	1.0000000
NODE_3408_length_1264_cov_8.024034	343	423	0	80	80	1.0000000
NODE_3413_length_1263_cov_8.566151	698	778	0	80	80	1.0000000
NODE_3413_length_1263_cov_8.566151	751	831	0	80	80	1.0000000
NODE_3413_length_1263_cov_8.566151	833	910	0	30	77	0.3896104
NODE_3413_length_1263_cov_8.566151	833	910	1	47	77	0.6103896
NODE_3413_length_1263_cov_8.566151	883	963	1	80	80	1.0000000
NODE_3414_length_1263_cov_7.376289	1060	1140	0	80	80	1.0000000
NODE_3414_length_1263_cov_7.376289	1113	1213	0	100	100	1.0000000
NODE_3416_length_1263_cov_1.827320	227	307	0	80	80	1.0000000
NODE_3416_length_1263_cov_1.827320	280	360	0	80	80	1.0000000
NODE_3418_length_1262_cov_17.416165	404	484	0	80	80	1.0000000
NODE_3418_length_1262_cov_17.416165	457	537	0	75	80	0.9375000
NODE_3418_length_1262_cov_17.416165	457	537	1	5	80	0.0625000
NODE_3419_length_1262_cov_15.268272	648	728	3	80	80	1.0000000
NODE_3419_length_1262_cov_15.268272	701	781	0	17	80	0.2125000
NODE_3419_length_1262_cov_15.268272	701	781	1	4	80	0.0500000
NODE_3419_length_1262_cov_15.268272	701	781	2	5	80	0.0625000
NODE_3419_length_1262_cov_15.268272	701	781	3	54	80	0.6750000
NODE_3419_length_1262_cov_15.268272	777	857	0	80	80	1.0000000
NODE_3419_length_1262_cov_15.268272	830	910	0	80	80	1.0000000
NODE_3424_length_1261_cov_1.777969	272	318	0	46	46	1.0000000
NODE_3425_length_1260_cov_55.640827	499	579	2	53	80	0.6625000
NODE_3425_length_1260_cov_55.640827	499	579	3	2	80	0.0250000
NODE_3425_length_1260_cov_55.640827	499	579	4	5	80	0.0625000
NODE_3425_length_1260_cov_55.640827	499	579	6	20	80	0.2500000
NODE_3425_length_1260_cov_55.640827	552	632	3	2	80	0.0250000
NODE_3425_length_1260_cov_55.640827	552	632	4	5	80	0.0625000
NODE_3425_length_1260_cov_55.640827	552	632	6	23	80	0.2875000
NODE_3425_length_1260_cov_55.640827	552	632	7	18	80	0.2250000
NODE_3425_length_1260_cov_55.640827	552	632	8	24	80	0.3000000
NODE_3425_length_1260_cov_55.640827	552	632	9	1	80	0.0125000
NODE_3425_length_1260_cov_55.640827	552	632	10	7	80	0.0875000
NODE_3425_length_1260_cov_55.640827	628	708	8	4	80	0.0500000
NODE_3425_length_1260_cov_55.640827	628	708	9	7	80	0.0875000
NODE_3425_length_1260_cov_55.640827	628	708	10	47	80	0.5875000
NODE_3425_length_1260_cov_55.640827	628	708	11	22	80	0.2750000
NODE_3425_length_1260_cov_55.640827	681	761	3	2	80	0.0250000
NODE_3425_length_1260_cov_55.640827	681	761	4	9	80	0.1125000
NODE_3425_length_1260_cov_55.640827	681	761	6	1	80	0.0125000
NODE_3425_length_1260_cov_55.640827	681	761	7	8	80	0.1000000
NODE_3425_length_1260_cov_55.640827	681	761	8	28	80	0.3500000
NODE_3425_length_1260_cov_55.640827	681	761	9	16	80	0.2000000
NODE_3425_length_1260_cov_55.640827	681	761	10	12	80	0.1500000
NODE_3425_length_1260_cov_55.640827	681	761	11	4	80	0.0500000
NODE_3426_length_1260_cov_12.242894	427	507	0	16	80	0.2000000
NODE_3426_length_1260_cov_12.242894	427	507	1	17	80	0.2125000
NODE_3426_length_1260_cov_12.242894	427	507	2	47	80	0.5875000
NODE_3426_length_1260_cov_12.242894	480	560	2	76	80	0.9500000
NODE_3426_length_1260_cov_12.242894	480	560	3	4	80	0.0500000
NODE_3436_length_1259_cov_15.381897	509	589	2	80	80	1.0000000
NODE_3436_length_1259_cov_15.381897	562	642	0	46	80	0.5750000
NODE_3436_length_1259_cov_15.381897	562	642	2	34	80	0.4250000
NODE_3439_length_1258_cov_33.519413	608	688	3	69	80	0.8625000
NODE_3439_length_1258_cov_33.519413	608	688	4	11	80	0.1375000
NODE_3439_length_1258_cov_33.519413	661	741	2	8	80	0.1000000
NODE_3439_length_1258_cov_33.519413	661	741	3	70	80	0.8750000
NODE_3439_length_1258_cov_33.519413	661	741	4	2	80	0.0250000
NODE_3440_length_1258_cov_22.569456	583	663	5	12	80	0.1500000
NODE_3440_length_1258_cov_22.569456	583	663	6	5	80	0.0625000
NODE_3440_length_1258_cov_22.569456	583	663	7	38	80	0.4750000
NODE_3440_length_1258_cov_22.569456	583	663	8	25	80	0.3125000
NODE_3440_length_1258_cov_22.569456	636	716	1	15	80	0.1875000
NODE_3440_length_1258_cov_22.569456	636	716	2	10	80	0.1250000
NODE_3440_length_1258_cov_22.569456	636	716	3	6	80	0.0750000
NODE_3440_length_1258_cov_22.569456	636	716	4	10	80	0.1250000
NODE_3440_length_1258_cov_22.569456	636	716	5	24	80	0.3000000
NODE_3440_length_1258_cov_22.569456	636	716	6	5	80	0.0625000
NODE_3440_length_1258_cov_22.569456	636	716	8	10	80	0.1250000
NODE_3441_length_1258_cov_18.747196	308	388	3	22	80	0.2750000
NODE_3441_length_1258_cov_18.747196	308	388	4	58	80	0.7250000
NODE_3441_length_1258_cov_18.747196	361	441	2	14	80	0.1750000
NODE_3441_length_1258_cov_18.747196	361	441	3	32	80	0.4000000
NODE_3441_length_1258_cov_18.747196	361	441	4	34	80	0.4250000
NODE_3441_length_1258_cov_18.747196	437	517	1	36	80	0.4500000
NODE_3441_length_1258_cov_18.747196	437	517	2	44	80	0.5500000
NODE_3441_length_1258_cov_18.747196	490	570	1	26	80	0.3250000
NODE_3441_length_1258_cov_18.747196	490	570	2	54	80	0.6750000
NODE_3442_length_1258_cov_13.699741	332	412	0	80	80	1.0000000
NODE_3442_length_1258_cov_13.699741	385	465	0	80	80	1.0000000
NODE_3447_length_1257_cov_34.029361	567	647	3	80	80	1.0000000
NODE_3447_length_1257_cov_34.029361	620	700	3	70	80	0.8750000
NODE_3447_length_1257_cov_34.029361	620	700	4	10	80	0.1250000
NODE_3447_length_1257_cov_34.029361	696	776	1	7	80	0.0875000
NODE_3447_length_1257_cov_34.029361	696	776	2	67	80	0.8375000
NODE_3447_length_1257_cov_34.029361	696	776	3	4	80	0.0500000
NODE_3447_length_1257_cov_34.029361	696	776	4	2	80	0.0250000
NODE_3447_length_1257_cov_34.029361	749	829	2	80	80	1.0000000
NODE_3449_length_1257_cov_7.892919	317	397	1	8	80	0.1000000
NODE_3449_length_1257_cov_7.892919	317	397	3	23	80	0.2875000
NODE_3449_length_1257_cov_7.892919	317	397	7	4	80	0.0500000
NODE_3449_length_1257_cov_7.892919	317	397	8	25	80	0.3125000
NODE_3449_length_1257_cov_7.892919	317	397	9	1	80	0.0125000
NODE_3449_length_1257_cov_7.892919	317	397	10	11	80	0.1375000
NODE_3449_length_1257_cov_7.892919	317	397	11	8	80	0.1000000
NODE_3449_length_1257_cov_7.892919	370	450	8	7	80	0.0875000
NODE_3449_length_1257_cov_7.892919	370	450	9	1	80	0.0125000
NODE_3449_length_1257_cov_7.892919	370	450	10	11	80	0.1375000
NODE_3449_length_1257_cov_7.892919	370	450	11	30	80	0.3750000
NODE_3449_length_1257_cov_7.892919	370	450	12	5	80	0.0625000
NODE_3449_length_1257_cov_7.892919	370	450	13	26	80	0.3250000
NODE_3452_length_1256_cov_50.506482	389	469	0	17	80	0.2125000
NODE_3452_length_1256_cov_50.506482	389	469	1	63	80	0.7875000
NODE_3452_length_1256_cov_50.506482	442	522	0	29	80	0.3625000
NODE_3452_length_1256_cov_50.506482	442	522	1	51	80	0.6375000
NODE_3452_length_1256_cov_50.506482	518	598	1	15	80	0.1875000
NODE_3452_length_1256_cov_50.506482	518	598	3	16	80	0.2000000
NODE_3452_length_1256_cov_50.506482	518	598	5	19	80	0.2375000
NODE_3452_length_1256_cov_50.506482	518	598	6	16	80	0.2000000
NODE_3452_length_1256_cov_50.506482	518	598	7	14	80	0.1750000
NODE_3452_length_1256_cov_50.506482	571	651	4	20	80	0.2500000
NODE_3452_length_1256_cov_50.506482	571	651	5	6	80	0.0750000
NODE_3452_length_1256_cov_50.506482	571	651	6	13	80	0.1625000
NODE_3452_length_1256_cov_50.506482	571	651	7	41	80	0.5125000
NODE_3453_length_1256_cov_25.944685	754	834	0	36	80	0.4500000
NODE_3453_length_1256_cov_25.944685	754	834	1	44	80	0.5500000
NODE_3453_length_1256_cov_25.944685	807	887	1	30	80	0.3750000
NODE_3453_length_1256_cov_25.944685	807	887	2	50	80	0.6250000
NODE_3455_length_1256_cov_21.720830	713	793	2	7	80	0.0875000
NODE_3455_length_1256_cov_21.720830	713	793	3	73	80	0.9125000
NODE_3455_length_1256_cov_21.720830	766	846	1	41	80	0.5125000
NODE_3455_length_1256_cov_21.720830	766	846	2	19	80	0.2375000
NODE_3455_length_1256_cov_21.720830	766	846	3	20	80	0.2500000
NODE_3456_length_1256_cov_14.242005	595	675	4	10	80	0.1250000
NODE_3456_length_1256_cov_14.242005	595	675	5	21	80	0.2625000
NODE_3456_length_1256_cov_14.242005	595	675	6	1	80	0.0125000
NODE_3456_length_1256_cov_14.242005	595	675	7	48	80	0.6000000
NODE_3456_length_1256_cov_14.242005	648	728	4	63	80	0.7875000
NODE_3456_length_1256_cov_14.242005	648	728	5	16	80	0.2000000
NODE_3456_length_1256_cov_14.242005	648	728	6	1	80	0.0125000
NODE_3457_length_1256_cov_5.870354	879	959	0	80	80	1.0000000
NODE_3463_length_1255_cov_37.271626	458	538	1	14	80	0.1750000
NODE_3463_length_1255_cov_37.271626	458	538	2	15	80	0.1875000
NODE_3463_length_1255_cov_37.271626	458	538	3	28	80	0.3500000
NODE_3463_length_1255_cov_37.271626	458	538	4	20	80	0.2500000
NODE_3463_length_1255_cov_37.271626	458	538	6	3	80	0.0375000
NODE_3463_length_1255_cov_37.271626	511	591	2	3	80	0.0375000
NODE_3463_length_1255_cov_37.271626	511	591	3	3	80	0.0375000
NODE_3463_length_1255_cov_37.271626	511	591	4	18	80	0.2250000
NODE_3463_length_1255_cov_37.271626	511	591	6	16	80	0.2000000
NODE_3463_length_1255_cov_37.271626	511	591	7	40	80	0.5000000
NODE_3463_length_1255_cov_37.271626	587	667	2	3	80	0.0375000
NODE_3463_length_1255_cov_37.271626	587	667	3	1	80	0.0125000
NODE_3463_length_1255_cov_37.271626	587	667	5	11	80	0.1375000
NODE_3463_length_1255_cov_37.271626	587	667	6	65	80	0.8125000
NODE_3463_length_1255_cov_37.271626	640	720	1	39	80	0.4875000
NODE_3463_length_1255_cov_37.271626	640	720	2	17	80	0.2125000
NODE_3463_length_1255_cov_37.271626	640	720	3	1	80	0.0125000
NODE_3463_length_1255_cov_37.271626	640	720	5	11	80	0.1375000
NODE_3463_length_1255_cov_37.271626	640	720	6	12	80	0.1500000
NODE_3464_length_1255_cov_21.374567	516	596	4	22	80	0.2750000
NODE_3464_length_1255_cov_21.374567	516	596	6	7	80	0.0875000
NODE_3464_length_1255_cov_21.374567	516	596	7	7	80	0.0875000
NODE_3464_length_1255_cov_21.374567	516	596	8	3	80	0.0375000
NODE_3464_length_1255_cov_21.374567	516	596	10	38	80	0.4750000
NODE_3464_length_1255_cov_21.374567	516	596	11	3	80	0.0375000
NODE_3464_length_1255_cov_21.374567	569	649	5	2	80	0.0250000
NODE_3464_length_1255_cov_21.374567	569	649	6	22	80	0.2750000
NODE_3464_length_1255_cov_21.374567	569	649	7	5	80	0.0625000
NODE_3464_length_1255_cov_21.374567	569	649	9	5	80	0.0625000
NODE_3464_length_1255_cov_21.374567	569	649	10	24	80	0.3000000
NODE_3464_length_1255_cov_21.374567	569	649	11	22	80	0.2750000
NODE_3464_length_1255_cov_21.374567	645	725	2	23	80	0.2875000
NODE_3464_length_1255_cov_21.374567	645	725	3	7	80	0.0875000
NODE_3464_length_1255_cov_21.374567	645	725	4	39	80	0.4875000
NODE_3464_length_1255_cov_21.374567	645	725	6	11	80	0.1375000
NODE_3464_length_1255_cov_21.374567	698	778	0	1	80	0.0125000
NODE_3464_length_1255_cov_21.374567	698	778	1	34	80	0.4250000
NODE_3464_length_1255_cov_21.374567	698	778	2	41	80	0.5125000
NODE_3464_length_1255_cov_21.374567	698	778	3	4	80	0.0500000
NODE_3465_length_1255_cov_18.391869	521	601	4	80	80	1.0000000
NODE_3465_length_1255_cov_18.391869	574	654	1	1	80	0.0125000
NODE_3465_length_1255_cov_18.391869	574	654	2	15	80	0.1875000
NODE_3465_length_1255_cov_18.391869	574	654	3	30	80	0.3750000
NODE_3465_length_1255_cov_18.391869	574	654	4	34	80	0.4250000
NODE_3466_length_1255_cov_4.096021	1194	1242	0	43	48	0.8958333
NODE_3466_length_1255_cov_4.096021	1194	1242	2	5	48	0.1041667
NODE_3469_length_1254_cov_32.470996	612	692	7	30	80	0.3750000
NODE_3469_length_1254_cov_32.470996	612	692	9	15	80	0.1875000
NODE_3469_length_1254_cov_32.470996	612	692	10	31	80	0.3875000
NODE_3469_length_1254_cov_32.470996	612	692	11	4	80	0.0500000
NODE_3469_length_1254_cov_32.470996	665	745	4	2	80	0.0250000
NODE_3469_length_1254_cov_32.470996	665	745	7	10	80	0.1250000
NODE_3469_length_1254_cov_32.470996	665	745	8	6	80	0.0750000
NODE_3469_length_1254_cov_32.470996	665	745	9	40	80	0.5000000
NODE_3469_length_1254_cov_32.470996	665	745	10	22	80	0.2750000
NODE_3470_length_1254_cov_26.449351	488	568	3	8	80	0.1000000
NODE_3470_length_1254_cov_26.449351	488	568	4	26	80	0.3250000
NODE_3470_length_1254_cov_26.449351	488	568	5	46	80	0.5750000
NODE_3470_length_1254_cov_26.449351	541	621	2	5	80	0.0625000
NODE_3470_length_1254_cov_26.449351	541	621	3	45	80	0.5625000
NODE_3470_length_1254_cov_26.449351	541	621	5	30	80	0.3750000
NODE_3471_length_1254_cov_22.032035	531	611	1	38	80	0.4750000
NODE_3471_length_1254_cov_22.032035	531	611	3	24	80	0.3000000
NODE_3471_length_1254_cov_22.032035	531	611	4	18	80	0.2250000
NODE_3471_length_1254_cov_22.032035	584	664	3	52	80	0.6500000
NODE_3471_length_1254_cov_22.032035	584	664	4	28	80	0.3500000
NODE_3479_length_1253_cov_16.916811	651	731	0	80	80	1.0000000
NODE_3479_length_1253_cov_16.916811	704	784	0	80	80	1.0000000
NODE_3479_length_1253_cov_16.916811	780	860	0	80	80	1.0000000
NODE_3479_length_1253_cov_16.916811	833	913	0	80	80	1.0000000
NODE_3480_length_1253_cov_13.816291	811	891	1	25	80	0.3125000
NODE_3480_length_1253_cov_13.816291	811	891	2	3	80	0.0375000
NODE_3480_length_1253_cov_13.816291	811	891	3	2	80	0.0250000
NODE_3480_length_1253_cov_13.816291	811	891	5	17	80	0.2125000
NODE_3480_length_1253_cov_13.816291	811	891	6	6	80	0.0750000
NODE_3480_length_1253_cov_13.816291	811	891	7	9	80	0.1125000
NODE_3480_length_1253_cov_13.816291	811	891	8	4	80	0.0500000
NODE_3480_length_1253_cov_13.816291	811	891	10	10	80	0.1250000
NODE_3480_length_1253_cov_13.816291	811	891	12	4	80	0.0500000
NODE_3481_length_1253_cov_9.067591	306	386	2	37	80	0.4625000
NODE_3481_length_1253_cov_9.067591	306	386	3	1	80	0.0125000
NODE_3481_length_1253_cov_9.067591	306	386	4	12	80	0.1500000
NODE_3481_length_1253_cov_9.067591	306	386	5	20	80	0.2500000
NODE_3481_length_1253_cov_9.067591	306	386	6	10	80	0.1250000
NODE_3481_length_1253_cov_9.067591	359	439	2	76	80	0.9500000
NODE_3481_length_1253_cov_9.067591	359	439	3	4	80	0.0500000
NODE_3487_length_1252_cov_57.745880	477	557	2	30	80	0.3750000
NODE_3487_length_1252_cov_57.745880	477	557	3	21	80	0.2625000
NODE_3487_length_1252_cov_57.745880	477	557	4	29	80	0.3625000
NODE_3487_length_1252_cov_57.745880	530	610	3	72	80	0.9000000
NODE_3487_length_1252_cov_57.745880	530	610	4	8	80	0.1000000
NODE_3487_length_1252_cov_57.745880	606	686	2	27	80	0.3375000
NODE_3487_length_1252_cov_57.745880	606	686	3	36	80	0.4500000
NODE_3487_length_1252_cov_57.745880	606	686	4	17	80	0.2125000
NODE_3487_length_1252_cov_57.745880	659	739	2	73	80	0.9125000
NODE_3487_length_1252_cov_57.745880	659	739	3	7	80	0.0875000
NODE_3488_length_1252_cov_56.694709	594	674	2	27	80	0.3375000
NODE_3488_length_1252_cov_56.694709	594	674	3	53	80	0.6625000
NODE_3488_length_1252_cov_56.694709	647	727	3	30	80	0.3750000
NODE_3488_length_1252_cov_56.694709	647	727	4	8	80	0.1000000
NODE_3488_length_1252_cov_56.694709	647	727	5	42	80	0.5250000
NODE_3488_length_1252_cov_56.694709	723	803	3	29	80	0.3625000
NODE_3488_length_1252_cov_56.694709	723	803	4	6	80	0.0750000
NODE_3488_length_1252_cov_56.694709	723	803	5	11	80	0.1375000
NODE_3488_length_1252_cov_56.694709	723	803	6	13	80	0.1625000
NODE_3488_length_1252_cov_56.694709	723	803	7	21	80	0.2625000
NODE_3488_length_1252_cov_56.694709	785	847	5	19	62	0.3064516
NODE_3488_length_1252_cov_56.694709	785	847	6	4	62	0.0645161
NODE_3488_length_1252_cov_56.694709	785	847	7	39	62	0.6290323
NODE_3489_length_1252_cov_34.023417	468	548	0	62	80	0.7750000
NODE_3489_length_1252_cov_34.023417	468	548	1	18	80	0.2250000
NODE_3489_length_1252_cov_34.023417	521	601	0	9	80	0.1125000
NODE_3489_length_1252_cov_34.023417	521	601	1	71	80	0.8875000
NODE_3489_length_1252_cov_34.023417	597	677	1	55	80	0.6875000
NODE_3489_length_1252_cov_34.023417	597	677	2	25	80	0.3125000
NODE_3489_length_1252_cov_34.023417	650	730	1	15	80	0.1875000
NODE_3489_length_1252_cov_34.023417	650	730	2	34	80	0.4250000
NODE_3489_length_1252_cov_34.023417	650	730	3	31	80	0.3875000
NODE_3490_length_1252_cov_9.316565	573	653	1	17	80	0.2125000
NODE_3490_length_1252_cov_9.316565	573	653	3	27	80	0.3375000
NODE_3490_length_1252_cov_9.316565	573	653	4	8	80	0.1000000
NODE_3490_length_1252_cov_9.316565	573	653	5	28	80	0.3500000
NODE_3490_length_1252_cov_9.316565	626	706	0	14	80	0.1750000
NODE_3490_length_1252_cov_9.316565	626	706	1	56	80	0.7000000
NODE_3490_length_1252_cov_9.316565	626	706	3	10	80	0.1250000
NODE_3491_length_1252_cov_8.295750	602	682	0	80	80	1.0000000
NODE_3491_length_1252_cov_8.295750	655	735	0	80	80	1.0000000
NODE_3494_length_1251_cov_17.513889	579	659	0	27	80	0.3375000
NODE_3494_length_1251_cov_17.513889	579	659	2	11	80	0.1375000
NODE_3494_length_1251_cov_17.513889	579	659	4	42	80	0.5250000
NODE_3494_length_1251_cov_17.513889	632	712	0	51	80	0.6375000
NODE_3494_length_1251_cov_17.513889	632	712	1	6	80	0.0750000
NODE_3494_length_1251_cov_17.513889	632	712	2	16	80	0.2000000
NODE_3494_length_1251_cov_17.513889	632	712	3	7	80	0.0875000
NODE_3494_length_1251_cov_17.513889	708	788	3	67	80	0.8375000
NODE_3494_length_1251_cov_17.513889	708	788	4	13	80	0.1625000
NODE_3494_length_1251_cov_17.513889	761	841	2	2	80	0.0250000
NODE_3494_length_1251_cov_17.513889	761	841	3	20	80	0.2500000
NODE_3494_length_1251_cov_17.513889	761	841	4	58	80	0.7250000
NODE_3497_length_1251_cov_3.139757	0	76	0	33	76	0.4342105
NODE_3497_length_1251_cov_3.139757	0	76	2	43	76	0.5657895
NODE_3497_length_1251_cov_3.139757	49	98	2	47	49	0.9591837
NODE_3497_length_1251_cov_3.139757	49	98	11	2	49	0.0408163
NODE_3501_length_1250_cov_25.133797	325	405	0	80	80	1.0000000
NODE_3501_length_1250_cov_25.133797	378	458	0	37	80	0.4625000
NODE_3501_length_1250_cov_25.133797	378	458	1	39	80	0.4875000
NODE_3501_length_1250_cov_25.133797	378	458	2	4	80	0.0500000
NODE_3503_length_1250_cov_11.471764	652	733	2	81	81	1.0000000
NODE_3503_length_1250_cov_11.471764	706	786	0	4	80	0.0500000
NODE_3503_length_1250_cov_11.471764	706	786	1	11	80	0.1375000
NODE_3503_length_1250_cov_11.471764	706	786	2	65	80	0.8125000
NODE_3505_length_1249_cov_45.772174	543	623	1	53	80	0.6625000
NODE_3505_length_1249_cov_45.772174	543	623	2	21	80	0.2625000
NODE_3505_length_1249_cov_45.772174	543	623	3	6	80	0.0750000
NODE_3505_length_1249_cov_45.772174	596	676	1	59	80	0.7375000
NODE_3505_length_1249_cov_45.772174	596	676	2	8	80	0.1000000
NODE_3505_length_1249_cov_45.772174	596	676	3	13	80	0.1625000
NODE_3505_length_1249_cov_45.772174	672	749	3	18	77	0.2337662
NODE_3505_length_1249_cov_45.772174	672	749	4	6	77	0.0779221
NODE_3505_length_1249_cov_45.772174	672	749	5	15	77	0.1948052
NODE_3505_length_1249_cov_45.772174	672	749	6	28	77	0.3636364
NODE_3505_length_1249_cov_45.772174	672	749	7	8	77	0.1038961
NODE_3505_length_1249_cov_45.772174	672	749	9	2	77	0.0259740
NODE_3505_length_1249_cov_45.772174	729	802	6	10	73	0.1369863
NODE_3505_length_1249_cov_45.772174	729	802	7	8	73	0.1095890
NODE_3505_length_1249_cov_45.772174	729	802	9	45	73	0.6164383
NODE_3505_length_1249_cov_45.772174	729	802	10	10	73	0.1369863
NODE_3506_length_1249_cov_35.670435	515	595	4	24	80	0.3000000
NODE_3506_length_1249_cov_35.670435	515	595	5	51	80	0.6375000
NODE_3506_length_1249_cov_35.670435	515	595	6	5	80	0.0625000
NODE_3506_length_1249_cov_35.670435	568	648	3	7	80	0.0875000
NODE_3506_length_1249_cov_35.670435	568	648	4	3	80	0.0375000
NODE_3506_length_1249_cov_35.670435	568	648	5	65	80	0.8125000
NODE_3506_length_1249_cov_35.670435	568	648	6	5	80	0.0625000
NODE_3506_length_1249_cov_35.670435	644	724	3	4	80	0.0500000
NODE_3506_length_1249_cov_35.670435	644	724	4	12	80	0.1500000
NODE_3506_length_1249_cov_35.670435	644	724	5	44	80	0.5500000
NODE_3506_length_1249_cov_35.670435	644	724	6	20	80	0.2500000
NODE_3506_length_1249_cov_35.670435	697	777	4	27	80	0.3375000
NODE_3506_length_1249_cov_35.670435	697	777	5	31	80	0.3875000
NODE_3506_length_1249_cov_35.670435	697	777	6	22	80	0.2750000
NODE_3507_length_1249_cov_34.616522	576	656	3	80	80	1.0000000
NODE_3507_length_1249_cov_34.616522	629	709	0	3	80	0.0375000
NODE_3507_length_1249_cov_34.616522	629	709	1	33	80	0.4125000
NODE_3507_length_1249_cov_34.616522	629	709	3	44	80	0.5500000
NODE_3507_length_1249_cov_34.616522	705	785	0	79	80	0.9875000
NODE_3507_length_1249_cov_34.616522	705	785	1	1	80	0.0125000
NODE_3507_length_1249_cov_34.616522	758	838	0	80	80	1.0000000
NODE_3508_length_1249_cov_19.592174	461	541	5	30	80	0.3750000
NODE_3508_length_1249_cov_19.592174	461	541	6	50	80	0.6250000
NODE_3508_length_1249_cov_19.592174	514	594	2	4	80	0.0500000
NODE_3508_length_1249_cov_19.592174	514	594	3	41	80	0.5125000
NODE_3508_length_1249_cov_19.592174	514	594	5	31	80	0.3875000
NODE_3508_length_1249_cov_19.592174	514	594	6	4	80	0.0500000
NODE_3508_length_1249_cov_19.592174	860	940	0	80	80	1.0000000
NODE_3508_length_1249_cov_19.592174	913	993	0	80	80	1.0000000
NODE_3509_length_1249_cov_14.926957	1153	1219	2	17	66	0.2575758
NODE_3509_length_1249_cov_14.926957	1153	1219	3	49	66	0.7424242
NODE_3509_length_1249_cov_14.926957	1192	1249	2	47	57	0.8245614
NODE_3509_length_1249_cov_14.926957	1192	1249	3	10	57	0.1754386
NODE_3509_length_1249_cov_14.926957	1192	1247	2	45	55	0.8181818
NODE_3509_length_1249_cov_14.926957	1192	1247	3	10	55	0.1818182
NODE_3509_length_1249_cov_14.926957	1192	1249	2	47	57	0.8245614
NODE_3509_length_1249_cov_14.926957	1192	1249	3	10	57	0.1754386
NODE_3510_length_1249_cov_7.682609	757	837	0	80	80	1.0000000
NODE_3510_length_1249_cov_7.682609	810	890	0	80	80	1.0000000
NODE_3514_length_1248_cov_14.351610	469	549	0	33	80	0.4125000
NODE_3514_length_1248_cov_14.351610	469	549	1	47	80	0.5875000
NODE_3514_length_1248_cov_14.351610	522	602	0	9	80	0.1125000
NODE_3514_length_1248_cov_14.351610	522	602	1	71	80	0.8875000
NODE_3514_length_1248_cov_14.351610	598	678	1	80	80	1.0000000
NODE_3514_length_1248_cov_14.351610	651	731	1	80	80	1.0000000
NODE_3515_length_1248_cov_11.181027	303	383	3	73	80	0.9125000
NODE_3515_length_1248_cov_11.181027	303	383	4	7	80	0.0875000
NODE_3515_length_1248_cov_11.181027	356	436	1	1	80	0.0125000
NODE_3515_length_1248_cov_11.181027	356	436	2	40	80	0.5000000
NODE_3515_length_1248_cov_11.181027	356	436	3	20	80	0.2500000
NODE_3515_length_1248_cov_11.181027	356	436	4	19	80	0.2375000
NODE_3515_length_1248_cov_11.181027	432	512	2	25	80	0.3125000
NODE_3515_length_1248_cov_11.181027	432	512	3	15	80	0.1875000
NODE_3515_length_1248_cov_11.181027	432	512	4	17	80	0.2125000
NODE_3515_length_1248_cov_11.181027	432	512	5	23	80	0.2875000
NODE_3515_length_1248_cov_11.181027	485	565	4	28	80	0.3500000
NODE_3515_length_1248_cov_11.181027	485	565	5	52	80	0.6500000
NODE_3516_length_1248_cov_4.372498	17	98	4	81	81	1.0000000
NODE_3516_length_1248_cov_4.372498	94	152	0	19	58	0.3275862
NODE_3516_length_1248_cov_4.372498	94	152	2	24	58	0.4137931
NODE_3516_length_1248_cov_4.372498	94	152	4	15	58	0.2586207
NODE_3517_length_1248_cov_2.356832	952	1032	0	3	80	0.0375000
NODE_3517_length_1248_cov_2.356832	952	1032	2	77	80	0.9625000
NODE_3517_length_1248_cov_2.356832	1005	1085	0	56	80	0.7000000
NODE_3517_length_1248_cov_2.356832	1005	1085	2	24	80	0.3000000
NODE_3518_length_1248_cov_2.283725	1102	1151	0	49	49	1.0000000
NODE_3522_length_1247_cov_25.355401	487	567	0	80	80	1.0000000
NODE_3522_length_1247_cov_25.355401	540	620	0	80	80	1.0000000
NODE_3522_length_1247_cov_25.355401	616	696	0	80	80	1.0000000
NODE_3522_length_1247_cov_25.355401	669	749	0	80	80	1.0000000
NODE_3528_length_1246_cov_30.231909	433	513	3	31	80	0.3875000
NODE_3528_length_1246_cov_30.231909	433	513	4	42	80	0.5250000
NODE_3528_length_1246_cov_30.231909	433	513	5	7	80	0.0875000
NODE_3528_length_1246_cov_30.231909	486	566	2	15	80	0.1875000
NODE_3528_length_1246_cov_30.231909	486	566	3	48	80	0.6000000
NODE_3528_length_1246_cov_30.231909	486	566	4	10	80	0.1250000
NODE_3528_length_1246_cov_30.231909	486	566	5	7	80	0.0875000
NODE_3528_length_1246_cov_30.231909	562	642	2	4	80	0.0500000
NODE_3528_length_1246_cov_30.231909	562	642	5	69	80	0.8625000
NODE_3528_length_1246_cov_30.231909	562	642	6	7	80	0.0875000
NODE_3528_length_1246_cov_30.231909	615	695	0	35	80	0.4375000
NODE_3528_length_1246_cov_30.231909	615	695	4	14	80	0.1750000
NODE_3528_length_1246_cov_30.231909	615	695	5	31	80	0.3875000
NODE_3529_length_1246_cov_13.847428	497	577	0	4	80	0.0500000
NODE_3529_length_1246_cov_13.847428	497	577	2	76	80	0.9500000
NODE_3529_length_1246_cov_13.847428	550	630	0	57	80	0.7125000
NODE_3529_length_1246_cov_13.847428	550	630	2	23	80	0.2875000
NODE_3535_length_1245_cov_31.472949	443	523	6	12	80	0.1500000
NODE_3535_length_1245_cov_31.472949	443	523	7	11	80	0.1375000
NODE_3535_length_1245_cov_31.472949	443	523	8	53	80	0.6625000
NODE_3535_length_1245_cov_31.472949	443	523	9	4	80	0.0500000
NODE_3535_length_1245_cov_31.472949	496	576	3	36	80	0.4500000
NODE_3535_length_1245_cov_31.472949	496	576	5	13	80	0.1625000
NODE_3535_length_1245_cov_31.472949	496	576	6	7	80	0.0875000
NODE_3535_length_1245_cov_31.472949	496	576	7	2	80	0.0250000
NODE_3535_length_1245_cov_31.472949	496	576	8	18	80	0.2250000
NODE_3535_length_1245_cov_31.472949	496	576	9	4	80	0.0500000
NODE_3536_length_1245_cov_30.068935	771	841	0	70	70	1.0000000
NODE_3537_length_1245_cov_24.765271	668	748	0	80	80	1.0000000
NODE_3537_length_1245_cov_24.765271	721	801	0	80	80	1.0000000
NODE_3537_length_1245_cov_24.765271	797	877	0	5	80	0.0625000
NODE_3537_length_1245_cov_24.765271	797	877	2	18	80	0.2250000
NODE_3537_length_1245_cov_24.765271	797	877	3	4	80	0.0500000
NODE_3537_length_1245_cov_24.765271	797	877	4	53	80	0.6625000
NODE_3537_length_1245_cov_24.765271	850	930	2	10	80	0.1250000
NODE_3537_length_1245_cov_24.765271	850	930	4	70	80	0.8750000
NODE_3538_length_1245_cov_16.854276	655	735	11	25	80	0.3125000
NODE_3538_length_1245_cov_16.854276	655	735	12	4	80	0.0500000
NODE_3538_length_1245_cov_16.854276	655	735	13	40	80	0.5000000
NODE_3538_length_1245_cov_16.854276	655	735	14	11	80	0.1375000
NODE_3538_length_1245_cov_16.854276	701	771	7	5	70	0.0714286
NODE_3538_length_1245_cov_16.854276	701	771	8	4	70	0.0571429
NODE_3538_length_1245_cov_16.854276	701	771	10	14	70	0.2000000
NODE_3538_length_1245_cov_16.854276	701	771	11	38	70	0.5428572
NODE_3538_length_1245_cov_16.854276	701	771	12	1	70	0.0142857
NODE_3538_length_1245_cov_16.854276	701	771	13	8	70	0.1142857
NODE_3538_length_1245_cov_16.854276	708	788	7	22	80	0.2750000
NODE_3538_length_1245_cov_16.854276	708	788	8	4	80	0.0500000
NODE_3538_length_1245_cov_16.854276	708	788	10	14	80	0.1750000
NODE_3538_length_1245_cov_16.854276	708	788	11	38	80	0.4750000
NODE_3538_length_1245_cov_16.854276	708	788	12	1	80	0.0125000
NODE_3538_length_1245_cov_16.854276	708	788	13	1	80	0.0125000
NODE_3540_length_1245_cov_1.187609	1148	1194	0	7	46	0.1521739
NODE_3540_length_1245_cov_1.187609	1148	1194	2	39	46	0.8478261
NODE_3540_length_1245_cov_1.187609	1167	1245	0	58	78	0.7435898
NODE_3540_length_1245_cov_1.187609	1167	1245	2	20	78	0.2564103
NODE_3541_length_1244_cov_52.633188	501	581	6	4	80	0.0500000
NODE_3541_length_1244_cov_52.633188	501	581	7	10	80	0.1250000
NODE_3541_length_1244_cov_52.633188	501	581	9	44	80	0.5500000
NODE_3541_length_1244_cov_52.633188	501	581	10	22	80	0.2750000
NODE_3541_length_1244_cov_52.633188	554	634	2	11	80	0.1375000
NODE_3541_length_1244_cov_52.633188	554	634	3	1	80	0.0125000
NODE_3541_length_1244_cov_52.633188	554	634	4	35	80	0.4375000
NODE_3541_length_1244_cov_52.633188	554	634	5	2	80	0.0250000
NODE_3541_length_1244_cov_52.633188	554	634	6	8	80	0.1000000
NODE_3541_length_1244_cov_52.633188	554	634	7	10	80	0.1250000
NODE_3541_length_1244_cov_52.633188	554	634	9	13	80	0.1625000
NODE_3541_length_1244_cov_52.633188	630	710	4	5	80	0.0625000
NODE_3541_length_1244_cov_52.633188	630	710	5	8	80	0.1000000
NODE_3541_length_1244_cov_52.633188	630	710	6	57	80	0.7125000
NODE_3541_length_1244_cov_52.633188	630	710	7	10	80	0.1250000
NODE_3541_length_1244_cov_52.633188	683	763	4	35	80	0.4375000
NODE_3541_length_1244_cov_52.633188	683	763	5	26	80	0.3250000
NODE_3541_length_1244_cov_52.633188	683	763	6	9	80	0.1125000
NODE_3541_length_1244_cov_52.633188	683	763	7	10	80	0.1250000
NODE_3542_length_1244_cov_33.889956	445	525	5	40	80	0.5000000
NODE_3542_length_1244_cov_33.889956	445	525	6	2	80	0.0250000
NODE_3542_length_1244_cov_33.889956	445	525	7	38	80	0.4750000
NODE_3542_length_1244_cov_33.889956	498	578	4	3	80	0.0375000
NODE_3542_length_1244_cov_33.889956	498	578	5	47	80	0.5875000
NODE_3542_length_1244_cov_33.889956	498	578	6	26	80	0.3250000
NODE_3542_length_1244_cov_33.889956	498	578	7	4	80	0.0500000
NODE_3542_length_1244_cov_33.889956	574	654	5	12	80	0.1500000
NODE_3542_length_1244_cov_33.889956	574	654	6	3	80	0.0375000
NODE_3542_length_1244_cov_33.889956	574	654	7	47	80	0.5875000
NODE_3542_length_1244_cov_33.889956	574	654	8	18	80	0.2250000
NODE_3542_length_1244_cov_33.889956	627	707	2	1	80	0.0125000
NODE_3542_length_1244_cov_33.889956	627	707	3	19	80	0.2375000
NODE_3542_length_1244_cov_33.889956	627	707	4	5	80	0.0625000
NODE_3542_length_1244_cov_33.889956	627	707	6	9	80	0.1125000
NODE_3542_length_1244_cov_33.889956	627	707	7	46	80	0.5750000
NODE_3543_length_1244_cov_16.798253	644	724	3	80	80	1.0000000
NODE_3543_length_1244_cov_16.798253	697	777	0	17	80	0.2125000
NODE_3543_length_1244_cov_16.798253	697	777	1	11	80	0.1375000
NODE_3543_length_1244_cov_16.798253	697	777	2	15	80	0.1875000
NODE_3543_length_1244_cov_16.798253	697	777	3	37	80	0.4625000
NODE_3544_length_1244_cov_1.735371	276	347	0	39	71	0.5492958
NODE_3544_length_1244_cov_1.735371	276	347	1	32	71	0.4507042
NODE_3544_length_1244_cov_1.735371	276	347	0	39	71	0.5492958
NODE_3544_length_1244_cov_1.735371	276	347	1	32	71	0.4507042
NODE_3544_length_1244_cov_1.735371	320	400	1	80	80	1.0000000
NODE_3544_length_1244_cov_1.735371	320	400	1	80	80	1.0000000
NODE_3548_length_1243_cov_34.284965	774	854	5	80	80	1.0000000
NODE_3548_length_1243_cov_34.284965	827	907	2	15	80	0.1875000
NODE_3548_length_1243_cov_34.284965	827	907	3	21	80	0.2625000
NODE_3548_length_1243_cov_34.284965	827	907	5	44	80	0.5500000
NODE_3552_length_1242_cov_29.665792	539	619	2	19	80	0.2375000
NODE_3552_length_1242_cov_29.665792	539	619	4	36	80	0.4500000
NODE_3552_length_1242_cov_29.665792	539	619	6	25	80	0.3125000
NODE_3552_length_1242_cov_29.665792	592	672	0	16	80	0.2000000
NODE_3552_length_1242_cov_29.665792	592	672	2	12	80	0.1500000
NODE_3552_length_1242_cov_29.665792	592	672	4	6	80	0.0750000
NODE_3552_length_1242_cov_29.665792	592	672	6	46	80	0.5750000
NODE_3553_length_1242_cov_28.304462	506	586	0	34	80	0.4250000
NODE_3553_length_1242_cov_28.304462	506	586	2	46	80	0.5750000
NODE_3553_length_1242_cov_28.304462	559	639	2	80	80	1.0000000
NODE_3553_length_1242_cov_28.304462	635	715	0	41	80	0.5125000
NODE_3553_length_1242_cov_28.304462	635	715	2	39	80	0.4875000
NODE_3553_length_1242_cov_28.304462	688	768	0	80	80	1.0000000
NODE_3554_length_1242_cov_16.383202	704	784	0	80	80	1.0000000
NODE_3554_length_1242_cov_16.383202	757	837	0	80	80	1.0000000
NODE_3555_length_1242_cov_8.081365	688	768	0	80	80	1.0000000
NODE_3555_length_1242_cov_8.081365	741	821	0	80	80	1.0000000
NODE_3561_length_1241_cov_36.544658	602	682	4	25	80	0.3125000
NODE_3561_length_1241_cov_36.544658	602	682	5	55	80	0.6875000
NODE_3561_length_1241_cov_36.544658	655	735	1	13	80	0.1625000
NODE_3561_length_1241_cov_36.544658	655	735	2	14	80	0.1750000
NODE_3561_length_1241_cov_36.544658	655	735	3	14	80	0.1750000
NODE_3561_length_1241_cov_36.544658	655	735	4	2	80	0.0250000
NODE_3561_length_1241_cov_36.544658	655	735	5	37	80	0.4625000
NODE_3562_length_1241_cov_19.894921	676	756	1	8	80	0.1000000
NODE_3562_length_1241_cov_19.894921	676	756	2	10	80	0.1250000
NODE_3562_length_1241_cov_19.894921	676	756	3	30	80	0.3750000
NODE_3562_length_1241_cov_19.894921	676	756	4	20	80	0.2500000
NODE_3562_length_1241_cov_19.894921	676	756	5	12	80	0.1500000
NODE_3562_length_1241_cov_19.894921	729	809	4	15	80	0.1875000
NODE_3562_length_1241_cov_19.894921	729	809	5	27	80	0.3375000
NODE_3562_length_1241_cov_19.894921	729	809	6	15	80	0.1875000
NODE_3562_length_1241_cov_19.894921	729	809	7	23	80	0.2875000
NODE_3569_length_1240_cov_38.375110	483	563	0	80	80	1.0000000
NODE_3569_length_1240_cov_38.375110	536	616	0	41	80	0.5125000
NODE_3569_length_1240_cov_38.375110	536	616	2	39	80	0.4875000
NODE_3569_length_1240_cov_38.375110	612	692	2	11	80	0.1375000
NODE_3569_length_1240_cov_38.375110	612	692	3	45	80	0.5625000
NODE_3569_length_1240_cov_38.375110	612	692	5	24	80	0.3000000
NODE_3569_length_1240_cov_38.375110	665	745	3	39	80	0.4875000
NODE_3569_length_1240_cov_38.375110	665	745	5	41	80	0.5125000
NODE_3570_length_1240_cov_24.975460	625	705	1	45	80	0.5625000
NODE_3570_length_1240_cov_24.975460	625	705	2	8	80	0.1000000
NODE_3570_length_1240_cov_24.975460	625	705	3	15	80	0.1875000
NODE_3570_length_1240_cov_24.975460	625	705	4	7	80	0.0875000
NODE_3570_length_1240_cov_24.975460	625	705	6	5	80	0.0625000
NODE_3570_length_1240_cov_24.975460	678	758	3	15	80	0.1875000
NODE_3570_length_1240_cov_24.975460	678	758	4	7	80	0.0875000
NODE_3570_length_1240_cov_24.975460	678	758	5	16	80	0.2000000
NODE_3570_length_1240_cov_24.975460	678	758	6	42	80	0.5250000
NODE_3571_length_1240_cov_23.812445	731	811	1	76	80	0.9500000
NODE_3571_length_1240_cov_23.812445	731	811	3	4	80	0.0500000
NODE_3571_length_1240_cov_23.812445	784	864	1	23	80	0.2875000
NODE_3571_length_1240_cov_23.812445	784	864	2	17	80	0.2125000
NODE_3571_length_1240_cov_23.812445	784	864	3	40	80	0.5000000
NODE_3576_length_1239_cov_37.657895	399	479	4	31	80	0.3875000
NODE_3576_length_1239_cov_37.657895	399	479	8	5	80	0.0625000
NODE_3576_length_1239_cov_37.657895	399	479	9	22	80	0.2750000
NODE_3576_length_1239_cov_37.657895	399	479	10	22	80	0.2750000
NODE_3576_length_1239_cov_37.657895	452	532	7	22	80	0.2750000
NODE_3576_length_1239_cov_37.657895	452	532	8	13	80	0.1625000
NODE_3576_length_1239_cov_37.657895	452	532	9	40	80	0.5000000
NODE_3576_length_1239_cov_37.657895	452	532	10	5	80	0.0625000
NODE_3576_length_1239_cov_37.657895	528	608	2	5	80	0.0625000
NODE_3576_length_1239_cov_37.657895	528	608	4	27	80	0.3375000
NODE_3576_length_1239_cov_37.657895	528	608	6	2	80	0.0250000
NODE_3576_length_1239_cov_37.657895	528	608	7	14	80	0.1750000
NODE_3576_length_1239_cov_37.657895	528	608	8	32	80	0.4000000
NODE_3576_length_1239_cov_37.657895	581	661	2	3	80	0.0375000
NODE_3576_length_1239_cov_37.657895	581	661	4	77	80	0.9625000
NODE_3577_length_1239_cov_14.984211	398	478	1	66	80	0.8250000
NODE_3577_length_1239_cov_14.984211	398	478	2	14	80	0.1750000
NODE_3577_length_1239_cov_14.984211	451	531	1	26	80	0.3250000
NODE_3577_length_1239_cov_14.984211	451	531	2	54	80	0.6750000
NODE_3577_length_1239_cov_14.984211	771	825	0	53	54	0.9814815
NODE_3577_length_1239_cov_14.984211	771	825	1	1	54	0.0185185
NODE_3577_length_1239_cov_14.984211	798	878	0	26	80	0.3250000
NODE_3577_length_1239_cov_14.984211	798	878	1	54	80	0.6750000
NODE_3578_length_1239_cov_13.312281	806	886	2	80	80	1.0000000
NODE_3578_length_1239_cov_13.312281	859	939	0	42	80	0.5250000
NODE_3578_length_1239_cov_13.312281	859	939	2	38	80	0.4750000
NODE_3579_length_1239_cov_7.116667	444	524	1	33	80	0.4125000
NODE_3579_length_1239_cov_7.116667	444	524	2	40	80	0.5000000
NODE_3579_length_1239_cov_7.116667	444	524	3	7	80	0.0875000
NODE_3579_length_1239_cov_7.116667	497	577	1	79	80	0.9875000
NODE_3579_length_1239_cov_7.116667	497	577	2	1	80	0.0125000
NODE_3582_length_1238_cov_33.830553	625	705	0	80	80	1.0000000
NODE_3582_length_1238_cov_33.830553	678	758	0	80	80	1.0000000
NODE_3583_length_1238_cov_8.163301	664	744	4	32	80	0.4000000
NODE_3583_length_1238_cov_8.163301	664	744	6	11	80	0.1375000
NODE_3583_length_1238_cov_8.163301	664	744	7	37	80	0.4625000
NODE_3583_length_1238_cov_8.163301	717	797	1	12	80	0.1500000
NODE_3583_length_1238_cov_8.163301	717	797	2	3	80	0.0375000
NODE_3583_length_1238_cov_8.163301	717	797	4	65	80	0.8125000
NODE_3586_length_1237_cov_24.562390	447	527	5	35	80	0.4375000
NODE_3586_length_1237_cov_24.562390	447	527	6	12	80	0.1500000
NODE_3586_length_1237_cov_24.562390	447	527	7	33	80	0.4125000
NODE_3586_length_1237_cov_24.562390	500	580	2	20	80	0.2500000
NODE_3586_length_1237_cov_24.562390	500	580	3	25	80	0.3125000
NODE_3586_length_1237_cov_24.562390	500	580	5	35	80	0.4375000
NODE_3587_length_1237_cov_9.297012	515	595	2	2	80	0.0250000
NODE_3587_length_1237_cov_9.297012	515	595	3	2	80	0.0250000
NODE_3587_length_1237_cov_9.297012	515	595	5	76	80	0.9500000
NODE_3587_length_1237_cov_9.297012	568	648	4	5	80	0.0625000
NODE_3587_length_1237_cov_9.297012	568	648	5	29	80	0.3625000
NODE_3587_length_1237_cov_9.297012	568	648	6	21	80	0.2625000
NODE_3587_length_1237_cov_9.297012	568	648	7	25	80	0.3125000
NODE_3594_length_1236_cov_46.661390	632	712	13	24	80	0.3000000
NODE_3594_length_1236_cov_46.661390	632	712	14	5	80	0.0625000
NODE_3594_length_1236_cov_46.661390	632	712	15	8	80	0.1000000
NODE_3594_length_1236_cov_46.661390	632	712	16	5	80	0.0625000
NODE_3594_length_1236_cov_46.661390	632	712	17	20	80	0.2500000
NODE_3594_length_1236_cov_46.661390	632	712	18	14	80	0.1750000
NODE_3594_length_1236_cov_46.661390	632	712	19	4	80	0.0500000
NODE_3594_length_1236_cov_46.661390	685	765	9	1	80	0.0125000
NODE_3594_length_1236_cov_46.661390	685	765	11	2	80	0.0250000
NODE_3594_length_1236_cov_46.661390	685	765	12	2	80	0.0250000
NODE_3594_length_1236_cov_46.661390	685	765	13	23	80	0.2875000
NODE_3594_length_1236_cov_46.661390	685	765	14	20	80	0.2500000
NODE_3594_length_1236_cov_46.661390	685	765	16	10	80	0.1250000
NODE_3594_length_1236_cov_46.661390	685	765	17	4	80	0.0500000
NODE_3594_length_1236_cov_46.661390	685	765	18	14	80	0.1750000
NODE_3594_length_1236_cov_46.661390	685	765	19	4	80	0.0500000
NODE_3595_length_1236_cov_8.625330	735	815	0	27	80	0.3375000
NODE_3595_length_1236_cov_8.625330	735	815	2	53	80	0.6625000
NODE_3595_length_1236_cov_8.625330	788	868	0	40	80	0.5000000
NODE_3595_length_1236_cov_8.625330	788	868	2	40	80	0.5000000
NODE_3597_length_1235_cov_31.619718	331	411	0	4	80	0.0500000
NODE_3597_length_1235_cov_31.619718	331	411	2	76	80	0.9500000
NODE_3597_length_1235_cov_31.619718	384	464	2	80	80	1.0000000
NODE_3598_length_1235_cov_20.252641	559	639	4	33	80	0.4125000
NODE_3598_length_1235_cov_20.252641	559	639	5	47	80	0.5875000
NODE_3598_length_1235_cov_20.252641	612	692	1	7	80	0.0875000
NODE_3598_length_1235_cov_20.252641	612	692	2	5	80	0.0625000
NODE_3598_length_1235_cov_20.252641	612	692	3	33	80	0.4125000
NODE_3598_length_1235_cov_20.252641	612	692	5	35	80	0.4375000
NODE_3598_length_1235_cov_20.252641	688	768	0	24	80	0.3000000
NODE_3598_length_1235_cov_20.252641	688	768	1	56	80	0.7000000
NODE_3598_length_1235_cov_20.252641	741	821	0	24	80	0.3000000
NODE_3598_length_1235_cov_20.252641	741	821	1	56	80	0.7000000
NODE_3599_length_1235_cov_18.462148	695	775	0	80	80	1.0000000
NODE_3599_length_1235_cov_18.462148	748	828	0	80	80	1.0000000
NODE_3600_length_1235_cov_8.696303	765	845	6	31	80	0.3875000
NODE_3600_length_1235_cov_8.696303	765	845	7	35	80	0.4375000
NODE_3600_length_1235_cov_8.696303	765	845	8	14	80	0.1750000
NODE_3600_length_1235_cov_8.696303	818	898	4	11	80	0.1375000
NODE_3600_length_1235_cov_8.696303	818	898	5	5	80	0.0625000
NODE_3600_length_1235_cov_8.696303	818	898	6	19	80	0.2375000
NODE_3600_length_1235_cov_8.696303	818	898	7	34	80	0.4250000
NODE_3600_length_1235_cov_8.696303	818	898	8	11	80	0.1375000
NODE_3601_length_1235_cov_5.580106	544	624	1	33	80	0.4125000
NODE_3601_length_1235_cov_5.580106	544	624	2	47	80	0.5875000
NODE_3601_length_1235_cov_5.580106	597	677	1	21	80	0.2625000
NODE_3601_length_1235_cov_5.580106	597	677	2	59	80	0.7375000
NODE_3608_length_1234_cov_27.136564	528	608	2	9	80	0.1125000
NODE_3608_length_1234_cov_27.136564	528	608	3	4	80	0.0500000
NODE_3608_length_1234_cov_27.136564	528	608	6	12	80	0.1500000
NODE_3608_length_1234_cov_27.136564	528	608	7	55	80	0.6875000
NODE_3608_length_1234_cov_27.136564	581	661	6	8	80	0.1000000
NODE_3608_length_1234_cov_27.136564	581	661	7	72	80	0.9000000
NODE_3611_length_1233_cov_64.374780	497	577	0	15	80	0.1875000
NODE_3611_length_1233_cov_64.374780	497	577	1	5	80	0.0625000
NODE_3611_length_1233_cov_64.374780	497	577	2	17	80	0.2125000
NODE_3611_length_1233_cov_64.374780	497	577	3	17	80	0.2125000
NODE_3611_length_1233_cov_64.374780	497	577	5	26	80	0.3250000
NODE_3611_length_1233_cov_64.374780	550	630	3	1	80	0.0125000
NODE_3611_length_1233_cov_64.374780	550	630	5	31	80	0.3875000
NODE_3611_length_1233_cov_64.374780	550	630	6	43	80	0.5375000
NODE_3611_length_1233_cov_64.374780	550	630	8	5	80	0.0625000
NODE_3611_length_1233_cov_64.374780	626	706	5	19	80	0.2375000
NODE_3611_length_1233_cov_64.374780	626	706	7	3	80	0.0375000
NODE_3611_length_1233_cov_64.374780	626	706	8	37	80	0.4625000
NODE_3611_length_1233_cov_64.374780	626	706	9	16	80	0.2000000
NODE_3611_length_1233_cov_64.374780	626	706	10	5	80	0.0625000
NODE_3611_length_1233_cov_64.374780	679	759	4	16	80	0.2000000
NODE_3611_length_1233_cov_64.374780	679	759	5	19	80	0.2375000
NODE_3611_length_1233_cov_64.374780	679	759	6	11	80	0.1375000
NODE_3611_length_1233_cov_64.374780	679	759	7	29	80	0.3625000
NODE_3611_length_1233_cov_64.374780	679	759	8	5	80	0.0625000
NODE_3612_length_1233_cov_52.833333	654	734	2	7	80	0.0875000
NODE_3612_length_1233_cov_52.833333	654	734	4	27	80	0.3375000
NODE_3612_length_1233_cov_52.833333	654	734	6	6	80	0.0750000
NODE_3612_length_1233_cov_52.833333	654	734	7	8	80	0.1000000
NODE_3612_length_1233_cov_52.833333	654	734	8	4	80	0.0500000
NODE_3612_length_1233_cov_52.833333	654	734	9	25	80	0.3125000
NODE_3612_length_1233_cov_52.833333	654	734	10	3	80	0.0375000
NODE_3612_length_1233_cov_52.833333	707	787	9	36	80	0.4500000
NODE_3612_length_1233_cov_52.833333	707	787	10	6	80	0.0750000
NODE_3612_length_1233_cov_52.833333	707	787	11	2	80	0.0250000
NODE_3612_length_1233_cov_52.833333	707	787	12	36	80	0.4500000
NODE_3613_length_1233_cov_18.096120	522	602	2	61	80	0.7625000
NODE_3613_length_1233_cov_18.096120	522	602	3	19	80	0.2375000
NODE_3613_length_1233_cov_18.096120	575	655	2	79	80	0.9875000
NODE_3613_length_1233_cov_18.096120	575	655	3	1	80	0.0125000
NODE_3613_length_1233_cov_18.096120	651	731	0	60	80	0.7500000
NODE_3613_length_1233_cov_18.096120	651	731	1	5	80	0.0625000
NODE_3613_length_1233_cov_18.096120	651	731	2	15	80	0.1875000
NODE_3613_length_1233_cov_18.096120	704	784	0	80	80	1.0000000
NODE_3614_length_1233_cov_15.360670	585	656	1	35	71	0.4929577
NODE_3614_length_1233_cov_15.360670	585	656	2	36	71	0.5070422
NODE_3614_length_1233_cov_15.360670	631	709	1	78	78	1.0000000
NODE_3620_length_1232_cov_62.112974	552	632	9	2	80	0.0250000
NODE_3620_length_1232_cov_62.112974	552	632	10	12	80	0.1500000
NODE_3620_length_1232_cov_62.112974	552	632	11	2	80	0.0250000
NODE_3620_length_1232_cov_62.112974	552	632	12	2	80	0.0250000
NODE_3620_length_1232_cov_62.112974	552	632	13	2	80	0.0250000
NODE_3620_length_1232_cov_62.112974	552	632	14	6	80	0.0750000
NODE_3620_length_1232_cov_62.112974	552	632	15	12	80	0.1500000
NODE_3620_length_1232_cov_62.112974	552	632	16	25	80	0.3125000
NODE_3620_length_1232_cov_62.112974	552	632	17	17	80	0.2125000
NODE_3620_length_1232_cov_62.112974	605	694	12	24	89	0.2696629
NODE_3620_length_1232_cov_62.112974	605	694	13	4	89	0.0449438
NODE_3620_length_1232_cov_62.112974	605	694	14	15	89	0.1685393
NODE_3620_length_1232_cov_62.112974	605	694	15	19	89	0.2134831
NODE_3620_length_1232_cov_62.112974	605	694	16	18	89	0.2022472
NODE_3620_length_1232_cov_62.112974	605	694	17	9	89	0.1011236
NODE_3620_length_1232_cov_62.112974	690	770	7	1	80	0.0125000
NODE_3620_length_1232_cov_62.112974	690	770	8	12	80	0.1500000
NODE_3620_length_1232_cov_62.112974	690	770	9	22	80	0.2750000
NODE_3620_length_1232_cov_62.112974	690	770	10	6	80	0.0750000
NODE_3620_length_1232_cov_62.112974	690	770	11	2	80	0.0250000
NODE_3620_length_1232_cov_62.112974	690	770	12	2	80	0.0250000
NODE_3620_length_1232_cov_62.112974	690	770	13	28	80	0.3500000
NODE_3620_length_1232_cov_62.112974	690	770	14	7	80	0.0875000
NODE_3620_length_1232_cov_62.112974	743	823	6	20	80	0.2500000
NODE_3620_length_1232_cov_62.112974	743	823	7	18	80	0.2250000
NODE_3620_length_1232_cov_62.112974	743	823	8	14	80	0.1750000
NODE_3620_length_1232_cov_62.112974	743	823	9	24	80	0.3000000
NODE_3620_length_1232_cov_62.112974	743	823	10	4	80	0.0500000
NODE_3621_length_1232_cov_34.635481	469	549	0	15	80	0.1875000
NODE_3621_length_1232_cov_34.635481	469	549	2	2	80	0.0250000
NODE_3621_length_1232_cov_34.635481	469	549	3	39	80	0.4875000
NODE_3621_length_1232_cov_34.635481	469	549	5	24	80	0.3000000
NODE_3621_length_1232_cov_34.635481	522	602	1	16	80	0.2000000
NODE_3621_length_1232_cov_34.635481	522	602	2	5	80	0.0625000
NODE_3621_length_1232_cov_34.635481	522	602	3	29	80	0.3625000
NODE_3621_length_1232_cov_34.635481	522	602	5	30	80	0.3750000
NODE_3622_length_1232_cov_16.362754	774	854	0	80	80	1.0000000
NODE_3622_length_1232_cov_16.362754	827	907	0	80	80	1.0000000
NODE_3623_length_1232_cov_13.395410	234	315	5	7	81	0.0864198
NODE_3623_length_1232_cov_13.395410	234	315	6	19	81	0.2345679
NODE_3623_length_1232_cov_13.395410	234	315	7	55	81	0.6790124
NODE_3623_length_1232_cov_13.395410	287	368	6	24	81	0.2962963
NODE_3623_length_1232_cov_13.395410	287	368	7	57	81	0.7037037
NODE_3623_length_1232_cov_13.395410	364	444	4	1	80	0.0125000
NODE_3623_length_1232_cov_13.395410	364	444	5	43	80	0.5375000
NODE_3623_length_1232_cov_13.395410	364	444	6	33	80	0.4125000
NODE_3623_length_1232_cov_13.395410	364	444	7	3	80	0.0375000
NODE_3623_length_1232_cov_13.395410	417	497	2	10	80	0.1250000
NODE_3623_length_1232_cov_13.395410	417	497	3	36	80	0.4500000
NODE_3623_length_1232_cov_13.395410	417	497	4	8	80	0.1000000
NODE_3623_length_1232_cov_13.395410	417	497	5	4	80	0.0500000
NODE_3623_length_1232_cov_13.395410	417	497	6	22	80	0.2750000
NODE_3625_length_1231_cov_47.606890	509	589	7	5	80	0.0625000
NODE_3625_length_1231_cov_47.606890	509	589	8	15	80	0.1875000
NODE_3625_length_1231_cov_47.606890	509	589	9	3	80	0.0375000
NODE_3625_length_1231_cov_47.606890	509	589	10	10	80	0.1250000
NODE_3625_length_1231_cov_47.606890	509	589	11	7	80	0.0875000
NODE_3625_length_1231_cov_47.606890	509	589	12	9	80	0.1125000
NODE_3625_length_1231_cov_47.606890	509	589	13	6	80	0.0750000
NODE_3625_length_1231_cov_47.606890	509	589	14	3	80	0.0375000
NODE_3625_length_1231_cov_47.606890	509	589	15	13	80	0.1625000
NODE_3625_length_1231_cov_47.606890	509	589	16	7	80	0.0875000
NODE_3625_length_1231_cov_47.606890	509	589	17	2	80	0.0250000
NODE_3625_length_1231_cov_47.606890	562	642	13	2	80	0.0250000
NODE_3625_length_1231_cov_47.606890	562	642	14	5	80	0.0625000
NODE_3625_length_1231_cov_47.606890	562	642	15	20	80	0.2500000
NODE_3625_length_1231_cov_47.606890	562	642	16	12	80	0.1500000
NODE_3625_length_1231_cov_47.606890	562	642	17	4	80	0.0500000
NODE_3625_length_1231_cov_47.606890	562	642	18	7	80	0.0875000
NODE_3625_length_1231_cov_47.606890	562	642	19	9	80	0.1125000
NODE_3625_length_1231_cov_47.606890	562	642	20	9	80	0.1125000
NODE_3625_length_1231_cov_47.606890	562	642	21	7	80	0.0875000
NODE_3625_length_1231_cov_47.606890	562	642	22	1	80	0.0125000
NODE_3625_length_1231_cov_47.606890	562	642	23	3	80	0.0375000
NODE_3625_length_1231_cov_47.606890	562	642	25	1	80	0.0125000
NODE_3625_length_1231_cov_47.606890	638	718	23	6	80	0.0750000
NODE_3625_length_1231_cov_47.606890	638	718	24	2	80	0.0250000
NODE_3625_length_1231_cov_47.606890	638	718	25	15	80	0.1875000
NODE_3625_length_1231_cov_47.606890	638	718	26	5	80	0.0625000
NODE_3625_length_1231_cov_47.606890	638	718	27	1	80	0.0125000
NODE_3625_length_1231_cov_47.606890	638	718	28	1	80	0.0125000
NODE_3625_length_1231_cov_47.606890	638	718	29	2	80	0.0250000
NODE_3625_length_1231_cov_47.606890	638	718	31	8	80	0.1000000
NODE_3625_length_1231_cov_47.606890	638	718	32	9	80	0.1125000
NODE_3625_length_1231_cov_47.606890	638	718	33	12	80	0.1500000
NODE_3625_length_1231_cov_47.606890	638	718	34	16	80	0.2000000
NODE_3625_length_1231_cov_47.606890	638	718	35	3	80	0.0375000
NODE_3625_length_1231_cov_47.606890	691	771	22	4	80	0.0500000
NODE_3625_length_1231_cov_47.606890	691	771	24	5	80	0.0625000
NODE_3625_length_1231_cov_47.606890	691	771	25	7	80	0.0875000
NODE_3625_length_1231_cov_47.606890	691	771	26	2	80	0.0250000
NODE_3625_length_1231_cov_47.606890	691	771	27	2	80	0.0250000
NODE_3625_length_1231_cov_47.606890	691	771	28	7	80	0.0875000
NODE_3625_length_1231_cov_47.606890	691	771	29	1	80	0.0125000
NODE_3625_length_1231_cov_47.606890	691	771	30	1	80	0.0125000
NODE_3625_length_1231_cov_47.606890	691	771	31	17	80	0.2125000
NODE_3625_length_1231_cov_47.606890	691	771	32	11	80	0.1375000
NODE_3625_length_1231_cov_47.606890	691	771	33	5	80	0.0625000
NODE_3625_length_1231_cov_47.606890	691	771	34	15	80	0.1875000
NODE_3625_length_1231_cov_47.606890	691	771	35	3	80	0.0375000
NODE_3626_length_1231_cov_27.498233	698	777	0	79	79	1.0000000
NODE_3626_length_1231_cov_27.498233	750	830	0	80	80	1.0000000
NODE_3627_length_1231_cov_21.245583	673	753	3	18	80	0.2250000
NODE_3627_length_1231_cov_21.245583	673	753	4	62	80	0.7750000
NODE_3627_length_1231_cov_21.245583	726	806	1	16	80	0.2000000
NODE_3627_length_1231_cov_21.245583	726	806	2	21	80	0.2625000
NODE_3627_length_1231_cov_21.245583	726	806	3	29	80	0.3625000
NODE_3627_length_1231_cov_21.245583	726	806	4	14	80	0.1750000
NODE_3627_length_1231_cov_21.245583	802	882	0	63	80	0.7875000
NODE_3627_length_1231_cov_21.245583	802	882	1	17	80	0.2125000
NODE_3627_length_1231_cov_21.245583	860	935	0	75	75	1.0000000
NODE_3628_length_1231_cov_9.895760	515	595	17	12	80	0.1500000
NODE_3628_length_1231_cov_9.895760	515	595	18	8	80	0.1000000
NODE_3628_length_1231_cov_9.895760	515	595	19	10	80	0.1250000
NODE_3628_length_1231_cov_9.895760	515	595	20	10	80	0.1250000
NODE_3628_length_1231_cov_9.895760	515	595	21	12	80	0.1500000
NODE_3628_length_1231_cov_9.895760	515	595	22	13	80	0.1625000
NODE_3628_length_1231_cov_9.895760	515	595	23	15	80	0.1875000
NODE_3628_length_1231_cov_9.895760	568	648	7	19	80	0.2375000
NODE_3628_length_1231_cov_9.895760	568	648	8	1	80	0.0125000
NODE_3628_length_1231_cov_9.895760	568	648	9	1	80	0.0125000
NODE_3628_length_1231_cov_9.895760	568	648	12	12	80	0.1500000
NODE_3628_length_1231_cov_9.895760	568	648	13	1	80	0.0125000
NODE_3628_length_1231_cov_9.895760	568	648	14	4	80	0.0500000
NODE_3628_length_1231_cov_9.895760	568	648	16	7	80	0.0875000
NODE_3628_length_1231_cov_9.895760	568	648	19	18	80	0.2250000
NODE_3628_length_1231_cov_9.895760	568	648	20	4	80	0.0500000
NODE_3628_length_1231_cov_9.895760	568	648	21	2	80	0.0250000
NODE_3628_length_1231_cov_9.895760	568	648	22	11	80	0.1375000
NODE_3630_length_1230_cov_43.705570	412	492	4	40	80	0.5000000
NODE_3630_length_1230_cov_43.705570	412	492	6	40	80	0.5000000
NODE_3630_length_1230_cov_43.705570	465	545	0	4	80	0.0500000
NODE_3630_length_1230_cov_43.705570	465	545	2	12	80	0.1500000
NODE_3630_length_1230_cov_43.705570	465	545	3	2	80	0.0250000
NODE_3630_length_1230_cov_43.705570	465	545	4	62	80	0.7750000
NODE_3631_length_1230_cov_43.663130	501	581	3	49	80	0.6125000
NODE_3631_length_1230_cov_43.663130	501	581	5	1	80	0.0125000
NODE_3631_length_1230_cov_43.663130	501	581	6	21	80	0.2625000
NODE_3631_length_1230_cov_43.663130	501	581	7	9	80	0.1125000
NODE_3631_length_1230_cov_43.663130	554	634	5	2	80	0.0250000
NODE_3631_length_1230_cov_43.663130	554	634	6	39	80	0.4875000
NODE_3631_length_1230_cov_43.663130	554	634	7	39	80	0.4875000
NODE_3632_length_1230_cov_33.173298	315	395	7	3	80	0.0375000
NODE_3632_length_1230_cov_33.173298	315	395	8	10	80	0.1250000
NODE_3632_length_1230_cov_33.173298	315	395	9	7	80	0.0875000
NODE_3632_length_1230_cov_33.173298	315	395	10	17	80	0.2125000
NODE_3632_length_1230_cov_33.173298	315	395	11	27	80	0.3375000
NODE_3632_length_1230_cov_33.173298	315	395	14	4	80	0.0500000
NODE_3632_length_1230_cov_33.173298	315	395	15	12	80	0.1500000
NODE_3632_length_1230_cov_33.173298	368	448	11	25	80	0.3125000
NODE_3632_length_1230_cov_33.173298	368	448	12	18	80	0.2250000
NODE_3632_length_1230_cov_33.173298	368	448	13	10	80	0.1250000
NODE_3632_length_1230_cov_33.173298	368	448	14	15	80	0.1875000
NODE_3632_length_1230_cov_33.173298	368	448	15	12	80	0.1500000
NODE_3633_length_1230_cov_12.939876	201	281	0	28	80	0.3500000
NODE_3633_length_1230_cov_12.939876	201	281	1	50	80	0.6250000
NODE_3633_length_1230_cov_12.939876	201	281	2	2	80	0.0250000
NODE_3633_length_1230_cov_12.939876	218	273	0	23	55	0.4181818
NODE_3633_length_1230_cov_12.939876	218	273	1	32	55	0.5818182
NODE_3633_length_1230_cov_12.939876	254	334	1	25	80	0.3125000
NODE_3633_length_1230_cov_12.939876	254	334	2	21	80	0.2625000
NODE_3633_length_1230_cov_12.939876	254	334	3	29	80	0.3625000
NODE_3633_length_1230_cov_12.939876	254	334	4	4	80	0.0500000
NODE_3633_length_1230_cov_12.939876	254	334	6	1	80	0.0125000
NODE_3633_length_1230_cov_12.939876	330	410	4	3	80	0.0375000
NODE_3633_length_1230_cov_12.939876	330	410	6	3	80	0.0375000
NODE_3633_length_1230_cov_12.939876	330	410	8	1	80	0.0125000
NODE_3633_length_1230_cov_12.939876	330	410	9	7	80	0.0875000
NODE_3633_length_1230_cov_12.939876	330	410	12	3	80	0.0375000
NODE_3633_length_1230_cov_12.939876	330	410	13	7	80	0.0875000
NODE_3633_length_1230_cov_12.939876	330	410	14	8	80	0.1000000
NODE_3633_length_1230_cov_12.939876	330	410	15	48	80	0.6000000
NODE_3633_length_1230_cov_12.939876	383	463	9	7	80	0.0875000
NODE_3633_length_1230_cov_12.939876	383	463	11	6	80	0.0750000
NODE_3633_length_1230_cov_12.939876	383	463	12	3	80	0.0375000
NODE_3633_length_1230_cov_12.939876	383	463	14	26	80	0.3250000
NODE_3633_length_1230_cov_12.939876	383	463	15	38	80	0.4750000
NODE_3634_length_1230_cov_5.155615	248	328	0	80	80	1.0000000
NODE_3634_length_1230_cov_5.155615	301	381	0	80	80	1.0000000
NODE_3640_length_1229_cov_30.214159	341	421	5	4	80	0.0500000
NODE_3640_length_1229_cov_30.214159	341	421	6	7	80	0.0875000
NODE_3640_length_1229_cov_30.214159	341	421	7	16	80	0.2000000
NODE_3640_length_1229_cov_30.214159	341	421	8	4	80	0.0500000
NODE_3640_length_1229_cov_30.214159	341	421	10	21	80	0.2625000
NODE_3640_length_1229_cov_30.214159	341	421	11	13	80	0.1625000
NODE_3640_length_1229_cov_30.214159	341	421	12	14	80	0.1750000
NODE_3640_length_1229_cov_30.214159	341	421	14	1	80	0.0125000
NODE_3640_length_1229_cov_30.214159	394	474	10	2	80	0.0250000
NODE_3640_length_1229_cov_30.214159	394	474	11	10	80	0.1250000
NODE_3640_length_1229_cov_30.214159	394	474	12	25	80	0.3125000
NODE_3640_length_1229_cov_30.214159	394	474	13	4	80	0.0500000
NODE_3640_length_1229_cov_30.214159	394	474	14	15	80	0.1875000
NODE_3640_length_1229_cov_30.214159	394	474	15	24	80	0.3000000
NODE_3641_length_1229_cov_23.165487	376	456	2	11	80	0.1375000
NODE_3641_length_1229_cov_23.165487	376	456	3	69	80	0.8625000
NODE_3641_length_1229_cov_23.165487	429	509	1	26	80	0.3250000
NODE_3641_length_1229_cov_23.165487	429	509	2	11	80	0.1375000
NODE_3641_length_1229_cov_23.165487	429	509	3	43	80	0.5375000
NODE_3641_length_1229_cov_23.165487	505	585	1	44	80	0.5500000
NODE_3641_length_1229_cov_23.165487	505	585	3	36	80	0.4500000
NODE_3641_length_1229_cov_23.165487	558	638	2	41	80	0.5125000
NODE_3641_length_1229_cov_23.165487	558	638	3	39	80	0.4875000
NODE_3642_length_1229_cov_19.376991	484	564	4	13	80	0.1625000
NODE_3642_length_1229_cov_19.376991	484	564	5	17	80	0.2125000
NODE_3642_length_1229_cov_19.376991	484	564	6	6	80	0.0750000
NODE_3642_length_1229_cov_19.376991	484	564	7	19	80	0.2375000
NODE_3642_length_1229_cov_19.376991	484	564	8	18	80	0.2250000
NODE_3642_length_1229_cov_19.376991	484	564	9	7	80	0.0875000
NODE_3642_length_1229_cov_19.376991	537	614	6	16	77	0.2077922
NODE_3642_length_1229_cov_19.376991	537	614	7	53	77	0.6883117
NODE_3642_length_1229_cov_19.376991	537	614	8	3	77	0.0389610
NODE_3642_length_1229_cov_19.376991	537	614	9	5	77	0.0649351
NODE_3643_length_1229_cov_11.799115	670	748	1	13	78	0.1666667
NODE_3643_length_1229_cov_11.799115	670	748	2	3	78	0.0384615
NODE_3643_length_1229_cov_11.799115	670	748	4	62	78	0.7948718
NODE_3643_length_1229_cov_11.799115	728	801	1	36	73	0.4931507
NODE_3643_length_1229_cov_11.799115	728	801	3	4	73	0.0547945
NODE_3643_length_1229_cov_11.799115	728	801	4	33	73	0.4520548
NODE_3644_length_1229_cov_8.140708	970	1050	0	80	80	1.0000000
NODE_3644_length_1229_cov_8.140708	1023	1103	0	80	80	1.0000000
NODE_3646_length_1229_cov_3.654867	765	840	0	75	75	1.0000000
NODE_3646_length_1229_cov_3.654867	813	893	0	80	80	1.0000000
NODE_3652_length_1229_cov_0.949558	1034	1079	0	43	45	0.9555556
NODE_3652_length_1229_cov_0.949558	1034	1079	3	2	45	0.0444444
NODE_3652_length_1229_cov_0.949558	1090	1130	0	7	40	0.1750000
NODE_3652_length_1229_cov_0.949558	1090	1130	2	33	40	0.8250000
NODE_3654_length_1228_cov_22.622675	604	684	2	14	80	0.1750000
NODE_3654_length_1228_cov_22.622675	604	684	3	58	80	0.7250000
NODE_3654_length_1228_cov_22.622675	604	684	4	8	80	0.1000000
NODE_3654_length_1228_cov_22.622675	657	738	1	46	81	0.5679013
NODE_3654_length_1228_cov_22.622675	657	738	3	35	81	0.4320988
NODE_3655_length_1228_cov_17.900797	423	503	0	80	80	1.0000000
NODE_3655_length_1228_cov_17.900797	423	503	0	80	80	1.0000000
NODE_3655_length_1228_cov_17.900797	423	503	0	80	80	1.0000000
NODE_3655_length_1228_cov_17.900797	476	538	0	62	62	1.0000000
NODE_3655_length_1228_cov_17.900797	476	538	0	62	62	1.0000000
NODE_3655_length_1228_cov_17.900797	476	538	0	62	62	1.0000000
NODE_3655_length_1228_cov_17.900797	476	556	0	80	80	1.0000000
NODE_3656_length_1228_cov_14.554473	367	447	0	80	80	1.0000000
NODE_3656_length_1228_cov_14.554473	420	500	0	80	80	1.0000000
NODE_3657_length_1228_cov_10.021258	661	741	0	80	80	1.0000000
NODE_3657_length_1228_cov_10.021258	714	794	0	80	80	1.0000000
NODE_3660_length_1228_cov_3.987600	1139	1219	1	33	80	0.4125000
NODE_3660_length_1228_cov_3.987600	1139	1219	2	8	80	0.1000000
NODE_3660_length_1228_cov_3.987600	1139	1219	3	10	80	0.1250000
NODE_3660_length_1228_cov_3.987600	1139	1219	5	29	80	0.3625000
NODE_3662_length_1227_cov_29.002660	423	503	4	8	80	0.1000000
NODE_3662_length_1227_cov_29.002660	423	503	5	4	80	0.0500000
NODE_3662_length_1227_cov_29.002660	423	503	7	2	80	0.0250000
NODE_3662_length_1227_cov_29.002660	423	503	8	26	80	0.3250000
NODE_3662_length_1227_cov_29.002660	423	503	9	8	80	0.1000000
NODE_3662_length_1227_cov_29.002660	423	503	10	32	80	0.4000000
NODE_3662_length_1227_cov_29.002660	476	556	9	18	80	0.2250000
NODE_3662_length_1227_cov_29.002660	476	556	10	37	80	0.4625000
NODE_3662_length_1227_cov_29.002660	476	556	11	25	80	0.3125000
NODE_3663_length_1227_cov_17.479610	759	839	1	12	80	0.1500000
NODE_3663_length_1227_cov_17.479610	759	839	2	54	80	0.6750000
NODE_3663_length_1227_cov_17.479610	759	839	3	14	80	0.1750000
NODE_3663_length_1227_cov_17.479610	812	892	2	64	80	0.8000000
NODE_3663_length_1227_cov_17.479610	812	892	3	16	80	0.2000000
NODE_3666_length_1227_cov_3.808511	120	186	13	1	66	0.0151515
NODE_3666_length_1227_cov_3.808511	120	186	15	2	66	0.0303030
NODE_3666_length_1227_cov_3.808511	120	186	17	3	66	0.0454545
NODE_3666_length_1227_cov_3.808511	120	186	18	2	66	0.0303030
NODE_3666_length_1227_cov_3.808511	120	186	19	1	66	0.0151515
NODE_3666_length_1227_cov_3.808511	120	186	20	8	66	0.1212121
NODE_3666_length_1227_cov_3.808511	120	186	21	1	66	0.0151515
NODE_3666_length_1227_cov_3.808511	120	186	22	7	66	0.1060606
NODE_3666_length_1227_cov_3.808511	120	186	23	30	66	0.4545455
NODE_3666_length_1227_cov_3.808511	120	186	24	11	66	0.1666667
NODE_3666_length_1227_cov_3.808511	173	239	19	2	66	0.0303030
NODE_3666_length_1227_cov_3.808511	173	239	21	1	66	0.0151515
NODE_3666_length_1227_cov_3.808511	173	239	22	10	66	0.1515152
NODE_3666_length_1227_cov_3.808511	173	239	23	2	66	0.0303030
NODE_3666_length_1227_cov_3.808511	173	239	24	51	66	0.7727273
NODE_3666_length_1227_cov_3.808511	229	299	1	4	70	0.0571429
NODE_3666_length_1227_cov_3.808511	229	299	2	7	70	0.1000000
NODE_3666_length_1227_cov_3.808511	229	299	3	9	70	0.1285714
NODE_3666_length_1227_cov_3.808511	229	299	4	2	70	0.0285714
NODE_3666_length_1227_cov_3.808511	229	299	5	16	70	0.2285714
NODE_3666_length_1227_cov_3.808511	229	299	7	1	70	0.0142857
NODE_3666_length_1227_cov_3.808511	229	299	8	1	70	0.0142857
NODE_3666_length_1227_cov_3.808511	229	299	9	13	70	0.1857143
NODE_3666_length_1227_cov_3.808511	229	299	11	1	70	0.0142857
NODE_3666_length_1227_cov_3.808511	229	299	15	3	70	0.0428571
NODE_3666_length_1227_cov_3.808511	229	299	17	2	70	0.0285714
NODE_3666_length_1227_cov_3.808511	229	299	18	1	70	0.0142857
NODE_3666_length_1227_cov_3.808511	229	299	19	2	70	0.0285714
NODE_3666_length_1227_cov_3.808511	229	299	21	1	70	0.0142857
NODE_3666_length_1227_cov_3.808511	229	299	22	7	70	0.1000000
NODE_3672_length_1226_cov_23.792369	579	659	4	41	80	0.5125000
NODE_3672_length_1226_cov_23.792369	579	659	5	39	80	0.4875000
NODE_3672_length_1226_cov_23.792369	632	712	2	30	80	0.3750000
NODE_3672_length_1226_cov_23.792369	632	712	3	3	80	0.0375000
NODE_3672_length_1226_cov_23.792369	632	712	4	41	80	0.5125000
NODE_3672_length_1226_cov_23.792369	632	712	5	6	80	0.0750000
NODE_3672_length_1226_cov_23.792369	708	788	1	34	80	0.4250000
NODE_3672_length_1226_cov_23.792369	708	788	2	46	80	0.5750000
NODE_3672_length_1226_cov_23.792369	761	839	1	33	78	0.4230769
NODE_3672_length_1226_cov_23.792369	761	839	2	45	78	0.5769231
NODE_3673_length_1226_cov_5.620231	463	543	0	80	80	1.0000000
NODE_3673_length_1226_cov_5.620231	516	596	0	79	80	0.9875000
NODE_3673_length_1226_cov_5.620231	516	596	1	1	80	0.0125000
NODE_3674_length_1226_cov_4.881988	582	662	0	17	80	0.2125000
NODE_3674_length_1226_cov_4.881988	582	662	1	63	80	0.7875000
NODE_3674_length_1226_cov_4.881988	635	715	1	80	80	1.0000000
NODE_3682_length_1225_cov_55.596803	637	717	2	10	80	0.1250000
NODE_3682_length_1225_cov_55.596803	637	717	3	8	80	0.1000000
NODE_3682_length_1225_cov_55.596803	637	717	4	40	80	0.5000000
NODE_3682_length_1225_cov_55.596803	637	717	5	19	80	0.2375000
NODE_3682_length_1225_cov_55.596803	637	717	6	3	80	0.0375000
NODE_3682_length_1225_cov_55.596803	690	770	4	80	80	1.0000000
NODE_3682_length_1225_cov_55.596803	766	846	0	36	80	0.4500000
NODE_3682_length_1225_cov_55.596803	766	846	1	1	80	0.0125000
NODE_3682_length_1225_cov_55.596803	766	846	2	4	80	0.0500000
NODE_3682_length_1225_cov_55.596803	766	846	3	8	80	0.1000000
NODE_3682_length_1225_cov_55.596803	766	846	4	31	80	0.3875000
NODE_3682_length_1225_cov_55.596803	819	899	0	80	80	1.0000000
NODE_3683_length_1225_cov_35.189165	661	742	4	1	81	0.0123457
NODE_3683_length_1225_cov_35.189165	661	742	6	6	81	0.0740741
NODE_3683_length_1225_cov_35.189165	661	742	7	32	81	0.3950617
NODE_3683_length_1225_cov_35.189165	661	742	8	29	81	0.3580247
NODE_3683_length_1225_cov_35.189165	661	742	9	13	81	0.1604938
NODE_3683_length_1225_cov_35.189165	714	795	5	4	81	0.0493827
NODE_3683_length_1225_cov_35.189165	714	795	7	17	81	0.2098765
NODE_3683_length_1225_cov_35.189165	714	795	8	26	81	0.3209876
NODE_3683_length_1225_cov_35.189165	714	795	9	34	81	0.4197531
NODE_3684_length_1225_cov_33.755773	456	535	6	30	79	0.3797468
NODE_3684_length_1225_cov_33.755773	456	535	7	49	79	0.6202531
NODE_3684_length_1225_cov_33.755773	508	588	6	30	80	0.3750000
NODE_3684_length_1225_cov_33.755773	508	588	7	50	80	0.6250000
NODE_3685_length_1225_cov_30.116341	566	646	5	3	80	0.0375000
NODE_3685_length_1225_cov_30.116341	566	646	6	9	80	0.1125000
NODE_3685_length_1225_cov_30.116341	566	646	7	67	80	0.8375000
NODE_3685_length_1225_cov_30.116341	566	646	8	1	80	0.0125000
NODE_3685_length_1225_cov_30.116341	619	699	4	29	80	0.3625000
NODE_3685_length_1225_cov_30.116341	619	699	5	26	80	0.3250000
NODE_3685_length_1225_cov_30.116341	619	699	6	10	80	0.1250000
NODE_3685_length_1225_cov_30.116341	619	699	7	14	80	0.1750000
NODE_3685_length_1225_cov_30.116341	619	699	8	1	80	0.0125000
NODE_3685_length_1225_cov_30.116341	695	775	2	74	80	0.9250000
NODE_3685_length_1225_cov_30.116341	695	775	4	6	80	0.0750000
NODE_3685_length_1225_cov_30.116341	748	828	0	10	80	0.1250000
NODE_3685_length_1225_cov_30.116341	748	828	1	36	80	0.4500000
NODE_3685_length_1225_cov_30.116341	748	828	2	34	80	0.4250000
NODE_3686_length_1225_cov_29.177620	195	275	5	40	80	0.5000000
NODE_3686_length_1225_cov_29.177620	195	275	6	40	80	0.5000000
NODE_3686_length_1225_cov_29.177620	248	328	2	11	80	0.1375000
NODE_3686_length_1225_cov_29.177620	248	328	3	7	80	0.0875000
NODE_3686_length_1225_cov_29.177620	248	328	4	8	80	0.1000000
NODE_3686_length_1225_cov_29.177620	248	328	6	54	80	0.6750000
NODE_3687_length_1225_cov_26.849023	588	668	2	5	80	0.0625000
NODE_3687_length_1225_cov_26.849023	588	668	3	60	80	0.7500000
NODE_3687_length_1225_cov_26.849023	588	668	4	15	80	0.1875000
NODE_3687_length_1225_cov_26.849023	641	721	3	47	80	0.5875000
NODE_3687_length_1225_cov_26.849023	641	721	6	28	80	0.3500000
NODE_3687_length_1225_cov_26.849023	641	721	7	5	80	0.0625000
NODE_3687_length_1225_cov_26.849023	717	797	4	7	80	0.0875000
NODE_3687_length_1225_cov_26.849023	717	797	5	40	80	0.5000000
NODE_3687_length_1225_cov_26.849023	717	797	6	33	80	0.4125000
NODE_3687_length_1225_cov_26.849023	770	850	2	32	80	0.4000000
NODE_3687_length_1225_cov_26.849023	770	850	5	20	80	0.2500000
NODE_3687_length_1225_cov_26.849023	770	850	6	28	80	0.3500000
NODE_3688_length_1225_cov_24.444938	386	466	1	26	80	0.3250000
NODE_3688_length_1225_cov_24.444938	386	466	2	54	80	0.6750000
NODE_3688_length_1225_cov_24.444938	439	519	1	15	80	0.1875000
NODE_3688_length_1225_cov_24.444938	439	519	2	65	80	0.8125000
NODE_3690_length_1225_cov_19.369449	491	571	0	21	80	0.2625000
NODE_3690_length_1225_cov_19.369449	491	571	2	59	80	0.7375000
NODE_3690_length_1225_cov_19.369449	544	624	0	74	80	0.9250000
NODE_3690_length_1225_cov_19.369449	544	624	2	6	80	0.0750000
NODE_3690_length_1225_cov_19.369449	620	700	0	80	80	1.0000000
NODE_3690_length_1225_cov_19.369449	673	753	0	80	80	1.0000000
NODE_3691_length_1225_cov_13.281528	462	542	0	80	80	1.0000000
NODE_3691_length_1225_cov_13.281528	515	595	0	80	80	1.0000000
NODE_3691_length_1225_cov_13.281528	591	671	0	80	80	1.0000000
NODE_3691_length_1225_cov_13.281528	644	724	0	80	80	1.0000000
NODE_3692_length_1225_cov_10.887211	566	646	0	80	80	1.0000000
NODE_3692_length_1225_cov_10.887211	619	699	0	80	80	1.0000000
NODE_3696_length_1224_cov_24.568889	613	693	1	7	80	0.0875000
NODE_3696_length_1224_cov_24.568889	613	693	2	38	80	0.4750000
NODE_3696_length_1224_cov_24.568889	613	693	4	29	80	0.3625000
NODE_3696_length_1224_cov_24.568889	613	693	5	6	80	0.0750000
NODE_3696_length_1224_cov_24.568889	666	746	4	31	80	0.3875000
NODE_3696_length_1224_cov_24.568889	666	746	5	49	80	0.6125000
NODE_3697_length_1224_cov_17.538667	762	842	5	31	80	0.3875000
NODE_3697_length_1224_cov_17.538667	762	842	6	49	80	0.6125000
NODE_3697_length_1224_cov_17.538667	815	895	5	30	80	0.3750000
NODE_3697_length_1224_cov_17.538667	815	895	6	50	80	0.6250000
NODE_3698_length_1224_cov_14.138667	389	469	2	11	80	0.1375000
NODE_3698_length_1224_cov_14.138667	389	469	4	29	80	0.3625000
NODE_3698_length_1224_cov_14.138667	389	469	5	40	80	0.5000000
NODE_3698_length_1224_cov_14.138667	442	522	2	2	80	0.0250000
NODE_3698_length_1224_cov_14.138667	442	522	4	56	80	0.7000000
NODE_3698_length_1224_cov_14.138667	442	522	5	22	80	0.2750000
NODE_3699_length_1224_cov_11.358222	704	784	0	80	80	1.0000000
NODE_3699_length_1224_cov_11.358222	757	837	0	80	80	1.0000000
NODE_3700_length_1224_cov_6.963556	516	581	0	65	65	1.0000000
NODE_3705_length_1223_cov_44.608541	548	630	4	4	82	0.0487805
NODE_3705_length_1223_cov_44.608541	548	630	6	20	82	0.2439024
NODE_3705_length_1223_cov_44.608541	548	630	7	23	82	0.2804878
NODE_3705_length_1223_cov_44.608541	548	630	8	35	82	0.4268293
NODE_3705_length_1223_cov_44.608541	601	683	6	39	82	0.4756097
NODE_3705_length_1223_cov_44.608541	601	683	7	13	82	0.1585366
NODE_3705_length_1223_cov_44.608541	601	683	8	30	82	0.3658537
NODE_3705_length_1223_cov_44.608541	679	759	1	14	80	0.1750000
NODE_3705_length_1223_cov_44.608541	679	759	2	23	80	0.2875000
NODE_3705_length_1223_cov_44.608541	679	759	3	24	80	0.3000000
NODE_3705_length_1223_cov_44.608541	679	759	5	6	80	0.0750000
NODE_3705_length_1223_cov_44.608541	679	759	6	5	80	0.0625000
NODE_3705_length_1223_cov_44.608541	679	759	7	8	80	0.1000000
NODE_3705_length_1223_cov_44.608541	732	812	1	62	80	0.7750000
NODE_3705_length_1223_cov_44.608541	732	812	2	18	80	0.2250000
NODE_3706_length_1223_cov_26.730427	508	588	2	15	80	0.1875000
NODE_3706_length_1223_cov_26.730427	508	588	3	58	80	0.7250000
NODE_3706_length_1223_cov_26.730427	508	588	4	7	80	0.0875000
NODE_3706_length_1223_cov_26.730427	561	641	1	17	80	0.2125000
NODE_3706_length_1223_cov_26.730427	561	641	2	51	80	0.6375000
NODE_3706_length_1223_cov_26.730427	561	641	3	12	80	0.1500000
NODE_3707_length_1223_cov_18.902135	460	540	4	34	80	0.4250000
NODE_3707_length_1223_cov_18.902135	460	540	6	46	80	0.5750000
NODE_3707_length_1223_cov_18.902135	513	593	6	80	80	1.0000000
NODE_3708_length_1223_cov_6.989324	707	778	4	13	71	0.1830986
NODE_3708_length_1223_cov_6.989324	707	778	5	27	71	0.3802817
NODE_3708_length_1223_cov_6.989324	707	778	6	31	71	0.4366197
NODE_3710_length_1223_cov_5.251779	666	746	0	8	80	0.1000000
NODE_3710_length_1223_cov_5.251779	666	746	2	63	80	0.7875000
NODE_3710_length_1223_cov_5.251779	666	746	3	9	80	0.1125000
NODE_3710_length_1223_cov_5.251779	719	799	1	17	80	0.2125000
NODE_3710_length_1223_cov_5.251779	719	799	2	18	80	0.2250000
NODE_3710_length_1223_cov_5.251779	719	799	3	45	80	0.5625000
NODE_3710_length_1223_cov_5.251779	795	875	1	80	80	1.0000000
NODE_3710_length_1223_cov_5.251779	848	928	0	42	80	0.5250000
NODE_3710_length_1223_cov_5.251779	848	928	1	38	80	0.4750000
NODE_3716_length_1222_cov_18.406946	273	353	0	18	80	0.2250000
NODE_3716_length_1222_cov_18.406946	273	353	2	62	80	0.7750000
NODE_3716_length_1222_cov_18.406946	326	406	0	47	80	0.5875000
NODE_3716_length_1222_cov_18.406946	326	406	2	33	80	0.4125000
NODE_3720_length_1221_cov_33.261141	505	577	2	1	72	0.0138889
NODE_3720_length_1221_cov_33.261141	505	577	3	13	72	0.1805556
NODE_3720_length_1221_cov_33.261141	505	577	5	32	72	0.4444444
NODE_3720_length_1221_cov_33.261141	505	577	6	26	72	0.3611111
NODE_3720_length_1221_cov_33.261141	558	637	4	8	79	0.1012658
NODE_3720_length_1221_cov_33.261141	558	637	5	32	79	0.4050633
NODE_3720_length_1221_cov_33.261141	558	637	6	39	79	0.4936709
NODE_3720_length_1221_cov_33.261141	633	713	1	14	80	0.1750000
NODE_3720_length_1221_cov_33.261141	633	713	2	48	80	0.6000000
NODE_3720_length_1221_cov_33.261141	633	713	3	13	80	0.1625000
NODE_3720_length_1221_cov_33.261141	633	713	4	5	80	0.0625000
NODE_3720_length_1221_cov_33.261141	686	766	1	67	80	0.8375000
NODE_3720_length_1221_cov_33.261141	686	766	2	13	80	0.1625000
NODE_3721_length_1221_cov_19.466132	541	621	3	10	80	0.1250000
NODE_3721_length_1221_cov_19.466132	541	621	4	36	80	0.4500000
NODE_3721_length_1221_cov_19.466132	541	621	5	34	80	0.4250000
NODE_3721_length_1221_cov_19.466132	594	674	2	17	80	0.2125000
NODE_3721_length_1221_cov_19.466132	594	674	3	37	80	0.4625000
NODE_3721_length_1221_cov_19.466132	594	674	4	21	80	0.2625000
NODE_3721_length_1221_cov_19.466132	594	674	5	5	80	0.0625000
NODE_3722_length_1221_cov_15.940285	788	868	3	5	80	0.0625000
NODE_3722_length_1221_cov_15.940285	788	868	4	38	80	0.4750000
NODE_3722_length_1221_cov_15.940285	788	868	5	35	80	0.4375000
NODE_3722_length_1221_cov_15.940285	788	868	6	2	80	0.0250000
NODE_3722_length_1221_cov_15.940285	841	921	5	30	80	0.3750000
NODE_3722_length_1221_cov_15.940285	841	921	6	26	80	0.3250000
NODE_3722_length_1221_cov_15.940285	841	921	7	24	80	0.3000000
NODE_3722_length_1221_cov_15.940285	917	997	4	16	80	0.2000000
NODE_3722_length_1221_cov_15.940285	917	997	5	14	80	0.1750000
NODE_3722_length_1221_cov_15.940285	917	997	6	50	80	0.6250000
NODE_3722_length_1221_cov_15.940285	970	1050	2	28	80	0.3500000
NODE_3722_length_1221_cov_15.940285	970	1050	3	6	80	0.0750000
NODE_3722_length_1221_cov_15.940285	970	1050	4	35	80	0.4375000
NODE_3722_length_1221_cov_15.940285	970	1050	5	11	80	0.1375000
NODE_3723_length_1221_cov_15.796791	484	564	0	50	80	0.6250000
NODE_3723_length_1221_cov_15.796791	484	564	1	30	80	0.3750000
NODE_3723_length_1221_cov_15.796791	537	617	1	80	80	1.0000000
NODE_3724_length_1221_cov_15.312834	342	415	2	51	73	0.6986302
NODE_3724_length_1221_cov_15.312834	342	415	3	22	73	0.3013699
NODE_3724_length_1221_cov_15.312834	395	474	2	25	79	0.3164557
NODE_3724_length_1221_cov_15.312834	395	474	3	54	79	0.6835443
NODE_3725_length_1221_cov_9.695187	988	1068	0	80	80	1.0000000
NODE_3725_length_1221_cov_9.695187	1041	1100	0	59	59	1.0000000
NODE_3726_length_1221_cov_9.043672	695	775	0	80	80	1.0000000
NODE_3726_length_1221_cov_9.043672	748	828	0	80	80	1.0000000
NODE_3727_length_1221_cov_7.946524	147	227	0	58	80	0.7250000
NODE_3727_length_1221_cov_7.946524	147	227	2	7	80	0.0875000
NODE_3727_length_1221_cov_7.946524	147	227	4	15	80	0.1875000
NODE_3727_length_1221_cov_7.946524	200	280	0	5	80	0.0625000
NODE_3727_length_1221_cov_7.946524	200	280	2	15	80	0.1875000
NODE_3727_length_1221_cov_7.946524	200	280	4	60	80	0.7500000
NODE_3728_length_1221_cov_5.122103	248	328	3	8	80	0.1000000
NODE_3728_length_1221_cov_5.122103	248	328	4	36	80	0.4500000
NODE_3728_length_1221_cov_5.122103	248	328	5	36	80	0.4500000
NODE_3728_length_1221_cov_5.122103	301	381	2	1	80	0.0125000
NODE_3728_length_1221_cov_5.122103	301	381	3	11	80	0.1375000
NODE_3728_length_1221_cov_5.122103	301	381	4	38	80	0.4750000
NODE_3728_length_1221_cov_5.122103	301	381	5	30	80	0.3750000
NODE_3736_length_1220_cov_44.501338	319	399	6	53	80	0.6625000
NODE_3736_length_1220_cov_44.501338	319	399	7	5	80	0.0625000
NODE_3736_length_1220_cov_44.501338	319	399	8	22	80	0.2750000
NODE_3736_length_1220_cov_44.501338	372	452	1	5	80	0.0625000
NODE_3736_length_1220_cov_44.501338	372	452	3	2	80	0.0250000
NODE_3736_length_1220_cov_44.501338	372	452	4	32	80	0.4000000
NODE_3736_length_1220_cov_44.501338	372	452	6	41	80	0.5125000
NODE_3736_length_1220_cov_44.501338	448	528	0	22	80	0.2750000
NODE_3736_length_1220_cov_44.501338	448	528	1	16	80	0.2000000
NODE_3736_length_1220_cov_44.501338	448	528	2	42	80	0.5250000
NODE_3736_length_1220_cov_44.501338	501	581	2	80	80	1.0000000
NODE_3737_length_1220_cov_43.868867	720	800	5	33	80	0.4125000
NODE_3737_length_1220_cov_43.868867	720	800	6	11	80	0.1375000
NODE_3737_length_1220_cov_43.868867	720	800	7	12	80	0.1500000
NODE_3737_length_1220_cov_43.868867	720	800	8	24	80	0.3000000
NODE_3737_length_1220_cov_43.868867	773	853	6	6	80	0.0750000
NODE_3737_length_1220_cov_43.868867	773	853	7	46	80	0.5750000
NODE_3737_length_1220_cov_43.868867	773	853	8	28	80	0.3500000
NODE_3738_length_1220_cov_41.900089	593	673	1	54	80	0.6750000
NODE_3738_length_1220_cov_41.900089	593	673	3	26	80	0.3250000
NODE_3738_length_1220_cov_41.900089	646	726	0	10	80	0.1250000
NODE_3738_length_1220_cov_41.900089	646	726	1	3	80	0.0375000
NODE_3738_length_1220_cov_41.900089	646	726	3	67	80	0.8375000
NODE_3738_length_1220_cov_41.900089	722	802	0	57	80	0.7125000
NODE_3738_length_1220_cov_41.900089	722	802	1	23	80	0.2875000
NODE_3738_length_1220_cov_41.900089	775	855	0	4	80	0.0500000
NODE_3738_length_1220_cov_41.900089	775	855	1	76	80	0.9500000
NODE_3739_length_1220_cov_15.485281	395	475	0	11	80	0.1375000
NODE_3739_length_1220_cov_15.485281	395	475	1	47	80	0.5875000
NODE_3739_length_1220_cov_15.485281	395	475	2	4	80	0.0500000
NODE_3739_length_1220_cov_15.485281	395	475	3	18	80	0.2250000
NODE_3739_length_1220_cov_15.485281	448	528	1	5	80	0.0625000
NODE_3739_length_1220_cov_15.485281	448	528	2	4	80	0.0500000
NODE_3739_length_1220_cov_15.485281	448	528	3	71	80	0.8875000
NODE_3745_length_1219_cov_30.493750	643	723	0	80	80	1.0000000
NODE_3745_length_1219_cov_30.493750	696	776	0	80	80	1.0000000
NODE_3745_length_1219_cov_30.493750	772	852	0	80	80	1.0000000
NODE_3745_length_1219_cov_30.493750	825	905	0	80	80	1.0000000
NODE_3746_length_1219_cov_24.991071	566	646	2	80	80	1.0000000
NODE_3746_length_1219_cov_24.991071	619	699	2	80	80	1.0000000
NODE_3746_length_1219_cov_24.991071	695	775	1	19	80	0.2375000
NODE_3746_length_1219_cov_24.991071	695	775	2	61	80	0.7625000
NODE_3746_length_1219_cov_24.991071	748	828	2	80	80	1.0000000
NODE_3747_length_1219_cov_24.728571	465	545	0	80	80	1.0000000
NODE_3747_length_1219_cov_24.728571	518	598	0	32	80	0.4000000
NODE_3747_length_1219_cov_24.728571	518	598	1	48	80	0.6000000
NODE_3747_length_1219_cov_24.728571	594	674	1	23	80	0.2875000
NODE_3747_length_1219_cov_24.728571	594	674	3	57	80	0.7125000
NODE_3747_length_1219_cov_24.728571	647	727	0	6	80	0.0750000
NODE_3747_length_1219_cov_24.728571	647	727	2	21	80	0.2625000
NODE_3747_length_1219_cov_24.728571	647	727	3	53	80	0.6625000
NODE_3748_length_1219_cov_11.130357	535	615	0	80	80	1.0000000
NODE_3748_length_1219_cov_11.130357	588	668	0	80	80	1.0000000
NODE_3749_length_1219_cov_9.696429	734	814	0	80	80	1.0000000
NODE_3749_length_1219_cov_9.696429	787	867	0	80	80	1.0000000
NODE_3754_length_1218_cov_40.159071	554	634	6	21	80	0.2625000
NODE_3754_length_1218_cov_40.159071	554	634	7	48	80	0.6000000
NODE_3754_length_1218_cov_40.159071	554	634	8	11	80	0.1375000
NODE_3754_length_1218_cov_40.159071	607	687	5	38	80	0.4750000
NODE_3754_length_1218_cov_40.159071	607	687	6	19	80	0.2375000
NODE_3754_length_1218_cov_40.159071	607	687	7	23	80	0.2875000
NODE_3754_length_1218_cov_40.159071	683	763	2	2	80	0.0250000
NODE_3754_length_1218_cov_40.159071	683	763	3	15	80	0.1875000
NODE_3754_length_1218_cov_40.159071	683	763	4	58	80	0.7250000
NODE_3754_length_1218_cov_40.159071	683	763	5	5	80	0.0625000
NODE_3754_length_1218_cov_40.159071	736	816	2	15	80	0.1875000
NODE_3754_length_1218_cov_40.159071	736	816	3	21	80	0.2625000
NODE_3754_length_1218_cov_40.159071	736	816	4	44	80	0.5500000
NODE_3765_length_1216_cov_99.538944	44	124	97	1	80	0.0125000
NODE_3765_length_1216_cov_99.538944	44	124	102	1	80	0.0125000
NODE_3765_length_1216_cov_99.538944	44	124	103	1	80	0.0125000
NODE_3765_length_1216_cov_99.538944	44	124	105	1	80	0.0125000
NODE_3765_length_1216_cov_99.538944	44	124	108	1	80	0.0125000
NODE_3765_length_1216_cov_99.538944	44	124	113	1	80	0.0125000
NODE_3765_length_1216_cov_99.538944	44	124	119	1	80	0.0125000
NODE_3765_length_1216_cov_99.538944	44	124	120	1	80	0.0125000
NODE_3765_length_1216_cov_99.538944	44	124	127	1	80	0.0125000
NODE_3765_length_1216_cov_99.538944	44	124	132	1	80	0.0125000
NODE_3765_length_1216_cov_99.538944	44	124	135	1	80	0.0125000
NODE_3765_length_1216_cov_99.538944	44	124	136	1	80	0.0125000
NODE_3765_length_1216_cov_99.538944	44	124	140	2	80	0.0250000
NODE_3765_length_1216_cov_99.538944	44	124	145	1	80	0.0125000
NODE_3765_length_1216_cov_99.538944	44	124	150	1	80	0.0125000
NODE_3765_length_1216_cov_99.538944	44	124	154	1	80	0.0125000
NODE_3765_length_1216_cov_99.538944	44	124	156	1	80	0.0125000
NODE_3765_length_1216_cov_99.538944	44	124	157	1	80	0.0125000
NODE_3765_length_1216_cov_99.538944	44	124	158	1	80	0.0125000
NODE_3765_length_1216_cov_99.538944	44	124	159	1	80	0.0125000
NODE_3765_length_1216_cov_99.538944	44	124	163	2	80	0.0250000
NODE_3765_length_1216_cov_99.538944	44	124	166	1	80	0.0125000
NODE_3765_length_1216_cov_99.538944	44	124	171	1	80	0.0125000
NODE_3765_length_1216_cov_99.538944	44	124	172	1	80	0.0125000
NODE_3765_length_1216_cov_99.538944	44	124	173	2	80	0.0250000
NODE_3765_length_1216_cov_99.538944	44	124	183	1	80	0.0125000
NODE_3765_length_1216_cov_99.538944	44	124	188	1	80	0.0125000
NODE_3765_length_1216_cov_99.538944	44	124	193	1	80	0.0125000
NODE_3765_length_1216_cov_99.538944	44	124	196	2	80	0.0250000
NODE_3765_length_1216_cov_99.538944	44	124	199	1	80	0.0125000
NODE_3765_length_1216_cov_99.538944	44	124	200	1	80	0.0125000
NODE_3765_length_1216_cov_99.538944	44	124	201	2	80	0.0250000
NODE_3765_length_1216_cov_99.538944	44	124	203	1	80	0.0125000
NODE_3765_length_1216_cov_99.538944	44	124	211	1	80	0.0125000
NODE_3765_length_1216_cov_99.538944	44	124	215	1	80	0.0125000
NODE_3765_length_1216_cov_99.538944	44	124	216	1	80	0.0125000
NODE_3765_length_1216_cov_99.538944	44	124	219	1	80	0.0125000
NODE_3765_length_1216_cov_99.538944	44	124	221	1	80	0.0125000
NODE_3765_length_1216_cov_99.538944	44	124	224	1	80	0.0125000
NODE_3765_length_1216_cov_99.538944	44	124	227	1	80	0.0125000
NODE_3765_length_1216_cov_99.538944	44	124	228	1	80	0.0125000
NODE_3765_length_1216_cov_99.538944	44	124	229	1	80	0.0125000
NODE_3765_length_1216_cov_99.538944	44	124	231	1	80	0.0125000
NODE_3765_length_1216_cov_99.538944	44	124	237	1	80	0.0125000
NODE_3765_length_1216_cov_99.538944	44	124	239	2	80	0.0250000
NODE_3765_length_1216_cov_99.538944	44	124	243	1	80	0.0125000
NODE_3765_length_1216_cov_99.538944	44	124	245	1	80	0.0125000
NODE_3765_length_1216_cov_99.538944	44	124	248	1	80	0.0125000
NODE_3765_length_1216_cov_99.538944	44	124	256	1	80	0.0125000
NODE_3765_length_1216_cov_99.538944	44	124	259	1	80	0.0125000
NODE_3765_length_1216_cov_99.538944	44	124	264	1	80	0.0125000
NODE_3765_length_1216_cov_99.538944	44	124	265	1	80	0.0125000
NODE_3765_length_1216_cov_99.538944	44	124	268	1	80	0.0125000
NODE_3765_length_1216_cov_99.538944	44	124	269	1	80	0.0125000
NODE_3765_length_1216_cov_99.538944	44	124	270	3	80	0.0375000
NODE_3765_length_1216_cov_99.538944	44	124	274	1	80	0.0125000
NODE_3765_length_1216_cov_99.538944	44	124	276	1	80	0.0125000
NODE_3765_length_1216_cov_99.538944	44	124	280	1	80	0.0125000
NODE_3765_length_1216_cov_99.538944	44	124	281	1	80	0.0125000
NODE_3765_length_1216_cov_99.538944	44	124	282	1	80	0.0125000
NODE_3765_length_1216_cov_99.538944	44	124	283	2	80	0.0250000
NODE_3765_length_1216_cov_99.538944	44	124	284	1	80	0.0125000
NODE_3765_length_1216_cov_99.538944	44	124	285	1	80	0.0125000
NODE_3765_length_1216_cov_99.538944	44	124	287	1	80	0.0125000
NODE_3765_length_1216_cov_99.538944	44	124	288	2	80	0.0250000
NODE_3765_length_1216_cov_99.538944	44	124	289	1	80	0.0125000
NODE_3765_length_1216_cov_99.538944	44	124	291	1	80	0.0125000
NODE_3765_length_1216_cov_99.538944	44	124	293	1	80	0.0125000
NODE_3765_length_1216_cov_99.538944	44	124	294	2	80	0.0250000
NODE_3765_length_1216_cov_99.538944	97	157	248	1	60	0.0166667
NODE_3765_length_1216_cov_99.538944	97	157	256	1	60	0.0166667
NODE_3765_length_1216_cov_99.538944	97	157	259	1	60	0.0166667
NODE_3765_length_1216_cov_99.538944	97	157	264	1	60	0.0166667
NODE_3765_length_1216_cov_99.538944	97	157	265	1	60	0.0166667
NODE_3765_length_1216_cov_99.538944	97	157	268	1	60	0.0166667
NODE_3765_length_1216_cov_99.538944	97	157	269	1	60	0.0166667
NODE_3765_length_1216_cov_99.538944	97	157	270	3	60	0.0500000
NODE_3765_length_1216_cov_99.538944	97	157	274	1	60	0.0166667
NODE_3765_length_1216_cov_99.538944	97	157	276	1	60	0.0166667
NODE_3765_length_1216_cov_99.538944	97	157	280	1	60	0.0166667
NODE_3765_length_1216_cov_99.538944	97	157	281	1	60	0.0166667
NODE_3765_length_1216_cov_99.538944	97	157	282	1	60	0.0166667
NODE_3765_length_1216_cov_99.538944	97	157	283	2	60	0.0333333
NODE_3765_length_1216_cov_99.538944	97	157	284	1	60	0.0166667
NODE_3765_length_1216_cov_99.538944	97	157	285	1	60	0.0166667
NODE_3765_length_1216_cov_99.538944	97	157	287	1	60	0.0166667
NODE_3765_length_1216_cov_99.538944	97	157	288	2	60	0.0333333
NODE_3765_length_1216_cov_99.538944	97	157	289	1	60	0.0166667
NODE_3765_length_1216_cov_99.538944	97	157	291	1	60	0.0166667
NODE_3765_length_1216_cov_99.538944	97	157	293	1	60	0.0166667
NODE_3765_length_1216_cov_99.538944	97	157	294	2	60	0.0333333
NODE_3765_length_1216_cov_99.538944	97	157	301	2	60	0.0333333
NODE_3765_length_1216_cov_99.538944	97	157	302	5	60	0.0833333
NODE_3765_length_1216_cov_99.538944	97	157	303	2	60	0.0333333
NODE_3765_length_1216_cov_99.538944	97	157	305	2	60	0.0333333
NODE_3765_length_1216_cov_99.538944	97	157	306	1	60	0.0166667
NODE_3765_length_1216_cov_99.538944	97	157	309	1	60	0.0166667
NODE_3765_length_1216_cov_99.538944	97	157	310	2	60	0.0333333
NODE_3765_length_1216_cov_99.538944	97	157	311	3	60	0.0500000
NODE_3765_length_1216_cov_99.538944	97	157	319	2	60	0.0333333
NODE_3765_length_1216_cov_99.538944	97	157	321	3	60	0.0500000
NODE_3765_length_1216_cov_99.538944	97	157	323	2	60	0.0333333
NODE_3765_length_1216_cov_99.538944	97	157	324	2	60	0.0333333
NODE_3765_length_1216_cov_99.538944	97	157	325	2	60	0.0333333
NODE_3765_length_1216_cov_99.538944	97	157	328	2	60	0.0333333
NODE_3765_length_1216_cov_99.538944	97	157	329	2	60	0.0333333
NODE_3765_length_1216_cov_99.538944	824	903	198	2	79	0.0253165
NODE_3765_length_1216_cov_99.538944	824	903	200	1	79	0.0126582
NODE_3765_length_1216_cov_99.538944	824	903	205	2	79	0.0253165
NODE_3765_length_1216_cov_99.538944	824	903	207	1	79	0.0126582
NODE_3765_length_1216_cov_99.538944	824	903	208	2	79	0.0253165
NODE_3765_length_1216_cov_99.538944	824	903	209	4	79	0.0506329
NODE_3765_length_1216_cov_99.538944	824	903	210	2	79	0.0253165
NODE_3765_length_1216_cov_99.538944	824	903	211	1	79	0.0126582
NODE_3765_length_1216_cov_99.538944	824	903	212	1	79	0.0126582
NODE_3765_length_1216_cov_99.538944	824	903	214	1	79	0.0126582
NODE_3765_length_1216_cov_99.538944	824	903	217	1	79	0.0126582
NODE_3765_length_1216_cov_99.538944	824	903	218	1	79	0.0126582
NODE_3765_length_1216_cov_99.538944	824	903	219	1	79	0.0126582
NODE_3765_length_1216_cov_99.538944	824	903	220	1	79	0.0126582
NODE_3765_length_1216_cov_99.538944	824	903	222	1	79	0.0126582
NODE_3765_length_1216_cov_99.538944	824	903	225	2	79	0.0253165
NODE_3765_length_1216_cov_99.538944	824	903	226	1	79	0.0126582
NODE_3765_length_1216_cov_99.538944	824	903	227	1	79	0.0126582
NODE_3765_length_1216_cov_99.538944	824	903	229	1	79	0.0126582
NODE_3765_length_1216_cov_99.538944	824	903	230	2	79	0.0253165
NODE_3765_length_1216_cov_99.538944	824	903	231	4	79	0.0506329
NODE_3765_length_1216_cov_99.538944	824	903	232	5	79	0.0632911
NODE_3765_length_1216_cov_99.538944	824	903	233	3	79	0.0379747
NODE_3765_length_1216_cov_99.538944	824	903	234	4	79	0.0506329
NODE_3765_length_1216_cov_99.538944	824	903	235	2	79	0.0253165
NODE_3765_length_1216_cov_99.538944	824	903	236	2	79	0.0253165
NODE_3765_length_1216_cov_99.538944	824	903	237	4	79	0.0506329
NODE_3765_length_1216_cov_99.538944	824	903	238	6	79	0.0759494
NODE_3765_length_1216_cov_99.538944	824	903	239	3	79	0.0379747
NODE_3765_length_1216_cov_99.538944	824	903	240	3	79	0.0379747
NODE_3765_length_1216_cov_99.538944	824	903	241	3	79	0.0379747
NODE_3765_length_1216_cov_99.538944	824	903	242	2	79	0.0253165
NODE_3765_length_1216_cov_99.538944	824	903	245	1	79	0.0126582
NODE_3765_length_1216_cov_99.538944	824	903	247	2	79	0.0253165
NODE_3765_length_1216_cov_99.538944	824	903	249	2	79	0.0253165
NODE_3765_length_1216_cov_99.538944	824	903	250	2	79	0.0253165
NODE_3765_length_1216_cov_99.538944	824	903	251	2	79	0.0253165
NODE_3766_length_1216_cov_15.855864	668	748	0	57	80	0.7125000
NODE_3766_length_1216_cov_15.855864	668	748	1	23	80	0.2875000
NODE_3766_length_1216_cov_15.855864	721	801	0	80	80	1.0000000
NODE_3767_length_1216_cov_4.128917	720	800	0	80	80	1.0000000
NODE_3767_length_1216_cov_4.128917	773	853	0	80	80	1.0000000
NODE_3774_length_1215_cov_32.293011	411	491	0	2	80	0.0250000
NODE_3774_length_1215_cov_32.293011	411	491	2	78	80	0.9750000
NODE_3774_length_1215_cov_32.293011	464	544	0	25	80	0.3125000
NODE_3774_length_1215_cov_32.293011	464	544	2	55	80	0.6875000
NODE_3775_length_1215_cov_24.177419	729	809	4	10	80	0.1250000
NODE_3775_length_1215_cov_24.177419	729	809	5	7	80	0.0875000
NODE_3775_length_1215_cov_24.177419	729	809	6	63	80	0.7875000
NODE_3775_length_1215_cov_24.177419	782	862	3	10	80	0.1250000
NODE_3775_length_1215_cov_24.177419	782	862	4	17	80	0.2125000
NODE_3775_length_1215_cov_24.177419	782	862	5	24	80	0.3000000
NODE_3775_length_1215_cov_24.177419	782	862	6	29	80	0.3625000
NODE_3776_length_1215_cov_21.566308	645	725	4	41	80	0.5125000
NODE_3776_length_1215_cov_21.566308	645	725	5	13	80	0.1625000
NODE_3776_length_1215_cov_21.566308	645	725	6	8	80	0.1000000
NODE_3776_length_1215_cov_21.566308	645	725	7	18	80	0.2250000
NODE_3776_length_1215_cov_21.566308	698	778	4	14	80	0.1750000
NODE_3776_length_1215_cov_21.566308	698	778	5	21	80	0.2625000
NODE_3776_length_1215_cov_21.566308	698	778	6	27	80	0.3375000
NODE_3776_length_1215_cov_21.566308	698	778	7	18	80	0.2250000
NODE_3777_length_1215_cov_19.278674	630	710	0	80	80	1.0000000
NODE_3777_length_1215_cov_19.278674	683	763	0	80	80	1.0000000
NODE_3778_length_1215_cov_15.074373	664	744	0	80	80	1.0000000
NODE_3778_length_1215_cov_15.074373	717	797	0	80	80	1.0000000
NODE_3779_length_1215_cov_5.932796	507	587	0	80	80	1.0000000
NODE_3779_length_1215_cov_5.932796	560	640	0	80	80	1.0000000
NODE_3787_length_1214_cov_26.771300	420	500	39	5	80	0.0625000
NODE_3787_length_1214_cov_26.771300	420	500	40	9	80	0.1125000
NODE_3787_length_1214_cov_26.771300	420	500	41	9	80	0.1125000
NODE_3787_length_1214_cov_26.771300	420	500	42	10	80	0.1250000
NODE_3787_length_1214_cov_26.771300	420	500	43	5	80	0.0625000
NODE_3787_length_1214_cov_26.771300	420	500	44	8	80	0.1000000
NODE_3787_length_1214_cov_26.771300	420	500	45	3	80	0.0375000
NODE_3787_length_1214_cov_26.771300	420	500	46	13	80	0.1625000
NODE_3787_length_1214_cov_26.771300	420	500	47	8	80	0.1000000
NODE_3787_length_1214_cov_26.771300	420	500	48	5	80	0.0625000
NODE_3787_length_1214_cov_26.771300	420	500	49	5	80	0.0625000
NODE_3787_length_1214_cov_26.771300	473	553	21	1	80	0.0125000
NODE_3787_length_1214_cov_26.771300	473	553	23	1	80	0.0125000
NODE_3787_length_1214_cov_26.771300	473	553	24	1	80	0.0125000
NODE_3787_length_1214_cov_26.771300	473	553	25	1	80	0.0125000
NODE_3787_length_1214_cov_26.771300	473	553	26	1	80	0.0125000
NODE_3787_length_1214_cov_26.771300	473	553	28	5	80	0.0625000
NODE_3787_length_1214_cov_26.771300	473	553	29	3	80	0.0375000
NODE_3787_length_1214_cov_26.771300	473	553	30	5	80	0.0625000
NODE_3787_length_1214_cov_26.771300	473	553	31	6	80	0.0750000
NODE_3787_length_1214_cov_26.771300	473	553	33	1	80	0.0125000
NODE_3787_length_1214_cov_26.771300	473	553	36	1	80	0.0125000
NODE_3787_length_1214_cov_26.771300	473	553	37	2	80	0.0250000
NODE_3787_length_1214_cov_26.771300	473	553	39	3	80	0.0375000
NODE_3787_length_1214_cov_26.771300	473	553	40	13	80	0.1625000
NODE_3787_length_1214_cov_26.771300	473	553	41	8	80	0.1000000
NODE_3787_length_1214_cov_26.771300	473	553	42	11	80	0.1375000
NODE_3787_length_1214_cov_26.771300	473	553	43	4	80	0.0500000
NODE_3787_length_1214_cov_26.771300	473	553	45	3	80	0.0375000
NODE_3787_length_1214_cov_26.771300	473	553	46	2	80	0.0250000
NODE_3787_length_1214_cov_26.771300	473	553	47	6	80	0.0750000
NODE_3787_length_1214_cov_26.771300	473	553	48	2	80	0.0250000
NODE_3788_length_1214_cov_24.555157	480	560	4	30	80	0.3750000
NODE_3788_length_1214_cov_24.555157	480	560	6	50	80	0.6250000
NODE_3788_length_1214_cov_24.555157	533	613	3	9	80	0.1125000
NODE_3788_length_1214_cov_24.555157	533	613	4	16	80	0.2000000
NODE_3788_length_1214_cov_24.555157	533	613	6	55	80	0.6875000
NODE_3789_length_1214_cov_23.167713	623	703	2	29	80	0.3625000
NODE_3789_length_1214_cov_23.167713	623	703	3	51	80	0.6375000
NODE_3789_length_1214_cov_23.167713	676	756	1	15	80	0.1875000
NODE_3789_length_1214_cov_23.167713	676	756	2	51	80	0.6375000
NODE_3789_length_1214_cov_23.167713	676	756	3	14	80	0.1750000
NODE_3790_length_1214_cov_18.452915	555	635	1	20	80	0.2500000
NODE_3790_length_1214_cov_18.452915	555	635	2	60	80	0.7500000
NODE_3790_length_1214_cov_18.452915	608	688	0	32	80	0.4000000
NODE_3790_length_1214_cov_18.452915	608	688	1	41	80	0.5125000
NODE_3790_length_1214_cov_18.452915	608	688	2	7	80	0.0875000
NODE_3790_length_1214_cov_18.452915	684	764	0	80	80	1.0000000
NODE_3790_length_1214_cov_18.452915	737	817	0	80	80	1.0000000
NODE_3791_length_1214_cov_8.906726	206	286	0	14	80	0.1750000
NODE_3791_length_1214_cov_8.906726	206	286	3	66	80	0.8250000
NODE_3791_length_1214_cov_8.906726	259	339	3	53	80	0.6625000
NODE_3791_length_1214_cov_8.906726	259	339	4	1	80	0.0125000
NODE_3791_length_1214_cov_8.906726	259	339	5	14	80	0.1750000
NODE_3791_length_1214_cov_8.906726	259	339	6	12	80	0.1500000
NODE_3792_length_1214_cov_3.686996	415	495	0	80	80	1.0000000
NODE_3792_length_1214_cov_3.686996	468	548	0	80	80	1.0000000
NODE_3799_length_1214_cov_0.967713	1049	1129	104	3	80	0.0375000
NODE_3799_length_1214_cov_0.967713	1049	1129	107	4	80	0.0500000
NODE_3799_length_1214_cov_0.967713	1049	1129	112	2	80	0.0250000
NODE_3799_length_1214_cov_0.967713	1049	1129	113	7	80	0.0875000
NODE_3799_length_1214_cov_0.967713	1049	1129	114	1	80	0.0125000
NODE_3799_length_1214_cov_0.967713	1049	1129	116	3	80	0.0375000
NODE_3799_length_1214_cov_0.967713	1049	1129	117	7	80	0.0875000
NODE_3799_length_1214_cov_0.967713	1049	1129	119	1	80	0.0125000
NODE_3799_length_1214_cov_0.967713	1049	1129	120	3	80	0.0375000
NODE_3799_length_1214_cov_0.967713	1049	1129	121	3	80	0.0375000
NODE_3799_length_1214_cov_0.967713	1049	1129	125	1	80	0.0125000
NODE_3799_length_1214_cov_0.967713	1049	1129	126	3	80	0.0375000
NODE_3799_length_1214_cov_0.967713	1049	1129	127	2	80	0.0250000
NODE_3799_length_1214_cov_0.967713	1049	1129	129	1	80	0.0125000
NODE_3799_length_1214_cov_0.967713	1049	1129	130	7	80	0.0875000
NODE_3799_length_1214_cov_0.967713	1049	1129	131	7	80	0.0875000
NODE_3799_length_1214_cov_0.967713	1049	1129	132	3	80	0.0375000
NODE_3799_length_1214_cov_0.967713	1049	1129	133	3	80	0.0375000
NODE_3799_length_1214_cov_0.967713	1049	1129	135	16	80	0.2000000
NODE_3799_length_1214_cov_0.967713	1049	1129	136	3	80	0.0375000
NODE_3800_length_1213_cov_19.524237	499	579	0	4	80	0.0500000
NODE_3800_length_1213_cov_19.524237	499	579	1	12	80	0.1500000
NODE_3800_length_1213_cov_19.524237	499	579	2	1	80	0.0125000
NODE_3800_length_1213_cov_19.524237	499	579	3	63	80	0.7875000
NODE_3800_length_1213_cov_19.524237	552	632	3	64	80	0.8000000
NODE_3800_length_1213_cov_19.524237	552	632	5	16	80	0.2000000
NODE_3806_length_1212_cov_32.663073	688	768	3	35	80	0.4375000
NODE_3806_length_1212_cov_32.663073	688	768	4	39	80	0.4875000
NODE_3806_length_1212_cov_32.663073	688	768	5	6	80	0.0750000
NODE_3806_length_1212_cov_32.663073	741	821	3	59	80	0.7375000
NODE_3806_length_1212_cov_32.663073	741	821	4	21	80	0.2625000
NODE_3807_length_1212_cov_15.981132	33	113	1	37	80	0.4625000
NODE_3807_length_1212_cov_15.981132	33	113	2	43	80	0.5375000
NODE_3807_length_1212_cov_15.981132	511	591	1	14	80	0.1750000
NODE_3807_length_1212_cov_15.981132	511	591	2	19	80	0.2375000
NODE_3807_length_1212_cov_15.981132	511	591	3	5	80	0.0625000
NODE_3807_length_1212_cov_15.981132	511	591	4	42	80	0.5250000
NODE_3807_length_1212_cov_15.981132	564	637	4	63	73	0.8630137
NODE_3807_length_1212_cov_15.981132	564	637	5	10	73	0.1369863
NODE_3813_length_1211_cov_30.513489	561	641	0	16	80	0.2000000
NODE_3813_length_1211_cov_30.513489	561	641	1	17	80	0.2125000
NODE_3813_length_1211_cov_30.513489	561	641	3	28	80	0.3500000
NODE_3813_length_1211_cov_30.513489	561	641	4	19	80	0.2375000
NODE_3813_length_1211_cov_30.513489	614	694	2	18	80	0.2250000
NODE_3813_length_1211_cov_30.513489	614	694	3	8	80	0.1000000
NODE_3813_length_1211_cov_30.513489	614	694	4	54	80	0.6750000
NODE_3813_length_1211_cov_30.513489	690	770	2	15	80	0.1875000
NODE_3813_length_1211_cov_30.513489	690	770	3	2	80	0.0250000
NODE_3813_length_1211_cov_30.513489	690	770	4	9	80	0.1125000
NODE_3813_length_1211_cov_30.513489	690	770	5	4	80	0.0500000
NODE_3813_length_1211_cov_30.513489	690	770	6	50	80	0.6250000
NODE_3813_length_1211_cov_30.513489	743	823	5	31	80	0.3875000
NODE_3813_length_1211_cov_30.513489	743	823	6	49	80	0.6125000
NODE_3815_length_1211_cov_10.073741	380	460	5	19	80	0.2375000
NODE_3815_length_1211_cov_10.073741	380	460	6	56	80	0.7000000
NODE_3815_length_1211_cov_10.073741	380	460	7	5	80	0.0625000
NODE_3815_length_1211_cov_10.073741	433	513	4	2	80	0.0250000
NODE_3815_length_1211_cov_10.073741	433	513	5	14	80	0.1750000
NODE_3815_length_1211_cov_10.073741	433	513	6	52	80	0.6500000
NODE_3815_length_1211_cov_10.073741	433	513	7	12	80	0.1500000
NODE_3816_length_1211_cov_7.561151	598	678	2	15	80	0.1875000
NODE_3816_length_1211_cov_7.561151	598	678	4	65	80	0.8125000
NODE_3816_length_1211_cov_7.561151	651	731	0	14	80	0.1750000
NODE_3816_length_1211_cov_7.561151	651	731	1	1	80	0.0125000
NODE_3816_length_1211_cov_7.561151	651	731	2	1	80	0.0125000
NODE_3816_length_1211_cov_7.561151	651	731	3	35	80	0.4375000
NODE_3816_length_1211_cov_7.561151	651	731	4	29	80	0.3625000
NODE_3820_length_1210_cov_49.743474	398	478	3	10	80	0.1250000
NODE_3820_length_1210_cov_49.743474	398	478	4	35	80	0.4375000
NODE_3820_length_1210_cov_49.743474	398	478	5	35	80	0.4375000
NODE_3820_length_1210_cov_49.743474	451	531	1	18	80	0.2250000
NODE_3820_length_1210_cov_49.743474	451	531	2	10	80	0.1250000
NODE_3820_length_1210_cov_49.743474	451	531	3	31	80	0.3875000
NODE_3820_length_1210_cov_49.743474	451	531	4	21	80	0.2625000
NODE_3821_length_1210_cov_15.647165	647	727	0	80	80	1.0000000
NODE_3821_length_1210_cov_15.647165	700	780	0	80	80	1.0000000
NODE_3822_length_1210_cov_11.194419	794	874	1	2	80	0.0250000
NODE_3822_length_1210_cov_11.194419	794	874	3	65	80	0.8125000
NODE_3822_length_1210_cov_11.194419	794	874	4	13	80	0.1625000
NODE_3822_length_1210_cov_11.194419	847	927	1	55	80	0.6875000
NODE_3822_length_1210_cov_11.194419	847	927	3	25	80	0.3125000
NODE_3826_length_1209_cov_24.504505	582	662	0	80	80	1.0000000
NODE_3826_length_1209_cov_24.504505	635	715	0	80	80	1.0000000
NODE_3826_length_1209_cov_24.504505	711	791	0	14	80	0.1750000
NODE_3826_length_1209_cov_24.504505	711	791	1	66	80	0.8250000
NODE_3826_length_1209_cov_24.504505	764	844	1	80	80	1.0000000
NODE_3827_length_1209_cov_21.846847	520	600	2	39	80	0.4875000
NODE_3827_length_1209_cov_21.846847	520	600	3	36	80	0.4500000
NODE_3827_length_1209_cov_21.846847	520	600	4	5	80	0.0625000
NODE_3827_length_1209_cov_21.846847	573	653	2	39	80	0.4875000
NODE_3827_length_1209_cov_21.846847	573	653	3	36	80	0.4500000
NODE_3827_length_1209_cov_21.846847	573	653	4	5	80	0.0625000
NODE_3827_length_1209_cov_21.846847	649	729	3	59	80	0.7375000
NODE_3827_length_1209_cov_21.846847	649	729	4	21	80	0.2625000
NODE_3827_length_1209_cov_21.846847	702	782	2	9	80	0.1125000
NODE_3827_length_1209_cov_21.846847	702	782	3	61	80	0.7625000
NODE_3827_length_1209_cov_21.846847	702	782	4	10	80	0.1250000
NODE_3828_length_1209_cov_9.026126	782	862	0	73	80	0.9125000
NODE_3828_length_1209_cov_9.026126	782	862	1	7	80	0.0875000
NODE_3828_length_1209_cov_9.026126	835	915	0	20	80	0.2500000
NODE_3828_length_1209_cov_9.026126	835	915	1	60	80	0.7500000
NODE_3830_length_1209_cov_5.721622	926	1006	1	46	80	0.5750000
NODE_3830_length_1209_cov_5.721622	926	1006	2	34	80	0.4250000
NODE_3830_length_1209_cov_5.721622	979	1059	1	71	80	0.8875000
NODE_3830_length_1209_cov_5.721622	979	1059	2	9	80	0.1125000
NODE_3833_length_1208_cov_40.717764	886	966	109	1	80	0.0125000
NODE_3833_length_1208_cov_40.717764	886	966	110	1	80	0.0125000
NODE_3833_length_1208_cov_40.717764	886	966	113	1	80	0.0125000
NODE_3833_length_1208_cov_40.717764	886	966	115	1	80	0.0125000
NODE_3833_length_1208_cov_40.717764	886	966	116	1	80	0.0125000
NODE_3833_length_1208_cov_40.717764	886	966	120	1	80	0.0125000
NODE_3833_length_1208_cov_40.717764	886	966	124	1	80	0.0125000
NODE_3833_length_1208_cov_40.717764	886	966	125	1	80	0.0125000
NODE_3833_length_1208_cov_40.717764	886	966	126	1	80	0.0125000
NODE_3833_length_1208_cov_40.717764	886	966	132	1	80	0.0125000
NODE_3833_length_1208_cov_40.717764	886	966	133	1	80	0.0125000
NODE_3833_length_1208_cov_40.717764	886	966	134	1	80	0.0125000
NODE_3833_length_1208_cov_40.717764	886	966	137	1	80	0.0125000
NODE_3833_length_1208_cov_40.717764	886	966	139	1	80	0.0125000
NODE_3833_length_1208_cov_40.717764	886	966	141	2	80	0.0250000
NODE_3833_length_1208_cov_40.717764	886	966	145	1	80	0.0125000
NODE_3833_length_1208_cov_40.717764	886	966	146	1	80	0.0125000
NODE_3833_length_1208_cov_40.717764	886	966	147	1	80	0.0125000
NODE_3833_length_1208_cov_40.717764	886	966	149	1	80	0.0125000
NODE_3833_length_1208_cov_40.717764	886	966	150	2	80	0.0250000
NODE_3833_length_1208_cov_40.717764	886	966	154	1	80	0.0125000
NODE_3833_length_1208_cov_40.717764	886	966	156	1	80	0.0125000
NODE_3833_length_1208_cov_40.717764	886	966	160	1	80	0.0125000
NODE_3833_length_1208_cov_40.717764	886	966	162	1	80	0.0125000
NODE_3833_length_1208_cov_40.717764	886	966	163	1	80	0.0125000
NODE_3833_length_1208_cov_40.717764	886	966	165	2	80	0.0250000
NODE_3833_length_1208_cov_40.717764	886	966	169	1	80	0.0125000
NODE_3833_length_1208_cov_40.717764	886	966	172	1	80	0.0125000
NODE_3833_length_1208_cov_40.717764	886	966	181	1	80	0.0125000
NODE_3833_length_1208_cov_40.717764	886	966	182	1	80	0.0125000
NODE_3833_length_1208_cov_40.717764	886	966	187	1	80	0.0125000
NODE_3833_length_1208_cov_40.717764	886	966	188	1	80	0.0125000
NODE_3833_length_1208_cov_40.717764	886	966	190	2	80	0.0250000
NODE_3833_length_1208_cov_40.717764	886	966	191	1	80	0.0125000
NODE_3833_length_1208_cov_40.717764	886	966	195	1	80	0.0125000
NODE_3833_length_1208_cov_40.717764	886	966	199	1	80	0.0125000
NODE_3833_length_1208_cov_40.717764	886	966	201	2	80	0.0250000
NODE_3833_length_1208_cov_40.717764	886	966	203	1	80	0.0125000
NODE_3833_length_1208_cov_40.717764	886	966	205	1	80	0.0125000
NODE_3833_length_1208_cov_40.717764	886	966	206	1	80	0.0125000
NODE_3833_length_1208_cov_40.717764	886	966	211	1	80	0.0125000
NODE_3833_length_1208_cov_40.717764	886	966	212	1	80	0.0125000
NODE_3833_length_1208_cov_40.717764	886	966	216	2	80	0.0250000
NODE_3833_length_1208_cov_40.717764	886	966	220	1	80	0.0125000
NODE_3833_length_1208_cov_40.717764	886	966	226	1	80	0.0125000
NODE_3833_length_1208_cov_40.717764	886	966	228	2	80	0.0250000
NODE_3833_length_1208_cov_40.717764	886	966	231	2	80	0.0250000
NODE_3833_length_1208_cov_40.717764	886	966	232	1	80	0.0125000
NODE_3833_length_1208_cov_40.717764	886	966	234	1	80	0.0125000
NODE_3833_length_1208_cov_40.717764	886	966	236	1	80	0.0125000
NODE_3833_length_1208_cov_40.717764	886	966	239	1	80	0.0125000
NODE_3833_length_1208_cov_40.717764	886	966	245	1	80	0.0125000
NODE_3833_length_1208_cov_40.717764	886	966	246	1	80	0.0125000
NODE_3833_length_1208_cov_40.717764	886	966	248	3	80	0.0375000
NODE_3833_length_1208_cov_40.717764	886	966	251	1	80	0.0125000
NODE_3833_length_1208_cov_40.717764	886	966	255	1	80	0.0125000
NODE_3833_length_1208_cov_40.717764	886	966	256	1	80	0.0125000
NODE_3833_length_1208_cov_40.717764	886	966	262	1	80	0.0125000
NODE_3833_length_1208_cov_40.717764	886	966	263	1	80	0.0125000
NODE_3833_length_1208_cov_40.717764	886	966	264	1	80	0.0125000
NODE_3833_length_1208_cov_40.717764	886	966	266	1	80	0.0125000
NODE_3833_length_1208_cov_40.717764	886	966	270	1	80	0.0125000
NODE_3833_length_1208_cov_40.717764	886	966	271	1	80	0.0125000
NODE_3833_length_1208_cov_40.717764	886	966	272	1	80	0.0125000
NODE_3833_length_1208_cov_40.717764	886	966	275	1	80	0.0125000
NODE_3833_length_1208_cov_40.717764	886	966	276	1	80	0.0125000
NODE_3833_length_1208_cov_40.717764	886	966	277	1	80	0.0125000
NODE_3833_length_1208_cov_40.717764	886	966	284	1	80	0.0125000
NODE_3833_length_1208_cov_40.717764	886	966	294	1	80	0.0125000
NODE_3833_length_1208_cov_40.717764	886	966	300	1	80	0.0125000
NODE_3833_length_1208_cov_40.717764	939	985	231	2	46	0.0434783
NODE_3833_length_1208_cov_40.717764	939	985	232	1	46	0.0217391
NODE_3833_length_1208_cov_40.717764	939	985	234	1	46	0.0217391
NODE_3833_length_1208_cov_40.717764	939	985	236	1	46	0.0217391
NODE_3833_length_1208_cov_40.717764	939	985	239	1	46	0.0217391
NODE_3833_length_1208_cov_40.717764	939	985	245	1	46	0.0217391
NODE_3833_length_1208_cov_40.717764	939	985	246	1	46	0.0217391
NODE_3833_length_1208_cov_40.717764	939	985	248	3	46	0.0652174
NODE_3833_length_1208_cov_40.717764	939	985	251	1	46	0.0217391
NODE_3833_length_1208_cov_40.717764	939	985	255	1	46	0.0217391
NODE_3833_length_1208_cov_40.717764	939	985	256	1	46	0.0217391
NODE_3833_length_1208_cov_40.717764	939	985	262	1	46	0.0217391
NODE_3833_length_1208_cov_40.717764	939	985	263	1	46	0.0217391
NODE_3833_length_1208_cov_40.717764	939	985	264	1	46	0.0217391
NODE_3833_length_1208_cov_40.717764	939	985	266	1	46	0.0217391
NODE_3833_length_1208_cov_40.717764	939	985	270	1	46	0.0217391
NODE_3833_length_1208_cov_40.717764	939	985	271	1	46	0.0217391
NODE_3833_length_1208_cov_40.717764	939	985	272	1	46	0.0217391
NODE_3833_length_1208_cov_40.717764	939	985	275	1	46	0.0217391
NODE_3833_length_1208_cov_40.717764	939	985	276	1	46	0.0217391
NODE_3833_length_1208_cov_40.717764	939	985	277	1	46	0.0217391
NODE_3833_length_1208_cov_40.717764	939	985	284	1	46	0.0217391
NODE_3833_length_1208_cov_40.717764	939	985	294	1	46	0.0217391
NODE_3833_length_1208_cov_40.717764	939	985	300	3	46	0.0652174
NODE_3833_length_1208_cov_40.717764	939	985	305	1	46	0.0217391
NODE_3833_length_1208_cov_40.717764	939	985	307	2	46	0.0434783
NODE_3833_length_1208_cov_40.717764	939	985	308	2	46	0.0434783
NODE_3833_length_1208_cov_40.717764	939	985	309	3	46	0.0652174
NODE_3833_length_1208_cov_40.717764	939	985	310	1	46	0.0217391
NODE_3833_length_1208_cov_40.717764	939	985	317	1	46	0.0217391
NODE_3833_length_1208_cov_40.717764	939	985	318	4	46	0.0869565
NODE_3833_length_1208_cov_40.717764	939	985	319	2	46	0.0434783
NODE_3833_length_1208_cov_40.717764	939	985	320	1	46	0.0217391
NODE_3834_length_1208_cov_28.528404	614	694	6	4	80	0.0500000
NODE_3834_length_1208_cov_28.528404	614	694	8	22	80	0.2750000
NODE_3834_length_1208_cov_28.528404	614	694	10	13	80	0.1625000
NODE_3834_length_1208_cov_28.528404	614	694	11	41	80	0.5125000
NODE_3834_length_1208_cov_28.528404	667	747	6	12	80	0.1500000
NODE_3834_length_1208_cov_28.528404	667	747	7	10	80	0.1250000
NODE_3834_length_1208_cov_28.528404	667	747	9	25	80	0.3125000
NODE_3834_length_1208_cov_28.528404	667	747	10	14	80	0.1750000
NODE_3834_length_1208_cov_28.528404	667	747	11	19	80	0.2375000
NODE_3835_length_1208_cov_19.688007	682	762	0	80	80	1.0000000
NODE_3835_length_1208_cov_19.688007	735	815	0	80	80	1.0000000
NODE_3836_length_1208_cov_18.577096	455	535	3	70	80	0.8750000
NODE_3836_length_1208_cov_18.577096	455	535	4	10	80	0.1250000
NODE_3836_length_1208_cov_18.577096	508	588	2	46	80	0.5750000
NODE_3836_length_1208_cov_18.577096	508	588	3	30	80	0.3750000
NODE_3836_length_1208_cov_18.577096	508	588	4	4	80	0.0500000
NODE_3836_length_1208_cov_18.577096	584	664	0	12	80	0.1500000
NODE_3836_length_1208_cov_18.577096	584	664	1	55	80	0.6875000
NODE_3836_length_1208_cov_18.577096	584	664	2	13	80	0.1625000
NODE_3836_length_1208_cov_18.577096	637	717	0	31	80	0.3875000
NODE_3836_length_1208_cov_18.577096	637	717	1	15	80	0.1875000
NODE_3836_length_1208_cov_18.577096	637	717	2	34	80	0.4250000
NODE_3837_length_1208_cov_12.733995	766	846	0	80	80	1.0000000
NODE_3837_length_1208_cov_12.733995	819	899	0	80	80	1.0000000
NODE_3837_length_1208_cov_12.733995	895	975	0	80	80	1.0000000
NODE_3837_length_1208_cov_12.733995	948	1028	0	80	80	1.0000000
NODE_3838_length_1207_cov_20.461191	874	954	1	30	80	0.3750000
NODE_3838_length_1207_cov_20.461191	874	954	2	50	80	0.6250000
NODE_3838_length_1207_cov_20.461191	927	1007	1	63	80	0.7875000
NODE_3838_length_1207_cov_20.461191	927	1007	2	17	80	0.2125000
NODE_3846_length_1206_cov_59.851852	540	620	4	1	80	0.0125000
NODE_3846_length_1206_cov_59.851852	540	620	5	1	80	0.0125000
NODE_3846_length_1206_cov_59.851852	540	620	6	3	80	0.0375000
NODE_3846_length_1206_cov_59.851852	540	620	8	27	80	0.3375000
NODE_3846_length_1206_cov_59.851852	540	620	11	21	80	0.2625000
NODE_3846_length_1206_cov_59.851852	540	620	12	27	80	0.3375000
NODE_3846_length_1206_cov_59.851852	593	673	7	6	80	0.0750000
NODE_3846_length_1206_cov_59.851852	593	673	11	41	80	0.5125000
NODE_3846_length_1206_cov_59.851852	593	673	12	33	80	0.4125000
NODE_3846_length_1206_cov_59.851852	669	749	2	20	80	0.2500000
NODE_3846_length_1206_cov_59.851852	669	749	3	35	80	0.4375000
NODE_3846_length_1206_cov_59.851852	669	749	4	3	80	0.0375000
NODE_3846_length_1206_cov_59.851852	669	749	6	1	80	0.0125000
NODE_3846_length_1206_cov_59.851852	669	749	7	21	80	0.2625000
NODE_3846_length_1206_cov_59.851852	722	802	3	58	80	0.7250000
NODE_3846_length_1206_cov_59.851852	722	802	4	22	80	0.2750000
NODE_3847_length_1206_cov_23.752484	669	749	9	8	80	0.1000000
NODE_3847_length_1206_cov_23.752484	669	749	10	6	80	0.0750000
NODE_3847_length_1206_cov_23.752484	669	749	11	23	80	0.2875000
NODE_3847_length_1206_cov_23.752484	669	749	12	12	80	0.1500000
NODE_3847_length_1206_cov_23.752484	669	749	13	31	80	0.3875000
NODE_3847_length_1206_cov_23.752484	722	802	6	2	80	0.0250000
NODE_3847_length_1206_cov_23.752484	722	802	7	19	80	0.2375000
NODE_3847_length_1206_cov_23.752484	722	802	8	1	80	0.0125000
NODE_3847_length_1206_cov_23.752484	722	802	9	12	80	0.1500000
NODE_3847_length_1206_cov_23.752484	722	802	10	4	80	0.0500000
NODE_3847_length_1206_cov_23.752484	722	802	11	21	80	0.2625000
NODE_3847_length_1206_cov_23.752484	722	802	12	12	80	0.1500000
NODE_3847_length_1206_cov_23.752484	722	802	13	9	80	0.1125000
NODE_3848_length_1206_cov_21.226739	585	665	1	5	80	0.0625000
NODE_3848_length_1206_cov_21.226739	585	665	2	27	80	0.3375000
NODE_3848_length_1206_cov_21.226739	585	665	3	21	80	0.2625000
NODE_3848_length_1206_cov_21.226739	585	665	4	27	80	0.3375000
NODE_3848_length_1206_cov_21.226739	638	718	0	30	80	0.3750000
NODE_3848_length_1206_cov_21.226739	638	718	1	28	80	0.3500000
NODE_3848_length_1206_cov_21.226739	638	718	2	22	80	0.2750000
NODE_3855_length_1205_cov_23.990054	355	435	0	8	80	0.1000000
NODE_3855_length_1205_cov_23.990054	355	435	1	9	80	0.1125000
NODE_3855_length_1205_cov_23.990054	355	435	2	3	80	0.0375000
NODE_3855_length_1205_cov_23.990054	355	435	3	60	80	0.7500000
NODE_3855_length_1205_cov_23.990054	408	488	3	80	80	1.0000000
NODE_3856_length_1205_cov_10.473779	780	860	0	80	80	1.0000000
NODE_3856_length_1205_cov_10.473779	833	913	0	80	80	1.0000000
NODE_3863_length_1204_cov_19.396380	537	617	2	43	80	0.5375000
NODE_3863_length_1204_cov_19.396380	537	617	3	37	80	0.4625000
NODE_3863_length_1204_cov_19.396380	590	670	3	80	80	1.0000000
NODE_3864_length_1204_cov_17.716742	448	528	0	80	80	1.0000000
NODE_3864_length_1204_cov_17.716742	501	581	0	80	80	1.0000000
NODE_3865_length_1204_cov_15.206335	426	506	6	8	80	0.1000000
NODE_3865_length_1204_cov_15.206335	426	506	7	9	80	0.1125000
NODE_3865_length_1204_cov_15.206335	426	506	8	13	80	0.1625000
NODE_3865_length_1204_cov_15.206335	426	506	9	24	80	0.3000000
NODE_3865_length_1204_cov_15.206335	426	506	10	24	80	0.3000000
NODE_3865_length_1204_cov_15.206335	426	506	11	2	80	0.0250000
NODE_3865_length_1204_cov_15.206335	479	559	3	10	80	0.1250000
NODE_3865_length_1204_cov_15.206335	479	559	6	17	80	0.2125000
NODE_3865_length_1204_cov_15.206335	479	559	7	43	80	0.5375000
NODE_3865_length_1204_cov_15.206335	479	559	8	10	80	0.1250000
NODE_3866_length_1204_cov_14.097738	632	712	0	5	80	0.0625000
NODE_3866_length_1204_cov_14.097738	632	712	1	75	80	0.9375000
NODE_3866_length_1204_cov_14.097738	685	765	0	58	80	0.7250000
NODE_3866_length_1204_cov_14.097738	685	765	1	22	80	0.2750000
NODE_3867_length_1204_cov_11.971946	549	629	0	79	80	0.9875000
NODE_3867_length_1204_cov_11.971946	549	629	2	1	80	0.0125000
NODE_3867_length_1204_cov_11.971946	602	682	0	26	80	0.3250000
NODE_3867_length_1204_cov_11.971946	602	682	2	54	80	0.6750000
NODE_3867_length_1204_cov_11.971946	678	758	2	80	80	1.0000000
NODE_3867_length_1204_cov_11.971946	731	811	0	48	80	0.6000000
NODE_3867_length_1204_cov_11.971946	731	811	2	32	80	0.4000000
NODE_3868_length_1204_cov_11.665158	499	579	1	2	80	0.0250000
NODE_3868_length_1204_cov_11.665158	499	579	2	61	80	0.7625000
NODE_3868_length_1204_cov_11.665158	499	579	3	17	80	0.2125000
NODE_3868_length_1204_cov_11.665158	552	632	0	12	80	0.1500000
NODE_3868_length_1204_cov_11.665158	552	632	1	43	80	0.5375000
NODE_3868_length_1204_cov_11.665158	552	632	2	25	80	0.3125000
NODE_3869_length_1204_cov_7.028959	637	717	2	80	80	1.0000000
NODE_3869_length_1204_cov_7.028959	690	770	0	2	80	0.0250000
NODE_3869_length_1204_cov_7.028959	690	770	1	11	80	0.1375000
NODE_3869_length_1204_cov_7.028959	690	770	2	67	80	0.8375000
NODE_3870_length_1204_cov_4.677828	807	887	0	80	80	1.0000000
NODE_3870_length_1204_cov_4.677828	860	940	0	80	80	1.0000000
NODE_3873_length_1203_cov_46.789855	515	595	6	63	80	0.7875000
NODE_3873_length_1203_cov_46.789855	515	595	8	17	80	0.2125000
NODE_3873_length_1203_cov_46.789855	568	648	5	19	80	0.2375000
NODE_3873_length_1203_cov_46.789855	568	648	6	49	80	0.6125000
NODE_3873_length_1203_cov_46.789855	568	648	7	12	80	0.1500000
NODE_3873_length_1203_cov_46.789855	644	724	3	36	80	0.4500000
NODE_3873_length_1203_cov_46.789855	644	724	5	34	80	0.4250000
NODE_3873_length_1203_cov_46.789855	644	724	6	10	80	0.1250000
NODE_3873_length_1203_cov_46.789855	697	777	2	18	80	0.2250000
NODE_3873_length_1203_cov_46.789855	697	777	3	62	80	0.7750000
NODE_3874_length_1203_cov_44.029891	471	551	0	60	80	0.7500000
NODE_3874_length_1203_cov_44.029891	471	551	2	20	80	0.2500000
NODE_3874_length_1203_cov_44.029891	524	604	0	7	80	0.0875000
NODE_3874_length_1203_cov_44.029891	524	604	2	33	80	0.4125000
NODE_3874_length_1203_cov_44.029891	524	604	3	11	80	0.1375000
NODE_3874_length_1203_cov_44.029891	524	604	4	29	80	0.3625000
NODE_3874_length_1203_cov_44.029891	600	680	3	38	80	0.4750000
NODE_3874_length_1203_cov_44.029891	600	680	4	6	80	0.0750000
NODE_3874_length_1203_cov_44.029891	600	680	5	36	80	0.4500000
NODE_3874_length_1203_cov_44.029891	653	733	1	8	80	0.1000000
NODE_3874_length_1203_cov_44.029891	653	733	2	11	80	0.1375000
NODE_3874_length_1203_cov_44.029891	653	733	3	61	80	0.7625000
NODE_3875_length_1203_cov_23.790761	308	388	1	80	80	1.0000000
NODE_3875_length_1203_cov_23.790761	361	441	1	76	80	0.9500000
NODE_3875_length_1203_cov_23.790761	361	441	2	4	80	0.0500000
NODE_3875_length_1203_cov_23.790761	437	517	1	80	80	1.0000000
NODE_3875_length_1203_cov_23.790761	490	570	1	80	80	1.0000000
NODE_3876_length_1203_cov_19.498188	336	416	0	9	80	0.1125000
NODE_3876_length_1203_cov_19.498188	336	416	1	11	80	0.1375000
NODE_3876_length_1203_cov_19.498188	336	416	3	60	80	0.7500000
NODE_3876_length_1203_cov_19.498188	389	469	3	40	80	0.5000000
NODE_3876_length_1203_cov_19.498188	389	469	4	40	80	0.5000000
NODE_3877_length_1203_cov_10.996377	317	397	1	80	80	1.0000000
NODE_3877_length_1203_cov_10.996377	370	450	1	64	80	0.8000000
NODE_3877_length_1203_cov_10.996377	370	450	2	16	80	0.2000000
NODE_3878_length_1203_cov_5.747283	725	805	1	80	80	1.0000000
NODE_3878_length_1203_cov_5.747283	778	858	0	52	80	0.6500000
NODE_3878_length_1203_cov_5.747283	778	858	1	28	80	0.3500000
NODE_3881_length_1202_cov_39.333636	475	555	0	16	80	0.2000000
NODE_3881_length_1202_cov_39.333636	475	555	1	29	80	0.3625000
NODE_3881_length_1202_cov_39.333636	475	555	2	35	80	0.4375000
NODE_3881_length_1202_cov_39.333636	528	608	0	69	80	0.8625000
NODE_3881_length_1202_cov_39.333636	528	608	1	11	80	0.1375000
NODE_3881_length_1202_cov_39.333636	604	684	0	46	80	0.5750000
NODE_3881_length_1202_cov_39.333636	604	684	4	34	80	0.4250000
NODE_3881_length_1202_cov_39.333636	657	737	4	80	80	1.0000000
NODE_3882_length_1202_cov_17.556664	599	679	3	21	80	0.2625000
NODE_3882_length_1202_cov_17.556664	599	679	5	29	80	0.3625000
NODE_3882_length_1202_cov_17.556664	599	679	7	6	80	0.0750000
NODE_3882_length_1202_cov_17.556664	599	679	9	24	80	0.3000000
NODE_3882_length_1202_cov_17.556664	652	732	5	10	80	0.1250000
NODE_3882_length_1202_cov_17.556664	652	732	6	13	80	0.1625000
NODE_3882_length_1202_cov_17.556664	652	732	7	13	80	0.1625000
NODE_3882_length_1202_cov_17.556664	652	732	9	44	80	0.5500000
NODE_3883_length_1202_cov_12.338169	634	714	3	2	80	0.0250000
NODE_3883_length_1202_cov_12.338169	634	714	5	57	80	0.7125000
NODE_3883_length_1202_cov_12.338169	634	714	6	21	80	0.2625000
NODE_3883_length_1202_cov_12.338169	687	767	5	25	80	0.3125000
NODE_3883_length_1202_cov_12.338169	687	767	6	40	80	0.5000000
NODE_3883_length_1202_cov_12.338169	687	767	7	4	80	0.0500000
NODE_3883_length_1202_cov_12.338169	687	767	8	11	80	0.1375000
NODE_3884_length_1202_cov_11.800544	520	600	0	45	80	0.5625000
NODE_3884_length_1202_cov_11.800544	520	600	2	35	80	0.4375000
NODE_3884_length_1202_cov_11.800544	573	653	2	80	80	1.0000000
NODE_3887_length_1201_cov_12.161525	434	514	0	15	80	0.1875000
NODE_3887_length_1201_cov_12.161525	434	514	1	35	80	0.4375000
NODE_3887_length_1201_cov_12.161525	434	514	2	30	80	0.3750000
NODE_3887_length_1201_cov_12.161525	487	567	2	80	80	1.0000000
NODE_3888_length_1201_cov_12.046279	643	723	1	61	80	0.7625000
NODE_3888_length_1201_cov_12.046279	643	723	2	19	80	0.2375000
NODE_3888_length_1201_cov_12.046279	696	776	1	26	80	0.3250000
NODE_3888_length_1201_cov_12.046279	696	776	2	54	80	0.6750000
NODE_3891_length_1200_cov_76.694823	630	710	4	14	80	0.1750000
NODE_3891_length_1200_cov_76.694823	630	710	5	19	80	0.2375000
NODE_3891_length_1200_cov_76.694823	630	710	6	47	80	0.5875000
NODE_3891_length_1200_cov_76.694823	683	763	3	8	80	0.1000000
NODE_3891_length_1200_cov_76.694823	683	763	4	2	80	0.0250000
NODE_3891_length_1200_cov_76.694823	683	763	5	27	80	0.3375000
NODE_3891_length_1200_cov_76.694823	683	763	6	39	80	0.4875000
NODE_3891_length_1200_cov_76.694823	683	763	7	4	80	0.0500000
NODE_3891_length_1200_cov_76.694823	759	839	4	40	80	0.5000000
NODE_3891_length_1200_cov_76.694823	759	839	5	10	80	0.1250000
NODE_3891_length_1200_cov_76.694823	759	839	7	30	80	0.3750000
NODE_3891_length_1200_cov_76.694823	812	892	4	11	80	0.1375000
NODE_3891_length_1200_cov_76.694823	812	892	5	10	80	0.1250000
NODE_3891_length_1200_cov_76.694823	812	892	6	14	80	0.1750000
NODE_3891_length_1200_cov_76.694823	812	892	7	45	80	0.5625000
NODE_3892_length_1200_cov_16.881926	827	902	6	21	75	0.2800000
NODE_3892_length_1200_cov_16.881926	827	902	9	1	75	0.0133333
NODE_3892_length_1200_cov_16.881926	827	902	10	2	75	0.0266667
NODE_3892_length_1200_cov_16.881926	827	902	11	13	75	0.1733333
NODE_3892_length_1200_cov_16.881926	827	902	12	6	75	0.0800000
NODE_3892_length_1200_cov_16.881926	827	902	13	8	75	0.1066667
NODE_3892_length_1200_cov_16.881926	827	902	14	5	75	0.0666667
NODE_3892_length_1200_cov_16.881926	827	902	15	7	75	0.0933333
NODE_3892_length_1200_cov_16.881926	827	902	17	5	75	0.0666667
NODE_3892_length_1200_cov_16.881926	827	902	19	7	75	0.0933333
NODE_3892_length_1200_cov_16.881926	828	904	6	20	76	0.2631579
NODE_3892_length_1200_cov_16.881926	828	904	9	1	76	0.0131579
NODE_3892_length_1200_cov_16.881926	828	904	10	2	76	0.0263158
NODE_3892_length_1200_cov_16.881926	828	904	11	13	76	0.1710526
NODE_3892_length_1200_cov_16.881926	828	904	12	6	76	0.0789474
NODE_3892_length_1200_cov_16.881926	828	904	13	8	76	0.1052632
NODE_3892_length_1200_cov_16.881926	828	904	14	5	76	0.0657895
NODE_3892_length_1200_cov_16.881926	828	904	15	7	76	0.0921053
NODE_3892_length_1200_cov_16.881926	828	904	17	5	76	0.0657895
NODE_3892_length_1200_cov_16.881926	828	904	19	7	76	0.0921053
NODE_3892_length_1200_cov_16.881926	828	904	20	2	76	0.0263158
NODE_3892_length_1200_cov_16.881926	841	907	6	7	66	0.1060606
NODE_3892_length_1200_cov_16.881926	841	907	9	1	66	0.0151515
NODE_3892_length_1200_cov_16.881926	841	907	10	2	66	0.0303030
NODE_3892_length_1200_cov_16.881926	841	907	11	13	66	0.1969697
NODE_3892_length_1200_cov_16.881926	841	907	12	6	66	0.0909091
NODE_3892_length_1200_cov_16.881926	841	907	13	8	66	0.1212121
NODE_3892_length_1200_cov_16.881926	841	907	14	5	66	0.0757576
NODE_3892_length_1200_cov_16.881926	841	907	15	7	66	0.1060606
NODE_3892_length_1200_cov_16.881926	841	907	17	5	66	0.0757576
NODE_3892_length_1200_cov_16.881926	841	907	19	7	66	0.1060606
NODE_3892_length_1200_cov_16.881926	841	907	20	3	66	0.0454545
NODE_3892_length_1200_cov_16.881926	841	907	21	2	66	0.0303030
NODE_3892_length_1200_cov_16.881926	880	957	14	3	77	0.0389610
NODE_3892_length_1200_cov_16.881926	880	957	15	7	77	0.0909091
NODE_3892_length_1200_cov_16.881926	880	957	17	5	77	0.0649351
NODE_3892_length_1200_cov_16.881926	880	957	19	7	77	0.0909091
NODE_3892_length_1200_cov_16.881926	880	957	20	3	77	0.0389610
NODE_3892_length_1200_cov_16.881926	880	957	21	2	77	0.0259740
NODE_3892_length_1200_cov_16.881926	880	957	22	5	77	0.0649351
NODE_3892_length_1200_cov_16.881926	880	957	23	2	77	0.0259740
NODE_3892_length_1200_cov_16.881926	880	957	24	9	77	0.1168831
NODE_3892_length_1200_cov_16.881926	880	957	25	2	77	0.0259740
NODE_3892_length_1200_cov_16.881926	880	957	26	2	77	0.0259740
NODE_3892_length_1200_cov_16.881926	880	957	29	3	77	0.0389610
NODE_3892_length_1200_cov_16.881926	880	957	30	1	77	0.0129870
NODE_3892_length_1200_cov_16.881926	880	957	31	4	77	0.0519481
NODE_3892_length_1200_cov_16.881926	880	957	32	5	77	0.0649351
NODE_3892_length_1200_cov_16.881926	880	957	33	12	77	0.1558442
NODE_3892_length_1200_cov_16.881926	880	957	34	1	77	0.0129870
NODE_3892_length_1200_cov_16.881926	880	957	35	1	77	0.0129870
NODE_3892_length_1200_cov_16.881926	880	957	36	3	77	0.0389610
NODE_3892_length_1200_cov_16.881926	880	957	14	3	77	0.0389610
NODE_3892_length_1200_cov_16.881926	880	957	15	7	77	0.0909091
NODE_3892_length_1200_cov_16.881926	880	957	17	5	77	0.0649351
NODE_3892_length_1200_cov_16.881926	880	957	19	7	77	0.0909091
NODE_3892_length_1200_cov_16.881926	880	957	20	3	77	0.0389610
NODE_3892_length_1200_cov_16.881926	880	957	21	2	77	0.0259740
NODE_3892_length_1200_cov_16.881926	880	957	22	5	77	0.0649351
NODE_3892_length_1200_cov_16.881926	880	957	23	2	77	0.0259740
NODE_3892_length_1200_cov_16.881926	880	957	24	9	77	0.1168831
NODE_3892_length_1200_cov_16.881926	880	957	25	2	77	0.0259740
NODE_3892_length_1200_cov_16.881926	880	957	26	2	77	0.0259740
NODE_3892_length_1200_cov_16.881926	880	957	29	3	77	0.0389610
NODE_3892_length_1200_cov_16.881926	880	957	30	1	77	0.0129870
NODE_3892_length_1200_cov_16.881926	880	957	31	4	77	0.0519481
NODE_3892_length_1200_cov_16.881926	880	957	32	5	77	0.0649351
NODE_3892_length_1200_cov_16.881926	880	957	33	12	77	0.1558442
NODE_3892_length_1200_cov_16.881926	880	957	34	1	77	0.0129870
NODE_3892_length_1200_cov_16.881926	880	957	35	1	77	0.0129870
NODE_3892_length_1200_cov_16.881926	880	957	36	3	77	0.0389610
NODE_3892_length_1200_cov_16.881926	880	957	14	3	77	0.0389610
NODE_3892_length_1200_cov_16.881926	880	957	15	7	77	0.0909091
NODE_3892_length_1200_cov_16.881926	880	957	17	5	77	0.0649351
NODE_3892_length_1200_cov_16.881926	880	957	19	7	77	0.0909091
NODE_3892_length_1200_cov_16.881926	880	957	20	3	77	0.0389610
NODE_3892_length_1200_cov_16.881926	880	957	21	2	77	0.0259740
NODE_3892_length_1200_cov_16.881926	880	957	22	5	77	0.0649351
NODE_3892_length_1200_cov_16.881926	880	957	23	2	77	0.0259740
NODE_3892_length_1200_cov_16.881926	880	957	24	9	77	0.1168831
NODE_3892_length_1200_cov_16.881926	880	957	25	2	77	0.0259740
NODE_3892_length_1200_cov_16.881926	880	957	26	2	77	0.0259740
NODE_3892_length_1200_cov_16.881926	880	957	29	3	77	0.0389610
NODE_3892_length_1200_cov_16.881926	880	957	30	1	77	0.0129870
NODE_3892_length_1200_cov_16.881926	880	957	31	4	77	0.0519481
NODE_3892_length_1200_cov_16.881926	880	957	32	5	77	0.0649351
NODE_3892_length_1200_cov_16.881926	880	957	33	12	77	0.1558442
NODE_3892_length_1200_cov_16.881926	880	957	34	1	77	0.0129870
NODE_3892_length_1200_cov_16.881926	880	957	35	1	77	0.0129870
NODE_3892_length_1200_cov_16.881926	880	957	36	3	77	0.0389610
NODE_3893_length_1200_cov_15.374205	605	685	0	12	80	0.1500000
NODE_3893_length_1200_cov_15.374205	605	685	1	68	80	0.8500000
NODE_3893_length_1200_cov_15.374205	658	738	1	63	80	0.7875000
NODE_3893_length_1200_cov_15.374205	658	738	2	17	80	0.2125000
NODE_3894_length_1200_cov_12.953678	486	550	6	5	64	0.0781250
NODE_3894_length_1200_cov_12.953678	486	550	7	59	64	0.9218750
NODE_3899_length_1199_cov_14.843636	222	302	0	23	80	0.2875000
NODE_3899_length_1199_cov_14.843636	222	302	1	35	80	0.4375000
NODE_3899_length_1199_cov_14.843636	222	302	2	22	80	0.2750000
NODE_3899_length_1199_cov_14.843636	275	355	1	5	80	0.0625000
NODE_3899_length_1199_cov_14.843636	275	355	2	75	80	0.9375000
NODE_3900_length_1199_cov_12.005455	383	463	0	3	80	0.0375000
NODE_3900_length_1199_cov_12.005455	383	463	1	29	80	0.3625000
NODE_3900_length_1199_cov_12.005455	383	463	3	5	80	0.0625000
NODE_3900_length_1199_cov_12.005455	383	463	5	41	80	0.5125000
NODE_3900_length_1199_cov_12.005455	383	463	6	2	80	0.0250000
NODE_3900_length_1199_cov_12.005455	436	516	5	25	80	0.3125000
NODE_3900_length_1199_cov_12.005455	436	516	6	13	80	0.1625000
NODE_3900_length_1199_cov_12.005455	436	516	7	4	80	0.0500000
NODE_3900_length_1199_cov_12.005455	436	516	8	23	80	0.2875000
NODE_3900_length_1199_cov_12.005455	436	516	9	10	80	0.1250000
NODE_3900_length_1199_cov_12.005455	436	516	10	5	80	0.0625000
NODE_3900_length_1199_cov_12.005455	512	592	6	37	80	0.4625000
NODE_3900_length_1199_cov_12.005455	512	592	7	7	80	0.0875000
NODE_3900_length_1199_cov_12.005455	512	592	8	36	80	0.4500000
NODE_3900_length_1199_cov_12.005455	565	645	3	17	80	0.2125000
NODE_3900_length_1199_cov_12.005455	565	645	4	4	80	0.0500000
NODE_3900_length_1199_cov_12.005455	565	645	5	13	80	0.1625000
NODE_3900_length_1199_cov_12.005455	565	645	6	46	80	0.5750000
NODE_3902_length_1198_cov_36.830755	619	699	7	23	80	0.2875000
NODE_3902_length_1198_cov_36.830755	619	699	9	29	80	0.3625000
NODE_3902_length_1198_cov_36.830755	619	699	10	21	80	0.2625000
NODE_3902_length_1198_cov_36.830755	619	699	11	7	80	0.0875000
NODE_3902_length_1198_cov_36.830755	672	752	5	4	80	0.0500000
NODE_3902_length_1198_cov_36.830755	672	752	6	3	80	0.0375000
NODE_3902_length_1198_cov_36.830755	672	752	7	41	80	0.5125000
NODE_3902_length_1198_cov_36.830755	672	752	9	15	80	0.1875000
NODE_3902_length_1198_cov_36.830755	672	752	10	17	80	0.2125000
NODE_3903_length_1198_cov_22.864422	719	799	1	3	80	0.0375000
NODE_3903_length_1198_cov_22.864422	719	799	2	3	80	0.0375000
NODE_3903_length_1198_cov_22.864422	719	799	3	51	80	0.6375000
NODE_3903_length_1198_cov_22.864422	719	799	4	23	80	0.2875000
NODE_3903_length_1198_cov_22.864422	772	852	0	2	80	0.0250000
NODE_3903_length_1198_cov_22.864422	772	852	1	54	80	0.6750000
NODE_3903_length_1198_cov_22.864422	772	852	2	3	80	0.0375000
NODE_3903_length_1198_cov_22.864422	772	852	3	21	80	0.2625000
NODE_3904_length_1198_cov_17.619654	260	340	4	32	80	0.4000000
NODE_3904_length_1198_cov_17.619654	260	340	5	48	80	0.6000000
NODE_3904_length_1198_cov_17.619654	313	392	3	23	79	0.2911392
NODE_3904_length_1198_cov_17.619654	313	392	4	11	79	0.1392405
NODE_3904_length_1198_cov_17.619654	313	392	5	45	79	0.5696203
NODE_3905_length_1198_cov_10.148317	718	798	1	17	80	0.2125000
NODE_3905_length_1198_cov_10.148317	718	798	2	15	80	0.1875000
NODE_3905_length_1198_cov_10.148317	718	798	4	48	80	0.6000000
NODE_3905_length_1198_cov_10.148317	771	851	1	2	80	0.0250000
NODE_3905_length_1198_cov_10.148317	771	851	3	44	80	0.5500000
NODE_3905_length_1198_cov_10.148317	771	851	4	34	80	0.4250000
NODE_3906_length_1198_cov_6.733394	549	629	2	8	80	0.1000000
NODE_3906_length_1198_cov_6.733394	549	629	3	18	80	0.2250000
NODE_3906_length_1198_cov_6.733394	549	629	4	54	80	0.6750000
NODE_3906_length_1198_cov_6.733394	602	682	0	19	80	0.2375000
NODE_3906_length_1198_cov_6.733394	602	682	3	25	80	0.3125000
NODE_3906_length_1198_cov_6.733394	602	682	4	36	80	0.4500000
NODE_3912_length_1197_cov_27.653005	417	497	0	12	80	0.1500000
NODE_3912_length_1197_cov_27.653005	417	497	1	61	80	0.7625000
NODE_3912_length_1197_cov_27.653005	417	497	2	7	80	0.0875000
NODE_3912_length_1197_cov_27.653005	470	550	1	20	80	0.2500000
NODE_3912_length_1197_cov_27.653005	470	550	2	11	80	0.1375000
NODE_3912_length_1197_cov_27.653005	470	550	3	36	80	0.4500000
NODE_3912_length_1197_cov_27.653005	470	550	4	3	80	0.0375000
NODE_3912_length_1197_cov_27.653005	470	550	5	10	80	0.1250000
NODE_3912_length_1197_cov_27.653005	546	626	5	10	80	0.1250000
NODE_3912_length_1197_cov_27.653005	546	626	6	10	80	0.1250000
NODE_3912_length_1197_cov_27.653005	546	626	7	57	80	0.7125000
NODE_3912_length_1197_cov_27.653005	546	626	8	3	80	0.0375000
NODE_3912_length_1197_cov_27.653005	599	679	5	28	80	0.3500000
NODE_3912_length_1197_cov_27.653005	599	679	6	11	80	0.1375000
NODE_3912_length_1197_cov_27.653005	599	679	7	41	80	0.5125000
NODE_3913_length_1197_cov_14.653916	490	570	2	32	80	0.4000000
NODE_3913_length_1197_cov_14.653916	490	570	3	48	80	0.6000000
NODE_3913_length_1197_cov_14.653916	543	623	0	25	80	0.3125000
NODE_3913_length_1197_cov_14.653916	543	623	1	7	80	0.0875000
NODE_3913_length_1197_cov_14.653916	543	623	2	48	80	0.6000000
NODE_3921_length_1196_cov_26.169553	298	378	3	80	80	1.0000000
NODE_3921_length_1196_cov_26.169553	351	431	1	4	80	0.0500000
NODE_3921_length_1196_cov_26.169553	351	431	2	30	80	0.3750000
NODE_3921_length_1196_cov_26.169553	351	431	3	33	80	0.4125000
NODE_3921_length_1196_cov_26.169553	351	431	4	13	80	0.1625000
NODE_3921_length_1196_cov_26.169553	427	507	1	80	80	1.0000000
NODE_3921_length_1196_cov_26.169553	480	560	1	69	80	0.8625000
NODE_3921_length_1196_cov_26.169553	480	560	2	11	80	0.1375000
NODE_3922_length_1196_cov_21.755697	521	601	4	20	80	0.2500000
NODE_3922_length_1196_cov_21.755697	521	601	6	60	80	0.7500000
NODE_3922_length_1196_cov_21.755697	574	654	2	20	80	0.2500000
NODE_3922_length_1196_cov_21.755697	574	654	6	60	80	0.7500000
NODE_3922_length_1196_cov_21.755697	650	730	2	66	80	0.8250000
NODE_3922_length_1196_cov_21.755697	650	730	4	14	80	0.1750000
NODE_3922_length_1196_cov_21.755697	703	783	0	3	80	0.0375000
NODE_3922_length_1196_cov_21.755697	703	783	2	77	80	0.9625000
NODE_3923_length_1196_cov_5.966272	556	636	0	80	80	1.0000000
NODE_3923_length_1196_cov_5.966272	609	689	0	80	80	1.0000000
NODE_3927_length_1195_cov_69.056569	474	554	1	38	80	0.4750000
NODE_3927_length_1195_cov_69.056569	474	554	2	15	80	0.1875000
NODE_3927_length_1195_cov_69.056569	474	554	3	18	80	0.2250000
NODE_3927_length_1195_cov_69.056569	474	554	4	9	80	0.1125000
NODE_3927_length_1195_cov_69.056569	527	607	3	37	80	0.4625000
NODE_3927_length_1195_cov_69.056569	527	607	4	43	80	0.5375000
NODE_3927_length_1195_cov_69.056569	603	683	1	7	80	0.0875000
NODE_3927_length_1195_cov_69.056569	603	683	2	14	80	0.1750000
NODE_3927_length_1195_cov_69.056569	603	683	3	59	80	0.7375000
NODE_3927_length_1195_cov_69.056569	656	736	0	41	80	0.5125000
NODE_3927_length_1195_cov_69.056569	656	736	1	19	80	0.2375000
NODE_3927_length_1195_cov_69.056569	656	736	2	14	80	0.1750000
NODE_3927_length_1195_cov_69.056569	656	736	3	6	80	0.0750000
NODE_3928_length_1195_cov_65.062044	579	659	3	61	80	0.7625000
NODE_3928_length_1195_cov_65.062044	579	659	5	19	80	0.2375000
NODE_3928_length_1195_cov_65.062044	632	712	3	8	80	0.1000000
NODE_3928_length_1195_cov_65.062044	632	712	4	6	80	0.0750000
NODE_3928_length_1195_cov_65.062044	632	712	5	49	80	0.6125000
NODE_3928_length_1195_cov_65.062044	632	712	6	17	80	0.2125000
NODE_3928_length_1195_cov_65.062044	708	788	6	4	80	0.0500000
NODE_3928_length_1195_cov_65.062044	708	788	7	4	80	0.0500000
NODE_3928_length_1195_cov_65.062044	708	788	8	1	80	0.0125000
NODE_3928_length_1195_cov_65.062044	708	788	9	2	80	0.0250000
NODE_3928_length_1195_cov_65.062044	708	788	10	2	80	0.0250000
NODE_3928_length_1195_cov_65.062044	708	788	12	1	80	0.0125000
NODE_3928_length_1195_cov_65.062044	708	788	14	1	80	0.0125000
NODE_3928_length_1195_cov_65.062044	708	788	15	3	80	0.0375000
NODE_3928_length_1195_cov_65.062044	708	788	16	6	80	0.0750000
NODE_3928_length_1195_cov_65.062044	708	788	18	1	80	0.0125000
NODE_3928_length_1195_cov_65.062044	708	788	19	12	80	0.1500000
NODE_3928_length_1195_cov_65.062044	708	788	21	1	80	0.0125000
NODE_3928_length_1195_cov_65.062044	708	788	23	7	80	0.0875000
NODE_3928_length_1195_cov_65.062044	708	788	27	25	80	0.3125000
NODE_3928_length_1195_cov_65.062044	708	788	29	1	80	0.0125000
NODE_3928_length_1195_cov_65.062044	708	788	30	9	80	0.1125000
NODE_3928_length_1195_cov_65.062044	761	841	22	14	80	0.1750000
NODE_3928_length_1195_cov_65.062044	761	841	23	5	80	0.0625000
NODE_3928_length_1195_cov_65.062044	761	841	24	5	80	0.0625000
NODE_3928_length_1195_cov_65.062044	761	841	25	3	80	0.0375000
NODE_3928_length_1195_cov_65.062044	761	841	27	19	80	0.2375000
NODE_3928_length_1195_cov_65.062044	761	841	28	13	80	0.1625000
NODE_3928_length_1195_cov_65.062044	761	841	29	11	80	0.1375000
NODE_3928_length_1195_cov_65.062044	761	841	30	10	80	0.1250000
NODE_3929_length_1195_cov_23.187044	460	540	0	80	80	1.0000000
NODE_3929_length_1195_cov_23.187044	513	593	0	80	80	1.0000000
NODE_3930_length_1195_cov_18.983577	521	601	2	38	80	0.4750000
NODE_3930_length_1195_cov_18.983577	521	601	4	42	80	0.5250000
NODE_3930_length_1195_cov_18.983577	574	654	0	31	80	0.3875000
NODE_3930_length_1195_cov_18.983577	574	654	2	17	80	0.2125000
NODE_3930_length_1195_cov_18.983577	574	654	4	32	80	0.4000000
NODE_3931_length_1195_cov_14.119526	726	806	0	80	80	1.0000000
NODE_3931_length_1195_cov_14.119526	779	859	0	80	80	1.0000000
NODE_3931_length_1195_cov_14.119526	855	935	0	80	80	1.0000000
NODE_3931_length_1195_cov_14.119526	908	988	0	80	80	1.0000000
NODE_3932_length_1195_cov_13.805657	759	839	0	80	80	1.0000000
NODE_3932_length_1195_cov_13.805657	812	892	0	80	80	1.0000000
NODE_3938_length_1195_cov_1.969891	912	992	2	23	80	0.2875000
NODE_3938_length_1195_cov_1.969891	912	992	3	51	80	0.6375000
NODE_3938_length_1195_cov_1.969891	912	992	4	6	80	0.0750000
NODE_3938_length_1195_cov_1.969891	912	992	2	23	80	0.2875000
NODE_3938_length_1195_cov_1.969891	912	992	3	51	80	0.6375000
NODE_3938_length_1195_cov_1.969891	912	992	4	6	80	0.0750000
NODE_3941_length_1194_cov_40.157991	237	317	2	6	80	0.0750000
NODE_3941_length_1194_cov_40.157991	237	317	3	40	80	0.5000000
NODE_3941_length_1194_cov_40.157991	237	317	4	26	80	0.3250000
NODE_3941_length_1194_cov_40.157991	237	317	5	8	80	0.1000000
NODE_3941_length_1194_cov_40.157991	290	370	4	29	80	0.3625000
NODE_3941_length_1194_cov_40.157991	290	370	5	51	80	0.6375000
NODE_3946_length_1193_cov_34.295247	443	523	4	19	80	0.2375000
NODE_3946_length_1193_cov_34.295247	443	523	5	18	80	0.2250000
NODE_3946_length_1193_cov_34.295247	443	523	6	28	80	0.3500000
NODE_3946_length_1193_cov_34.295247	443	523	7	15	80	0.1875000
NODE_3946_length_1193_cov_34.295247	496	576	4	5	80	0.0625000
NODE_3946_length_1193_cov_34.295247	496	576	5	32	80	0.4000000
NODE_3946_length_1193_cov_34.295247	496	576	6	37	80	0.4625000
NODE_3946_length_1193_cov_34.295247	496	576	7	6	80	0.0750000
NODE_3947_length_1193_cov_16.930530	124	154	4	2	30	0.0666667
NODE_3947_length_1193_cov_16.930530	124	154	6	10	30	0.3333333
NODE_3947_length_1193_cov_16.930530	124	154	7	18	30	0.6000000
NODE_3947_length_1193_cov_16.930530	390	470	20	8	80	0.1000000
NODE_3947_length_1193_cov_16.930530	390	470	21	6	80	0.0750000
NODE_3947_length_1193_cov_16.930530	390	470	23	12	80	0.1500000
NODE_3947_length_1193_cov_16.930530	390	470	25	16	80	0.2000000
NODE_3947_length_1193_cov_16.930530	390	470	26	11	80	0.1375000
NODE_3947_length_1193_cov_16.930530	390	470	27	19	80	0.2375000
NODE_3947_length_1193_cov_16.930530	390	470	28	8	80	0.1000000
NODE_3947_length_1193_cov_16.930530	443	523	20	2	80	0.0250000
NODE_3947_length_1193_cov_16.930530	443	523	21	3	80	0.0375000
NODE_3947_length_1193_cov_16.930530	443	523	22	5	80	0.0625000
NODE_3947_length_1193_cov_16.930530	443	523	23	13	80	0.1625000
NODE_3947_length_1193_cov_16.930530	443	523	24	9	80	0.1125000
NODE_3947_length_1193_cov_16.930530	443	523	25	12	80	0.1500000
NODE_3947_length_1193_cov_16.930530	443	523	26	6	80	0.0750000
NODE_3947_length_1193_cov_16.930530	443	523	27	16	80	0.2000000
NODE_3947_length_1193_cov_16.930530	443	523	28	9	80	0.1125000
NODE_3947_length_1193_cov_16.930530	443	523	29	5	80	0.0625000
NODE_3949_length_1192_cov_26.803294	205	285	2	80	80	1.0000000
NODE_3949_length_1192_cov_26.803294	258	338	1	12	80	0.1500000
NODE_3949_length_1192_cov_26.803294	258	338	2	55	80	0.6875000
NODE_3949_length_1192_cov_26.803294	258	338	3	13	80	0.1625000
NODE_3949_length_1192_cov_26.803294	334	414	2	50	80	0.6250000
NODE_3949_length_1192_cov_26.803294	334	414	3	30	80	0.3750000
NODE_3949_length_1192_cov_26.803294	387	467	3	79	80	0.9875000
NODE_3949_length_1192_cov_26.803294	387	467	4	1	80	0.0125000
NODE_3950_length_1192_cov_23.228728	487	567	0	46	80	0.5750000
NODE_3950_length_1192_cov_23.228728	487	567	2	34	80	0.4250000
NODE_3950_length_1192_cov_23.228728	540	620	2	80	80	1.0000000
NODE_3950_length_1192_cov_23.228728	616	696	0	14	80	0.1750000
NODE_3950_length_1192_cov_23.228728	616	696	1	12	80	0.1500000
NODE_3950_length_1192_cov_23.228728	616	696	2	54	80	0.6750000
NODE_3950_length_1192_cov_23.228728	669	749	0	14	80	0.1750000
NODE_3950_length_1192_cov_23.228728	669	749	1	21	80	0.2625000
NODE_3950_length_1192_cov_23.228728	669	749	2	45	80	0.5625000
NODE_3951_length_1192_cov_18.314730	613	693	0	63	80	0.7875000
NODE_3951_length_1192_cov_18.314730	613	693	1	17	80	0.2125000
NODE_3951_length_1192_cov_18.314730	666	746	0	10	80	0.1250000
NODE_3951_length_1192_cov_18.314730	666	746	1	70	80	0.8750000
NODE_3951_length_1192_cov_18.314730	742	822	1	16	80	0.2000000
NODE_3951_length_1192_cov_18.314730	742	822	3	64	80	0.8000000
NODE_3951_length_1192_cov_18.314730	795	875	0	22	80	0.2750000
NODE_3951_length_1192_cov_18.314730	795	875	2	27	80	0.3375000
NODE_3951_length_1192_cov_18.314730	795	875	3	31	80	0.3875000
NODE_3952_length_1192_cov_14.888381	622	702	2	5	80	0.0625000
NODE_3952_length_1192_cov_14.888381	622	702	3	17	80	0.2125000
NODE_3952_length_1192_cov_14.888381	622	702	4	39	80	0.4875000
NODE_3952_length_1192_cov_14.888381	622	702	5	19	80	0.2375000
NODE_3952_length_1192_cov_14.888381	675	755	4	29	80	0.3625000
NODE_3952_length_1192_cov_14.888381	675	755	5	51	80	0.6375000
NODE_3952_length_1192_cov_14.888381	751	831	1	58	80	0.7250000
NODE_3952_length_1192_cov_14.888381	751	831	3	18	80	0.2250000
NODE_3952_length_1192_cov_14.888381	751	831	4	4	80	0.0500000
NODE_3952_length_1192_cov_14.888381	804	884	0	51	80	0.6375000
NODE_3952_length_1192_cov_14.888381	804	884	1	29	80	0.3625000
NODE_3953_length_1192_cov_9.995425	161	241	6	11	80	0.1375000
NODE_3953_length_1192_cov_9.995425	161	241	8	32	80	0.4000000
NODE_3953_length_1192_cov_9.995425	161	241	9	13	80	0.1625000
NODE_3953_length_1192_cov_9.995425	161	241	10	19	80	0.2375000
NODE_3953_length_1192_cov_9.995425	161	241	12	5	80	0.0625000
NODE_3953_length_1192_cov_9.995425	214	294	4	47	80	0.5875000
NODE_3953_length_1192_cov_9.995425	214	294	6	17	80	0.2125000
NODE_3953_length_1192_cov_9.995425	214	294	9	13	80	0.1625000
NODE_3953_length_1192_cov_9.995425	214	294	10	3	80	0.0375000
NODE_3954_length_1192_cov_5.078683	749	829	1	12	80	0.1500000
NODE_3954_length_1192_cov_5.078683	749	829	2	8	80	0.1000000
NODE_3954_length_1192_cov_5.078683	749	829	3	57	80	0.7125000
NODE_3954_length_1192_cov_5.078683	749	829	4	3	80	0.0375000
NODE_3954_length_1192_cov_5.078683	802	882	1	12	80	0.1500000
NODE_3954_length_1192_cov_5.078683	802	882	2	61	80	0.7625000
NODE_3954_length_1192_cov_5.078683	802	882	3	4	80	0.0500000
NODE_3954_length_1192_cov_5.078683	802	882	4	3	80	0.0375000
NODE_3960_length_1192_cov_0.614822	1046	1126	0	80	80	1.0000000
NODE_3961_length_1191_cov_55.466117	392	472	0	56	80	0.7000000
NODE_3961_length_1191_cov_55.466117	392	472	1	2	80	0.0250000
NODE_3961_length_1191_cov_55.466117	392	472	2	22	80	0.2750000
NODE_3961_length_1191_cov_55.466117	445	525	0	3	80	0.0375000
NODE_3961_length_1191_cov_55.466117	445	525	1	2	80	0.0250000
NODE_3961_length_1191_cov_55.466117	445	525	2	75	80	0.9375000
NODE_3961_length_1191_cov_55.466117	521	601	2	16	80	0.2000000
NODE_3961_length_1191_cov_55.466117	521	601	3	1	80	0.0125000
NODE_3961_length_1191_cov_55.466117	521	601	4	15	80	0.1875000
NODE_3961_length_1191_cov_55.466117	521	601	5	7	80	0.0875000
NODE_3961_length_1191_cov_55.466117	521	601	6	13	80	0.1625000
NODE_3961_length_1191_cov_55.466117	521	601	8	28	80	0.3500000
NODE_3961_length_1191_cov_55.466117	574	654	6	19	80	0.2375000
NODE_3961_length_1191_cov_55.466117	574	654	7	37	80	0.4625000
NODE_3961_length_1191_cov_55.466117	574	654	8	24	80	0.3000000
NODE_3963_length_1191_cov_20.677656	695	775	1	21	80	0.2625000
NODE_3963_length_1191_cov_20.677656	695	775	2	59	80	0.7375000
NODE_3963_length_1191_cov_20.677656	748	828	1	20	80	0.2500000
NODE_3963_length_1191_cov_20.677656	748	828	2	60	80	0.7500000
NODE_3964_length_1191_cov_9.074176	420	500	0	80	80	1.0000000
NODE_3964_length_1191_cov_9.074176	473	553	0	80	80	1.0000000
NODE_3968_length_1190_cov_40.916590	521	601	3	7	80	0.0875000
NODE_3968_length_1190_cov_40.916590	521	601	4	39	80	0.4875000
NODE_3968_length_1190_cov_40.916590	521	601	5	34	80	0.4250000
NODE_3968_length_1190_cov_40.916590	574	654	4	56	80	0.7000000
NODE_3968_length_1190_cov_40.916590	574	654	5	10	80	0.1250000
NODE_3968_length_1190_cov_40.916590	574	654	6	14	80	0.1750000
NODE_3968_length_1190_cov_40.916590	650	730	3	64	80	0.8000000
NODE_3968_length_1190_cov_40.916590	650	730	4	16	80	0.2000000
NODE_3968_length_1190_cov_40.916590	703	783	0	10	80	0.1250000
NODE_3968_length_1190_cov_40.916590	703	783	2	17	80	0.2125000
NODE_3968_length_1190_cov_40.916590	703	783	3	53	80	0.6625000
NODE_3969_length_1190_cov_20.715857	257	337	2	12	80	0.1500000
NODE_3969_length_1190_cov_20.715857	257	337	3	68	80	0.8500000
NODE_3969_length_1190_cov_20.715857	310	390	2	35	80	0.4375000
NODE_3969_length_1190_cov_20.715857	310	390	3	38	80	0.4750000
NODE_3969_length_1190_cov_20.715857	310	390	4	7	80	0.0875000
NODE_3970_length_1190_cov_19.724106	296	376	0	75	80	0.9375000
NODE_3970_length_1190_cov_19.724106	296	376	2	5	80	0.0625000
NODE_3970_length_1190_cov_19.724106	349	429	0	22	80	0.2750000
NODE_3970_length_1190_cov_19.724106	349	429	2	26	80	0.3250000
NODE_3970_length_1190_cov_19.724106	349	429	3	32	80	0.4000000
NODE_3973_length_1190_cov_2.698442	1022	1070	3	48	48	1.0000000
NODE_3973_length_1190_cov_2.698442	1075	1123	3	48	48	1.0000000
NODE_3977_length_1189_cov_29.193578	576	656	2	29	80	0.3625000
NODE_3977_length_1189_cov_29.193578	576	656	3	12	80	0.1500000
NODE_3977_length_1189_cov_29.193578	576	656	4	1	80	0.0125000
NODE_3977_length_1189_cov_29.193578	576	656	6	9	80	0.1125000
NODE_3977_length_1189_cov_29.193578	576	656	7	29	80	0.3625000
NODE_3977_length_1189_cov_29.193578	629	709	5	30	80	0.3750000
NODE_3977_length_1189_cov_29.193578	629	709	6	2	80	0.0250000
NODE_3977_length_1189_cov_29.193578	629	709	7	48	80	0.6000000
NODE_3978_length_1189_cov_13.484404	315	341	0	26	26	1.0000000
NODE_3978_length_1189_cov_13.484404	366	446	1	80	80	1.0000000
NODE_3984_length_1188_cov_19.278237	396	476	2	80	80	1.0000000
NODE_3984_length_1188_cov_19.278237	449	529	0	10	80	0.1250000
NODE_3984_length_1188_cov_19.278237	449	529	1	30	80	0.3750000
NODE_3984_length_1188_cov_19.278237	449	529	2	40	80	0.5000000
NODE_3990_length_1187_cov_63.185662	529	609	1	42	80	0.5250000
NODE_3990_length_1187_cov_63.185662	529	609	2	3	80	0.0375000
NODE_3990_length_1187_cov_63.185662	529	609	3	6	80	0.0750000
NODE_3990_length_1187_cov_63.185662	529	609	4	29	80	0.3625000
NODE_3990_length_1187_cov_63.185662	582	662	4	29	80	0.3625000
NODE_3990_length_1187_cov_63.185662	582	662	6	26	80	0.3250000
NODE_3990_length_1187_cov_63.185662	582	662	7	15	80	0.1875000
NODE_3990_length_1187_cov_63.185662	582	662	8	10	80	0.1250000
NODE_3990_length_1187_cov_63.185662	658	738	8	10	80	0.1250000
NODE_3990_length_1187_cov_63.185662	658	738	9	9	80	0.1125000
NODE_3990_length_1187_cov_63.185662	658	738	10	8	80	0.1000000
NODE_3990_length_1187_cov_63.185662	658	738	11	53	80	0.6625000
NODE_3990_length_1187_cov_63.185662	711	791	8	5	80	0.0625000
NODE_3990_length_1187_cov_63.185662	711	791	9	18	80	0.2250000
NODE_3990_length_1187_cov_63.185662	711	791	10	7	80	0.0875000
NODE_3990_length_1187_cov_63.185662	711	791	11	50	80	0.6250000
NODE_3991_length_1187_cov_36.926471	432	512	6	39	80	0.4875000
NODE_3991_length_1187_cov_36.926471	432	512	7	41	80	0.5125000
NODE_3991_length_1187_cov_36.926471	485	565	2	8	80	0.1000000
NODE_3991_length_1187_cov_36.926471	485	565	4	20	80	0.2500000
NODE_3991_length_1187_cov_36.926471	485	565	5	12	80	0.1500000
NODE_3991_length_1187_cov_36.926471	485	565	6	4	80	0.0500000
NODE_3991_length_1187_cov_36.926471	485	565	7	36	80	0.4500000
NODE_3991_length_1187_cov_36.926471	561	641	2	44	80	0.5500000
NODE_3991_length_1187_cov_36.926471	561	641	3	24	80	0.3000000
NODE_3991_length_1187_cov_36.926471	561	641	4	12	80	0.1500000
NODE_3991_length_1187_cov_36.926471	614	694	2	7	80	0.0875000
NODE_3991_length_1187_cov_36.926471	614	694	3	8	80	0.1000000
NODE_3991_length_1187_cov_36.926471	614	694	4	65	80	0.8125000
NODE_3992_length_1187_cov_20.383272	492	572	3	8	80	0.1000000
NODE_3992_length_1187_cov_20.383272	492	572	4	72	80	0.9000000
NODE_3992_length_1187_cov_20.383272	545	625	1	13	80	0.1625000
NODE_3992_length_1187_cov_20.383272	545	625	2	12	80	0.1500000
NODE_3992_length_1187_cov_20.383272	545	625	3	19	80	0.2375000
NODE_3992_length_1187_cov_20.383272	545	625	4	36	80	0.4500000
NODE_3993_length_1187_cov_17.941176	377	457	0	80	80	1.0000000
NODE_3993_length_1187_cov_17.941176	430	510	0	80	80	1.0000000
NODE_3993_length_1187_cov_17.941176	506	586	0	80	80	1.0000000
NODE_3993_length_1187_cov_17.941176	559	639	0	80	80	1.0000000
NODE_3997_length_1186_cov_59.606256	338	418	2	19	80	0.2375000
NODE_3997_length_1186_cov_59.606256	338	418	3	61	80	0.7625000
NODE_3997_length_1186_cov_59.606256	391	471	2	50	80	0.6250000
NODE_3997_length_1186_cov_59.606256	391	471	3	30	80	0.3750000
NODE_3997_length_1186_cov_59.606256	480	551	1	19	71	0.2676056
NODE_3997_length_1186_cov_59.606256	480	551	2	9	71	0.1267606
NODE_3997_length_1186_cov_59.606256	480	551	3	43	71	0.6056338
NODE_3997_length_1186_cov_59.606256	524	604	3	29	80	0.3625000
NODE_3997_length_1186_cov_59.606256	524	604	5	51	80	0.6375000
NODE_3998_length_1186_cov_34.937443	582	662	3	14	80	0.1750000
NODE_3998_length_1186_cov_34.937443	582	662	4	2	80	0.0250000
NODE_3998_length_1186_cov_34.937443	582	662	5	40	80	0.5000000
NODE_3998_length_1186_cov_34.937443	582	662	6	23	80	0.2875000
NODE_3998_length_1186_cov_34.937443	582	662	7	1	80	0.0125000
NODE_3998_length_1186_cov_34.937443	635	715	4	7	80	0.0875000
NODE_3998_length_1186_cov_34.937443	635	715	5	31	80	0.3875000
NODE_3998_length_1186_cov_34.937443	635	715	6	23	80	0.2875000
NODE_3998_length_1186_cov_34.937443	635	715	7	19	80	0.2375000
NODE_3998_length_1186_cov_34.937443	711	791	1	3	80	0.0375000
NODE_3998_length_1186_cov_34.937443	711	791	2	42	80	0.5250000
NODE_3998_length_1186_cov_34.937443	711	791	3	18	80	0.2250000
NODE_3998_length_1186_cov_34.937443	711	791	4	17	80	0.2125000
NODE_3998_length_1186_cov_34.937443	764	844	0	33	80	0.4125000
NODE_3998_length_1186_cov_34.937443	764	844	1	23	80	0.2875000
NODE_3998_length_1186_cov_34.937443	764	844	2	24	80	0.3000000
NODE_3999_length_1186_cov_29.840846	511	591	2	80	80	1.0000000
NODE_3999_length_1186_cov_29.840846	564	644	0	49	80	0.6125000
NODE_3999_length_1186_cov_29.840846	564	644	2	31	80	0.3875000
NODE_3999_length_1186_cov_29.840846	640	720	0	10	80	0.1250000
NODE_3999_length_1186_cov_29.840846	640	720	1	70	80	0.8750000
NODE_3999_length_1186_cov_29.840846	693	773	1	33	80	0.4125000
NODE_3999_length_1186_cov_29.840846	693	773	2	47	80	0.5875000
NODE_4000_length_1186_cov_13.108556	578	658	0	80	80	1.0000000
NODE_4000_length_1186_cov_13.108556	631	711	0	80	80	1.0000000
NODE_4001_length_1186_cov_12.867525	404	484	0	79	80	0.9875000
NODE_4001_length_1186_cov_12.867525	404	484	1	1	80	0.0125000
NODE_4001_length_1186_cov_12.867525	457	534	0	26	77	0.3376623
NODE_4001_length_1186_cov_12.867525	457	534	1	1	77	0.0129870
NODE_4001_length_1186_cov_12.867525	457	534	2	50	77	0.6493506
NODE_4001_length_1186_cov_12.867525	536	613	2	47	77	0.6103896
NODE_4001_length_1186_cov_12.867525	536	613	4	30	77	0.3896104
NODE_4001_length_1186_cov_12.867525	586	666	2	33	80	0.4125000
NODE_4001_length_1186_cov_12.867525	586	666	4	47	80	0.5875000
NODE_4002_length_1186_cov_12.135235	643	723	1	79	80	0.9875000
NODE_4002_length_1186_cov_12.135235	643	723	2	1	80	0.0125000
NODE_4002_length_1186_cov_12.135235	696	776	1	26	80	0.3250000
NODE_4002_length_1186_cov_12.135235	696	776	2	6	80	0.0750000
NODE_4002_length_1186_cov_12.135235	696	776	3	48	80	0.6000000
NODE_4012_length_1185_cov_36.974217	423	503	2	4	80	0.0500000
NODE_4012_length_1185_cov_36.974217	423	503	3	8	80	0.1000000
NODE_4012_length_1185_cov_36.974217	423	503	4	68	80	0.8500000
NODE_4012_length_1185_cov_36.974217	476	556	1	2	80	0.0250000
NODE_4012_length_1185_cov_36.974217	476	556	2	55	80	0.6875000
NODE_4012_length_1185_cov_36.974217	476	556	4	23	80	0.2875000
NODE_4013_length_1185_cov_28.410681	448	528	1	14	80	0.1750000
NODE_4013_length_1185_cov_28.410681	448	528	3	32	80	0.4000000
NODE_4013_length_1185_cov_28.410681	448	528	4	34	80	0.4250000
NODE_4013_length_1185_cov_28.410681	501	581	1	1	80	0.0125000
NODE_4013_length_1185_cov_28.410681	501	581	3	21	80	0.2625000
NODE_4013_length_1185_cov_28.410681	501	581	4	58	80	0.7250000
NODE_4014_length_1185_cov_19.768877	411	491	0	80	80	1.0000000
NODE_4014_length_1185_cov_19.768877	464	544	0	58	80	0.7250000
NODE_4014_length_1185_cov_19.768877	464	544	1	22	80	0.2750000
NODE_4014_length_1185_cov_19.768877	540	620	1	48	80	0.6000000
NODE_4014_length_1185_cov_19.768877	540	620	2	32	80	0.4000000
NODE_4014_length_1185_cov_19.768877	593	673	1	2	80	0.0250000
NODE_4014_length_1185_cov_19.768877	593	673	2	78	80	0.9750000
NODE_4015_length_1185_cov_14.490792	379	459	0	7	80	0.0875000
NODE_4015_length_1185_cov_14.490792	379	459	1	73	80	0.9125000
NODE_4015_length_1185_cov_14.490792	432	512	0	7	80	0.0875000
NODE_4015_length_1185_cov_14.490792	432	512	1	73	80	0.9125000
NODE_4016_length_1185_cov_13.686004	677	757	3	80	80	1.0000000
NODE_4016_length_1185_cov_13.686004	730	810	1	15	80	0.1875000
NODE_4016_length_1185_cov_13.686004	730	810	2	1	80	0.0125000
NODE_4016_length_1185_cov_13.686004	730	810	3	27	80	0.3375000
NODE_4016_length_1185_cov_13.686004	730	810	4	37	80	0.4625000
NODE_4017_length_1185_cov_12.362799	711	791	5	11	80	0.1375000
NODE_4017_length_1185_cov_12.362799	711	791	6	69	80	0.8625000
NODE_4017_length_1185_cov_12.362799	764	844	1	9	80	0.1125000
NODE_4017_length_1185_cov_12.362799	764	844	3	8	80	0.1000000
NODE_4017_length_1185_cov_12.362799	764	844	4	6	80	0.0750000
NODE_4017_length_1185_cov_12.362799	764	844	5	12	80	0.1500000
NODE_4017_length_1185_cov_12.362799	764	844	6	45	80	0.5625000
NODE_4024_length_1184_cov_30.061751	416	497	2	31	81	0.3827161
NODE_4024_length_1184_cov_30.061751	416	497	4	32	81	0.3950617
NODE_4024_length_1184_cov_30.061751	416	497	5	18	81	0.2222222
NODE_4024_length_1184_cov_30.061751	470	550	4	9	80	0.1125000
NODE_4024_length_1184_cov_30.061751	470	550	5	61	80	0.7625000
NODE_4024_length_1184_cov_30.061751	470	550	6	10	80	0.1250000
NODE_4024_length_1184_cov_30.061751	546	627	3	4	81	0.0493827
NODE_4024_length_1184_cov_30.061751	546	627	4	9	81	0.1111111
NODE_4024_length_1184_cov_30.061751	546	627	5	49	81	0.6049383
NODE_4024_length_1184_cov_30.061751	546	627	6	16	81	0.1975309
NODE_4024_length_1184_cov_30.061751	546	627	7	3	81	0.0370370
NODE_4024_length_1184_cov_30.061751	600	680	3	1	80	0.0125000
NODE_4024_length_1184_cov_30.061751	600	680	4	9	80	0.1125000
NODE_4024_length_1184_cov_30.061751	600	680	5	68	80	0.8500000
NODE_4024_length_1184_cov_30.061751	600	680	6	2	80	0.0250000
NODE_4025_length_1184_cov_19.544700	550	630	0	80	80	1.0000000
NODE_4025_length_1184_cov_19.544700	603	683	0	74	80	0.9250000
NODE_4025_length_1184_cov_19.544700	603	683	2	6	80	0.0750000
NODE_4025_length_1184_cov_19.544700	679	759	2	80	80	1.0000000
NODE_4025_length_1184_cov_19.544700	732	812	2	80	80	1.0000000
NODE_4026_length_1184_cov_9.129954	624	704	0	80	80	1.0000000
NODE_4026_length_1184_cov_9.129954	677	757	0	80	80	1.0000000
NODE_4031_length_1183_cov_17.260148	545	625	0	80	80	1.0000000
NODE_4031_length_1183_cov_17.260148	598	678	0	80	80	1.0000000
NODE_4031_length_1183_cov_17.260148	674	754	0	80	80	1.0000000
NODE_4031_length_1183_cov_17.260148	727	807	0	80	80	1.0000000
NODE_4032_length_1183_cov_9.777675	484	564	1	10	80	0.1250000
NODE_4032_length_1183_cov_9.777675	484	564	2	70	80	0.8750000
NODE_4032_length_1183_cov_9.777675	537	617	1	58	80	0.7250000
NODE_4032_length_1183_cov_9.777675	537	617	2	22	80	0.2750000
NODE_4033_length_1183_cov_6.847786	711	791	2	52	80	0.6500000
NODE_4033_length_1183_cov_6.847786	711	791	4	28	80	0.3500000
NODE_4033_length_1183_cov_6.847786	764	844	2	38	80	0.4750000
NODE_4033_length_1183_cov_6.847786	764	844	3	9	80	0.1125000
NODE_4033_length_1183_cov_6.847786	764	844	4	33	80	0.4125000
NODE_4033_length_1183_cov_6.847786	840	920	2	25	80	0.3125000
NODE_4033_length_1183_cov_6.847786	840	920	4	55	80	0.6875000
NODE_4033_length_1183_cov_6.847786	893	973	1	1	80	0.0125000
NODE_4033_length_1183_cov_6.847786	893	973	2	77	80	0.9625000
NODE_4033_length_1183_cov_6.847786	893	973	4	2	80	0.0250000
NODE_4035_length_1183_cov_2.680812	59	139	2	3	80	0.0375000
NODE_4035_length_1183_cov_2.680812	59	139	4	77	80	0.9625000
NODE_4040_length_1182_cov_64.600185	588	668	6	3	80	0.0375000
NODE_4040_length_1182_cov_64.600185	588	668	7	5	80	0.0625000
NODE_4040_length_1182_cov_64.600185	588	668	8	29	80	0.3625000
NODE_4040_length_1182_cov_64.600185	588	668	9	11	80	0.1375000
NODE_4040_length_1182_cov_64.600185	588	668	10	20	80	0.2500000
NODE_4040_length_1182_cov_64.600185	588	668	11	12	80	0.1500000
NODE_4040_length_1182_cov_64.600185	641	721	10	29	80	0.3625000
NODE_4040_length_1182_cov_64.600185	641	721	11	26	80	0.3250000
NODE_4040_length_1182_cov_64.600185	641	721	12	17	80	0.2125000
NODE_4040_length_1182_cov_64.600185	641	721	13	8	80	0.1000000
NODE_4040_length_1182_cov_64.600185	717	797	7	11	80	0.1375000
NODE_4040_length_1182_cov_64.600185	717	797	8	40	80	0.5000000
NODE_4040_length_1182_cov_64.600185	717	797	9	21	80	0.2625000
NODE_4040_length_1182_cov_64.600185	717	797	10	8	80	0.1000000
NODE_4040_length_1182_cov_64.600185	770	849	6	9	79	0.1139240
NODE_4040_length_1182_cov_64.600185	770	849	7	34	79	0.4303797
NODE_4040_length_1182_cov_64.600185	770	849	8	32	79	0.4050633
NODE_4040_length_1182_cov_64.600185	770	849	9	1	79	0.0126582
NODE_4040_length_1182_cov_64.600185	770	849	10	3	79	0.0379747
NODE_4041_length_1182_cov_18.584488	487	557	0	70	70	1.0000000
NODE_4041_length_1182_cov_18.584488	536	612	0	76	76	1.0000000
NODE_4041_length_1182_cov_18.584488	608	688	0	13	80	0.1625000
NODE_4041_length_1182_cov_18.584488	608	688	1	26	80	0.3250000
NODE_4041_length_1182_cov_18.584488	608	688	3	40	80	0.5000000
NODE_4041_length_1182_cov_18.584488	608	688	5	1	80	0.0125000
NODE_4041_length_1182_cov_18.584488	671	741	3	16	70	0.2285714
NODE_4041_length_1182_cov_18.584488	671	741	5	54	70	0.7714286
NODE_4042_length_1182_cov_18.075716	598	678	1	46	80	0.5750000
NODE_4042_length_1182_cov_18.075716	598	678	2	18	80	0.2250000
NODE_4042_length_1182_cov_18.075716	598	678	3	16	80	0.2000000
NODE_4042_length_1182_cov_18.075716	651	731	0	1	80	0.0125000
NODE_4042_length_1182_cov_18.075716	651	731	2	70	80	0.8750000
NODE_4042_length_1182_cov_18.075716	651	731	3	9	80	0.1125000
NODE_4042_length_1182_cov_18.075716	727	807	0	10	80	0.1250000
NODE_4042_length_1182_cov_18.075716	727	807	1	15	80	0.1875000
NODE_4042_length_1182_cov_18.075716	727	807	2	55	80	0.6875000
NODE_4042_length_1182_cov_18.075716	780	860	0	13	80	0.1625000
NODE_4042_length_1182_cov_18.075716	780	860	2	67	80	0.8375000
NODE_4043_length_1182_cov_8.716528	464	544	0	80	80	1.0000000
NODE_4043_length_1182_cov_8.716528	517	597	0	80	80	1.0000000
NODE_4044_length_1182_cov_4.109880	793	873	0	80	80	1.0000000
NODE_4044_length_1182_cov_4.109880	846	926	0	80	80	1.0000000
NODE_4045_length_1182_cov_3.433980	1052	1100	4	25	48	0.5208333
NODE_4045_length_1182_cov_3.433980	1052	1100	5	23	48	0.4791667
NODE_4050_length_1181_cov_13.856747	687	767	0	78	80	0.9750000
NODE_4050_length_1181_cov_13.856747	687	767	2	2	80	0.0250000
NODE_4050_length_1181_cov_13.856747	740	820	0	25	80	0.3125000
NODE_4050_length_1181_cov_13.856747	740	820	2	55	80	0.6875000
NODE_4051_length_1181_cov_8.239372	735	815	0	80	80	1.0000000
NODE_4059_length_1180_cov_46.345051	695	775	0	21	80	0.2625000
NODE_4059_length_1180_cov_46.345051	695	775	2	20	80	0.2500000
NODE_4059_length_1180_cov_46.345051	695	775	4	39	80	0.4875000
NODE_4059_length_1180_cov_46.345051	748	828	0	74	80	0.9250000
NODE_4059_length_1180_cov_46.345051	748	828	2	6	80	0.0750000
NODE_4066_length_1179_cov_93.272222	660	740	76	5	80	0.0625000
NODE_4066_length_1179_cov_93.272222	660	740	77	5	80	0.0625000
NODE_4066_length_1179_cov_93.272222	660	740	78	9	80	0.1125000
NODE_4066_length_1179_cov_93.272222	660	740	79	8	80	0.1000000
NODE_4066_length_1179_cov_93.272222	660	740	80	6	80	0.0750000
NODE_4066_length_1179_cov_93.272222	660	740	81	4	80	0.0500000
NODE_4066_length_1179_cov_93.272222	660	740	82	9	80	0.1125000
NODE_4066_length_1179_cov_93.272222	660	740	83	5	80	0.0625000
NODE_4066_length_1179_cov_93.272222	660	740	84	7	80	0.0875000
NODE_4066_length_1179_cov_93.272222	660	740	85	14	80	0.1750000
NODE_4066_length_1179_cov_93.272222	660	740	86	4	80	0.0500000
NODE_4066_length_1179_cov_93.272222	660	740	87	4	80	0.0500000
NODE_4066_length_1179_cov_93.272222	713	793	64	7	80	0.0875000
NODE_4066_length_1179_cov_93.272222	713	793	65	2	80	0.0250000
NODE_4066_length_1179_cov_93.272222	713	793	66	3	80	0.0375000
NODE_4066_length_1179_cov_93.272222	713	793	67	5	80	0.0625000
NODE_4066_length_1179_cov_93.272222	713	793	68	3	80	0.0375000
NODE_4066_length_1179_cov_93.272222	713	793	69	1	80	0.0125000
NODE_4066_length_1179_cov_93.272222	713	793	70	2	80	0.0250000
NODE_4066_length_1179_cov_93.272222	713	793	71	1	80	0.0125000
NODE_4066_length_1179_cov_93.272222	713	793	72	2	80	0.0250000
NODE_4066_length_1179_cov_93.272222	713	793	73	5	80	0.0625000
NODE_4066_length_1179_cov_93.272222	713	793	74	10	80	0.1250000
NODE_4066_length_1179_cov_93.272222	713	793	75	12	80	0.1500000
NODE_4066_length_1179_cov_93.272222	713	793	76	5	80	0.0625000
NODE_4066_length_1179_cov_93.272222	713	793	77	3	80	0.0375000
NODE_4066_length_1179_cov_93.272222	713	793	78	9	80	0.1125000
NODE_4066_length_1179_cov_93.272222	713	793	79	8	80	0.1000000
NODE_4066_length_1179_cov_93.272222	713	793	80	2	80	0.0250000
NODE_4067_length_1179_cov_55.355556	547	627	3	27	80	0.3375000
NODE_4067_length_1179_cov_55.355556	547	627	4	21	80	0.2625000
NODE_4067_length_1179_cov_55.355556	547	627	6	32	80	0.4000000
NODE_4067_length_1179_cov_55.355556	600	680	1	9	80	0.1125000
NODE_4067_length_1179_cov_55.355556	600	680	2	5	80	0.0625000
NODE_4067_length_1179_cov_55.355556	600	680	3	45	80	0.5625000
NODE_4067_length_1179_cov_55.355556	600	680	4	21	80	0.2625000
NODE_4068_length_1179_cov_29.712037	613	693	0	10	80	0.1250000
NODE_4068_length_1179_cov_29.712037	613	693	2	70	80	0.8750000
NODE_4068_length_1179_cov_29.712037	666	746	2	80	80	1.0000000
NODE_4069_length_1179_cov_26.767593	483	563	1	52	80	0.6500000
NODE_4069_length_1179_cov_26.767593	483	563	2	28	80	0.3500000
NODE_4069_length_1179_cov_26.767593	536	616	2	79	80	0.9875000
NODE_4069_length_1179_cov_26.767593	536	616	3	1	80	0.0125000
NODE_4069_length_1179_cov_26.767593	612	692	1	3	80	0.0375000
NODE_4069_length_1179_cov_26.767593	612	692	2	77	80	0.9625000
NODE_4069_length_1179_cov_26.767593	665	745	0	9	80	0.1125000
NODE_4069_length_1179_cov_26.767593	665	745	1	47	80	0.5875000
NODE_4069_length_1179_cov_26.767593	665	745	2	24	80	0.3000000
NODE_4070_length_1179_cov_22.249074	581	661	0	80	80	1.0000000
NODE_4070_length_1179_cov_22.249074	634	714	0	80	80	1.0000000
NODE_4071_length_1179_cov_16.538889	498	568	2	7	70	0.1000000
NODE_4071_length_1179_cov_16.538889	498	568	3	63	70	0.9000000
NODE_4072_length_1179_cov_15.442593	535	615	3	4	80	0.0500000
NODE_4072_length_1179_cov_15.442593	535	615	4	41	80	0.5125000
NODE_4072_length_1179_cov_15.442593	535	615	5	35	80	0.4375000
NODE_4072_length_1179_cov_15.442593	588	668	2	4	80	0.0500000
NODE_4072_length_1179_cov_15.442593	588	668	3	40	80	0.5000000
NODE_4072_length_1179_cov_15.442593	588	668	5	36	80	0.4500000
NODE_4076_length_1179_cov_2.419444	1108	1155	0	47	47	1.0000000
NODE_4078_length_1179_cov_1.009259	944	1024	2	19	80	0.2375000
NODE_4078_length_1179_cov_1.009259	944	1024	3	17	80	0.2125000
NODE_4078_length_1179_cov_1.009259	944	1024	5	41	80	0.5125000
NODE_4078_length_1179_cov_1.009259	944	1024	7	3	80	0.0375000
NODE_4078_length_1179_cov_1.009259	997	1077	5	24	80	0.3000000
NODE_4078_length_1179_cov_1.009259	997	1077	7	56	80	0.7000000
NODE_4079_length_1178_cov_42.484708	423	503	0	22	80	0.2750000
NODE_4079_length_1178_cov_42.484708	423	503	2	3	80	0.0375000
NODE_4079_length_1178_cov_42.484708	423	503	4	15	80	0.1875000
NODE_4079_length_1178_cov_42.484708	423	503	5	8	80	0.1000000
NODE_4079_length_1178_cov_42.484708	423	503	7	11	80	0.1375000
NODE_4079_length_1178_cov_42.484708	423	503	8	21	80	0.2625000
NODE_4079_length_1178_cov_42.484708	476	556	7	6	80	0.0750000
NODE_4079_length_1178_cov_42.484708	476	556	8	65	80	0.8125000
NODE_4079_length_1178_cov_42.484708	476	556	9	9	80	0.1125000
NODE_4079_length_1178_cov_42.484708	552	632	6	18	80	0.2250000
NODE_4079_length_1178_cov_42.484708	552	632	7	25	80	0.3125000
NODE_4079_length_1178_cov_42.484708	552	632	8	3	80	0.0375000
NODE_4079_length_1178_cov_42.484708	552	632	9	34	80	0.4250000
NODE_4079_length_1178_cov_42.484708	605	685	4	12	80	0.1500000
NODE_4079_length_1178_cov_42.484708	605	685	5	16	80	0.2000000
NODE_4079_length_1178_cov_42.484708	605	685	6	43	80	0.5375000
NODE_4079_length_1178_cov_42.484708	605	685	7	8	80	0.1000000
NODE_4079_length_1178_cov_42.484708	605	685	8	1	80	0.0125000
NODE_4080_length_1178_cov_15.332715	215	295	2	80	80	1.0000000
NODE_4080_length_1178_cov_15.332715	268	348	2	80	80	1.0000000
NODE_4081_length_1178_cov_11.403151	527	607	2	9	80	0.1125000
NODE_4081_length_1178_cov_11.403151	527	607	3	6	80	0.0750000
NODE_4081_length_1178_cov_11.403151	527	607	4	65	80	0.8125000
NODE_4081_length_1178_cov_11.403151	580	660	4	56	80	0.7000000
NODE_4081_length_1178_cov_11.403151	580	660	5	24	80	0.3000000
NODE_4084_length_1177_cov_34.920223	369	449	3	19	80	0.2375000
NODE_4084_length_1177_cov_34.920223	369	449	5	6	80	0.0750000
NODE_4084_length_1177_cov_34.920223	369	449	6	55	80	0.6875000
NODE_4084_length_1177_cov_34.920223	422	502	5	1	80	0.0125000
NODE_4084_length_1177_cov_34.920223	422	502	6	79	80	0.9875000
NODE_4084_length_1177_cov_34.920223	498	578	0	10	80	0.1250000
NODE_4084_length_1177_cov_34.920223	498	578	1	37	80	0.4625000
NODE_4084_length_1177_cov_34.920223	498	578	2	2	80	0.0250000
NODE_4084_length_1177_cov_34.920223	498	578	3	14	80	0.1750000
NODE_4084_length_1177_cov_34.920223	498	578	5	14	80	0.1750000
NODE_4084_length_1177_cov_34.920223	498	578	6	3	80	0.0375000
NODE_4084_length_1177_cov_34.920223	551	631	0	1	80	0.0125000
NODE_4084_length_1177_cov_34.920223	551	631	1	18	80	0.2250000
NODE_4084_length_1177_cov_34.920223	551	631	2	2	80	0.0250000
NODE_4084_length_1177_cov_34.920223	551	631	3	14	80	0.1750000
NODE_4084_length_1177_cov_34.920223	551	631	5	14	80	0.1750000
NODE_4084_length_1177_cov_34.920223	551	631	6	22	80	0.2750000
NODE_4084_length_1177_cov_34.920223	551	631	7	9	80	0.1125000
NODE_4085_length_1177_cov_12.186456	481	561	0	80	80	1.0000000
NODE_4085_length_1177_cov_12.186456	534	614	0	80	80	1.0000000
NODE_4085_length_1177_cov_12.186456	610	690	0	80	80	1.0000000
NODE_4085_length_1177_cov_12.186456	663	743	0	80	80	1.0000000
NODE_4086_length_1177_cov_11.926716	443	523	2	56	80	0.7000000
NODE_4086_length_1177_cov_11.926716	443	523	3	3	80	0.0375000
NODE_4086_length_1177_cov_11.926716	443	523	4	8	80	0.1000000
NODE_4086_length_1177_cov_11.926716	443	523	6	13	80	0.1625000
NODE_4086_length_1177_cov_11.926716	496	578	2	3	82	0.0365854
NODE_4086_length_1177_cov_11.926716	496	578	3	3	82	0.0365854
NODE_4086_length_1177_cov_11.926716	496	578	4	15	82	0.1829268
NODE_4086_length_1177_cov_11.926716	496	578	6	61	82	0.7439024
NODE_4088_length_1177_cov_5.923933	358	438	1	80	80	1.0000000
NODE_4088_length_1177_cov_5.923933	411	491	0	13	80	0.1625000
NODE_4088_length_1177_cov_5.923933	411	491	1	67	80	0.8375000
NODE_4089_length_1177_cov_5.775510	760	840	0	80	80	1.0000000
NODE_4089_length_1177_cov_5.775510	813	893	0	80	80	1.0000000
NODE_4096_length_1176_cov_26.994429	377	457	0	40	80	0.5000000
NODE_4096_length_1176_cov_26.994429	377	457	2	40	80	0.5000000
NODE_4096_length_1176_cov_26.994429	430	510	0	66	80	0.8250000
NODE_4096_length_1176_cov_26.994429	430	510	2	14	80	0.1750000
NODE_4096_length_1176_cov_26.994429	506	586	2	10	80	0.1250000
NODE_4096_length_1176_cov_26.994429	506	586	3	62	80	0.7750000
NODE_4096_length_1176_cov_26.994429	506	586	4	4	80	0.0500000
NODE_4096_length_1176_cov_26.994429	506	586	5	4	80	0.0500000
NODE_4096_length_1176_cov_26.994429	559	639	3	56	80	0.7000000
NODE_4096_length_1176_cov_26.994429	559	639	4	4	80	0.0500000
NODE_4096_length_1176_cov_26.994429	559	639	5	20	80	0.2500000
NODE_4097_length_1176_cov_15.766945	531	611	0	80	80	1.0000000
NODE_4097_length_1176_cov_15.766945	584	664	0	80	80	1.0000000
NODE_4098_length_1176_cov_14.882080	628	708	0	5	80	0.0625000
NODE_4098_length_1176_cov_14.882080	628	708	2	39	80	0.4875000
NODE_4098_length_1176_cov_14.882080	628	708	3	24	80	0.3000000
NODE_4098_length_1176_cov_14.882080	628	708	4	12	80	0.1500000
NODE_4098_length_1176_cov_14.882080	681	761	2	15	80	0.1875000
NODE_4098_length_1176_cov_14.882080	681	761	3	15	80	0.1875000
NODE_4098_length_1176_cov_14.882080	681	761	4	50	80	0.6250000
NODE_4099_length_1176_cov_10.692665	392	472	1	80	80	1.0000000
NODE_4099_length_1176_cov_10.692665	445	525	0	28	80	0.3500000
NODE_4099_length_1176_cov_10.692665	445	525	1	52	80	0.6500000
NODE_4106_length_1175_cov_50.754647	526	606	4	1	80	0.0125000
NODE_4106_length_1175_cov_50.754647	526	606	6	31	80	0.3875000
NODE_4106_length_1175_cov_50.754647	526	606	8	18	80	0.2250000
NODE_4106_length_1175_cov_50.754647	526	606	9	21	80	0.2625000
NODE_4106_length_1175_cov_50.754647	526	606	11	9	80	0.1125000
NODE_4106_length_1175_cov_50.754647	579	659	8	17	80	0.2125000
NODE_4106_length_1175_cov_50.754647	579	659	9	39	80	0.4875000
NODE_4106_length_1175_cov_50.754647	579	659	11	24	80	0.3000000
NODE_4107_length_1175_cov_42.638476	327	407	4	32	80	0.4000000
NODE_4107_length_1175_cov_42.638476	327	407	5	2	80	0.0250000
NODE_4107_length_1175_cov_42.638476	327	407	6	2	80	0.0250000
NODE_4107_length_1175_cov_42.638476	327	407	7	8	80	0.1000000
NODE_4107_length_1175_cov_42.638476	327	407	8	10	80	0.1250000
NODE_4107_length_1175_cov_42.638476	327	407	10	17	80	0.2125000
NODE_4107_length_1175_cov_42.638476	327	407	11	3	80	0.0375000
NODE_4107_length_1175_cov_42.638476	327	407	12	6	80	0.0750000
NODE_4107_length_1175_cov_42.638476	380	460	8	1	80	0.0125000
NODE_4107_length_1175_cov_42.638476	380	460	10	17	80	0.2125000
NODE_4107_length_1175_cov_42.638476	380	460	11	14	80	0.1750000
NODE_4107_length_1175_cov_42.638476	380	460	12	21	80	0.2625000
NODE_4107_length_1175_cov_42.638476	380	460	13	6	80	0.0750000
NODE_4107_length_1175_cov_42.638476	380	460	15	21	80	0.2625000
NODE_4107_length_1175_cov_42.638476	456	536	7	17	80	0.2125000
NODE_4107_length_1175_cov_42.638476	456	536	8	8	80	0.1000000
NODE_4107_length_1175_cov_42.638476	456	536	10	8	80	0.1000000
NODE_4107_length_1175_cov_42.638476	456	536	11	41	80	0.5125000
NODE_4107_length_1175_cov_42.638476	456	536	13	6	80	0.0750000
NODE_4107_length_1175_cov_42.638476	509	589	1	1	80	0.0125000
NODE_4107_length_1175_cov_42.638476	509	589	3	5	80	0.0625000
NODE_4107_length_1175_cov_42.638476	509	589	4	4	80	0.0500000
NODE_4107_length_1175_cov_42.638476	509	589	5	28	80	0.3500000
NODE_4107_length_1175_cov_42.638476	509	589	6	3	80	0.0375000
NODE_4107_length_1175_cov_42.638476	509	589	7	29	80	0.3625000
NODE_4107_length_1175_cov_42.638476	509	589	8	8	80	0.1000000
NODE_4107_length_1175_cov_42.638476	509	589	10	2	80	0.0250000
NODE_4108_length_1175_cov_40.217472	437	517	2	80	80	1.0000000
NODE_4108_length_1175_cov_40.217472	490	570	0	28	80	0.3500000
NODE_4108_length_1175_cov_40.217472	490	570	2	52	80	0.6500000
NODE_4108_length_1175_cov_40.217472	566	646	0	80	80	1.0000000
NODE_4108_length_1175_cov_40.217472	619	699	0	80	80	1.0000000
NODE_4109_length_1175_cov_12.834572	775	855	1	22	80	0.2750000
NODE_4109_length_1175_cov_12.834572	775	855	2	1	80	0.0125000
NODE_4109_length_1175_cov_12.834572	775	855	3	57	80	0.7125000
NODE_4109_length_1175_cov_12.834572	828	908	0	4	80	0.0500000
NODE_4109_length_1175_cov_12.834572	828	908	2	25	80	0.3125000
NODE_4109_length_1175_cov_12.834572	828	908	3	51	80	0.6375000
NODE_4115_length_1174_cov_20.569302	433	513	0	80	80	1.0000000
NODE_4115_length_1174_cov_20.569302	486	566	0	80	80	1.0000000
NODE_4115_length_1174_cov_20.569302	562	642	0	80	80	1.0000000
NODE_4115_length_1174_cov_20.569302	615	695	0	80	80	1.0000000
NODE_4116_length_1174_cov_18.797209	578	658	0	80	80	1.0000000
NODE_4116_length_1174_cov_18.797209	631	711	0	80	80	1.0000000
NODE_4117_length_1174_cov_17.486512	589	669	0	42	80	0.5250000
NODE_4117_length_1174_cov_17.486512	589	669	1	12	80	0.1500000
NODE_4117_length_1174_cov_17.486512	589	669	2	12	80	0.1500000
NODE_4117_length_1174_cov_17.486512	589	669	4	14	80	0.1750000
NODE_4117_length_1174_cov_17.486512	642	722	1	1	80	0.0125000
NODE_4117_length_1174_cov_17.486512	642	722	2	12	80	0.1500000
NODE_4117_length_1174_cov_17.486512	642	722	4	67	80	0.8375000
NODE_4118_length_1174_cov_15.888372	570	650	1	2	80	0.0250000
NODE_4118_length_1174_cov_15.888372	570	650	2	78	80	0.9750000
NODE_4118_length_1174_cov_15.888372	623	703	1	30	80	0.3750000
NODE_4118_length_1174_cov_15.888372	623	703	2	50	80	0.6250000
NODE_4118_length_1174_cov_15.888372	699	779	0	57	80	0.7125000
NODE_4118_length_1174_cov_15.888372	699	779	1	23	80	0.2875000
NODE_4118_length_1174_cov_15.888372	752	832	0	80	80	1.0000000
NODE_4124_length_1174_cov_1.536744	1066	1115	0	42	49	0.8571429
NODE_4124_length_1174_cov_1.536744	1066	1115	1	1	49	0.0204082
NODE_4124_length_1174_cov_1.536744	1066	1115	3	6	49	0.1224490
NODE_4124_length_1174_cov_1.536744	1088	1168	0	80	80	1.0000000
NODE_4128_length_1173_cov_29.562384	455	535	3	54	80	0.6750000
NODE_4128_length_1173_cov_29.562384	455	535	5	26	80	0.3250000
NODE_4128_length_1173_cov_29.562384	508	588	3	36	80	0.4500000
NODE_4128_length_1173_cov_29.562384	508	588	4	5	80	0.0625000
NODE_4128_length_1173_cov_29.562384	508	588	5	39	80	0.4875000
NODE_4128_length_1173_cov_29.562384	584	664	1	7	80	0.0875000
NODE_4128_length_1173_cov_29.562384	584	664	3	73	80	0.9125000
NODE_4128_length_1173_cov_29.562384	637	717	0	10	80	0.1250000
NODE_4128_length_1173_cov_29.562384	637	717	1	50	80	0.6250000
NODE_4128_length_1173_cov_29.562384	637	717	3	20	80	0.2500000
NODE_4129_length_1173_cov_25.206704	395	475	6	29	80	0.3625000
NODE_4129_length_1173_cov_25.206704	395	475	7	25	80	0.3125000
NODE_4129_length_1173_cov_25.206704	395	475	9	26	80	0.3250000
NODE_4129_length_1173_cov_25.206704	448	528	5	17	80	0.2125000
NODE_4129_length_1173_cov_25.206704	448	528	7	1	80	0.0125000
NODE_4129_length_1173_cov_25.206704	448	528	8	29	80	0.3625000
NODE_4129_length_1173_cov_25.206704	448	528	9	33	80	0.4125000
NODE_4130_length_1173_cov_9.486965	693	773	0	23	80	0.2875000
NODE_4130_length_1173_cov_9.486965	693	773	1	9	80	0.1125000
NODE_4130_length_1173_cov_9.486965	693	773	2	32	80	0.4000000
NODE_4130_length_1173_cov_9.486965	693	773	3	16	80	0.2000000
NODE_4130_length_1173_cov_9.486965	746	826	2	53	80	0.6625000
NODE_4130_length_1173_cov_9.486965	746	826	3	27	80	0.3375000
NODE_4131_length_1173_cov_7.946927	201	281	3	44	80	0.5500000
NODE_4131_length_1173_cov_7.946927	201	281	4	36	80	0.4500000
NODE_4131_length_1173_cov_7.946927	254	334	2	14	80	0.1750000
NODE_4131_length_1173_cov_7.946927	254	334	3	41	80	0.5125000
NODE_4131_length_1173_cov_7.946927	254	334	4	25	80	0.3125000
NODE_4136_length_1172_cov_37.177074	527	607	3	31	80	0.3875000
NODE_4136_length_1172_cov_37.177074	527	607	4	49	80	0.6125000
NODE_4136_length_1172_cov_37.177074	580	660	3	24	80	0.3000000
NODE_4136_length_1172_cov_37.177074	580	660	4	56	80	0.7000000
NODE_4137_length_1172_cov_20.397018	677	757	0	7	80	0.0875000
NODE_4137_length_1172_cov_20.397018	677	757	1	73	80	0.9125000
NODE_4137_length_1172_cov_20.397018	730	810	1	40	80	0.5000000
NODE_4137_length_1172_cov_20.397018	730	810	2	40	80	0.5000000
NODE_4138_length_1172_cov_15.018639	460	540	1	19	80	0.2375000
NODE_4138_length_1172_cov_15.018639	460	540	2	15	80	0.1875000
NODE_4138_length_1172_cov_15.018639	460	540	4	11	80	0.1375000
NODE_4138_length_1172_cov_15.018639	460	540	5	35	80	0.4375000
NODE_4138_length_1172_cov_15.018639	513	593	2	8	80	0.1000000
NODE_4138_length_1172_cov_15.018639	513	593	3	10	80	0.1250000
NODE_4138_length_1172_cov_15.018639	513	593	4	41	80	0.5125000
NODE_4138_length_1172_cov_15.018639	513	593	5	21	80	0.2625000
NODE_4139_length_1172_cov_13.199441	622	702	0	80	80	1.0000000
NODE_4139_length_1172_cov_13.199441	675	755	0	80	80	1.0000000
NODE_4140_length_1172_cov_10.720410	499	579	0	16	80	0.2000000
NODE_4140_length_1172_cov_10.720410	499	579	1	64	80	0.8000000
NODE_4140_length_1172_cov_10.720410	552	632	0	69	80	0.8625000
NODE_4140_length_1172_cov_10.720410	552	632	1	11	80	0.1375000
NODE_4140_length_1172_cov_10.720410	628	708	0	18	80	0.2250000
NODE_4140_length_1172_cov_10.720410	628	708	1	10	80	0.1250000
NODE_4140_length_1172_cov_10.720410	628	708	2	52	80	0.6500000
NODE_4140_length_1172_cov_10.720410	681	761	2	80	80	1.0000000
NODE_4141_length_1172_cov_10.574091	951	1021	18	2	70	0.0285714
NODE_4141_length_1172_cov_10.574091	951	1021	19	10	70	0.1428571
NODE_4141_length_1172_cov_10.574091	951	1021	21	4	70	0.0571429
NODE_4141_length_1172_cov_10.574091	951	1021	22	3	70	0.0428571
NODE_4141_length_1172_cov_10.574091	951	1021	23	3	70	0.0428571
NODE_4141_length_1172_cov_10.574091	951	1021	25	2	70	0.0285714
NODE_4141_length_1172_cov_10.574091	951	1021	26	3	70	0.0428571
NODE_4141_length_1172_cov_10.574091	951	1021	27	2	70	0.0285714
NODE_4141_length_1172_cov_10.574091	951	1021	28	8	70	0.1142857
NODE_4141_length_1172_cov_10.574091	951	1021	29	4	70	0.0571429
NODE_4141_length_1172_cov_10.574091	951	1021	31	1	70	0.0142857
NODE_4141_length_1172_cov_10.574091	951	1021	33	4	70	0.0571429
NODE_4141_length_1172_cov_10.574091	951	1021	34	12	70	0.1714286
NODE_4141_length_1172_cov_10.574091	951	1021	35	9	70	0.1285714
NODE_4141_length_1172_cov_10.574091	951	1021	36	1	70	0.0142857
NODE_4141_length_1172_cov_10.574091	951	1021	37	2	70	0.0285714
NODE_4142_length_1172_cov_9.204101	276	356	2	9	80	0.1125000
NODE_4142_length_1172_cov_9.204101	276	356	3	34	80	0.4250000
NODE_4142_length_1172_cov_9.204101	276	356	4	37	80	0.4625000
NODE_4142_length_1172_cov_9.204101	329	409	3	60	80	0.7500000
NODE_4142_length_1172_cov_9.204101	329	409	4	20	80	0.2500000
NODE_4148_length_1171_cov_13.311567	666	746	1	12	80	0.1500000
NODE_4148_length_1171_cov_13.311567	666	746	2	28	80	0.3500000
NODE_4148_length_1171_cov_13.311567	666	746	3	40	80	0.5000000
NODE_4148_length_1171_cov_13.311567	719	803	2	35	84	0.4166667
NODE_4148_length_1171_cov_13.311567	719	803	3	49	84	0.5833333
NODE_4149_length_1171_cov_9.154851	198	278	1	80	80	1.0000000
NODE_4149_length_1171_cov_9.154851	251	331	0	15	80	0.1875000
NODE_4149_length_1171_cov_9.154851	251	331	1	65	80	0.8125000
NODE_4157_length_1170_cov_65.480859	402	482	11	1	80	0.0125000
NODE_4157_length_1170_cov_65.480859	402	482	12	10	80	0.1250000
NODE_4157_length_1170_cov_65.480859	402	482	13	22	80	0.2750000
NODE_4157_length_1170_cov_65.480859	402	482	14	1	80	0.0125000
NODE_4157_length_1170_cov_65.480859	402	482	15	13	80	0.1625000
NODE_4157_length_1170_cov_65.480859	402	482	16	5	80	0.0625000
NODE_4157_length_1170_cov_65.480859	402	482	17	27	80	0.3375000
NODE_4157_length_1170_cov_65.480859	402	482	19	1	80	0.0125000
NODE_4157_length_1170_cov_65.480859	455	535	9	19	80	0.2375000
NODE_4157_length_1170_cov_65.480859	455	535	11	8	80	0.1000000
NODE_4157_length_1170_cov_65.480859	455	535	13	16	80	0.2000000
NODE_4157_length_1170_cov_65.480859	455	535	15	2	80	0.0250000
NODE_4157_length_1170_cov_65.480859	455	535	16	13	80	0.1625000
NODE_4157_length_1170_cov_65.480859	455	535	17	21	80	0.2625000
NODE_4157_length_1170_cov_65.480859	455	535	19	1	80	0.0125000
NODE_4158_length_1170_cov_35.283847	704	784	0	38	80	0.4750000
NODE_4158_length_1170_cov_35.283847	704	784	1	42	80	0.5250000
NODE_4158_length_1170_cov_35.283847	757	837	1	80	80	1.0000000
NODE_4159_length_1170_cov_23.600373	450	530	5	5	80	0.0625000
NODE_4159_length_1170_cov_23.600373	450	530	6	48	80	0.6000000
NODE_4159_length_1170_cov_23.600373	450	530	7	27	80	0.3375000
NODE_4159_length_1170_cov_23.600373	503	583	2	3	80	0.0375000
NODE_4159_length_1170_cov_23.600373	503	583	4	43	80	0.5375000
NODE_4159_length_1170_cov_23.600373	503	583	5	12	80	0.1500000
NODE_4159_length_1170_cov_23.600373	503	583	6	17	80	0.2125000
NODE_4159_length_1170_cov_23.600373	503	583	7	5	80	0.0625000
NODE_4159_length_1170_cov_23.600373	579	659	3	8	80	0.1000000
NODE_4159_length_1170_cov_23.600373	579	659	4	6	80	0.0750000
NODE_4159_length_1170_cov_23.600373	579	659	5	62	80	0.7750000
NODE_4159_length_1170_cov_23.600373	579	659	6	4	80	0.0500000
NODE_4159_length_1170_cov_23.600373	632	705	1	3	73	0.0410959
NODE_4159_length_1170_cov_23.600373	632	705	3	11	73	0.1506849
NODE_4159_length_1170_cov_23.600373	632	705	5	59	73	0.8082192
NODE_4160_length_1170_cov_19.783380	325	405	1	40	80	0.5000000
NODE_4160_length_1170_cov_19.783380	325	405	2	40	80	0.5000000
NODE_4160_length_1170_cov_19.783380	378	458	0	49	80	0.6125000
NODE_4160_length_1170_cov_19.783380	378	458	1	31	80	0.3875000
NODE_4168_length_1169_cov_61.689720	464	544	5	14	80	0.1750000
NODE_4168_length_1169_cov_61.689720	464	544	6	14	80	0.1750000
NODE_4168_length_1169_cov_61.689720	464	544	7	19	80	0.2375000
NODE_4168_length_1169_cov_61.689720	464	544	8	19	80	0.2375000
NODE_4168_length_1169_cov_61.689720	464	544	9	14	80	0.1750000
NODE_4168_length_1169_cov_61.689720	517	597	4	16	80	0.2000000
NODE_4168_length_1169_cov_61.689720	517	597	5	4	80	0.0500000
NODE_4168_length_1169_cov_61.689720	517	597	6	47	80	0.5875000
NODE_4168_length_1169_cov_61.689720	517	597	7	13	80	0.1625000
NODE_4168_length_1169_cov_61.689720	593	673	4	16	80	0.2000000
NODE_4168_length_1169_cov_61.689720	593	673	5	30	80	0.3750000
NODE_4168_length_1169_cov_61.689720	593	673	6	19	80	0.2375000
NODE_4168_length_1169_cov_61.689720	593	673	7	15	80	0.1875000
NODE_4168_length_1169_cov_61.689720	646	726	5	77	80	0.9625000
NODE_4168_length_1169_cov_61.689720	646	726	6	3	80	0.0375000
NODE_4169_length_1169_cov_55.247664	640	720	6	24	80	0.3000000
NODE_4169_length_1169_cov_55.247664	640	720	7	13	80	0.1625000
NODE_4169_length_1169_cov_55.247664	640	720	8	43	80	0.5375000
NODE_4169_length_1169_cov_55.247664	693	773	6	21	80	0.2625000
NODE_4169_length_1169_cov_55.247664	693	773	7	20	80	0.2500000
NODE_4169_length_1169_cov_55.247664	693	773	8	39	80	0.4875000
NODE_4170_length_1169_cov_39.016822	447	527	4	23	80	0.2875000
NODE_4170_length_1169_cov_39.016822	447	527	5	55	80	0.6875000
NODE_4170_length_1169_cov_39.016822	447	527	6	2	80	0.0250000
NODE_4170_length_1169_cov_39.016822	500	580	3	27	80	0.3375000
NODE_4170_length_1169_cov_39.016822	500	580	4	43	80	0.5375000
NODE_4170_length_1169_cov_39.016822	500	580	5	8	80	0.1000000
NODE_4170_length_1169_cov_39.016822	500	580	6	2	80	0.0250000
NODE_4170_length_1169_cov_39.016822	576	656	3	47	80	0.5875000
NODE_4170_length_1169_cov_39.016822	576	656	4	33	80	0.4125000
NODE_4170_length_1169_cov_39.016822	629	709	2	30	80	0.3750000
NODE_4170_length_1169_cov_39.016822	629	709	3	21	80	0.2625000
NODE_4170_length_1169_cov_39.016822	629	709	4	29	80	0.3625000
NODE_4171_length_1169_cov_35.383178	582	662	3	1	80	0.0125000
NODE_4171_length_1169_cov_35.383178	582	662	4	3	80	0.0375000
NODE_4171_length_1169_cov_35.383178	582	662	6	6	80	0.0750000
NODE_4171_length_1169_cov_35.383178	582	662	8	12	80	0.1500000
NODE_4171_length_1169_cov_35.383178	582	662	10	9	80	0.1125000
NODE_4171_length_1169_cov_35.383178	582	662	14	7	80	0.0875000
NODE_4171_length_1169_cov_35.383178	582	662	15	42	80	0.5250000
NODE_4171_length_1169_cov_35.383178	635	715	12	11	80	0.1375000
NODE_4171_length_1169_cov_35.383178	635	715	13	32	80	0.4000000
NODE_4171_length_1169_cov_35.383178	635	715	14	5	80	0.0625000
NODE_4171_length_1169_cov_35.383178	635	715	15	32	80	0.4000000
NODE_4173_length_1169_cov_12.010280	338	418	1	13	80	0.1625000
NODE_4173_length_1169_cov_12.010280	338	418	2	22	80	0.2750000
NODE_4173_length_1169_cov_12.010280	338	418	3	45	80	0.5625000
NODE_4173_length_1169_cov_12.010280	391	471	2	55	80	0.6875000
NODE_4173_length_1169_cov_12.010280	391	471	3	25	80	0.3125000
NODE_4175_length_1169_cov_4.172897	74	135	0	61	61	1.0000000
NODE_4175_length_1169_cov_4.172897	74	135	0	61	61	1.0000000
NODE_4175_length_1169_cov_4.172897	74	135	0	61	61	1.0000000
NODE_4183_length_1168_cov_27.350795	517	597	0	80	80	1.0000000
NODE_4183_length_1168_cov_27.350795	570	650	0	70	80	0.8750000
NODE_4183_length_1168_cov_27.350795	570	650	1	10	80	0.1250000
NODE_4183_length_1168_cov_27.350795	646	726	1	10	80	0.1250000
NODE_4183_length_1168_cov_27.350795	646	726	2	47	80	0.5875000
NODE_4183_length_1168_cov_27.350795	646	726	3	23	80	0.2875000
NODE_4183_length_1168_cov_27.350795	699	779	2	4	80	0.0500000
NODE_4183_length_1168_cov_27.350795	699	779	3	76	80	0.9500000
NODE_4184_length_1168_cov_25.777362	672	752	5	24	80	0.3000000
NODE_4184_length_1168_cov_25.777362	672	752	6	3	80	0.0375000
NODE_4184_length_1168_cov_25.777362	672	752	7	6	80	0.0750000
NODE_4184_length_1168_cov_25.777362	672	752	8	44	80	0.5500000
NODE_4184_length_1168_cov_25.777362	672	752	10	3	80	0.0375000
NODE_4184_length_1168_cov_25.777362	725	805	3	2	80	0.0250000
NODE_4184_length_1168_cov_25.777362	725	805	4	47	80	0.5875000
NODE_4184_length_1168_cov_25.777362	725	805	6	2	80	0.0250000
NODE_4184_length_1168_cov_25.777362	725	805	8	24	80	0.3000000
NODE_4184_length_1168_cov_25.777362	725	805	10	5	80	0.0625000
NODE_4185_length_1168_cov_25.295603	543	623	3	9	80	0.1125000
NODE_4185_length_1168_cov_25.295603	543	623	4	1	80	0.0125000
NODE_4185_length_1168_cov_25.295603	543	623	5	61	80	0.7625000
NODE_4185_length_1168_cov_25.295603	543	623	6	9	80	0.1125000
NODE_4185_length_1168_cov_25.295603	596	676	5	80	80	1.0000000
NODE_4185_length_1168_cov_25.295603	672	752	0	47	80	0.5875000
NODE_4185_length_1168_cov_25.295603	672	752	1	2	80	0.0250000
NODE_4185_length_1168_cov_25.295603	672	752	2	1	80	0.0125000
NODE_4185_length_1168_cov_25.295603	672	752	3	22	80	0.2750000
NODE_4185_length_1168_cov_25.295603	672	752	5	8	80	0.1000000
NODE_4185_length_1168_cov_25.295603	725	804	0	79	79	1.0000000
NODE_4186_length_1168_cov_20.202058	434	514	5	29	80	0.3625000
NODE_4186_length_1168_cov_20.202058	434	514	6	41	80	0.5125000
NODE_4186_length_1168_cov_20.202058	434	514	7	10	80	0.1250000
NODE_4186_length_1168_cov_20.202058	487	567	1	11	80	0.1375000
NODE_4186_length_1168_cov_20.202058	487	567	2	2	80	0.0250000
NODE_4186_length_1168_cov_20.202058	487	567	3	6	80	0.0750000
NODE_4186_length_1168_cov_20.202058	487	567	4	25	80	0.3125000
NODE_4186_length_1168_cov_20.202058	487	567	5	36	80	0.4500000
NODE_4187_length_1168_cov_16.787652	405	485	2	54	80	0.6750000
NODE_4187_length_1168_cov_16.787652	405	485	3	8	80	0.1000000
NODE_4187_length_1168_cov_16.787652	405	485	4	18	80	0.2250000
NODE_4187_length_1168_cov_16.787652	458	538	2	21	80	0.2625000
NODE_4187_length_1168_cov_16.787652	458	538	3	8	80	0.1000000
NODE_4187_length_1168_cov_16.787652	458	538	4	51	80	0.6375000
NODE_4188_length_1168_cov_10.079514	722	802	0	21	80	0.2625000
NODE_4188_length_1168_cov_10.079514	722	802	1	59	80	0.7375000
NODE_4188_length_1168_cov_10.079514	775	855	1	31	80	0.3875000
NODE_4188_length_1168_cov_10.079514	775	855	2	49	80	0.6125000
NODE_4198_length_1167_cov_27.961610	591	671	2	9	80	0.1125000
NODE_4198_length_1167_cov_27.961610	591	671	4	4	80	0.0500000
NODE_4198_length_1167_cov_27.961610	591	671	6	20	80	0.2500000
NODE_4198_length_1167_cov_27.961610	591	671	9	31	80	0.3875000
NODE_4198_length_1167_cov_27.961610	591	671	10	16	80	0.2000000
NODE_4198_length_1167_cov_27.961610	644	724	8	32	80	0.4000000
NODE_4198_length_1167_cov_27.961610	644	724	9	39	80	0.4875000
NODE_4198_length_1167_cov_27.961610	644	724	10	9	80	0.1125000
NODE_4199_length_1167_cov_12.393258	670	750	0	13	80	0.1625000
NODE_4199_length_1167_cov_12.393258	670	750	1	67	80	0.8375000
NODE_4199_length_1167_cov_12.393258	723	803	0	66	80	0.8250000
NODE_4199_length_1167_cov_12.393258	723	803	1	14	80	0.1750000
NODE_4200_length_1167_cov_11.189139	434	514	0	80	80	1.0000000
NODE_4200_length_1167_cov_11.189139	487	567	0	42	80	0.5250000
NODE_4200_length_1167_cov_11.189139	487	567	1	38	80	0.4750000
NODE_4201_length_1167_cov_7.998127	711	791	0	80	80	1.0000000
NODE_4201_length_1167_cov_7.998127	764	844	0	80	80	1.0000000
NODE_4206_length_1166_cov_313.815370	444	524	41	1	80	0.0125000
NODE_4206_length_1166_cov_313.815370	444	524	42	10	80	0.1250000
NODE_4206_length_1166_cov_313.815370	444	524	43	3	80	0.0375000
NODE_4206_length_1166_cov_313.815370	444	524	44	1	80	0.0125000
NODE_4206_length_1166_cov_313.815370	444	524	45	1	80	0.0125000
NODE_4206_length_1166_cov_313.815370	444	524	47	1	80	0.0125000
NODE_4206_length_1166_cov_313.815370	444	524	50	1	80	0.0125000
NODE_4206_length_1166_cov_313.815370	444	524	53	2	80	0.0250000
NODE_4206_length_1166_cov_313.815370	444	524	55	1	80	0.0125000
NODE_4206_length_1166_cov_313.815370	444	524	56	4	80	0.0500000
NODE_4206_length_1166_cov_313.815370	444	524	59	1	80	0.0125000
NODE_4206_length_1166_cov_313.815370	444	524	61	2	80	0.0250000
NODE_4206_length_1166_cov_313.815370	444	524	63	2	80	0.0250000
NODE_4206_length_1166_cov_313.815370	444	524	64	2	80	0.0250000
NODE_4206_length_1166_cov_313.815370	444	524	66	1	80	0.0125000
NODE_4206_length_1166_cov_313.815370	444	524	68	1	80	0.0125000
NODE_4206_length_1166_cov_313.815370	444	524	69	2	80	0.0250000
NODE_4206_length_1166_cov_313.815370	444	524	73	1	80	0.0125000
NODE_4206_length_1166_cov_313.815370	444	524	76	2	80	0.0250000
NODE_4206_length_1166_cov_313.815370	444	524	79	3	80	0.0375000
NODE_4206_length_1166_cov_313.815370	444	524	81	1	80	0.0125000
NODE_4206_length_1166_cov_313.815370	444	524	83	4	80	0.0500000
NODE_4206_length_1166_cov_313.815370	444	524	86	1	80	0.0125000
NODE_4206_length_1166_cov_313.815370	444	524	88	1	80	0.0125000
NODE_4206_length_1166_cov_313.815370	444	524	89	2	80	0.0250000
NODE_4206_length_1166_cov_313.815370	444	524	90	3	80	0.0375000
NODE_4206_length_1166_cov_313.815370	444	524	91	5	80	0.0625000
NODE_4206_length_1166_cov_313.815370	444	524	92	1	80	0.0125000
NODE_4206_length_1166_cov_313.815370	444	524	93	9	80	0.1125000
NODE_4206_length_1166_cov_313.815370	444	524	94	4	80	0.0500000
NODE_4206_length_1166_cov_313.815370	444	524	95	2	80	0.0250000
NODE_4206_length_1166_cov_313.815370	444	524	96	5	80	0.0625000
NODE_4206_length_1166_cov_313.815370	444	524	41	1	80	0.0125000
NODE_4206_length_1166_cov_313.815370	444	524	42	10	80	0.1250000
NODE_4206_length_1166_cov_313.815370	444	524	43	3	80	0.0375000
NODE_4206_length_1166_cov_313.815370	444	524	44	1	80	0.0125000
NODE_4206_length_1166_cov_313.815370	444	524	45	1	80	0.0125000
NODE_4206_length_1166_cov_313.815370	444	524	47	1	80	0.0125000
NODE_4206_length_1166_cov_313.815370	444	524	50	1	80	0.0125000
NODE_4206_length_1166_cov_313.815370	444	524	53	2	80	0.0250000
NODE_4206_length_1166_cov_313.815370	444	524	55	1	80	0.0125000
NODE_4206_length_1166_cov_313.815370	444	524	56	4	80	0.0500000
NODE_4206_length_1166_cov_313.815370	444	524	59	1	80	0.0125000
NODE_4206_length_1166_cov_313.815370	444	524	61	2	80	0.0250000
NODE_4206_length_1166_cov_313.815370	444	524	63	2	80	0.0250000
NODE_4206_length_1166_cov_313.815370	444	524	64	2	80	0.0250000
NODE_4206_length_1166_cov_313.815370	444	524	66	1	80	0.0125000
NODE_4206_length_1166_cov_313.815370	444	524	68	1	80	0.0125000
NODE_4206_length_1166_cov_313.815370	444	524	69	2	80	0.0250000
NODE_4206_length_1166_cov_313.815370	444	524	73	1	80	0.0125000
NODE_4206_length_1166_cov_313.815370	444	524	76	2	80	0.0250000
NODE_4206_length_1166_cov_313.815370	444	524	79	3	80	0.0375000
NODE_4206_length_1166_cov_313.815370	444	524	81	1	80	0.0125000
NODE_4206_length_1166_cov_313.815370	444	524	83	4	80	0.0500000
NODE_4206_length_1166_cov_313.815370	444	524	86	1	80	0.0125000
NODE_4206_length_1166_cov_313.815370	444	524	88	1	80	0.0125000
NODE_4206_length_1166_cov_313.815370	444	524	89	2	80	0.0250000
NODE_4206_length_1166_cov_313.815370	444	524	90	3	80	0.0375000
NODE_4206_length_1166_cov_313.815370	444	524	91	5	80	0.0625000
NODE_4206_length_1166_cov_313.815370	444	524	92	1	80	0.0125000
NODE_4206_length_1166_cov_313.815370	444	524	93	9	80	0.1125000
NODE_4206_length_1166_cov_313.815370	444	524	94	4	80	0.0500000
NODE_4206_length_1166_cov_313.815370	444	524	95	2	80	0.0250000
NODE_4206_length_1166_cov_313.815370	444	524	96	5	80	0.0625000
NODE_4206_length_1166_cov_313.815370	444	524	41	1	80	0.0125000
NODE_4206_length_1166_cov_313.815370	444	524	42	10	80	0.1250000
NODE_4206_length_1166_cov_313.815370	444	524	43	3	80	0.0375000
NODE_4206_length_1166_cov_313.815370	444	524	44	1	80	0.0125000
NODE_4206_length_1166_cov_313.815370	444	524	45	1	80	0.0125000
NODE_4206_length_1166_cov_313.815370	444	524	47	1	80	0.0125000
NODE_4206_length_1166_cov_313.815370	444	524	50	1	80	0.0125000
NODE_4206_length_1166_cov_313.815370	444	524	53	2	80	0.0250000
NODE_4206_length_1166_cov_313.815370	444	524	55	1	80	0.0125000
NODE_4206_length_1166_cov_313.815370	444	524	56	4	80	0.0500000
NODE_4206_length_1166_cov_313.815370	444	524	59	1	80	0.0125000
NODE_4206_length_1166_cov_313.815370	444	524	61	2	80	0.0250000
NODE_4206_length_1166_cov_313.815370	444	524	63	2	80	0.0250000
NODE_4206_length_1166_cov_313.815370	444	524	64	2	80	0.0250000
NODE_4206_length_1166_cov_313.815370	444	524	66	1	80	0.0125000
NODE_4206_length_1166_cov_313.815370	444	524	68	1	80	0.0125000
NODE_4206_length_1166_cov_313.815370	444	524	69	2	80	0.0250000
NODE_4206_length_1166_cov_313.815370	444	524	73	1	80	0.0125000
NODE_4206_length_1166_cov_313.815370	444	524	76	2	80	0.0250000
NODE_4206_length_1166_cov_313.815370	444	524	79	3	80	0.0375000
NODE_4206_length_1166_cov_313.815370	444	524	81	1	80	0.0125000
NODE_4206_length_1166_cov_313.815370	444	524	83	4	80	0.0500000
NODE_4206_length_1166_cov_313.815370	444	524	86	1	80	0.0125000
NODE_4206_length_1166_cov_313.815370	444	524	88	1	80	0.0125000
NODE_4206_length_1166_cov_313.815370	444	524	89	2	80	0.0250000
NODE_4206_length_1166_cov_313.815370	444	524	90	3	80	0.0375000
NODE_4206_length_1166_cov_313.815370	444	524	91	5	80	0.0625000
NODE_4206_length_1166_cov_313.815370	444	524	92	1	80	0.0125000
NODE_4206_length_1166_cov_313.815370	444	524	93	9	80	0.1125000
NODE_4206_length_1166_cov_313.815370	444	524	94	4	80	0.0500000
NODE_4206_length_1166_cov_313.815370	444	524	95	2	80	0.0250000
NODE_4206_length_1166_cov_313.815370	444	524	96	5	80	0.0625000
NODE_4206_length_1166_cov_313.815370	444	524	41	1	80	0.0125000
NODE_4206_length_1166_cov_313.815370	444	524	42	10	80	0.1250000
NODE_4206_length_1166_cov_313.815370	444	524	43	3	80	0.0375000
NODE_4206_length_1166_cov_313.815370	444	524	44	1	80	0.0125000
NODE_4206_length_1166_cov_313.815370	444	524	45	1	80	0.0125000
NODE_4206_length_1166_cov_313.815370	444	524	47	1	80	0.0125000
NODE_4206_length_1166_cov_313.815370	444	524	50	1	80	0.0125000
NODE_4206_length_1166_cov_313.815370	444	524	53	2	80	0.0250000
NODE_4206_length_1166_cov_313.815370	444	524	55	1	80	0.0125000
NODE_4206_length_1166_cov_313.815370	444	524	56	4	80	0.0500000
NODE_4206_length_1166_cov_313.815370	444	524	59	1	80	0.0125000
NODE_4206_length_1166_cov_313.815370	444	524	61	2	80	0.0250000
NODE_4206_length_1166_cov_313.815370	444	524	63	2	80	0.0250000
NODE_4206_length_1166_cov_313.815370	444	524	64	2	80	0.0250000
NODE_4206_length_1166_cov_313.815370	444	524	66	1	80	0.0125000
NODE_4206_length_1166_cov_313.815370	444	524	68	1	80	0.0125000
NODE_4206_length_1166_cov_313.815370	444	524	69	2	80	0.0250000
NODE_4206_length_1166_cov_313.815370	444	524	73	1	80	0.0125000
NODE_4206_length_1166_cov_313.815370	444	524	76	2	80	0.0250000
NODE_4206_length_1166_cov_313.815370	444	524	79	3	80	0.0375000
NODE_4206_length_1166_cov_313.815370	444	524	81	1	80	0.0125000
NODE_4206_length_1166_cov_313.815370	444	524	83	4	80	0.0500000
NODE_4206_length_1166_cov_313.815370	444	524	86	1	80	0.0125000
NODE_4206_length_1166_cov_313.815370	444	524	88	1	80	0.0125000
NODE_4206_length_1166_cov_313.815370	444	524	89	2	80	0.0250000
NODE_4206_length_1166_cov_313.815370	444	524	90	3	80	0.0375000
NODE_4206_length_1166_cov_313.815370	444	524	91	5	80	0.0625000
NODE_4206_length_1166_cov_313.815370	444	524	92	1	80	0.0125000
NODE_4206_length_1166_cov_313.815370	444	524	93	9	80	0.1125000
NODE_4206_length_1166_cov_313.815370	444	524	94	4	80	0.0500000
NODE_4206_length_1166_cov_313.815370	444	524	95	2	80	0.0250000
NODE_4206_length_1166_cov_313.815370	444	524	96	5	80	0.0625000
NODE_4206_length_1166_cov_313.815370	444	524	41	1	80	0.0125000
NODE_4206_length_1166_cov_313.815370	444	524	42	10	80	0.1250000
NODE_4206_length_1166_cov_313.815370	444	524	43	3	80	0.0375000
NODE_4206_length_1166_cov_313.815370	444	524	44	1	80	0.0125000
NODE_4206_length_1166_cov_313.815370	444	524	45	1	80	0.0125000
NODE_4206_length_1166_cov_313.815370	444	524	47	1	80	0.0125000
NODE_4206_length_1166_cov_313.815370	444	524	50	1	80	0.0125000
NODE_4206_length_1166_cov_313.815370	444	524	53	2	80	0.0250000
NODE_4206_length_1166_cov_313.815370	444	524	55	1	80	0.0125000
NODE_4206_length_1166_cov_313.815370	444	524	56	4	80	0.0500000
NODE_4206_length_1166_cov_313.815370	444	524	59	1	80	0.0125000
NODE_4206_length_1166_cov_313.815370	444	524	61	2	80	0.0250000
NODE_4206_length_1166_cov_313.815370	444	524	63	2	80	0.0250000
NODE_4206_length_1166_cov_313.815370	444	524	64	2	80	0.0250000
NODE_4206_length_1166_cov_313.815370	444	524	66	1	80	0.0125000
NODE_4206_length_1166_cov_313.815370	444	524	68	1	80	0.0125000
NODE_4206_length_1166_cov_313.815370	444	524	69	2	80	0.0250000
NODE_4206_length_1166_cov_313.815370	444	524	73	1	80	0.0125000
NODE_4206_length_1166_cov_313.815370	444	524	76	2	80	0.0250000
NODE_4206_length_1166_cov_313.815370	444	524	79	3	80	0.0375000
NODE_4206_length_1166_cov_313.815370	444	524	81	1	80	0.0125000
NODE_4206_length_1166_cov_313.815370	444	524	83	4	80	0.0500000
NODE_4206_length_1166_cov_313.815370	444	524	86	1	80	0.0125000
NODE_4206_length_1166_cov_313.815370	444	524	88	1	80	0.0125000
NODE_4206_length_1166_cov_313.815370	444	524	89	2	80	0.0250000
NODE_4206_length_1166_cov_313.815370	444	524	90	3	80	0.0375000
NODE_4206_length_1166_cov_313.815370	444	524	91	5	80	0.0625000
NODE_4206_length_1166_cov_313.815370	444	524	92	1	80	0.0125000
NODE_4206_length_1166_cov_313.815370	444	524	93	9	80	0.1125000
NODE_4206_length_1166_cov_313.815370	444	524	94	4	80	0.0500000
NODE_4206_length_1166_cov_313.815370	444	524	95	2	80	0.0250000
NODE_4206_length_1166_cov_313.815370	444	524	96	5	80	0.0625000
NODE_4206_length_1166_cov_313.815370	444	524	41	1	80	0.0125000
NODE_4206_length_1166_cov_313.815370	444	524	42	10	80	0.1250000
NODE_4206_length_1166_cov_313.815370	444	524	43	3	80	0.0375000
NODE_4206_length_1166_cov_313.815370	444	524	44	1	80	0.0125000
NODE_4206_length_1166_cov_313.815370	444	524	45	1	80	0.0125000
NODE_4206_length_1166_cov_313.815370	444	524	47	1	80	0.0125000
NODE_4206_length_1166_cov_313.815370	444	524	50	1	80	0.0125000
NODE_4206_length_1166_cov_313.815370	444	524	53	2	80	0.0250000
NODE_4206_length_1166_cov_313.815370	444	524	55	1	80	0.0125000
NODE_4206_length_1166_cov_313.815370	444	524	56	4	80	0.0500000
NODE_4206_length_1166_cov_313.815370	444	524	59	1	80	0.0125000
NODE_4206_length_1166_cov_313.815370	444	524	61	2	80	0.0250000
NODE_4206_length_1166_cov_313.815370	444	524	63	2	80	0.0250000
NODE_4206_length_1166_cov_313.815370	444	524	64	2	80	0.0250000
NODE_4206_length_1166_cov_313.815370	444	524	66	1	80	0.0125000
NODE_4206_length_1166_cov_313.815370	444	524	68	1	80	0.0125000
NODE_4206_length_1166_cov_313.815370	444	524	69	2	80	0.0250000
NODE_4206_length_1166_cov_313.815370	444	524	73	1	80	0.0125000
NODE_4206_length_1166_cov_313.815370	444	524	76	2	80	0.0250000
NODE_4206_length_1166_cov_313.815370	444	524	79	3	80	0.0375000
NODE_4206_length_1166_cov_313.815370	444	524	81	1	80	0.0125000
NODE_4206_length_1166_cov_313.815370	444	524	83	4	80	0.0500000
NODE_4206_length_1166_cov_313.815370	444	524	86	1	80	0.0125000
NODE_4206_length_1166_cov_313.815370	444	524	88	1	80	0.0125000
NODE_4206_length_1166_cov_313.815370	444	524	89	2	80	0.0250000
NODE_4206_length_1166_cov_313.815370	444	524	90	3	80	0.0375000
NODE_4206_length_1166_cov_313.815370	444	524	91	5	80	0.0625000
NODE_4206_length_1166_cov_313.815370	444	524	92	1	80	0.0125000
NODE_4206_length_1166_cov_313.815370	444	524	93	9	80	0.1125000
NODE_4206_length_1166_cov_313.815370	444	524	94	4	80	0.0500000
NODE_4206_length_1166_cov_313.815370	444	524	95	2	80	0.0250000
NODE_4206_length_1166_cov_313.815370	444	524	96	5	80	0.0625000
NODE_4206_length_1166_cov_313.815370	497	577	79	2	80	0.0250000
NODE_4206_length_1166_cov_313.815370	497	577	80	3	80	0.0375000
NODE_4206_length_1166_cov_313.815370	497	577	82	4	80	0.0500000
NODE_4206_length_1166_cov_313.815370	497	577	83	5	80	0.0625000
NODE_4206_length_1166_cov_313.815370	497	577	84	12	80	0.1500000
NODE_4206_length_1166_cov_313.815370	497	577	85	6	80	0.0750000
NODE_4206_length_1166_cov_313.815370	497	577	86	2	80	0.0250000
NODE_4206_length_1166_cov_313.815370	497	577	89	6	80	0.0750000
NODE_4206_length_1166_cov_313.815370	497	577	90	8	80	0.1000000
NODE_4206_length_1166_cov_313.815370	497	577	91	7	80	0.0875000
NODE_4206_length_1166_cov_313.815370	497	577	92	5	80	0.0625000
NODE_4206_length_1166_cov_313.815370	497	577	93	9	80	0.1125000
NODE_4206_length_1166_cov_313.815370	497	577	94	4	80	0.0500000
NODE_4206_length_1166_cov_313.815370	497	577	95	2	80	0.0250000
NODE_4206_length_1166_cov_313.815370	497	577	96	5	80	0.0625000
NODE_4206_length_1166_cov_313.815370	497	577	79	2	80	0.0250000
NODE_4206_length_1166_cov_313.815370	497	577	80	3	80	0.0375000
NODE_4206_length_1166_cov_313.815370	497	577	82	4	80	0.0500000
NODE_4206_length_1166_cov_313.815370	497	577	83	5	80	0.0625000
NODE_4206_length_1166_cov_313.815370	497	577	84	12	80	0.1500000
NODE_4206_length_1166_cov_313.815370	497	577	85	6	80	0.0750000
NODE_4206_length_1166_cov_313.815370	497	577	86	2	80	0.0250000
NODE_4206_length_1166_cov_313.815370	497	577	89	6	80	0.0750000
NODE_4206_length_1166_cov_313.815370	497	577	90	8	80	0.1000000
NODE_4206_length_1166_cov_313.815370	497	577	91	7	80	0.0875000
NODE_4206_length_1166_cov_313.815370	497	577	92	5	80	0.0625000
NODE_4206_length_1166_cov_313.815370	497	577	93	9	80	0.1125000
NODE_4206_length_1166_cov_313.815370	497	577	94	4	80	0.0500000
NODE_4206_length_1166_cov_313.815370	497	577	95	2	80	0.0250000
NODE_4206_length_1166_cov_313.815370	497	577	96	5	80	0.0625000
NODE_4206_length_1166_cov_313.815370	497	577	79	2	80	0.0250000
NODE_4206_length_1166_cov_313.815370	497	577	80	3	80	0.0375000
NODE_4206_length_1166_cov_313.815370	497	577	82	4	80	0.0500000
NODE_4206_length_1166_cov_313.815370	497	577	83	5	80	0.0625000
NODE_4206_length_1166_cov_313.815370	497	577	84	12	80	0.1500000
NODE_4206_length_1166_cov_313.815370	497	577	85	6	80	0.0750000
NODE_4206_length_1166_cov_313.815370	497	577	86	2	80	0.0250000
NODE_4206_length_1166_cov_313.815370	497	577	89	6	80	0.0750000
NODE_4206_length_1166_cov_313.815370	497	577	90	8	80	0.1000000
NODE_4206_length_1166_cov_313.815370	497	577	91	7	80	0.0875000
NODE_4206_length_1166_cov_313.815370	497	577	92	5	80	0.0625000
NODE_4206_length_1166_cov_313.815370	497	577	93	9	80	0.1125000
NODE_4206_length_1166_cov_313.815370	497	577	94	4	80	0.0500000
NODE_4206_length_1166_cov_313.815370	497	577	95	2	80	0.0250000
NODE_4206_length_1166_cov_313.815370	497	577	96	5	80	0.0625000
NODE_4206_length_1166_cov_313.815370	497	577	79	2	80	0.0250000
NODE_4206_length_1166_cov_313.815370	497	577	80	3	80	0.0375000
NODE_4206_length_1166_cov_313.815370	497	577	82	4	80	0.0500000
NODE_4206_length_1166_cov_313.815370	497	577	83	5	80	0.0625000
NODE_4206_length_1166_cov_313.815370	497	577	84	12	80	0.1500000
NODE_4206_length_1166_cov_313.815370	497	577	85	6	80	0.0750000
NODE_4206_length_1166_cov_313.815370	497	577	86	2	80	0.0250000
NODE_4206_length_1166_cov_313.815370	497	577	89	6	80	0.0750000
NODE_4206_length_1166_cov_313.815370	497	577	90	8	80	0.1000000
NODE_4206_length_1166_cov_313.815370	497	577	91	7	80	0.0875000
NODE_4206_length_1166_cov_313.815370	497	577	92	5	80	0.0625000
NODE_4206_length_1166_cov_313.815370	497	577	93	9	80	0.1125000
NODE_4206_length_1166_cov_313.815370	497	577	94	4	80	0.0500000
NODE_4206_length_1166_cov_313.815370	497	577	95	2	80	0.0250000
NODE_4206_length_1166_cov_313.815370	497	577	96	5	80	0.0625000
NODE_4206_length_1166_cov_313.815370	497	577	79	2	80	0.0250000
NODE_4206_length_1166_cov_313.815370	497	577	80	3	80	0.0375000
NODE_4206_length_1166_cov_313.815370	497	577	82	4	80	0.0500000
NODE_4206_length_1166_cov_313.815370	497	577	83	5	80	0.0625000
NODE_4206_length_1166_cov_313.815370	497	577	84	12	80	0.1500000
NODE_4206_length_1166_cov_313.815370	497	577	85	6	80	0.0750000
NODE_4206_length_1166_cov_313.815370	497	577	86	2	80	0.0250000
NODE_4206_length_1166_cov_313.815370	497	577	89	6	80	0.0750000
NODE_4206_length_1166_cov_313.815370	497	577	90	8	80	0.1000000
NODE_4206_length_1166_cov_313.815370	497	577	91	7	80	0.0875000
NODE_4206_length_1166_cov_313.815370	497	577	92	5	80	0.0625000
NODE_4206_length_1166_cov_313.815370	497	577	93	9	80	0.1125000
NODE_4206_length_1166_cov_313.815370	497	577	94	4	80	0.0500000
NODE_4206_length_1166_cov_313.815370	497	577	95	2	80	0.0250000
NODE_4206_length_1166_cov_313.815370	497	577	96	5	80	0.0625000
NODE_4206_length_1166_cov_313.815370	497	577	79	2	80	0.0250000
NODE_4206_length_1166_cov_313.815370	497	577	80	3	80	0.0375000
NODE_4206_length_1166_cov_313.815370	497	577	82	4	80	0.0500000
NODE_4206_length_1166_cov_313.815370	497	577	83	5	80	0.0625000
NODE_4206_length_1166_cov_313.815370	497	577	84	12	80	0.1500000
NODE_4206_length_1166_cov_313.815370	497	577	85	6	80	0.0750000
NODE_4206_length_1166_cov_313.815370	497	577	86	2	80	0.0250000
NODE_4206_length_1166_cov_313.815370	497	577	89	6	80	0.0750000
NODE_4206_length_1166_cov_313.815370	497	577	90	8	80	0.1000000
NODE_4206_length_1166_cov_313.815370	497	577	91	7	80	0.0875000
NODE_4206_length_1166_cov_313.815370	497	577	92	5	80	0.0625000
NODE_4206_length_1166_cov_313.815370	497	577	93	9	80	0.1125000
NODE_4206_length_1166_cov_313.815370	497	577	94	4	80	0.0500000
NODE_4206_length_1166_cov_313.815370	497	577	95	2	80	0.0250000
NODE_4206_length_1166_cov_313.815370	497	577	96	5	80	0.0625000
NODE_4206_length_1166_cov_313.815370	497	568	83	5	71	0.0704225
NODE_4206_length_1166_cov_313.815370	497	568	84	12	71	0.1690141
NODE_4206_length_1166_cov_313.815370	497	568	85	6	71	0.0845070
NODE_4206_length_1166_cov_313.815370	497	568	86	2	71	0.0281690
NODE_4206_length_1166_cov_313.815370	497	568	89	6	71	0.0845070
NODE_4206_length_1166_cov_313.815370	497	568	90	8	71	0.1126761
NODE_4206_length_1166_cov_313.815370	497	568	91	7	71	0.0985916
NODE_4206_length_1166_cov_313.815370	497	568	92	5	71	0.0704225
NODE_4206_length_1166_cov_313.815370	497	568	93	9	71	0.1267606
NODE_4206_length_1166_cov_313.815370	497	568	94	4	71	0.0563380
NODE_4206_length_1166_cov_313.815370	497	568	95	2	71	0.0281690
NODE_4206_length_1166_cov_313.815370	497	568	96	5	71	0.0704225
NODE_4206_length_1166_cov_313.815370	500	570	82	2	70	0.0285714
NODE_4206_length_1166_cov_313.815370	500	570	83	5	70	0.0714286
NODE_4206_length_1166_cov_313.815370	500	570	84	12	70	0.1714286
NODE_4206_length_1166_cov_313.815370	500	570	85	6	70	0.0857143
NODE_4206_length_1166_cov_313.815370	500	570	86	2	70	0.0285714
NODE_4206_length_1166_cov_313.815370	500	570	89	6	70	0.0857143
NODE_4206_length_1166_cov_313.815370	500	570	90	8	70	0.1142857
NODE_4206_length_1166_cov_313.815370	500	570	91	6	70	0.0857143
NODE_4206_length_1166_cov_313.815370	500	570	92	5	70	0.0714286
NODE_4206_length_1166_cov_313.815370	500	570	93	7	70	0.1000000
NODE_4206_length_1166_cov_313.815370	500	570	94	4	70	0.0571429
NODE_4206_length_1166_cov_313.815370	500	570	95	2	70	0.0285714
NODE_4206_length_1166_cov_313.815370	500	570	96	5	70	0.0714286
NODE_4206_length_1166_cov_313.815370	997	1077	6	16	80	0.2000000
NODE_4206_length_1166_cov_313.815370	997	1077	7	3	80	0.0375000
NODE_4206_length_1166_cov_313.815370	997	1077	8	31	80	0.3875000
NODE_4206_length_1166_cov_313.815370	997	1077	9	30	80	0.3750000
NODE_4206_length_1166_cov_313.815370	1050	1130	4	4	80	0.0500000
NODE_4206_length_1166_cov_313.815370	1050	1130	5	2	80	0.0250000
NODE_4206_length_1166_cov_313.815370	1050	1130	6	15	80	0.1875000
NODE_4206_length_1166_cov_313.815370	1050	1130	7	34	80	0.4250000
NODE_4206_length_1166_cov_313.815370	1050	1130	8	17	80	0.2125000
NODE_4206_length_1166_cov_313.815370	1050	1130	9	8	80	0.1000000
NODE_4206_length_1166_cov_313.815370	1050	1130	4	4	80	0.0500000
NODE_4206_length_1166_cov_313.815370	1050	1130	5	2	80	0.0250000
NODE_4206_length_1166_cov_313.815370	1050	1130	6	15	80	0.1875000
NODE_4206_length_1166_cov_313.815370	1050	1130	7	34	80	0.4250000
NODE_4206_length_1166_cov_313.815370	1050	1130	8	17	80	0.2125000
NODE_4206_length_1166_cov_313.815370	1050	1130	9	8	80	0.1000000
NODE_4206_length_1166_cov_313.815370	1050	1121	6	12	71	0.1690141
NODE_4206_length_1166_cov_313.815370	1050	1121	7	34	71	0.4788733
NODE_4206_length_1166_cov_313.815370	1050	1121	8	17	71	0.2394366
NODE_4206_length_1166_cov_313.815370	1050	1121	9	8	71	0.1126761
NODE_4207_length_1166_cov_25.107779	561	641	2	80	80	1.0000000
NODE_4207_length_1166_cov_25.107779	614	694	2	42	80	0.5250000
NODE_4207_length_1166_cov_25.107779	614	694	3	38	80	0.4750000
NODE_4209_length_1166_cov_18.820056	325	405	2	80	80	1.0000000
NODE_4209_length_1166_cov_18.820056	378	458	2	36	80	0.4500000
NODE_4209_length_1166_cov_18.820056	378	458	3	14	80	0.1750000
NODE_4209_length_1166_cov_18.820056	378	458	4	30	80	0.3750000
NODE_4210_length_1166_cov_18.404873	676	756	5	28	80	0.3500000
NODE_4210_length_1166_cov_18.404873	676	756	6	52	80	0.6500000
NODE_4210_length_1166_cov_18.404873	729	809	4	18	80	0.2250000
NODE_4210_length_1166_cov_18.404873	729	809	5	57	80	0.7125000
NODE_4210_length_1166_cov_18.404873	729	809	6	5	80	0.0625000
NODE_4214_length_1166_cov_1.893158	0	71	0	71	71	1.0000000
NODE_4214_length_1166_cov_1.893158	44	99	0	55	55	1.0000000
NODE_4218_length_1165_cov_29.402439	497	577	3	18	80	0.2250000
NODE_4218_length_1165_cov_29.402439	497	577	4	62	80	0.7750000
NODE_4218_length_1165_cov_29.402439	550	630	1	35	80	0.4375000
NODE_4218_length_1165_cov_29.402439	550	630	2	12	80	0.1500000
NODE_4218_length_1165_cov_29.402439	550	630	3	17	80	0.2125000
NODE_4218_length_1165_cov_29.402439	550	630	4	16	80	0.2000000
NODE_4218_length_1165_cov_29.402439	626	706	0	13	80	0.1625000
NODE_4218_length_1165_cov_29.402439	626	706	1	67	80	0.8375000
NODE_4218_length_1165_cov_29.402439	679	759	0	16	80	0.2000000
NODE_4218_length_1165_cov_29.402439	679	759	1	64	80	0.8000000
NODE_4219_length_1165_cov_28.366792	663	743	1	3	80	0.0375000
NODE_4219_length_1165_cov_28.366792	663	743	3	12	80	0.1500000
NODE_4219_length_1165_cov_28.366792	663	743	4	24	80	0.3000000
NODE_4219_length_1165_cov_28.366792	663	743	5	41	80	0.5125000
NODE_4219_length_1165_cov_28.366792	716	796	3	2	80	0.0250000
NODE_4219_length_1165_cov_28.366792	716	796	4	1	80	0.0125000
NODE_4219_length_1165_cov_28.366792	716	796	5	44	80	0.5500000
NODE_4219_length_1165_cov_28.366792	716	796	6	33	80	0.4125000
NODE_4220_length_1165_cov_23.841463	631	711	0	62	80	0.7750000
NODE_4220_length_1165_cov_23.841463	631	711	1	1	80	0.0125000
NODE_4220_length_1165_cov_23.841463	631	711	2	17	80	0.2125000
NODE_4220_length_1165_cov_23.841463	684	765	0	9	81	0.1111111
NODE_4220_length_1165_cov_23.841463	684	765	1	1	81	0.0123457
NODE_4220_length_1165_cov_23.841463	684	765	2	33	81	0.4074074
NODE_4220_length_1165_cov_23.841463	684	765	3	38	81	0.4691358
NODE_4220_length_1165_cov_23.841463	761	841	3	40	80	0.5000000
NODE_4220_length_1165_cov_23.841463	761	841	5	40	80	0.5000000
NODE_4220_length_1165_cov_23.841463	814	894	2	16	80	0.2000000
NODE_4220_length_1165_cov_23.841463	814	894	3	33	80	0.4125000
NODE_4220_length_1165_cov_23.841463	814	894	4	1	80	0.0125000
NODE_4220_length_1165_cov_23.841463	814	894	5	30	80	0.3750000
NODE_4221_length_1165_cov_21.883677	482	562	2	70	80	0.8750000
NODE_4221_length_1165_cov_21.883677	482	562	3	10	80	0.1250000
NODE_4221_length_1165_cov_21.883677	535	615	1	17	80	0.2125000
NODE_4221_length_1165_cov_21.883677	535	615	2	53	80	0.6625000
NODE_4221_length_1165_cov_21.883677	535	615	3	10	80	0.1250000
NODE_4222_length_1165_cov_14.591932	295	375	0	8	80	0.1000000
NODE_4222_length_1165_cov_14.591932	295	375	2	72	80	0.9000000
NODE_4222_length_1165_cov_14.591932	348	428	0	61	80	0.7625000
NODE_4222_length_1165_cov_14.591932	348	428	2	19	80	0.2375000
NODE_4223_length_1165_cov_13.683865	502	582	1	41	80	0.5125000
NODE_4223_length_1165_cov_13.683865	502	582	2	39	80	0.4875000
NODE_4223_length_1165_cov_13.683865	555	635	1	36	80	0.4500000
NODE_4223_length_1165_cov_13.683865	555	635	2	44	80	0.5500000
NODE_4224_length_1165_cov_7.915572	383	463	7	26	80	0.3250000
NODE_4224_length_1165_cov_7.915572	383	463	9	54	80	0.6750000
NODE_4224_length_1165_cov_7.915572	436	516	0	3	80	0.0375000
NODE_4224_length_1165_cov_7.915572	436	516	1	6	80	0.0750000
NODE_4224_length_1165_cov_7.915572	436	516	2	5	80	0.0625000
NODE_4224_length_1165_cov_7.915572	436	516	3	12	80	0.1500000
NODE_4224_length_1165_cov_7.915572	436	516	4	2	80	0.0250000
NODE_4224_length_1165_cov_7.915572	436	516	5	8	80	0.1000000
NODE_4224_length_1165_cov_7.915572	436	516	7	43	80	0.5375000
NODE_4224_length_1165_cov_7.915572	436	516	9	1	80	0.0125000
NODE_4225_length_1165_cov_7.466229	552	632	0	80	80	1.0000000
NODE_4225_length_1165_cov_7.466229	605	685	0	80	80	1.0000000
NODE_4226_length_1165_cov_5.617261	676	756	0	80	80	1.0000000
NODE_4226_length_1165_cov_5.617261	729	809	0	80	80	1.0000000
NODE_4227_length_1165_cov_3.658537	554	602	1	47	48	0.9791667
NODE_4227_length_1165_cov_3.658537	554	602	2	1	48	0.0208333
NODE_4233_length_1164_cov_55.273239	459	539	3	1	80	0.0125000
NODE_4233_length_1164_cov_55.273239	459	539	5	7	80	0.0875000
NODE_4233_length_1164_cov_55.273239	459	539	7	2	80	0.0250000
NODE_4233_length_1164_cov_55.273239	459	539	8	27	80	0.3375000
NODE_4233_length_1164_cov_55.273239	459	539	9	1	80	0.0125000
NODE_4233_length_1164_cov_55.273239	459	539	10	12	80	0.1500000
NODE_4233_length_1164_cov_55.273239	459	539	11	18	80	0.2250000
NODE_4233_length_1164_cov_55.273239	459	539	13	12	80	0.1500000
NODE_4233_length_1164_cov_55.273239	512	592	11	15	80	0.1875000
NODE_4233_length_1164_cov_55.273239	512	592	13	19	80	0.2375000
NODE_4233_length_1164_cov_55.273239	512	592	14	46	80	0.5750000
NODE_4234_length_1164_cov_44.183099	571	651	5	14	80	0.1750000
NODE_4234_length_1164_cov_44.183099	571	651	6	32	80	0.4000000
NODE_4234_length_1164_cov_44.183099	571	651	7	30	80	0.3750000
NODE_4234_length_1164_cov_44.183099	571	651	8	4	80	0.0500000
NODE_4234_length_1164_cov_44.183099	624	704	5	15	80	0.1875000
NODE_4234_length_1164_cov_44.183099	624	704	6	15	80	0.1875000
NODE_4234_length_1164_cov_44.183099	624	704	7	27	80	0.3375000
NODE_4234_length_1164_cov_44.183099	624	704	8	23	80	0.2875000
NODE_4234_length_1164_cov_44.183099	700	780	5	59	80	0.7375000
NODE_4234_length_1164_cov_44.183099	700	780	6	3	80	0.0375000
NODE_4234_length_1164_cov_44.183099	700	780	7	18	80	0.2250000
NODE_4234_length_1164_cov_44.183099	753	833	2	32	80	0.4000000
NODE_4234_length_1164_cov_44.183099	753	833	3	10	80	0.1250000
NODE_4234_length_1164_cov_44.183099	753	833	5	30	80	0.3750000
NODE_4234_length_1164_cov_44.183099	753	833	6	8	80	0.1000000
NODE_4235_length_1164_cov_14.277934	1029	1109	0	80	80	1.0000000
NODE_4235_length_1164_cov_14.277934	1097	1162	0	65	65	1.0000000
NODE_4236_length_1164_cov_12.880751	415	495	0	80	80	1.0000000
NODE_4236_length_1164_cov_12.880751	468	548	0	80	80	1.0000000
NODE_4237_length_1164_cov_6.924883	415	495	1	10	80	0.1250000
NODE_4237_length_1164_cov_6.924883	415	495	2	65	80	0.8125000
NODE_4237_length_1164_cov_6.924883	415	495	4	5	80	0.0625000
NODE_4237_length_1164_cov_6.924883	468	548	2	22	80	0.2750000
NODE_4237_length_1164_cov_6.924883	468	548	3	40	80	0.5000000
NODE_4237_length_1164_cov_6.924883	468	548	4	18	80	0.2250000
NODE_4245_length_1163_cov_36.315789	458	538	2	80	80	1.0000000
NODE_4245_length_1163_cov_36.315789	511	591	2	69	80	0.8625000
NODE_4245_length_1163_cov_36.315789	511	591	3	11	80	0.1375000
NODE_4245_length_1163_cov_36.315789	587	667	1	6	80	0.0750000
NODE_4245_length_1163_cov_36.315789	587	667	2	4	80	0.0500000
NODE_4245_length_1163_cov_36.315789	587	667	3	15	80	0.1875000
NODE_4245_length_1163_cov_36.315789	587	667	5	2	80	0.0250000
NODE_4245_length_1163_cov_36.315789	587	667	6	53	80	0.6625000
NODE_4245_length_1163_cov_36.315789	640	720	5	22	80	0.2750000
NODE_4245_length_1163_cov_36.315789	640	720	6	58	80	0.7250000
NODE_4246_length_1163_cov_29.466165	542	622	6	13	80	0.1625000
NODE_4246_length_1163_cov_29.466165	542	622	8	2	80	0.0250000
NODE_4246_length_1163_cov_29.466165	542	622	9	1	80	0.0125000
NODE_4246_length_1163_cov_29.466165	542	622	10	64	80	0.8000000
NODE_4246_length_1163_cov_29.466165	595	675	0	8	80	0.1000000
NODE_4246_length_1163_cov_29.466165	595	675	3	1	80	0.0125000
NODE_4246_length_1163_cov_29.466165	595	675	4	44	80	0.5500000
NODE_4246_length_1163_cov_29.466165	595	675	6	11	80	0.1375000
NODE_4246_length_1163_cov_29.466165	595	675	8	2	80	0.0250000
NODE_4246_length_1163_cov_29.466165	595	675	10	14	80	0.1750000
NODE_4246_length_1163_cov_29.466165	671	751	0	23	80	0.2875000
NODE_4246_length_1163_cov_29.466165	671	751	2	42	80	0.5250000
NODE_4246_length_1163_cov_29.466165	671	751	3	15	80	0.1875000
NODE_4246_length_1163_cov_29.466165	724	804	2	12	80	0.1500000
NODE_4246_length_1163_cov_29.466165	724	804	3	68	80	0.8500000
NODE_4247_length_1163_cov_15.107143	668	748	0	80	80	1.0000000
NODE_4247_length_1163_cov_15.107143	721	801	0	80	80	1.0000000
NODE_4248_length_1163_cov_14.347744	540	620	2	54	80	0.6750000
NODE_4248_length_1163_cov_14.347744	540	620	3	1	80	0.0125000
NODE_4248_length_1163_cov_14.347744	540	620	4	25	80	0.3125000
NODE_4248_length_1163_cov_14.347744	593	673	2	18	80	0.2250000
NODE_4248_length_1163_cov_14.347744	593	673	3	15	80	0.1875000
NODE_4248_length_1163_cov_14.347744	593	673	4	47	80	0.5875000
NODE_4249_length_1163_cov_11.650376	354	434	4	80	80	1.0000000
NODE_4249_length_1163_cov_11.650376	407	487	0	13	80	0.1625000
NODE_4249_length_1163_cov_11.650376	407	487	2	23	80	0.2875000
NODE_4249_length_1163_cov_11.650376	407	487	4	44	80	0.5500000
NODE_4249_length_1163_cov_11.650376	738	818	0	80	80	1.0000000
NODE_4249_length_1163_cov_11.650376	791	871	0	80	80	1.0000000
NODE_4253_length_1162_cov_30.049859	359	439	1	51	80	0.6375000
NODE_4253_length_1162_cov_30.049859	359	439	2	29	80	0.3625000
NODE_4253_length_1162_cov_30.049859	412	492	1	33	80	0.4125000
NODE_4253_length_1162_cov_30.049859	412	492	2	47	80	0.5875000
NODE_4254_length_1162_cov_25.960489	440	520	0	35	80	0.4375000
NODE_4254_length_1162_cov_25.960489	440	520	1	39	80	0.4875000
NODE_4254_length_1162_cov_25.960489	440	520	2	6	80	0.0750000
NODE_4254_length_1162_cov_25.960489	493	573	1	21	80	0.2625000
NODE_4254_length_1162_cov_25.960489	493	573	2	59	80	0.7375000
NODE_4254_length_1162_cov_25.960489	569	649	2	17	80	0.2125000
NODE_4254_length_1162_cov_25.960489	569	649	3	40	80	0.5000000
NODE_4254_length_1162_cov_25.960489	569	649	4	23	80	0.2875000
NODE_4254_length_1162_cov_25.960489	622	702	2	38	80	0.4750000
NODE_4254_length_1162_cov_25.960489	622	702	3	39	80	0.4875000
NODE_4254_length_1162_cov_25.960489	622	702	4	3	80	0.0375000
NODE_4255_length_1162_cov_24.843838	523	603	2	80	80	1.0000000
NODE_4255_length_1162_cov_24.843838	576	656	0	3	80	0.0375000
NODE_4255_length_1162_cov_24.843838	576	656	1	31	80	0.3875000
NODE_4255_length_1162_cov_24.843838	576	656	2	46	80	0.5750000
NODE_4255_length_1162_cov_24.843838	652	732	0	2	80	0.0250000
NODE_4255_length_1162_cov_24.843838	652	732	1	52	80	0.6500000
NODE_4255_length_1162_cov_24.843838	652	732	2	26	80	0.3250000
NODE_4255_length_1162_cov_24.843838	705	785	1	1	80	0.0125000
NODE_4255_length_1162_cov_24.843838	705	785	2	79	80	0.9875000
NODE_4257_length_1162_cov_17.131703	302	382	0	80	80	1.0000000
NODE_4257_length_1162_cov_17.131703	355	435	0	80	80	1.0000000
NODE_4257_length_1162_cov_17.131703	431	511	0	34	80	0.4250000
NODE_4257_length_1162_cov_17.131703	431	511	2	46	80	0.5750000
NODE_4257_length_1162_cov_17.131703	484	564	2	80	80	1.0000000
NODE_4258_length_1162_cov_14.766698	630	710	0	80	80	1.0000000
NODE_4258_length_1162_cov_14.766698	683	763	0	80	80	1.0000000
NODE_4259_length_1162_cov_13.968015	423	503	2	20	80	0.2500000
NODE_4259_length_1162_cov_13.968015	423	503	3	5	80	0.0625000
NODE_4259_length_1162_cov_13.968015	423	503	4	14	80	0.1750000
NODE_4259_length_1162_cov_13.968015	423	503	5	2	80	0.0250000
NODE_4259_length_1162_cov_13.968015	423	503	6	23	80	0.2875000
NODE_4259_length_1162_cov_13.968015	423	503	7	9	80	0.1125000
NODE_4259_length_1162_cov_13.968015	423	503	8	7	80	0.0875000
NODE_4259_length_1162_cov_13.968015	476	556	6	55	80	0.6875000
NODE_4259_length_1162_cov_13.968015	476	556	7	18	80	0.2250000
NODE_4259_length_1162_cov_13.968015	476	556	8	7	80	0.0875000
NODE_4264_length_1162_cov_1.977422	855	926	0	71	71	1.0000000
NODE_4264_length_1162_cov_1.977422	908	977	0	69	69	1.0000000
NODE_4264_length_1162_cov_1.977422	908	977	0	69	69	1.0000000
NODE_4266_length_1161_cov_33.312618	456	536	2	39	80	0.4875000
NODE_4266_length_1161_cov_33.312618	456	536	3	41	80	0.5125000
NODE_4266_length_1161_cov_33.312618	509	587	1	37	78	0.4743590
NODE_4266_length_1161_cov_33.312618	509	587	3	41	78	0.5256410
NODE_4267_length_1161_cov_30.466102	594	674	7	10	80	0.1250000
NODE_4267_length_1161_cov_30.466102	594	674	8	12	80	0.1500000
NODE_4267_length_1161_cov_30.466102	594	674	10	10	80	0.1250000
NODE_4267_length_1161_cov_30.466102	594	674	11	10	80	0.1250000
NODE_4267_length_1161_cov_30.466102	594	674	12	29	80	0.3625000
NODE_4267_length_1161_cov_30.466102	594	674	13	9	80	0.1125000
NODE_4267_length_1161_cov_30.466102	647	727	6	21	80	0.2625000
NODE_4267_length_1161_cov_30.466102	647	727	7	5	80	0.0625000
NODE_4267_length_1161_cov_30.466102	647	727	8	14	80	0.1750000
NODE_4267_length_1161_cov_30.466102	647	727	9	11	80	0.1375000
NODE_4267_length_1161_cov_30.466102	647	727	10	12	80	0.1500000
NODE_4267_length_1161_cov_30.466102	647	727	11	3	80	0.0375000
NODE_4267_length_1161_cov_30.466102	647	727	12	14	80	0.1750000
NODE_4268_length_1161_cov_29.628060	426	506	0	21	80	0.2625000
NODE_4268_length_1161_cov_29.628060	426	506	1	59	80	0.7375000
NODE_4268_length_1161_cov_29.628060	479	559	1	40	80	0.5000000
NODE_4268_length_1161_cov_29.628060	479	559	2	40	80	0.5000000
NODE_4268_length_1161_cov_29.628060	603	683	3	33	80	0.4125000
NODE_4268_length_1161_cov_29.628060	603	683	5	34	80	0.4250000
NODE_4268_length_1161_cov_29.628060	603	683	6	13	80	0.1625000
NODE_4268_length_1161_cov_29.628060	656	736	3	25	80	0.3125000
NODE_4268_length_1161_cov_29.628060	656	736	5	42	80	0.5250000
NODE_4268_length_1161_cov_29.628060	656	736	6	13	80	0.1625000
NODE_4269_length_1161_cov_22.923729	492	572	0	25	80	0.3125000
NODE_4269_length_1161_cov_22.923729	492	572	1	30	80	0.3750000
NODE_4269_length_1161_cov_22.923729	492	572	2	10	80	0.1250000
NODE_4269_length_1161_cov_22.923729	492	572	3	15	80	0.1875000
NODE_4269_length_1161_cov_22.923729	545	625	1	2	80	0.0250000
NODE_4269_length_1161_cov_22.923729	545	625	2	10	80	0.1250000
NODE_4269_length_1161_cov_22.923729	545	625	3	25	80	0.3125000
NODE_4269_length_1161_cov_22.923729	545	625	4	43	80	0.5375000
NODE_4269_length_1161_cov_22.923729	621	701	2	5	80	0.0625000
NODE_4269_length_1161_cov_22.923729	621	701	3	29	80	0.3625000
NODE_4269_length_1161_cov_22.923729	621	701	4	46	80	0.5750000
NODE_4269_length_1161_cov_22.923729	674	754	1	43	80	0.5375000
NODE_4269_length_1161_cov_22.923729	674	754	2	15	80	0.1875000
NODE_4269_length_1161_cov_22.923729	674	754	3	22	80	0.2750000
NODE_4270_length_1161_cov_20.184557	480	560	1	63	80	0.7875000
NODE_4270_length_1161_cov_20.184557	480	560	2	14	80	0.1750000
NODE_4270_length_1161_cov_20.184557	480	560	3	3	80	0.0375000
NODE_4270_length_1161_cov_20.184557	533	613	1	24	80	0.3000000
NODE_4270_length_1161_cov_20.184557	533	613	3	56	80	0.7000000
NODE_4271_length_1161_cov_17.437853	375	455	2	48	80	0.6000000
NODE_4271_length_1161_cov_17.437853	375	455	4	32	80	0.4000000
NODE_4271_length_1161_cov_17.437853	428	508	0	9	80	0.1125000
NODE_4271_length_1161_cov_17.437853	428	508	2	5	80	0.0625000
NODE_4271_length_1161_cov_17.437853	428	508	4	66	80	0.8250000
NODE_4272_length_1161_cov_14.062147	375	455	0	80	80	1.0000000
NODE_4272_length_1161_cov_14.062147	428	508	0	80	80	1.0000000
NODE_4273_length_1161_cov_12.304143	381	461	0	80	80	1.0000000
NODE_4273_length_1161_cov_12.304143	434	514	0	80	80	1.0000000
NODE_4274_length_1161_cov_10.297552	598	678	0	45	80	0.5625000
NODE_4274_length_1161_cov_10.297552	598	678	1	35	80	0.4375000
NODE_4274_length_1161_cov_10.297552	651	731	0	42	80	0.5250000
NODE_4274_length_1161_cov_10.297552	651	731	2	38	80	0.4750000
NODE_4283_length_1160_cov_86.515551	613	693	7	10	80	0.1250000
NODE_4283_length_1160_cov_86.515551	613	693	8	3	80	0.0375000
NODE_4283_length_1160_cov_86.515551	613	693	9	3	80	0.0375000
NODE_4283_length_1160_cov_86.515551	613	693	10	18	80	0.2250000
NODE_4283_length_1160_cov_86.515551	613	693	11	33	80	0.4125000
NODE_4283_length_1160_cov_86.515551	613	693	12	13	80	0.1625000
NODE_4283_length_1160_cov_86.515551	666	746	7	10	80	0.1250000
NODE_4283_length_1160_cov_86.515551	666	746	8	10	80	0.1250000
NODE_4283_length_1160_cov_86.515551	666	746	9	17	80	0.2125000
NODE_4283_length_1160_cov_86.515551	666	746	10	21	80	0.2625000
NODE_4283_length_1160_cov_86.515551	666	746	11	11	80	0.1375000
NODE_4283_length_1160_cov_86.515551	666	746	12	11	80	0.1375000
NODE_4284_length_1160_cov_29.272385	526	606	0	39	80	0.4875000
NODE_4284_length_1160_cov_29.272385	526	606	1	41	80	0.5125000
NODE_4284_length_1160_cov_29.272385	579	659	1	41	80	0.5125000
NODE_4284_length_1160_cov_29.272385	579	659	2	39	80	0.4875000
NODE_4285_length_1160_cov_21.391140	767	847	2	2	80	0.0250000
NODE_4285_length_1160_cov_21.391140	767	847	3	40	80	0.5000000
NODE_4285_length_1160_cov_21.391140	767	847	4	36	80	0.4500000
NODE_4285_length_1160_cov_21.391140	767	847	5	2	80	0.0250000
NODE_4296_length_1159_cov_147.794340	911	991	175	1	80	0.0125000
NODE_4296_length_1159_cov_147.794340	911	991	177	2	80	0.0250000
NODE_4296_length_1159_cov_147.794340	911	991	180	3	80	0.0375000
NODE_4296_length_1159_cov_147.794340	911	991	181	3	80	0.0375000
NODE_4296_length_1159_cov_147.794340	911	991	182	2	80	0.0250000
NODE_4296_length_1159_cov_147.794340	911	991	183	2	80	0.0250000
NODE_4296_length_1159_cov_147.794340	911	991	184	3	80	0.0375000
NODE_4296_length_1159_cov_147.794340	911	991	186	3	80	0.0375000
NODE_4296_length_1159_cov_147.794340	911	991	189	2	80	0.0250000
NODE_4296_length_1159_cov_147.794340	911	991	191	1	80	0.0125000
NODE_4296_length_1159_cov_147.794340	911	991	192	1	80	0.0125000
NODE_4296_length_1159_cov_147.794340	911	991	193	2	80	0.0250000
NODE_4296_length_1159_cov_147.794340	911	991	194	4	80	0.0500000
NODE_4296_length_1159_cov_147.794340	911	991	195	2	80	0.0250000
NODE_4296_length_1159_cov_147.794340	911	991	196	3	80	0.0375000
NODE_4296_length_1159_cov_147.794340	911	991	197	1	80	0.0125000
NODE_4296_length_1159_cov_147.794340	911	991	200	1	80	0.0125000
NODE_4296_length_1159_cov_147.794340	911	991	201	2	80	0.0250000
NODE_4296_length_1159_cov_147.794340	911	991	202	7	80	0.0875000
NODE_4296_length_1159_cov_147.794340	911	991	203	3	80	0.0375000
NODE_4296_length_1159_cov_147.794340	911	991	204	6	80	0.0750000
NODE_4296_length_1159_cov_147.794340	911	991	205	1	80	0.0125000
NODE_4296_length_1159_cov_147.794340	911	991	206	4	80	0.0500000
NODE_4296_length_1159_cov_147.794340	911	991	207	5	80	0.0625000
NODE_4296_length_1159_cov_147.794340	911	991	208	4	80	0.0500000
NODE_4296_length_1159_cov_147.794340	911	991	209	7	80	0.0875000
NODE_4296_length_1159_cov_147.794340	911	991	210	3	80	0.0375000
NODE_4296_length_1159_cov_147.794340	911	991	211	1	80	0.0125000
NODE_4296_length_1159_cov_147.794340	911	991	213	1	80	0.0125000
NODE_4296_length_1159_cov_147.794340	964	1044	130	2	80	0.0250000
NODE_4296_length_1159_cov_147.794340	964	1044	132	2	80	0.0250000
NODE_4296_length_1159_cov_147.794340	964	1044	135	2	80	0.0250000
NODE_4296_length_1159_cov_147.794340	964	1044	137	2	80	0.0250000
NODE_4296_length_1159_cov_147.794340	964	1044	142	1	80	0.0125000
NODE_4296_length_1159_cov_147.794340	964	1044	145	1	80	0.0125000
NODE_4296_length_1159_cov_147.794340	964	1044	147	1	80	0.0125000
NODE_4296_length_1159_cov_147.794340	964	1044	152	1	80	0.0125000
NODE_4296_length_1159_cov_147.794340	964	1044	157	2	80	0.0250000
NODE_4296_length_1159_cov_147.794340	964	1044	158	1	80	0.0125000
NODE_4296_length_1159_cov_147.794340	964	1044	161	2	80	0.0250000
NODE_4296_length_1159_cov_147.794340	964	1044	169	1	80	0.0125000
NODE_4296_length_1159_cov_147.794340	964	1044	171	1	80	0.0125000
NODE_4296_length_1159_cov_147.794340	964	1044	174	1	80	0.0125000
NODE_4296_length_1159_cov_147.794340	964	1044	178	1	80	0.0125000
NODE_4296_length_1159_cov_147.794340	964	1044	179	2	80	0.0250000
NODE_4296_length_1159_cov_147.794340	964	1044	180	1	80	0.0125000
NODE_4296_length_1159_cov_147.794340	964	1044	182	4	80	0.0500000
NODE_4296_length_1159_cov_147.794340	964	1044	183	5	80	0.0625000
NODE_4296_length_1159_cov_147.794340	964	1044	185	2	80	0.0250000
NODE_4296_length_1159_cov_147.794340	964	1044	186	3	80	0.0375000
NODE_4296_length_1159_cov_147.794340	964	1044	189	1	80	0.0125000
NODE_4296_length_1159_cov_147.794340	964	1044	191	1	80	0.0125000
NODE_4296_length_1159_cov_147.794340	964	1044	194	3	80	0.0375000
NODE_4296_length_1159_cov_147.794340	964	1044	195	4	80	0.0500000
NODE_4296_length_1159_cov_147.794340	964	1044	199	1	80	0.0125000
NODE_4296_length_1159_cov_147.794340	964	1044	202	5	80	0.0625000
NODE_4296_length_1159_cov_147.794340	964	1044	203	2	80	0.0250000
NODE_4296_length_1159_cov_147.794340	964	1044	204	5	80	0.0625000
NODE_4296_length_1159_cov_147.794340	964	1044	205	1	80	0.0125000
NODE_4296_length_1159_cov_147.794340	964	1044	206	3	80	0.0375000
NODE_4296_length_1159_cov_147.794340	964	1044	207	3	80	0.0375000
NODE_4296_length_1159_cov_147.794340	964	1044	208	3	80	0.0375000
NODE_4296_length_1159_cov_147.794340	964	1044	209	6	80	0.0750000
NODE_4296_length_1159_cov_147.794340	964	1044	210	2	80	0.0250000
NODE_4296_length_1159_cov_147.794340	964	1044	211	1	80	0.0125000
NODE_4296_length_1159_cov_147.794340	964	1044	213	1	80	0.0125000
NODE_4297_length_1159_cov_57.566981	457	537	1	1	80	0.0125000
NODE_4297_length_1159_cov_57.566981	457	537	2	74	80	0.9250000
NODE_4297_length_1159_cov_57.566981	457	537	3	5	80	0.0625000
NODE_4297_length_1159_cov_57.566981	510	590	1	54	80	0.6750000
NODE_4297_length_1159_cov_57.566981	510	590	2	26	80	0.3250000
NODE_4297_length_1159_cov_57.566981	586	666	0	12	80	0.1500000
NODE_4297_length_1159_cov_57.566981	586	666	1	16	80	0.2000000
NODE_4297_length_1159_cov_57.566981	586	666	2	19	80	0.2375000
NODE_4297_length_1159_cov_57.566981	586	666	3	33	80	0.4125000
NODE_4297_length_1159_cov_57.566981	639	719	1	14	80	0.1750000
NODE_4297_length_1159_cov_57.566981	639	719	3	66	80	0.8250000
NODE_4298_length_1159_cov_44.053774	329	409	1	17	80	0.2125000
NODE_4298_length_1159_cov_44.053774	329	409	2	63	80	0.7875000
NODE_4298_length_1159_cov_44.053774	382	462	2	68	80	0.8500000
NODE_4298_length_1159_cov_44.053774	382	462	3	12	80	0.1500000
NODE_4298_length_1159_cov_44.053774	458	538	2	31	80	0.3875000
NODE_4298_length_1159_cov_44.053774	458	538	3	35	80	0.4375000
NODE_4298_length_1159_cov_44.053774	458	538	4	14	80	0.1750000
NODE_4298_length_1159_cov_44.053774	511	591	3	13	80	0.1625000
NODE_4298_length_1159_cov_44.053774	511	591	4	28	80	0.3500000
NODE_4298_length_1159_cov_44.053774	511	591	5	39	80	0.4875000
NODE_4299_length_1159_cov_40.194340	391	471	2	7	80	0.0875000
NODE_4299_length_1159_cov_40.194340	391	471	3	52	80	0.6500000
NODE_4299_length_1159_cov_40.194340	391	471	4	21	80	0.2625000
NODE_4299_length_1159_cov_40.194340	444	524	2	56	80	0.7000000
NODE_4299_length_1159_cov_40.194340	444	524	3	3	80	0.0375000
NODE_4299_length_1159_cov_40.194340	444	524	4	21	80	0.2625000
NODE_4301_length_1159_cov_25.919811	456	536	2	3	80	0.0375000
NODE_4301_length_1159_cov_25.919811	456	536	3	77	80	0.9625000
NODE_4301_length_1159_cov_25.919811	509	591	1	19	82	0.2317073
NODE_4301_length_1159_cov_25.919811	509	591	2	14	82	0.1707317
NODE_4301_length_1159_cov_25.919811	509	591	3	49	82	0.5975610
NODE_4302_length_1159_cov_18.306604	538	618	2	6	80	0.0750000
NODE_4302_length_1159_cov_18.306604	538	618	3	74	80	0.9250000
NODE_4302_length_1159_cov_18.306604	591	671	1	17	80	0.2125000
NODE_4302_length_1159_cov_18.306604	591	671	2	42	80	0.5250000
NODE_4302_length_1159_cov_18.306604	591	671	3	21	80	0.2625000
NODE_4303_length_1159_cov_14.457547	358	438	1	3	80	0.0375000
NODE_4303_length_1159_cov_14.457547	358	438	2	11	80	0.1375000
NODE_4303_length_1159_cov_14.457547	358	438	3	9	80	0.1125000
NODE_4303_length_1159_cov_14.457547	358	438	4	21	80	0.2625000
NODE_4303_length_1159_cov_14.457547	358	438	5	36	80	0.4500000
NODE_4303_length_1159_cov_14.457547	411	491	4	28	80	0.3500000
NODE_4303_length_1159_cov_14.457547	411	491	5	52	80	0.6500000
NODE_4304_length_1159_cov_11.566981	625	705	2	80	80	1.0000000
NODE_4304_length_1159_cov_11.566981	678	758	2	80	80	1.0000000
NODE_4305_length_1159_cov_9.927358	278	358	0	80	80	1.0000000
NODE_4305_length_1159_cov_9.927358	331	411	0	80	80	1.0000000
NODE_4314_length_1159_cov_1.568868	513	562	5	49	49	1.0000000
NODE_4316_length_1158_cov_33.529745	357	437	0	80	80	1.0000000
NODE_4316_length_1158_cov_33.529745	410	490	0	80	80	1.0000000
NODE_4316_length_1158_cov_33.529745	486	566	0	31	80	0.3875000
NODE_4316_length_1158_cov_33.529745	486	566	2	49	80	0.6125000
NODE_4316_length_1158_cov_33.529745	539	619	2	80	80	1.0000000
NODE_4317_length_1158_cov_31.368272	416	496	1	80	80	1.0000000
NODE_4317_length_1158_cov_31.368272	469	549	0	16	80	0.2000000
NODE_4317_length_1158_cov_31.368272	469	549	1	64	80	0.8000000
NODE_4317_length_1158_cov_31.368272	545	626	0	16	81	0.1975309
NODE_4317_length_1158_cov_31.368272	545	626	1	65	81	0.8024691
NODE_4317_length_1158_cov_31.368272	599	679	1	80	80	1.0000000
NODE_4318_length_1158_cov_31.240793	430	510	1	40	80	0.5000000
NODE_4318_length_1158_cov_31.240793	430	510	2	25	80	0.3125000
NODE_4318_length_1158_cov_31.240793	430	510	3	10	80	0.1250000
NODE_4318_length_1158_cov_31.240793	430	510	5	5	80	0.0625000
NODE_4318_length_1158_cov_31.240793	483	563	2	12	80	0.1500000
NODE_4318_length_1158_cov_31.240793	483	563	3	10	80	0.1250000
NODE_4318_length_1158_cov_31.240793	483	563	5	31	80	0.3875000
NODE_4318_length_1158_cov_31.240793	483	563	6	19	80	0.2375000
NODE_4318_length_1158_cov_31.240793	483	563	7	2	80	0.0250000
NODE_4318_length_1158_cov_31.240793	483	563	8	6	80	0.0750000
NODE_4318_length_1158_cov_31.240793	559	639	4	19	80	0.2375000
NODE_4318_length_1158_cov_31.240793	559	639	5	11	80	0.1375000
NODE_4318_length_1158_cov_31.240793	559	639	6	2	80	0.0250000
NODE_4318_length_1158_cov_31.240793	559	639	8	48	80	0.6000000
NODE_4318_length_1158_cov_31.240793	612	692	1	51	80	0.6375000
NODE_4318_length_1158_cov_31.240793	612	692	4	21	80	0.2625000
NODE_4318_length_1158_cov_31.240793	612	692	5	8	80	0.1000000
NODE_4319_length_1158_cov_29.216242	405	485	2	51	80	0.6375000
NODE_4319_length_1158_cov_29.216242	405	485	3	29	80	0.3625000
NODE_4319_length_1158_cov_29.216242	458	538	1	30	80	0.3750000
NODE_4319_length_1158_cov_29.216242	458	538	2	42	80	0.5250000
NODE_4319_length_1158_cov_29.216242	458	538	3	8	80	0.1000000
NODE_4320_length_1158_cov_25.245515	500	580	3	27	80	0.3375000
NODE_4320_length_1158_cov_25.245515	500	580	4	20	80	0.2500000
NODE_4320_length_1158_cov_25.245515	500	580	5	32	80	0.4000000
NODE_4320_length_1158_cov_25.245515	500	580	6	1	80	0.0125000
NODE_4320_length_1158_cov_25.245515	553	633	5	80	80	1.0000000
NODE_4320_length_1158_cov_25.245515	629	709	2	6	80	0.0750000
NODE_4320_length_1158_cov_25.245515	629	709	3	5	80	0.0625000
NODE_4320_length_1158_cov_25.245515	629	709	4	57	80	0.7125000
NODE_4320_length_1158_cov_25.245515	629	709	5	12	80	0.1500000
NODE_4320_length_1158_cov_25.245515	682	762	2	6	80	0.0750000
NODE_4320_length_1158_cov_25.245515	682	762	4	74	80	0.9250000
NODE_4321_length_1158_cov_16.566572	396	476	0	80	80	1.0000000
NODE_4321_length_1158_cov_16.566572	449	529	0	80	80	1.0000000
NODE_4322_length_1158_cov_13.092540	372	452	0	80	80	1.0000000
NODE_4322_length_1158_cov_13.092540	425	505	0	80	80	1.0000000
NODE_4322_length_1158_cov_13.092540	735	815	2	80	80	1.0000000
NODE_4322_length_1158_cov_13.092540	788	868	0	43	80	0.5375000
NODE_4322_length_1158_cov_13.092540	788	868	2	37	80	0.4625000
NODE_4323_length_1158_cov_7.408876	656	736	0	20	80	0.2500000
NODE_4323_length_1158_cov_7.408876	656	736	1	24	80	0.3000000
NODE_4323_length_1158_cov_7.408876	656	736	2	28	80	0.3500000
NODE_4323_length_1158_cov_7.408876	656	736	3	8	80	0.1000000
NODE_4323_length_1158_cov_7.408876	709	789	2	19	80	0.2375000
NODE_4323_length_1158_cov_7.408876	709	789	3	61	80	0.7625000
NODE_4324_length_1158_cov_6.242682	239	310	2	67	71	0.9436620
NODE_4324_length_1158_cov_6.242682	239	310	3	4	71	0.0563380
NODE_4325_length_1158_cov_6.043437	531	611	0	10	80	0.1250000
NODE_4325_length_1158_cov_6.043437	531	611	1	49	80	0.6125000
NODE_4325_length_1158_cov_6.043437	531	611	2	21	80	0.2625000
NODE_4325_length_1158_cov_6.043437	584	634	0	33	50	0.6600000
NODE_4325_length_1158_cov_6.043437	584	634	1	17	50	0.3400000
NODE_4326_length_1158_cov_5.855524	324	404	1	80	80	1.0000000
NODE_4326_length_1158_cov_5.855524	377	457	1	80	80	1.0000000
NODE_4329_length_1157_cov_32.233459	472	552	0	80	80	1.0000000
NODE_4329_length_1157_cov_32.233459	525	605	0	80	80	1.0000000
NODE_4329_length_1157_cov_32.233459	601	681	0	80	80	1.0000000
NODE_4329_length_1157_cov_32.233459	654	734	0	80	80	1.0000000
NODE_4330_length_1157_cov_6.438563	765	788	0	11	23	0.4782609
NODE_4330_length_1157_cov_6.438563	765	788	1	12	23	0.5217391
NODE_4332_length_1157_cov_4.068053	221	292	0	44	71	0.6197183
NODE_4332_length_1157_cov_4.068053	221	292	1	27	71	0.3802817
NODE_4333_length_1156_cov_46.381268	328	408	2	13	80	0.1625000
NODE_4333_length_1156_cov_46.381268	328	408	3	10	80	0.1250000
NODE_4333_length_1156_cov_46.381268	328	408	4	3	80	0.0375000
NODE_4333_length_1156_cov_46.381268	328	408	5	2	80	0.0250000
NODE_4333_length_1156_cov_46.381268	328	408	6	13	80	0.1625000
NODE_4333_length_1156_cov_46.381268	328	408	7	39	80	0.4875000
NODE_4333_length_1156_cov_46.381268	381	461	7	45	80	0.5625000
NODE_4333_length_1156_cov_46.381268	381	461	8	14	80	0.1750000
NODE_4333_length_1156_cov_46.381268	381	461	9	5	80	0.0625000
NODE_4333_length_1156_cov_46.381268	381	461	11	16	80	0.2000000
NODE_4333_length_1156_cov_46.381268	457	537	8	12	80	0.1500000
NODE_4333_length_1156_cov_46.381268	457	537	9	18	80	0.2250000
NODE_4333_length_1156_cov_46.381268	457	537	10	25	80	0.3125000
NODE_4333_length_1156_cov_46.381268	457	537	11	16	80	0.2000000
NODE_4333_length_1156_cov_46.381268	457	537	12	9	80	0.1125000
NODE_4333_length_1156_cov_46.381268	510	590	8	17	80	0.2125000
NODE_4333_length_1156_cov_46.381268	510	590	9	42	80	0.5250000
NODE_4333_length_1156_cov_46.381268	510	590	10	6	80	0.0750000
NODE_4333_length_1156_cov_46.381268	510	590	11	15	80	0.1875000
NODE_4334_length_1156_cov_32.198675	378	458	5	5	80	0.0625000
NODE_4334_length_1156_cov_32.198675	378	458	6	1	80	0.0125000
NODE_4334_length_1156_cov_32.198675	378	458	7	12	80	0.1500000
NODE_4334_length_1156_cov_32.198675	378	458	8	6	80	0.0750000
NODE_4334_length_1156_cov_32.198675	378	458	9	56	80	0.7000000
NODE_4334_length_1156_cov_32.198675	431	511	7	11	80	0.1375000
NODE_4334_length_1156_cov_32.198675	431	511	8	6	80	0.0750000
NODE_4334_length_1156_cov_32.198675	431	511	9	61	80	0.7625000
NODE_4334_length_1156_cov_32.198675	431	511	10	2	80	0.0250000
NODE_4334_length_1156_cov_32.198675	507	587	3	53	80	0.6625000
NODE_4334_length_1156_cov_32.198675	507	587	4	1	80	0.0125000
NODE_4334_length_1156_cov_32.198675	507	587	5	4	80	0.0500000
NODE_4334_length_1156_cov_32.198675	507	587	7	16	80	0.2000000
NODE_4334_length_1156_cov_32.198675	507	587	8	6	80	0.0750000
NODE_4334_length_1156_cov_32.198675	560	641	1	29	81	0.3580247
NODE_4334_length_1156_cov_32.198675	560	641	2	23	81	0.2839506
NODE_4334_length_1156_cov_32.198675	560	641	3	29	81	0.3580247
NODE_4335_length_1156_cov_12.683065	593	673	3	9	80	0.1125000
NODE_4335_length_1156_cov_12.683065	593	673	4	15	80	0.1875000
NODE_4335_length_1156_cov_12.683065	593	673	5	56	80	0.7000000
NODE_4335_length_1156_cov_12.683065	646	726	3	55	80	0.6875000
NODE_4335_length_1156_cov_12.683065	646	726	5	25	80	0.3125000
NODE_4336_length_1156_cov_9.287606	680	760	3	3	80	0.0375000
NODE_4336_length_1156_cov_9.287606	680	760	4	77	80	0.9625000
NODE_4336_length_1156_cov_9.287606	733	813	2	14	80	0.1750000
NODE_4336_length_1156_cov_9.287606	733	813	3	23	80	0.2875000
NODE_4336_length_1156_cov_9.287606	733	813	4	43	80	0.5375000
NODE_4339_length_1155_cov_19.570076	437	517	3	49	80	0.6125000
NODE_4339_length_1155_cov_19.570076	437	517	4	31	80	0.3875000
NODE_4339_length_1155_cov_19.570076	490	570	1	3	80	0.0375000
NODE_4339_length_1155_cov_19.570076	490	570	3	74	80	0.9250000
NODE_4339_length_1155_cov_19.570076	490	570	4	3	80	0.0375000
NODE_4340_length_1155_cov_18.666667	332	412	3	13	80	0.1625000
NODE_4340_length_1155_cov_18.666667	332	412	4	11	80	0.1375000
NODE_4340_length_1155_cov_18.666667	332	412	5	9	80	0.1125000
NODE_4340_length_1155_cov_18.666667	332	412	6	47	80	0.5875000
NODE_4340_length_1155_cov_18.666667	385	465	3	6	80	0.0750000
NODE_4340_length_1155_cov_18.666667	385	465	4	27	80	0.3375000
NODE_4340_length_1155_cov_18.666667	385	465	6	47	80	0.5875000
NODE_4346_length_1154_cov_61.769668	488	568	7	2	80	0.0250000
NODE_4346_length_1154_cov_61.769668	488	568	8	41	80	0.5125000
NODE_4346_length_1154_cov_61.769668	488	568	9	37	80	0.4625000
NODE_4346_length_1154_cov_61.769668	541	621	3	21	80	0.2625000
NODE_4346_length_1154_cov_61.769668	541	621	4	8	80	0.1000000
NODE_4346_length_1154_cov_61.769668	541	621	5	9	80	0.1125000
NODE_4346_length_1154_cov_61.769668	541	621	7	7	80	0.0875000
NODE_4346_length_1154_cov_61.769668	541	621	8	35	80	0.4375000
NODE_4347_length_1154_cov_50.909005	409	489	2	48	80	0.6000000
NODE_4347_length_1154_cov_50.909005	409	489	4	32	80	0.4000000
NODE_4347_length_1154_cov_50.909005	462	542	0	51	80	0.6375000
NODE_4347_length_1154_cov_50.909005	462	542	2	29	80	0.3625000
NODE_4347_length_1154_cov_50.909005	538	618	0	80	80	1.0000000
NODE_4347_length_1154_cov_50.909005	591	671	0	80	80	1.0000000
NODE_4348_length_1154_cov_28.941232	695	775	0	7	80	0.0875000
NODE_4348_length_1154_cov_28.941232	695	775	2	73	80	0.9125000
NODE_4348_length_1154_cov_28.941232	748	828	0	60	80	0.7500000
NODE_4348_length_1154_cov_28.941232	748	828	2	20	80	0.2500000
NODE_4349_length_1154_cov_13.765877	322	402	0	30	80	0.3750000
NODE_4349_length_1154_cov_13.765877	322	402	1	50	80	0.6250000
NODE_4349_length_1154_cov_13.765877	375	455	0	80	80	1.0000000
NODE_4351_length_1154_cov_5.930806	497	577	0	22	80	0.2750000
NODE_4351_length_1154_cov_5.930806	497	577	2	58	80	0.7250000
NODE_4351_length_1154_cov_5.930806	550	622	0	13	72	0.1805556
NODE_4351_length_1154_cov_5.930806	550	622	2	59	72	0.8194444
NODE_4357_length_1153_cov_65.486717	416	496	3	11	80	0.1375000
NODE_4357_length_1153_cov_65.486717	416	496	4	12	80	0.1500000
NODE_4357_length_1153_cov_65.486717	416	496	5	43	80	0.5375000
NODE_4357_length_1153_cov_65.486717	416	496	6	13	80	0.1625000
NODE_4357_length_1153_cov_65.486717	416	496	7	1	80	0.0125000
NODE_4357_length_1153_cov_65.486717	469	549	5	24	80	0.3000000
NODE_4357_length_1153_cov_65.486717	469	549	6	5	80	0.0625000
NODE_4357_length_1153_cov_65.486717	469	549	7	51	80	0.6375000
NODE_4357_length_1153_cov_65.486717	545	625	4	17	80	0.2125000
NODE_4357_length_1153_cov_65.486717	545	625	5	25	80	0.3125000
NODE_4357_length_1153_cov_65.486717	545	625	6	29	80	0.3625000
NODE_4357_length_1153_cov_65.486717	545	625	7	9	80	0.1125000
NODE_4357_length_1153_cov_65.486717	598	678	2	34	80	0.4250000
NODE_4357_length_1153_cov_65.486717	598	678	4	36	80	0.4500000
NODE_4357_length_1153_cov_65.486717	598	678	5	10	80	0.1250000
NODE_4358_length_1153_cov_50.733397	404	484	0	32	80	0.4000000
NODE_4358_length_1153_cov_50.733397	404	484	1	33	80	0.4125000
NODE_4358_length_1153_cov_50.733397	404	484	2	15	80	0.1875000
NODE_4358_length_1153_cov_50.733397	457	537	0	3	80	0.0375000
NODE_4358_length_1153_cov_50.733397	457	537	1	9	80	0.1125000
NODE_4358_length_1153_cov_50.733397	457	537	2	65	80	0.8125000
NODE_4358_length_1153_cov_50.733397	457	537	3	3	80	0.0375000
NODE_4358_length_1153_cov_50.733397	533	613	2	1	80	0.0125000
NODE_4358_length_1153_cov_50.733397	533	613	3	35	80	0.4375000
NODE_4358_length_1153_cov_50.733397	533	613	5	6	80	0.0750000
NODE_4358_length_1153_cov_50.733397	533	613	6	11	80	0.1375000
NODE_4358_length_1153_cov_50.733397	533	613	7	7	80	0.0875000
NODE_4358_length_1153_cov_50.733397	533	613	9	7	80	0.0875000
NODE_4358_length_1153_cov_50.733397	533	613	10	4	80	0.0500000
NODE_4358_length_1153_cov_50.733397	533	613	11	9	80	0.1125000
NODE_4358_length_1153_cov_50.733397	586	666	7	7	80	0.0875000
NODE_4358_length_1153_cov_50.733397	586	666	8	7	80	0.0875000
NODE_4358_length_1153_cov_50.733397	586	666	9	47	80	0.5875000
NODE_4358_length_1153_cov_50.733397	586	666	10	10	80	0.1250000
NODE_4358_length_1153_cov_50.733397	586	666	11	9	80	0.1125000
NODE_4359_length_1153_cov_26.131879	493	573	3	8	80	0.1000000
NODE_4359_length_1153_cov_26.131879	493	573	4	5	80	0.0625000
NODE_4359_length_1153_cov_26.131879	493	573	5	46	80	0.5750000
NODE_4359_length_1153_cov_26.131879	493	573	6	21	80	0.2625000
NODE_4359_length_1153_cov_26.131879	546	626	4	12	80	0.1500000
NODE_4359_length_1153_cov_26.131879	546	626	5	32	80	0.4000000
NODE_4359_length_1153_cov_26.131879	546	626	6	36	80	0.4500000
NODE_4360_length_1153_cov_10.195446	500	580	0	61	80	0.7625000
NODE_4360_length_1153_cov_10.195446	500	580	1	1	80	0.0125000
NODE_4360_length_1153_cov_10.195446	500	580	2	18	80	0.2250000
NODE_4360_length_1153_cov_10.195446	553	633	0	8	80	0.1000000
NODE_4360_length_1153_cov_10.195446	553	633	1	1	80	0.0125000
NODE_4360_length_1153_cov_10.195446	553	633	2	71	80	0.8875000
NODE_4361_length_1153_cov_8.286528	558	638	0	60	80	0.7500000
NODE_4361_length_1153_cov_8.286528	558	638	1	20	80	0.2500000
NODE_4361_length_1153_cov_8.286528	611	691	0	79	80	0.9875000
NODE_4361_length_1153_cov_8.286528	611	691	1	1	80	0.0125000
NODE_4368_length_1152_cov_19.800570	553	633	4	80	80	1.0000000
NODE_4368_length_1152_cov_19.800570	606	686	2	41	80	0.5125000
NODE_4368_length_1152_cov_19.800570	606	686	3	9	80	0.1125000
NODE_4368_length_1152_cov_19.800570	606	686	4	30	80	0.3750000
NODE_4369_length_1152_cov_19.365622	490	570	0	80	80	1.0000000
NODE_4369_length_1152_cov_19.365622	543	623	0	80	80	1.0000000
NODE_4370_length_1152_cov_18.654321	594	674	0	80	80	1.0000000
NODE_4370_length_1152_cov_18.654321	647	727	0	80	80	1.0000000
NODE_4371_length_1152_cov_18.075024	377	457	2	13	80	0.1625000
NODE_4371_length_1152_cov_18.075024	377	457	3	36	80	0.4500000
NODE_4371_length_1152_cov_18.075024	377	457	4	31	80	0.3875000
NODE_4371_length_1152_cov_18.075024	430	510	2	12	80	0.1500000
NODE_4371_length_1152_cov_18.075024	430	510	3	39	80	0.4875000
NODE_4371_length_1152_cov_18.075024	430	510	4	29	80	0.3625000
NODE_4371_length_1152_cov_18.075024	506	586	0	10	80	0.1250000
NODE_4371_length_1152_cov_18.075024	506	586	1	50	80	0.6250000
NODE_4371_length_1152_cov_18.075024	506	586	2	20	80	0.2500000
NODE_4371_length_1152_cov_18.075024	559	639	0	63	80	0.7875000
NODE_4371_length_1152_cov_18.075024	559	639	1	17	80	0.2125000
NODE_4373_length_1152_cov_16.047483	543	623	1	27	80	0.3375000
NODE_4373_length_1152_cov_16.047483	543	623	2	21	80	0.2625000
NODE_4373_length_1152_cov_16.047483	543	623	3	32	80	0.4000000
NODE_4373_length_1152_cov_16.047483	596	676	1	37	80	0.4625000
NODE_4373_length_1152_cov_16.047483	596	676	2	21	80	0.2625000
NODE_4373_length_1152_cov_16.047483	596	676	4	22	80	0.2750000
NODE_4373_length_1152_cov_16.047483	672	752	4	71	80	0.8875000
NODE_4373_length_1152_cov_16.047483	672	752	5	9	80	0.1125000
NODE_4373_length_1152_cov_16.047483	725	805	1	22	80	0.2750000
NODE_4373_length_1152_cov_16.047483	725	805	2	6	80	0.0750000
NODE_4373_length_1152_cov_16.047483	725	805	4	52	80	0.6500000
NODE_4374_length_1152_cov_13.981007	583	663	1	80	80	1.0000000
NODE_4374_length_1152_cov_13.981007	636	716	0	34	80	0.4250000
NODE_4374_length_1152_cov_13.981007	636	716	1	46	80	0.5750000
NODE_4380_length_1151_cov_30.469582	479	559	0	80	80	1.0000000
NODE_4380_length_1151_cov_30.469582	532	612	0	80	80	1.0000000
NODE_4381_length_1151_cov_26.650190	567	647	0	29	80	0.3625000
NODE_4381_length_1151_cov_26.650190	567	647	2	51	80	0.6375000
NODE_4381_length_1151_cov_26.650190	620	700	2	80	80	1.0000000
NODE_4382_length_1151_cov_26.375475	441	521	2	65	80	0.8125000
NODE_4382_length_1151_cov_26.375475	441	521	3	15	80	0.1875000
NODE_4382_length_1151_cov_26.375475	494	574	1	34	80	0.4250000
NODE_4382_length_1151_cov_26.375475	494	574	2	25	80	0.3125000
NODE_4382_length_1151_cov_26.375475	494	574	3	21	80	0.2625000
NODE_4382_length_1151_cov_26.375475	570	650	1	80	80	1.0000000
NODE_4382_length_1151_cov_26.375475	623	703	0	34	80	0.4250000
NODE_4382_length_1151_cov_26.375475	623	703	1	46	80	0.5750000
NODE_4383_length_1151_cov_23.614068	590	670	0	61	80	0.7625000
NODE_4383_length_1151_cov_23.614068	590	670	1	19	80	0.2375000
NODE_4383_length_1151_cov_23.614068	643	721	0	78	78	1.0000000
NODE_4384_length_1151_cov_18.693916	355	435	3	64	80	0.8000000
NODE_4384_length_1151_cov_18.693916	355	435	4	16	80	0.2000000
NODE_4384_length_1151_cov_18.693916	408	491	1	18	83	0.2168675
NODE_4384_length_1151_cov_18.693916	408	491	2	7	83	0.0843373
NODE_4384_length_1151_cov_18.693916	408	491	3	58	83	0.6987952
NODE_4385_length_1151_cov_16.093156	474	554	2	80	80	1.0000000
NODE_4385_length_1151_cov_16.093156	527	607	1	20	80	0.2500000
NODE_4385_length_1151_cov_16.093156	527	607	2	60	80	0.7500000
NODE_4386_length_1151_cov_13.782319	400	482	0	82	82	1.0000000
NODE_4386_length_1151_cov_13.782319	450	535	0	41	85	0.4823529
NODE_4386_length_1151_cov_13.782319	450	535	2	44	85	0.5176471
NODE_4392_length_1150_cov_38.601332	563	643	3	24	80	0.3000000
NODE_4392_length_1150_cov_38.601332	563	643	5	56	80	0.7000000
NODE_4392_length_1150_cov_38.601332	616	696	1	5	80	0.0625000
NODE_4392_length_1150_cov_38.601332	616	696	2	17	80	0.2125000
NODE_4392_length_1150_cov_38.601332	616	696	4	15	80	0.1875000
NODE_4392_length_1150_cov_38.601332	616	696	5	43	80	0.5375000
NODE_4392_length_1150_cov_38.601332	692	772	0	73	80	0.9125000
NODE_4392_length_1150_cov_38.601332	692	772	1	7	80	0.0875000
NODE_4392_length_1150_cov_38.601332	745	825	0	80	80	1.0000000
NODE_4393_length_1150_cov_15.741199	497	578	3	81	81	1.0000000
NODE_4393_length_1150_cov_15.741199	550	631	2	5	81	0.0617284
NODE_4393_length_1150_cov_15.741199	550	631	3	60	81	0.7407407
NODE_4393_length_1150_cov_15.741199	550	631	4	16	81	0.1975309
NODE_4394_length_1150_cov_11.132255	795	875	0	80	80	1.0000000
NODE_4394_length_1150_cov_11.132255	848	928	0	80	80	1.0000000
NODE_4395_length_1150_cov_9.253092	583	663	0	80	80	1.0000000
NODE_4395_length_1150_cov_9.253092	636	716	0	80	80	1.0000000
NODE_4398_length_1149_cov_17.289524	644	695	0	51	51	1.0000000
NODE_4399_length_1149_cov_13.805714	584	664	1	8	80	0.1000000
NODE_4399_length_1149_cov_13.805714	584	664	2	16	80	0.2000000
NODE_4399_length_1149_cov_13.805714	584	664	3	36	80	0.4500000
NODE_4399_length_1149_cov_13.805714	584	664	5	20	80	0.2500000
NODE_4399_length_1149_cov_13.805714	637	717	2	3	80	0.0375000
NODE_4399_length_1149_cov_13.805714	637	717	3	4	80	0.0500000
NODE_4399_length_1149_cov_13.805714	637	717	5	65	80	0.8125000
NODE_4399_length_1149_cov_13.805714	637	717	6	8	80	0.1000000
NODE_4399_length_1149_cov_13.805714	713	793	2	3	80	0.0375000
NODE_4399_length_1149_cov_13.805714	713	793	3	46	80	0.5750000
NODE_4399_length_1149_cov_13.805714	713	793	4	15	80	0.1875000
NODE_4399_length_1149_cov_13.805714	713	793	5	11	80	0.1375000
NODE_4399_length_1149_cov_13.805714	713	793	6	5	80	0.0625000
NODE_4399_length_1149_cov_13.805714	766	846	2	56	80	0.7000000
NODE_4399_length_1149_cov_13.805714	766	846	3	24	80	0.3000000
NODE_4407_length_1148_cov_27.674929	387	467	1	5	80	0.0625000
NODE_4407_length_1148_cov_27.674929	387	467	2	7	80	0.0875000
NODE_4407_length_1148_cov_27.674929	387	467	3	23	80	0.2875000
NODE_4407_length_1148_cov_27.674929	387	467	4	19	80	0.2375000
NODE_4407_length_1148_cov_27.674929	387	467	5	15	80	0.1875000
NODE_4407_length_1148_cov_27.674929	387	467	6	11	80	0.1375000
NODE_4407_length_1148_cov_27.674929	440	520	0	23	80	0.2875000
NODE_4407_length_1148_cov_27.674929	440	520	1	35	80	0.4375000
NODE_4407_length_1148_cov_27.674929	440	520	2	7	80	0.0875000
NODE_4407_length_1148_cov_27.674929	440	520	3	15	80	0.1875000
NODE_4408_length_1148_cov_13.275500	136	216	4	8	80	0.1000000
NODE_4408_length_1148_cov_13.275500	136	216	5	18	80	0.2250000
NODE_4408_length_1148_cov_13.275500	136	216	6	54	80	0.6750000
NODE_4408_length_1148_cov_13.275500	189	268	4	15	79	0.1898734
NODE_4408_length_1148_cov_13.275500	189	268	5	20	79	0.2531646
NODE_4408_length_1148_cov_13.275500	189	268	6	44	79	0.5569620
NODE_4409_length_1148_cov_10.613918	506	586	2	4	80	0.0500000
NODE_4409_length_1148_cov_10.613918	506	586	3	36	80	0.4500000
NODE_4409_length_1148_cov_10.613918	506	586	4	40	80	0.5000000
NODE_4409_length_1148_cov_10.613918	559	639	3	8	80	0.1000000
NODE_4409_length_1148_cov_10.613918	559	639	4	72	80	0.9000000
NODE_4415_length_1147_cov_33.543893	378	458	2	28	80	0.3500000
NODE_4415_length_1147_cov_33.543893	378	458	3	52	80	0.6500000
NODE_4415_length_1147_cov_33.543893	431	511	2	8	80	0.1000000
NODE_4415_length_1147_cov_33.543893	431	511	3	72	80	0.9000000
NODE_4416_length_1147_cov_26.858779	254	334	1	2	80	0.0250000
NODE_4416_length_1147_cov_26.858779	254	334	2	78	80	0.9750000
NODE_4416_length_1147_cov_26.858779	307	387	2	30	80	0.3750000
NODE_4416_length_1147_cov_26.858779	307	387	3	22	80	0.2750000
NODE_4416_length_1147_cov_26.858779	307	387	4	28	80	0.3500000
NODE_4416_length_1147_cov_26.858779	383	463	3	66	80	0.8250000
NODE_4416_length_1147_cov_26.858779	383	463	4	14	80	0.1750000
NODE_4416_length_1147_cov_26.858779	436	516	2	15	80	0.1875000
NODE_4416_length_1147_cov_26.858779	436	516	3	32	80	0.4000000
NODE_4416_length_1147_cov_26.858779	436	516	4	33	80	0.4125000
NODE_4417_length_1147_cov_24.227099	606	686	5	25	80	0.3125000
NODE_4417_length_1147_cov_24.227099	606	686	6	30	80	0.3750000
NODE_4417_length_1147_cov_24.227099	606	686	7	8	80	0.1000000
NODE_4417_length_1147_cov_24.227099	606	686	8	17	80	0.2125000
NODE_4417_length_1147_cov_24.227099	659	739	4	19	80	0.2375000
NODE_4417_length_1147_cov_24.227099	659	739	5	51	80	0.6375000
NODE_4417_length_1147_cov_24.227099	659	739	6	8	80	0.1000000
NODE_4417_length_1147_cov_24.227099	659	739	8	2	80	0.0250000
NODE_4417_length_1147_cov_24.227099	735	815	2	21	80	0.2625000
NODE_4417_length_1147_cov_24.227099	735	815	3	37	80	0.4625000
NODE_4417_length_1147_cov_24.227099	735	815	4	22	80	0.2750000
NODE_4417_length_1147_cov_24.227099	788	868	1	12	80	0.1500000
NODE_4417_length_1147_cov_24.227099	788	868	2	62	80	0.7750000
NODE_4417_length_1147_cov_24.227099	788	868	3	6	80	0.0750000
NODE_4418_length_1147_cov_16.559160	417	497	0	80	80	1.0000000
NODE_4418_length_1147_cov_16.559160	470	550	0	80	80	1.0000000
NODE_4428_length_1146_cov_52.393505	411	491	0	80	80	1.0000000
NODE_4428_length_1146_cov_52.393505	464	544	0	80	80	1.0000000
NODE_4428_length_1146_cov_52.393505	540	620	0	42	80	0.5250000
NODE_4428_length_1146_cov_52.393505	540	620	1	20	80	0.2500000
NODE_4428_length_1146_cov_52.393505	540	620	2	1	80	0.0125000
NODE_4428_length_1146_cov_52.393505	540	620	3	17	80	0.2125000
NODE_4428_length_1146_cov_52.393505	593	673	1	9	80	0.1125000
NODE_4428_length_1146_cov_52.393505	593	673	2	1	80	0.0125000
NODE_4428_length_1146_cov_52.393505	593	673	3	44	80	0.5500000
NODE_4428_length_1146_cov_52.393505	593	673	4	26	80	0.3250000
NODE_4429_length_1146_cov_46.364852	233	313	6	4	80	0.0500000
NODE_4429_length_1146_cov_46.364852	233	313	7	9	80	0.1125000
NODE_4429_length_1146_cov_46.364852	233	313	8	32	80	0.4000000
NODE_4429_length_1146_cov_46.364852	233	313	9	5	80	0.0625000
NODE_4429_length_1146_cov_46.364852	233	313	11	30	80	0.3750000
NODE_4429_length_1146_cov_46.364852	286	366	7	11	80	0.1375000
NODE_4429_length_1146_cov_46.364852	286	366	8	3	80	0.0375000
NODE_4429_length_1146_cov_46.364852	286	366	10	10	80	0.1250000
NODE_4429_length_1146_cov_46.364852	286	366	11	56	80	0.7000000
NODE_4430_length_1146_cov_26.159503	476	556	1	40	80	0.5000000
NODE_4430_length_1146_cov_26.159503	476	556	2	40	80	0.5000000
NODE_4430_length_1146_cov_26.159503	529	609	1	69	80	0.8625000
NODE_4430_length_1146_cov_26.159503	529	609	2	11	80	0.1375000
NODE_4430_length_1146_cov_26.159503	605	685	0	35	80	0.4375000
NODE_4430_length_1146_cov_26.159503	605	685	1	45	80	0.5625000
NODE_4430_length_1146_cov_26.159503	658	738	0	80	80	1.0000000
NODE_4431_length_1146_cov_14.210124	343	423	2	14	80	0.1750000
NODE_4431_length_1146_cov_14.210124	343	423	3	15	80	0.1875000
NODE_4431_length_1146_cov_14.210124	343	423	4	51	80	0.6375000
NODE_4431_length_1146_cov_14.210124	396	476	3	48	80	0.6000000
NODE_4431_length_1146_cov_14.210124	396	476	4	32	80	0.4000000
NODE_4432_length_1146_cov_13.479465	425	501	2	55	76	0.7236842
NODE_4432_length_1146_cov_13.479465	425	501	3	21	76	0.2763158
NODE_4432_length_1146_cov_13.479465	505	565	2	4	60	0.0666667
NODE_4432_length_1146_cov_13.479465	505	565	3	54	60	0.9000000
NODE_4432_length_1146_cov_13.479465	505	565	4	2	60	0.0333333
NODE_4432_length_1146_cov_13.479465	561	641	1	11	80	0.1375000
NODE_4432_length_1146_cov_13.479465	561	641	2	69	80	0.8625000
NODE_4432_length_1146_cov_13.479465	614	694	1	64	80	0.8000000
NODE_4432_length_1146_cov_13.479465	614	694	2	16	80	0.2000000
NODE_4438_length_1145_cov_49.566922	395	470	0	59	75	0.7866667
NODE_4438_length_1145_cov_49.566922	395	470	1	16	75	0.2133333
NODE_4438_length_1145_cov_49.566922	443	523	0	11	80	0.1375000
NODE_4438_length_1145_cov_49.566922	443	523	1	35	80	0.4375000
NODE_4438_length_1145_cov_49.566922	443	523	2	13	80	0.1625000
NODE_4438_length_1145_cov_49.566922	443	523	3	21	80	0.2625000
NODE_4439_length_1145_cov_38.191205	497	576	0	43	79	0.5443038
NODE_4439_length_1145_cov_38.191205	497	576	1	36	79	0.4556962
NODE_4439_length_1145_cov_38.191205	549	629	1	80	80	1.0000000
NODE_4440_length_1145_cov_26.929254	468	548	2	80	80	1.0000000
NODE_4440_length_1145_cov_26.929254	521	601	0	15	80	0.1875000
NODE_4440_length_1145_cov_26.929254	521	601	2	65	80	0.8125000
NODE_4441_length_1145_cov_20.121415	508	588	2	12	80	0.1500000
NODE_4441_length_1145_cov_20.121415	508	588	4	68	80	0.8500000
NODE_4441_length_1145_cov_20.121415	561	641	2	27	80	0.3375000
NODE_4441_length_1145_cov_20.121415	561	641	3	25	80	0.3125000
NODE_4441_length_1145_cov_20.121415	561	641	4	28	80	0.3500000
NODE_4442_length_1145_cov_11.753346	527	605	1	78	78	1.0000000
NODE_4442_length_1145_cov_11.753346	578	659	1	29	81	0.3580247
NODE_4442_length_1145_cov_11.753346	578	659	2	52	81	0.6419753
NODE_4443_length_1145_cov_9.571702	93	173	2	80	80	1.0000000
NODE_4443_length_1145_cov_9.571702	146	226	0	48	80	0.6000000
NODE_4443_length_1145_cov_9.571702	146	226	2	32	80	0.4000000
NODE_4455_length_1143_cov_42.255747	380	460	0	50	80	0.6250000
NODE_4455_length_1143_cov_42.255747	380	460	1	30	80	0.3750000
NODE_4455_length_1143_cov_42.255747	433	513	1	46	80	0.5750000
NODE_4455_length_1143_cov_42.255747	433	513	2	19	80	0.2375000
NODE_4455_length_1143_cov_42.255747	433	513	4	14	80	0.1750000
NODE_4455_length_1143_cov_42.255747	433	513	5	1	80	0.0125000
NODE_4455_length_1143_cov_42.255747	509	589	4	3	80	0.0375000
NODE_4455_length_1143_cov_42.255747	509	589	5	5	80	0.0625000
NODE_4455_length_1143_cov_42.255747	509	589	6	8	80	0.1000000
NODE_4455_length_1143_cov_42.255747	509	589	7	30	80	0.3750000
NODE_4455_length_1143_cov_42.255747	509	589	8	34	80	0.4250000
NODE_4455_length_1143_cov_42.255747	562	642	6	7	80	0.0875000
NODE_4455_length_1143_cov_42.255747	562	642	7	14	80	0.1750000
NODE_4455_length_1143_cov_42.255747	562	642	8	24	80	0.3000000
NODE_4455_length_1143_cov_42.255747	562	642	9	35	80	0.4375000
NODE_4456_length_1143_cov_22.076628	526	606	4	70	80	0.8750000
NODE_4456_length_1143_cov_22.076628	526	606	5	10	80	0.1250000
NODE_4456_length_1143_cov_22.076628	579	659	2	27	80	0.3375000
NODE_4456_length_1143_cov_22.076628	579	659	3	10	80	0.1250000
NODE_4456_length_1143_cov_22.076628	579	659	4	43	80	0.5375000
NODE_4457_length_1143_cov_19.106322	565	645	0	80	80	1.0000000
NODE_4457_length_1143_cov_19.106322	618	698	0	80	80	1.0000000
NODE_4458_length_1143_cov_16.223180	638	719	0	81	81	1.0000000
NODE_4458_length_1143_cov_16.223180	692	772	0	80	80	1.0000000
NODE_4459_length_1143_cov_13.961686	634	714	0	80	80	1.0000000
NODE_4459_length_1143_cov_13.961686	687	767	0	80	80	1.0000000
NODE_4459_length_1143_cov_13.961686	763	843	0	80	80	1.0000000
NODE_4459_length_1143_cov_13.961686	816	896	0	80	80	1.0000000
NODE_4460_length_1143_cov_12.782567	328	409	0	25	81	0.3086420
NODE_4460_length_1143_cov_12.782567	328	409	1	56	81	0.6913580
NODE_4460_length_1143_cov_12.782567	381	462	1	50	81	0.6172839
NODE_4460_length_1143_cov_12.782567	381	462	2	31	81	0.3827161
NODE_4460_length_1143_cov_12.782567	458	538	1	8	80	0.1000000
NODE_4460_length_1143_cov_12.782567	458	538	2	64	80	0.8000000
NODE_4460_length_1143_cov_12.782567	458	538	3	8	80	0.1000000
NODE_4460_length_1143_cov_12.782567	511	591	1	1	80	0.0125000
NODE_4460_length_1143_cov_12.782567	511	591	2	28	80	0.3500000
NODE_4460_length_1143_cov_12.782567	511	591	3	51	80	0.6375000
NODE_4461_length_1143_cov_8.287356	692	772	1	4	80	0.0500000
NODE_4461_length_1143_cov_8.287356	692	772	2	5	80	0.0625000
NODE_4461_length_1143_cov_8.287356	692	772	4	71	80	0.8875000
NODE_4461_length_1143_cov_8.287356	745	825	0	44	80	0.5500000
NODE_4461_length_1143_cov_8.287356	745	825	3	5	80	0.0625000
NODE_4461_length_1143_cov_8.287356	745	825	4	31	80	0.3875000
NODE_4463_length_1143_cov_2.197318	988	1057	2	1	69	0.0144928
NODE_4463_length_1143_cov_2.197318	988	1057	4	68	69	0.9855072
NODE_4466_length_1142_cov_28.364334	613	693	0	24	80	0.3000000
NODE_4466_length_1142_cov_28.364334	613	693	2	34	80	0.4250000
NODE_4466_length_1142_cov_28.364334	613	693	3	22	80	0.2750000
NODE_4466_length_1142_cov_28.364334	666	746	2	5	80	0.0625000
NODE_4466_length_1142_cov_28.364334	666	746	3	32	80	0.4000000
NODE_4466_length_1142_cov_28.364334	666	746	4	43	80	0.5375000
NODE_4467_length_1142_cov_21.669223	518	598	1	1	80	0.0125000
NODE_4467_length_1142_cov_21.669223	518	598	3	7	80	0.0875000
NODE_4467_length_1142_cov_21.669223	518	598	4	72	80	0.9000000
NODE_4467_length_1142_cov_21.669223	571	651	2	46	80	0.5750000
NODE_4467_length_1142_cov_21.669223	571	651	4	34	80	0.4250000
NODE_4468_length_1142_cov_19.007670	411	491	1	32	80	0.4000000
NODE_4468_length_1142_cov_19.007670	411	491	2	9	80	0.1125000
NODE_4468_length_1142_cov_19.007670	411	491	4	39	80	0.4875000
NODE_4468_length_1142_cov_19.007670	464	544	2	40	80	0.5000000
NODE_4468_length_1142_cov_19.007670	464	544	4	40	80	0.5000000
NODE_4474_length_1141_cov_12.500960	17	97	5	11	80	0.1375000
NODE_4474_length_1141_cov_12.500960	17	97	6	3	80	0.0375000
NODE_4474_length_1141_cov_12.500960	17	97	7	31	80	0.3875000
NODE_4474_length_1141_cov_12.500960	17	97	9	31	80	0.3875000
NODE_4474_length_1141_cov_12.500960	17	97	10	4	80	0.0500000
NODE_4474_length_1141_cov_12.500960	17	97	5	11	80	0.1375000
NODE_4474_length_1141_cov_12.500960	17	97	6	3	80	0.0375000
NODE_4474_length_1141_cov_12.500960	17	97	7	31	80	0.3875000
NODE_4474_length_1141_cov_12.500960	17	97	9	31	80	0.3875000
NODE_4474_length_1141_cov_12.500960	17	97	10	4	80	0.0500000
NODE_4474_length_1141_cov_12.500960	17	97	5	11	80	0.1375000
NODE_4474_length_1141_cov_12.500960	17	97	6	3	80	0.0375000
NODE_4474_length_1141_cov_12.500960	17	97	7	31	80	0.3875000
NODE_4474_length_1141_cov_12.500960	17	97	9	31	80	0.3875000
NODE_4474_length_1141_cov_12.500960	17	97	10	4	80	0.0500000
NODE_4474_length_1141_cov_12.500960	17	97	5	11	80	0.1375000
NODE_4474_length_1141_cov_12.500960	17	97	6	3	80	0.0375000
NODE_4474_length_1141_cov_12.500960	17	97	7	31	80	0.3875000
NODE_4474_length_1141_cov_12.500960	17	97	9	31	80	0.3875000
NODE_4474_length_1141_cov_12.500960	17	97	10	4	80	0.0500000
NODE_4474_length_1141_cov_12.500960	70	132	7	2	62	0.0322581
NODE_4474_length_1141_cov_12.500960	70	132	8	11	62	0.1774193
NODE_4474_length_1141_cov_12.500960	70	132	9	31	62	0.5000000
NODE_4474_length_1141_cov_12.500960	70	132	10	18	62	0.2903226
NODE_4474_length_1141_cov_12.500960	70	132	7	2	62	0.0322581
NODE_4474_length_1141_cov_12.500960	70	132	8	11	62	0.1774193
NODE_4474_length_1141_cov_12.500960	70	132	9	31	62	0.5000000
NODE_4474_length_1141_cov_12.500960	70	132	10	18	62	0.2903226
NODE_4474_length_1141_cov_12.500960	70	132	7	2	62	0.0322581
NODE_4474_length_1141_cov_12.500960	70	132	8	11	62	0.1774193
NODE_4474_length_1141_cov_12.500960	70	132	9	31	62	0.5000000
NODE_4474_length_1141_cov_12.500960	70	132	10	18	62	0.2903226
NODE_4474_length_1141_cov_12.500960	70	132	7	2	62	0.0322581
NODE_4474_length_1141_cov_12.500960	70	132	8	11	62	0.1774193
NODE_4474_length_1141_cov_12.500960	70	132	9	31	62	0.5000000
NODE_4474_length_1141_cov_12.500960	70	132	10	18	62	0.2903226
NODE_4475_length_1141_cov_7.197697	54	134	0	80	80	1.0000000
NODE_4475_length_1141_cov_7.197697	107	187	0	80	80	1.0000000
NODE_4475_length_1141_cov_7.197697	573	653	0	80	80	1.0000000
NODE_4475_length_1141_cov_7.197697	626	707	0	81	81	1.0000000
NODE_4476_length_1141_cov_5.428023	411	491	1	80	80	1.0000000
NODE_4476_length_1141_cov_5.428023	464	544	0	7	80	0.0875000
NODE_4476_length_1141_cov_5.428023	464	544	1	73	80	0.9125000
NODE_4482_length_1140_cov_39.383285	451	531	2	14	80	0.1750000
NODE_4482_length_1140_cov_39.383285	451	531	3	66	80	0.8250000
NODE_4482_length_1140_cov_39.383285	504	584	1	30	80	0.3750000
NODE_4482_length_1140_cov_39.383285	504	584	2	14	80	0.1750000
NODE_4482_length_1140_cov_39.383285	504	584	3	36	80	0.4500000
NODE_4482_length_1140_cov_39.383285	580	660	2	45	80	0.5625000
NODE_4482_length_1140_cov_39.383285	580	660	3	35	80	0.4375000
NODE_4482_length_1140_cov_39.383285	633	713	0	7	80	0.0875000
NODE_4482_length_1140_cov_39.383285	633	713	2	73	80	0.9125000
NODE_4483_length_1140_cov_19.493756	543	623	0	80	80	1.0000000
NODE_4483_length_1140_cov_19.493756	596	676	0	80	80	1.0000000
NODE_4484_length_1140_cov_18.341018	347	427	0	23	80	0.2875000
NODE_4484_length_1140_cov_18.341018	347	427	1	47	80	0.5875000
NODE_4484_length_1140_cov_18.341018	347	427	2	10	80	0.1250000
NODE_4484_length_1140_cov_18.341018	400	480	1	17	80	0.2125000
NODE_4484_length_1140_cov_18.341018	400	480	2	63	80	0.7875000
NODE_4484_length_1140_cov_18.341018	476	556	1	36	80	0.4500000
NODE_4484_length_1140_cov_18.341018	476	556	2	44	80	0.5500000
NODE_4484_length_1140_cov_18.341018	529	609	0	42	80	0.5250000
NODE_4484_length_1140_cov_18.341018	529	609	1	38	80	0.4750000
NODE_4494_length_1139_cov_26.812500	410	490	0	80	80	1.0000000
NODE_4494_length_1139_cov_26.812500	463	543	0	33	80	0.4125000
NODE_4494_length_1139_cov_26.812500	463	543	1	36	80	0.4500000
NODE_4494_length_1139_cov_26.812500	463	543	2	11	80	0.1375000
NODE_4494_length_1139_cov_26.812500	539	619	2	40	80	0.5000000
NODE_4494_length_1139_cov_26.812500	539	619	4	40	80	0.5000000
NODE_4494_length_1139_cov_26.812500	592	672	1	12	80	0.1500000
NODE_4494_length_1139_cov_26.812500	592	672	3	14	80	0.1750000
NODE_4494_length_1139_cov_26.812500	592	672	4	54	80	0.6750000
NODE_4495_length_1139_cov_26.323077	308	388	0	80	80	1.0000000
NODE_4495_length_1139_cov_26.323077	361	441	0	80	80	1.0000000
NODE_4495_length_1139_cov_26.323077	437	517	0	63	80	0.7875000
NODE_4495_length_1139_cov_26.323077	437	517	2	17	80	0.2125000
NODE_4495_length_1139_cov_26.323077	490	570	0	10	80	0.1250000
NODE_4495_length_1139_cov_26.323077	490	570	2	70	80	0.8750000
NODE_4496_length_1139_cov_15.223077	530	610	1	6	80	0.0750000
NODE_4496_length_1139_cov_15.223077	530	610	3	14	80	0.1750000
NODE_4496_length_1139_cov_15.223077	530	610	4	8	80	0.1000000
NODE_4496_length_1139_cov_15.223077	530	610	5	48	80	0.6000000
NODE_4496_length_1139_cov_15.223077	530	610	6	4	80	0.0500000
NODE_4496_length_1139_cov_15.223077	583	663	4	3	80	0.0375000
NODE_4496_length_1139_cov_15.223077	583	663	5	23	80	0.2875000
NODE_4496_length_1139_cov_15.223077	583	663	6	54	80	0.6750000
NODE_4505_length_1138_cov_74.599615	480	560	5	1	80	0.0125000
NODE_4505_length_1138_cov_74.599615	480	560	6	24	80	0.3000000
NODE_4505_length_1138_cov_74.599615	480	560	7	28	80	0.3500000
NODE_4505_length_1138_cov_74.599615	480	560	8	27	80	0.3375000
NODE_4505_length_1138_cov_74.599615	533	613	4	9	80	0.1125000
NODE_4505_length_1138_cov_74.599615	533	613	5	14	80	0.1750000
NODE_4505_length_1138_cov_74.599615	533	613	6	33	80	0.4125000
NODE_4505_length_1138_cov_74.599615	533	613	7	24	80	0.3000000
NODE_4505_length_1138_cov_74.599615	609	689	4	67	80	0.8375000
NODE_4505_length_1138_cov_74.599615	609	689	5	13	80	0.1625000
NODE_4505_length_1138_cov_74.599615	662	742	1	6	80	0.0750000
NODE_4505_length_1138_cov_74.599615	662	742	2	9	80	0.1125000
NODE_4505_length_1138_cov_74.599615	662	742	4	65	80	0.8125000
NODE_4506_length_1138_cov_29.407122	559	639	1	6	80	0.0750000
NODE_4506_length_1138_cov_29.407122	559	639	3	74	80	0.9250000
NODE_4506_length_1138_cov_29.407122	612	692	2	23	80	0.2875000
NODE_4506_length_1138_cov_29.407122	612	692	3	57	80	0.7125000
NODE_4506_length_1138_cov_29.407122	688	768	1	54	80	0.6750000
NODE_4506_length_1138_cov_29.407122	688	768	3	26	80	0.3250000
NODE_4506_length_1138_cov_29.407122	741	821	0	2	80	0.0250000
NODE_4506_length_1138_cov_29.407122	741	821	1	78	80	0.9750000
NODE_4507_length_1138_cov_18.326275	454	534	4	17	80	0.2125000
NODE_4507_length_1138_cov_18.326275	454	534	5	63	80	0.7875000
NODE_4507_length_1138_cov_18.326275	507	587	2	18	80	0.2250000
NODE_4507_length_1138_cov_18.326275	507	587	3	19	80	0.2375000
NODE_4507_length_1138_cov_18.326275	507	587	5	34	80	0.4250000
NODE_4507_length_1138_cov_18.326275	507	587	6	9	80	0.1125000
NODE_4507_length_1138_cov_18.326275	583	663	1	42	80	0.5250000
NODE_4507_length_1138_cov_18.326275	583	663	2	38	80	0.4750000
NODE_4507_length_1138_cov_18.326275	636	716	0	29	80	0.3625000
NODE_4507_length_1138_cov_18.326275	636	716	1	51	80	0.6375000
NODE_4509_length_1138_cov_11.834456	291	371	2	66	80	0.8250000
NODE_4509_length_1138_cov_11.834456	291	371	3	14	80	0.1750000
NODE_4509_length_1138_cov_11.834456	344	424	2	13	80	0.1625000
NODE_4509_length_1138_cov_11.834456	344	424	3	19	80	0.2375000
NODE_4509_length_1138_cov_11.834456	344	424	4	48	80	0.6000000
NODE_4510_length_1138_cov_10.923003	318	398	1	25	80	0.3125000
NODE_4510_length_1138_cov_10.923003	318	398	2	12	80	0.1500000
NODE_4510_length_1138_cov_10.923003	318	398	3	8	80	0.1000000
NODE_4510_length_1138_cov_10.923003	318	398	4	35	80	0.4375000
NODE_4510_length_1138_cov_10.923003	371	451	3	7	80	0.0875000
NODE_4510_length_1138_cov_10.923003	371	451	4	73	80	0.9125000
NODE_4517_length_1137_cov_23.983622	470	550	2	18	80	0.2250000
NODE_4517_length_1137_cov_23.983622	470	550	3	15	80	0.1875000
NODE_4517_length_1137_cov_23.983622	470	550	4	47	80	0.5875000
NODE_4517_length_1137_cov_23.983622	523	603	2	12	80	0.1500000
NODE_4517_length_1137_cov_23.983622	523	603	3	57	80	0.7125000
NODE_4517_length_1137_cov_23.983622	523	603	4	1	80	0.0125000
NODE_4517_length_1137_cov_23.983622	523	603	5	10	80	0.1250000
NODE_4517_length_1137_cov_23.983622	599	679	3	11	80	0.1375000
NODE_4517_length_1137_cov_23.983622	599	679	4	10	80	0.1250000
NODE_4517_length_1137_cov_23.983622	599	679	6	17	80	0.2125000
NODE_4517_length_1137_cov_23.983622	599	679	8	42	80	0.5250000
NODE_4517_length_1137_cov_23.983622	652	732	5	1	80	0.0125000
NODE_4517_length_1137_cov_23.983622	652	732	7	46	80	0.5750000
NODE_4517_length_1137_cov_23.983622	652	732	8	33	80	0.4125000
NODE_4518_length_1137_cov_22.877649	405	485	0	80	80	1.0000000
NODE_4518_length_1137_cov_22.877649	458	538	0	80	80	1.0000000
NODE_4518_length_1137_cov_22.877649	534	614	0	80	80	1.0000000
NODE_4518_length_1137_cov_22.877649	587	667	0	80	80	1.0000000
NODE_4519_length_1137_cov_21.570328	383	463	3	80	80	1.0000000
NODE_4519_length_1137_cov_21.570328	436	516	1	10	80	0.1250000
NODE_4519_length_1137_cov_21.570328	436	516	2	9	80	0.1125000
NODE_4519_length_1137_cov_21.570328	436	516	3	61	80	0.7625000
NODE_4520_length_1137_cov_18.560694	665	745	3	4	80	0.0500000
NODE_4520_length_1137_cov_18.560694	665	745	4	16	80	0.2000000
NODE_4520_length_1137_cov_18.560694	665	745	5	6	80	0.0750000
NODE_4520_length_1137_cov_18.560694	665	745	7	54	80	0.6750000
NODE_4520_length_1137_cov_18.560694	718	798	3	18	80	0.2250000
NODE_4520_length_1137_cov_18.560694	718	798	5	5	80	0.0625000
NODE_4520_length_1137_cov_18.560694	718	798	7	57	80	0.7125000
NODE_4521_length_1137_cov_18.505780	557	637	1	20	80	0.2500000
NODE_4521_length_1137_cov_18.505780	557	637	2	60	80	0.7500000
NODE_4521_length_1137_cov_18.505780	610	690	0	35	80	0.4375000
NODE_4521_length_1137_cov_18.505780	610	690	1	38	80	0.4750000
NODE_4521_length_1137_cov_18.505780	610	690	2	7	80	0.0875000
NODE_4521_length_1137_cov_18.505780	686	766	0	80	80	1.0000000
NODE_4521_length_1137_cov_18.505780	739	819	0	80	80	1.0000000
NODE_4523_length_1137_cov_11.866089	313	393	0	80	80	1.0000000
NODE_4523_length_1137_cov_11.866089	366	446	0	80	80	1.0000000
NODE_4523_length_1137_cov_11.866089	442	522	0	48	80	0.6000000
NODE_4523_length_1137_cov_11.866089	442	522	1	32	80	0.4000000
NODE_4523_length_1137_cov_11.866089	495	575	1	52	80	0.6500000
NODE_4523_length_1137_cov_11.866089	495	575	2	28	80	0.3500000
NODE_4524_length_1137_cov_5.594412	144	224	0	80	80	1.0000000
NODE_4524_length_1137_cov_5.594412	197	277	0	80	80	1.0000000
NODE_4532_length_1136_cov_42.827387	445	525	0	10	80	0.1250000
NODE_4532_length_1136_cov_42.827387	445	525	1	70	80	0.8750000
NODE_4532_length_1136_cov_42.827387	498	578	1	45	80	0.5625000
NODE_4532_length_1136_cov_42.827387	498	578	2	15	80	0.1875000
NODE_4532_length_1136_cov_42.827387	498	578	3	6	80	0.0750000
NODE_4532_length_1136_cov_42.827387	498	578	5	14	80	0.1750000
NODE_4532_length_1136_cov_42.827387	574	654	4	49	80	0.6125000
NODE_4532_length_1136_cov_42.827387	574	654	5	31	80	0.3875000
NODE_4532_length_1136_cov_42.827387	627	707	3	14	80	0.1750000
NODE_4532_length_1136_cov_42.827387	627	707	4	66	80	0.8250000
NODE_4533_length_1136_cov_30.940212	534	614	1	14	80	0.1750000
NODE_4533_length_1136_cov_30.940212	534	614	2	55	80	0.6875000
NODE_4533_length_1136_cov_30.940212	534	614	4	11	80	0.1375000
NODE_4533_length_1136_cov_30.940212	587	667	2	16	80	0.2000000
NODE_4533_length_1136_cov_30.940212	587	667	4	29	80	0.3625000
NODE_4533_length_1136_cov_30.940212	587	667	5	33	80	0.4125000
NODE_4533_length_1136_cov_30.940212	587	667	7	2	80	0.0250000
NODE_4533_length_1136_cov_30.940212	663	743	5	13	80	0.1625000
NODE_4533_length_1136_cov_30.940212	663	743	7	59	80	0.7375000
NODE_4533_length_1136_cov_30.940212	663	743	8	8	80	0.1000000
NODE_4533_length_1136_cov_30.940212	716	796	1	7	80	0.0875000
NODE_4533_length_1136_cov_30.940212	716	796	2	3	80	0.0375000
NODE_4533_length_1136_cov_30.940212	716	796	4	15	80	0.1875000
NODE_4533_length_1136_cov_30.940212	716	796	5	39	80	0.4875000
NODE_4533_length_1136_cov_30.940212	716	796	7	8	80	0.1000000
NODE_4533_length_1136_cov_30.940212	716	796	8	8	80	0.1000000
NODE_4534_length_1136_cov_30.797493	557	637	3	7	80	0.0875000
NODE_4534_length_1136_cov_30.797493	557	637	4	42	80	0.5250000
NODE_4534_length_1136_cov_30.797493	557	637	5	14	80	0.1750000
NODE_4534_length_1136_cov_30.797493	557	637	6	17	80	0.2125000
NODE_4534_length_1136_cov_30.797493	610	691	4	1	81	0.0123457
NODE_4534_length_1136_cov_30.797493	610	691	5	39	81	0.4814815
NODE_4534_length_1136_cov_30.797493	610	691	6	19	81	0.2345679
NODE_4534_length_1136_cov_30.797493	610	691	7	22	81	0.2716049
NODE_4534_length_1136_cov_30.797493	687	767	2	3	80	0.0375000
NODE_4534_length_1136_cov_30.797493	687	767	3	59	80	0.7375000
NODE_4534_length_1136_cov_30.797493	687	767	5	18	80	0.2250000
NODE_4534_length_1136_cov_30.797493	740	820	0	28	80	0.3500000
NODE_4534_length_1136_cov_30.797493	740	820	1	19	80	0.2375000
NODE_4534_length_1136_cov_30.797493	740	820	2	9	80	0.1125000
NODE_4534_length_1136_cov_30.797493	740	820	3	24	80	0.3000000
NODE_4535_length_1136_cov_23.142719	704	784	1	26	80	0.3250000
NODE_4535_length_1136_cov_23.142719	704	784	2	13	80	0.1625000
NODE_4535_length_1136_cov_23.142719	704	784	4	12	80	0.1500000
NODE_4535_length_1136_cov_23.142719	704	784	6	29	80	0.3625000
NODE_4535_length_1136_cov_23.142719	757	837	5	5	80	0.0625000
NODE_4535_length_1136_cov_23.142719	757	837	6	75	80	0.9375000
NODE_4536_length_1136_cov_21.798457	570	651	0	75	81	0.9259259
NODE_4536_length_1136_cov_21.798457	570	651	1	6	81	0.0740741
NODE_4536_length_1136_cov_21.798457	624	704	0	48	80	0.6000000
NODE_4536_length_1136_cov_21.798457	624	704	1	32	80	0.4000000
NODE_4537_length_1136_cov_21.109932	460	532	1	6	72	0.0833333
NODE_4537_length_1136_cov_21.109932	460	532	3	66	72	0.9166667
NODE_4537_length_1136_cov_21.109932	505	585	1	11	80	0.1375000
NODE_4537_length_1136_cov_21.109932	505	585	2	37	80	0.4625000
NODE_4537_length_1136_cov_21.109932	505	585	3	23	80	0.2875000
NODE_4537_length_1136_cov_21.109932	505	585	4	9	80	0.1125000
NODE_4538_length_1136_cov_20.528447	19	99	9	70	80	0.8750000
NODE_4538_length_1136_cov_20.528447	19	99	10	4	80	0.0500000
NODE_4538_length_1136_cov_20.528447	19	99	11	5	80	0.0625000
NODE_4538_length_1136_cov_20.528447	19	99	12	1	80	0.0125000
NODE_4538_length_1136_cov_20.528447	19	99	9	70	80	0.8750000
NODE_4538_length_1136_cov_20.528447	19	99	10	4	80	0.0500000
NODE_4538_length_1136_cov_20.528447	19	99	11	5	80	0.0625000
NODE_4538_length_1136_cov_20.528447	19	99	12	1	80	0.0125000
NODE_4538_length_1136_cov_20.528447	28	99	9	61	71	0.8591549
NODE_4538_length_1136_cov_20.528447	28	99	10	4	71	0.0563380
NODE_4538_length_1136_cov_20.528447	28	99	11	5	71	0.0704225
NODE_4538_length_1136_cov_20.528447	28	99	12	1	71	0.0140845
NODE_4538_length_1136_cov_20.528447	877	912	0	35	35	1.0000000
NODE_4538_length_1136_cov_20.528447	879	921	0	42	42	1.0000000
NODE_4539_length_1136_cov_14.921890	657	737	0	40	80	0.5000000
NODE_4539_length_1136_cov_14.921890	657	737	1	40	80	0.5000000
NODE_4539_length_1136_cov_14.921890	710	790	1	50	80	0.6250000
NODE_4539_length_1136_cov_14.921890	710	790	2	30	80	0.3750000
NODE_4556_length_1135_cov_100.121622	454	534	3	10	80	0.1250000
NODE_4556_length_1135_cov_100.121622	454	534	4	66	80	0.8250000
NODE_4556_length_1135_cov_100.121622	454	534	6	4	80	0.0500000
NODE_4556_length_1135_cov_100.121622	507	587	1	5	80	0.0625000
NODE_4556_length_1135_cov_100.121622	507	587	3	33	80	0.4125000
NODE_4556_length_1135_cov_100.121622	507	587	4	38	80	0.4750000
NODE_4556_length_1135_cov_100.121622	507	587	6	4	80	0.0500000
NODE_4556_length_1135_cov_100.121622	583	663	1	18	80	0.2250000
NODE_4556_length_1135_cov_100.121622	583	663	3	1	80	0.0125000
NODE_4556_length_1135_cov_100.121622	583	663	4	15	80	0.1875000
NODE_4556_length_1135_cov_100.121622	583	663	5	34	80	0.4250000
NODE_4556_length_1135_cov_100.121622	583	663	7	12	80	0.1500000
NODE_4556_length_1135_cov_100.121622	636	719	5	15	83	0.1807229
NODE_4556_length_1135_cov_100.121622	636	719	6	29	83	0.3493976
NODE_4556_length_1135_cov_100.121622	636	719	7	39	83	0.4698795
NODE_4557_length_1135_cov_34.523166	313	393	0	16	80	0.2000000
NODE_4557_length_1135_cov_34.523166	313	393	1	15	80	0.1875000
NODE_4557_length_1135_cov_34.523166	313	393	3	31	80	0.3875000
NODE_4557_length_1135_cov_34.523166	313	393	4	18	80	0.2250000
NODE_4557_length_1135_cov_34.523166	366	446	3	9	80	0.1125000
NODE_4557_length_1135_cov_34.523166	366	446	4	51	80	0.6375000
NODE_4557_length_1135_cov_34.523166	366	446	5	20	80	0.2500000
NODE_4558_length_1135_cov_20.735521	484	564	1	66	80	0.8250000
NODE_4558_length_1135_cov_20.735521	484	564	2	14	80	0.1750000
NODE_4558_length_1135_cov_20.735521	537	617	1	80	80	1.0000000
NODE_4558_length_1135_cov_20.735521	613	693	0	23	80	0.2875000
NODE_4558_length_1135_cov_20.735521	613	693	1	57	80	0.7125000
NODE_4558_length_1135_cov_20.735521	666	746	0	76	80	0.9500000
NODE_4558_length_1135_cov_20.735521	666	746	1	4	80	0.0500000
NODE_4559_length_1135_cov_9.644788	620	700	0	33	80	0.4125000
NODE_4559_length_1135_cov_9.644788	620	700	2	43	80	0.5375000
NODE_4559_length_1135_cov_9.644788	620	700	4	4	80	0.0500000
NODE_4559_length_1135_cov_9.644788	673	753	2	23	80	0.2875000
NODE_4559_length_1135_cov_9.644788	673	753	4	57	80	0.7125000
NODE_4562_length_1135_cov_2.990347	349	429	1	30	80	0.3750000
NODE_4562_length_1135_cov_2.990347	349	429	2	36	80	0.4500000
NODE_4562_length_1135_cov_2.990347	349	429	3	14	80	0.1750000
NODE_4562_length_1135_cov_2.990347	402	482	2	30	80	0.3750000
NODE_4562_length_1135_cov_2.990347	402	482	3	50	80	0.6250000
NODE_4571_length_1134_cov_34.784541	478	558	4	13	80	0.1625000
NODE_4571_length_1134_cov_34.784541	478	558	5	50	80	0.6250000
NODE_4571_length_1134_cov_34.784541	478	558	6	17	80	0.2125000
NODE_4571_length_1134_cov_34.784541	531	611	2	18	80	0.2250000
NODE_4571_length_1134_cov_34.784541	531	611	3	2	80	0.0250000
NODE_4571_length_1134_cov_34.784541	531	611	4	46	80	0.5750000
NODE_4571_length_1134_cov_34.784541	531	611	5	3	80	0.0375000
NODE_4571_length_1134_cov_34.784541	531	611	6	11	80	0.1375000
NODE_4571_length_1134_cov_34.784541	607	687	2	2	80	0.0250000
NODE_4571_length_1134_cov_34.784541	607	687	3	29	80	0.3625000
NODE_4571_length_1134_cov_34.784541	607	687	4	16	80	0.2000000
NODE_4571_length_1134_cov_34.784541	607	687	5	8	80	0.1000000
NODE_4571_length_1134_cov_34.784541	607	687	6	25	80	0.3125000
NODE_4571_length_1134_cov_34.784541	660	740	4	6	80	0.0750000
NODE_4571_length_1134_cov_34.784541	660	740	5	55	80	0.6875000
NODE_4571_length_1134_cov_34.784541	660	740	6	19	80	0.2375000
NODE_4572_length_1134_cov_28.524638	511	591	4	65	80	0.8125000
NODE_4572_length_1134_cov_28.524638	511	591	5	15	80	0.1875000
NODE_4572_length_1134_cov_28.524638	564	644	1	18	80	0.2250000
NODE_4572_length_1134_cov_28.524638	564	644	3	7	80	0.0875000
NODE_4572_length_1134_cov_28.524638	564	644	4	55	80	0.6875000
NODE_4572_length_1134_cov_28.524638	640	720	0	59	80	0.7375000
NODE_4572_length_1134_cov_28.524638	640	720	1	21	80	0.2625000
NODE_4572_length_1134_cov_28.524638	693	773	0	80	80	1.0000000
NODE_4576_length_1134_cov_2.619324	606	686	0	80	80	1.0000000
NODE_4576_length_1134_cov_2.619324	659	739	0	80	80	1.0000000
NODE_4584_length_1133_cov_5.563830	292	372	0	35	80	0.4375000
NODE_4584_length_1133_cov_5.563830	292	372	1	11	80	0.1375000
NODE_4584_length_1133_cov_5.563830	292	372	2	34	80	0.4250000
NODE_4584_length_1133_cov_5.563830	345	425	2	79	80	0.9875000
NODE_4584_length_1133_cov_5.563830	345	425	4	1	80	0.0125000
NODE_4584_length_1133_cov_5.563830	904	966	2	51	62	0.8225806
NODE_4584_length_1133_cov_5.563830	904	966	4	11	62	0.1774193
NODE_4592_length_1132_cov_23.121007	485	565	0	51	80	0.6375000
NODE_4592_length_1132_cov_23.121007	485	565	2	29	80	0.3625000
NODE_4592_length_1132_cov_23.121007	538	618	2	34	80	0.4250000
NODE_4592_length_1132_cov_23.121007	538	618	3	42	80	0.5250000
NODE_4592_length_1132_cov_23.121007	538	618	4	1	80	0.0125000
NODE_4592_length_1132_cov_23.121007	538	618	5	3	80	0.0375000
NODE_4592_length_1132_cov_23.121007	618	664	5	46	46	1.0000000
NODE_4592_length_1132_cov_23.121007	700	751	2	51	51	1.0000000
NODE_4593_length_1132_cov_19.377541	595	675	4	40	80	0.5000000
NODE_4593_length_1132_cov_19.377541	595	675	5	40	80	0.5000000
NODE_4593_length_1132_cov_19.377541	648	728	2	20	80	0.2500000
NODE_4593_length_1132_cov_19.377541	648	728	3	17	80	0.2125000
NODE_4593_length_1132_cov_19.377541	648	728	4	24	80	0.3000000
NODE_4593_length_1132_cov_19.377541	648	728	5	19	80	0.2375000
NODE_4594_length_1132_cov_18.872217	363	443	3	38	80	0.4750000
NODE_4594_length_1132_cov_18.872217	363	443	4	17	80	0.2125000
NODE_4594_length_1132_cov_18.872217	363	443	5	25	80	0.3125000
NODE_4594_length_1132_cov_18.872217	416	496	3	2	80	0.0250000
NODE_4594_length_1132_cov_18.872217	416	496	5	69	80	0.8625000
NODE_4594_length_1132_cov_18.872217	416	496	6	9	80	0.1125000
NODE_4595_length_1132_cov_11.242982	474	554	0	80	80	1.0000000
NODE_4595_length_1132_cov_11.242982	527	607	0	80	80	1.0000000
NODE_4596_length_1132_cov_7.356244	354	434	0	5	80	0.0625000
NODE_4596_length_1132_cov_7.356244	354	434	1	75	80	0.9375000
NODE_4596_length_1132_cov_7.356244	407	487	0	58	80	0.7250000
NODE_4596_length_1132_cov_7.356244	407	487	1	22	80	0.2750000
NODE_4597_length_1132_cov_6.214908	269	349	0	80	80	1.0000000
NODE_4597_length_1132_cov_6.214908	322	402	0	80	80	1.0000000
NODE_4606_length_1131_cov_36.161822	478	558	0	74	80	0.9250000
NODE_4606_length_1131_cov_36.161822	478	558	1	6	80	0.0750000
NODE_4606_length_1131_cov_36.161822	531	611	0	21	80	0.2625000
NODE_4606_length_1131_cov_36.161822	531	611	1	21	80	0.2625000
NODE_4606_length_1131_cov_36.161822	531	611	2	38	80	0.4750000
NODE_4606_length_1131_cov_36.161822	607	687	2	47	80	0.5875000
NODE_4606_length_1131_cov_36.161822	607	687	3	26	80	0.3250000
NODE_4606_length_1131_cov_36.161822	607	687	4	7	80	0.0875000
NODE_4606_length_1131_cov_36.161822	660	740	2	17	80	0.2125000
NODE_4606_length_1131_cov_36.161822	660	740	3	41	80	0.5125000
NODE_4606_length_1131_cov_36.161822	660	740	4	22	80	0.2750000
NODE_4607_length_1131_cov_31.907946	390	470	5	65	80	0.8125000
NODE_4607_length_1131_cov_31.907946	390	470	6	15	80	0.1875000
NODE_4607_length_1131_cov_31.907946	443	523	4	39	80	0.4875000
NODE_4607_length_1131_cov_31.907946	443	523	5	23	80	0.2875000
NODE_4607_length_1131_cov_31.907946	443	523	6	18	80	0.2250000
NODE_4607_length_1131_cov_31.907946	519	599	4	5	80	0.0625000
NODE_4607_length_1131_cov_31.907946	519	599	5	27	80	0.3375000
NODE_4607_length_1131_cov_31.907946	519	599	6	48	80	0.6000000
NODE_4607_length_1131_cov_31.907946	572	652	4	1	80	0.0125000
NODE_4607_length_1131_cov_31.907946	572	652	5	35	80	0.4375000
NODE_4607_length_1131_cov_31.907946	572	652	6	44	80	0.5500000
NODE_4608_length_1131_cov_26.827519	464	544	3	80	80	1.0000000
NODE_4608_length_1131_cov_26.827519	517	597	1	27	80	0.3375000
NODE_4608_length_1131_cov_26.827519	517	597	2	10	80	0.1250000
NODE_4608_length_1131_cov_26.827519	517	597	3	43	80	0.5375000
NODE_4609_length_1131_cov_20.441860	555	635	4	14	80	0.1750000
NODE_4609_length_1131_cov_20.441860	555	635	5	6	80	0.0750000
NODE_4609_length_1131_cov_20.441860	555	635	6	32	80	0.4000000
NODE_4609_length_1131_cov_20.441860	555	635	7	28	80	0.3500000
NODE_4609_length_1131_cov_20.441860	608	688	2	1	80	0.0125000
NODE_4609_length_1131_cov_20.441860	608	688	4	12	80	0.1500000
NODE_4609_length_1131_cov_20.441860	608	688	5	46	80	0.5750000
NODE_4609_length_1131_cov_20.441860	608	688	6	5	80	0.0625000
NODE_4609_length_1131_cov_20.441860	608	688	7	16	80	0.2000000
NODE_4610_length_1131_cov_12.517442	420	500	1	69	80	0.8625000
NODE_4610_length_1131_cov_12.517442	420	500	2	11	80	0.1375000
NODE_4610_length_1131_cov_12.517442	473	553	0	48	80	0.6000000
NODE_4610_length_1131_cov_12.517442	473	553	1	32	80	0.4000000
NODE_4611_length_1131_cov_10.912791	429	509	0	80	80	1.0000000
NODE_4611_length_1131_cov_10.912791	482	562	0	80	80	1.0000000
NODE_4620_length_1130_cov_43.354995	742	822	0	80	80	1.0000000
NODE_4620_length_1130_cov_43.354995	795	875	0	80	80	1.0000000
NODE_4621_length_1130_cov_13.097963	642	722	1	35	80	0.4375000
NODE_4621_length_1130_cov_13.097963	642	722	3	41	80	0.5125000
NODE_4621_length_1130_cov_13.097963	642	722	4	4	80	0.0500000
NODE_4621_length_1130_cov_13.097963	695	775	3	23	80	0.2875000
NODE_4621_length_1130_cov_13.097963	695	775	4	57	80	0.7125000
NODE_4626_length_1129_cov_31.088350	396	476	1	80	80	1.0000000
NODE_4626_length_1129_cov_31.088350	449	529	0	36	80	0.4500000
NODE_4626_length_1129_cov_31.088350	449	529	1	44	80	0.5500000
NODE_4627_length_1129_cov_20.591262	450	530	2	33	80	0.4125000
NODE_4627_length_1129_cov_20.591262	450	530	3	31	80	0.3875000
NODE_4627_length_1129_cov_20.591262	450	530	5	16	80	0.2000000
NODE_4627_length_1129_cov_20.591262	503	583	3	11	80	0.1375000
NODE_4627_length_1129_cov_20.591262	503	583	4	30	80	0.3750000
NODE_4627_length_1129_cov_20.591262	503	583	5	39	80	0.4875000
NODE_4628_length_1129_cov_16.934951	261	341	0	80	80	1.0000000
NODE_4628_length_1129_cov_16.934951	314	394	0	38	80	0.4750000
NODE_4628_length_1129_cov_16.934951	314	394	2	42	80	0.5250000
NODE_4629_length_1129_cov_9.441748	665	738	0	73	73	1.0000000
NODE_4629_length_1129_cov_9.441748	711	791	0	80	80	1.0000000
NODE_4630_length_1129_cov_9.260194	658	738	0	29	80	0.3625000
NODE_4630_length_1129_cov_9.260194	658	738	1	31	80	0.3875000
NODE_4630_length_1129_cov_9.260194	658	738	2	20	80	0.2500000
NODE_4630_length_1129_cov_9.260194	711	791	0	80	80	1.0000000
NODE_4631_length_1129_cov_5.055340	759	839	3	80	80	1.0000000
NODE_4638_length_1128_cov_48.099125	588	668	2	26	80	0.3250000
NODE_4638_length_1128_cov_48.099125	588	668	3	3	80	0.0375000
NODE_4638_length_1128_cov_48.099125	588	668	4	13	80	0.1625000
NODE_4638_length_1128_cov_48.099125	588	668	5	12	80	0.1500000
NODE_4638_length_1128_cov_48.099125	588	668	6	26	80	0.3250000
NODE_4638_length_1128_cov_48.099125	641	721	5	1	80	0.0125000
NODE_4638_length_1128_cov_48.099125	641	721	6	79	80	0.9875000
NODE_4640_length_1128_cov_26.230321	455	535	3	11	80	0.1375000
NODE_4640_length_1128_cov_26.230321	455	535	5	40	80	0.5000000
NODE_4640_length_1128_cov_26.230321	455	535	7	9	80	0.1125000
NODE_4640_length_1128_cov_26.230321	455	535	8	20	80	0.2500000
NODE_4640_length_1128_cov_26.230321	508	588	5	7	80	0.0875000
NODE_4640_length_1128_cov_26.230321	508	588	6	23	80	0.2875000
NODE_4640_length_1128_cov_26.230321	508	588	7	14	80	0.1750000
NODE_4640_length_1128_cov_26.230321	508	588	8	36	80	0.4500000
NODE_4640_length_1128_cov_26.230321	584	664	1	58	80	0.7250000
NODE_4640_length_1128_cov_26.230321	584	664	3	12	80	0.1500000
NODE_4640_length_1128_cov_26.230321	584	664	5	10	80	0.1250000
NODE_4640_length_1128_cov_26.230321	637	718	0	53	81	0.6543210
NODE_4640_length_1128_cov_26.230321	637	718	1	28	81	0.3456790
NODE_4641_length_1128_cov_26.031098	594	674	2	25	80	0.3125000
NODE_4641_length_1128_cov_26.031098	594	674	3	11	80	0.1375000
NODE_4641_length_1128_cov_26.031098	594	674	4	8	80	0.1000000
NODE_4641_length_1128_cov_26.031098	594	674	5	11	80	0.1375000
NODE_4641_length_1128_cov_26.031098	594	674	6	21	80	0.2625000
NODE_4641_length_1128_cov_26.031098	594	674	7	4	80	0.0500000
NODE_4641_length_1128_cov_26.031098	647	727	5	3	80	0.0375000
NODE_4641_length_1128_cov_26.031098	647	727	6	43	80	0.5375000
NODE_4641_length_1128_cov_26.031098	647	727	7	34	80	0.4250000
NODE_4642_length_1128_cov_25.869776	465	538	3	25	73	0.3424658
NODE_4642_length_1128_cov_25.869776	465	538	4	36	73	0.4931507
NODE_4642_length_1128_cov_25.869776	465	538	5	12	73	0.1643836
NODE_4642_length_1128_cov_25.869776	601	674	1	17	73	0.2328767
NODE_4642_length_1128_cov_25.869776	601	674	2	18	73	0.2465753
NODE_4642_length_1128_cov_25.869776	601	674	3	38	73	0.5205479
NODE_4642_length_1128_cov_25.869776	647	723	0	28	76	0.3684210
NODE_4642_length_1128_cov_25.869776	647	723	1	38	76	0.5000000
NODE_4642_length_1128_cov_25.869776	647	723	2	10	76	0.1315790
NODE_4643_length_1128_cov_24.185617	350	430	2	23	80	0.2875000
NODE_4643_length_1128_cov_24.185617	350	430	3	37	80	0.4625000
NODE_4643_length_1128_cov_24.185617	350	430	4	20	80	0.2500000
NODE_4643_length_1128_cov_24.185617	403	483	3	33	80	0.4125000
NODE_4643_length_1128_cov_24.185617	403	483	4	47	80	0.5875000
NODE_4644_length_1128_cov_18.537415	335	415	2	26	80	0.3250000
NODE_4644_length_1128_cov_18.537415	335	415	4	54	80	0.6750000
NODE_4644_length_1128_cov_18.537415	388	468	2	2	80	0.0250000
NODE_4644_length_1128_cov_18.537415	388	468	4	78	80	0.9750000
NODE_4645_length_1128_cov_9.345967	690	770	0	19	80	0.2375000
NODE_4645_length_1128_cov_9.345967	690	770	1	61	80	0.7625000
NODE_4645_length_1128_cov_9.345967	743	823	1	59	80	0.7375000
NODE_4645_length_1128_cov_9.345967	743	823	3	13	80	0.1625000
NODE_4645_length_1128_cov_9.345967	743	823	5	8	80	0.1000000
NODE_4647_length_1128_cov_3.920311	675	725	0	50	50	1.0000000
NODE_4647_length_1128_cov_3.920311	698	778	0	80	80	1.0000000
NODE_4648_length_1128_cov_3.631681	613	693	0	80	80	1.0000000
NODE_4648_length_1128_cov_3.631681	666	746	0	80	80	1.0000000
NODE_4650_length_1128_cov_3.091351	519	599	0	17	80	0.2125000
NODE_4650_length_1128_cov_3.091351	519	599	2	63	80	0.7875000
NODE_4650_length_1128_cov_3.091351	572	652	0	6	80	0.0750000
NODE_4650_length_1128_cov_3.091351	572	652	2	74	80	0.9250000
NODE_4660_length_1127_cov_38.932879	405	485	0	53	80	0.6625000
NODE_4660_length_1127_cov_38.932879	405	485	1	13	80	0.1625000
NODE_4660_length_1127_cov_38.932879	405	485	2	14	80	0.1750000
NODE_4660_length_1127_cov_38.932879	458	538	1	13	80	0.1625000
NODE_4660_length_1127_cov_38.932879	458	538	2	17	80	0.2125000
NODE_4660_length_1127_cov_38.932879	458	538	3	1	80	0.0125000
NODE_4660_length_1127_cov_38.932879	458	538	4	16	80	0.2000000
NODE_4660_length_1127_cov_38.932879	458	538	5	33	80	0.4125000
NODE_4660_length_1127_cov_38.932879	534	614	5	40	80	0.5000000
NODE_4660_length_1127_cov_38.932879	534	614	6	40	80	0.5000000
NODE_4660_length_1127_cov_38.932879	587	667	1	4	80	0.0500000
NODE_4660_length_1127_cov_38.932879	587	667	2	8	80	0.1000000
NODE_4660_length_1127_cov_38.932879	587	667	3	16	80	0.2000000
NODE_4660_length_1127_cov_38.932879	587	667	4	14	80	0.1750000
NODE_4660_length_1127_cov_38.932879	587	667	5	18	80	0.2250000
NODE_4660_length_1127_cov_38.932879	587	667	6	20	80	0.2500000
NODE_4661_length_1127_cov_37.721790	236	316	1	62	80	0.7750000
NODE_4661_length_1127_cov_37.721790	236	316	2	18	80	0.2250000
NODE_4661_length_1127_cov_37.721790	289	369	1	15	80	0.1875000
NODE_4661_length_1127_cov_37.721790	289	369	2	36	80	0.4500000
NODE_4661_length_1127_cov_37.721790	289	369	3	29	80	0.3625000
NODE_4661_length_1127_cov_37.721790	365	445	2	36	80	0.4500000
NODE_4661_length_1127_cov_37.721790	365	445	3	44	80	0.5500000
NODE_4661_length_1127_cov_37.721790	418	498	0	8	80	0.1000000
NODE_4661_length_1127_cov_37.721790	418	498	1	36	80	0.4500000
NODE_4661_length_1127_cov_37.721790	418	498	2	36	80	0.4500000
NODE_4662_length_1127_cov_31.866732	444	523	6	1	79	0.0126582
NODE_4662_length_1127_cov_31.866732	444	523	7	53	79	0.6708861
NODE_4662_length_1127_cov_31.866732	444	523	8	9	79	0.1139240
NODE_4662_length_1127_cov_31.866732	444	523	9	16	79	0.2025317
NODE_4662_length_1127_cov_31.866732	496	576	6	1	80	0.0125000
NODE_4662_length_1127_cov_31.866732	496	576	7	27	80	0.3375000
NODE_4662_length_1127_cov_31.866732	496	576	8	12	80	0.1500000
NODE_4662_length_1127_cov_31.866732	496	576	9	10	80	0.1250000
NODE_4662_length_1127_cov_31.866732	496	576	10	30	80	0.3750000
NODE_4662_length_1127_cov_31.866732	572	652	7	40	80	0.5000000
NODE_4662_length_1127_cov_31.866732	572	652	8	26	80	0.3250000
NODE_4662_length_1127_cov_31.866732	572	652	9	14	80	0.1750000
NODE_4662_length_1127_cov_31.866732	625	705	2	13	80	0.1625000
NODE_4662_length_1127_cov_31.866732	625	705	3	16	80	0.2000000
NODE_4662_length_1127_cov_31.866732	625	705	4	1	80	0.0125000
NODE_4662_length_1127_cov_31.866732	625	705	6	19	80	0.2375000
NODE_4662_length_1127_cov_31.866732	625	705	7	31	80	0.3875000
NODE_4663_length_1127_cov_25.616732	430	510	0	80	80	1.0000000
NODE_4663_length_1127_cov_25.616732	483	563	0	80	80	1.0000000
NODE_4664_length_1127_cov_21.838521	338	418	1	80	80	1.0000000
NODE_4664_length_1127_cov_21.838521	391	471	1	32	80	0.4000000
NODE_4664_length_1127_cov_21.838521	391	471	2	46	80	0.5750000
NODE_4664_length_1127_cov_21.838521	391	471	3	2	80	0.0250000
NODE_4664_length_1127_cov_21.838521	467	547	2	50	80	0.6250000
NODE_4664_length_1127_cov_21.838521	467	547	3	30	80	0.3750000
NODE_4664_length_1127_cov_21.838521	520	600	1	3	80	0.0375000
NODE_4664_length_1127_cov_21.838521	520	600	2	24	80	0.3000000
NODE_4664_length_1127_cov_21.838521	520	600	3	53	80	0.6625000
NODE_4665_length_1127_cov_15.024319	711	800	0	4	89	0.0449438
NODE_4665_length_1127_cov_15.024319	711	800	2	85	89	0.9550562
NODE_4665_length_1127_cov_15.024319	773	853	0	10	80	0.1250000
NODE_4665_length_1127_cov_15.024319	773	853	1	3	80	0.0375000
NODE_4665_length_1127_cov_15.024319	773	853	2	67	80	0.8375000
NODE_4667_length_1127_cov_4.786965	386	466	0	13	80	0.1625000
NODE_4667_length_1127_cov_4.786965	386	466	1	67	80	0.8375000
NODE_4667_length_1127_cov_4.786965	439	519	0	66	80	0.8250000
NODE_4667_length_1127_cov_4.786965	439	519	1	14	80	0.1750000
NODE_4672_length_1126_cov_51.699124	448	528	2	10	80	0.1250000
NODE_4672_length_1126_cov_51.699124	448	528	3	44	80	0.5500000
NODE_4672_length_1126_cov_51.699124	448	528	4	18	80	0.2250000
NODE_4672_length_1126_cov_51.699124	448	528	5	2	80	0.0250000
NODE_4672_length_1126_cov_51.699124	448	528	6	2	80	0.0250000
NODE_4672_length_1126_cov_51.699124	448	528	7	4	80	0.0500000
NODE_4672_length_1126_cov_51.699124	501	581	3	5	80	0.0625000
NODE_4672_length_1126_cov_51.699124	501	581	4	14	80	0.1750000
NODE_4672_length_1126_cov_51.699124	501	581	5	2	80	0.0250000
NODE_4672_length_1126_cov_51.699124	501	581	6	20	80	0.2500000
NODE_4672_length_1126_cov_51.699124	501	581	7	39	80	0.4875000
NODE_4673_length_1126_cov_38.135346	427	507	2	5	80	0.0625000
NODE_4673_length_1126_cov_38.135346	427	507	3	46	80	0.5750000
NODE_4673_length_1126_cov_38.135346	427	507	4	29	80	0.3625000
NODE_4673_length_1126_cov_38.135346	480	560	2	19	80	0.2375000
NODE_4673_length_1126_cov_38.135346	480	560	3	20	80	0.2500000
NODE_4673_length_1126_cov_38.135346	480	560	4	23	80	0.2875000
NODE_4673_length_1126_cov_38.135346	480	560	5	18	80	0.2250000
NODE_4673_length_1126_cov_38.135346	556	638	4	8	82	0.0975610
NODE_4673_length_1126_cov_38.135346	556	638	5	9	82	0.1097561
NODE_4673_length_1126_cov_38.135346	556	638	7	33	82	0.4024390
NODE_4673_length_1126_cov_38.135346	556	638	8	4	82	0.0487805
NODE_4673_length_1126_cov_38.135346	556	638	9	28	82	0.3414634
NODE_4673_length_1126_cov_38.135346	611	691	3	6	80	0.0750000
NODE_4673_length_1126_cov_38.135346	611	691	4	2	80	0.0250000
NODE_4673_length_1126_cov_38.135346	611	691	6	1	80	0.0125000
NODE_4673_length_1126_cov_38.135346	611	691	8	48	80	0.6000000
NODE_4673_length_1126_cov_38.135346	611	691	9	23	80	0.2875000
NODE_4674_length_1126_cov_34.637780	23	97	19	6	74	0.0810811
NODE_4674_length_1126_cov_34.637780	23	97	21	1	74	0.0135135
NODE_4674_length_1126_cov_34.637780	23	97	23	2	74	0.0270270
NODE_4674_length_1126_cov_34.637780	23	97	24	1	74	0.0135135
NODE_4674_length_1126_cov_34.637780	23	97	25	4	74	0.0540541
NODE_4674_length_1126_cov_34.637780	23	97	26	9	74	0.1216216
NODE_4674_length_1126_cov_34.637780	23	97	27	1	74	0.0135135
NODE_4674_length_1126_cov_34.637780	23	97	29	7	74	0.0945946
NODE_4674_length_1126_cov_34.637780	23	97	30	12	74	0.1621622
NODE_4674_length_1126_cov_34.637780	23	97	31	5	74	0.0675676
NODE_4674_length_1126_cov_34.637780	23	97	32	2	74	0.0270270
NODE_4674_length_1126_cov_34.637780	23	97	34	5	74	0.0675676
NODE_4674_length_1126_cov_34.637780	23	97	35	2	74	0.0270270
NODE_4674_length_1126_cov_34.637780	23	97	36	2	74	0.0270270
NODE_4674_length_1126_cov_34.637780	23	97	37	3	74	0.0405405
NODE_4674_length_1126_cov_34.637780	23	97	38	1	74	0.0135135
NODE_4674_length_1126_cov_34.637780	23	97	41	8	74	0.1081081
NODE_4674_length_1126_cov_34.637780	23	97	42	2	74	0.0270270
NODE_4674_length_1126_cov_34.637780	23	97	44	1	74	0.0135135
NODE_4674_length_1126_cov_34.637780	146	226	11	5	80	0.0625000
NODE_4674_length_1126_cov_34.637780	146	226	12	4	80	0.0500000
NODE_4674_length_1126_cov_34.637780	146	226	14	2	80	0.0250000
NODE_4674_length_1126_cov_34.637780	146	226	15	7	80	0.0875000
NODE_4674_length_1126_cov_34.637780	146	226	17	4	80	0.0500000
NODE_4674_length_1126_cov_34.637780	146	226	18	8	80	0.1000000
NODE_4674_length_1126_cov_34.637780	146	226	21	4	80	0.0500000
NODE_4674_length_1126_cov_34.637780	146	226	23	5	80	0.0625000
NODE_4674_length_1126_cov_34.637780	146	226	24	5	80	0.0625000
NODE_4674_length_1126_cov_34.637780	146	226	25	2	80	0.0250000
NODE_4674_length_1126_cov_34.637780	146	226	26	6	80	0.0750000
NODE_4674_length_1126_cov_34.637780	146	226	27	1	80	0.0125000
NODE_4674_length_1126_cov_34.637780	146	226	28	1	80	0.0125000
NODE_4674_length_1126_cov_34.637780	146	226	29	1	80	0.0125000
NODE_4674_length_1126_cov_34.637780	146	226	30	2	80	0.0250000
NODE_4674_length_1126_cov_34.637780	146	226	31	4	80	0.0500000
NODE_4674_length_1126_cov_34.637780	146	226	32	5	80	0.0625000
NODE_4674_length_1126_cov_34.637780	146	226	37	5	80	0.0625000
NODE_4674_length_1126_cov_34.637780	146	226	38	4	80	0.0500000
NODE_4674_length_1126_cov_34.637780	146	226	43	5	80	0.0625000
NODE_4674_length_1126_cov_34.637780	146	226	11	5	80	0.0625000
NODE_4674_length_1126_cov_34.637780	146	226	12	4	80	0.0500000
NODE_4674_length_1126_cov_34.637780	146	226	14	2	80	0.0250000
NODE_4674_length_1126_cov_34.637780	146	226	15	7	80	0.0875000
NODE_4674_length_1126_cov_34.637780	146	226	17	4	80	0.0500000
NODE_4674_length_1126_cov_34.637780	146	226	18	8	80	0.1000000
NODE_4674_length_1126_cov_34.637780	146	226	21	4	80	0.0500000
NODE_4674_length_1126_cov_34.637780	146	226	23	5	80	0.0625000
NODE_4674_length_1126_cov_34.637780	146	226	24	5	80	0.0625000
NODE_4674_length_1126_cov_34.637780	146	226	25	2	80	0.0250000
NODE_4674_length_1126_cov_34.637780	146	226	26	6	80	0.0750000
NODE_4674_length_1126_cov_34.637780	146	226	27	1	80	0.0125000
NODE_4674_length_1126_cov_34.637780	146	226	28	1	80	0.0125000
NODE_4674_length_1126_cov_34.637780	146	226	29	1	80	0.0125000
NODE_4674_length_1126_cov_34.637780	146	226	30	2	80	0.0250000
NODE_4674_length_1126_cov_34.637780	146	226	31	4	80	0.0500000
NODE_4674_length_1126_cov_34.637780	146	226	32	5	80	0.0625000
NODE_4674_length_1126_cov_34.637780	146	226	37	5	80	0.0625000
NODE_4674_length_1126_cov_34.637780	146	226	38	4	80	0.0500000
NODE_4674_length_1126_cov_34.637780	146	226	43	5	80	0.0625000
NODE_4674_length_1126_cov_34.637780	146	208	17	4	62	0.0645161
NODE_4674_length_1126_cov_34.637780	146	208	18	8	62	0.1290323
NODE_4674_length_1126_cov_34.637780	146	208	21	4	62	0.0645161
NODE_4674_length_1126_cov_34.637780	146	208	23	5	62	0.0806452
NODE_4674_length_1126_cov_34.637780	146	208	24	5	62	0.0806452
NODE_4674_length_1126_cov_34.637780	146	208	25	2	62	0.0322581
NODE_4674_length_1126_cov_34.637780	146	208	26	6	62	0.0967742
NODE_4674_length_1126_cov_34.637780	146	208	27	1	62	0.0161290
NODE_4674_length_1126_cov_34.637780	146	208	28	1	62	0.0161290
NODE_4674_length_1126_cov_34.637780	146	208	29	1	62	0.0161290
NODE_4674_length_1126_cov_34.637780	146	208	30	2	62	0.0322581
NODE_4674_length_1126_cov_34.637780	146	208	31	4	62	0.0645161
NODE_4674_length_1126_cov_34.637780	146	208	32	5	62	0.0806452
NODE_4674_length_1126_cov_34.637780	146	208	37	5	62	0.0806452
NODE_4674_length_1126_cov_34.637780	146	208	38	4	62	0.0645161
NODE_4674_length_1126_cov_34.637780	146	208	43	5	62	0.0806452
NODE_4674_length_1126_cov_34.637780	146	217	14	2	71	0.0281690
NODE_4674_length_1126_cov_34.637780	146	217	15	7	71	0.0985916
NODE_4674_length_1126_cov_34.637780	146	217	17	4	71	0.0563380
NODE_4674_length_1126_cov_34.637780	146	217	18	8	71	0.1126761
NODE_4674_length_1126_cov_34.637780	146	217	21	4	71	0.0563380
NODE_4674_length_1126_cov_34.637780	146	217	23	5	71	0.0704225
NODE_4674_length_1126_cov_34.637780	146	217	24	5	71	0.0704225
NODE_4674_length_1126_cov_34.637780	146	217	25	2	71	0.0281690
NODE_4674_length_1126_cov_34.637780	146	217	26	6	71	0.0845070
NODE_4674_length_1126_cov_34.637780	146	217	27	1	71	0.0140845
NODE_4674_length_1126_cov_34.637780	146	217	28	1	71	0.0140845
NODE_4674_length_1126_cov_34.637780	146	217	29	1	71	0.0140845
NODE_4674_length_1126_cov_34.637780	146	217	30	2	71	0.0281690
NODE_4674_length_1126_cov_34.637780	146	217	31	4	71	0.0563380
NODE_4674_length_1126_cov_34.637780	146	217	32	5	71	0.0704225
NODE_4674_length_1126_cov_34.637780	146	217	37	5	71	0.0704225
NODE_4674_length_1126_cov_34.637780	146	217	38	4	71	0.0563380
NODE_4674_length_1126_cov_34.637780	146	217	43	5	71	0.0704225
NODE_4675_length_1126_cov_21.360273	595	675	0	80	80	1.0000000
NODE_4675_length_1126_cov_21.360273	648	728	0	64	80	0.8000000
NODE_4675_length_1126_cov_21.360273	648	728	1	16	80	0.2000000
NODE_4676_length_1126_cov_17.420643	422	502	4	5	80	0.0625000
NODE_4676_length_1126_cov_17.420643	422	502	5	75	80	0.9375000
NODE_4676_length_1126_cov_17.420643	475	555	1	10	80	0.1250000
NODE_4676_length_1126_cov_17.420643	475	555	2	26	80	0.3250000
NODE_4676_length_1126_cov_17.420643	475	555	3	9	80	0.1125000
NODE_4676_length_1126_cov_17.420643	475	555	4	13	80	0.1625000
NODE_4676_length_1126_cov_17.420643	475	555	5	22	80	0.2750000
NODE_4677_length_1126_cov_15.896787	383	463	0	80	80	1.0000000
NODE_4677_length_1126_cov_15.896787	436	516	0	80	80	1.0000000
NODE_4678_length_1126_cov_8.525803	174	254	0	8	80	0.1000000
NODE_4678_length_1126_cov_8.525803	174	254	1	25	80	0.3125000
NODE_4678_length_1126_cov_8.525803	174	254	2	17	80	0.2125000
NODE_4678_length_1126_cov_8.525803	174	254	3	12	80	0.1500000
NODE_4678_length_1126_cov_8.525803	174	254	4	18	80	0.2250000
NODE_4678_length_1126_cov_8.525803	227	307	3	9	80	0.1125000
NODE_4678_length_1126_cov_8.525803	227	307	4	71	80	0.8875000
NODE_4679_length_1126_cov_5.805258	463	543	0	80	80	1.0000000
NODE_4679_length_1126_cov_5.805258	516	596	0	80	80	1.0000000
NODE_4685_length_1126_cov_1.502434	6	86	0	80	80	1.0000000
NODE_4685_length_1126_cov_1.502434	59	108	0	49	49	1.0000000
NODE_4689_length_1125_cov_34.314815	405	485	3	14	80	0.1750000
NODE_4689_length_1125_cov_34.314815	405	485	4	26	80	0.3250000
NODE_4689_length_1125_cov_34.314815	405	485	5	40	80	0.5000000
NODE_4689_length_1125_cov_34.314815	458	538	2	16	80	0.2000000
NODE_4689_length_1125_cov_34.314815	458	538	3	20	80	0.2500000
NODE_4689_length_1125_cov_34.314815	458	538	4	18	80	0.2250000
NODE_4689_length_1125_cov_34.314815	458	538	5	26	80	0.3250000
NODE_4689_length_1125_cov_34.314815	534	614	5	30	80	0.3750000
NODE_4689_length_1125_cov_34.314815	534	614	6	15	80	0.1875000
NODE_4689_length_1125_cov_34.314815	534	614	7	5	80	0.0625000
NODE_4689_length_1125_cov_34.314815	534	614	8	14	80	0.1750000
NODE_4689_length_1125_cov_34.314815	534	614	9	6	80	0.0750000
NODE_4689_length_1125_cov_34.314815	534	614	10	4	80	0.0500000
NODE_4689_length_1125_cov_34.314815	534	614	11	6	80	0.0750000
NODE_4689_length_1125_cov_34.314815	587	667	8	11	80	0.1375000
NODE_4689_length_1125_cov_34.314815	587	667	9	14	80	0.1750000
NODE_4689_length_1125_cov_34.314815	587	667	10	25	80	0.3125000
NODE_4689_length_1125_cov_34.314815	587	667	11	30	80	0.3750000
NODE_4690_length_1125_cov_33.553606	458	538	2	80	80	1.0000000
NODE_4690_length_1125_cov_33.553606	511	591	0	19	80	0.2375000
NODE_4690_length_1125_cov_33.553606	511	591	2	61	80	0.7625000
NODE_4690_length_1125_cov_33.553606	587	667	0	80	80	1.0000000
NODE_4690_length_1125_cov_33.553606	640	720	0	80	80	1.0000000
NODE_4691_length_1125_cov_33.371345	408	488	2	12	80	0.1500000
NODE_4691_length_1125_cov_33.371345	408	488	3	61	80	0.7625000
NODE_4691_length_1125_cov_33.371345	408	488	4	7	80	0.0875000
NODE_4691_length_1125_cov_33.371345	461	541	2	65	80	0.8125000
NODE_4691_length_1125_cov_33.371345	461	541	3	15	80	0.1875000
NODE_4691_length_1125_cov_33.371345	537	617	0	32	80	0.4000000
NODE_4691_length_1125_cov_33.371345	537	617	1	42	80	0.5250000
NODE_4691_length_1125_cov_33.371345	537	617	2	6	80	0.0750000
NODE_4691_length_1125_cov_33.371345	590	670	0	80	80	1.0000000
NODE_4692_length_1125_cov_22.580897	279	359	0	69	80	0.8625000
NODE_4692_length_1125_cov_22.580897	279	359	2	11	80	0.1375000
NODE_4692_length_1125_cov_22.580897	332	412	0	16	80	0.2000000
NODE_4692_length_1125_cov_22.580897	332	412	2	64	80	0.8000000
NODE_4692_length_1125_cov_22.580897	408	488	0	16	80	0.2000000
NODE_4692_length_1125_cov_22.580897	408	488	2	64	80	0.8000000
NODE_4692_length_1125_cov_22.580897	461	541	0	69	80	0.8625000
NODE_4692_length_1125_cov_22.580897	461	541	2	11	80	0.1375000
NODE_4705_length_1124_cov_52.278049	616	696	1	14	80	0.1750000
NODE_4705_length_1124_cov_52.278049	616	696	2	31	80	0.3875000
NODE_4705_length_1124_cov_52.278049	616	696	3	35	80	0.4375000
NODE_4705_length_1124_cov_52.278049	669	749	1	28	80	0.3500000
NODE_4705_length_1124_cov_52.278049	669	749	2	6	80	0.0750000
NODE_4705_length_1124_cov_52.278049	669	749	3	46	80	0.5750000
NODE_4706_length_1124_cov_25.280000	444	524	2	15	80	0.1875000
NODE_4706_length_1124_cov_25.280000	444	524	3	65	80	0.8125000
NODE_4706_length_1124_cov_25.280000	497	577	1	35	80	0.4375000
NODE_4706_length_1124_cov_25.280000	497	577	2	29	80	0.3625000
NODE_4706_length_1124_cov_25.280000	497	577	3	16	80	0.2000000
NODE_4706_length_1124_cov_25.280000	573	653	3	11	80	0.1375000
NODE_4706_length_1124_cov_25.280000	573	653	4	14	80	0.1750000
NODE_4706_length_1124_cov_25.280000	573	653	5	55	80	0.6875000
NODE_4706_length_1124_cov_25.280000	626	706	2	5	80	0.0625000
NODE_4706_length_1124_cov_25.280000	626	706	4	15	80	0.1875000
NODE_4706_length_1124_cov_25.280000	626	706	5	60	80	0.7500000
NODE_4707_length_1124_cov_18.700488	114	194	0	5	80	0.0625000
NODE_4707_length_1124_cov_18.700488	114	194	1	75	80	0.9375000
NODE_4707_length_1124_cov_18.700488	167	247	0	21	80	0.2625000
NODE_4707_length_1124_cov_18.700488	167	247	1	59	80	0.7375000
NODE_4717_length_1123_cov_26.445312	388	468	0	10	80	0.1250000
NODE_4717_length_1123_cov_26.445312	388	468	1	70	80	0.8750000
NODE_4717_length_1123_cov_26.445312	441	521	1	80	80	1.0000000
NODE_4717_length_1123_cov_26.445312	517	597	0	4	80	0.0500000
NODE_4717_length_1123_cov_26.445312	517	597	1	31	80	0.3875000
NODE_4717_length_1123_cov_26.445312	517	597	2	34	80	0.4250000
NODE_4717_length_1123_cov_26.445312	517	597	3	11	80	0.1375000
NODE_4717_length_1123_cov_26.445312	570	650	2	16	80	0.2000000
NODE_4717_length_1123_cov_26.445312	570	650	3	64	80	0.8000000
NODE_4718_length_1123_cov_18.677734	522	602	0	19	80	0.2375000
NODE_4718_length_1123_cov_18.677734	522	602	1	2	80	0.0250000
NODE_4718_length_1123_cov_18.677734	522	602	3	9	80	0.1125000
NODE_4718_length_1123_cov_18.677734	522	602	4	50	80	0.6250000
NODE_4718_length_1123_cov_18.677734	575	655	4	46	80	0.5750000
NODE_4718_length_1123_cov_18.677734	575	655	5	1	80	0.0125000
NODE_4718_length_1123_cov_18.677734	575	655	6	33	80	0.4125000
NODE_4718_length_1123_cov_18.677734	651	731	2	29	80	0.3625000
NODE_4718_length_1123_cov_18.677734	651	731	3	11	80	0.1375000
NODE_4718_length_1123_cov_18.677734	651	731	4	9	80	0.1125000
NODE_4718_length_1123_cov_18.677734	651	731	6	31	80	0.3875000
NODE_4718_length_1123_cov_18.677734	704	784	0	12	80	0.1500000
NODE_4718_length_1123_cov_18.677734	704	784	1	1	80	0.0125000
NODE_4718_length_1123_cov_18.677734	704	784	2	67	80	0.8375000
NODE_4728_length_1122_cov_38.688172	295	375	0	55	80	0.6875000
NODE_4728_length_1122_cov_38.688172	295	375	1	3	80	0.0375000
NODE_4728_length_1122_cov_38.688172	295	375	3	1	80	0.0125000
NODE_4728_length_1122_cov_38.688172	295	375	4	21	80	0.2625000
NODE_4728_length_1122_cov_38.688172	348	428	0	2	80	0.0250000
NODE_4728_length_1122_cov_38.688172	348	428	1	3	80	0.0375000
NODE_4728_length_1122_cov_38.688172	348	428	2	11	80	0.1375000
NODE_4728_length_1122_cov_38.688172	348	428	3	1	80	0.0125000
NODE_4728_length_1122_cov_38.688172	348	428	4	63	80	0.7875000
NODE_4728_length_1122_cov_38.688172	424	504	2	55	80	0.6875000
NODE_4728_length_1122_cov_38.688172	424	504	4	6	80	0.0750000
NODE_4728_length_1122_cov_38.688172	424	504	5	3	80	0.0375000
NODE_4728_length_1122_cov_38.688172	424	504	6	15	80	0.1875000
NODE_4728_length_1122_cov_38.688172	424	504	7	1	80	0.0125000
NODE_4728_length_1122_cov_38.688172	477	557	2	2	80	0.0250000
NODE_4728_length_1122_cov_38.688172	477	557	4	6	80	0.0750000
NODE_4728_length_1122_cov_38.688172	477	557	5	3	80	0.0375000
NODE_4728_length_1122_cov_38.688172	477	557	6	68	80	0.8500000
NODE_4728_length_1122_cov_38.688172	477	557	7	1	80	0.0125000
NODE_4729_length_1122_cov_32.827957	232	312	0	80	80	1.0000000
NODE_4729_length_1122_cov_32.827957	285	365	0	80	80	1.0000000
NODE_4729_length_1122_cov_32.827957	361	441	0	80	80	1.0000000
NODE_4729_length_1122_cov_32.827957	414	494	0	80	80	1.0000000
NODE_4730_length_1122_cov_12.574780	396	476	0	80	80	1.0000000
NODE_4730_length_1122_cov_12.574780	449	529	0	80	80	1.0000000
NODE_4730_length_1122_cov_12.574780	525	605	0	18	80	0.2250000
NODE_4730_length_1122_cov_12.574780	525	605	1	56	80	0.7000000
NODE_4730_length_1122_cov_12.574780	525	605	2	6	80	0.0750000
NODE_4730_length_1122_cov_12.574780	578	658	1	21	80	0.2625000
NODE_4730_length_1122_cov_12.574780	578	658	2	59	80	0.7375000
NODE_4731_length_1122_cov_8.582600	586	666	1	2	80	0.0250000
NODE_4731_length_1122_cov_8.582600	586	666	2	47	80	0.5875000
NODE_4731_length_1122_cov_8.582600	586	666	3	21	80	0.2625000
NODE_4731_length_1122_cov_8.582600	586	666	4	10	80	0.1250000
NODE_4731_length_1122_cov_8.582600	639	719	1	50	80	0.6250000
NODE_4731_length_1122_cov_8.582600	639	719	2	30	80	0.3750000
NODE_4733_length_1122_cov_3.714565	284	364	0	6	80	0.0750000
NODE_4733_length_1122_cov_3.714565	284	364	1	74	80	0.9250000
NODE_4733_length_1122_cov_3.714565	337	417	1	80	80	1.0000000
NODE_4738_length_1122_cov_1.757576	25	87	0	62	62	1.0000000
NODE_4742_length_1121_cov_39.595890	507	587	2	9	80	0.1125000
NODE_4742_length_1121_cov_39.595890	507	587	3	13	80	0.1625000
NODE_4742_length_1121_cov_39.595890	507	587	4	17	80	0.2125000
NODE_4742_length_1121_cov_39.595890	507	587	5	19	80	0.2375000
NODE_4742_length_1121_cov_39.595890	507	587	6	22	80	0.2750000
NODE_4742_length_1121_cov_39.595890	560	640	5	32	80	0.4000000
NODE_4742_length_1121_cov_39.595890	560	640	6	48	80	0.6000000
NODE_4742_length_1121_cov_39.595890	636	716	1	1	80	0.0125000
NODE_4742_length_1121_cov_39.595890	636	716	2	23	80	0.2875000
NODE_4742_length_1121_cov_39.595890	636	716	3	36	80	0.4500000
NODE_4742_length_1121_cov_39.595890	636	716	4	14	80	0.1750000
NODE_4742_length_1121_cov_39.595890	636	716	5	6	80	0.0750000
NODE_4742_length_1121_cov_39.595890	689	769	1	42	80	0.5250000
NODE_4742_length_1121_cov_39.595890	689	769	2	31	80	0.3875000
NODE_4742_length_1121_cov_39.595890	689	769	3	7	80	0.0875000
NODE_4743_length_1121_cov_23.832681	525	605	3	45	80	0.5625000
NODE_4743_length_1121_cov_23.832681	525	605	4	2	80	0.0250000
NODE_4743_length_1121_cov_23.832681	525	605	6	33	80	0.4125000
NODE_4743_length_1121_cov_23.832681	578	658	3	7	80	0.0875000
NODE_4743_length_1121_cov_23.832681	578	658	4	4	80	0.0500000
NODE_4743_length_1121_cov_23.832681	578	658	5	31	80	0.3875000
NODE_4743_length_1121_cov_23.832681	578	658	6	38	80	0.4750000
NODE_4744_length_1121_cov_18.033268	1	42	0	41	41	1.0000000
NODE_4744_length_1121_cov_18.033268	671	751	1	1	80	0.0125000
NODE_4744_length_1121_cov_18.033268	671	751	2	48	80	0.6000000
NODE_4744_length_1121_cov_18.033268	671	751	3	31	80	0.3875000
NODE_4744_length_1121_cov_18.033268	724	804	2	35	80	0.4375000
NODE_4744_length_1121_cov_18.033268	724	804	3	45	80	0.5625000
NODE_4745_length_1121_cov_8.633072	610	690	0	80	80	1.0000000
NODE_4745_length_1121_cov_8.633072	663	743	0	80	80	1.0000000
NODE_4751_length_1120_cov_34.281097	377	457	1	13	80	0.1625000
NODE_4751_length_1120_cov_34.281097	377	457	2	67	80	0.8375000
NODE_4751_length_1120_cov_34.281097	430	510	1	23	80	0.2875000
NODE_4751_length_1120_cov_34.281097	430	510	2	57	80	0.7125000
NODE_4751_length_1120_cov_34.281097	506	586	0	46	80	0.5750000
NODE_4751_length_1120_cov_34.281097	506	586	1	34	80	0.4250000
NODE_4751_length_1120_cov_34.281097	559	639	0	80	80	1.0000000
NODE_4752_length_1120_cov_31.468168	401	481	0	7	80	0.0875000
NODE_4752_length_1120_cov_31.468168	401	481	1	68	80	0.8500000
NODE_4752_length_1120_cov_31.468168	401	481	3	5	80	0.0625000
NODE_4752_length_1120_cov_31.468168	454	534	1	22	80	0.2750000
NODE_4752_length_1120_cov_31.468168	454	534	3	25	80	0.3125000
NODE_4752_length_1120_cov_31.468168	454	534	4	5	80	0.0625000
NODE_4752_length_1120_cov_31.468168	454	534	5	28	80	0.3500000
NODE_4752_length_1120_cov_31.468168	530	610	5	9	80	0.1125000
NODE_4752_length_1120_cov_31.468168	530	610	6	21	80	0.2625000
NODE_4752_length_1120_cov_31.468168	530	610	7	28	80	0.3500000
NODE_4752_length_1120_cov_31.468168	530	610	8	22	80	0.2750000
NODE_4752_length_1120_cov_31.468168	583	663	7	12	80	0.1500000
NODE_4752_length_1120_cov_31.468168	583	663	8	27	80	0.3375000
NODE_4752_length_1120_cov_31.468168	583	663	9	41	80	0.5125000
NODE_4753_length_1120_cov_28.182174	418	498	3	7	80	0.0875000
NODE_4753_length_1120_cov_28.182174	418	498	4	26	80	0.3250000
NODE_4753_length_1120_cov_28.182174	418	498	5	9	80	0.1125000
NODE_4753_length_1120_cov_28.182174	418	498	6	38	80	0.4750000
NODE_4753_length_1120_cov_28.182174	471	551	1	6	80	0.0750000
NODE_4753_length_1120_cov_28.182174	471	551	2	22	80	0.2750000
NODE_4753_length_1120_cov_28.182174	471	551	4	45	80	0.5625000
NODE_4753_length_1120_cov_28.182174	471	551	5	7	80	0.0875000
NODE_4754_length_1120_cov_25.423115	405	485	0	20	80	0.2500000
NODE_4754_length_1120_cov_25.423115	405	485	1	22	80	0.2750000
NODE_4754_length_1120_cov_25.423115	405	485	2	8	80	0.1000000
NODE_4754_length_1120_cov_25.423115	405	485	4	30	80	0.3750000
NODE_4754_length_1120_cov_25.423115	458	538	4	29	80	0.3625000
NODE_4754_length_1120_cov_25.423115	458	538	5	51	80	0.6375000
NODE_4754_length_1120_cov_25.423115	534	614	3	9	80	0.1125000
NODE_4754_length_1120_cov_25.423115	534	614	4	17	80	0.2125000
NODE_4754_length_1120_cov_25.423115	534	614	5	54	80	0.6750000
NODE_4754_length_1120_cov_25.423115	587	667	3	34	80	0.4250000
NODE_4754_length_1120_cov_25.423115	587	667	4	40	80	0.5000000
NODE_4754_length_1120_cov_25.423115	587	667	5	6	80	0.0750000
NODE_4755_length_1120_cov_24.441724	589	662	3	33	73	0.4520548
NODE_4755_length_1120_cov_24.441724	589	662	4	27	73	0.3698630
NODE_4755_length_1120_cov_24.441724	589	662	5	13	73	0.1780822
NODE_4755_length_1120_cov_24.441724	636	716	2	39	80	0.4875000
NODE_4755_length_1120_cov_24.441724	636	716	3	34	80	0.4250000
NODE_4755_length_1120_cov_24.441724	636	716	4	7	80	0.0875000
NODE_4756_length_1120_cov_18.966699	406	486	0	80	80	1.0000000
NODE_4756_length_1120_cov_18.966699	459	539	0	80	80	1.0000000
NODE_4757_length_1120_cov_16.136141	508	588	1	23	80	0.2875000
NODE_4757_length_1120_cov_16.136141	508	588	2	14	80	0.1750000
NODE_4757_length_1120_cov_16.136141	508	588	3	14	80	0.1750000
NODE_4757_length_1120_cov_16.136141	508	588	4	29	80	0.3625000
NODE_4757_length_1120_cov_16.136141	561	641	3	16	80	0.2000000
NODE_4757_length_1120_cov_16.136141	561	641	4	64	80	0.8000000
NODE_4758_length_1120_cov_15.492654	460	540	7	7	80	0.0875000
NODE_4758_length_1120_cov_15.492654	460	540	8	39	80	0.4875000
NODE_4758_length_1120_cov_15.492654	460	540	9	34	80	0.4250000
NODE_4758_length_1120_cov_15.492654	460	540	7	7	80	0.0875000
NODE_4758_length_1120_cov_15.492654	460	540	8	39	80	0.4875000
NODE_4758_length_1120_cov_15.492654	460	540	9	34	80	0.4250000
NODE_4758_length_1120_cov_15.492654	513	593	3	29	80	0.3625000
NODE_4758_length_1120_cov_15.492654	513	593	4	16	80	0.2000000
NODE_4758_length_1120_cov_15.492654	513	593	5	1	80	0.0125000
NODE_4758_length_1120_cov_15.492654	513	593	7	13	80	0.1625000
NODE_4758_length_1120_cov_15.492654	513	593	9	21	80	0.2625000
NODE_4759_length_1120_cov_8.696376	646	726	1	80	80	1.0000000
NODE_4759_length_1120_cov_8.696376	699	779	0	29	80	0.3625000
NODE_4759_length_1120_cov_8.696376	699	779	1	51	80	0.6375000
NODE_4760_length_1120_cov_7.916748	304	384	0	74	80	0.9250000
NODE_4760_length_1120_cov_7.916748	304	384	2	6	80	0.0750000
NODE_4760_length_1120_cov_7.916748	357	437	0	21	80	0.2625000
NODE_4760_length_1120_cov_7.916748	357	437	2	59	80	0.7375000
NODE_4772_length_1119_cov_32.617647	425	505	0	80	80	1.0000000
NODE_4772_length_1119_cov_32.617647	478	558	0	80	80	1.0000000
NODE_4773_length_1119_cov_24.944118	455	535	1	2	80	0.0250000
NODE_4773_length_1119_cov_24.944118	455	535	2	38	80	0.4750000
NODE_4773_length_1119_cov_24.944118	455	535	3	40	80	0.5000000
NODE_4773_length_1119_cov_24.944118	508	588	2	80	80	1.0000000
NODE_4774_length_1119_cov_22.214706	614	694	0	80	80	1.0000000
NODE_4774_length_1119_cov_22.214706	667	747	0	80	80	1.0000000
NODE_4775_length_1119_cov_21.115686	431	511	3	7	80	0.0875000
NODE_4775_length_1119_cov_21.115686	431	511	4	73	80	0.9125000
NODE_4775_length_1119_cov_21.115686	484	564	2	8	80	0.1000000
NODE_4775_length_1119_cov_21.115686	484	564	3	25	80	0.3125000
NODE_4775_length_1119_cov_21.115686	484	564	4	47	80	0.5875000
NODE_4777_length_1119_cov_11.895098	565	645	4	30	80	0.3750000
NODE_4777_length_1119_cov_11.895098	565	645	5	10	80	0.1250000
NODE_4777_length_1119_cov_11.895098	565	645	7	11	80	0.1375000
NODE_4777_length_1119_cov_11.895098	565	645	8	29	80	0.3625000
NODE_4777_length_1119_cov_11.895098	618	698	4	26	80	0.3250000
NODE_4777_length_1119_cov_11.895098	618	698	6	22	80	0.2750000
NODE_4777_length_1119_cov_11.895098	618	698	8	32	80	0.4000000
NODE_4782_length_1119_cov_2.783333	37	99	3	1	62	0.0161290
NODE_4782_length_1119_cov_2.783333	37	99	4	22	62	0.3548387
NODE_4782_length_1119_cov_2.783333	37	99	6	39	62	0.6290323
NODE_4789_length_1118_cov_35.214917	555	635	0	14	80	0.1750000
NODE_4789_length_1118_cov_35.214917	555	635	1	66	80	0.8250000
NODE_4789_length_1118_cov_35.214917	608	688	1	80	80	1.0000000
NODE_4789_length_1118_cov_35.214917	684	764	1	36	80	0.4500000
NODE_4789_length_1118_cov_35.214917	684	764	2	31	80	0.3875000
NODE_4789_length_1118_cov_35.214917	684	764	4	13	80	0.1625000
NODE_4789_length_1118_cov_35.214917	737	817	1	3	80	0.0375000
NODE_4789_length_1118_cov_35.214917	737	817	2	11	80	0.1375000
NODE_4789_length_1118_cov_35.214917	737	817	4	66	80	0.8250000
NODE_4790_length_1118_cov_23.114818	602	682	3	14	80	0.1750000
NODE_4790_length_1118_cov_23.114818	602	682	4	42	80	0.5250000
NODE_4790_length_1118_cov_23.114818	602	682	5	24	80	0.3000000
NODE_4790_length_1118_cov_23.114818	655	735	1	27	80	0.3375000
NODE_4790_length_1118_cov_23.114818	655	735	3	40	80	0.5000000
NODE_4790_length_1118_cov_23.114818	655	735	4	1	80	0.0125000
NODE_4790_length_1118_cov_23.114818	655	735	5	12	80	0.1500000
NODE_4790_length_1118_cov_23.114818	731	811	1	38	80	0.4750000
NODE_4790_length_1118_cov_23.114818	731	811	2	42	80	0.5250000
NODE_4790_length_1118_cov_23.114818	784	864	1	69	80	0.8625000
NODE_4790_length_1118_cov_23.114818	784	864	2	11	80	0.1375000
NODE_4791_length_1118_cov_18.293425	388	463	2	5	75	0.0666667
NODE_4791_length_1118_cov_18.293425	388	463	3	36	75	0.4800000
NODE_4791_length_1118_cov_18.293425	388	463	4	34	75	0.4533333
NODE_4791_length_1118_cov_18.293425	436	516	2	7	80	0.0875000
NODE_4791_length_1118_cov_18.293425	436	516	3	39	80	0.4875000
NODE_4791_length_1118_cov_18.293425	436	516	4	34	80	0.4250000
NODE_4791_length_1118_cov_18.293425	512	592	1	23	80	0.2875000
NODE_4791_length_1118_cov_18.293425	512	592	2	51	80	0.6375000
NODE_4791_length_1118_cov_18.293425	512	592	3	6	80	0.0750000
NODE_4791_length_1118_cov_18.293425	565	645	1	11	80	0.1375000
NODE_4791_length_1118_cov_18.293425	565	645	2	69	80	0.8625000
NODE_4792_length_1118_cov_17.228656	480	560	2	24	80	0.3000000
NODE_4792_length_1118_cov_17.228656	480	560	3	56	80	0.7000000
NODE_4792_length_1118_cov_17.228656	533	613	1	31	80	0.3875000
NODE_4792_length_1118_cov_17.228656	533	613	2	5	80	0.0625000
NODE_4792_length_1118_cov_17.228656	533	613	3	44	80	0.5500000
NODE_4794_length_1118_cov_14.299313	468	548	0	53	80	0.6625000
NODE_4794_length_1118_cov_14.299313	468	548	1	4	80	0.0500000
NODE_4794_length_1118_cov_14.299313	468	548	2	23	80	0.2875000
NODE_4794_length_1118_cov_14.299313	521	601	1	4	80	0.0500000
NODE_4794_length_1118_cov_14.299313	521	601	2	76	80	0.9500000
NODE_4795_length_1118_cov_10.203140	306	386	2	39	80	0.4875000
NODE_4795_length_1118_cov_10.203140	306	386	4	41	80	0.5125000
NODE_4795_length_1118_cov_10.203140	359	439	3	4	80	0.0500000
NODE_4795_length_1118_cov_10.203140	359	439	4	46	80	0.5750000
NODE_4795_length_1118_cov_10.203140	359	439	5	30	80	0.3750000
NODE_4795_length_1118_cov_10.203140	435	515	0	14	80	0.1750000
NODE_4795_length_1118_cov_10.203140	435	515	2	15	80	0.1875000
NODE_4795_length_1118_cov_10.203140	435	515	4	38	80	0.4750000
NODE_4795_length_1118_cov_10.203140	435	515	5	13	80	0.1625000
NODE_4795_length_1118_cov_10.203140	488	568	0	23	80	0.2875000
NODE_4795_length_1118_cov_10.203140	488	568	2	57	80	0.7125000
NODE_4796_length_1118_cov_2.885182	471	551	0	80	80	1.0000000
NODE_4796_length_1118_cov_2.885182	524	604	0	80	80	1.0000000
NODE_4805_length_1117_cov_19.425344	541	621	2	4	80	0.0500000
NODE_4805_length_1117_cov_19.425344	541	621	3	12	80	0.1500000
NODE_4805_length_1117_cov_19.425344	541	621	4	64	80	0.8000000
NODE_4805_length_1117_cov_19.425344	594	674	1	24	80	0.3000000
NODE_4805_length_1117_cov_19.425344	594	674	2	33	80	0.4125000
NODE_4805_length_1117_cov_19.425344	594	674	4	23	80	0.2875000
NODE_4806_length_1117_cov_16.386051	385	465	0	12	80	0.1500000
NODE_4806_length_1117_cov_16.386051	385	465	1	5	80	0.0625000
NODE_4806_length_1117_cov_16.386051	385	465	2	63	80	0.7875000
NODE_4806_length_1117_cov_16.386051	438	518	2	50	80	0.6250000
NODE_4806_length_1117_cov_16.386051	438	518	3	30	80	0.3750000
NODE_4807_length_1117_cov_10.353635	294	374	2	1	80	0.0125000
NODE_4807_length_1117_cov_10.353635	294	374	3	79	80	0.9875000
NODE_4807_length_1117_cov_10.353635	347	427	1	13	80	0.1625000
NODE_4807_length_1117_cov_10.353635	347	427	2	37	80	0.4625000
NODE_4807_length_1117_cov_10.353635	347	427	3	30	80	0.3750000
NODE_4808_length_1117_cov_7.492141	417	497	3	64	80	0.8000000
NODE_4808_length_1117_cov_7.492141	417	497	6	16	80	0.2000000
NODE_4808_length_1117_cov_7.492141	470	550	3	80	80	1.0000000
NODE_4812_length_1117_cov_3.225933	666	728	0	62	62	1.0000000
NODE_4819_length_1116_cov_30.106195	457	537	1	23	80	0.2875000
NODE_4819_length_1116_cov_30.106195	457	537	2	57	80	0.7125000
NODE_4819_length_1116_cov_30.106195	510	590	2	80	80	1.0000000
NODE_4820_length_1116_cov_25.518191	831	911	1	21	80	0.2625000
NODE_4820_length_1116_cov_25.518191	831	911	2	59	80	0.7375000
NODE_4820_length_1116_cov_25.518191	884	964	2	43	80	0.5375000
NODE_4820_length_1116_cov_25.518191	884	964	3	37	80	0.4625000
NODE_4821_length_1116_cov_20.629302	500	580	0	80	80	1.0000000
NODE_4821_length_1116_cov_20.629302	553	633	0	80	80	1.0000000
NODE_4822_length_1116_cov_16.723697	345	425	7	8	80	0.1000000
NODE_4822_length_1116_cov_16.723697	345	425	8	7	80	0.0875000
NODE_4822_length_1116_cov_16.723697	345	425	9	17	80	0.2125000
NODE_4822_length_1116_cov_16.723697	345	425	10	8	80	0.1000000
NODE_4822_length_1116_cov_16.723697	345	425	11	40	80	0.5000000
NODE_4822_length_1116_cov_16.723697	398	478	4	14	80	0.1750000
NODE_4822_length_1116_cov_16.723697	398	478	5	29	80	0.3625000
NODE_4822_length_1116_cov_16.723697	398	478	6	7	80	0.0875000
NODE_4822_length_1116_cov_16.723697	398	478	7	11	80	0.1375000
NODE_4822_length_1116_cov_16.723697	398	478	9	12	80	0.1500000
NODE_4822_length_1116_cov_16.723697	398	478	11	7	80	0.0875000
NODE_4823_length_1116_cov_16.046214	735	815	2	60	80	0.7500000
NODE_4823_length_1116_cov_16.046214	735	815	3	20	80	0.2500000
NODE_4823_length_1116_cov_16.046214	788	868	2	58	80	0.7250000
NODE_4823_length_1116_cov_16.046214	788	868	3	22	80	0.2750000
NODE_4828_length_1116_cov_1.379548	800	880	2	28	80	0.3500000
NODE_4828_length_1116_cov_1.379548	800	880	3	52	80	0.6500000
NODE_4828_length_1116_cov_1.379548	853	933	3	34	80	0.4250000
NODE_4828_length_1116_cov_1.379548	853	933	4	36	80	0.4500000
NODE_4828_length_1116_cov_1.379548	853	933	5	10	80	0.1250000
NODE_4832_length_1115_cov_30.584646	549	629	0	43	80	0.5375000
NODE_4832_length_1115_cov_30.584646	549	629	3	12	80	0.1500000
NODE_4832_length_1115_cov_30.584646	549	629	5	17	80	0.2125000
NODE_4832_length_1115_cov_30.584646	549	629	7	4	80	0.0500000
NODE_4832_length_1115_cov_30.584646	549	629	8	4	80	0.0500000
NODE_4832_length_1115_cov_30.584646	602	682	3	2	80	0.0250000
NODE_4832_length_1115_cov_30.584646	602	682	5	17	80	0.2125000
NODE_4832_length_1115_cov_30.584646	602	682	7	4	80	0.0500000
NODE_4832_length_1115_cov_30.584646	602	682	8	23	80	0.2875000
NODE_4832_length_1115_cov_30.584646	602	682	9	34	80	0.4250000
NODE_4833_length_1115_cov_15.871063	454	534	0	80	80	1.0000000
NODE_4833_length_1115_cov_15.871063	507	587	0	80	80	1.0000000
NODE_4833_length_1115_cov_15.871063	583	663	0	80	80	1.0000000
NODE_4833_length_1115_cov_15.871063	636	716	0	80	80	1.0000000
NODE_4840_length_1114_cov_20.633498	1034	1114	0	43	80	0.5375000
NODE_4840_length_1114_cov_20.633498	1034	1114	2	37	80	0.4625000
NODE_4840_length_1114_cov_20.633498	1034	1114	0	43	80	0.5375000
NODE_4840_length_1114_cov_20.633498	1034	1114	2	37	80	0.4625000
NODE_4840_length_1114_cov_20.633498	1034	1114	0	43	80	0.5375000
NODE_4840_length_1114_cov_20.633498	1034	1114	2	37	80	0.4625000
NODE_4840_length_1114_cov_20.633498	1034	1114	0	43	80	0.5375000
NODE_4840_length_1114_cov_20.633498	1034	1114	2	37	80	0.4625000
NODE_4840_length_1114_cov_20.633498	1034	1114	0	43	80	0.5375000
NODE_4840_length_1114_cov_20.633498	1034	1114	2	37	80	0.4625000
NODE_4840_length_1114_cov_20.633498	1043	1114	0	43	71	0.6056338
NODE_4840_length_1114_cov_20.633498	1043	1114	2	28	71	0.3943662
NODE_4841_length_1114_cov_17.383251	516	601	0	3	85	0.0352941
NODE_4841_length_1114_cov_17.383251	516	601	1	82	85	0.9647059
NODE_4841_length_1114_cov_17.383251	574	653	1	79	79	1.0000000
NODE_4841_length_1114_cov_17.383251	649	729	0	56	80	0.7000000
NODE_4841_length_1114_cov_17.383251	649	729	1	24	80	0.3000000
NODE_4841_length_1114_cov_17.383251	702	782	0	30	80	0.3750000
NODE_4841_length_1114_cov_17.383251	702	782	1	50	80	0.6250000
NODE_4842_length_1114_cov_5.562562	563	643	1	23	80	0.2875000
NODE_4842_length_1114_cov_5.562562	563	643	2	43	80	0.5375000
NODE_4842_length_1114_cov_5.562562	563	643	3	14	80	0.1750000
NODE_4842_length_1114_cov_5.562562	616	696	2	36	80	0.4500000
NODE_4842_length_1114_cov_5.562562	616	696	3	44	80	0.5500000
NODE_4847_length_1113_cov_51.988166	343	423	12	2	80	0.0250000
NODE_4847_length_1113_cov_51.988166	343	423	14	2	80	0.0250000
NODE_4847_length_1113_cov_51.988166	343	423	16	13	80	0.1625000
NODE_4847_length_1113_cov_51.988166	343	423	17	5	80	0.0625000
NODE_4847_length_1113_cov_51.988166	343	423	18	58	80	0.7250000
NODE_4847_length_1113_cov_51.988166	396	476	10	4	80	0.0500000
NODE_4847_length_1113_cov_51.988166	396	476	12	11	80	0.1375000
NODE_4847_length_1113_cov_51.988166	396	476	13	10	80	0.1250000
NODE_4847_length_1113_cov_51.988166	396	476	14	5	80	0.0625000
NODE_4847_length_1113_cov_51.988166	396	476	15	13	80	0.1625000
NODE_4847_length_1113_cov_51.988166	396	476	16	1	80	0.0125000
NODE_4847_length_1113_cov_51.988166	396	476	17	14	80	0.1750000
NODE_4847_length_1113_cov_51.988166	396	476	18	22	80	0.2750000
NODE_4847_length_1113_cov_51.988166	472	552	6	26	80	0.3250000
NODE_4847_length_1113_cov_51.988166	472	552	7	45	80	0.5625000
NODE_4847_length_1113_cov_51.988166	472	552	8	2	80	0.0250000
NODE_4847_length_1113_cov_51.988166	472	552	9	1	80	0.0125000
NODE_4847_length_1113_cov_51.988166	472	552	10	6	80	0.0750000
NODE_4847_length_1113_cov_51.988166	525	605	3	33	80	0.4125000
NODE_4847_length_1113_cov_51.988166	525	605	5	2	80	0.0250000
NODE_4847_length_1113_cov_51.988166	525	605	6	19	80	0.2375000
NODE_4847_length_1113_cov_51.988166	525	605	7	24	80	0.3000000
NODE_4847_length_1113_cov_51.988166	525	605	8	2	80	0.0250000
NODE_4848_length_1113_cov_35.005917	359	439	0	17	80	0.2125000
NODE_4848_length_1113_cov_35.005917	359	439	2	63	80	0.7875000
NODE_4848_length_1113_cov_35.005917	412	492	0	11	80	0.1375000
NODE_4848_length_1113_cov_35.005917	412	492	2	69	80	0.8625000
NODE_4849_length_1113_cov_28.106509	570	650	2	7	80	0.0875000
NODE_4849_length_1113_cov_28.106509	570	650	4	73	80	0.9125000
NODE_4849_length_1113_cov_28.106509	623	703	2	28	80	0.3500000
NODE_4849_length_1113_cov_28.106509	623	703	4	52	80	0.6500000
NODE_4849_length_1113_cov_28.106509	699	779	1	25	80	0.3125000
NODE_4849_length_1113_cov_28.106509	699	779	2	48	80	0.6000000
NODE_4849_length_1113_cov_28.106509	699	779	3	7	80	0.0875000
NODE_4849_length_1113_cov_28.106509	752	832	2	80	80	1.0000000
NODE_4850_length_1113_cov_18.636095	512	592	3	15	80	0.1875000
NODE_4850_length_1113_cov_18.636095	512	592	4	12	80	0.1500000
NODE_4850_length_1113_cov_18.636095	512	592	5	19	80	0.2375000
NODE_4850_length_1113_cov_18.636095	512	592	6	15	80	0.1875000
NODE_4850_length_1113_cov_18.636095	512	592	7	19	80	0.2375000
NODE_4850_length_1113_cov_18.636095	565	645	5	17	80	0.2125000
NODE_4850_length_1113_cov_18.636095	565	645	6	13	80	0.1625000
NODE_4850_length_1113_cov_18.636095	565	645	7	50	80	0.6250000
NODE_4851_length_1113_cov_16.664694	352	432	0	80	80	1.0000000
NODE_4851_length_1113_cov_16.664694	405	485	0	65	80	0.8125000
NODE_4851_length_1113_cov_16.664694	405	485	1	15	80	0.1875000
NODE_4851_length_1113_cov_16.664694	481	561	1	21	80	0.2625000
NODE_4851_length_1113_cov_16.664694	481	561	2	35	80	0.4375000
NODE_4851_length_1113_cov_16.664694	481	561	3	6	80	0.0750000
NODE_4851_length_1113_cov_16.664694	481	561	4	18	80	0.2250000
NODE_4851_length_1113_cov_16.664694	534	614	2	3	80	0.0375000
NODE_4851_length_1113_cov_16.664694	534	614	3	6	80	0.0750000
NODE_4851_length_1113_cov_16.664694	534	614	4	71	80	0.8875000
NODE_4852_length_1113_cov_14.155819	454	512	0	58	58	1.0000000
NODE_4852_length_1113_cov_14.155819	511	575	0	64	64	1.0000000
NODE_4853_length_1113_cov_10.185404	494	574	1	9	80	0.1125000
NODE_4853_length_1113_cov_10.185404	494	574	2	71	80	0.8875000
NODE_4853_length_1113_cov_10.185404	547	627	0	26	80	0.3250000
NODE_4853_length_1113_cov_10.185404	547	627	1	36	80	0.4500000
NODE_4853_length_1113_cov_10.185404	547	627	2	18	80	0.2250000
NODE_4855_length_1113_cov_4.005917	700	780	1	4	80	0.0500000
NODE_4855_length_1113_cov_4.005917	700	780	2	76	80	0.9500000
NODE_4855_length_1113_cov_4.005917	753	833	2	80	80	1.0000000
NODE_4866_length_1112_cov_14.961500	427	507	3	16	80	0.2000000
NODE_4866_length_1112_cov_14.961500	427	507	4	1	80	0.0125000
NODE_4866_length_1112_cov_14.961500	427	507	5	63	80	0.7875000
NODE_4866_length_1112_cov_14.961500	480	560	3	11	80	0.1375000
NODE_4866_length_1112_cov_14.961500	480	560	4	36	80	0.4500000
NODE_4866_length_1112_cov_14.961500	480	560	5	31	80	0.3875000
NODE_4866_length_1112_cov_14.961500	480	560	6	2	80	0.0250000
NODE_4866_length_1112_cov_14.961500	556	636	3	80	80	1.0000000
NODE_4866_length_1112_cov_14.961500	609	689	0	17	80	0.2125000
NODE_4866_length_1112_cov_14.961500	609	689	1	24	80	0.3000000
NODE_4866_length_1112_cov_14.961500	609	689	3	39	80	0.4875000
NODE_4875_length_1112_cov_1.655479	45	123	0	78	78	1.0000000
NODE_4875_length_1112_cov_1.655479	98	166	0	68	68	1.0000000
NODE_4880_length_1111_cov_37.999012	473	553	1	53	80	0.6625000
NODE_4880_length_1111_cov_37.999012	473	553	2	27	80	0.3375000
NODE_4880_length_1111_cov_37.999012	526	606	2	47	80	0.5875000
NODE_4880_length_1111_cov_37.999012	526	606	3	33	80	0.4125000
NODE_4880_length_1111_cov_37.999012	602	682	2	15	80	0.1875000
NODE_4880_length_1111_cov_37.999012	602	682	3	27	80	0.3375000
NODE_4880_length_1111_cov_37.999012	602	682	5	10	80	0.1250000
NODE_4880_length_1111_cov_37.999012	602	682	7	2	80	0.0250000
NODE_4880_length_1111_cov_37.999012	602	682	8	6	80	0.0750000
NODE_4880_length_1111_cov_37.999012	602	682	9	20	80	0.2500000
NODE_4880_length_1111_cov_37.999012	655	735	5	2	80	0.0250000
NODE_4880_length_1111_cov_37.999012	655	735	7	11	80	0.1375000
NODE_4880_length_1111_cov_37.999012	655	735	8	47	80	0.5875000
NODE_4880_length_1111_cov_37.999012	655	735	9	20	80	0.2500000
NODE_4881_length_1111_cov_24.394269	644	724	2	20	80	0.2500000
NODE_4881_length_1111_cov_24.394269	644	724	3	46	80	0.5750000
NODE_4881_length_1111_cov_24.394269	644	724	4	14	80	0.1750000
NODE_4881_length_1111_cov_24.394269	697	777	2	73	80	0.9125000
NODE_4881_length_1111_cov_24.394269	697	777	4	7	80	0.0875000
NODE_4882_length_1111_cov_23.676877	374	454	1	6	80	0.0750000
NODE_4882_length_1111_cov_23.676877	374	454	2	4	80	0.0500000
NODE_4882_length_1111_cov_23.676877	374	454	3	70	80	0.8750000
NODE_4882_length_1111_cov_23.676877	427	507	0	53	80	0.6625000
NODE_4882_length_1111_cov_23.676877	427	507	2	4	80	0.0500000
NODE_4882_length_1111_cov_23.676877	427	507	3	23	80	0.2875000
NODE_4883_length_1111_cov_17.522727	383	463	2	34	80	0.4250000
NODE_4883_length_1111_cov_17.522727	383	463	3	5	80	0.0625000
NODE_4883_length_1111_cov_17.522727	383	463	4	41	80	0.5125000
NODE_4883_length_1111_cov_17.522727	436	516	4	66	80	0.8250000
NODE_4883_length_1111_cov_17.522727	436	516	6	14	80	0.1750000
NODE_4884_length_1111_cov_16.495059	388	468	2	8	80	0.1000000
NODE_4884_length_1111_cov_16.495059	388	468	3	30	80	0.3750000
NODE_4884_length_1111_cov_16.495059	388	468	4	42	80	0.5250000
NODE_4884_length_1111_cov_16.495059	441	521	1	43	80	0.5375000
NODE_4884_length_1111_cov_16.495059	441	521	2	18	80	0.2250000
NODE_4884_length_1111_cov_16.495059	441	521	3	19	80	0.2375000
NODE_4885_length_1111_cov_15.366601	555	635	0	80	80	1.0000000
NODE_4885_length_1111_cov_15.366601	608	688	0	80	80	1.0000000
NODE_4886_length_1111_cov_15.314229	809	889	1	10	80	0.1250000
NODE_4886_length_1111_cov_15.314229	809	889	2	53	80	0.6625000
NODE_4886_length_1111_cov_15.314229	809	889	3	17	80	0.2125000
NODE_4886_length_1111_cov_15.314229	862	942	2	80	80	1.0000000
NODE_4887_length_1111_cov_9.732213	443	523	0	5	80	0.0625000
NODE_4887_length_1111_cov_9.732213	443	523	1	75	80	0.9375000
NODE_4887_length_1111_cov_9.732213	496	576	0	5	80	0.0625000
NODE_4887_length_1111_cov_9.732213	496	576	1	75	80	0.9375000
NODE_4888_length_1111_cov_4.907115	606	686	1	80	80	1.0000000
NODE_4888_length_1111_cov_4.907115	659	739	1	80	80	1.0000000
NODE_4892_length_1110_cov_23.012859	453	533	0	55	80	0.6875000
NODE_4892_length_1110_cov_23.012859	453	533	2	25	80	0.3125000
NODE_4892_length_1110_cov_23.012859	506	586	0	2	80	0.0250000
NODE_4892_length_1110_cov_23.012859	506	586	2	78	80	0.9750000
NODE_4892_length_1110_cov_23.012859	582	662	0	64	80	0.8000000
NODE_4892_length_1110_cov_23.012859	582	662	2	16	80	0.2000000
NODE_4892_length_1110_cov_23.012859	635	715	0	80	80	1.0000000
NODE_4895_length_1110_cov_5.305638	754	834	0	80	80	1.0000000
NODE_4895_length_1110_cov_5.305638	807	887	0	64	80	0.8000000
NODE_4895_length_1110_cov_5.305638	807	887	1	16	80	0.2000000
NODE_4896_length_1110_cov_3.698318	642	685	3	1	43	0.0232558
NODE_4896_length_1110_cov_3.698318	642	685	5	28	43	0.6511628
NODE_4896_length_1110_cov_3.698318	642	685	6	1	43	0.0232558
NODE_4896_length_1110_cov_3.698318	642	685	7	13	43	0.3023256
NODE_4899_length_1110_cov_1.871414	15	86	0	61	71	0.8591549
NODE_4899_length_1110_cov_1.871414	15	86	3	10	71	0.1408451
NODE_4903_length_1109_cov_35.307921	413	493	2	42	80	0.5250000
NODE_4903_length_1109_cov_35.307921	413	493	4	38	80	0.4750000
NODE_4903_length_1109_cov_35.307921	466	546	3	23	80	0.2875000
NODE_4903_length_1109_cov_35.307921	466	546	4	57	80	0.7125000
NODE_4903_length_1109_cov_35.307921	542	622	2	21	80	0.2625000
NODE_4903_length_1109_cov_35.307921	542	622	3	5	80	0.0625000
NODE_4903_length_1109_cov_35.307921	542	622	4	54	80	0.6750000
NODE_4903_length_1109_cov_35.307921	595	675	2	70	80	0.8750000
NODE_4903_length_1109_cov_35.307921	595	675	4	10	80	0.1250000
NODE_4904_length_1109_cov_27.880198	501	581	0	80	80	1.0000000
NODE_4904_length_1109_cov_27.880198	554	634	0	80	80	1.0000000
NODE_4904_length_1109_cov_27.880198	630	710	0	80	80	1.0000000
NODE_4904_length_1109_cov_27.880198	683	763	0	80	80	1.0000000
NODE_4905_length_1109_cov_21.858416	571	651	2	80	80	1.0000000
NODE_4905_length_1109_cov_21.858416	624	704	0	23	80	0.2875000
NODE_4905_length_1109_cov_21.858416	624	704	2	57	80	0.7125000
NODE_4912_length_1108_cov_59.921705	386	466	3	2	80	0.0250000
NODE_4912_length_1108_cov_59.921705	386	466	4	28	80	0.3500000
NODE_4912_length_1108_cov_59.921705	386	466	5	32	80	0.4000000
NODE_4912_length_1108_cov_59.921705	386	466	6	1	80	0.0125000
NODE_4912_length_1108_cov_59.921705	386	466	7	17	80	0.2125000
NODE_4912_length_1108_cov_59.921705	439	519	1	5	80	0.0625000
NODE_4912_length_1108_cov_59.921705	439	519	2	44	80	0.5500000
NODE_4912_length_1108_cov_59.921705	439	519	3	6	80	0.0750000
NODE_4912_length_1108_cov_59.921705	439	519	4	6	80	0.0750000
NODE_4912_length_1108_cov_59.921705	439	519	5	19	80	0.2375000
NODE_4912_length_1108_cov_59.921705	515	595	1	61	80	0.7625000
NODE_4912_length_1108_cov_59.921705	515	595	2	16	80	0.2000000
NODE_4912_length_1108_cov_59.921705	515	595	3	3	80	0.0375000
NODE_4912_length_1108_cov_59.921705	568	648	1	8	80	0.1000000
NODE_4912_length_1108_cov_59.921705	568	648	2	69	80	0.8625000
NODE_4912_length_1108_cov_59.921705	568	648	3	3	80	0.0375000
NODE_4914_length_1108_cov_16.069376	513	593	2	9	80	0.1125000
NODE_4914_length_1108_cov_16.069376	513	593	3	4	80	0.0500000
NODE_4914_length_1108_cov_16.069376	513	593	4	31	80	0.3875000
NODE_4914_length_1108_cov_16.069376	513	593	5	36	80	0.4500000
NODE_4914_length_1108_cov_16.069376	566	646	4	29	80	0.3625000
NODE_4914_length_1108_cov_16.069376	566	646	5	51	80	0.6375000
NODE_4916_length_1108_cov_11.656095	333	413	3	80	80	1.0000000
NODE_4916_length_1108_cov_11.656095	386	466	2	15	80	0.1875000
NODE_4916_length_1108_cov_11.656095	386	466	3	47	80	0.5875000
NODE_4916_length_1108_cov_11.656095	386	466	4	18	80	0.2250000
NODE_4917_length_1108_cov_10.266601	431	511	1	80	80	1.0000000
NODE_4917_length_1108_cov_10.266601	484	564	0	46	80	0.5750000
NODE_4917_length_1108_cov_10.266601	484	564	1	34	80	0.4250000
NODE_4918_length_1108_cov_8.895937	635	715	2	80	80	1.0000000
NODE_4918_length_1108_cov_8.895937	688	768	1	1	80	0.0125000
NODE_4918_length_1108_cov_8.895937	688	768	2	48	80	0.6000000
NODE_4918_length_1108_cov_8.895937	688	768	3	31	80	0.3875000
NODE_4920_length_1108_cov_5.682854	577	657	1	28	80	0.3500000
NODE_4920_length_1108_cov_5.682854	577	657	2	52	80	0.6500000
NODE_4920_length_1108_cov_5.682854	630	710	1	47	80	0.5875000
NODE_4920_length_1108_cov_5.682854	630	710	2	33	80	0.4125000
NODE_4927_length_1107_cov_35.050595	423	503	2	80	80	1.0000000
NODE_4927_length_1107_cov_35.050595	476	556	0	32	80	0.4000000
NODE_4927_length_1107_cov_35.050595	476	556	2	48	80	0.6000000
NODE_4927_length_1107_cov_35.050595	552	632	0	80	80	1.0000000
NODE_4927_length_1107_cov_35.050595	605	685	0	80	80	1.0000000
NODE_4928_length_1107_cov_31.386905	422	502	6	3	80	0.0375000
NODE_4928_length_1107_cov_31.386905	422	502	7	15	80	0.1875000
NODE_4928_length_1107_cov_31.386905	422	502	8	23	80	0.2875000
NODE_4928_length_1107_cov_31.386905	422	502	9	27	80	0.3375000
NODE_4928_length_1107_cov_31.386905	422	502	10	12	80	0.1500000
NODE_4928_length_1107_cov_31.386905	475	555	6	27	80	0.3375000
NODE_4928_length_1107_cov_31.386905	475	555	7	3	80	0.0375000
NODE_4928_length_1107_cov_31.386905	475	555	8	12	80	0.1500000
NODE_4928_length_1107_cov_31.386905	475	555	9	17	80	0.2125000
NODE_4928_length_1107_cov_31.386905	475	555	10	21	80	0.2625000
NODE_4929_length_1107_cov_29.178571	577	657	0	22	80	0.2750000
NODE_4929_length_1107_cov_29.178571	577	657	2	58	80	0.7250000
NODE_4929_length_1107_cov_29.178571	630	710	0	4	80	0.0500000
NODE_4929_length_1107_cov_29.178571	630	710	2	76	80	0.9500000
NODE_4929_length_1107_cov_29.178571	934	1000	0	66	66	1.0000000
NODE_4929_length_1107_cov_29.178571	934	1005	0	71	71	1.0000000
NODE_4930_length_1107_cov_16.038690	574	654	0	16	80	0.2000000
NODE_4930_length_1107_cov_16.038690	574	654	1	64	80	0.8000000
NODE_4930_length_1107_cov_16.038690	627	707	0	29	80	0.3625000
NODE_4930_length_1107_cov_16.038690	627	707	1	51	80	0.6375000
NODE_4931_length_1107_cov_15.472222	78	158	10	2	80	0.0250000
NODE_4931_length_1107_cov_15.472222	78	158	12	5	80	0.0625000
NODE_4931_length_1107_cov_15.472222	78	158	16	5	80	0.0625000
NODE_4931_length_1107_cov_15.472222	78	158	17	11	80	0.1375000
NODE_4931_length_1107_cov_15.472222	78	158	18	14	80	0.1750000
NODE_4931_length_1107_cov_15.472222	78	158	20	43	80	0.5375000
NODE_4931_length_1107_cov_15.472222	131	194	1	4	63	0.0634921
NODE_4931_length_1107_cov_15.472222	131	194	3	16	63	0.2539683
NODE_4931_length_1107_cov_15.472222	131	194	4	1	63	0.0158730
NODE_4931_length_1107_cov_15.472222	131	194	5	2	63	0.0317460
NODE_4931_length_1107_cov_15.472222	131	194	6	1	63	0.0158730
NODE_4931_length_1107_cov_15.472222	131	194	7	1	63	0.0158730
NODE_4931_length_1107_cov_15.472222	131	194	9	9	63	0.1428571
NODE_4931_length_1107_cov_15.472222	131	194	10	3	63	0.0476190
NODE_4931_length_1107_cov_15.472222	131	194	12	5	63	0.0793651
NODE_4931_length_1107_cov_15.472222	131	194	16	5	63	0.0793651
NODE_4931_length_1107_cov_15.472222	131	194	17	11	63	0.1746032
NODE_4931_length_1107_cov_15.472222	131	194	18	4	63	0.0634921
NODE_4931_length_1107_cov_15.472222	131	194	19	1	63	0.0158730
NODE_4931_length_1107_cov_15.472222	952	995	3	33	43	0.7674419
NODE_4931_length_1107_cov_15.472222	952	995	4	6	43	0.1395349
NODE_4931_length_1107_cov_15.472222	952	995	9	1	43	0.0232558
NODE_4931_length_1107_cov_15.472222	952	995	12	3	43	0.0697674
NODE_4931_length_1107_cov_15.472222	968	1052	3	80	84	0.9523810
NODE_4931_length_1107_cov_15.472222	968	1052	4	4	84	0.0476190
NODE_4932_length_1107_cov_13.911706	502	582	0	80	80	1.0000000
NODE_4932_length_1107_cov_13.911706	555	635	0	80	80	1.0000000
NODE_4933_length_1107_cov_11.701389	520	600	0	80	80	1.0000000
NODE_4933_length_1107_cov_11.701389	573	653	0	80	80	1.0000000
NODE_4944_length_1106_cov_59.617676	452	532	0	49	80	0.6125000
NODE_4944_length_1106_cov_59.617676	452	532	1	7	80	0.0875000
NODE_4944_length_1106_cov_59.617676	452	532	3	24	80	0.3000000
NODE_4944_length_1106_cov_59.617676	505	585	1	3	80	0.0375000
NODE_4944_length_1106_cov_59.617676	505	585	3	31	80	0.3875000
NODE_4944_length_1106_cov_59.617676	505	585	5	18	80	0.2250000
NODE_4944_length_1106_cov_59.617676	505	585	6	5	80	0.0625000
NODE_4944_length_1106_cov_59.617676	505	585	8	23	80	0.2875000
NODE_4944_length_1106_cov_59.617676	581	661	8	31	80	0.3875000
NODE_4944_length_1106_cov_59.617676	581	661	9	6	80	0.0750000
NODE_4944_length_1106_cov_59.617676	581	661	10	8	80	0.1000000
NODE_4944_length_1106_cov_59.617676	581	661	11	20	80	0.2500000
NODE_4944_length_1106_cov_59.617676	581	661	12	15	80	0.1875000
NODE_4944_length_1106_cov_59.617676	634	714	4	7	80	0.0875000
NODE_4944_length_1106_cov_59.617676	634	714	5	7	80	0.0875000
NODE_4944_length_1106_cov_59.617676	634	714	7	11	80	0.1375000
NODE_4944_length_1106_cov_59.617676	634	714	9	31	80	0.3875000
NODE_4944_length_1106_cov_59.617676	634	714	11	9	80	0.1125000
NODE_4944_length_1106_cov_59.617676	634	714	12	15	80	0.1875000
NODE_4945_length_1106_cov_40.808342	439	504	0	65	65	1.0000000
NODE_4945_length_1106_cov_40.808342	471	511	0	40	40	1.0000000
NODE_4945_length_1106_cov_40.808342	503	569	0	26	66	0.3939394
NODE_4945_length_1106_cov_40.808342	503	569	1	40	66	0.6060606
NODE_4945_length_1106_cov_40.808342	536	601	1	65	65	1.0000000
NODE_4945_length_1106_cov_40.808342	568	648	1	71	80	0.8875000
NODE_4945_length_1106_cov_40.808342	568	648	2	9	80	0.1125000
NODE_4945_length_1106_cov_40.808342	621	682	1	21	61	0.3442623
NODE_4945_length_1106_cov_40.808342	621	682	2	40	61	0.6557377
NODE_4946_length_1106_cov_23.186693	560	640	2	14	80	0.1750000
NODE_4946_length_1106_cov_23.186693	560	640	3	3	80	0.0375000
NODE_4946_length_1106_cov_23.186693	560	640	4	16	80	0.2000000
NODE_4946_length_1106_cov_23.186693	560	640	5	38	80	0.4750000
NODE_4946_length_1106_cov_23.186693	560	640	6	9	80	0.1125000
NODE_4946_length_1106_cov_23.186693	613	693	0	22	80	0.2750000
NODE_4946_length_1106_cov_23.186693	613	693	1	17	80	0.2125000
NODE_4946_length_1106_cov_23.186693	613	693	2	28	80	0.3500000
NODE_4946_length_1106_cov_23.186693	613	693	3	3	80	0.0375000
NODE_4946_length_1106_cov_23.186693	613	693	4	10	80	0.1250000
NODE_4947_length_1106_cov_14.570010	466	546	0	32	80	0.4000000
NODE_4947_length_1106_cov_14.570010	466	546	1	21	80	0.2625000
NODE_4947_length_1106_cov_14.570010	466	546	2	23	80	0.2875000
NODE_4947_length_1106_cov_14.570010	466	546	3	4	80	0.0500000
NODE_4947_length_1106_cov_14.570010	519	599	2	23	80	0.2875000
NODE_4947_length_1106_cov_14.570010	519	599	3	22	80	0.2750000
NODE_4947_length_1106_cov_14.570010	519	599	4	35	80	0.4375000
NODE_4948_length_1106_cov_14.039722	487	567	0	18	80	0.2250000
NODE_4948_length_1106_cov_14.039722	487	567	2	62	80	0.7750000
NODE_4948_length_1106_cov_14.039722	540	620	0	13	80	0.1625000
NODE_4948_length_1106_cov_14.039722	540	620	2	67	80	0.8375000
NODE_4949_length_1106_cov_8.872890	328	408	0	80	80	1.0000000
NODE_4949_length_1106_cov_8.872890	381	461	0	80	80	1.0000000
NODE_4950_length_1106_cov_7.157895	332	412	2	47	80	0.5875000
NODE_4950_length_1106_cov_7.157895	332	412	3	33	80	0.4125000
NODE_4950_length_1106_cov_7.157895	385	465	1	25	80	0.3125000
NODE_4950_length_1106_cov_7.157895	385	465	2	19	80	0.2375000
NODE_4950_length_1106_cov_7.157895	385	465	3	36	80	0.4500000
NODE_4951_length_1106_cov_6.530288	513	593	0	80	80	1.0000000
NODE_4951_length_1106_cov_6.530288	566	646	0	80	80	1.0000000
NODE_4959_length_1105_cov_28.126243	253	333	2	1	80	0.0125000
NODE_4959_length_1105_cov_28.126243	253	333	3	31	80	0.3875000
NODE_4959_length_1105_cov_28.126243	253	333	5	48	80	0.6000000
NODE_4959_length_1105_cov_28.126243	306	386	3	27	80	0.3375000
NODE_4959_length_1105_cov_28.126243	306	386	4	8	80	0.1000000
NODE_4959_length_1105_cov_28.126243	306	386	5	45	80	0.5625000
NODE_4960_length_1105_cov_24.994036	549	629	0	23	80	0.2875000
NODE_4960_length_1105_cov_24.994036	549	629	2	11	80	0.1375000
NODE_4960_length_1105_cov_24.994036	549	629	3	38	80	0.4750000
NODE_4960_length_1105_cov_24.994036	549	629	4	8	80	0.1000000
NODE_4960_length_1105_cov_24.994036	602	682	0	76	80	0.9500000
NODE_4960_length_1105_cov_24.994036	602	682	2	4	80	0.0500000
NODE_4961_length_1105_cov_17.635189	442	522	0	76	80	0.9500000
NODE_4961_length_1105_cov_17.635189	442	522	1	4	80	0.0500000
NODE_4961_length_1105_cov_17.635189	495	575	0	23	80	0.2875000
NODE_4961_length_1105_cov_17.635189	495	575	1	57	80	0.7125000
NODE_4963_length_1105_cov_10.114314	438	518	0	80	80	1.0000000
NODE_4963_length_1105_cov_10.114314	491	571	0	80	80	1.0000000
NODE_4964_length_1105_cov_8.403579	507	587	2	80	80	1.0000000
NODE_4964_length_1105_cov_8.403579	560	640	0	40	80	0.5000000
NODE_4964_length_1105_cov_8.403579	560	640	2	40	80	0.5000000
NODE_4966_length_1105_cov_6.682903	467	547	0	80	80	1.0000000
NODE_4966_length_1105_cov_6.682903	520	600	0	80	80	1.0000000
NODE_4966_length_1105_cov_6.682903	596	676	0	80	80	1.0000000
NODE_4966_length_1105_cov_6.682903	649	729	0	80	80	1.0000000
NODE_4974_length_1104_cov_27.599005	388	468	3	28	80	0.3500000
NODE_4974_length_1104_cov_27.599005	388	468	4	12	80	0.1500000
NODE_4974_length_1104_cov_27.599005	388	468	5	40	80	0.5000000
NODE_4974_length_1104_cov_27.599005	441	521	2	39	80	0.4875000
NODE_4974_length_1104_cov_27.599005	441	521	3	22	80	0.2750000
NODE_4974_length_1104_cov_27.599005	441	521	5	19	80	0.2375000
NODE_4984_length_1103_cov_2.787849	620	682	0	62	62	1.0000000
NODE_4986_length_1102_cov_34.484546	667	747	1	14	80	0.1750000
NODE_4986_length_1102_cov_34.484546	667	747	3	66	80	0.8250000
NODE_4986_length_1102_cov_34.484546	720	800	3	80	80	1.0000000
NODE_4987_length_1102_cov_17.631107	511	587	3	16	76	0.2105263
NODE_4987_length_1102_cov_17.631107	511	587	4	22	76	0.2894737
NODE_4987_length_1102_cov_17.631107	511	587	5	38	76	0.5000000
NODE_4987_length_1102_cov_17.631107	560	640	3	20	80	0.2500000
NODE_4987_length_1102_cov_17.631107	560	640	4	6	80	0.0750000
NODE_4987_length_1102_cov_17.631107	560	640	5	54	80	0.6750000
NODE_4998_length_1101_cov_35.638723	414	491	4	26	77	0.3376623
NODE_4998_length_1101_cov_35.638723	414	491	5	8	77	0.1038961
NODE_4998_length_1101_cov_35.638723	414	491	6	38	77	0.4935065
NODE_4998_length_1101_cov_35.638723	414	491	7	1	77	0.0129870
NODE_4998_length_1101_cov_35.638723	414	491	8	4	77	0.0519481
NODE_4998_length_1101_cov_35.638723	414	491	4	26	77	0.3376623
NODE_4998_length_1101_cov_35.638723	414	491	5	8	77	0.1038961
NODE_4998_length_1101_cov_35.638723	414	491	6	38	77	0.4935065
NODE_4998_length_1101_cov_35.638723	414	491	7	1	77	0.0129870
NODE_4998_length_1101_cov_35.638723	414	491	8	4	77	0.0519481
NODE_4998_length_1101_cov_35.638723	488	544	2	7	56	0.1250000
NODE_4998_length_1101_cov_35.638723	488	544	4	26	56	0.4642857
NODE_4998_length_1101_cov_35.638723	488	544	6	23	56	0.4107143
NODE_4998_length_1101_cov_35.638723	752	832	0	33	80	0.4125000
NODE_4998_length_1101_cov_35.638723	752	832	1	47	80	0.5875000
NODE_4998_length_1101_cov_35.638723	805	885	1	35	80	0.4375000
NODE_4998_length_1101_cov_35.638723	805	885	2	45	80	0.5625000
NODE_4998_length_1101_cov_35.638723	881	961	1	21	80	0.2625000
NODE_4998_length_1101_cov_35.638723	881	961	2	59	80	0.7375000
NODE_4998_length_1101_cov_35.638723	934	1014	0	24	80	0.3000000
NODE_4998_length_1101_cov_35.638723	934	1014	1	50	80	0.6250000
NODE_4998_length_1101_cov_35.638723	934	1014	2	6	80	0.0750000
NODE_4999_length_1101_cov_28.366267	452	532	2	3	80	0.0375000
NODE_4999_length_1101_cov_28.366267	452	532	3	75	80	0.9375000
NODE_4999_length_1101_cov_28.366267	452	532	4	2	80	0.0250000
NODE_4999_length_1101_cov_28.366267	505	585	1	27	80	0.3375000
NODE_4999_length_1101_cov_28.366267	505	585	2	29	80	0.3625000
NODE_4999_length_1101_cov_28.366267	505	585	3	22	80	0.2750000
NODE_4999_length_1101_cov_28.366267	505	585	4	2	80	0.0250000
NODE_5000_length_1101_cov_24.513972	475	555	0	80	80	1.0000000
NODE_5000_length_1101_cov_24.513972	528	608	0	80	80	1.0000000
NODE_5001_length_1101_cov_22.315369	335	415	6	26	80	0.3250000
NODE_5001_length_1101_cov_22.315369	335	415	7	18	80	0.2250000
NODE_5001_length_1101_cov_22.315369	335	415	9	36	80	0.4500000
NODE_5001_length_1101_cov_22.315369	388	468	5	6	80	0.0750000
NODE_5001_length_1101_cov_22.315369	388	468	6	4	80	0.0500000
NODE_5001_length_1101_cov_22.315369	388	468	7	37	80	0.4625000
NODE_5001_length_1101_cov_22.315369	388	468	8	4	80	0.0500000
NODE_5001_length_1101_cov_22.315369	388	468	9	29	80	0.3625000
NODE_5001_length_1101_cov_22.315369	464	544	3	18	80	0.2250000
NODE_5001_length_1101_cov_22.315369	464	544	4	12	80	0.1500000
NODE_5001_length_1101_cov_22.315369	464	544	5	11	80	0.1375000
NODE_5001_length_1101_cov_22.315369	464	544	6	35	80	0.4375000
NODE_5001_length_1101_cov_22.315369	464	544	7	4	80	0.0500000
NODE_5001_length_1101_cov_22.315369	517	597	3	15	80	0.1875000
NODE_5001_length_1101_cov_22.315369	517	597	4	57	80	0.7125000
NODE_5001_length_1101_cov_22.315369	517	597	5	8	80	0.1000000
NODE_5002_length_1101_cov_22.070858	419	499	0	10	80	0.1250000
NODE_5002_length_1101_cov_22.070858	419	499	1	35	80	0.4375000
NODE_5002_length_1101_cov_22.070858	419	499	2	35	80	0.4375000
NODE_5002_length_1101_cov_22.070858	472	552	0	63	80	0.7875000
NODE_5002_length_1101_cov_22.070858	472	552	1	17	80	0.2125000
NODE_5002_length_1101_cov_22.070858	548	628	0	36	80	0.4500000
NODE_5002_length_1101_cov_22.070858	548	628	2	44	80	0.5500000
NODE_5002_length_1101_cov_22.070858	601	681	2	80	80	1.0000000
NODE_5003_length_1101_cov_18.821357	469	549	1	5	80	0.0625000
NODE_5003_length_1101_cov_18.821357	469	549	2	75	80	0.9375000
NODE_5003_length_1101_cov_18.821357	522	602	2	80	80	1.0000000
NODE_5004_length_1101_cov_17.151697	502	582	6	11	80	0.1375000
NODE_5004_length_1101_cov_17.151697	502	582	7	4	80	0.0500000
NODE_5004_length_1101_cov_17.151697	502	582	8	28	80	0.3500000
NODE_5004_length_1101_cov_17.151697	502	582	9	18	80	0.2250000
NODE_5004_length_1101_cov_17.151697	502	582	11	19	80	0.2375000
NODE_5004_length_1101_cov_17.151697	555	635	7	7	80	0.0875000
NODE_5004_length_1101_cov_17.151697	555	635	8	14	80	0.1750000
NODE_5004_length_1101_cov_17.151697	555	635	9	38	80	0.4750000
NODE_5004_length_1101_cov_17.151697	555	635	11	21	80	0.2625000
NODE_5005_length_1101_cov_8.371257	968	1048	7	2	80	0.0250000
NODE_5005_length_1101_cov_8.371257	968	1048	8	1	80	0.0125000
NODE_5005_length_1101_cov_8.371257	968	1048	9	1	80	0.0125000
NODE_5005_length_1101_cov_8.371257	968	1048	11	2	80	0.0250000
NODE_5005_length_1101_cov_8.371257	968	1048	13	72	80	0.9000000
NODE_5005_length_1101_cov_8.371257	968	1048	16	1	80	0.0125000
NODE_5005_length_1101_cov_8.371257	968	1048	17	1	80	0.0125000
NODE_5010_length_1100_cov_42.528472	582	662	0	80	80	1.0000000
NODE_5010_length_1100_cov_42.528472	635	715	0	44	80	0.5500000
NODE_5010_length_1100_cov_42.528472	635	715	1	36	80	0.4500000
NODE_5010_length_1100_cov_42.528472	711	791	1	21	80	0.2625000
NODE_5010_length_1100_cov_42.528472	711	791	2	59	80	0.7375000
NODE_5010_length_1100_cov_42.528472	764	844	1	16	80	0.2000000
NODE_5010_length_1100_cov_42.528472	764	844	2	64	80	0.8000000
NODE_5011_length_1100_cov_40.883117	324	404	2	80	80	1.0000000
NODE_5011_length_1100_cov_40.883117	377	457	1	13	80	0.1625000
NODE_5011_length_1100_cov_40.883117	377	457	2	41	80	0.5125000
NODE_5011_length_1100_cov_40.883117	377	457	3	26	80	0.3250000
NODE_5011_length_1100_cov_40.883117	453	533	3	27	80	0.3375000
NODE_5011_length_1100_cov_40.883117	453	533	4	1	80	0.0125000
NODE_5011_length_1100_cov_40.883117	453	533	5	52	80	0.6500000
NODE_5011_length_1100_cov_40.883117	506	586	4	5	80	0.0625000
NODE_5011_length_1100_cov_40.883117	506	586	5	43	80	0.5375000
NODE_5011_length_1100_cov_40.883117	506	586	6	32	80	0.4000000
NODE_5012_length_1100_cov_23.160839	524	604	4	40	80	0.5000000
NODE_5012_length_1100_cov_23.160839	524	604	5	40	80	0.5000000
NODE_5012_length_1100_cov_23.160839	577	657	4	43	80	0.5375000
NODE_5012_length_1100_cov_23.160839	577	657	5	30	80	0.3750000
NODE_5012_length_1100_cov_23.160839	577	657	6	7	80	0.0875000
NODE_5012_length_1100_cov_23.160839	653	733	4	14	80	0.1750000
NODE_5012_length_1100_cov_23.160839	653	733	5	8	80	0.1000000
NODE_5012_length_1100_cov_23.160839	653	733	6	48	80	0.6000000
NODE_5012_length_1100_cov_23.160839	653	733	7	10	80	0.1250000
NODE_5012_length_1100_cov_23.160839	706	786	5	14	80	0.1750000
NODE_5012_length_1100_cov_23.160839	706	786	6	61	80	0.7625000
NODE_5012_length_1100_cov_23.160839	706	786	7	5	80	0.0625000
NODE_5013_length_1100_cov_22.200799	485	565	0	80	80	1.0000000
NODE_5013_length_1100_cov_22.200799	538	618	0	80	80	1.0000000
NODE_5013_length_1100_cov_22.200799	614	694	0	80	80	1.0000000
NODE_5013_length_1100_cov_22.200799	667	745	0	78	78	1.0000000
NODE_5014_length_1100_cov_15.353646	472	552	1	1	80	0.0125000
NODE_5014_length_1100_cov_15.353646	472	552	3	10	80	0.1250000
NODE_5014_length_1100_cov_15.353646	472	552	4	10	80	0.1250000
NODE_5014_length_1100_cov_15.353646	472	552	5	18	80	0.2250000
NODE_5014_length_1100_cov_15.353646	472	552	6	41	80	0.5125000
NODE_5014_length_1100_cov_15.353646	525	605	4	23	80	0.2875000
NODE_5014_length_1100_cov_15.353646	525	605	6	57	80	0.7125000
NODE_5015_length_1100_cov_14.584416	673	753	2	15	80	0.1875000
NODE_5015_length_1100_cov_14.584416	673	753	3	34	80	0.4250000
NODE_5015_length_1100_cov_14.584416	673	753	4	31	80	0.3875000
NODE_5015_length_1100_cov_14.584416	726	806	3	28	80	0.3500000
NODE_5015_length_1100_cov_14.584416	726	806	4	23	80	0.2875000
NODE_5015_length_1100_cov_14.584416	726	806	5	29	80	0.3625000
NODE_5029_length_1099_cov_85.893000	464	544	5	41	80	0.5125000
NODE_5029_length_1099_cov_85.893000	464	544	6	39	80	0.4875000
NODE_5029_length_1099_cov_85.893000	517	597	3	13	80	0.1625000
NODE_5029_length_1099_cov_85.893000	517	597	5	26	80	0.3250000
NODE_5029_length_1099_cov_85.893000	517	597	6	18	80	0.2250000
NODE_5029_length_1099_cov_85.893000	517	597	7	17	80	0.2125000
NODE_5029_length_1099_cov_85.893000	517	597	8	6	80	0.0750000
NODE_5029_length_1099_cov_85.893000	593	673	3	63	80	0.7875000
NODE_5029_length_1099_cov_85.893000	593	673	4	9	80	0.1125000
NODE_5029_length_1099_cov_85.893000	593	673	5	8	80	0.1000000
NODE_5029_length_1099_cov_85.893000	646	726	1	22	80	0.2750000
NODE_5029_length_1099_cov_85.893000	646	726	3	58	80	0.7250000
NODE_5030_length_1099_cov_45.874000	521	601	2	25	80	0.3125000
NODE_5030_length_1099_cov_45.874000	521	601	3	55	80	0.6875000
NODE_5030_length_1099_cov_45.874000	574	654	1	28	80	0.3500000
NODE_5030_length_1099_cov_45.874000	574	654	2	8	80	0.1000000
NODE_5030_length_1099_cov_45.874000	574	654	3	44	80	0.5500000
NODE_5030_length_1099_cov_45.874000	650	730	2	47	80	0.5875000
NODE_5030_length_1099_cov_45.874000	650	730	3	33	80	0.4125000
NODE_5030_length_1099_cov_45.874000	703	783	2	69	80	0.8625000
NODE_5030_length_1099_cov_45.874000	703	783	3	11	80	0.1375000
NODE_5031_length_1099_cov_25.192000	526	606	0	80	80	1.0000000
NODE_5031_length_1099_cov_25.192000	579	659	0	80	80	1.0000000
NODE_5032_length_1099_cov_11.846000	565	645	1	63	80	0.7875000
NODE_5032_length_1099_cov_11.846000	565	645	2	16	80	0.2000000
NODE_5032_length_1099_cov_11.846000	565	645	3	1	80	0.0125000
NODE_5032_length_1099_cov_11.846000	618	698	1	26	80	0.3250000
NODE_5032_length_1099_cov_11.846000	618	698	2	30	80	0.3750000
NODE_5032_length_1099_cov_11.846000	618	698	3	24	80	0.3000000
NODE_5033_length_1099_cov_9.527000	495	575	3	7	80	0.0875000
NODE_5033_length_1099_cov_9.527000	495	575	4	59	80	0.7375000
NODE_5033_length_1099_cov_9.527000	495	575	5	14	80	0.1750000
NODE_5033_length_1099_cov_9.527000	548	628	4	54	80	0.6750000
NODE_5033_length_1099_cov_9.527000	548	628	5	26	80	0.3250000
NODE_5034_length_1099_cov_8.993000	464	544	0	80	80	1.0000000
NODE_5034_length_1099_cov_8.993000	517	597	0	80	80	1.0000000
NODE_5039_length_1099_cov_2.286000	273	353	1	80	80	1.0000000
NODE_5045_length_1098_cov_44.988989	360	440	1	9	80	0.1125000
NODE_5045_length_1098_cov_44.988989	360	440	3	17	80	0.2125000
NODE_5045_length_1098_cov_44.988989	360	440	4	32	80	0.4000000
NODE_5045_length_1098_cov_44.988989	360	440	5	22	80	0.2750000
NODE_5045_length_1098_cov_44.988989	413	493	1	47	80	0.5875000
NODE_5045_length_1098_cov_44.988989	413	493	2	15	80	0.1875000
NODE_5045_length_1098_cov_44.988989	413	493	3	17	80	0.2125000
NODE_5045_length_1098_cov_44.988989	413	493	4	1	80	0.0125000
NODE_5046_length_1098_cov_35.192192	452	532	1	10	80	0.1250000
NODE_5046_length_1098_cov_35.192192	452	532	3	70	80	0.8750000
NODE_5046_length_1098_cov_35.192192	505	585	3	49	80	0.6125000
NODE_5046_length_1098_cov_35.192192	505	585	4	26	80	0.3250000
NODE_5046_length_1098_cov_35.192192	505	585	5	5	80	0.0625000
NODE_5046_length_1098_cov_35.192192	581	661	2	2	80	0.0250000
NODE_5046_length_1098_cov_35.192192	581	661	3	29	80	0.3625000
NODE_5046_length_1098_cov_35.192192	581	661	4	49	80	0.6125000
NODE_5046_length_1098_cov_35.192192	634	714	4	39	80	0.4875000
NODE_5046_length_1098_cov_35.192192	634	714	5	41	80	0.5125000
NODE_5047_length_1098_cov_28.743744	449	529	3	37	80	0.4625000
NODE_5047_length_1098_cov_28.743744	449	529	4	21	80	0.2625000
NODE_5047_length_1098_cov_28.743744	449	529	5	22	80	0.2750000
NODE_5047_length_1098_cov_28.743744	502	582	4	5	80	0.0625000
NODE_5047_length_1098_cov_28.743744	502	582	5	22	80	0.2750000
NODE_5047_length_1098_cov_28.743744	502	582	6	8	80	0.1000000
NODE_5047_length_1098_cov_28.743744	502	582	7	10	80	0.1250000
NODE_5047_length_1098_cov_28.743744	502	582	8	6	80	0.0750000
NODE_5047_length_1098_cov_28.743744	502	582	9	6	80	0.0750000
NODE_5047_length_1098_cov_28.743744	502	582	10	14	80	0.1750000
NODE_5047_length_1098_cov_28.743744	502	582	11	9	80	0.1125000
NODE_5047_length_1098_cov_28.743744	578	658	10	16	80	0.2000000
NODE_5047_length_1098_cov_28.743744	578	658	11	2	80	0.0250000
NODE_5047_length_1098_cov_28.743744	578	658	13	10	80	0.1250000
NODE_5047_length_1098_cov_28.743744	578	658	15	6	80	0.0750000
NODE_5047_length_1098_cov_28.743744	578	658	16	9	80	0.1125000
NODE_5047_length_1098_cov_28.743744	578	658	20	4	80	0.0500000
NODE_5047_length_1098_cov_28.743744	578	658	21	3	80	0.0375000
NODE_5047_length_1098_cov_28.743744	578	658	22	1	80	0.0125000
NODE_5047_length_1098_cov_28.743744	578	658	23	26	80	0.3250000
NODE_5047_length_1098_cov_28.743744	578	658	24	3	80	0.0375000
NODE_5047_length_1098_cov_28.743744	631	711	22	6	80	0.0750000
NODE_5047_length_1098_cov_28.743744	631	711	23	28	80	0.3500000
NODE_5047_length_1098_cov_28.743744	631	711	24	4	80	0.0500000
NODE_5047_length_1098_cov_28.743744	631	711	25	7	80	0.0875000
NODE_5047_length_1098_cov_28.743744	631	711	26	12	80	0.1500000
NODE_5047_length_1098_cov_28.743744	631	711	27	23	80	0.2875000
NODE_5048_length_1098_cov_28.230230	477	557	3	15	80	0.1875000
NODE_5048_length_1098_cov_28.230230	477	557	4	65	80	0.8125000
NODE_5048_length_1098_cov_28.230230	530	610	3	5	80	0.0625000
NODE_5048_length_1098_cov_28.230230	530	610	4	73	80	0.9125000
NODE_5048_length_1098_cov_28.230230	530	610	5	2	80	0.0250000
NODE_5048_length_1098_cov_28.230230	606	686	2	49	80	0.6125000
NODE_5048_length_1098_cov_28.230230	606	686	3	12	80	0.1500000
NODE_5048_length_1098_cov_28.230230	606	686	4	19	80	0.2375000
NODE_5048_length_1098_cov_28.230230	659	739	0	42	80	0.5250000
NODE_5048_length_1098_cov_28.230230	659	739	1	10	80	0.1250000
NODE_5048_length_1098_cov_28.230230	659	739	2	28	80	0.3500000
NODE_5049_length_1098_cov_26.131131	494	574	4	36	80	0.4500000
NODE_5049_length_1098_cov_26.131131	494	574	7	14	80	0.1750000
NODE_5049_length_1098_cov_26.131131	494	574	8	20	80	0.2500000
NODE_5049_length_1098_cov_26.131131	494	574	9	10	80	0.1250000
NODE_5049_length_1098_cov_26.131131	547	627	7	16	80	0.2000000
NODE_5049_length_1098_cov_26.131131	547	627	8	36	80	0.4500000
NODE_5049_length_1098_cov_26.131131	547	627	9	28	80	0.3500000
NODE_5050_length_1098_cov_21.355355	599	679	3	57	80	0.7125000
NODE_5050_length_1098_cov_21.355355	599	679	4	23	80	0.2875000
NODE_5050_length_1098_cov_21.355355	652	732	3	67	80	0.8375000
NODE_5050_length_1098_cov_21.355355	652	732	4	13	80	0.1625000
NODE_5051_length_1098_cov_17.087087	541	621	0	80	80	1.0000000
NODE_5051_length_1098_cov_17.087087	594	674	0	80	80	1.0000000
NODE_5051_length_1098_cov_17.087087	670	750	0	24	80	0.3000000
NODE_5051_length_1098_cov_17.087087	670	750	1	47	80	0.5875000
NODE_5051_length_1098_cov_17.087087	670	750	2	9	80	0.1125000
NODE_5051_length_1098_cov_17.087087	723	803	1	18	80	0.2250000
NODE_5051_length_1098_cov_17.087087	723	803	2	62	80	0.7750000
NODE_5052_length_1098_cov_15.455455	545	625	1	22	80	0.2750000
NODE_5052_length_1098_cov_15.455455	545	625	2	3	80	0.0375000
NODE_5052_length_1098_cov_15.455455	545	625	3	55	80	0.6875000
NODE_5052_length_1098_cov_15.455455	598	678	1	53	80	0.6625000
NODE_5052_length_1098_cov_15.455455	598	678	2	25	80	0.3125000
NODE_5052_length_1098_cov_15.455455	598	678	3	2	80	0.0250000
NODE_5052_length_1098_cov_15.455455	674	754	1	80	80	1.0000000
NODE_5052_length_1098_cov_15.455455	727	807	0	35	80	0.4375000
NODE_5052_length_1098_cov_15.455455	727	807	1	45	80	0.5625000
NODE_5054_length_1097_cov_37.103206	438	518	1	23	80	0.2875000
NODE_5054_length_1097_cov_37.103206	438	518	2	57	80	0.7125000
NODE_5054_length_1097_cov_37.103206	491	571	2	72	80	0.9000000
NODE_5054_length_1097_cov_37.103206	491	571	3	8	80	0.1000000
NODE_5054_length_1097_cov_37.103206	567	647	2	8	80	0.1000000
NODE_5054_length_1097_cov_37.103206	567	647	3	33	80	0.4125000
NODE_5054_length_1097_cov_37.103206	567	647	4	39	80	0.4875000
NODE_5054_length_1097_cov_37.103206	620	700	3	25	80	0.3125000
NODE_5054_length_1097_cov_37.103206	620	700	4	19	80	0.2375000
NODE_5054_length_1097_cov_37.103206	620	700	5	36	80	0.4500000
NODE_5055_length_1097_cov_32.624248	501	581	3	4	80	0.0500000
NODE_5055_length_1097_cov_32.624248	501	581	4	42	80	0.5250000
NODE_5055_length_1097_cov_32.624248	501	581	5	11	80	0.1375000
NODE_5055_length_1097_cov_32.624248	501	581	7	23	80	0.2875000
NODE_5055_length_1097_cov_32.624248	554	634	3	57	80	0.7125000
NODE_5055_length_1097_cov_32.624248	554	634	5	6	80	0.0750000
NODE_5055_length_1097_cov_32.624248	554	634	7	17	80	0.2125000
NODE_5056_length_1097_cov_25.240481	401	480	0	5	79	0.0632911
NODE_5056_length_1097_cov_25.240481	401	480	1	61	79	0.7721519
NODE_5056_length_1097_cov_25.240481	401	480	2	13	79	0.1645570
NODE_5056_length_1097_cov_25.240481	453	533	1	14	80	0.1750000
NODE_5056_length_1097_cov_25.240481	453	533	2	66	80	0.8250000
NODE_5056_length_1097_cov_25.240481	529	609	1	53	80	0.6625000
NODE_5056_length_1097_cov_25.240481	529	609	2	27	80	0.3375000
NODE_5056_length_1097_cov_25.240481	582	662	0	45	80	0.5625000
NODE_5056_length_1097_cov_25.240481	582	662	1	35	80	0.4375000
NODE_5057_length_1097_cov_21.221443	484	564	2	23	80	0.2875000
NODE_5057_length_1097_cov_21.221443	484	564	3	43	80	0.5375000
NODE_5057_length_1097_cov_21.221443	484	564	4	14	80	0.1750000
NODE_5057_length_1097_cov_21.221443	537	617	2	51	80	0.6375000
NODE_5057_length_1097_cov_21.221443	537	617	3	13	80	0.1625000
NODE_5057_length_1097_cov_21.221443	537	617	4	16	80	0.2000000
NODE_5057_length_1097_cov_21.221443	613	693	1	2	80	0.0250000
NODE_5057_length_1097_cov_21.221443	613	693	2	78	80	0.9750000
NODE_5057_length_1097_cov_21.221443	666	746	1	13	80	0.1625000
NODE_5057_length_1097_cov_21.221443	666	746	2	67	80	0.8375000
NODE_5058_length_1097_cov_20.968938	515	595	4	11	80	0.1375000
NODE_5058_length_1097_cov_20.968938	515	595	5	69	80	0.8625000
NODE_5058_length_1097_cov_20.968938	568	648	2	36	80	0.4500000
NODE_5058_length_1097_cov_20.968938	568	648	3	12	80	0.1500000
NODE_5058_length_1097_cov_20.968938	568	648	5	32	80	0.4000000
NODE_5059_length_1097_cov_13.136273	697	779	2	12	82	0.1463415
NODE_5059_length_1097_cov_13.136273	697	779	3	15	82	0.1829268
NODE_5059_length_1097_cov_13.136273	697	779	4	55	82	0.6707317
NODE_5059_length_1097_cov_13.136273	752	832	1	5	80	0.0625000
NODE_5059_length_1097_cov_13.136273	752	832	3	7	80	0.0875000
NODE_5059_length_1097_cov_13.136273	752	832	4	68	80	0.8500000
NODE_5060_length_1097_cov_6.376754	442	522	1	25	80	0.3125000
NODE_5060_length_1097_cov_6.376754	442	522	2	47	80	0.5875000
NODE_5060_length_1097_cov_6.376754	442	522	3	6	80	0.0750000
NODE_5060_length_1097_cov_6.376754	442	522	5	2	80	0.0250000
NODE_5060_length_1097_cov_6.376754	495	575	2	19	80	0.2375000
NODE_5060_length_1097_cov_6.376754	495	575	3	6	80	0.0750000
NODE_5060_length_1097_cov_6.376754	495	575	5	21	80	0.2625000
NODE_5060_length_1097_cov_6.376754	495	575	6	34	80	0.4250000
NODE_5061_length_1097_cov_6.068136	299	379	0	80	80	1.0000000
NODE_5061_length_1097_cov_6.068136	352	432	0	80	80	1.0000000
NODE_5072_length_1096_cov_55.816449	430	510	4	3	80	0.0375000
NODE_5072_length_1096_cov_55.816449	430	510	5	17	80	0.2125000
NODE_5072_length_1096_cov_55.816449	430	510	6	55	80	0.6875000
NODE_5072_length_1096_cov_55.816449	430	510	7	5	80	0.0625000
NODE_5072_length_1096_cov_55.816449	483	563	4	45	80	0.5625000
NODE_5072_length_1096_cov_55.816449	483	563	6	30	80	0.3750000
NODE_5072_length_1096_cov_55.816449	483	563	7	5	80	0.0625000
NODE_5072_length_1096_cov_55.816449	559	639	3	4	80	0.0500000
NODE_5072_length_1096_cov_55.816449	559	639	4	53	80	0.6625000
NODE_5072_length_1096_cov_55.816449	559	639	5	17	80	0.2125000
NODE_5072_length_1096_cov_55.816449	559	639	6	6	80	0.0750000
NODE_5072_length_1096_cov_55.816449	612	692	3	57	80	0.7125000
NODE_5072_length_1096_cov_55.816449	612	692	4	23	80	0.2875000
NODE_5073_length_1096_cov_24.672016	431	511	1	25	80	0.3125000
NODE_5073_length_1096_cov_24.672016	431	511	2	43	80	0.5375000
NODE_5073_length_1096_cov_24.672016	431	511	3	12	80	0.1500000
NODE_5073_length_1096_cov_24.672016	484	564	2	23	80	0.2875000
NODE_5073_length_1096_cov_24.672016	484	564	3	57	80	0.7125000
NODE_5073_length_1096_cov_24.672016	560	640	1	34	80	0.4250000
NODE_5073_length_1096_cov_24.672016	560	640	2	46	80	0.5750000
NODE_5073_length_1096_cov_24.672016	613	693	0	44	80	0.5500000
NODE_5073_length_1096_cov_24.672016	613	693	1	36	80	0.4500000
NODE_5074_length_1096_cov_22.980943	372	452	0	80	80	1.0000000
NODE_5074_length_1096_cov_22.980943	425	505	0	80	80	1.0000000
NODE_5075_length_1096_cov_16.649950	486	566	0	80	80	1.0000000
NODE_5075_length_1096_cov_16.649950	539	619	0	80	80	1.0000000
NODE_5076_length_1096_cov_16.433300	443	523	2	16	80	0.2000000
NODE_5076_length_1096_cov_16.433300	443	523	3	11	80	0.1375000
NODE_5076_length_1096_cov_16.433300	443	523	4	8	80	0.1000000
NODE_5076_length_1096_cov_16.433300	443	523	5	5	80	0.0625000
NODE_5076_length_1096_cov_16.433300	443	523	6	25	80	0.3125000
NODE_5076_length_1096_cov_16.433300	443	523	7	15	80	0.1875000
NODE_5076_length_1096_cov_16.433300	496	576	6	31	80	0.3875000
NODE_5076_length_1096_cov_16.433300	496	576	7	49	80	0.6125000
NODE_5076_length_1096_cov_16.433300	886	966	0	6	80	0.0750000
NODE_5076_length_1096_cov_16.433300	886	966	2	74	80	0.9250000
NODE_5076_length_1096_cov_16.433300	939	1018	0	47	79	0.5949367
NODE_5076_length_1096_cov_16.433300	939	1018	1	11	79	0.1392405
NODE_5076_length_1096_cov_16.433300	939	1018	2	21	79	0.2658228
NODE_5077_length_1096_cov_13.398195	670	750	0	80	80	1.0000000
NODE_5077_length_1096_cov_13.398195	723	803	0	71	80	0.8875000
NODE_5077_length_1096_cov_13.398195	723	803	1	9	80	0.1125000
NODE_5080_length_1095_cov_25.390562	520	600	2	80	80	1.0000000
NODE_5080_length_1095_cov_25.390562	573	653	0	40	80	0.5000000
NODE_5080_length_1095_cov_25.390562	573	653	2	40	80	0.5000000
NODE_5080_length_1095_cov_25.390562	649	729	2	7	80	0.0875000
NODE_5080_length_1095_cov_25.390562	649	729	3	73	80	0.9125000
NODE_5080_length_1095_cov_25.390562	702	782	1	52	80	0.6500000
NODE_5080_length_1095_cov_25.390562	702	782	3	28	80	0.3500000
NODE_5081_length_1095_cov_13.832329	549	629	10	5	80	0.0625000
NODE_5081_length_1095_cov_13.832329	549	629	11	6	80	0.0750000
NODE_5081_length_1095_cov_13.832329	549	629	12	26	80	0.3250000
NODE_5081_length_1095_cov_13.832329	549	629	13	21	80	0.2625000
NODE_5081_length_1095_cov_13.832329	549	629	14	10	80	0.1250000
NODE_5081_length_1095_cov_13.832329	549	629	15	12	80	0.1500000
NODE_5081_length_1095_cov_13.832329	602	682	8	6	80	0.0750000
NODE_5081_length_1095_cov_13.832329	602	682	9	26	80	0.3250000
NODE_5081_length_1095_cov_13.832329	602	682	10	24	80	0.3000000
NODE_5081_length_1095_cov_13.832329	602	682	12	10	80	0.1250000
NODE_5081_length_1095_cov_13.832329	602	682	14	5	80	0.0625000
NODE_5081_length_1095_cov_13.832329	602	682	15	9	80	0.1125000
NODE_5082_length_1095_cov_13.017068	497	577	3	77	80	0.9625000
NODE_5082_length_1095_cov_13.017068	497	577	5	3	80	0.0375000
NODE_5082_length_1095_cov_13.017068	550	630	3	43	80	0.5375000
NODE_5082_length_1095_cov_13.017068	550	630	4	37	80	0.4625000
NODE_5083_length_1095_cov_7.640562	627	707	3	80	80	1.0000000
NODE_5083_length_1095_cov_7.640562	680	760	2	45	80	0.5625000
NODE_5083_length_1095_cov_7.640562	680	760	3	35	80	0.4375000
NODE_5085_length_1095_cov_4.664659	307	387	2	80	80	1.0000000
NODE_5089_length_1094_cov_35.850251	409	489	0	80	80	1.0000000
NODE_5089_length_1094_cov_35.850251	462	542	0	53	80	0.6625000
NODE_5089_length_1094_cov_35.850251	462	542	1	27	80	0.3375000
NODE_5089_length_1094_cov_35.850251	538	618	1	8	80	0.1000000
NODE_5089_length_1094_cov_35.850251	538	618	2	1	80	0.0125000
NODE_5089_length_1094_cov_35.850251	538	618	4	4	80	0.0500000
NODE_5089_length_1094_cov_35.850251	538	618	5	67	80	0.8375000
NODE_5089_length_1094_cov_35.850251	591	671	3	18	80	0.2250000
NODE_5089_length_1094_cov_35.850251	591	671	4	14	80	0.1750000
NODE_5089_length_1094_cov_35.850251	591	671	5	48	80	0.6000000
NODE_5090_length_1094_cov_27.197990	462	542	0	6	80	0.0750000
NODE_5090_length_1094_cov_27.197990	462	542	2	18	80	0.2250000
NODE_5090_length_1094_cov_27.197990	462	542	4	56	80	0.7000000
NODE_5090_length_1094_cov_27.197990	515	595	4	80	80	1.0000000
NODE_5091_length_1094_cov_19.282412	451	531	0	14	80	0.1750000
NODE_5091_length_1094_cov_19.282412	451	531	2	66	80	0.8250000
NODE_5091_length_1094_cov_19.282412	504	584	2	80	80	1.0000000
NODE_5092_length_1094_cov_16.084422	558	614	2	56	56	1.0000000
NODE_5092_length_1094_cov_16.084422	587	667	1	24	80	0.3000000
NODE_5092_length_1094_cov_16.084422	587	667	2	56	80	0.7000000
NODE_5093_length_1094_cov_11.335678	384	464	6	80	80	1.0000000
NODE_5093_length_1094_cov_11.335678	437	517	2	17	80	0.2125000
NODE_5093_length_1094_cov_11.335678	437	517	3	15	80	0.1875000
NODE_5093_length_1094_cov_11.335678	437	517	4	5	80	0.0625000
NODE_5093_length_1094_cov_11.335678	437	517	6	43	80	0.5375000
NODE_5094_length_1094_cov_10.767839	396	476	0	80	80	1.0000000
NODE_5094_length_1094_cov_10.767839	449	529	0	80	80	1.0000000
NODE_5095_length_1094_cov_9.527638	579	659	0	5	80	0.0625000
NODE_5095_length_1094_cov_9.527638	579	659	1	75	80	0.9375000
NODE_5095_length_1094_cov_9.527638	632	712	1	80	80	1.0000000
NODE_5096_length_1094_cov_9.166834	527	607	3	6	80	0.0750000
NODE_5096_length_1094_cov_9.166834	527	607	4	29	80	0.3625000
NODE_5096_length_1094_cov_9.166834	527	607	5	28	80	0.3500000
NODE_5096_length_1094_cov_9.166834	527	607	6	17	80	0.2125000
NODE_5096_length_1094_cov_9.166834	580	660	3	33	80	0.4125000
NODE_5096_length_1094_cov_9.166834	580	660	4	14	80	0.1750000
NODE_5096_length_1094_cov_9.166834	580	660	5	12	80	0.1500000
NODE_5096_length_1094_cov_9.166834	580	660	6	21	80	0.2625000
NODE_5097_length_1094_cov_5.632161	708	768	1	36	60	0.6000000
NODE_5097_length_1094_cov_5.632161	708	768	3	24	60	0.4000000
NODE_5097_length_1094_cov_5.632161	761	821	3	60	60	1.0000000
NODE_5108_length_1093_cov_28.531187	374	454	4	26	80	0.3250000
NODE_5108_length_1093_cov_28.531187	374	454	5	49	80	0.6125000
NODE_5108_length_1093_cov_28.531187	374	454	6	5	80	0.0625000
NODE_5108_length_1093_cov_28.531187	427	507	4	2	80	0.0250000
NODE_5108_length_1093_cov_28.531187	427	507	5	68	80	0.8500000
NODE_5108_length_1093_cov_28.531187	427	507	6	10	80	0.1250000
NODE_5109_length_1093_cov_22.744467	516	596	1	42	80	0.5250000
NODE_5109_length_1093_cov_22.744467	516	596	2	38	80	0.4750000
NODE_5109_length_1093_cov_22.744467	569	649	2	80	80	1.0000000
NODE_5109_length_1093_cov_22.744467	645	725	0	17	80	0.2125000
NODE_5109_length_1093_cov_22.744467	645	725	1	43	80	0.5375000
NODE_5109_length_1093_cov_22.744467	645	725	2	20	80	0.2500000
NODE_5109_length_1093_cov_22.744467	698	778	0	70	80	0.8750000
NODE_5109_length_1093_cov_22.744467	698	778	1	10	80	0.1250000
NODE_5110_length_1093_cov_11.637827	282	362	3	69	80	0.8625000
NODE_5110_length_1093_cov_11.637827	282	362	4	9	80	0.1125000
NODE_5110_length_1093_cov_11.637827	282	362	5	2	80	0.0250000
NODE_5110_length_1093_cov_11.637827	335	415	3	23	80	0.2875000
NODE_5110_length_1093_cov_11.637827	335	415	4	55	80	0.6875000
NODE_5110_length_1093_cov_11.637827	335	415	5	2	80	0.0250000
NODE_5111_length_1093_cov_9.047284	660	740	0	80	80	1.0000000
NODE_5111_length_1093_cov_9.047284	713	793	0	80	80	1.0000000
NODE_5112_length_1093_cov_6.857143	658	738	0	80	80	1.0000000
NODE_5112_length_1093_cov_6.857143	711	791	0	80	80	1.0000000
NODE_5113_length_1093_cov_5.311871	587	667	2	80	80	1.0000000
NODE_5113_length_1093_cov_5.311871	640	720	0	47	80	0.5875000
NODE_5113_length_1093_cov_5.311871	640	720	2	33	80	0.4125000
NODE_5118_length_1092_cov_105.542800	682	768	2	33	86	0.3837209
NODE_5118_length_1092_cov_105.542800	682	768	3	3	86	0.0348837
NODE_5118_length_1092_cov_105.542800	682	768	4	50	86	0.5813953
NODE_5118_length_1092_cov_105.542800	745	807	1	4	62	0.0645161
NODE_5118_length_1092_cov_105.542800	745	807	2	6	62	0.0967742
NODE_5118_length_1092_cov_105.542800	745	807	3	22	62	0.3548387
NODE_5118_length_1092_cov_105.542800	745	807	4	30	62	0.4838710
NODE_5119_length_1092_cov_30.957704	610	690	2	80	80	1.0000000
NODE_5119_length_1092_cov_30.957704	663	743	1	16	80	0.2000000
NODE_5119_length_1092_cov_30.957704	663	743	2	64	80	0.8000000
NODE_5121_length_1092_cov_16.737160	725	805	0	80	80	1.0000000
NODE_5121_length_1092_cov_16.737160	778	858	0	80	80	1.0000000
NODE_5123_length_1092_cov_11.193353	335	415	1	6	80	0.0750000
NODE_5123_length_1092_cov_11.193353	335	415	2	74	80	0.9250000
NODE_5123_length_1092_cov_11.193353	388	468	0	37	80	0.4625000
NODE_5123_length_1092_cov_11.193353	388	468	1	22	80	0.2750000
NODE_5123_length_1092_cov_11.193353	388	468	2	21	80	0.2625000
NODE_5124_length_1092_cov_9.348439	489	569	0	25	80	0.3125000
NODE_5124_length_1092_cov_9.348439	489	569	1	17	80	0.2125000
NODE_5124_length_1092_cov_9.348439	489	569	2	38	80	0.4750000
NODE_5124_length_1092_cov_9.348439	542	622	2	80	80	1.0000000
NODE_5125_length_1092_cov_7.533736	243	323	0	80	80	1.0000000
NODE_5125_length_1092_cov_7.533736	296	376	0	80	80	1.0000000
NODE_5126_length_1092_cov_6.968781	470	550	0	80	80	1.0000000
NODE_5126_length_1092_cov_6.968781	523	603	0	80	80	1.0000000
NODE_5134_length_1091_cov_54.234879	417	497	3	62	80	0.7750000
NODE_5134_length_1091_cov_54.234879	417	497	4	18	80	0.2250000
NODE_5134_length_1091_cov_54.234879	470	550	2	29	80	0.3625000
NODE_5134_length_1091_cov_54.234879	470	550	3	22	80	0.2750000
NODE_5134_length_1091_cov_54.234879	470	550	4	29	80	0.3625000
NODE_5134_length_1091_cov_54.234879	546	626	2	35	80	0.4375000
NODE_5134_length_1091_cov_54.234879	546	626	4	8	80	0.1000000
NODE_5134_length_1091_cov_54.234879	546	626	5	37	80	0.4625000
NODE_5134_length_1091_cov_54.234879	599	679	3	10	80	0.1250000
NODE_5134_length_1091_cov_54.234879	599	679	4	40	80	0.5000000
NODE_5134_length_1091_cov_54.234879	599	679	5	30	80	0.3750000
NODE_5135_length_1091_cov_35.045363	384	464	2	32	80	0.4000000
NODE_5135_length_1091_cov_35.045363	384	464	3	47	80	0.5875000
NODE_5135_length_1091_cov_35.045363	384	464	4	1	80	0.0125000
NODE_5135_length_1091_cov_35.045363	437	517	2	26	80	0.3250000
NODE_5135_length_1091_cov_35.045363	437	517	4	8	80	0.1000000
NODE_5135_length_1091_cov_35.045363	437	517	5	3	80	0.0375000
NODE_5135_length_1091_cov_35.045363	437	517	6	19	80	0.2375000
NODE_5135_length_1091_cov_35.045363	437	517	8	6	80	0.0750000
NODE_5135_length_1091_cov_35.045363	437	517	10	18	80	0.2250000
NODE_5135_length_1091_cov_35.045363	513	593	9	20	80	0.2500000
NODE_5135_length_1091_cov_35.045363	513	593	10	58	80	0.7250000
NODE_5135_length_1091_cov_35.045363	513	593	11	2	80	0.0250000
NODE_5135_length_1091_cov_35.045363	566	646	2	3	80	0.0375000
NODE_5135_length_1091_cov_35.045363	566	646	4	19	80	0.2375000
NODE_5135_length_1091_cov_35.045363	566	646	5	3	80	0.0375000
NODE_5135_length_1091_cov_35.045363	566	646	6	3	80	0.0375000
NODE_5135_length_1091_cov_35.045363	566	646	8	23	80	0.2875000
NODE_5135_length_1091_cov_35.045363	566	646	10	29	80	0.3625000
NODE_5136_length_1091_cov_28.490927	329	409	0	80	80	1.0000000
NODE_5136_length_1091_cov_28.490927	382	462	0	80	80	1.0000000
NODE_5136_length_1091_cov_28.490927	618	698	0	11	80	0.1375000
NODE_5136_length_1091_cov_28.490927	618	698	2	69	80	0.8625000
NODE_5136_length_1091_cov_28.490927	671	751	2	80	80	1.0000000
NODE_5137_length_1091_cov_23.733871	514	594	0	4	80	0.0500000
NODE_5137_length_1091_cov_23.733871	514	594	2	76	80	0.9500000
NODE_5137_length_1091_cov_23.733871	567	647	0	26	80	0.3250000
NODE_5137_length_1091_cov_23.733871	567	647	2	54	80	0.6750000
NODE_5138_length_1091_cov_13.065524	444	524	3	79	80	0.9875000
NODE_5138_length_1091_cov_13.065524	444	524	4	1	80	0.0125000
NODE_5138_length_1091_cov_13.065524	497	577	1	9	80	0.1125000
NODE_5138_length_1091_cov_13.065524	497	577	2	16	80	0.2000000
NODE_5138_length_1091_cov_13.065524	497	577	3	55	80	0.6875000
NODE_5139_length_1091_cov_10.961694	582	646	2	64	64	1.0000000
NODE_5140_length_1091_cov_8.166331	299	379	3	17	80	0.2125000
NODE_5140_length_1091_cov_8.166331	299	379	4	20	80	0.2500000
NODE_5140_length_1091_cov_8.166331	299	379	5	16	80	0.2000000
NODE_5140_length_1091_cov_8.166331	299	379	7	5	80	0.0625000
NODE_5140_length_1091_cov_8.166331	299	379	8	22	80	0.2750000
NODE_5140_length_1091_cov_8.166331	352	432	7	5	80	0.0625000
NODE_5140_length_1091_cov_8.166331	352	432	8	54	80	0.6750000
NODE_5140_length_1091_cov_8.166331	352	432	9	21	80	0.2625000
NODE_5141_length_1091_cov_7.006048	617	697	2	80	80	1.0000000
NODE_5141_length_1091_cov_7.006048	670	750	0	17	80	0.2125000
NODE_5141_length_1091_cov_7.006048	670	750	2	63	80	0.7875000
NODE_5151_length_1090_cov_73.781029	352	432	1	5	80	0.0625000
NODE_5151_length_1090_cov_73.781029	352	432	2	26	80	0.3250000
NODE_5151_length_1090_cov_73.781029	352	432	3	32	80	0.4000000
NODE_5151_length_1090_cov_73.781029	352	432	4	17	80	0.2125000
NODE_5151_length_1090_cov_73.781029	405	485	2	10	80	0.1250000
NODE_5151_length_1090_cov_73.781029	405	485	4	17	80	0.2125000
NODE_5151_length_1090_cov_73.781029	405	485	5	28	80	0.3500000
NODE_5151_length_1090_cov_73.781029	405	485	6	25	80	0.3125000
NODE_5151_length_1090_cov_73.781029	481	567	2	49	86	0.5697674
NODE_5151_length_1090_cov_73.781029	481	567	4	27	86	0.3139535
NODE_5151_length_1090_cov_73.781029	481	567	6	10	86	0.1162791
NODE_5151_length_1090_cov_73.781029	540	620	2	10	80	0.1250000
NODE_5151_length_1090_cov_73.781029	540	620	4	22	80	0.2750000
NODE_5151_length_1090_cov_73.781029	540	620	5	4	80	0.0500000
NODE_5151_length_1090_cov_73.781029	540	620	6	30	80	0.3750000
NODE_5151_length_1090_cov_73.781029	540	620	7	14	80	0.1750000
NODE_5152_length_1090_cov_42.394551	530	610	1	12	80	0.1500000
NODE_5152_length_1090_cov_42.394551	530	610	2	68	80	0.8500000
NODE_5152_length_1090_cov_42.394551	583	663	2	80	80	1.0000000
NODE_5153_length_1090_cov_37.643794	436	516	3	6	80	0.0750000
NODE_5153_length_1090_cov_37.643794	436	516	4	33	80	0.4125000
NODE_5153_length_1090_cov_37.643794	436	516	5	19	80	0.2375000
NODE_5153_length_1090_cov_37.643794	436	516	6	4	80	0.0500000
NODE_5153_length_1090_cov_37.643794	436	516	7	3	80	0.0375000
NODE_5153_length_1090_cov_37.643794	436	516	8	15	80	0.1875000
NODE_5153_length_1090_cov_37.643794	489	569	5	26	80	0.3250000
NODE_5153_length_1090_cov_37.643794	489	569	6	4	80	0.0500000
NODE_5153_length_1090_cov_37.643794	489	569	7	17	80	0.2125000
NODE_5153_length_1090_cov_37.643794	489	569	8	33	80	0.4125000
NODE_5153_length_1090_cov_37.643794	565	645	3	3	80	0.0375000
NODE_5153_length_1090_cov_37.643794	565	645	4	22	80	0.2750000
NODE_5153_length_1090_cov_37.643794	565	645	5	10	80	0.1250000
NODE_5153_length_1090_cov_37.643794	565	645	6	31	80	0.3875000
NODE_5153_length_1090_cov_37.643794	565	645	8	14	80	0.1750000
NODE_5153_length_1090_cov_37.643794	618	698	1	53	80	0.6625000
NODE_5153_length_1090_cov_37.643794	618	698	3	3	80	0.0375000
NODE_5153_length_1090_cov_37.643794	618	698	4	22	80	0.2750000
NODE_5153_length_1090_cov_37.643794	618	698	5	2	80	0.0250000
NODE_5154_length_1090_cov_32.876892	487	567	5	3	80	0.0375000
NODE_5154_length_1090_cov_32.876892	487	567	6	1	80	0.0125000
NODE_5154_length_1090_cov_32.876892	487	567	7	1	80	0.0125000
NODE_5154_length_1090_cov_32.876892	487	567	8	75	80	0.9375000
NODE_5154_length_1090_cov_32.876892	540	620	1	4	80	0.0500000
NODE_5154_length_1090_cov_32.876892	540	620	2	3	80	0.0375000
NODE_5154_length_1090_cov_32.876892	540	620	3	5	80	0.0625000
NODE_5154_length_1090_cov_32.876892	540	620	4	22	80	0.2750000
NODE_5154_length_1090_cov_32.876892	540	620	5	2	80	0.0250000
NODE_5154_length_1090_cov_32.876892	540	620	6	7	80	0.0875000
NODE_5154_length_1090_cov_32.876892	540	620	8	37	80	0.4625000
NODE_5155_length_1090_cov_25.373360	486	566	3	38	80	0.4750000
NODE_5155_length_1090_cov_25.373360	486	566	4	42	80	0.5250000
NODE_5155_length_1090_cov_25.373360	539	619	2	50	80	0.6250000
NODE_5155_length_1090_cov_25.373360	539	619	4	30	80	0.3750000
NODE_5156_length_1090_cov_21.290616	422	502	1	34	80	0.4250000
NODE_5156_length_1090_cov_21.290616	422	502	2	7	80	0.0875000
NODE_5156_length_1090_cov_21.290616	422	502	3	38	80	0.4750000
NODE_5156_length_1090_cov_21.290616	422	502	4	1	80	0.0125000
NODE_5156_length_1090_cov_21.290616	475	555	3	37	80	0.4625000
NODE_5156_length_1090_cov_21.290616	475	555	4	43	80	0.5375000
NODE_5156_length_1090_cov_21.290616	551	631	2	18	80	0.2250000
NODE_5156_length_1090_cov_21.290616	551	631	3	7	80	0.0875000
NODE_5156_length_1090_cov_21.290616	551	631	4	55	80	0.6875000
NODE_5156_length_1090_cov_21.290616	604	684	1	33	80	0.4125000
NODE_5156_length_1090_cov_21.290616	604	684	2	38	80	0.4750000
NODE_5156_length_1090_cov_21.290616	604	684	3	7	80	0.0875000
NODE_5156_length_1090_cov_21.290616	604	684	4	2	80	0.0250000
NODE_5157_length_1090_cov_16.040363	666	746	2	24	80	0.3000000
NODE_5157_length_1090_cov_16.040363	666	746	3	5	80	0.0625000
NODE_5157_length_1090_cov_16.040363	666	746	4	47	80	0.5875000
NODE_5157_length_1090_cov_16.040363	666	746	5	4	80	0.0500000
NODE_5157_length_1090_cov_16.040363	719	799	3	58	80	0.7250000
NODE_5157_length_1090_cov_16.040363	719	799	4	18	80	0.2250000
NODE_5157_length_1090_cov_16.040363	719	799	5	4	80	0.0500000
NODE_5158_length_1090_cov_14.826438	393	473	3	26	80	0.3250000
NODE_5158_length_1090_cov_14.826438	393	473	4	37	80	0.4625000
NODE_5158_length_1090_cov_14.826438	393	473	5	17	80	0.2125000
NODE_5158_length_1090_cov_14.826438	446	526	2	7	80	0.0875000
NODE_5158_length_1090_cov_14.826438	446	526	3	30	80	0.3750000
NODE_5158_length_1090_cov_14.826438	446	526	4	26	80	0.3250000
NODE_5158_length_1090_cov_14.826438	446	526	5	17	80	0.2125000
NODE_5159_length_1090_cov_13.721493	498	578	3	4	80	0.0500000
NODE_5159_length_1090_cov_13.721493	498	578	4	76	80	0.9500000
NODE_5159_length_1090_cov_13.721493	551	631	2	22	80	0.2750000
NODE_5159_length_1090_cov_13.721493	551	631	3	28	80	0.3500000
NODE_5159_length_1090_cov_13.721493	551	631	4	30	80	0.3750000
NODE_5160_length_1090_cov_12.365288	386	467	4	3	81	0.0370370
NODE_5160_length_1090_cov_12.365288	386	467	6	12	81	0.1481481
NODE_5160_length_1090_cov_12.365288	386	467	7	32	81	0.3950617
NODE_5160_length_1090_cov_12.365288	386	467	8	34	81	0.4197531
NODE_5160_length_1090_cov_12.365288	440	520	3	1	80	0.0125000
NODE_5160_length_1090_cov_12.365288	440	520	4	46	80	0.5750000
NODE_5160_length_1090_cov_12.365288	440	520	5	9	80	0.1125000
NODE_5160_length_1090_cov_12.365288	440	520	6	10	80	0.1250000
NODE_5160_length_1090_cov_12.365288	440	520	7	1	80	0.0125000
NODE_5160_length_1090_cov_12.365288	440	520	8	13	80	0.1625000
NODE_5160_length_1090_cov_12.365288	516	596	3	21	80	0.2625000
NODE_5160_length_1090_cov_12.365288	516	596	4	58	80	0.7250000
NODE_5160_length_1090_cov_12.365288	516	596	5	1	80	0.0125000
NODE_5160_length_1090_cov_12.365288	569	649	4	37	80	0.4625000
NODE_5160_length_1090_cov_12.365288	569	649	5	43	80	0.5375000
NODE_5161_length_1090_cov_5.348133	0	80	0	8	80	0.1000000
NODE_5161_length_1090_cov_5.348133	0	80	2	1	80	0.0125000
NODE_5161_length_1090_cov_5.348133	0	80	4	36	80	0.4500000
NODE_5161_length_1090_cov_5.348133	0	80	6	19	80	0.2375000
NODE_5161_length_1090_cov_5.348133	0	80	7	4	80	0.0500000
NODE_5161_length_1090_cov_5.348133	0	80	8	10	80	0.1250000
NODE_5161_length_1090_cov_5.348133	0	80	9	2	80	0.0250000
NODE_5161_length_1090_cov_5.348133	53	99	6	11	46	0.2391304
NODE_5161_length_1090_cov_5.348133	53	99	7	4	46	0.0869565
NODE_5161_length_1090_cov_5.348133	53	99	8	10	46	0.2173913
NODE_5161_length_1090_cov_5.348133	53	99	9	16	46	0.3478261
NODE_5161_length_1090_cov_5.348133	53	99	11	5	46	0.1086956
NODE_5163_length_1090_cov_3.598385	300	340	29	2	40	0.0500000
NODE_5163_length_1090_cov_3.598385	300	340	30	2	40	0.0500000
NODE_5163_length_1090_cov_3.598385	300	340	32	1	40	0.0250000
NODE_5163_length_1090_cov_3.598385	300	340	34	11	40	0.2750000
NODE_5163_length_1090_cov_3.598385	300	340	35	4	40	0.1000000
NODE_5163_length_1090_cov_3.598385	300	340	36	14	40	0.3500000
NODE_5163_length_1090_cov_3.598385	300	340	37	6	40	0.1500000
NODE_5170_length_1089_cov_55.374747	515	594	2	2	79	0.0253165
NODE_5170_length_1089_cov_55.374747	515	594	4	53	79	0.6708861
NODE_5170_length_1089_cov_55.374747	515	594	5	24	79	0.3037975
NODE_5170_length_1089_cov_55.374747	567	647	3	22	80	0.2750000
NODE_5170_length_1089_cov_55.374747	567	647	4	3	80	0.0375000
NODE_5170_length_1089_cov_55.374747	567	647	5	55	80	0.6875000
NODE_5170_length_1089_cov_55.374747	643	723	1	15	80	0.1875000
NODE_5170_length_1089_cov_55.374747	643	723	2	26	80	0.3250000
NODE_5170_length_1089_cov_55.374747	643	723	3	39	80	0.4875000
NODE_5170_length_1089_cov_55.374747	696	776	2	57	80	0.7125000
NODE_5170_length_1089_cov_55.374747	696	776	3	23	80	0.2875000
NODE_5171_length_1089_cov_38.506061	458	538	3	9	80	0.1125000
NODE_5171_length_1089_cov_38.506061	458	538	4	16	80	0.2000000
NODE_5171_length_1089_cov_38.506061	458	538	5	38	80	0.4750000
NODE_5171_length_1089_cov_38.506061	458	538	6	17	80	0.2125000
NODE_5171_length_1089_cov_38.506061	511	591	4	18	80	0.2250000
NODE_5171_length_1089_cov_38.506061	511	591	5	60	80	0.7500000
NODE_5171_length_1089_cov_38.506061	511	591	6	2	80	0.0250000
NODE_5171_length_1089_cov_38.506061	587	667	3	2	80	0.0250000
NODE_5171_length_1089_cov_38.506061	587	667	4	26	80	0.3250000
NODE_5171_length_1089_cov_38.506061	587	667	5	44	80	0.5500000
NODE_5171_length_1089_cov_38.506061	587	667	6	8	80	0.1000000
NODE_5171_length_1089_cov_38.506061	640	720	4	32	80	0.4000000
NODE_5171_length_1089_cov_38.506061	640	720	5	47	80	0.5875000
NODE_5171_length_1089_cov_38.506061	640	720	6	1	80	0.0125000
NODE_5172_length_1089_cov_22.657576	379	459	2	7	80	0.0875000
NODE_5172_length_1089_cov_22.657576	379	459	4	8	80	0.1000000
NODE_5172_length_1089_cov_22.657576	379	459	5	65	80	0.8125000
NODE_5172_length_1089_cov_22.657576	432	512	1	14	80	0.1750000
NODE_5172_length_1089_cov_22.657576	432	512	2	42	80	0.5250000
NODE_5172_length_1089_cov_22.657576	432	512	4	7	80	0.0875000
NODE_5172_length_1089_cov_22.657576	432	512	5	17	80	0.2125000
NODE_5173_length_1089_cov_21.180808	547	627	2	29	80	0.3625000
NODE_5173_length_1089_cov_21.180808	547	627	4	48	80	0.6000000
NODE_5173_length_1089_cov_21.180808	547	627	6	3	80	0.0375000
NODE_5173_length_1089_cov_21.180808	600	680	3	9	80	0.1125000
NODE_5173_length_1089_cov_21.180808	600	680	4	32	80	0.4000000
NODE_5173_length_1089_cov_21.180808	600	680	6	39	80	0.4875000
NODE_5174_length_1089_cov_18.713131	431	511	1	80	80	1.0000000
NODE_5174_length_1089_cov_18.713131	484	564	1	47	80	0.5875000
NODE_5174_length_1089_cov_18.713131	484	564	2	33	80	0.4125000
NODE_5174_length_1089_cov_18.713131	560	640	1	80	80	1.0000000
NODE_5174_length_1089_cov_18.713131	613	693	0	22	80	0.2750000
NODE_5174_length_1089_cov_18.713131	613	693	1	58	80	0.7250000
NODE_5175_length_1089_cov_17.382828	376	456	0	80	80	1.0000000
NODE_5175_length_1089_cov_17.382828	429	509	0	39	80	0.4875000
NODE_5175_length_1089_cov_17.382828	429	509	2	41	80	0.5125000
NODE_5175_length_1089_cov_17.382828	505	585	2	80	80	1.0000000
NODE_5175_length_1089_cov_17.382828	558	638	0	1	80	0.0125000
NODE_5175_length_1089_cov_17.382828	558	638	1	36	80	0.4500000
NODE_5175_length_1089_cov_17.382828	558	638	2	43	80	0.5375000
NODE_5176_length_1089_cov_14.540404	610	690	1	30	80	0.3750000
NODE_5176_length_1089_cov_14.540404	610	690	2	50	80	0.6250000
NODE_5176_length_1089_cov_14.540404	663	743	2	31	80	0.3875000
NODE_5176_length_1089_cov_14.540404	663	743	3	11	80	0.1375000
NODE_5176_length_1089_cov_14.540404	663	743	4	38	80	0.4750000
NODE_5182_length_1088_cov_10.603640	504	584	2	80	80	1.0000000
NODE_5182_length_1088_cov_10.603640	557	632	2	75	75	1.0000000
NODE_5194_length_1088_cov_0.759353	0	59	1	9	59	0.1525424
NODE_5194_length_1088_cov_0.759353	0	59	2	5	59	0.0847458
NODE_5194_length_1088_cov_0.759353	0	59	4	8	59	0.1355932
NODE_5194_length_1088_cov_0.759353	0	59	5	10	59	0.1694915
NODE_5194_length_1088_cov_0.759353	0	59	6	27	59	0.4576271
NODE_5194_length_1088_cov_0.759353	32	97	6	65	65	1.0000000
NODE_5195_length_1087_cov_51.676113	457	537	2	4	80	0.0500000
NODE_5195_length_1087_cov_51.676113	457	537	3	17	80	0.2125000
NODE_5195_length_1087_cov_51.676113	457	537	4	42	80	0.5250000
NODE_5195_length_1087_cov_51.676113	457	537	5	17	80	0.2125000
NODE_5195_length_1087_cov_51.676113	510	590	1	49	80	0.6125000
NODE_5195_length_1087_cov_51.676113	510	590	2	8	80	0.1000000
NODE_5195_length_1087_cov_51.676113	510	590	3	17	80	0.2125000
NODE_5195_length_1087_cov_51.676113	510	590	4	6	80	0.0750000
NODE_5195_length_1087_cov_51.676113	586	666	0	55	80	0.6875000
NODE_5195_length_1087_cov_51.676113	586	666	1	25	80	0.3125000
NODE_5195_length_1087_cov_51.676113	639	719	0	80	80	1.0000000
NODE_5196_length_1087_cov_47.144737	214	276	89	1	62	0.0161290
NODE_5196_length_1087_cov_47.144737	214	276	91	1	62	0.0161290
NODE_5196_length_1087_cov_47.144737	214	276	92	1	62	0.0161290
NODE_5196_length_1087_cov_47.144737	214	276	94	1	62	0.0161290
NODE_5196_length_1087_cov_47.144737	214	276	99	1	62	0.0161290
NODE_5196_length_1087_cov_47.144737	214	276	101	1	62	0.0161290
NODE_5196_length_1087_cov_47.144737	214	276	104	1	62	0.0161290
NODE_5196_length_1087_cov_47.144737	214	276	107	1	62	0.0161290
NODE_5196_length_1087_cov_47.144737	214	276	109	1	62	0.0161290
NODE_5196_length_1087_cov_47.144737	214	276	113	1	62	0.0161290
NODE_5196_length_1087_cov_47.144737	214	276	117	2	62	0.0322581
NODE_5196_length_1087_cov_47.144737	214	276	122	1	62	0.0161290
NODE_5196_length_1087_cov_47.144737	214	276	125	1	62	0.0161290
NODE_5196_length_1087_cov_47.144737	214	276	126	1	62	0.0161290
NODE_5196_length_1087_cov_47.144737	214	276	130	4	62	0.0645161
NODE_5196_length_1087_cov_47.144737	214	276	133	1	62	0.0161290
NODE_5196_length_1087_cov_47.144737	214	276	138	1	62	0.0161290
NODE_5196_length_1087_cov_47.144737	214	276	143	1	62	0.0161290
NODE_5196_length_1087_cov_47.144737	214	276	146	1	62	0.0161290
NODE_5196_length_1087_cov_47.144737	214	276	153	1	62	0.0161290
NODE_5196_length_1087_cov_47.144737	214	276	155	1	62	0.0161290
NODE_5196_length_1087_cov_47.144737	214	276	158	1	62	0.0161290
NODE_5196_length_1087_cov_47.144737	214	276	165	2	62	0.0322581
NODE_5196_length_1087_cov_47.144737	214	276	169	3	62	0.0483871
NODE_5196_length_1087_cov_47.144737	214	276	171	1	62	0.0161290
NODE_5196_length_1087_cov_47.144737	214	276	174	1	62	0.0161290
NODE_5196_length_1087_cov_47.144737	214	276	175	1	62	0.0161290
NODE_5196_length_1087_cov_47.144737	214	276	182	1	62	0.0161290
NODE_5196_length_1087_cov_47.144737	214	276	187	1	62	0.0161290
NODE_5196_length_1087_cov_47.144737	214	276	194	1	62	0.0161290
NODE_5196_length_1087_cov_47.144737	214	276	202	1	62	0.0161290
NODE_5196_length_1087_cov_47.144737	214	276	206	1	62	0.0161290
NODE_5196_length_1087_cov_47.144737	214	276	209	1	62	0.0161290
NODE_5196_length_1087_cov_47.144737	214	276	211	1	62	0.0161290
NODE_5196_length_1087_cov_47.144737	214	276	214	1	62	0.0161290
NODE_5196_length_1087_cov_47.144737	214	276	216	2	62	0.0322581
NODE_5196_length_1087_cov_47.144737	214	276	218	1	62	0.0161290
NODE_5196_length_1087_cov_47.144737	214	276	223	1	62	0.0161290
NODE_5196_length_1087_cov_47.144737	214	276	225	1	62	0.0161290
NODE_5196_length_1087_cov_47.144737	214	276	232	1	62	0.0161290
NODE_5196_length_1087_cov_47.144737	214	276	233	1	62	0.0161290
NODE_5196_length_1087_cov_47.144737	214	276	238	1	62	0.0161290
NODE_5196_length_1087_cov_47.144737	214	276	240	1	62	0.0161290
NODE_5196_length_1087_cov_47.144737	214	276	241	1	62	0.0161290
NODE_5196_length_1087_cov_47.144737	214	276	243	1	62	0.0161290
NODE_5196_length_1087_cov_47.144737	214	276	245	1	62	0.0161290
NODE_5196_length_1087_cov_47.144737	214	276	248	1	62	0.0161290
NODE_5196_length_1087_cov_47.144737	214	276	250	2	62	0.0322581
NODE_5196_length_1087_cov_47.144737	214	276	254	1	62	0.0161290
NODE_5196_length_1087_cov_47.144737	214	276	256	1	62	0.0161290
NODE_5196_length_1087_cov_47.144737	214	276	258	1	62	0.0161290
NODE_5196_length_1087_cov_47.144737	214	276	263	1	62	0.0161290
NODE_5196_length_1087_cov_47.144737	214	276	269	1	62	0.0161290
NODE_5196_length_1087_cov_47.144737	630	710	1	47	80	0.5875000
NODE_5196_length_1087_cov_47.144737	630	710	2	33	80	0.4125000
NODE_5196_length_1087_cov_47.144737	683	763	1	9	80	0.1125000
NODE_5196_length_1087_cov_47.144737	683	763	2	71	80	0.8875000
NODE_5197_length_1087_cov_46.633603	871	951	14	2	80	0.0250000
NODE_5197_length_1087_cov_46.633603	871	951	16	1	80	0.0125000
NODE_5197_length_1087_cov_46.633603	871	951	17	6	80	0.0750000
NODE_5197_length_1087_cov_46.633603	871	951	18	14	80	0.1750000
NODE_5197_length_1087_cov_46.633603	871	951	19	6	80	0.0750000
NODE_5197_length_1087_cov_46.633603	871	951	23	51	80	0.6375000
NODE_5197_length_1087_cov_46.633603	924	999	1	4	75	0.0533333
NODE_5197_length_1087_cov_46.633603	924	999	2	10	75	0.1333333
NODE_5197_length_1087_cov_46.633603	924	999	5	3	75	0.0400000
NODE_5197_length_1087_cov_46.633603	924	999	6	12	75	0.1600000
NODE_5197_length_1087_cov_46.633603	924	999	7	2	75	0.0266667
NODE_5197_length_1087_cov_46.633603	924	999	8	1	75	0.0133333
NODE_5197_length_1087_cov_46.633603	924	999	11	5	75	0.0666667
NODE_5197_length_1087_cov_46.633603	924	999	12	1	75	0.0133333
NODE_5197_length_1087_cov_46.633603	924	999	14	12	75	0.1600000
NODE_5197_length_1087_cov_46.633603	924	999	16	1	75	0.0133333
NODE_5197_length_1087_cov_46.633603	924	999	17	6	75	0.0800000
NODE_5197_length_1087_cov_46.633603	924	999	18	14	75	0.1866667
NODE_5197_length_1087_cov_46.633603	924	999	19	4	75	0.0533333
NODE_5198_length_1087_cov_30.577935	528	608	10	35	80	0.4375000
NODE_5198_length_1087_cov_30.577935	528	608	11	17	80	0.2125000
NODE_5198_length_1087_cov_30.577935	528	608	12	1	80	0.0125000
NODE_5198_length_1087_cov_30.577935	528	608	13	27	80	0.3375000
NODE_5198_length_1087_cov_30.577935	581	661	5	1	80	0.0125000
NODE_5198_length_1087_cov_30.577935	581	661	6	2	80	0.0250000
NODE_5198_length_1087_cov_30.577935	581	661	7	1	80	0.0125000
NODE_5198_length_1087_cov_30.577935	581	661	8	6	80	0.0750000
NODE_5198_length_1087_cov_30.577935	581	661	9	17	80	0.2125000
NODE_5198_length_1087_cov_30.577935	581	661	10	16	80	0.2000000
NODE_5198_length_1087_cov_30.577935	581	661	11	4	80	0.0500000
NODE_5198_length_1087_cov_30.577935	581	661	12	4	80	0.0500000
NODE_5198_length_1087_cov_30.577935	581	661	13	29	80	0.3625000
NODE_5199_length_1087_cov_30.205466	515	591	1	17	76	0.2236842
NODE_5199_length_1087_cov_30.205466	515	591	2	49	76	0.6447368
NODE_5199_length_1087_cov_30.205466	515	591	3	10	76	0.1315790
NODE_5199_length_1087_cov_30.205466	564	644	1	17	80	0.2125000
NODE_5199_length_1087_cov_30.205466	564	644	2	33	80	0.4125000
NODE_5199_length_1087_cov_30.205466	564	644	3	30	80	0.3750000
NODE_5200_length_1087_cov_29.595142	568	648	5	2	80	0.0250000
NODE_5200_length_1087_cov_29.595142	568	648	6	25	80	0.3125000
NODE_5200_length_1087_cov_29.595142	568	648	7	53	80	0.6625000
NODE_5200_length_1087_cov_29.595142	621	701	3	45	80	0.5625000
NODE_5200_length_1087_cov_29.595142	621	701	5	10	80	0.1250000
NODE_5200_length_1087_cov_29.595142	621	701	7	25	80	0.3125000
NODE_5201_length_1087_cov_11.600202	374	454	1	51	80	0.6375000
NODE_5201_length_1087_cov_11.600202	374	454	2	19	80	0.2375000
NODE_5201_length_1087_cov_11.600202	374	454	3	4	80	0.0500000
NODE_5201_length_1087_cov_11.600202	374	454	4	6	80	0.0750000
NODE_5201_length_1087_cov_11.600202	427	507	1	17	80	0.2125000
NODE_5201_length_1087_cov_11.600202	427	507	3	33	80	0.4125000
NODE_5201_length_1087_cov_11.600202	427	507	4	30	80	0.3750000
NODE_5202_length_1087_cov_7.746964	436	516	0	80	80	1.0000000
NODE_5202_length_1087_cov_7.746964	489	569	0	80	80	1.0000000
NODE_5211_length_1086_cov_35.748734	406	486	0	80	80	1.0000000
NODE_5211_length_1086_cov_35.748734	459	539	0	80	80	1.0000000
NODE_5212_length_1086_cov_18.445795	325	405	0	14	80	0.1750000
NODE_5212_length_1086_cov_18.445795	325	405	1	8	80	0.1000000
NODE_5212_length_1086_cov_18.445795	325	405	3	3	80	0.0375000
NODE_5212_length_1086_cov_18.445795	325	405	4	11	80	0.1375000
NODE_5212_length_1086_cov_18.445795	325	405	5	22	80	0.2750000
NODE_5212_length_1086_cov_18.445795	325	405	6	1	80	0.0125000
NODE_5212_length_1086_cov_18.445795	325	405	7	21	80	0.2625000
NODE_5212_length_1086_cov_18.445795	378	458	5	5	80	0.0625000
NODE_5212_length_1086_cov_18.445795	378	458	6	1	80	0.0125000
NODE_5212_length_1086_cov_18.445795	378	458	7	61	80	0.7625000
NODE_5212_length_1086_cov_18.445795	378	458	8	13	80	0.1625000
NODE_5213_length_1086_cov_16.878419	528	608	0	80	80	1.0000000
NODE_5213_length_1086_cov_16.878419	581	661	0	80	80	1.0000000
NODE_5214_length_1086_cov_10.700101	498	578	0	80	80	1.0000000
NODE_5214_length_1086_cov_10.700101	551	631	0	80	80	1.0000000
NODE_5215_length_1086_cov_10.656535	277	357	5	22	80	0.2750000
NODE_5215_length_1086_cov_10.656535	277	357	6	2	80	0.0250000
NODE_5215_length_1086_cov_10.656535	277	357	7	2	80	0.0250000
NODE_5215_length_1086_cov_10.656535	277	357	8	3	80	0.0375000
NODE_5215_length_1086_cov_10.656535	277	357	9	6	80	0.0750000
NODE_5215_length_1086_cov_10.656535	277	357	10	13	80	0.1625000
NODE_5215_length_1086_cov_10.656535	277	357	11	32	80	0.4000000
NODE_5215_length_1086_cov_10.656535	330	410	2	3	80	0.0375000
NODE_5215_length_1086_cov_10.656535	330	410	3	1	80	0.0125000
NODE_5215_length_1086_cov_10.656535	330	410	4	7	80	0.0875000
NODE_5215_length_1086_cov_10.656535	330	410	5	64	80	0.8000000
NODE_5215_length_1086_cov_10.656535	330	410	6	2	80	0.0250000
NODE_5215_length_1086_cov_10.656535	330	410	7	2	80	0.0250000
NODE_5215_length_1086_cov_10.656535	330	410	9	1	80	0.0125000
NODE_5216_length_1086_cov_6.873354	374	454	0	80	80	1.0000000
NODE_5216_length_1086_cov_6.873354	427	507	0	80	80	1.0000000
NODE_5217_length_1086_cov_5.225937	869	949	1	57	80	0.7125000
NODE_5217_length_1086_cov_5.225937	869	949	2	23	80	0.2875000
NODE_5217_length_1086_cov_5.225937	922	1002	1	4	80	0.0500000
NODE_5217_length_1086_cov_5.225937	922	1002	2	76	80	0.9500000
NODE_5229_length_1085_cov_30.599391	515	595	4	14	80	0.1750000
NODE_5229_length_1085_cov_30.599391	515	595	6	16	80	0.2000000
NODE_5229_length_1085_cov_30.599391	515	595	7	3	80	0.0375000
NODE_5229_length_1085_cov_30.599391	515	595	8	47	80	0.5875000
NODE_5229_length_1085_cov_30.599391	568	648	5	12	80	0.1500000
NODE_5229_length_1085_cov_30.599391	568	648	6	45	80	0.5625000
NODE_5229_length_1085_cov_30.599391	568	648	7	3	80	0.0375000
NODE_5229_length_1085_cov_30.599391	568	648	8	20	80	0.2500000
NODE_5231_length_1085_cov_13.723124	558	638	2	29	80	0.3625000
NODE_5231_length_1085_cov_13.723124	558	638	6	51	80	0.6375000
NODE_5231_length_1085_cov_13.723124	611	691	5	30	80	0.3750000
NODE_5231_length_1085_cov_13.723124	611	691	6	50	80	0.6250000
NODE_5232_length_1085_cov_12.481744	576	656	1	79	80	0.9875000
NODE_5232_length_1085_cov_12.481744	576	656	2	1	80	0.0125000
NODE_5232_length_1085_cov_12.481744	629	709	1	78	80	0.9750000
NODE_5232_length_1085_cov_12.481744	629	709	2	2	80	0.0250000
NODE_5233_length_1085_cov_11.570994	553	633	1	80	80	1.0000000
NODE_5233_length_1085_cov_11.570994	606	686	1	80	80	1.0000000
NODE_5234_length_1085_cov_10.730223	273	353	0	3	80	0.0375000
NODE_5234_length_1085_cov_10.730223	273	353	1	29	80	0.3625000
NODE_5234_length_1085_cov_10.730223	273	353	3	2	80	0.0250000
NODE_5234_length_1085_cov_10.730223	273	353	4	46	80	0.5750000
NODE_5234_length_1085_cov_10.730223	326	406	4	50	80	0.6250000
NODE_5234_length_1085_cov_10.730223	326	406	6	4	80	0.0500000
NODE_5234_length_1085_cov_10.730223	326	406	7	11	80	0.1375000
NODE_5234_length_1085_cov_10.730223	326	406	8	6	80	0.0750000
NODE_5234_length_1085_cov_10.730223	326	406	9	5	80	0.0625000
NODE_5234_length_1085_cov_10.730223	326	406	10	4	80	0.0500000
NODE_5234_length_1085_cov_10.730223	402	482	7	21	80	0.2625000
NODE_5234_length_1085_cov_10.730223	402	482	8	21	80	0.2625000
NODE_5234_length_1085_cov_10.730223	402	482	9	14	80	0.1750000
NODE_5234_length_1085_cov_10.730223	402	482	10	24	80	0.3000000
NODE_5234_length_1085_cov_10.730223	455	535	3	10	80	0.1250000
NODE_5234_length_1085_cov_10.730223	455	535	5	22	80	0.2750000
NODE_5234_length_1085_cov_10.730223	455	535	7	19	80	0.2375000
NODE_5234_length_1085_cov_10.730223	455	535	8	29	80	0.3625000
NODE_5234_length_1085_cov_10.730223	832	908	5	1	76	0.0131579
NODE_5234_length_1085_cov_10.730223	832	908	7	8	76	0.1052632
NODE_5234_length_1085_cov_10.730223	832	908	10	1	76	0.0131579
NODE_5234_length_1085_cov_10.730223	832	908	11	6	76	0.0789474
NODE_5234_length_1085_cov_10.730223	832	908	12	13	76	0.1710526
NODE_5234_length_1085_cov_10.730223	832	908	13	17	76	0.2236842
NODE_5234_length_1085_cov_10.730223	832	908	14	3	76	0.0394737
NODE_5234_length_1085_cov_10.730223	832	908	15	27	76	0.3552631
NODE_5236_length_1085_cov_8.309331	400	480	0	63	80	0.7875000
NODE_5236_length_1085_cov_8.309331	400	480	1	17	80	0.2125000
NODE_5236_length_1085_cov_8.309331	453	533	0	10	80	0.1250000
NODE_5236_length_1085_cov_8.309331	453	533	1	60	80	0.7500000
NODE_5236_length_1085_cov_8.309331	453	533	2	10	80	0.1250000
NODE_5248_length_1084_cov_60.255838	446	524	2	52	78	0.6666667
NODE_5248_length_1084_cov_60.255838	446	524	4	26	78	0.3333333
NODE_5248_length_1084_cov_60.255838	497	577	2	45	80	0.5625000
NODE_5248_length_1084_cov_60.255838	497	577	4	35	80	0.4375000
NODE_5249_length_1084_cov_33.332995	445	525	0	80	80	1.0000000
NODE_5249_length_1084_cov_33.332995	498	578	0	80	80	1.0000000
NODE_5250_length_1084_cov_11.004061	757	837	3	4	80	0.0500000
NODE_5250_length_1084_cov_11.004061	757	837	4	34	80	0.4250000
NODE_5250_length_1084_cov_11.004061	757	837	5	42	80	0.5250000
NODE_5250_length_1084_cov_11.004061	810	890	2	1	80	0.0125000
NODE_5250_length_1084_cov_11.004061	810	890	3	31	80	0.3875000
NODE_5250_length_1084_cov_11.004061	810	890	4	29	80	0.3625000
NODE_5250_length_1084_cov_11.004061	810	890	5	19	80	0.2375000
NODE_5258_length_1083_cov_42.182927	451	531	0	41	80	0.5125000
NODE_5258_length_1083_cov_42.182927	451	531	1	39	80	0.4875000
NODE_5258_length_1083_cov_42.182927	504	584	1	80	80	1.0000000
NODE_5258_length_1083_cov_42.182927	580	660	0	10	80	0.1250000
NODE_5258_length_1083_cov_42.182927	580	660	1	70	80	0.8750000
NODE_5258_length_1083_cov_42.182927	633	713	0	63	80	0.7875000
NODE_5258_length_1083_cov_42.182927	633	713	1	17	80	0.2125000
NODE_5259_length_1083_cov_41.163618	275	355	1	80	80	1.0000000
NODE_5259_length_1083_cov_41.163618	328	408	1	54	80	0.6750000
NODE_5259_length_1083_cov_41.163618	328	408	3	16	80	0.2000000
NODE_5259_length_1083_cov_41.163618	328	408	4	10	80	0.1250000
NODE_5259_length_1083_cov_41.163618	404	484	3	80	80	1.0000000
NODE_5259_length_1083_cov_41.163618	457	537	1	51	80	0.6375000
NODE_5259_length_1083_cov_41.163618	457	537	3	29	80	0.3625000
NODE_5260_length_1083_cov_39.798780	527	607	0	28	80	0.3500000
NODE_5260_length_1083_cov_39.798780	527	607	2	15	80	0.1875000
NODE_5260_length_1083_cov_39.798780	527	607	3	35	80	0.4375000
NODE_5260_length_1083_cov_39.798780	527	607	4	2	80	0.0250000
NODE_5260_length_1083_cov_39.798780	580	660	3	47	80	0.5875000
NODE_5260_length_1083_cov_39.798780	580	660	4	26	80	0.3250000
NODE_5260_length_1083_cov_39.798780	580	660	5	7	80	0.0875000
NODE_5261_length_1083_cov_34.261179	475	555	3	3	80	0.0375000
NODE_5261_length_1083_cov_34.261179	475	555	4	42	80	0.5250000
NODE_5261_length_1083_cov_34.261179	475	555	5	1	80	0.0125000
NODE_5261_length_1083_cov_34.261179	475	555	6	34	80	0.4250000
NODE_5261_length_1083_cov_34.261179	528	608	3	8	80	0.1000000
NODE_5261_length_1083_cov_34.261179	528	608	4	6	80	0.0750000
NODE_5261_length_1083_cov_34.261179	528	608	5	27	80	0.3375000
NODE_5261_length_1083_cov_34.261179	528	608	6	39	80	0.4875000
NODE_5262_length_1083_cov_33.573171	486	566	1	22	80	0.2750000
NODE_5262_length_1083_cov_33.573171	486	566	2	46	80	0.5750000
NODE_5262_length_1083_cov_33.573171	486	566	3	2	80	0.0250000
NODE_5262_length_1083_cov_33.573171	486	566	4	10	80	0.1250000
NODE_5262_length_1083_cov_33.573171	539	619	1	14	80	0.1750000
NODE_5262_length_1083_cov_33.573171	539	619	2	1	80	0.0125000
NODE_5262_length_1083_cov_33.573171	539	619	3	13	80	0.1625000
NODE_5262_length_1083_cov_33.573171	539	619	4	52	80	0.6500000
NODE_5262_length_1083_cov_33.573171	615	695	4	48	80	0.6000000
NODE_5262_length_1083_cov_33.573171	615	695	6	29	80	0.3625000
NODE_5262_length_1083_cov_33.573171	615	695	8	3	80	0.0375000
NODE_5262_length_1083_cov_33.573171	668	748	5	42	80	0.5250000
NODE_5262_length_1083_cov_33.573171	668	748	6	26	80	0.3250000
NODE_5262_length_1083_cov_33.573171	668	748	7	1	80	0.0125000
NODE_5262_length_1083_cov_33.573171	668	748	8	11	80	0.1375000
NODE_5263_length_1083_cov_33.091463	452	532	3	8	80	0.1000000
NODE_5263_length_1083_cov_33.091463	452	532	5	15	80	0.1875000
NODE_5263_length_1083_cov_33.091463	452	532	6	19	80	0.2375000
NODE_5263_length_1083_cov_33.091463	452	532	8	38	80	0.4750000
NODE_5263_length_1083_cov_33.091463	505	585	4	40	80	0.5000000
NODE_5263_length_1083_cov_33.091463	505	585	6	22	80	0.2750000
NODE_5263_length_1083_cov_33.091463	505	585	8	18	80	0.2250000
NODE_5264_length_1083_cov_30.982724	550	630	1	1	80	0.0125000
NODE_5264_length_1083_cov_30.982724	550	630	2	39	80	0.4875000
NODE_5264_length_1083_cov_30.982724	550	630	3	40	80	0.5000000
NODE_5264_length_1083_cov_30.982724	603	683	3	31	80	0.3875000
NODE_5264_length_1083_cov_30.982724	603	683	4	16	80	0.2000000
NODE_5264_length_1083_cov_30.982724	603	683	5	33	80	0.4125000
NODE_5265_length_1083_cov_18.819106	586	666	2	80	80	1.0000000
NODE_5265_length_1083_cov_18.819106	639	719	0	28	80	0.3500000
NODE_5265_length_1083_cov_18.819106	639	719	2	52	80	0.6500000
NODE_5266_length_1083_cov_17.278455	408	488	6	2	80	0.0250000
NODE_5266_length_1083_cov_17.278455	408	488	7	54	80	0.6750000
NODE_5266_length_1083_cov_17.278455	408	488	8	24	80	0.3000000
NODE_5266_length_1083_cov_17.278455	461	541	3	11	80	0.1375000
NODE_5266_length_1083_cov_17.278455	461	541	4	10	80	0.1250000
NODE_5266_length_1083_cov_17.278455	461	541	5	16	80	0.2000000
NODE_5266_length_1083_cov_17.278455	461	541	6	16	80	0.2000000
NODE_5266_length_1083_cov_17.278455	461	541	7	27	80	0.3375000
NODE_5267_length_1083_cov_13.862805	481	561	0	80	80	1.0000000
NODE_5267_length_1083_cov_13.862805	534	614	0	80	80	1.0000000
NODE_5268_length_1083_cov_13.083333	522	602	1	5	80	0.0625000
NODE_5268_length_1083_cov_13.083333	522	602	3	42	80	0.5250000
NODE_5268_length_1083_cov_13.083333	522	602	4	33	80	0.4125000
NODE_5268_length_1083_cov_13.083333	575	655	4	76	80	0.9500000
NODE_5268_length_1083_cov_13.083333	575	655	5	4	80	0.0500000
NODE_5269_length_1083_cov_11.824187	242	322	2	5	80	0.0625000
NODE_5269_length_1083_cov_11.824187	242	322	3	1	80	0.0125000
NODE_5269_length_1083_cov_11.824187	242	322	4	42	80	0.5250000
NODE_5269_length_1083_cov_11.824187	242	322	5	32	80	0.4000000
NODE_5269_length_1083_cov_11.824187	295	375	1	31	80	0.3875000
NODE_5269_length_1083_cov_11.824187	295	375	2	27	80	0.3375000
NODE_5269_length_1083_cov_11.824187	295	375	3	1	80	0.0125000
NODE_5269_length_1083_cov_11.824187	295	375	4	14	80	0.1750000
NODE_5269_length_1083_cov_11.824187	295	375	5	7	80	0.0875000
NODE_5271_length_1083_cov_3.025407	359	439	2	4	80	0.0500000
NODE_5271_length_1083_cov_3.025407	359	439	3	8	80	0.1000000
NODE_5271_length_1083_cov_3.025407	359	439	4	15	80	0.1875000
NODE_5271_length_1083_cov_3.025407	359	439	5	53	80	0.6625000
NODE_5271_length_1083_cov_3.025407	412	489	3	33	77	0.4285714
NODE_5271_length_1083_cov_3.025407	412	489	4	29	77	0.3766234
NODE_5271_length_1083_cov_3.025407	412	489	5	15	77	0.1948052
NODE_5277_length_1082_cov_34.664293	461	541	0	30	80	0.3750000
NODE_5277_length_1082_cov_34.664293	461	541	1	12	80	0.1500000
NODE_5277_length_1082_cov_34.664293	461	541	2	38	80	0.4750000
NODE_5277_length_1082_cov_34.664293	514	594	2	80	80	1.0000000
NODE_5278_length_1082_cov_17.422177	406	486	1	9	80	0.1125000
NODE_5278_length_1082_cov_17.422177	406	486	2	34	80	0.4250000
NODE_5278_length_1082_cov_17.422177	406	486	3	37	80	0.4625000
NODE_5278_length_1082_cov_17.422177	459	539	2	40	80	0.5000000
NODE_5278_length_1082_cov_17.422177	459	539	3	40	80	0.5000000
NODE_5279_length_1082_cov_15.906409	442	522	2	80	80	1.0000000
NODE_5279_length_1082_cov_15.906409	495	575	1	13	80	0.1625000
NODE_5279_length_1082_cov_15.906409	495	575	2	67	80	0.8375000
NODE_5280_length_1082_cov_13.703967	324	404	0	8	80	0.1000000
NODE_5280_length_1082_cov_13.703967	324	404	1	25	80	0.3125000
NODE_5280_length_1082_cov_13.703967	324	404	3	13	80	0.1625000
NODE_5280_length_1082_cov_13.703967	324	404	4	34	80	0.4250000
NODE_5280_length_1082_cov_13.703967	377	457	4	80	80	1.0000000
NODE_5281_length_1082_cov_6.478128	159	205	2	4	46	0.0869565
NODE_5281_length_1082_cov_6.478128	159	205	3	3	46	0.0652174
NODE_5281_length_1082_cov_6.478128	159	205	4	39	46	0.8478261
NODE_5281_length_1082_cov_6.478128	203	283	0	2	80	0.0250000
NODE_5281_length_1082_cov_6.478128	203	283	2	78	80	0.9750000
NODE_5281_length_1082_cov_6.478128	256	336	0	20	80	0.2500000
NODE_5281_length_1082_cov_6.478128	256	336	2	60	80	0.7500000
NODE_5281_length_1082_cov_6.478128	861	941	0	80	80	1.0000000
NODE_5282_length_1082_cov_4.218718	982	1062	56	2	80	0.0250000
NODE_5282_length_1082_cov_4.218718	982	1062	59	1	80	0.0125000
NODE_5282_length_1082_cov_4.218718	982	1062	63	1	80	0.0125000
NODE_5282_length_1082_cov_4.218718	982	1062	67	4	80	0.0500000
NODE_5282_length_1082_cov_4.218718	982	1062	69	1	80	0.0125000
NODE_5282_length_1082_cov_4.218718	982	1062	70	1	80	0.0125000
NODE_5282_length_1082_cov_4.218718	982	1062	71	1	80	0.0125000
NODE_5282_length_1082_cov_4.218718	982	1062	73	1	80	0.0125000
NODE_5282_length_1082_cov_4.218718	982	1062	75	1	80	0.0125000
NODE_5282_length_1082_cov_4.218718	982	1062	77	1	80	0.0125000
NODE_5282_length_1082_cov_4.218718	982	1062	78	2	80	0.0250000
NODE_5282_length_1082_cov_4.218718	982	1062	81	1	80	0.0125000
NODE_5282_length_1082_cov_4.218718	982	1062	87	1	80	0.0125000
NODE_5282_length_1082_cov_4.218718	982	1062	90	3	80	0.0375000
NODE_5282_length_1082_cov_4.218718	982	1062	91	1	80	0.0125000
NODE_5282_length_1082_cov_4.218718	982	1062	95	1	80	0.0125000
NODE_5282_length_1082_cov_4.218718	982	1062	99	1	80	0.0125000
NODE_5282_length_1082_cov_4.218718	982	1062	101	1	80	0.0125000
NODE_5282_length_1082_cov_4.218718	982	1062	107	2	80	0.0250000
NODE_5282_length_1082_cov_4.218718	982	1062	114	2	80	0.0250000
NODE_5282_length_1082_cov_4.218718	982	1062	116	1	80	0.0125000
NODE_5282_length_1082_cov_4.218718	982	1062	122	4	80	0.0500000
NODE_5282_length_1082_cov_4.218718	982	1062	124	2	80	0.0250000
NODE_5282_length_1082_cov_4.218718	982	1062	126	1	80	0.0125000
NODE_5282_length_1082_cov_4.218718	982	1062	127	2	80	0.0250000
NODE_5282_length_1082_cov_4.218718	982	1062	130	2	80	0.0250000
NODE_5282_length_1082_cov_4.218718	982	1062	132	1	80	0.0125000
NODE_5282_length_1082_cov_4.218718	982	1062	134	1	80	0.0125000
NODE_5282_length_1082_cov_4.218718	982	1062	136	1	80	0.0125000
NODE_5282_length_1082_cov_4.218718	982	1062	139	2	80	0.0250000
NODE_5282_length_1082_cov_4.218718	982	1062	145	1	80	0.0125000
NODE_5282_length_1082_cov_4.218718	982	1062	146	2	80	0.0250000
NODE_5282_length_1082_cov_4.218718	982	1062	148	1	80	0.0125000
NODE_5282_length_1082_cov_4.218718	982	1062	149	2	80	0.0250000
NODE_5282_length_1082_cov_4.218718	982	1062	153	1	80	0.0125000
NODE_5282_length_1082_cov_4.218718	982	1062	154	1	80	0.0125000
NODE_5282_length_1082_cov_4.218718	982	1062	160	2	80	0.0250000
NODE_5282_length_1082_cov_4.218718	982	1062	163	2	80	0.0250000
NODE_5282_length_1082_cov_4.218718	982	1062	166	1	80	0.0125000
NODE_5282_length_1082_cov_4.218718	982	1062	170	3	80	0.0375000
NODE_5282_length_1082_cov_4.218718	982	1062	172	1	80	0.0125000
NODE_5282_length_1082_cov_4.218718	982	1062	175	2	80	0.0250000
NODE_5282_length_1082_cov_4.218718	982	1062	177	2	80	0.0250000
NODE_5282_length_1082_cov_4.218718	982	1062	178	2	80	0.0250000
NODE_5282_length_1082_cov_4.218718	982	1062	183	2	80	0.0250000
NODE_5282_length_1082_cov_4.218718	982	1062	186	1	80	0.0125000
NODE_5282_length_1082_cov_4.218718	982	1062	187	3	80	0.0375000
NODE_5282_length_1082_cov_4.218718	982	1062	189	4	80	0.0500000
NODE_5282_length_1082_cov_4.218718	982	1062	190	1	80	0.0125000
NODE_5291_length_1081_cov_45.308554	510	590	2	20	80	0.2500000
NODE_5291_length_1081_cov_45.308554	510	590	3	60	80	0.7500000
NODE_5291_length_1081_cov_45.308554	563	643	2	16	80	0.2000000
NODE_5291_length_1081_cov_45.308554	563	643	3	64	80	0.8000000
NODE_5292_length_1081_cov_39.581466	476	556	0	80	80	1.0000000
NODE_5292_length_1081_cov_39.581466	529	609	0	80	80	1.0000000
NODE_5292_length_1081_cov_39.581466	605	685	0	80	80	1.0000000
NODE_5292_length_1081_cov_39.581466	658	738	0	80	80	1.0000000
NODE_5293_length_1081_cov_39.457230	373	453	1	9	80	0.1125000
NODE_5293_length_1081_cov_39.457230	373	453	2	71	80	0.8875000
NODE_5293_length_1081_cov_39.457230	426	506	1	54	80	0.6750000
NODE_5293_length_1081_cov_39.457230	426	506	2	26	80	0.3250000
NODE_5294_length_1081_cov_20.415479	376	451	0	75	75	1.0000000
NODE_5294_length_1081_cov_20.415479	436	511	0	75	75	1.0000000
NODE_5294_length_1081_cov_20.415479	496	571	0	75	75	1.0000000
NODE_5294_length_1081_cov_20.415479	544	624	0	80	80	1.0000000
NODE_5295_length_1081_cov_19.985743	378	458	3	9	80	0.1125000
NODE_5295_length_1081_cov_19.985743	378	458	4	10	80	0.1250000
NODE_5295_length_1081_cov_19.985743	378	458	5	13	80	0.1625000
NODE_5295_length_1081_cov_19.985743	378	458	6	48	80	0.6000000
NODE_5295_length_1081_cov_19.985743	431	511	0	3	80	0.0375000
NODE_5295_length_1081_cov_19.985743	431	511	1	5	80	0.0625000
NODE_5295_length_1081_cov_19.985743	431	511	2	18	80	0.2250000
NODE_5295_length_1081_cov_19.985743	431	511	3	36	80	0.4500000
NODE_5295_length_1081_cov_19.985743	431	511	4	10	80	0.1250000
NODE_5295_length_1081_cov_19.985743	431	511	5	8	80	0.1000000
NODE_5295_length_1081_cov_19.985743	507	587	0	79	80	0.9875000
NODE_5295_length_1081_cov_19.985743	507	587	1	1	80	0.0125000
NODE_5295_length_1081_cov_19.985743	560	640	0	80	80	1.0000000
NODE_5296_length_1081_cov_12.658859	468	548	0	10	80	0.1250000
NODE_5296_length_1081_cov_12.658859	468	548	1	34	80	0.4250000
NODE_5296_length_1081_cov_12.658859	468	548	3	4	80	0.0500000
NODE_5296_length_1081_cov_12.658859	468	548	4	24	80	0.3000000
NODE_5296_length_1081_cov_12.658859	468	548	5	8	80	0.1000000
NODE_5296_length_1081_cov_12.658859	521	601	4	19	80	0.2375000
NODE_5296_length_1081_cov_12.658859	521	601	5	61	80	0.7625000
NODE_5299_length_1081_cov_2.586558	7	44	0	37	37	1.0000000
NODE_5304_length_1080_cov_27.857288	261	341	1	22	80	0.2750000
NODE_5304_length_1080_cov_27.857288	261	341	3	58	80	0.7250000
NODE_5304_length_1080_cov_27.857288	314	394	0	9	80	0.1125000
NODE_5304_length_1080_cov_27.857288	314	394	1	18	80	0.2250000
NODE_5304_length_1080_cov_27.857288	314	394	2	12	80	0.1500000
NODE_5304_length_1080_cov_27.857288	314	394	3	41	80	0.5125000
NODE_5305_length_1080_cov_24.258919	321	401	0	43	80	0.5375000
NODE_5305_length_1080_cov_24.258919	321	401	1	37	80	0.4625000
NODE_5305_length_1080_cov_24.258919	374	454	1	71	80	0.8875000
NODE_5305_length_1080_cov_24.258919	374	454	3	8	80	0.1000000
NODE_5305_length_1080_cov_24.258919	374	454	4	1	80	0.0125000
NODE_5305_length_1080_cov_24.258919	450	530	3	19	80	0.2375000
NODE_5305_length_1080_cov_24.258919	450	530	4	61	80	0.7625000
NODE_5305_length_1080_cov_24.258919	503	583	1	1	80	0.0125000
NODE_5305_length_1080_cov_24.258919	503	583	3	68	80	0.8500000
NODE_5305_length_1080_cov_24.258919	503	583	4	11	80	0.1375000
NODE_5306_length_1080_cov_22.589195	446	526	1	72	80	0.9000000
NODE_5306_length_1080_cov_22.589195	446	526	2	8	80	0.1000000
NODE_5306_length_1080_cov_22.589195	499	579	1	21	80	0.2625000
NODE_5306_length_1080_cov_22.589195	499	579	2	59	80	0.7375000
NODE_5306_length_1080_cov_22.589195	575	655	1	78	80	0.9750000
NODE_5306_length_1080_cov_22.589195	575	655	2	2	80	0.0250000
NODE_5306_length_1080_cov_22.589195	628	708	0	40	80	0.5000000
NODE_5306_length_1080_cov_22.589195	628	708	1	40	80	0.5000000
NODE_5307_length_1080_cov_15.544343	599	679	0	28	80	0.3500000
NODE_5307_length_1080_cov_15.544343	599	679	2	11	80	0.1375000
NODE_5307_length_1080_cov_15.544343	599	679	3	28	80	0.3500000
NODE_5307_length_1080_cov_15.544343	599	679	4	13	80	0.1625000
NODE_5307_length_1080_cov_15.544343	652	732	2	13	80	0.1625000
NODE_5307_length_1080_cov_15.544343	652	732	3	14	80	0.1750000
NODE_5307_length_1080_cov_15.544343	652	732	4	53	80	0.6625000
NODE_5308_length_1080_cov_10.416922	321	401	0	80	80	1.0000000
NODE_5308_length_1080_cov_10.416922	374	454	0	80	80	1.0000000
NODE_5315_length_1079_cov_55.352041	367	447	2	80	80	1.0000000
NODE_5315_length_1079_cov_55.352041	420	500	0	30	80	0.3750000
NODE_5315_length_1079_cov_55.352041	420	500	1	14	80	0.1750000
NODE_5315_length_1079_cov_55.352041	420	500	2	36	80	0.4500000
NODE_5315_length_1079_cov_55.352041	496	576	1	76	80	0.9500000
NODE_5315_length_1079_cov_55.352041	496	576	2	4	80	0.0500000
NODE_5315_length_1079_cov_55.352041	549	629	1	68	80	0.8500000
NODE_5315_length_1079_cov_55.352041	549	629	2	12	80	0.1500000
NODE_5316_length_1079_cov_46.879592	444	524	8	19	80	0.2375000
NODE_5316_length_1079_cov_46.879592	444	524	9	3	80	0.0375000
NODE_5316_length_1079_cov_46.879592	444	524	10	21	80	0.2625000
NODE_5316_length_1079_cov_46.879592	444	524	11	14	80	0.1750000
NODE_5316_length_1079_cov_46.879592	444	524	12	20	80	0.2500000
NODE_5316_length_1079_cov_46.879592	444	524	14	3	80	0.0375000
NODE_5316_length_1079_cov_46.879592	497	577	9	11	80	0.1375000
NODE_5316_length_1079_cov_46.879592	497	577	10	16	80	0.2000000
NODE_5316_length_1079_cov_46.879592	497	577	11	12	80	0.1500000
NODE_5316_length_1079_cov_46.879592	497	577	12	21	80	0.2625000
NODE_5316_length_1079_cov_46.879592	497	577	13	3	80	0.0375000
NODE_5316_length_1079_cov_46.879592	497	577	14	6	80	0.0750000
NODE_5316_length_1079_cov_46.879592	497	577	15	11	80	0.1375000
NODE_5316_length_1079_cov_46.879592	573	652	7	2	79	0.0253165
NODE_5316_length_1079_cov_46.879592	573	652	8	13	79	0.1645570
NODE_5316_length_1079_cov_46.879592	573	652	9	24	79	0.3037975
NODE_5316_length_1079_cov_46.879592	573	652	10	39	79	0.4936709
NODE_5316_length_1079_cov_46.879592	573	652	11	1	79	0.0126582
NODE_5316_length_1079_cov_46.879592	625	703	4	17	78	0.2179487
NODE_5316_length_1079_cov_46.879592	625	703	5	15	78	0.1923077
NODE_5316_length_1079_cov_46.879592	625	703	6	17	78	0.2179487
NODE_5316_length_1079_cov_46.879592	625	703	7	4	78	0.0512821
NODE_5316_length_1079_cov_46.879592	625	703	8	13	78	0.1666667
NODE_5316_length_1079_cov_46.879592	625	703	9	12	78	0.1538462
NODE_5317_length_1079_cov_13.708163	611	691	3	3	80	0.0375000
NODE_5317_length_1079_cov_13.708163	611	691	4	77	80	0.9625000
NODE_5317_length_1079_cov_13.708163	664	744	3	17	80	0.2125000
NODE_5317_length_1079_cov_13.708163	664	744	4	63	80	0.7875000
NODE_5318_length_1079_cov_8.632653	416	496	0	80	80	1.0000000
NODE_5318_length_1079_cov_8.632653	469	549	0	80	80	1.0000000
NODE_5325_length_1078_cov_27.804903	357	437	5	30	80	0.3750000
NODE_5325_length_1078_cov_27.804903	357	437	6	10	80	0.1250000
NODE_5325_length_1078_cov_27.804903	357	437	7	3	80	0.0375000
NODE_5325_length_1078_cov_27.804903	357	437	8	31	80	0.3875000
NODE_5325_length_1078_cov_27.804903	357	437	9	6	80	0.0750000
NODE_5325_length_1078_cov_27.804903	410	490	4	3	80	0.0375000
NODE_5325_length_1078_cov_27.804903	410	490	5	14	80	0.1750000
NODE_5325_length_1078_cov_27.804903	410	490	6	24	80	0.3000000
NODE_5325_length_1078_cov_27.804903	410	490	7	15	80	0.1875000
NODE_5325_length_1078_cov_27.804903	410	490	8	24	80	0.3000000
NODE_5326_length_1078_cov_26.071502	459	539	1	80	80	1.0000000
NODE_5326_length_1078_cov_26.071502	512	592	1	72	80	0.9000000
NODE_5326_length_1078_cov_26.071502	512	592	2	5	80	0.0625000
NODE_5326_length_1078_cov_26.071502	512	592	3	3	80	0.0375000
NODE_5326_length_1078_cov_26.071502	588	668	2	30	80	0.3750000
NODE_5326_length_1078_cov_26.071502	588	668	3	50	80	0.6250000
NODE_5326_length_1078_cov_26.071502	641	718	3	77	77	1.0000000
NODE_5327_length_1078_cov_14.985700	495	575	1	31	80	0.3875000
NODE_5327_length_1078_cov_14.985700	495	575	2	49	80	0.6125000
NODE_5327_length_1078_cov_14.985700	548	628	1	77	80	0.9625000
NODE_5327_length_1078_cov_14.985700	548	628	2	3	80	0.0375000
NODE_5333_length_1077_cov_23.876278	546	626	3	80	80	1.0000000
NODE_5333_length_1077_cov_23.876278	599	679	0	16	80	0.2000000
NODE_5333_length_1077_cov_23.876278	599	679	2	12	80	0.1500000
NODE_5333_length_1077_cov_23.876278	599	679	3	52	80	0.6500000
NODE_5334_length_1077_cov_16.067485	532	612	1	23	80	0.2875000
NODE_5334_length_1077_cov_16.067485	532	612	2	57	80	0.7125000
NODE_5334_length_1077_cov_16.067485	585	665	1	21	80	0.2625000
NODE_5334_length_1077_cov_16.067485	585	665	2	59	80	0.7375000
NODE_5335_length_1077_cov_14.568507	556	636	2	2	80	0.0250000
NODE_5335_length_1077_cov_14.568507	556	636	3	19	80	0.2375000
NODE_5335_length_1077_cov_14.568507	556	636	4	59	80	0.7375000
NODE_5335_length_1077_cov_14.568507	609	689	1	46	80	0.5750000
NODE_5335_length_1077_cov_14.568507	609	689	2	9	80	0.1125000
NODE_5335_length_1077_cov_14.568507	609	689	3	19	80	0.2375000
NODE_5335_length_1077_cov_14.568507	609	689	4	6	80	0.0750000
NODE_5336_length_1077_cov_9.507157	496	576	0	80	80	1.0000000
NODE_5336_length_1077_cov_9.507157	549	629	0	80	80	1.0000000
NODE_5342_length_1077_cov_1.781186	252	274	0	22	22	1.0000000
NODE_5345_length_1076_cov_20.592631	534	614	2	24	80	0.3000000
NODE_5345_length_1076_cov_20.592631	534	614	3	16	80	0.2000000
NODE_5345_length_1076_cov_20.592631	534	614	4	34	80	0.4250000
NODE_5345_length_1076_cov_20.592631	534	614	5	6	80	0.0750000
NODE_5345_length_1076_cov_20.592631	587	667	0	24	80	0.3000000
NODE_5345_length_1076_cov_20.592631	587	667	2	53	80	0.6625000
NODE_5345_length_1076_cov_20.592631	587	667	4	3	80	0.0375000
NODE_5346_length_1076_cov_14.788127	427	507	0	80	80	1.0000000
NODE_5346_length_1076_cov_14.788127	480	560	0	80	80	1.0000000
NODE_5348_length_1076_cov_6.306039	883	961	0	78	78	1.0000000
NODE_5348_length_1076_cov_6.306039	936	1014	0	78	78	1.0000000
NODE_5357_length_1075_cov_37.941598	550	630	4	4	80	0.0500000
NODE_5357_length_1075_cov_37.941598	550	630	5	27	80	0.3375000
NODE_5357_length_1075_cov_37.941598	550	630	6	49	80	0.6125000
NODE_5357_length_1075_cov_37.941598	603	685	3	25	82	0.3048781
NODE_5357_length_1075_cov_37.941598	603	685	4	19	82	0.2317073
NODE_5357_length_1075_cov_37.941598	603	685	5	15	82	0.1829268
NODE_5357_length_1075_cov_37.941598	603	685	6	23	82	0.2804878
NODE_5357_length_1075_cov_37.941598	681	761	1	34	80	0.4250000
NODE_5357_length_1075_cov_37.941598	681	761	2	23	80	0.2875000
NODE_5357_length_1075_cov_37.941598	681	761	3	23	80	0.2875000
NODE_5357_length_1075_cov_37.941598	734	814	0	11	80	0.1375000
NODE_5357_length_1075_cov_37.941598	734	814	1	69	80	0.8625000
NODE_5358_length_1075_cov_32.224385	397	477	0	17	80	0.2125000
NODE_5358_length_1075_cov_32.224385	397	477	1	23	80	0.2875000
NODE_5358_length_1075_cov_32.224385	397	477	2	40	80	0.5000000
NODE_5358_length_1075_cov_32.224385	450	530	2	80	80	1.0000000
NODE_5359_length_1075_cov_9.626025	440	520	4	19	80	0.2375000
NODE_5359_length_1075_cov_9.626025	440	520	6	61	80	0.7625000
NODE_5359_length_1075_cov_9.626025	493	573	0	8	80	0.1000000
NODE_5359_length_1075_cov_9.626025	493	573	2	21	80	0.2625000
NODE_5359_length_1075_cov_9.626025	493	573	4	7	80	0.0875000
NODE_5359_length_1075_cov_9.626025	493	573	6	44	80	0.5500000
NODE_5362_length_1075_cov_2.926230	38	99	0	61	61	1.0000000
NODE_5372_length_1074_cov_19.034872	568	648	0	36	80	0.4500000
NODE_5372_length_1074_cov_19.034872	568	648	1	20	80	0.2500000
NODE_5372_length_1074_cov_19.034872	568	648	2	24	80	0.3000000
NODE_5372_length_1074_cov_19.034872	621	701	0	80	80	1.0000000
NODE_5372_length_1074_cov_19.034872	697	777	0	80	80	1.0000000
NODE_5372_length_1074_cov_19.034872	750	830	0	80	80	1.0000000
NODE_5373_length_1074_cov_9.450256	577	657	0	80	80	1.0000000
NODE_5373_length_1074_cov_9.450256	630	710	0	80	80	1.0000000
NODE_5374_length_1074_cov_9.155897	526	606	0	80	80	1.0000000
NODE_5374_length_1074_cov_9.155897	579	659	0	37	80	0.4625000
NODE_5374_length_1074_cov_9.155897	579	659	1	1	80	0.0125000
NODE_5374_length_1074_cov_9.155897	579	659	2	42	80	0.5250000
NODE_5374_length_1074_cov_9.155897	655	735	2	80	80	1.0000000
NODE_5374_length_1074_cov_9.155897	708	788	0	21	80	0.2625000
NODE_5374_length_1074_cov_9.155897	708	788	1	1	80	0.0125000
NODE_5374_length_1074_cov_9.155897	708	788	2	58	80	0.7250000
NODE_5375_length_1074_cov_4.600000	606	686	2	80	80	1.0000000
NODE_5375_length_1074_cov_4.600000	659	739	0	8	80	0.1000000
NODE_5375_length_1074_cov_4.600000	659	739	1	8	80	0.1000000
NODE_5375_length_1074_cov_4.600000	659	739	2	64	80	0.8000000
NODE_5376_length_1074_cov_4.328205	32	112	2	15	80	0.1875000
NODE_5376_length_1074_cov_4.328205	32	112	4	6	80	0.0750000
NODE_5376_length_1074_cov_4.328205	32	112	6	29	80	0.3625000
NODE_5376_length_1074_cov_4.328205	32	112	8	30	80	0.3750000
NODE_5380_length_1073_cov_60.012320	448	528	5	11	80	0.1375000
NODE_5380_length_1073_cov_60.012320	448	528	6	16	80	0.2000000
NODE_5380_length_1073_cov_60.012320	448	528	7	9	80	0.1125000
NODE_5380_length_1073_cov_60.012320	448	528	8	28	80	0.3500000
NODE_5380_length_1073_cov_60.012320	448	528	9	16	80	0.2000000
NODE_5380_length_1073_cov_60.012320	501	581	4	12	80	0.1500000
NODE_5380_length_1073_cov_60.012320	501	581	6	57	80	0.7125000
NODE_5380_length_1073_cov_60.012320	501	581	8	11	80	0.1375000
NODE_5382_length_1073_cov_26.415811	529	609	2	21	80	0.2625000
NODE_5382_length_1073_cov_26.415811	529	609	3	3	80	0.0375000
NODE_5382_length_1073_cov_26.415811	529	609	4	24	80	0.3000000
NODE_5382_length_1073_cov_26.415811	529	609	5	32	80	0.4000000
NODE_5382_length_1073_cov_26.415811	582	662	1	26	80	0.3250000
NODE_5382_length_1073_cov_26.415811	582	662	2	48	80	0.6000000
NODE_5382_length_1073_cov_26.415811	582	662	3	3	80	0.0375000
NODE_5382_length_1073_cov_26.415811	582	662	5	3	80	0.0375000
NODE_5383_length_1073_cov_19.062628	571	651	0	80	80	1.0000000
NODE_5383_length_1073_cov_19.062628	624	704	0	80	80	1.0000000
NODE_5384_length_1073_cov_18.536961	447	527	0	80	80	1.0000000
NODE_5384_length_1073_cov_18.536961	500	580	0	80	80	1.0000000
NODE_5384_length_1073_cov_18.536961	576	656	0	72	80	0.9000000
NODE_5384_length_1073_cov_18.536961	576	656	2	8	80	0.1000000
NODE_5384_length_1073_cov_18.536961	629	709	0	19	80	0.2375000
NODE_5384_length_1073_cov_18.536961	629	709	2	61	80	0.7625000
NODE_5385_length_1073_cov_15.318275	712	792	0	61	80	0.7625000
NODE_5385_length_1073_cov_15.318275	712	792	2	19	80	0.2375000
NODE_5385_length_1073_cov_15.318275	765	845	0	8	80	0.1000000
NODE_5385_length_1073_cov_15.318275	765	845	2	72	80	0.9000000
NODE_5386_length_1073_cov_8.376797	287	367	0	12	80	0.1500000
NODE_5386_length_1073_cov_8.376797	287	367	2	61	80	0.7625000
NODE_5386_length_1073_cov_8.376797	287	367	4	7	80	0.0875000
NODE_5386_length_1073_cov_8.376797	340	420	2	20	80	0.2500000
NODE_5386_length_1073_cov_8.376797	340	420	4	60	80	0.7500000
NODE_5387_length_1073_cov_5.749487	257	337	0	80	80	1.0000000
NODE_5387_length_1073_cov_5.749487	310	390	0	80	80	1.0000000
NODE_5388_length_1073_cov_5.156057	408	444	3	26	36	0.7222222
NODE_5388_length_1073_cov_5.156057	408	444	4	5	36	0.1388889
NODE_5388_length_1073_cov_5.156057	408	444	5	5	36	0.1388889
NODE_5390_length_1073_cov_3.019507	1	69	0	68	68	1.0000000
NODE_5390_length_1073_cov_3.019507	42	122	0	39	80	0.4875000
NODE_5390_length_1073_cov_3.019507	42	122	1	12	80	0.1500000
NODE_5390_length_1073_cov_3.019507	42	122	2	29	80	0.3625000
NODE_5399_length_1072_cov_62.729702	351	431	5	12	80	0.1500000
NODE_5399_length_1072_cov_62.729702	351	431	6	17	80	0.2125000
NODE_5399_length_1072_cov_62.729702	351	431	7	18	80	0.2250000
NODE_5399_length_1072_cov_62.729702	351	431	8	17	80	0.2125000
NODE_5399_length_1072_cov_62.729702	351	431	9	13	80	0.1625000
NODE_5399_length_1072_cov_62.729702	351	431	10	3	80	0.0375000
NODE_5399_length_1072_cov_62.729702	404	484	6	15	80	0.1875000
NODE_5399_length_1072_cov_62.729702	404	484	7	2	80	0.0250000
NODE_5399_length_1072_cov_62.729702	404	484	8	41	80	0.5125000
NODE_5399_length_1072_cov_62.729702	404	484	9	19	80	0.2375000
NODE_5399_length_1072_cov_62.729702	404	484	10	3	80	0.0375000
NODE_5399_length_1072_cov_62.729702	480	560	3	4	80	0.0500000
NODE_5399_length_1072_cov_62.729702	480	560	4	18	80	0.2250000
NODE_5399_length_1072_cov_62.729702	480	560	6	10	80	0.1250000
NODE_5399_length_1072_cov_62.729702	480	560	7	13	80	0.1625000
NODE_5399_length_1072_cov_62.729702	480	560	8	35	80	0.4375000
NODE_5399_length_1072_cov_62.729702	533	613	2	53	80	0.6625000
NODE_5399_length_1072_cov_62.729702	533	613	3	4	80	0.0500000
NODE_5399_length_1072_cov_62.729702	533	613	4	18	80	0.2250000
NODE_5399_length_1072_cov_62.729702	533	613	6	5	80	0.0625000
NODE_5400_length_1072_cov_34.045221	430	510	2	80	80	1.0000000
NODE_5400_length_1072_cov_34.045221	483	563	2	35	80	0.4375000
NODE_5400_length_1072_cov_34.045221	483	563	3	4	80	0.0500000
NODE_5400_length_1072_cov_34.045221	483	563	4	41	80	0.5125000
NODE_5401_length_1072_cov_34.006166	342	423	0	1	81	0.0123457
NODE_5401_length_1072_cov_34.006166	342	423	1	6	81	0.0740741
NODE_5401_length_1072_cov_34.006166	342	423	2	74	81	0.9135802
NODE_5401_length_1072_cov_34.006166	396	476	2	52	80	0.6500000
NODE_5401_length_1072_cov_34.006166	396	476	3	28	80	0.3500000
NODE_5401_length_1072_cov_34.006166	472	552	1	53	80	0.6625000
NODE_5401_length_1072_cov_34.006166	472	552	2	6	80	0.0750000
NODE_5401_length_1072_cov_34.006166	472	552	3	21	80	0.2625000
NODE_5401_length_1072_cov_34.006166	525	605	0	7	80	0.0875000
NODE_5401_length_1072_cov_34.006166	525	605	1	73	80	0.9125000
NODE_5403_length_1072_cov_21.852004	300	380	1	58	80	0.7250000
NODE_5403_length_1072_cov_21.852004	300	380	3	10	80	0.1250000
NODE_5403_length_1072_cov_21.852004	300	380	4	12	80	0.1500000
NODE_5403_length_1072_cov_21.852004	353	433	1	5	80	0.0625000
NODE_5403_length_1072_cov_21.852004	353	433	3	10	80	0.1250000
NODE_5403_length_1072_cov_21.852004	353	433	4	65	80	0.8125000
NODE_5404_length_1072_cov_21.532374	476	556	0	80	80	1.0000000
NODE_5404_length_1072_cov_21.532374	529	609	0	80	80	1.0000000
NODE_5405_length_1072_cov_17.018499	415	495	0	3	80	0.0375000
NODE_5405_length_1072_cov_17.018499	415	495	1	15	80	0.1875000
NODE_5405_length_1072_cov_17.018499	415	495	2	62	80	0.7750000
NODE_5405_length_1072_cov_17.018499	468	548	0	56	80	0.7000000
NODE_5405_length_1072_cov_17.018499	468	548	1	15	80	0.1875000
NODE_5405_length_1072_cov_17.018499	468	548	2	9	80	0.1125000
NODE_5410_length_1072_cov_3.302158	388	449	5	5	61	0.0819672
NODE_5410_length_1072_cov_3.302158	388	449	7	2	61	0.0327869
NODE_5410_length_1072_cov_3.302158	388	449	8	8	61	0.1311475
NODE_5410_length_1072_cov_3.302158	388	449	10	46	61	0.7540984
NODE_5410_length_1072_cov_3.302158	422	502	8	22	80	0.2750000
NODE_5410_length_1072_cov_3.302158	422	502	9	6	80	0.0750000
NODE_5410_length_1072_cov_3.302158	422	502	10	49	80	0.6125000
NODE_5410_length_1072_cov_3.302158	422	502	12	3	80	0.0375000
NODE_5414_length_1072_cov_1.773895	114	176	2	59	62	0.9516129
NODE_5414_length_1072_cov_1.773895	114	176	3	3	62	0.0483871
NODE_5417_length_1071_cov_27.565844	312	392	4	23	80	0.2875000
NODE_5417_length_1071_cov_27.565844	312	392	5	32	80	0.4000000
NODE_5417_length_1071_cov_27.565844	312	392	6	25	80	0.3125000
NODE_5417_length_1071_cov_27.565844	365	445	4	43	80	0.5375000
NODE_5417_length_1071_cov_27.565844	365	445	5	7	80	0.0875000
NODE_5417_length_1071_cov_27.565844	365	445	6	26	80	0.3250000
NODE_5417_length_1071_cov_27.565844	365	445	7	4	80	0.0500000
NODE_5419_length_1071_cov_12.666667	480	560	0	80	80	1.0000000
NODE_5419_length_1071_cov_12.666667	533	613	0	80	80	1.0000000
NODE_5421_length_1071_cov_8.942387	418	498	0	80	80	1.0000000
NODE_5421_length_1071_cov_8.942387	471	551	0	80	80	1.0000000
NODE_5427_length_1070_cov_39.255407	591	671	3	4	80	0.0500000
NODE_5427_length_1070_cov_39.255407	591	671	4	4	80	0.0500000
NODE_5427_length_1070_cov_39.255407	591	671	5	4	80	0.0500000
NODE_5427_length_1070_cov_39.255407	591	671	6	20	80	0.2500000
NODE_5427_length_1070_cov_39.255407	591	671	7	14	80	0.1750000
NODE_5427_length_1070_cov_39.255407	591	671	8	12	80	0.1500000
NODE_5427_length_1070_cov_39.255407	591	671	9	22	80	0.2750000
NODE_5427_length_1070_cov_39.255407	644	724	4	3	80	0.0375000
NODE_5427_length_1070_cov_39.255407	644	724	5	30	80	0.3750000
NODE_5427_length_1070_cov_39.255407	644	724	6	2	80	0.0250000
NODE_5427_length_1070_cov_39.255407	644	724	8	18	80	0.2250000
NODE_5427_length_1070_cov_39.255407	644	724	9	27	80	0.3375000
NODE_5428_length_1070_cov_21.903193	430	510	0	80	80	1.0000000
NODE_5428_length_1070_cov_21.903193	483	563	0	80	80	1.0000000
NODE_5428_length_1070_cov_21.903193	559	639	0	6	80	0.0750000
NODE_5428_length_1070_cov_21.903193	559	639	1	20	80	0.2500000
NODE_5428_length_1070_cov_21.903193	559	639	2	31	80	0.3875000
NODE_5428_length_1070_cov_21.903193	559	639	4	23	80	0.2875000
NODE_5428_length_1070_cov_21.903193	612	692	2	4	80	0.0500000
NODE_5428_length_1070_cov_21.903193	612	692	4	76	80	0.9500000
NODE_5429_length_1070_cov_8.963955	871	900	5	3	29	0.1034483
NODE_5429_length_1070_cov_8.963955	871	900	6	1	29	0.0344828
NODE_5429_length_1070_cov_8.963955	871	900	7	1	29	0.0344828
NODE_5429_length_1070_cov_8.963955	871	900	10	3	29	0.1034483
NODE_5429_length_1070_cov_8.963955	871	900	13	1	29	0.0344828
NODE_5429_length_1070_cov_8.963955	871	900	16	3	29	0.1034483
NODE_5429_length_1070_cov_8.963955	871	900	18	3	29	0.1034483
NODE_5429_length_1070_cov_8.963955	871	900	22	2	29	0.0689655
NODE_5429_length_1070_cov_8.963955	871	900	24	2	29	0.0689655
NODE_5429_length_1070_cov_8.963955	871	900	27	8	29	0.2758621
NODE_5429_length_1070_cov_8.963955	871	900	29	2	29	0.0689655
NODE_5429_length_1070_cov_8.963955	873	953	5	1	80	0.0125000
NODE_5429_length_1070_cov_8.963955	873	953	6	1	80	0.0125000
NODE_5429_length_1070_cov_8.963955	873	953	7	1	80	0.0125000
NODE_5429_length_1070_cov_8.963955	873	953	10	3	80	0.0375000
NODE_5429_length_1070_cov_8.963955	873	953	13	1	80	0.0125000
NODE_5429_length_1070_cov_8.963955	873	953	16	3	80	0.0375000
NODE_5429_length_1070_cov_8.963955	873	953	18	3	80	0.0375000
NODE_5429_length_1070_cov_8.963955	873	953	22	2	80	0.0250000
NODE_5429_length_1070_cov_8.963955	873	953	24	2	80	0.0250000
NODE_5429_length_1070_cov_8.963955	873	953	27	8	80	0.1000000
NODE_5429_length_1070_cov_8.963955	873	953	29	3	80	0.0375000
NODE_5429_length_1070_cov_8.963955	873	953	30	1	80	0.0125000
NODE_5429_length_1070_cov_8.963955	873	953	34	1	80	0.0125000
NODE_5429_length_1070_cov_8.963955	873	953	35	4	80	0.0500000
NODE_5429_length_1070_cov_8.963955	873	953	36	4	80	0.0500000
NODE_5429_length_1070_cov_8.963955	873	953	38	2	80	0.0250000
NODE_5429_length_1070_cov_8.963955	873	953	39	5	80	0.0625000
NODE_5429_length_1070_cov_8.963955	873	953	40	1	80	0.0125000
NODE_5429_length_1070_cov_8.963955	873	953	41	1	80	0.0125000
NODE_5429_length_1070_cov_8.963955	873	953	42	4	80	0.0500000
NODE_5429_length_1070_cov_8.963955	873	953	43	5	80	0.0625000
NODE_5429_length_1070_cov_8.963955	873	953	45	1	80	0.0125000
NODE_5429_length_1070_cov_8.963955	873	953	47	1	80	0.0125000
NODE_5429_length_1070_cov_8.963955	873	953	48	2	80	0.0250000
NODE_5429_length_1070_cov_8.963955	873	953	49	6	80	0.0750000
NODE_5429_length_1070_cov_8.963955	873	953	50	4	80	0.0500000
NODE_5429_length_1070_cov_8.963955	873	953	51	10	80	0.1250000
NODE_5433_length_1070_cov_1.659114	1027	1046	0	19	19	1.0000000
NODE_5439_length_1069_cov_40.277320	451	531	0	5	80	0.0625000
NODE_5439_length_1069_cov_40.277320	451	531	2	27	80	0.3375000
NODE_5439_length_1069_cov_40.277320	451	531	4	48	80	0.6000000
NODE_5439_length_1069_cov_40.277320	504	584	4	80	80	1.0000000
NODE_5440_length_1069_cov_23.571134	274	354	0	66	80	0.8250000
NODE_5440_length_1069_cov_23.571134	274	354	1	14	80	0.1750000
NODE_5440_length_1069_cov_23.571134	327	407	0	13	80	0.1625000
NODE_5440_length_1069_cov_23.571134	327	407	1	57	80	0.7125000
NODE_5440_length_1069_cov_23.571134	327	407	2	10	80	0.1250000
NODE_5441_length_1069_cov_22.436082	185	265	4	5	80	0.0625000
NODE_5441_length_1069_cov_22.436082	185	265	5	40	80	0.5000000
NODE_5441_length_1069_cov_22.436082	185	265	7	35	80	0.4375000
NODE_5441_length_1069_cov_22.436082	238	318	1	2	80	0.0250000
NODE_5441_length_1069_cov_22.436082	238	318	2	28	80	0.3500000
NODE_5441_length_1069_cov_22.436082	238	318	3	12	80	0.1500000
NODE_5441_length_1069_cov_22.436082	238	318	4	16	80	0.2000000
NODE_5441_length_1069_cov_22.436082	238	318	5	22	80	0.2750000
NODE_5442_length_1069_cov_18.207216	436	516	0	37	80	0.4625000
NODE_5442_length_1069_cov_18.207216	436	516	2	3	80	0.0375000
NODE_5442_length_1069_cov_18.207216	436	516	4	40	80	0.5000000
NODE_5442_length_1069_cov_18.207216	489	569	4	80	80	1.0000000
NODE_5443_length_1069_cov_17.601031	596	676	2	61	80	0.7625000
NODE_5443_length_1069_cov_17.601031	596	676	3	19	80	0.2375000
NODE_5443_length_1069_cov_17.601031	649	729	1	33	80	0.4125000
NODE_5443_length_1069_cov_17.601031	649	729	2	18	80	0.2250000
NODE_5443_length_1069_cov_17.601031	649	729	3	29	80	0.3625000
NODE_5444_length_1069_cov_16.318557	353	433	0	80	80	1.0000000
NODE_5444_length_1069_cov_16.318557	406	486	0	80	80	1.0000000
NODE_5444_length_1069_cov_16.318557	482	562	0	80	80	1.0000000
NODE_5444_length_1069_cov_16.318557	535	615	0	80	80	1.0000000
NODE_5445_length_1069_cov_13.349485	471	551	5	54	80	0.6750000
NODE_5445_length_1069_cov_13.349485	471	551	6	26	80	0.3250000
NODE_5445_length_1069_cov_13.349485	524	604	2	7	80	0.0875000
NODE_5445_length_1069_cov_13.349485	524	604	3	37	80	0.4625000
NODE_5445_length_1069_cov_13.349485	524	604	5	36	80	0.4500000
NODE_5446_length_1069_cov_13.050515	314	394	1	21	80	0.2625000
NODE_5446_length_1069_cov_13.050515	314	394	2	34	80	0.4250000
NODE_5446_length_1069_cov_13.050515	314	394	3	25	80	0.3125000
NODE_5446_length_1069_cov_13.050515	367	447	2	71	80	0.8875000
NODE_5446_length_1069_cov_13.050515	367	447	3	9	80	0.1125000
NODE_5447_length_1069_cov_12.818557	240	320	0	36	80	0.4500000
NODE_5447_length_1069_cov_12.818557	240	320	2	44	80	0.5500000
NODE_5447_length_1069_cov_12.818557	293	373	2	80	80	1.0000000
NODE_5448_length_1069_cov_11.985567	554	634	0	80	80	1.0000000
NODE_5448_length_1069_cov_11.985567	607	687	0	80	80	1.0000000
NODE_5449_length_1069_cov_10.812371	366	446	0	54	80	0.6750000
NODE_5449_length_1069_cov_10.812371	366	446	1	26	80	0.3250000
NODE_5449_length_1069_cov_10.812371	419	499	0	1	80	0.0125000
NODE_5449_length_1069_cov_10.812371	419	499	1	29	80	0.3625000
NODE_5449_length_1069_cov_10.812371	419	499	2	50	80	0.6250000
NODE_5450_length_1069_cov_7.729897	482	562	0	80	80	1.0000000
NODE_5450_length_1069_cov_7.729897	535	615	0	80	80	1.0000000
NODE_5456_length_1068_cov_31.692466	314	394	2	16	80	0.2000000
NODE_5456_length_1068_cov_31.692466	314	394	3	37	80	0.4625000
NODE_5456_length_1068_cov_31.692466	314	394	4	27	80	0.3375000
NODE_5456_length_1068_cov_31.692466	367	447	3	3	80	0.0375000
NODE_5456_length_1068_cov_31.692466	367	447	4	58	80	0.7250000
NODE_5456_length_1068_cov_31.692466	367	447	5	19	80	0.2375000
NODE_5456_length_1068_cov_31.692466	443	523	2	1	80	0.0125000
NODE_5456_length_1068_cov_31.692466	443	523	3	8	80	0.1000000
NODE_5456_length_1068_cov_31.692466	443	523	4	34	80	0.4250000
NODE_5456_length_1068_cov_31.692466	443	523	5	37	80	0.4625000
NODE_5456_length_1068_cov_31.692466	496	576	2	33	80	0.4125000
NODE_5456_length_1068_cov_31.692466	496	576	3	29	80	0.3625000
NODE_5456_length_1068_cov_31.692466	496	576	4	18	80	0.2250000
NODE_5457_length_1068_cov_29.579979	347	427	2	11	80	0.1375000
NODE_5457_length_1068_cov_29.579979	347	427	4	69	80	0.8625000
NODE_5457_length_1068_cov_29.579979	400	480	4	66	80	0.8250000
NODE_5457_length_1068_cov_29.579979	400	480	6	14	80	0.1750000
NODE_5459_length_1068_cov_23.020640	476	556	3	9	80	0.1125000
NODE_5459_length_1068_cov_23.020640	476	556	4	17	80	0.2125000
NODE_5459_length_1068_cov_23.020640	476	556	5	54	80	0.6750000
NODE_5459_length_1068_cov_23.020640	529	609	2	6	80	0.0750000
NODE_5459_length_1068_cov_23.020640	529	609	3	45	80	0.5625000
NODE_5459_length_1068_cov_23.020640	529	609	4	28	80	0.3500000
NODE_5459_length_1068_cov_23.020640	529	609	5	1	80	0.0125000
NODE_5460_length_1068_cov_15.272446	546	626	1	23	80	0.2875000
NODE_5460_length_1068_cov_15.272446	546	626	3	42	80	0.5250000
NODE_5460_length_1068_cov_15.272446	546	626	4	15	80	0.1875000
NODE_5460_length_1068_cov_15.272446	599	679	3	14	80	0.1750000
NODE_5460_length_1068_cov_15.272446	599	679	4	66	80	0.8250000
NODE_5461_length_1068_cov_13.557276	674	754	0	80	80	1.0000000
NODE_5461_length_1068_cov_13.557276	727	807	0	40	80	0.5000000
NODE_5461_length_1068_cov_13.557276	727	807	1	40	80	0.5000000
NODE_5479_length_1067_cov_48.282025	429	509	0	1	80	0.0125000
NODE_5479_length_1067_cov_48.282025	429	509	2	5	80	0.0625000
NODE_5479_length_1067_cov_48.282025	429	509	3	1	80	0.0125000
NODE_5479_length_1067_cov_48.282025	429	509	4	6	80	0.0750000
NODE_5479_length_1067_cov_48.282025	429	509	5	3	80	0.0375000
NODE_5479_length_1067_cov_48.282025	429	509	6	23	80	0.2875000
NODE_5479_length_1067_cov_48.282025	429	509	7	4	80	0.0500000
NODE_5479_length_1067_cov_48.282025	429	509	10	11	80	0.1375000
NODE_5479_length_1067_cov_48.282025	429	509	12	7	80	0.0875000
NODE_5479_length_1067_cov_48.282025	429	509	13	19	80	0.2375000
NODE_5479_length_1067_cov_48.282025	482	562	10	1	80	0.0125000
NODE_5479_length_1067_cov_48.282025	482	562	12	33	80	0.4125000
NODE_5479_length_1067_cov_48.282025	482	562	13	22	80	0.2750000
NODE_5479_length_1067_cov_48.282025	482	562	14	24	80	0.3000000
NODE_5480_length_1067_cov_41.111570	460	540	2	24	80	0.3000000
NODE_5480_length_1067_cov_41.111570	460	540	4	38	80	0.4750000
NODE_5480_length_1067_cov_41.111570	460	540	5	4	80	0.0500000
NODE_5480_length_1067_cov_41.111570	460	540	6	14	80	0.1750000
NODE_5480_length_1067_cov_41.111570	513	593	2	1	80	0.0125000
NODE_5480_length_1067_cov_41.111570	513	593	4	8	80	0.1000000
NODE_5480_length_1067_cov_41.111570	513	593	5	4	80	0.0500000
NODE_5480_length_1067_cov_41.111570	513	593	6	51	80	0.6375000
NODE_5480_length_1067_cov_41.111570	513	593	7	16	80	0.2000000
NODE_5481_length_1067_cov_39.109504	295	375	1	54	80	0.6750000
NODE_5481_length_1067_cov_39.109504	295	375	3	15	80	0.1875000
NODE_5481_length_1067_cov_39.109504	295	375	4	11	80	0.1375000
NODE_5481_length_1067_cov_39.109504	348	428	1	1	80	0.0125000
NODE_5481_length_1067_cov_39.109504	348	428	3	15	80	0.1875000
NODE_5481_length_1067_cov_39.109504	348	428	4	52	80	0.6500000
NODE_5481_length_1067_cov_39.109504	348	428	5	12	80	0.1500000
NODE_5481_length_1067_cov_39.109504	424	504	2	4	80	0.0500000
NODE_5481_length_1067_cov_39.109504	424	504	4	37	80	0.4625000
NODE_5481_length_1067_cov_39.109504	424	504	5	39	80	0.4875000
NODE_5481_length_1067_cov_39.109504	477	557	2	26	80	0.3250000
NODE_5481_length_1067_cov_39.109504	477	557	4	19	80	0.2375000
NODE_5481_length_1067_cov_39.109504	477	557	5	35	80	0.4375000
NODE_5482_length_1067_cov_35.426653	252	332	2	80	80	1.0000000
NODE_5482_length_1067_cov_35.426653	305	385	0	3	80	0.0375000
NODE_5482_length_1067_cov_35.426653	305	385	1	2	80	0.0250000
NODE_5482_length_1067_cov_35.426653	305	385	2	75	80	0.9375000
NODE_5483_length_1067_cov_29.467975	412	492	0	33	80	0.4125000
NODE_5483_length_1067_cov_29.467975	412	492	2	47	80	0.5875000
NODE_5483_length_1067_cov_29.467975	465	545	2	80	80	1.0000000
NODE_5484_length_1067_cov_20.738636	579	645	13	4	66	0.0606061
NODE_5484_length_1067_cov_20.738636	579	645	14	4	66	0.0606061
NODE_5484_length_1067_cov_20.738636	579	645	15	1	66	0.0151515
NODE_5484_length_1067_cov_20.738636	579	645	16	3	66	0.0454545
NODE_5484_length_1067_cov_20.738636	579	645	17	6	66	0.0909091
NODE_5484_length_1067_cov_20.738636	579	645	18	12	66	0.1818182
NODE_5484_length_1067_cov_20.738636	579	645	20	1	66	0.0151515
NODE_5484_length_1067_cov_20.738636	579	645	22	3	66	0.0454545
NODE_5484_length_1067_cov_20.738636	579	645	24	5	66	0.0757576
NODE_5484_length_1067_cov_20.738636	579	645	25	13	66	0.1969697
NODE_5484_length_1067_cov_20.738636	579	645	26	3	66	0.0454545
NODE_5484_length_1067_cov_20.738636	579	645	27	5	66	0.0757576
NODE_5484_length_1067_cov_20.738636	579	645	28	5	66	0.0757576
NODE_5484_length_1067_cov_20.738636	579	645	29	1	66	0.0151515
NODE_5484_length_1067_cov_20.738636	618	698	25	13	80	0.1625000
NODE_5484_length_1067_cov_20.738636	618	698	26	3	80	0.0375000
NODE_5484_length_1067_cov_20.738636	618	698	27	5	80	0.0625000
NODE_5484_length_1067_cov_20.738636	618	698	28	8	80	0.1000000
NODE_5484_length_1067_cov_20.738636	618	698	29	4	80	0.0500000
NODE_5484_length_1067_cov_20.738636	618	698	30	4	80	0.0500000
NODE_5484_length_1067_cov_20.738636	618	698	31	5	80	0.0625000
NODE_5484_length_1067_cov_20.738636	618	698	32	5	80	0.0625000
NODE_5484_length_1067_cov_20.738636	618	698	33	22	80	0.2750000
NODE_5484_length_1067_cov_20.738636	618	698	34	8	80	0.1000000
NODE_5484_length_1067_cov_20.738636	618	698	36	3	80	0.0375000
NODE_5485_length_1067_cov_15.280992	538	617	0	6	79	0.0759494
NODE_5485_length_1067_cov_15.280992	538	617	2	9	79	0.1139240
NODE_5485_length_1067_cov_15.280992	538	617	4	24	79	0.3037975
NODE_5485_length_1067_cov_15.280992	538	617	6	20	79	0.2531646
NODE_5485_length_1067_cov_15.280992	538	617	7	8	79	0.1012658
NODE_5485_length_1067_cov_15.280992	538	617	9	12	79	0.1518987
NODE_5485_length_1067_cov_15.280992	590	670	6	7	80	0.0875000
NODE_5485_length_1067_cov_15.280992	590	670	7	22	80	0.2750000
NODE_5485_length_1067_cov_15.280992	590	670	9	51	80	0.6375000
NODE_5486_length_1067_cov_13.708678	478	558	1	13	80	0.1625000
NODE_5486_length_1067_cov_13.708678	478	558	2	12	80	0.1500000
NODE_5486_length_1067_cov_13.708678	478	558	3	55	80	0.6875000
NODE_5486_length_1067_cov_13.708678	531	611	3	78	80	0.9750000
NODE_5486_length_1067_cov_13.708678	531	611	4	2	80	0.0250000
NODE_5488_length_1067_cov_9.070248	625	705	4	24	80	0.3000000
NODE_5488_length_1067_cov_9.070248	625	705	5	15	80	0.1875000
NODE_5488_length_1067_cov_9.070248	625	705	6	7	80	0.0875000
NODE_5488_length_1067_cov_9.070248	625	705	7	21	80	0.2625000
NODE_5488_length_1067_cov_9.070248	625	705	8	13	80	0.1625000
NODE_5488_length_1067_cov_9.070248	678	758	6	2	80	0.0250000
NODE_5488_length_1067_cov_9.070248	678	758	7	15	80	0.1875000
NODE_5488_length_1067_cov_9.070248	678	758	8	63	80	0.7875000
NODE_5494_length_1067_cov_1.946281	765	812	0	38	47	0.8085107
NODE_5494_length_1067_cov_1.946281	765	812	2	9	47	0.1914894
NODE_5501_length_1066_cov_54.227508	395	475	5	10	80	0.1250000
NODE_5501_length_1066_cov_54.227508	395	475	6	39	80	0.4875000
NODE_5501_length_1066_cov_54.227508	395	475	7	14	80	0.1750000
NODE_5501_length_1066_cov_54.227508	395	475	8	17	80	0.2125000
NODE_5501_length_1066_cov_54.227508	448	528	4	30	80	0.3750000
NODE_5501_length_1066_cov_54.227508	448	528	5	33	80	0.4125000
NODE_5501_length_1066_cov_54.227508	448	528	6	12	80	0.1500000
NODE_5501_length_1066_cov_54.227508	448	528	7	5	80	0.0625000
NODE_5502_length_1066_cov_33.501551	357	437	3	25	80	0.3125000
NODE_5502_length_1066_cov_33.501551	357	437	5	55	80	0.6875000
NODE_5502_length_1066_cov_33.501551	410	490	5	80	80	1.0000000
NODE_5503_length_1066_cov_33.115822	397	477	6	14	80	0.1750000
NODE_5503_length_1066_cov_33.115822	397	477	7	18	80	0.2250000
NODE_5503_length_1066_cov_33.115822	397	477	8	21	80	0.2625000
NODE_5503_length_1066_cov_33.115822	397	477	9	27	80	0.3375000
NODE_5503_length_1066_cov_33.115822	450	530	4	8	80	0.1000000
NODE_5503_length_1066_cov_33.115822	450	530	5	26	80	0.3250000
NODE_5503_length_1066_cov_33.115822	450	530	7	25	80	0.3125000
NODE_5503_length_1066_cov_33.115822	450	530	9	21	80	0.2625000
NODE_5504_length_1066_cov_26.517063	215	285	101	1	70	0.0142857
NODE_5504_length_1066_cov_26.517063	215	285	102	2	70	0.0285714
NODE_5504_length_1066_cov_26.517063	215	285	103	5	70	0.0714286
NODE_5504_length_1066_cov_26.517063	215	285	104	5	70	0.0714286
NODE_5504_length_1066_cov_26.517063	215	285	106	7	70	0.1000000
NODE_5504_length_1066_cov_26.517063	215	285	107	3	70	0.0428571
NODE_5504_length_1066_cov_26.517063	215	285	108	11	70	0.1571429
NODE_5504_length_1066_cov_26.517063	215	285	109	9	70	0.1285714
NODE_5504_length_1066_cov_26.517063	215	285	110	12	70	0.1714286
NODE_5504_length_1066_cov_26.517063	215	285	111	3	70	0.0428571
NODE_5504_length_1066_cov_26.517063	215	285	112	8	70	0.1142857
NODE_5504_length_1066_cov_26.517063	215	285	113	2	70	0.0285714
NODE_5504_length_1066_cov_26.517063	215	285	114	2	70	0.0285714
NODE_5505_length_1066_cov_16.906929	526	606	0	26	80	0.3250000
NODE_5505_length_1066_cov_16.906929	526	606	1	3	80	0.0375000
NODE_5505_length_1066_cov_16.906929	526	606	2	51	80	0.6375000
NODE_5505_length_1066_cov_16.906929	579	659	2	80	80	1.0000000
NODE_5506_length_1066_cov_16.190279	298	378	1	2	80	0.0250000
NODE_5506_length_1066_cov_16.190279	298	378	2	20	80	0.2500000
NODE_5506_length_1066_cov_16.190279	298	378	3	37	80	0.4625000
NODE_5506_length_1066_cov_16.190279	298	378	4	21	80	0.2625000
NODE_5506_length_1066_cov_16.190279	351	432	3	81	81	1.0000000
NODE_5507_length_1066_cov_15.444674	582	662	0	80	80	1.0000000
NODE_5507_length_1066_cov_15.444674	635	715	0	80	80	1.0000000
NODE_5516_length_1065_cov_51.693582	480	560	9	19	80	0.2375000
NODE_5516_length_1065_cov_51.693582	480	560	10	7	80	0.0875000
NODE_5516_length_1065_cov_51.693582	480	560	11	21	80	0.2625000
NODE_5516_length_1065_cov_51.693582	480	560	12	33	80	0.4125000
NODE_5516_length_1065_cov_51.693582	533	613	8	5	80	0.0625000
NODE_5516_length_1065_cov_51.693582	533	613	9	15	80	0.1875000
NODE_5516_length_1065_cov_51.693582	533	613	10	23	80	0.2875000
NODE_5516_length_1065_cov_51.693582	533	613	11	37	80	0.4625000
NODE_5517_length_1065_cov_33.428571	422	502	6	32	80	0.4000000
NODE_5517_length_1065_cov_33.428571	422	502	7	5	80	0.0625000
NODE_5517_length_1065_cov_33.428571	422	502	8	14	80	0.1750000
NODE_5517_length_1065_cov_33.428571	422	502	9	14	80	0.1750000
NODE_5517_length_1065_cov_33.428571	422	502	10	3	80	0.0375000
NODE_5517_length_1065_cov_33.428571	422	502	11	3	80	0.0375000
NODE_5517_length_1065_cov_33.428571	422	502	12	3	80	0.0375000
NODE_5517_length_1065_cov_33.428571	422	502	14	6	80	0.0750000
NODE_5517_length_1065_cov_33.428571	422	502	6	32	80	0.4000000
NODE_5517_length_1065_cov_33.428571	422	502	7	5	80	0.0625000
NODE_5517_length_1065_cov_33.428571	422	502	8	14	80	0.1750000
NODE_5517_length_1065_cov_33.428571	422	502	9	14	80	0.1750000
NODE_5517_length_1065_cov_33.428571	422	502	10	3	80	0.0375000
NODE_5517_length_1065_cov_33.428571	422	502	11	3	80	0.0375000
NODE_5517_length_1065_cov_33.428571	422	502	12	3	80	0.0375000
NODE_5517_length_1065_cov_33.428571	422	502	14	6	80	0.0750000
NODE_5517_length_1065_cov_33.428571	422	502	6	32	80	0.4000000
NODE_5517_length_1065_cov_33.428571	422	502	7	5	80	0.0625000
NODE_5517_length_1065_cov_33.428571	422	502	8	14	80	0.1750000
NODE_5517_length_1065_cov_33.428571	422	502	9	14	80	0.1750000
NODE_5517_length_1065_cov_33.428571	422	502	10	3	80	0.0375000
NODE_5517_length_1065_cov_33.428571	422	502	11	3	80	0.0375000
NODE_5517_length_1065_cov_33.428571	422	502	12	3	80	0.0375000
NODE_5517_length_1065_cov_33.428571	422	502	14	6	80	0.0750000
NODE_5517_length_1065_cov_33.428571	475	555	9	12	80	0.1500000
NODE_5517_length_1065_cov_33.428571	475	555	10	3	80	0.0375000
NODE_5517_length_1065_cov_33.428571	475	555	11	13	80	0.1625000
NODE_5517_length_1065_cov_33.428571	475	555	12	10	80	0.1250000
NODE_5517_length_1065_cov_33.428571	475	555	13	8	80	0.1000000
NODE_5517_length_1065_cov_33.428571	475	555	14	21	80	0.2625000
NODE_5517_length_1065_cov_33.428571	475	555	15	13	80	0.1625000
NODE_5517_length_1065_cov_33.428571	475	555	9	12	80	0.1500000
NODE_5517_length_1065_cov_33.428571	475	555	10	3	80	0.0375000
NODE_5517_length_1065_cov_33.428571	475	555	11	13	80	0.1625000
NODE_5517_length_1065_cov_33.428571	475	555	12	10	80	0.1250000
NODE_5517_length_1065_cov_33.428571	475	555	13	8	80	0.1000000
NODE_5517_length_1065_cov_33.428571	475	555	14	21	80	0.2625000
NODE_5517_length_1065_cov_33.428571	475	555	15	13	80	0.1625000
NODE_5517_length_1065_cov_33.428571	551	631	7	8	80	0.1000000
NODE_5517_length_1065_cov_33.428571	551	631	8	29	80	0.3625000
NODE_5517_length_1065_cov_33.428571	551	631	10	30	80	0.3750000
NODE_5517_length_1065_cov_33.428571	551	631	11	13	80	0.1625000
NODE_5517_length_1065_cov_33.428571	551	631	7	8	80	0.1000000
NODE_5517_length_1065_cov_33.428571	551	631	8	29	80	0.3625000
NODE_5517_length_1065_cov_33.428571	551	631	10	30	80	0.3750000
NODE_5517_length_1065_cov_33.428571	551	631	11	13	80	0.1625000
NODE_5517_length_1065_cov_33.428571	551	572	10	8	21	0.3809524
NODE_5517_length_1065_cov_33.428571	551	572	11	13	21	0.6190476
NODE_5517_length_1065_cov_33.428571	604	666	4	7	62	0.1129032
NODE_5517_length_1065_cov_33.428571	604	666	5	15	62	0.2419355
NODE_5517_length_1065_cov_33.428571	604	666	6	3	62	0.0483871
NODE_5517_length_1065_cov_33.428571	604	666	7	14	62	0.2258064
NODE_5517_length_1065_cov_33.428571	604	666	8	19	62	0.3064516
NODE_5517_length_1065_cov_33.428571	604	666	9	1	62	0.0161290
NODE_5517_length_1065_cov_33.428571	604	666	11	3	62	0.0483871
NODE_5517_length_1065_cov_33.428571	604	684	4	7	80	0.0875000
NODE_5517_length_1065_cov_33.428571	604	684	5	15	80	0.1875000
NODE_5517_length_1065_cov_33.428571	604	684	6	3	80	0.0375000
NODE_5517_length_1065_cov_33.428571	604	684	7	14	80	0.1750000
NODE_5517_length_1065_cov_33.428571	604	684	8	19	80	0.2375000
NODE_5517_length_1065_cov_33.428571	604	684	9	1	80	0.0125000
NODE_5517_length_1065_cov_33.428571	604	684	11	3	80	0.0375000
NODE_5517_length_1065_cov_33.428571	604	684	12	1	80	0.0125000
NODE_5517_length_1065_cov_33.428571	604	684	13	2	80	0.0250000
NODE_5517_length_1065_cov_33.428571	604	684	14	3	80	0.0375000
NODE_5517_length_1065_cov_33.428571	604	684	15	10	80	0.1250000
NODE_5517_length_1065_cov_33.428571	604	684	16	2	80	0.0250000
NODE_5518_length_1065_cov_31.874741	255	335	0	80	80	1.0000000
NODE_5518_length_1065_cov_31.874741	308	388	0	80	80	1.0000000
NODE_5519_length_1065_cov_21.762940	234	314	1	20	80	0.2500000
NODE_5519_length_1065_cov_21.762940	234	314	3	29	80	0.3625000
NODE_5519_length_1065_cov_21.762940	234	314	4	31	80	0.3875000
NODE_5519_length_1065_cov_21.762940	287	367	1	5	80	0.0625000
NODE_5519_length_1065_cov_21.762940	287	367	2	31	80	0.3875000
NODE_5519_length_1065_cov_21.762940	287	367	4	44	80	0.5500000
NODE_5520_length_1065_cov_19.947205	447	527	8	9	80	0.1125000
NODE_5520_length_1065_cov_19.947205	447	527	9	36	80	0.4500000
NODE_5520_length_1065_cov_19.947205	447	527	11	35	80	0.4375000
NODE_5520_length_1065_cov_19.947205	500	580	8	20	80	0.2500000
NODE_5520_length_1065_cov_19.947205	500	580	9	4	80	0.0500000
NODE_5520_length_1065_cov_19.947205	500	580	10	18	80	0.2250000
NODE_5520_length_1065_cov_19.947205	500	580	11	38	80	0.4750000
NODE_5521_length_1065_cov_14.590062	343	423	3	9	80	0.1125000
NODE_5521_length_1065_cov_14.590062	343	423	4	71	80	0.8875000
NODE_5521_length_1065_cov_14.590062	396	476	2	11	80	0.1375000
NODE_5521_length_1065_cov_14.590062	396	476	3	20	80	0.2500000
NODE_5521_length_1065_cov_14.590062	396	476	4	49	80	0.6125000
NODE_5522_length_1065_cov_13.232919	243	323	2	11	80	0.1375000
NODE_5522_length_1065_cov_13.232919	243	323	3	13	80	0.1625000
NODE_5522_length_1065_cov_13.232919	243	323	4	56	80	0.7000000
NODE_5522_length_1065_cov_13.232919	296	376	3	6	80	0.0750000
NODE_5522_length_1065_cov_13.232919	296	376	4	40	80	0.5000000
NODE_5522_length_1065_cov_13.232919	296	376	5	34	80	0.4250000
NODE_5523_length_1065_cov_10.670807	481	561	0	80	80	1.0000000
NODE_5523_length_1065_cov_10.670807	534	614	0	34	80	0.4250000
NODE_5523_length_1065_cov_10.670807	534	614	1	46	80	0.5750000
NODE_5524_length_1065_cov_10.473085	496	576	1	25	80	0.3125000
NODE_5524_length_1065_cov_10.473085	496	576	2	6	80	0.0750000
NODE_5524_length_1065_cov_10.473085	496	576	4	49	80	0.6125000
NODE_5524_length_1065_cov_10.473085	549	629	3	21	80	0.2625000
NODE_5524_length_1065_cov_10.473085	549	629	4	59	80	0.7375000
NODE_5525_length_1065_cov_9.711180	286	360	9	4	74	0.0540541
NODE_5525_length_1065_cov_9.711180	286	360	10	13	74	0.1756757
NODE_5525_length_1065_cov_9.711180	286	360	11	18	74	0.2432432
NODE_5525_length_1065_cov_9.711180	286	360	12	10	74	0.1351351
NODE_5525_length_1065_cov_9.711180	286	360	13	7	74	0.0945946
NODE_5525_length_1065_cov_9.711180	286	360	14	20	74	0.2702703
NODE_5525_length_1065_cov_9.711180	286	360	15	2	74	0.0270270
NODE_5525_length_1065_cov_9.711180	339	419	10	1	80	0.0125000
NODE_5525_length_1065_cov_9.711180	339	419	11	8	80	0.1000000
NODE_5525_length_1065_cov_9.711180	339	419	12	9	80	0.1125000
NODE_5525_length_1065_cov_9.711180	339	419	13	9	80	0.1125000
NODE_5525_length_1065_cov_9.711180	339	419	14	26	80	0.3250000
NODE_5525_length_1065_cov_9.711180	339	419	15	27	80	0.3375000
NODE_5534_length_1064_cov_59.929534	457	537	0	31	80	0.3875000
NODE_5534_length_1064_cov_59.929534	457	537	1	5	80	0.0625000
NODE_5534_length_1064_cov_59.929534	457	537	4	44	80	0.5500000
NODE_5534_length_1064_cov_59.929534	510	590	4	52	80	0.6500000
NODE_5534_length_1064_cov_59.929534	510	590	5	6	80	0.0750000
NODE_5534_length_1064_cov_59.929534	510	590	6	20	80	0.2500000
NODE_5534_length_1064_cov_59.929534	510	590	7	2	80	0.0250000
NODE_5534_length_1064_cov_59.929534	586	666	3	1	80	0.0125000
NODE_5534_length_1064_cov_59.929534	586	666	4	45	80	0.5625000
NODE_5534_length_1064_cov_59.929534	586	666	6	2	80	0.0250000
NODE_5534_length_1064_cov_59.929534	586	666	7	22	80	0.2750000
NODE_5534_length_1064_cov_59.929534	586	666	8	10	80	0.1250000
NODE_5534_length_1064_cov_59.929534	639	719	4	40	80	0.5000000
NODE_5534_length_1064_cov_59.929534	639	719	5	40	80	0.5000000
NODE_5535_length_1064_cov_36.480829	367	447	4	2	80	0.0250000
NODE_5535_length_1064_cov_36.480829	367	447	5	1	80	0.0125000
NODE_5535_length_1064_cov_36.480829	367	447	6	22	80	0.2750000
NODE_5535_length_1064_cov_36.480829	367	447	7	22	80	0.2750000
NODE_5535_length_1064_cov_36.480829	367	447	9	33	80	0.4125000
NODE_5535_length_1064_cov_36.480829	420	500	7	63	80	0.7875000
NODE_5535_length_1064_cov_36.480829	420	500	9	17	80	0.2125000
NODE_5535_length_1064_cov_36.480829	496	576	0	34	80	0.4250000
NODE_5535_length_1064_cov_36.480829	496	576	1	8	80	0.1000000
NODE_5535_length_1064_cov_36.480829	496	576	3	14	80	0.1750000
NODE_5535_length_1064_cov_36.480829	496	576	4	1	80	0.0125000
NODE_5535_length_1064_cov_36.480829	496	576	5	4	80	0.0500000
NODE_5535_length_1064_cov_36.480829	496	576	7	19	80	0.2375000
NODE_5535_length_1064_cov_36.480829	549	629	0	80	80	1.0000000
NODE_5536_length_1064_cov_32.307772	547	627	2	41	80	0.5125000
NODE_5536_length_1064_cov_32.307772	547	627	3	26	80	0.3250000
NODE_5536_length_1064_cov_32.307772	547	627	5	13	80	0.1625000
NODE_5536_length_1064_cov_32.307772	600	680	3	40	80	0.5000000
NODE_5536_length_1064_cov_32.307772	600	680	4	6	80	0.0750000
NODE_5536_length_1064_cov_32.307772	600	680	5	34	80	0.4250000
NODE_5537_length_1064_cov_25.255959	462	542	2	25	80	0.3125000
NODE_5537_length_1064_cov_25.255959	462	542	3	55	80	0.6875000
NODE_5537_length_1064_cov_25.255959	515	595	2	22	80	0.2750000
NODE_5537_length_1064_cov_25.255959	515	595	3	48	80	0.6000000
NODE_5537_length_1064_cov_25.255959	515	595	4	10	80	0.1250000
NODE_5537_length_1064_cov_25.255959	591	671	1	35	80	0.4375000
NODE_5537_length_1064_cov_25.255959	591	671	2	45	80	0.5625000
NODE_5537_length_1064_cov_25.255959	644	724	0	12	80	0.1500000
NODE_5537_length_1064_cov_25.255959	644	724	1	68	80	0.8500000
NODE_5538_length_1064_cov_23.053886	343	423	2	9	80	0.1125000
NODE_5538_length_1064_cov_23.053886	343	423	3	71	80	0.8875000
NODE_5538_length_1064_cov_23.053886	396	476	2	10	80	0.1250000
NODE_5538_length_1064_cov_23.053886	396	476	3	70	80	0.8750000
NODE_5538_length_1064_cov_23.053886	472	552	0	11	80	0.1375000
NODE_5538_length_1064_cov_23.053886	472	552	1	64	80	0.8000000
NODE_5538_length_1064_cov_23.053886	472	552	2	5	80	0.0625000
NODE_5538_length_1064_cov_23.053886	525	605	0	64	80	0.8000000
NODE_5538_length_1064_cov_23.053886	525	605	1	16	80	0.2000000
NODE_5539_length_1064_cov_22.018653	479	559	5	19	80	0.2375000
NODE_5539_length_1064_cov_22.018653	479	559	6	1	80	0.0125000
NODE_5539_length_1064_cov_22.018653	479	559	7	9	80	0.1125000
NODE_5539_length_1064_cov_22.018653	479	559	8	3	80	0.0375000
NODE_5539_length_1064_cov_22.018653	479	559	9	1	80	0.0125000
NODE_5539_length_1064_cov_22.018653	479	559	10	21	80	0.2625000
NODE_5539_length_1064_cov_22.018653	479	559	11	26	80	0.3250000
NODE_5539_length_1064_cov_22.018653	532	612	6	3	80	0.0375000
NODE_5539_length_1064_cov_22.018653	532	612	9	45	80	0.5625000
NODE_5539_length_1064_cov_22.018653	532	612	10	22	80	0.2750000
NODE_5539_length_1064_cov_22.018653	532	612	11	10	80	0.1250000
NODE_5540_length_1064_cov_12.868394	424	504	0	9	80	0.1125000
NODE_5540_length_1064_cov_12.868394	424	504	1	6	80	0.0750000
NODE_5540_length_1064_cov_12.868394	424	504	3	61	80	0.7625000
NODE_5540_length_1064_cov_12.868394	424	504	4	4	80	0.0500000
NODE_5540_length_1064_cov_12.868394	477	557	3	23	80	0.2875000
NODE_5540_length_1064_cov_12.868394	477	557	4	57	80	0.7125000
NODE_5541_length_1064_cov_10.098446	467	547	4	1	80	0.0125000
NODE_5541_length_1064_cov_10.098446	467	547	5	49	80	0.6125000
NODE_5541_length_1064_cov_10.098446	467	547	6	30	80	0.3750000
NODE_5541_length_1064_cov_10.098446	520	600	2	24	80	0.3000000
NODE_5541_length_1064_cov_10.098446	520	600	4	21	80	0.2625000
NODE_5541_length_1064_cov_10.098446	520	600	5	35	80	0.4375000
NODE_5543_length_1064_cov_2.925389	173	245	1	40	72	0.5555556
NODE_5543_length_1064_cov_2.925389	173	245	2	1	72	0.0138889
NODE_5543_length_1064_cov_2.925389	173	245	4	8	72	0.1111111
NODE_5543_length_1064_cov_2.925389	173	245	6	6	72	0.0833333
NODE_5543_length_1064_cov_2.925389	173	245	9	1	72	0.0138889
NODE_5543_length_1064_cov_2.925389	173	245	10	11	72	0.1527778
NODE_5543_length_1064_cov_2.925389	173	245	12	1	72	0.0138889
NODE_5543_length_1064_cov_2.925389	173	245	14	2	72	0.0277778
NODE_5543_length_1064_cov_2.925389	173	245	15	2	72	0.0277778
NODE_5551_length_1063_cov_104.615145	504	584	3	10	80	0.1250000
NODE_5551_length_1063_cov_104.615145	504	584	4	39	80	0.4875000
NODE_5551_length_1063_cov_104.615145	504	584	6	10	80	0.1250000
NODE_5551_length_1063_cov_104.615145	504	584	7	9	80	0.1125000
NODE_5551_length_1063_cov_104.615145	504	584	8	4	80	0.0500000
NODE_5551_length_1063_cov_104.615145	504	584	9	8	80	0.1000000
NODE_5551_length_1063_cov_104.615145	557	637	6	6	80	0.0750000
NODE_5551_length_1063_cov_104.615145	557	637	7	9	80	0.1125000
NODE_5551_length_1063_cov_104.615145	557	637	8	4	80	0.0500000
NODE_5551_length_1063_cov_104.615145	557	637	9	43	80	0.5375000
NODE_5551_length_1063_cov_104.615145	557	637	10	17	80	0.2125000
NODE_5551_length_1063_cov_104.615145	557	637	11	1	80	0.0125000
NODE_5552_length_1063_cov_36.515560	482	562	2	18	80	0.2250000
NODE_5552_length_1063_cov_36.515560	482	562	3	26	80	0.3250000
NODE_5552_length_1063_cov_36.515560	482	562	4	25	80	0.3125000
NODE_5552_length_1063_cov_36.515560	482	562	5	11	80	0.1375000
NODE_5552_length_1063_cov_36.515560	535	615	3	19	80	0.2375000
NODE_5552_length_1063_cov_36.515560	535	615	4	47	80	0.5875000
NODE_5552_length_1063_cov_36.515560	535	615	5	14	80	0.1750000
NODE_5552_length_1063_cov_36.515560	611	691	2	13	80	0.1625000
NODE_5552_length_1063_cov_36.515560	611	691	3	50	80	0.6250000
NODE_5552_length_1063_cov_36.515560	611	691	4	17	80	0.2125000
NODE_5552_length_1063_cov_36.515560	664	744	0	32	80	0.4000000
NODE_5552_length_1063_cov_36.515560	664	744	1	8	80	0.1000000
NODE_5552_length_1063_cov_36.515560	664	744	2	26	80	0.3250000
NODE_5552_length_1063_cov_36.515560	664	744	3	14	80	0.1750000
NODE_5553_length_1063_cov_30.700207	470	550	2	30	80	0.3750000
NODE_5553_length_1063_cov_30.700207	470	550	3	40	80	0.5000000
NODE_5553_length_1063_cov_30.700207	470	550	4	10	80	0.1250000
NODE_5553_length_1063_cov_30.700207	523	603	3	17	80	0.2125000
NODE_5553_length_1063_cov_30.700207	523	603	4	28	80	0.3500000
NODE_5553_length_1063_cov_30.700207	523	603	5	35	80	0.4375000
NODE_5553_length_1063_cov_30.700207	599	679	3	18	80	0.2250000
NODE_5553_length_1063_cov_30.700207	599	679	4	52	80	0.6500000
NODE_5553_length_1063_cov_30.700207	599	679	5	10	80	0.1250000
NODE_5553_length_1063_cov_30.700207	652	732	2	14	80	0.1750000
NODE_5553_length_1063_cov_30.700207	652	732	3	46	80	0.5750000
NODE_5553_length_1063_cov_30.700207	652	732	4	20	80	0.2500000
NODE_5554_length_1063_cov_24.552905	362	442	0	1	80	0.0125000
NODE_5554_length_1063_cov_24.552905	362	442	2	16	80	0.2000000
NODE_5554_length_1063_cov_24.552905	362	442	3	23	80	0.2875000
NODE_5554_length_1063_cov_24.552905	362	442	4	9	80	0.1125000
NODE_5554_length_1063_cov_24.552905	362	442	5	8	80	0.1000000
NODE_5554_length_1063_cov_24.552905	362	442	6	23	80	0.2875000
NODE_5554_length_1063_cov_24.552905	415	495	5	4	80	0.0500000
NODE_5554_length_1063_cov_24.552905	415	495	6	37	80	0.4625000
NODE_5554_length_1063_cov_24.552905	415	495	7	39	80	0.4875000
NODE_5555_length_1063_cov_21.985477	407	487	0	80	80	1.0000000
NODE_5555_length_1063_cov_21.985477	460	540	0	41	80	0.5125000
NODE_5555_length_1063_cov_21.985477	460	540	1	4	80	0.0500000
NODE_5555_length_1063_cov_21.985477	460	540	2	32	80	0.4000000
NODE_5555_length_1063_cov_21.985477	460	540	4	3	80	0.0375000
NODE_5555_length_1063_cov_21.985477	536	616	2	1	80	0.0125000
NODE_5555_length_1063_cov_21.985477	536	616	4	19	80	0.2375000
NODE_5555_length_1063_cov_21.985477	536	616	5	21	80	0.2625000
NODE_5555_length_1063_cov_21.985477	536	616	6	39	80	0.4875000
NODE_5555_length_1063_cov_21.985477	589	670	2	19	81	0.2345679
NODE_5555_length_1063_cov_21.985477	589	670	3	2	81	0.0246914
NODE_5555_length_1063_cov_21.985477	589	670	4	2	81	0.0246914
NODE_5555_length_1063_cov_21.985477	589	670	6	58	81	0.7160494
NODE_5557_length_1063_cov_15.400415	685	765	1	30	80	0.3750000
NODE_5557_length_1063_cov_15.400415	685	765	2	50	80	0.6250000
NODE_5557_length_1063_cov_15.400415	738	818	0	19	80	0.2375000
NODE_5557_length_1063_cov_15.400415	738	818	1	3	80	0.0375000
NODE_5557_length_1063_cov_15.400415	738	818	2	58	80	0.7250000
NODE_5558_length_1063_cov_13.282158	510	590	1	68	80	0.8500000
NODE_5558_length_1063_cov_13.282158	510	590	3	12	80	0.1500000
NODE_5558_length_1063_cov_13.282158	563	643	1	15	80	0.1875000
NODE_5558_length_1063_cov_13.282158	563	643	3	54	80	0.6750000
NODE_5558_length_1063_cov_13.282158	563	643	4	11	80	0.1375000
NODE_5559_length_1063_cov_12.970954	417	495	0	78	78	1.0000000
NODE_5559_length_1063_cov_12.970954	468	548	0	80	80	1.0000000
NODE_5560_length_1063_cov_7.917012	639	719	0	19	80	0.2375000
NODE_5560_length_1063_cov_7.917012	639	719	1	49	80	0.6125000
NODE_5560_length_1063_cov_7.917012	639	719	2	12	80	0.1500000
NODE_5560_length_1063_cov_7.917012	692	772	1	15	80	0.1875000
NODE_5560_length_1063_cov_7.917012	692	772	2	19	80	0.2375000
NODE_5560_length_1063_cov_7.917012	692	772	3	46	80	0.5750000
NODE_5569_length_1063_cov_1.695021	893	947	0	3	54	0.0555556
NODE_5569_length_1063_cov_1.695021	893	947	2	51	54	0.9444444
NODE_5574_length_1062_cov_43.399792	272	352	4	53	80	0.6625000
NODE_5574_length_1062_cov_43.399792	272	352	5	2	80	0.0250000
NODE_5574_length_1062_cov_43.399792	272	352	6	25	80	0.3125000
NODE_5574_length_1062_cov_43.399792	325	405	1	15	80	0.1875000
NODE_5574_length_1062_cov_43.399792	325	405	3	11	80	0.1375000
NODE_5574_length_1062_cov_43.399792	325	405	4	54	80	0.6750000
NODE_5576_length_1062_cov_19.778816	401	481	1	21	80	0.2625000
NODE_5576_length_1062_cov_19.778816	401	481	2	1	80	0.0125000
NODE_5576_length_1062_cov_19.778816	401	481	3	25	80	0.3125000
NODE_5576_length_1062_cov_19.778816	401	481	4	33	80	0.4125000
NODE_5576_length_1062_cov_19.778816	454	534	3	32	80	0.4000000
NODE_5576_length_1062_cov_19.778816	454	534	4	48	80	0.6000000
NODE_5577_length_1062_cov_16.034268	628	708	0	1	80	0.0125000
NODE_5577_length_1062_cov_16.034268	628	708	2	79	80	0.9875000
NODE_5577_length_1062_cov_16.034268	681	761	0	17	80	0.2125000
NODE_5577_length_1062_cov_16.034268	681	761	1	34	80	0.4250000
NODE_5577_length_1062_cov_16.034268	681	761	2	29	80	0.3625000
NODE_5578_length_1062_cov_13.346833	623	703	2	14	80	0.1750000
NODE_5578_length_1062_cov_13.346833	623	703	4	66	80	0.8250000
NODE_5578_length_1062_cov_13.346833	676	756	0	3	80	0.0375000
NODE_5578_length_1062_cov_13.346833	676	756	2	52	80	0.6500000
NODE_5578_length_1062_cov_13.346833	676	756	4	25	80	0.3125000
NODE_5579_length_1062_cov_9.886812	670	750	0	11	80	0.1375000
NODE_5579_length_1062_cov_9.886812	670	750	2	69	80	0.8625000
NODE_5579_length_1062_cov_9.886812	723	803	2	80	80	1.0000000
NODE_5580_length_1062_cov_9.078920	525	604	2	79	79	1.0000000
NODE_5580_length_1062_cov_9.078920	577	657	0	3	80	0.0375000
NODE_5580_length_1062_cov_9.078920	577	657	1	39	80	0.4875000
NODE_5580_length_1062_cov_9.078920	577	657	2	38	80	0.4750000
NODE_5581_length_1062_cov_8.934579	203	283	1	80	80	1.0000000
NODE_5581_length_1062_cov_8.934579	256	336	0	11	80	0.1375000
NODE_5581_length_1062_cov_8.934579	256	336	1	69	80	0.8625000
NODE_5588_length_1061_cov_22.637214	418	498	0	6	80	0.0750000
NODE_5588_length_1061_cov_22.637214	418	498	1	11	80	0.1375000
NODE_5588_length_1061_cov_22.637214	418	498	2	44	80	0.5500000
NODE_5588_length_1061_cov_22.637214	418	498	3	19	80	0.2375000
NODE_5588_length_1061_cov_22.637214	471	551	0	59	80	0.7375000
NODE_5588_length_1061_cov_22.637214	471	551	1	11	80	0.1375000
NODE_5588_length_1061_cov_22.637214	471	551	2	10	80	0.1250000
NODE_5589_length_1061_cov_22.338877	479	559	8	15	80	0.1875000
NODE_5589_length_1061_cov_22.338877	479	559	9	15	80	0.1875000
NODE_5589_length_1061_cov_22.338877	479	559	10	17	80	0.2125000
NODE_5589_length_1061_cov_22.338877	479	559	11	4	80	0.0500000
NODE_5589_length_1061_cov_22.338877	479	559	12	29	80	0.3625000
NODE_5589_length_1061_cov_22.338877	532	612	4	21	80	0.2625000
NODE_5589_length_1061_cov_22.338877	532	612	5	13	80	0.1625000
NODE_5589_length_1061_cov_22.338877	532	612	6	12	80	0.1500000
NODE_5589_length_1061_cov_22.338877	532	612	10	7	80	0.0875000
NODE_5589_length_1061_cov_22.338877	532	612	12	27	80	0.3375000
NODE_5597_length_1060_cov_31.595213	394	473	0	13	79	0.1645570
NODE_5597_length_1060_cov_31.595213	394	473	2	66	79	0.8354430
NODE_5597_length_1060_cov_31.595213	446	526	0	27	80	0.3375000
NODE_5597_length_1060_cov_31.595213	446	526	1	17	80	0.2125000
NODE_5597_length_1060_cov_31.595213	446	526	2	36	80	0.4500000
NODE_5597_length_1060_cov_31.595213	522	602	1	11	80	0.1375000
NODE_5597_length_1060_cov_31.595213	522	602	3	15	80	0.1875000
NODE_5597_length_1060_cov_31.595213	522	602	5	4	80	0.0500000
NODE_5597_length_1060_cov_31.595213	522	602	6	50	80	0.6250000
NODE_5597_length_1060_cov_31.595213	575	655	2	14	80	0.1750000
NODE_5597_length_1060_cov_31.595213	575	655	6	66	80	0.8250000
NODE_5598_length_1060_cov_26.136316	486	566	2	52	80	0.6500000
NODE_5598_length_1060_cov_26.136316	486	566	3	28	80	0.3500000
NODE_5598_length_1060_cov_26.136316	539	619	3	61	80	0.7625000
NODE_5598_length_1060_cov_26.136316	539	619	4	19	80	0.2375000
NODE_5598_length_1060_cov_26.136316	615	695	1	7	80	0.0875000
NODE_5598_length_1060_cov_26.136316	615	695	2	61	80	0.7625000
NODE_5598_length_1060_cov_26.136316	615	695	3	12	80	0.1500000
NODE_5598_length_1060_cov_26.136316	668	748	0	5	80	0.0625000
NODE_5598_length_1060_cov_26.136316	668	748	1	55	80	0.6875000
NODE_5598_length_1060_cov_26.136316	668	748	2	20	80	0.2500000
NODE_5599_length_1060_cov_25.329865	370	450	1	80	80	1.0000000
NODE_5599_length_1060_cov_25.329865	423	503	1	29	80	0.3625000
NODE_5599_length_1060_cov_25.329865	423	503	2	51	80	0.6375000
NODE_5600_length_1060_cov_16.881374	539	611	4	8	72	0.1111111
NODE_5600_length_1060_cov_16.881374	539	611	5	36	72	0.5000000
NODE_5600_length_1060_cov_16.881374	539	611	7	28	72	0.3888889
NODE_5601_length_1060_cov_14.789802	406	486	0	80	80	1.0000000
NODE_5601_length_1060_cov_14.789802	459	539	0	80	80	1.0000000
NODE_5603_length_1060_cov_5.900104	517	597	0	80	80	1.0000000
NODE_5603_length_1060_cov_5.900104	570	650	0	80	80	1.0000000
NODE_5611_length_1059_cov_16.630208	412	492	0	80	80	1.0000000
NODE_5611_length_1059_cov_16.630208	465	552	0	87	87	1.0000000
NODE_5611_length_1059_cov_16.630208	548	628	0	80	80	1.0000000
NODE_5611_length_1059_cov_16.630208	601	681	0	80	80	1.0000000
NODE_5621_length_1058_cov_60.155370	395	475	1	80	80	1.0000000
NODE_5621_length_1058_cov_60.155370	448	528	1	66	80	0.8250000
NODE_5621_length_1058_cov_60.155370	448	528	2	14	80	0.1750000
NODE_5621_length_1058_cov_60.155370	524	604	1	68	80	0.8500000
NODE_5621_length_1058_cov_60.155370	524	604	2	12	80	0.1500000
NODE_5621_length_1058_cov_60.155370	577	657	1	21	80	0.2625000
NODE_5621_length_1058_cov_60.155370	577	657	2	59	80	0.7375000
NODE_5622_length_1058_cov_31.253389	475	555	3	4	80	0.0500000
NODE_5622_length_1058_cov_31.253389	475	555	4	1	80	0.0125000
NODE_5622_length_1058_cov_31.253389	475	555	6	2	80	0.0250000
NODE_5622_length_1058_cov_31.253389	475	555	7	2	80	0.0250000
NODE_5622_length_1058_cov_31.253389	475	555	9	17	80	0.2125000
NODE_5622_length_1058_cov_31.253389	475	555	10	26	80	0.3250000
NODE_5622_length_1058_cov_31.253389	475	555	11	23	80	0.2875000
NODE_5622_length_1058_cov_31.253389	475	555	12	5	80	0.0625000
NODE_5622_length_1058_cov_31.253389	475	555	3	4	80	0.0500000
NODE_5622_length_1058_cov_31.253389	475	555	4	1	80	0.0125000
NODE_5622_length_1058_cov_31.253389	475	555	6	2	80	0.0250000
NODE_5622_length_1058_cov_31.253389	475	555	7	2	80	0.0250000
NODE_5622_length_1058_cov_31.253389	475	555	9	17	80	0.2125000
NODE_5622_length_1058_cov_31.253389	475	555	10	26	80	0.3250000
NODE_5622_length_1058_cov_31.253389	475	555	11	23	80	0.2875000
NODE_5622_length_1058_cov_31.253389	475	555	12	5	80	0.0625000
NODE_5622_length_1058_cov_31.253389	528	608	0	38	80	0.4750000
NODE_5622_length_1058_cov_31.253389	528	608	1	5	80	0.0625000
NODE_5622_length_1058_cov_31.253389	528	608	2	6	80	0.0750000
NODE_5622_length_1058_cov_31.253389	528	608	3	8	80	0.1000000
NODE_5622_length_1058_cov_31.253389	528	608	4	1	80	0.0125000
NODE_5622_length_1058_cov_31.253389	528	608	6	2	80	0.0250000
NODE_5622_length_1058_cov_31.253389	528	608	7	2	80	0.0250000
NODE_5622_length_1058_cov_31.253389	528	608	9	17	80	0.2125000
NODE_5622_length_1058_cov_31.253389	528	608	10	1	80	0.0125000
NODE_5622_length_1058_cov_31.253389	533	608	0	38	75	0.5066667
NODE_5622_length_1058_cov_31.253389	533	608	1	5	75	0.0666667
NODE_5622_length_1058_cov_31.253389	533	608	2	6	75	0.0800000
NODE_5622_length_1058_cov_31.253389	533	608	3	8	75	0.1066667
NODE_5622_length_1058_cov_31.253389	533	608	4	1	75	0.0133333
NODE_5622_length_1058_cov_31.253389	533	608	6	2	75	0.0266667
NODE_5622_length_1058_cov_31.253389	533	608	7	2	75	0.0266667
NODE_5622_length_1058_cov_31.253389	533	608	9	13	75	0.1733333
NODE_5623_length_1058_cov_24.520334	264	344	1	80	80	1.0000000
NODE_5623_length_1058_cov_24.520334	317	397	1	80	80	1.0000000
NODE_5624_length_1058_cov_24.211679	297	377	3	55	80	0.6875000
NODE_5624_length_1058_cov_24.211679	297	377	5	25	80	0.3125000
NODE_5624_length_1058_cov_24.211679	350	430	3	61	80	0.7625000
NODE_5624_length_1058_cov_24.211679	350	430	4	19	80	0.2375000
NODE_5625_length_1058_cov_18.100104	454	534	0	21	80	0.2625000
NODE_5625_length_1058_cov_18.100104	454	534	1	33	80	0.4125000
NODE_5625_length_1058_cov_18.100104	454	534	3	25	80	0.3125000
NODE_5625_length_1058_cov_18.100104	454	534	5	1	80	0.0125000
NODE_5625_length_1058_cov_18.100104	507	587	1	1	80	0.0125000
NODE_5625_length_1058_cov_18.100104	507	587	3	25	80	0.3125000
NODE_5625_length_1058_cov_18.100104	507	587	5	54	80	0.6750000
NODE_5626_length_1058_cov_11.645464	476	556	0	80	80	1.0000000
NODE_5626_length_1058_cov_11.645464	529	609	0	80	80	1.0000000
NODE_5627_length_1058_cov_9.953076	621	712	0	91	91	1.0000000
NODE_5627_length_1058_cov_9.953076	685	765	0	80	80	1.0000000
NODE_5628_length_1058_cov_6.294056	819	899	0	29	80	0.3625000
NODE_5628_length_1058_cov_6.294056	819	899	2	51	80	0.6375000
NODE_5628_length_1058_cov_6.294056	875	952	2	77	77	1.0000000
NODE_5637_length_1057_cov_43.191023	413	493	1	10	80	0.1250000
NODE_5637_length_1057_cov_43.191023	413	493	2	16	80	0.2000000
NODE_5637_length_1057_cov_43.191023	413	493	3	6	80	0.0750000
NODE_5637_length_1057_cov_43.191023	413	493	4	48	80	0.6000000
NODE_5637_length_1057_cov_43.191023	466	546	4	54	80	0.6750000
NODE_5637_length_1057_cov_43.191023	466	546	5	26	80	0.3250000
NODE_5637_length_1057_cov_43.191023	542	622	1	27	80	0.3375000
NODE_5637_length_1057_cov_43.191023	542	622	2	6	80	0.0750000
NODE_5637_length_1057_cov_43.191023	542	622	3	14	80	0.1750000
NODE_5637_length_1057_cov_43.191023	542	622	4	30	80	0.3750000
NODE_5637_length_1057_cov_43.191023	542	622	5	3	80	0.0375000
NODE_5637_length_1057_cov_43.191023	595	675	1	30	80	0.3750000
NODE_5637_length_1057_cov_43.191023	595	675	2	19	80	0.2375000
NODE_5637_length_1057_cov_43.191023	595	675	3	31	80	0.3875000
NODE_5638_length_1057_cov_27.387265	486	566	0	80	80	1.0000000
NODE_5638_length_1057_cov_27.387265	539	619	0	80	80	1.0000000
NODE_5639_length_1057_cov_16.489562	416	496	0	21	80	0.2625000
NODE_5639_length_1057_cov_16.489562	416	496	1	59	80	0.7375000
NODE_5639_length_1057_cov_16.489562	469	549	1	80	80	1.0000000
NODE_5640_length_1057_cov_13.605428	631	711	6	59	80	0.7375000
NODE_5640_length_1057_cov_13.605428	631	711	7	11	80	0.1375000
NODE_5640_length_1057_cov_13.605428	631	711	8	10	80	0.1250000
NODE_5640_length_1057_cov_13.605428	684	764	2	7	80	0.0875000
NODE_5640_length_1057_cov_13.605428	684	764	3	2	80	0.0250000
NODE_5640_length_1057_cov_13.605428	684	764	4	3	80	0.0375000
NODE_5640_length_1057_cov_13.605428	684	764	5	6	80	0.0750000
NODE_5640_length_1057_cov_13.605428	684	764	6	24	80	0.3000000
NODE_5640_length_1057_cov_13.605428	684	764	7	11	80	0.1375000
NODE_5640_length_1057_cov_13.605428	684	764	8	27	80	0.3375000
NODE_5641_length_1057_cov_12.768267	518	598	0	21	80	0.2625000
NODE_5641_length_1057_cov_12.768267	518	598	2	59	80	0.7375000
NODE_5641_length_1057_cov_12.768267	571	651	0	5	80	0.0625000
NODE_5641_length_1057_cov_12.768267	571	651	2	75	80	0.9375000
NODE_5644_length_1057_cov_7.692067	706	786	0	27	80	0.3375000
NODE_5644_length_1057_cov_7.692067	706	786	1	53	80	0.6625000
NODE_5644_length_1057_cov_7.692067	759	839	0	23	80	0.2875000
NODE_5644_length_1057_cov_7.692067	759	839	1	18	80	0.2250000
NODE_5644_length_1057_cov_7.692067	759	839	2	5	80	0.0625000
NODE_5644_length_1057_cov_7.692067	759	839	3	10	80	0.1250000
NODE_5644_length_1057_cov_7.692067	759	839	4	24	80	0.3000000
NODE_5645_length_1057_cov_6.697286	561	641	0	80	80	1.0000000
NODE_5645_length_1057_cov_6.697286	614	694	0	40	80	0.5000000
NODE_5645_length_1057_cov_6.697286	614	694	1	28	80	0.3500000
NODE_5645_length_1057_cov_6.697286	614	694	2	12	80	0.1500000
NODE_5654_length_1056_cov_57.539185	462	542	2	3	80	0.0375000
NODE_5654_length_1056_cov_57.539185	462	542	3	30	80	0.3750000
NODE_5654_length_1056_cov_57.539185	462	542	4	4	80	0.0500000
NODE_5654_length_1056_cov_57.539185	462	542	5	43	80	0.5375000
NODE_5654_length_1056_cov_57.539185	515	595	4	57	80	0.7125000
NODE_5654_length_1056_cov_57.539185	515	595	5	23	80	0.2875000
NODE_5655_length_1056_cov_35.751306	421	501	1	6	80	0.0750000
NODE_5655_length_1056_cov_35.751306	421	501	2	36	80	0.4500000
NODE_5655_length_1056_cov_35.751306	421	501	3	38	80	0.4750000
NODE_5655_length_1056_cov_35.751306	474	554	2	62	80	0.7750000
NODE_5655_length_1056_cov_35.751306	474	554	3	18	80	0.2250000
NODE_5656_length_1056_cov_29.749216	415	490	10	6	75	0.0800000
NODE_5656_length_1056_cov_29.749216	415	490	11	19	75	0.2533333
NODE_5656_length_1056_cov_29.749216	415	490	12	17	75	0.2266667
NODE_5656_length_1056_cov_29.749216	415	490	14	4	75	0.0533333
NODE_5656_length_1056_cov_29.749216	415	490	15	18	75	0.2400000
NODE_5656_length_1056_cov_29.749216	415	490	16	1	75	0.0133333
NODE_5656_length_1056_cov_29.749216	415	490	17	5	75	0.0666667
NODE_5656_length_1056_cov_29.749216	415	490	18	5	75	0.0666667
NODE_5656_length_1056_cov_29.749216	416	495	10	5	79	0.0632911
NODE_5656_length_1056_cov_29.749216	416	495	11	19	79	0.2405063
NODE_5656_length_1056_cov_29.749216	416	495	12	17	79	0.2151899
NODE_5656_length_1056_cov_29.749216	416	495	14	4	79	0.0506329
NODE_5656_length_1056_cov_29.749216	416	495	15	18	79	0.2278481
NODE_5656_length_1056_cov_29.749216	416	495	16	1	79	0.0126582
NODE_5656_length_1056_cov_29.749216	416	495	17	10	79	0.1265823
NODE_5656_length_1056_cov_29.749216	416	495	18	5	79	0.0632911
NODE_5656_length_1056_cov_29.749216	448	495	10	5	47	0.1063830
NODE_5656_length_1056_cov_29.749216	448	495	12	4	47	0.0851064
NODE_5656_length_1056_cov_29.749216	448	495	14	4	47	0.0851064
NODE_5656_length_1056_cov_29.749216	448	495	15	18	47	0.3829787
NODE_5656_length_1056_cov_29.749216	448	495	16	1	47	0.0212766
NODE_5656_length_1056_cov_29.749216	448	495	17	10	47	0.2127660
NODE_5656_length_1056_cov_29.749216	448	495	18	5	47	0.1063830
NODE_5656_length_1056_cov_29.749216	468	548	15	11	80	0.1375000
NODE_5656_length_1056_cov_29.749216	468	548	16	1	80	0.0125000
NODE_5656_length_1056_cov_29.749216	468	548	17	10	80	0.1250000
NODE_5656_length_1056_cov_29.749216	468	548	18	11	80	0.1375000
NODE_5656_length_1056_cov_29.749216	468	548	19	12	80	0.1500000
NODE_5656_length_1056_cov_29.749216	468	548	20	15	80	0.1875000
NODE_5656_length_1056_cov_29.749216	468	548	21	20	80	0.2500000
NODE_5656_length_1056_cov_29.749216	468	548	15	11	80	0.1375000
NODE_5656_length_1056_cov_29.749216	468	548	16	1	80	0.0125000
NODE_5656_length_1056_cov_29.749216	468	548	17	10	80	0.1250000
NODE_5656_length_1056_cov_29.749216	468	548	18	11	80	0.1375000
NODE_5656_length_1056_cov_29.749216	468	548	19	12	80	0.1500000
NODE_5656_length_1056_cov_29.749216	468	548	20	15	80	0.1875000
NODE_5656_length_1056_cov_29.749216	468	548	21	20	80	0.2500000
NODE_5656_length_1056_cov_29.749216	468	548	15	11	80	0.1375000
NODE_5656_length_1056_cov_29.749216	468	548	16	1	80	0.0125000
NODE_5656_length_1056_cov_29.749216	468	548	17	10	80	0.1250000
NODE_5656_length_1056_cov_29.749216	468	548	18	11	80	0.1375000
NODE_5656_length_1056_cov_29.749216	468	548	19	12	80	0.1500000
NODE_5656_length_1056_cov_29.749216	468	548	20	15	80	0.1875000
NODE_5656_length_1056_cov_29.749216	468	548	21	20	80	0.2500000
NODE_5657_length_1056_cov_25.342738	297	377	0	1	80	0.0125000
NODE_5657_length_1056_cov_25.342738	297	377	1	64	80	0.8000000
NODE_5657_length_1056_cov_25.342738	297	377	2	15	80	0.1875000
NODE_5657_length_1056_cov_25.342738	350	430	1	12	80	0.1500000
NODE_5657_length_1056_cov_25.342738	350	430	2	63	80	0.7875000
NODE_5657_length_1056_cov_25.342738	350	430	3	5	80	0.0625000
NODE_5657_length_1056_cov_25.342738	426	506	2	56	80	0.7000000
NODE_5657_length_1056_cov_25.342738	426	506	3	24	80	0.3000000
NODE_5657_length_1056_cov_25.342738	479	559	2	72	80	0.9000000
NODE_5657_length_1056_cov_25.342738	479	559	3	8	80	0.1000000
NODE_5658_length_1056_cov_24.094044	535	615	3	12	80	0.1500000
NODE_5658_length_1056_cov_24.094044	535	615	5	52	80	0.6500000
NODE_5658_length_1056_cov_24.094044	535	615	6	16	80	0.2000000
NODE_5658_length_1056_cov_24.094044	588	668	2	14	80	0.1750000
NODE_5658_length_1056_cov_24.094044	588	668	3	51	80	0.6375000
NODE_5658_length_1056_cov_24.094044	588	668	5	14	80	0.1750000
NODE_5658_length_1056_cov_24.094044	588	668	6	1	80	0.0125000
NODE_5659_length_1056_cov_20.700104	570	650	3	7	80	0.0875000
NODE_5659_length_1056_cov_20.700104	570	650	5	3	80	0.0375000
NODE_5659_length_1056_cov_20.700104	570	650	7	2	80	0.0250000
NODE_5659_length_1056_cov_20.700104	570	650	8	3	80	0.0375000
NODE_5659_length_1056_cov_20.700104	570	650	10	16	80	0.2000000
NODE_5659_length_1056_cov_20.700104	570	650	11	2	80	0.0250000
NODE_5659_length_1056_cov_20.700104	570	650	12	45	80	0.5625000
NODE_5659_length_1056_cov_20.700104	570	650	13	2	80	0.0250000
NODE_5659_length_1056_cov_20.700104	623	703	6	20	80	0.2500000
NODE_5659_length_1056_cov_20.700104	623	703	8	9	80	0.1125000
NODE_5659_length_1056_cov_20.700104	623	703	10	5	80	0.0625000
NODE_5659_length_1056_cov_20.700104	623	703	12	41	80	0.5125000
NODE_5659_length_1056_cov_20.700104	623	703	13	5	80	0.0625000
NODE_5660_length_1056_cov_14.215256	349	429	0	80	80	1.0000000
NODE_5660_length_1056_cov_14.215256	402	482	0	74	80	0.9250000
NODE_5660_length_1056_cov_14.215256	402	482	1	1	80	0.0125000
NODE_5660_length_1056_cov_14.215256	402	482	2	5	80	0.0625000
NODE_5660_length_1056_cov_14.215256	478	558	2	80	80	1.0000000
NODE_5660_length_1056_cov_14.215256	531	611	0	38	80	0.4750000
NODE_5660_length_1056_cov_14.215256	531	611	2	42	80	0.5250000
NODE_5661_length_1056_cov_13.782654	563	643	0	80	80	1.0000000
NODE_5661_length_1056_cov_13.782654	616	696	0	80	80	1.0000000
NODE_5663_length_1056_cov_9.298851	373	453	1	30	80	0.3750000
NODE_5663_length_1056_cov_9.298851	373	453	2	44	80	0.5500000
NODE_5663_length_1056_cov_9.298851	373	453	3	6	80	0.0750000
NODE_5663_length_1056_cov_9.298851	426	503	2	21	77	0.2727273
NODE_5663_length_1056_cov_9.298851	426	503	3	47	77	0.6103896
NODE_5663_length_1056_cov_9.298851	426	503	4	9	77	0.1168831
NODE_5665_length_1056_cov_6.157785	396	476	0	8	80	0.1000000
NODE_5665_length_1056_cov_6.157785	396	476	2	72	80	0.9000000
NODE_5665_length_1056_cov_6.157785	449	529	0	61	80	0.7625000
NODE_5665_length_1056_cov_6.157785	449	529	2	19	80	0.2375000
NODE_5666_length_1056_cov_6.034483	287	367	1	23	80	0.2875000
NODE_5666_length_1056_cov_6.034483	287	367	3	13	80	0.1625000
NODE_5666_length_1056_cov_6.034483	287	367	4	4	80	0.0500000
NODE_5666_length_1056_cov_6.034483	287	367	5	16	80	0.2000000
NODE_5666_length_1056_cov_6.034483	287	367	6	24	80	0.3000000
NODE_5666_length_1056_cov_6.034483	340	420	5	69	80	0.8625000
NODE_5666_length_1056_cov_6.034483	340	420	6	11	80	0.1375000
NODE_5667_length_1056_cov_3.259143	371	410	1	39	39	1.0000000
NODE_5667_length_1056_cov_3.259143	424	463	0	39	39	1.0000000
NODE_5668_length_1056_cov_2.362591	234	314	2	2	80	0.0250000
NODE_5668_length_1056_cov_2.362591	234	314	3	10	80	0.1250000
NODE_5668_length_1056_cov_2.362591	234	314	4	24	80	0.3000000
NODE_5668_length_1056_cov_2.362591	234	314	5	22	80	0.2750000
NODE_5668_length_1056_cov_2.362591	234	314	7	6	80	0.0750000
NODE_5668_length_1056_cov_2.362591	234	314	8	1	80	0.0125000
NODE_5668_length_1056_cov_2.362591	234	314	9	15	80	0.1875000
NODE_5672_length_1055_cov_36.460251	468	548	8	40	80	0.5000000
NODE_5672_length_1055_cov_36.460251	468	548	9	13	80	0.1625000
NODE_5672_length_1055_cov_36.460251	468	548	10	27	80	0.3375000
NODE_5672_length_1055_cov_36.460251	521	601	5	8	80	0.1000000
NODE_5672_length_1055_cov_36.460251	521	601	6	2	80	0.0250000
NODE_5672_length_1055_cov_36.460251	521	601	8	15	80	0.1875000
NODE_5672_length_1055_cov_36.460251	521	601	9	10	80	0.1250000
NODE_5672_length_1055_cov_36.460251	521	601	10	45	80	0.5625000
NODE_5673_length_1055_cov_31.235356	502	582	0	80	80	1.0000000
NODE_5673_length_1055_cov_31.235356	555	635	0	80	80	1.0000000
NODE_5674_length_1055_cov_23.330544	403	483	0	3	80	0.0375000
NODE_5674_length_1055_cov_23.330544	403	483	1	21	80	0.2625000
NODE_5674_length_1055_cov_23.330544	403	483	2	3	80	0.0375000
NODE_5674_length_1055_cov_23.330544	403	483	3	7	80	0.0875000
NODE_5674_length_1055_cov_23.330544	403	483	4	46	80	0.5750000
NODE_5674_length_1055_cov_23.330544	456	536	4	54	80	0.6750000
NODE_5674_length_1055_cov_23.330544	456	536	6	26	80	0.3250000
NODE_5674_length_1055_cov_23.330544	532	612	2	25	80	0.3125000
NODE_5674_length_1055_cov_23.330544	532	612	3	7	80	0.0875000
NODE_5674_length_1055_cov_23.330544	532	612	4	3	80	0.0375000
NODE_5674_length_1055_cov_23.330544	532	612	5	14	80	0.1750000
NODE_5674_length_1055_cov_23.330544	532	612	6	31	80	0.3875000
NODE_5674_length_1055_cov_23.330544	585	665	0	46	80	0.5750000
NODE_5674_length_1055_cov_23.330544	585	665	2	32	80	0.4000000
NODE_5674_length_1055_cov_23.330544	585	665	3	2	80	0.0250000
NODE_5675_length_1055_cov_19.541841	321	401	1	28	80	0.3500000
NODE_5675_length_1055_cov_19.541841	321	401	2	52	80	0.6500000
NODE_5675_length_1055_cov_19.541841	374	454	1	67	80	0.8375000
NODE_5675_length_1055_cov_19.541841	374	454	2	13	80	0.1625000
NODE_5676_length_1055_cov_15.744770	525	605	2	29	80	0.3625000
NODE_5676_length_1055_cov_15.744770	525	605	3	17	80	0.2125000
NODE_5676_length_1055_cov_15.744770	525	605	4	25	80	0.3125000
NODE_5676_length_1055_cov_15.744770	525	605	5	9	80	0.1125000
NODE_5676_length_1055_cov_15.744770	578	658	4	33	80	0.4125000
NODE_5676_length_1055_cov_15.744770	578	658	5	43	80	0.5375000
NODE_5676_length_1055_cov_15.744770	578	658	6	4	80	0.0500000
NODE_5677_length_1055_cov_10.729079	335	415	2	76	80	0.9500000
NODE_5677_length_1055_cov_10.729079	335	415	4	4	80	0.0500000
NODE_5677_length_1055_cov_10.729079	388	468	2	80	80	1.0000000
NODE_5678_length_1055_cov_7.525105	575	655	7	11	80	0.1375000
NODE_5678_length_1055_cov_7.525105	575	655	8	1	80	0.0125000
NODE_5678_length_1055_cov_7.525105	575	655	9	48	80	0.6000000
NODE_5678_length_1055_cov_7.525105	575	655	10	20	80	0.2500000
NODE_5678_length_1055_cov_7.525105	628	708	3	21	80	0.2625000
NODE_5678_length_1055_cov_7.525105	628	708	9	14	80	0.1750000
NODE_5678_length_1055_cov_7.525105	628	708	10	45	80	0.5625000
NODE_5688_length_1054_cov_45.920419	371	451	3	27	80	0.3375000
NODE_5688_length_1054_cov_45.920419	371	451	5	51	80	0.6375000
NODE_5688_length_1054_cov_45.920419	371	451	7	2	80	0.0250000
NODE_5688_length_1054_cov_45.920419	424	505	5	56	81	0.6913580
NODE_5688_length_1054_cov_45.920419	424	505	6	17	81	0.2098765
NODE_5688_length_1054_cov_45.920419	424	505	7	8	81	0.0987654
NODE_5689_length_1054_cov_30.545550	499	578	2	9	79	0.1139240
NODE_5689_length_1054_cov_30.545550	499	578	3	20	79	0.2531646
NODE_5689_length_1054_cov_30.545550	499	578	4	50	79	0.6329114
NODE_5689_length_1054_cov_30.545550	552	631	1	4	79	0.0506329
NODE_5689_length_1054_cov_30.545550	552	631	2	58	79	0.7341772
NODE_5689_length_1054_cov_30.545550	552	631	3	17	79	0.2151899
NODE_5689_length_1054_cov_30.545550	627	707	1	44	80	0.5500000
NODE_5689_length_1054_cov_30.545550	627	707	2	36	80	0.4500000
NODE_5689_length_1054_cov_30.545550	680	760	1	9	80	0.1125000
NODE_5689_length_1054_cov_30.545550	680	760	2	71	80	0.8875000
NODE_5690_length_1054_cov_16.606283	347	427	1	80	80	1.0000000
NODE_5690_length_1054_cov_16.606283	400	480	1	34	80	0.4250000
NODE_5690_length_1054_cov_16.606283	400	480	2	46	80	0.5750000
NODE_5691_length_1054_cov_11.637696	244	316	3	18	72	0.2500000
NODE_5691_length_1054_cov_11.637696	244	316	5	2	72	0.0277778
NODE_5691_length_1054_cov_11.637696	244	316	6	46	72	0.6388889
NODE_5691_length_1054_cov_11.637696	244	316	7	6	72	0.0833333
NODE_5691_length_1054_cov_11.637696	312	392	4	1	80	0.0125000
NODE_5691_length_1054_cov_11.637696	312	392	5	74	80	0.9250000
NODE_5691_length_1054_cov_11.637696	312	392	6	5	80	0.0625000
NODE_5691_length_1054_cov_11.637696	365	445	1	29	80	0.3625000
NODE_5691_length_1054_cov_11.637696	365	445	2	2	80	0.0250000
NODE_5691_length_1054_cov_11.637696	365	445	3	3	80	0.0375000
NODE_5691_length_1054_cov_11.637696	365	445	5	46	80	0.5750000
NODE_5692_length_1054_cov_10.381152	493	573	0	14	80	0.1750000
NODE_5692_length_1054_cov_10.381152	493	573	2	25	80	0.3125000
NODE_5692_length_1054_cov_10.381152	493	573	3	41	80	0.5125000
NODE_5692_length_1054_cov_10.381152	546	626	3	80	80	1.0000000
NODE_5703_length_1053_cov_57.660377	445	527	2	82	82	1.0000000
NODE_5703_length_1053_cov_57.660377	500	580	1	9	80	0.1125000
NODE_5703_length_1053_cov_57.660377	500	580	2	71	80	0.8875000
NODE_5704_length_1053_cov_33.518868	329	409	1	80	80	1.0000000
NODE_5704_length_1053_cov_33.518868	382	462	0	49	80	0.6125000
NODE_5704_length_1053_cov_33.518868	382	462	1	31	80	0.3875000
NODE_5704_length_1053_cov_33.518868	458	538	0	68	80	0.8500000
NODE_5704_length_1053_cov_33.518868	458	538	1	12	80	0.1500000
NODE_5704_length_1053_cov_33.518868	511	591	0	15	80	0.1875000
NODE_5704_length_1053_cov_33.518868	511	591	1	14	80	0.1750000
NODE_5704_length_1053_cov_33.518868	511	591	2	51	80	0.6375000
NODE_5705_length_1053_cov_32.412998	375	455	1	6	80	0.0750000
NODE_5705_length_1053_cov_32.412998	375	455	2	74	80	0.9250000
NODE_5705_length_1053_cov_32.412998	428	508	2	31	80	0.3875000
NODE_5705_length_1053_cov_32.412998	428	508	3	23	80	0.2875000
NODE_5705_length_1053_cov_32.412998	428	508	4	24	80	0.3000000
NODE_5705_length_1053_cov_32.412998	428	508	5	2	80	0.0250000
NODE_5705_length_1053_cov_32.412998	504	584	3	2	80	0.0250000
NODE_5705_length_1053_cov_32.412998	504	584	4	53	80	0.6625000
NODE_5705_length_1053_cov_32.412998	504	584	5	25	80	0.3125000
NODE_5705_length_1053_cov_32.412998	557	637	0	38	80	0.4750000
NODE_5705_length_1053_cov_32.412998	557	637	2	7	80	0.0875000
NODE_5705_length_1053_cov_32.412998	557	637	4	35	80	0.4375000
NODE_5706_length_1053_cov_26.545073	456	536	3	32	80	0.4000000
NODE_5706_length_1053_cov_26.545073	456	536	4	17	80	0.2125000
NODE_5706_length_1053_cov_26.545073	456	536	5	29	80	0.3625000
NODE_5706_length_1053_cov_26.545073	456	536	7	2	80	0.0250000
NODE_5706_length_1053_cov_26.545073	509	589	5	29	80	0.3625000
NODE_5706_length_1053_cov_26.545073	509	589	6	25	80	0.3125000
NODE_5706_length_1053_cov_26.545073	509	589	7	26	80	0.3250000
NODE_5706_length_1053_cov_26.545073	585	665	4	8	80	0.1000000
NODE_5706_length_1053_cov_26.545073	585	665	5	60	80	0.7500000
NODE_5706_length_1053_cov_26.545073	585	665	6	12	80	0.1500000
NODE_5706_length_1053_cov_26.545073	638	718	2	34	80	0.4250000
NODE_5706_length_1053_cov_26.545073	638	718	4	10	80	0.1250000
NODE_5706_length_1053_cov_26.545073	638	718	5	36	80	0.4500000
NODE_5707_length_1053_cov_20.346960	543	623	1	11	80	0.1375000
NODE_5707_length_1053_cov_20.346960	543	623	2	69	80	0.8625000
NODE_5707_length_1053_cov_20.346960	596	677	0	7	81	0.0864198
NODE_5707_length_1053_cov_20.346960	596	677	1	58	81	0.7160494
NODE_5707_length_1053_cov_20.346960	596	677	2	16	81	0.1975309
NODE_5708_length_1053_cov_11.655136	393	473	0	7	80	0.0875000
NODE_5708_length_1053_cov_11.655136	393	473	1	52	80	0.6500000
NODE_5708_length_1053_cov_11.655136	393	473	2	21	80	0.2625000
NODE_5708_length_1053_cov_11.655136	446	526	1	6	80	0.0750000
NODE_5708_length_1053_cov_11.655136	446	526	2	74	80	0.9250000
NODE_5710_length_1053_cov_4.771488	84	149	5	10	65	0.1538462
NODE_5710_length_1053_cov_4.771488	84	149	6	45	65	0.6923077
NODE_5710_length_1053_cov_4.771488	84	149	7	10	65	0.1538462
NODE_5718_length_1052_cov_18.469045	448	528	0	80	80	1.0000000
NODE_5718_length_1052_cov_18.469045	501	581	0	80	80	1.0000000
NODE_5719_length_1052_cov_13.136411	425	505	0	16	80	0.2000000
NODE_5719_length_1052_cov_13.136411	425	505	2	6	80	0.0750000
NODE_5719_length_1052_cov_13.136411	425	505	4	58	80	0.7250000
NODE_5719_length_1052_cov_13.136411	478	558	4	80	80	1.0000000
NODE_5722_length_1052_cov_3.082896	607	687	0	80	80	1.0000000
NODE_5722_length_1052_cov_3.082896	660	740	0	80	80	1.0000000
NODE_5729_length_1051_cov_34.868697	472	552	8	8	80	0.1000000
NODE_5729_length_1051_cov_34.868697	472	552	9	1	80	0.0125000
NODE_5729_length_1051_cov_34.868697	472	552	11	18	80	0.2250000
NODE_5729_length_1051_cov_34.868697	472	552	12	36	80	0.4500000
NODE_5729_length_1051_cov_34.868697	472	552	13	12	80	0.1500000
NODE_5729_length_1051_cov_34.868697	472	552	14	5	80	0.0625000
NODE_5729_length_1051_cov_34.868697	525	605	8	1	80	0.0125000
NODE_5729_length_1051_cov_34.868697	525	605	9	9	80	0.1125000
NODE_5729_length_1051_cov_34.868697	525	605	10	4	80	0.0500000
NODE_5729_length_1051_cov_34.868697	525	605	11	11	80	0.1375000
NODE_5729_length_1051_cov_34.868697	525	605	12	24	80	0.3000000
NODE_5729_length_1051_cov_34.868697	525	605	13	26	80	0.3250000
NODE_5729_length_1051_cov_34.868697	525	605	14	5	80	0.0625000
NODE_5730_length_1051_cov_19.446429	549	629	5	13	80	0.1625000
NODE_5730_length_1051_cov_19.446429	549	629	6	60	80	0.7500000
NODE_5730_length_1051_cov_19.446429	549	629	7	7	80	0.0875000
NODE_5730_length_1051_cov_19.446429	602	682	3	39	80	0.4875000
NODE_5730_length_1051_cov_19.446429	602	682	4	2	80	0.0250000
NODE_5730_length_1051_cov_19.446429	602	682	5	25	80	0.3125000
NODE_5730_length_1051_cov_19.446429	602	682	6	14	80	0.1750000
NODE_5731_length_1051_cov_4.022059	600	680	1	75	80	0.9375000
NODE_5731_length_1051_cov_4.022059	600	680	2	5	80	0.0625000
NODE_5736_length_1050_cov_31.556257	429	509	2	15	80	0.1875000
NODE_5736_length_1050_cov_31.556257	429	509	4	7	80	0.0875000
NODE_5736_length_1050_cov_31.556257	429	509	5	43	80	0.5375000
NODE_5736_length_1050_cov_31.556257	429	509	6	15	80	0.1875000
NODE_5736_length_1050_cov_31.556257	482	562	4	23	80	0.2875000
NODE_5736_length_1050_cov_31.556257	482	562	5	57	80	0.7125000
NODE_5736_length_1050_cov_31.556257	558	638	2	35	80	0.4375000
NODE_5736_length_1050_cov_31.556257	558	638	4	36	80	0.4500000
NODE_5736_length_1050_cov_31.556257	558	638	6	9	80	0.1125000
NODE_5736_length_1050_cov_31.556257	611	691	2	76	80	0.9500000
NODE_5736_length_1050_cov_31.556257	611	691	4	4	80	0.0500000
NODE_5737_length_1050_cov_16.337539	398	478	0	80	80	1.0000000
NODE_5737_length_1050_cov_16.337539	451	531	0	40	80	0.5000000
NODE_5737_length_1050_cov_16.337539	451	531	2	40	80	0.5000000
NODE_5738_length_1050_cov_13.290221	507	587	2	15	80	0.1875000
NODE_5738_length_1050_cov_13.290221	507	587	3	65	80	0.8125000
NODE_5738_length_1050_cov_13.290221	560	640	1	14	80	0.1750000
NODE_5738_length_1050_cov_13.290221	560	640	3	66	80	0.8250000
NODE_5739_length_1050_cov_11.389064	532	612	2	80	80	1.0000000
NODE_5739_length_1050_cov_11.389064	585	665	0	5	80	0.0625000
NODE_5739_length_1050_cov_11.389064	585	665	1	46	80	0.5750000
NODE_5739_length_1050_cov_11.389064	585	665	2	29	80	0.3625000
NODE_5740_length_1050_cov_11.091483	259	321	4	51	62	0.8225806
NODE_5740_length_1050_cov_11.091483	259	321	5	11	62	0.1774193
NODE_5740_length_1050_cov_11.091483	294	374	0	7	80	0.0875000
NODE_5740_length_1050_cov_11.091483	294	374	1	2	80	0.0250000
NODE_5740_length_1050_cov_11.091483	294	374	2	1	80	0.0125000
NODE_5740_length_1050_cov_11.091483	294	374	3	21	80	0.2625000
NODE_5740_length_1050_cov_11.091483	294	374	4	49	80	0.6125000
NODE_5740_length_1050_cov_11.091483	370	450	0	80	80	1.0000000
NODE_5740_length_1050_cov_11.091483	423	503	0	29	80	0.3625000
NODE_5740_length_1050_cov_11.091483	423	503	2	51	80	0.6375000
NODE_5742_length_1050_cov_2.201893	928	990	1	62	62	1.0000000
NODE_5742_length_1050_cov_2.201893	981	1043	0	42	62	0.6774194
NODE_5742_length_1050_cov_2.201893	981	1043	1	20	62	0.3225806
NODE_5748_length_1050_cov_1.241851	935	990	10	2	55	0.0363636
NODE_5748_length_1050_cov_1.241851	935	990	12	2	55	0.0363636
NODE_5748_length_1050_cov_1.241851	935	990	14	38	55	0.6909091
NODE_5748_length_1050_cov_1.241851	935	990	16	13	55	0.2363636
NODE_5748_length_1050_cov_1.241851	956	1036	8	6	80	0.0750000
NODE_5748_length_1050_cov_1.241851	956	1036	10	13	80	0.1625000
NODE_5748_length_1050_cov_1.241851	956	1036	12	1	80	0.0125000
NODE_5748_length_1050_cov_1.241851	956	1036	14	47	80	0.5875000
NODE_5748_length_1050_cov_1.241851	956	1036	16	13	80	0.1625000
NODE_5752_length_1049_cov_28.174737	446	526	0	20	80	0.2500000
NODE_5752_length_1049_cov_28.174737	446	526	1	13	80	0.1625000
NODE_5752_length_1049_cov_28.174737	446	526	2	42	80	0.5250000
NODE_5752_length_1049_cov_28.174737	446	526	3	5	80	0.0625000
NODE_5752_length_1049_cov_28.174737	499	579	2	22	80	0.2750000
NODE_5752_length_1049_cov_28.174737	499	579	3	58	80	0.7250000
NODE_5753_length_1049_cov_23.186316	389	469	1	31	80	0.3875000
NODE_5753_length_1049_cov_23.186316	389	469	2	21	80	0.2625000
NODE_5753_length_1049_cov_23.186316	389	469	3	8	80	0.1000000
NODE_5753_length_1049_cov_23.186316	389	469	4	20	80	0.2500000
NODE_5753_length_1049_cov_23.186316	442	522	3	7	80	0.0875000
NODE_5753_length_1049_cov_23.186316	442	522	4	73	80	0.9125000
NODE_5753_length_1049_cov_23.186316	518	595	3	12	77	0.1558442
NODE_5753_length_1049_cov_23.186316	518	595	4	31	77	0.4025974
NODE_5753_length_1049_cov_23.186316	518	595	5	34	77	0.4415585
NODE_5753_length_1049_cov_23.186316	568	648	2	23	80	0.2875000
NODE_5753_length_1049_cov_23.186316	568	648	3	37	80	0.4625000
NODE_5753_length_1049_cov_23.186316	568	648	4	5	80	0.0625000
NODE_5753_length_1049_cov_23.186316	568	648	5	15	80	0.1875000
NODE_5754_length_1049_cov_21.097895	532	612	0	80	80	1.0000000
NODE_5754_length_1049_cov_21.097895	585	665	0	80	80	1.0000000
NODE_5755_length_1049_cov_18.964211	375	466	2	65	91	0.7142857
NODE_5755_length_1049_cov_18.964211	375	466	4	26	91	0.2857143
NODE_5755_length_1049_cov_18.964211	439	519	1	4	80	0.0500000
NODE_5755_length_1049_cov_18.964211	439	519	2	1	80	0.0125000
NODE_5755_length_1049_cov_18.964211	439	519	3	1	80	0.0125000
NODE_5755_length_1049_cov_18.964211	439	519	4	74	80	0.9250000
NODE_5755_length_1049_cov_18.964211	515	595	0	75	80	0.9375000
NODE_5755_length_1049_cov_18.964211	515	595	1	5	80	0.0625000
NODE_5755_length_1049_cov_18.964211	568	648	0	80	80	1.0000000
NODE_5756_length_1049_cov_18.075789	437	517	0	80	80	1.0000000
NODE_5756_length_1049_cov_18.075789	490	570	0	48	80	0.6000000
NODE_5756_length_1049_cov_18.075789	490	570	2	9	80	0.1125000
NODE_5756_length_1049_cov_18.075789	490	570	3	12	80	0.1500000
NODE_5756_length_1049_cov_18.075789	490	570	4	11	80	0.1375000
NODE_5756_length_1049_cov_18.075789	566	644	4	78	78	1.0000000
NODE_5756_length_1049_cov_18.075789	620	695	2	27	75	0.3600000
NODE_5756_length_1049_cov_18.075789	620	695	4	48	75	0.6400000
NODE_5757_length_1049_cov_16.194737	569	650	1	14	81	0.1728395
NODE_5757_length_1049_cov_16.194737	569	650	2	19	81	0.2345679
NODE_5757_length_1049_cov_16.194737	569	650	3	31	81	0.3827161
NODE_5757_length_1049_cov_16.194737	569	650	4	17	81	0.2098765
NODE_5757_length_1049_cov_16.194737	623	703	1	67	80	0.8375000
NODE_5757_length_1049_cov_16.194737	623	703	2	13	80	0.1625000
NODE_5757_length_1049_cov_16.194737	699	779	0	45	80	0.5625000
NODE_5757_length_1049_cov_16.194737	699	779	1	35	80	0.4375000
NODE_5757_length_1049_cov_16.194737	752	832	0	80	80	1.0000000
NODE_5759_length_1049_cov_6.323158	588	668	0	80	80	1.0000000
NODE_5759_length_1049_cov_6.323158	641	721	0	80	80	1.0000000
NODE_5770_length_1048_cov_73.887250	535	615	2	2	80	0.0250000
NODE_5770_length_1048_cov_73.887250	535	615	3	7	80	0.0875000
NODE_5770_length_1048_cov_73.887250	535	615	4	19	80	0.2375000
NODE_5770_length_1048_cov_73.887250	535	615	5	12	80	0.1500000
NODE_5770_length_1048_cov_73.887250	535	615	6	5	80	0.0625000
NODE_5770_length_1048_cov_73.887250	535	615	7	16	80	0.2000000
NODE_5770_length_1048_cov_73.887250	535	615	8	7	80	0.0875000
NODE_5770_length_1048_cov_73.887250	535	615	9	12	80	0.1500000
NODE_5770_length_1048_cov_73.887250	588	668	7	8	80	0.1000000
NODE_5770_length_1048_cov_73.887250	588	668	8	7	80	0.0875000
NODE_5770_length_1048_cov_73.887250	588	668	9	27	80	0.3375000
NODE_5770_length_1048_cov_73.887250	588	668	10	10	80	0.1250000
NODE_5770_length_1048_cov_73.887250	588	668	11	28	80	0.3500000
NODE_5770_length_1048_cov_73.887250	664	744	5	14	80	0.1750000
NODE_5770_length_1048_cov_73.887250	664	744	6	5	80	0.0625000
NODE_5770_length_1048_cov_73.887250	664	744	7	12	80	0.1500000
NODE_5770_length_1048_cov_73.887250	664	744	8	19	80	0.2375000
NODE_5770_length_1048_cov_73.887250	664	744	9	7	80	0.0875000
NODE_5770_length_1048_cov_73.887250	664	744	10	21	80	0.2625000
NODE_5770_length_1048_cov_73.887250	664	744	11	2	80	0.0250000
NODE_5770_length_1048_cov_73.887250	717	797	0	2	80	0.0250000
NODE_5770_length_1048_cov_73.887250	717	797	1	8	80	0.1000000
NODE_5770_length_1048_cov_73.887250	717	797	2	7	80	0.0875000
NODE_5770_length_1048_cov_73.887250	717	797	3	27	80	0.3375000
NODE_5770_length_1048_cov_73.887250	717	797	4	7	80	0.0875000
NODE_5770_length_1048_cov_73.887250	717	797	5	16	80	0.2000000
NODE_5770_length_1048_cov_73.887250	717	797	6	5	80	0.0625000
NODE_5770_length_1048_cov_73.887250	717	797	7	8	80	0.1000000
NODE_5770_length_1048_cov_73.887250	899	979	0	12	80	0.1500000
NODE_5770_length_1048_cov_73.887250	899	979	2	68	80	0.8500000
NODE_5771_length_1048_cov_48.242360	407	487	0	2	80	0.0250000
NODE_5771_length_1048_cov_48.242360	407	487	1	45	80	0.5625000
NODE_5771_length_1048_cov_48.242360	407	487	2	33	80	0.4125000
NODE_5771_length_1048_cov_48.242360	460	540	0	55	80	0.6875000
NODE_5771_length_1048_cov_48.242360	460	540	1	25	80	0.3125000
NODE_5771_length_1048_cov_48.242360	536	616	0	80	80	1.0000000
NODE_5771_length_1048_cov_48.242360	589	669	0	28	80	0.3500000
NODE_5771_length_1048_cov_48.242360	589	669	2	52	80	0.6500000
NODE_5772_length_1048_cov_38.430980	352	432	1	7	80	0.0875000
NODE_5772_length_1048_cov_38.430980	352	432	4	19	80	0.2375000
NODE_5772_length_1048_cov_38.430980	352	432	5	54	80	0.6750000
NODE_5772_length_1048_cov_38.430980	405	485	3	13	80	0.1625000
NODE_5772_length_1048_cov_38.430980	405	485	4	25	80	0.3125000
NODE_5772_length_1048_cov_38.430980	405	485	5	42	80	0.5250000
NODE_5773_length_1048_cov_28.179136	548	628	0	39	80	0.4875000
NODE_5773_length_1048_cov_28.179136	548	628	2	41	80	0.5125000
NODE_5773_length_1048_cov_28.179136	601	681	0	80	80	1.0000000
NODE_5773_length_1048_cov_28.179136	677	757	0	9	80	0.1125000
NODE_5773_length_1048_cov_28.179136	677	757	2	71	80	0.8875000
NODE_5773_length_1048_cov_28.179136	730	810	0	28	80	0.3500000
NODE_5773_length_1048_cov_28.179136	730	810	2	52	80	0.6500000
NODE_5774_length_1048_cov_22.985248	409	489	1	36	80	0.4500000
NODE_5774_length_1048_cov_22.985248	409	489	2	44	80	0.5500000
NODE_5774_length_1048_cov_22.985248	462	542	2	80	80	1.0000000
NODE_5774_length_1048_cov_22.985248	538	618	0	23	80	0.2875000
NODE_5774_length_1048_cov_22.985248	538	618	1	41	80	0.5125000
NODE_5774_length_1048_cov_22.985248	538	618	2	16	80	0.2000000
NODE_5774_length_1048_cov_22.985248	591	671	0	76	80	0.9500000
NODE_5774_length_1048_cov_22.985248	591	671	1	4	80	0.0500000
NODE_5775_length_1048_cov_17.883035	500	580	0	80	80	1.0000000
NODE_5775_length_1048_cov_17.883035	553	633	0	80	80	1.0000000
NODE_5776_length_1048_cov_17.444679	377	457	0	8	80	0.1000000
NODE_5776_length_1048_cov_17.444679	377	457	2	72	80	0.9000000
NODE_5776_length_1048_cov_17.444679	430	510	0	4	80	0.0500000
NODE_5776_length_1048_cov_17.444679	430	510	2	76	80	0.9500000
NODE_5777_length_1048_cov_13.387777	518	598	1	14	80	0.1750000
NODE_5777_length_1048_cov_13.387777	518	598	2	14	80	0.1750000
NODE_5777_length_1048_cov_13.387777	518	598	3	11	80	0.1375000
NODE_5777_length_1048_cov_13.387777	518	598	4	41	80	0.5125000
NODE_5777_length_1048_cov_13.387777	571	651	4	80	80	1.0000000
NODE_5778_length_1048_cov_12.934668	716	796	0	80	80	1.0000000
NODE_5778_length_1048_cov_12.934668	769	849	0	64	80	0.8000000
NODE_5778_length_1048_cov_12.934668	769	849	1	16	80	0.2000000
NODE_5778_length_1048_cov_12.934668	845	925	1	21	80	0.2625000
NODE_5778_length_1048_cov_12.934668	845	925	2	59	80	0.7375000
NODE_5778_length_1048_cov_12.934668	898	975	2	77	77	1.0000000
NODE_5779_length_1048_cov_12.712329	330	410	0	80	80	1.0000000
NODE_5779_length_1048_cov_12.712329	384	463	0	79	79	1.0000000
NODE_5779_length_1048_cov_12.712329	459	539	0	49	80	0.6125000
NODE_5779_length_1048_cov_12.712329	459	539	1	31	80	0.3875000
NODE_5779_length_1048_cov_12.712329	512	592	1	80	80	1.0000000
NODE_5780_length_1048_cov_9.232877	305	355	1	2	50	0.0400000
NODE_5780_length_1048_cov_9.232877	305	355	2	48	50	0.9600000
NODE_5786_length_1047_cov_79.917722	540	620	6	13	80	0.1625000
NODE_5786_length_1047_cov_79.917722	540	620	7	9	80	0.1125000
NODE_5786_length_1047_cov_79.917722	540	620	8	26	80	0.3250000
NODE_5786_length_1047_cov_79.917722	540	620	9	22	80	0.2750000
NODE_5786_length_1047_cov_79.917722	540	620	10	8	80	0.1000000
NODE_5786_length_1047_cov_79.917722	540	620	11	1	80	0.0125000
NODE_5786_length_1047_cov_79.917722	540	620	12	1	80	0.0125000
NODE_5786_length_1047_cov_79.917722	593	673	2	2	80	0.0250000
NODE_5786_length_1047_cov_79.917722	593	673	4	18	80	0.2250000
NODE_5786_length_1047_cov_79.917722	593	673	8	59	80	0.7375000
NODE_5786_length_1047_cov_79.917722	593	673	10	1	80	0.0125000
NODE_5787_length_1047_cov_28.527426	582	662	0	9	80	0.1125000
NODE_5787_length_1047_cov_28.527426	582	662	2	71	80	0.8875000
NODE_5787_length_1047_cov_28.527426	635	715	0	28	80	0.3500000
NODE_5787_length_1047_cov_28.527426	635	715	2	52	80	0.6500000
NODE_5788_length_1047_cov_26.068565	372	452	3	5	80	0.0625000
NODE_5788_length_1047_cov_26.068565	372	452	4	73	80	0.9125000
NODE_5788_length_1047_cov_26.068565	372	452	5	2	80	0.0250000
NODE_5788_length_1047_cov_26.068565	425	505	3	20	80	0.2500000
NODE_5788_length_1047_cov_26.068565	425	505	4	41	80	0.5125000
NODE_5788_length_1047_cov_26.068565	425	505	5	19	80	0.2375000
NODE_5789_length_1047_cov_25.946203	424	504	2	48	80	0.6000000
NODE_5789_length_1047_cov_25.946203	424	504	3	19	80	0.2375000
NODE_5789_length_1047_cov_25.946203	424	504	4	13	80	0.1625000
NODE_5789_length_1047_cov_25.946203	477	557	2	31	80	0.3875000
NODE_5789_length_1047_cov_25.946203	477	557	3	41	80	0.5125000
NODE_5789_length_1047_cov_25.946203	477	557	4	8	80	0.1000000
NODE_5790_length_1047_cov_19.255274	458	538	0	1	80	0.0125000
NODE_5790_length_1047_cov_19.255274	458	538	1	17	80	0.2125000
NODE_5790_length_1047_cov_19.255274	458	538	3	1	80	0.0125000
NODE_5790_length_1047_cov_19.255274	458	538	4	41	80	0.5125000
NODE_5790_length_1047_cov_19.255274	458	538	5	7	80	0.0875000
NODE_5790_length_1047_cov_19.255274	458	538	7	13	80	0.1625000
NODE_5790_length_1047_cov_19.255274	511	591	4	7	80	0.0875000
NODE_5790_length_1047_cov_19.255274	511	591	5	7	80	0.0875000
NODE_5790_length_1047_cov_19.255274	511	591	7	66	80	0.8250000
NODE_5791_length_1047_cov_16.618143	467	547	1	12	80	0.1500000
NODE_5791_length_1047_cov_16.618143	467	547	2	68	80	0.8500000
NODE_5791_length_1047_cov_16.618143	520	600	1	56	80	0.7000000
NODE_5791_length_1047_cov_16.618143	520	600	2	24	80	0.3000000
NODE_5792_length_1047_cov_14.246835	643	723	1	35	80	0.4375000
NODE_5792_length_1047_cov_14.246835	643	723	2	15	80	0.1875000
NODE_5792_length_1047_cov_14.246835	643	723	3	30	80	0.3750000
NODE_5792_length_1047_cov_14.246835	696	776	3	80	80	1.0000000
NODE_5793_length_1047_cov_9.869198	414	494	1	80	80	1.0000000
NODE_5793_length_1047_cov_9.869198	467	547	1	80	80	1.0000000
NODE_5794_length_1047_cov_8.513713	300	380	0	16	80	0.2000000
NODE_5794_length_1047_cov_8.513713	300	380	2	64	80	0.8000000
NODE_5794_length_1047_cov_8.513713	353	433	0	45	80	0.5625000
NODE_5794_length_1047_cov_8.513713	353	433	1	24	80	0.3000000
NODE_5794_length_1047_cov_8.513713	353	433	2	11	80	0.1375000
NODE_5795_length_1047_cov_7.412447	442	522	0	29	80	0.3625000
NODE_5795_length_1047_cov_7.412447	442	522	1	51	80	0.6375000
NODE_5795_length_1047_cov_7.412447	495	575	0	14	80	0.1750000
NODE_5795_length_1047_cov_7.412447	495	575	1	66	80	0.8250000
NODE_5803_length_1046_cov_41.392819	587	667	2	25	80	0.3125000
NODE_5803_length_1046_cov_41.392819	587	667	3	5	80	0.0625000
NODE_5803_length_1046_cov_41.392819	587	667	4	50	80	0.6250000
NODE_5803_length_1046_cov_41.392819	640	720	4	80	80	1.0000000
NODE_5804_length_1046_cov_30.317846	382	462	6	19	80	0.2375000
NODE_5804_length_1046_cov_30.317846	382	462	7	41	80	0.5125000
NODE_5804_length_1046_cov_30.317846	382	462	8	20	80	0.2500000
NODE_5804_length_1046_cov_30.317846	435	515	2	3	80	0.0375000
NODE_5804_length_1046_cov_30.317846	435	515	3	2	80	0.0250000
NODE_5804_length_1046_cov_30.317846	435	515	4	1	80	0.0125000
NODE_5804_length_1046_cov_30.317846	435	515	5	26	80	0.3250000
NODE_5804_length_1046_cov_30.317846	435	515	6	38	80	0.4750000
NODE_5804_length_1046_cov_30.317846	435	515	8	10	80	0.1250000
NODE_5805_length_1046_cov_28.184794	346	426	3	18	80	0.2250000
NODE_5805_length_1046_cov_28.184794	346	426	4	62	80	0.7750000
NODE_5805_length_1046_cov_28.184794	399	479	2	30	80	0.3750000
NODE_5805_length_1046_cov_28.184794	399	479	3	12	80	0.1500000
NODE_5805_length_1046_cov_28.184794	399	479	4	38	80	0.4750000
NODE_5806_length_1046_cov_24.595565	501	581	0	4	80	0.0500000
NODE_5806_length_1046_cov_24.595565	501	581	2	76	80	0.9500000
NODE_5806_length_1046_cov_24.595565	554	634	0	14	80	0.1750000
NODE_5806_length_1046_cov_24.595565	554	634	2	66	80	0.8250000
NODE_5807_length_1046_cov_17.958817	447	527	5	15	80	0.1875000
NODE_5807_length_1046_cov_17.958817	447	527	6	14	80	0.1750000
NODE_5807_length_1046_cov_17.958817	447	527	7	40	80	0.5000000
NODE_5807_length_1046_cov_17.958817	447	527	8	1	80	0.0125000
NODE_5807_length_1046_cov_17.958817	447	527	9	10	80	0.1250000
NODE_5807_length_1046_cov_17.958817	500	580	5	15	80	0.1875000
NODE_5807_length_1046_cov_17.958817	500	580	6	12	80	0.1500000
NODE_5807_length_1046_cov_17.958817	500	580	7	42	80	0.5250000
NODE_5807_length_1046_cov_17.958817	500	580	8	1	80	0.0125000
NODE_5807_length_1046_cov_17.958817	500	580	9	10	80	0.1250000
NODE_5808_length_1046_cov_15.494192	385	465	2	21	80	0.2625000
NODE_5808_length_1046_cov_15.494192	385	465	3	48	80	0.6000000
NODE_5808_length_1046_cov_15.494192	385	465	4	11	80	0.1375000
NODE_5808_length_1046_cov_15.494192	438	518	2	24	80	0.3000000
NODE_5808_length_1046_cov_15.494192	438	518	3	56	80	0.7000000
NODE_5809_length_1046_cov_12.639916	554	634	5	50	80	0.6250000
NODE_5809_length_1046_cov_12.639916	554	634	6	30	80	0.3750000
NODE_5809_length_1046_cov_12.639916	607	687	1	28	80	0.3500000
NODE_5809_length_1046_cov_12.639916	607	687	2	14	80	0.1750000
NODE_5809_length_1046_cov_12.639916	607	687	4	3	80	0.0375000
NODE_5809_length_1046_cov_12.639916	607	687	5	32	80	0.4000000
NODE_5809_length_1046_cov_12.639916	607	687	6	3	80	0.0375000
NODE_5810_length_1046_cov_11.238648	471	551	0	33	80	0.4125000
NODE_5810_length_1046_cov_11.238648	471	551	1	47	80	0.5875000
NODE_5810_length_1046_cov_11.238648	524	604	1	80	80	1.0000000
NODE_5811_length_1046_cov_10.744456	459	539	1	39	80	0.4875000
NODE_5811_length_1046_cov_10.744456	459	539	2	41	80	0.5125000
NODE_5811_length_1046_cov_10.744456	512	592	0	9	80	0.1125000
NODE_5811_length_1046_cov_10.744456	512	592	1	71	80	0.8875000
NODE_5812_length_1046_cov_8.689546	302	382	3	12	80	0.1500000
NODE_5812_length_1046_cov_8.689546	302	382	4	2	80	0.0250000
NODE_5812_length_1046_cov_8.689546	302	382	5	31	80	0.3875000
NODE_5812_length_1046_cov_8.689546	302	382	6	35	80	0.4375000
NODE_5812_length_1046_cov_8.689546	355	435	3	2	80	0.0250000
NODE_5812_length_1046_cov_8.689546	355	435	4	14	80	0.1750000
NODE_5812_length_1046_cov_8.689546	355	435	5	64	80	0.8000000
NODE_5823_length_1045_cov_75.975687	359	440	1	25	81	0.3086420
NODE_5823_length_1045_cov_75.975687	359	440	2	44	81	0.5432099
NODE_5823_length_1045_cov_75.975687	359	440	3	12	81	0.1481481
NODE_5823_length_1045_cov_75.975687	412	493	2	81	81	1.0000000
NODE_5823_length_1045_cov_75.975687	489	569	2	17	80	0.2125000
NODE_5823_length_1045_cov_75.975687	489	569	3	9	80	0.1125000
NODE_5823_length_1045_cov_75.975687	489	569	4	17	80	0.2125000
NODE_5823_length_1045_cov_75.975687	489	569	5	21	80	0.2625000
NODE_5823_length_1045_cov_75.975687	489	569	7	16	80	0.2000000
NODE_5823_length_1045_cov_75.975687	542	622	3	1	80	0.0125000
NODE_5823_length_1045_cov_75.975687	542	622	5	10	80	0.1250000
NODE_5823_length_1045_cov_75.975687	542	622	7	69	80	0.8625000
NODE_5824_length_1045_cov_54.419662	434	514	1	14	80	0.1750000
NODE_5824_length_1045_cov_54.419662	434	514	2	34	80	0.4250000
NODE_5824_length_1045_cov_54.419662	434	514	3	14	80	0.1750000
NODE_5824_length_1045_cov_54.419662	434	514	4	18	80	0.2250000
NODE_5824_length_1045_cov_54.419662	487	567	1	66	80	0.8250000
NODE_5824_length_1045_cov_54.419662	487	567	2	1	80	0.0125000
NODE_5824_length_1045_cov_54.419662	487	567	3	13	80	0.1625000
NODE_5824_length_1045_cov_54.419662	563	639	1	5	76	0.0657895
NODE_5824_length_1045_cov_54.419662	563	639	2	71	76	0.9342105
NODE_5824_length_1045_cov_54.419662	616	696	1	59	80	0.7375000
NODE_5824_length_1045_cov_54.419662	616	696	2	21	80	0.2625000
NODE_5825_length_1045_cov_23.188161	395	475	1	9	80	0.1125000
NODE_5825_length_1045_cov_23.188161	395	475	2	71	80	0.8875000
NODE_5825_length_1045_cov_23.188161	448	528	2	80	80	1.0000000
NODE_5826_length_1045_cov_19.686047	571	651	0	59	80	0.7375000
NODE_5826_length_1045_cov_19.686047	571	651	1	21	80	0.2625000
NODE_5826_length_1045_cov_19.686047	624	704	0	6	80	0.0750000
NODE_5826_length_1045_cov_19.686047	624	704	1	74	80	0.9250000
NODE_5827_length_1045_cov_19.378436	478	558	0	80	80	1.0000000
NODE_5827_length_1045_cov_19.378436	531	611	0	80	80	1.0000000
NODE_5828_length_1045_cov_17.601480	359	439	0	80	80	1.0000000
NODE_5828_length_1045_cov_17.601480	412	492	0	80	80	1.0000000
NODE_5829_length_1045_cov_17.372093	633	713	0	80	80	1.0000000
NODE_5829_length_1045_cov_17.372093	686	766	0	80	80	1.0000000
NODE_5830_length_1045_cov_14.828753	433	513	2	11	80	0.1375000
NODE_5830_length_1045_cov_14.828753	433	513	3	36	80	0.4500000
NODE_5830_length_1045_cov_14.828753	433	513	4	33	80	0.4125000
NODE_5830_length_1045_cov_14.828753	486	566	0	27	80	0.3375000
NODE_5830_length_1045_cov_14.828753	486	566	2	5	80	0.0625000
NODE_5830_length_1045_cov_14.828753	486	566	3	48	80	0.6000000
NODE_5831_length_1045_cov_11.673362	664	744	1	68	80	0.8500000
NODE_5831_length_1045_cov_11.673362	664	744	2	12	80	0.1500000
NODE_5831_length_1045_cov_11.673362	717	797	1	21	80	0.2625000
NODE_5831_length_1045_cov_11.673362	717	797	2	59	80	0.7375000
NODE_5843_length_1044_cov_42.600000	344	424	1	13	80	0.1625000
NODE_5843_length_1044_cov_42.600000	344	424	2	21	80	0.2625000
NODE_5843_length_1044_cov_42.600000	344	424	3	46	80	0.5750000
NODE_5843_length_1044_cov_42.600000	397	477	2	44	80	0.5500000
NODE_5843_length_1044_cov_42.600000	397	477	3	36	80	0.4500000
NODE_5844_length_1044_cov_27.653968	454	534	5	25	80	0.3125000
NODE_5844_length_1044_cov_27.653968	454	534	6	3	80	0.0375000
NODE_5844_length_1044_cov_27.653968	454	534	8	15	80	0.1875000
NODE_5844_length_1044_cov_27.653968	454	534	10	21	80	0.2625000
NODE_5844_length_1044_cov_27.653968	454	534	11	9	80	0.1125000
NODE_5844_length_1044_cov_27.653968	454	534	12	7	80	0.0875000
NODE_5844_length_1044_cov_27.653968	507	587	7	2	80	0.0250000
NODE_5844_length_1044_cov_27.653968	507	587	8	8	80	0.1000000
NODE_5844_length_1044_cov_27.653968	507	587	9	8	80	0.1000000
NODE_5844_length_1044_cov_27.653968	507	587	10	27	80	0.3375000
NODE_5844_length_1044_cov_27.653968	507	587	11	20	80	0.2500000
NODE_5844_length_1044_cov_27.653968	507	587	12	15	80	0.1875000
NODE_5845_length_1044_cov_24.561905	297	375	0	78	78	1.0000000
NODE_5845_length_1044_cov_24.561905	348	428	0	31	80	0.3875000
NODE_5845_length_1044_cov_24.561905	348	428	2	49	80	0.6125000
NODE_5845_length_1044_cov_24.561905	424	504	0	31	80	0.3875000
NODE_5845_length_1044_cov_24.561905	424	504	2	49	80	0.6125000
NODE_5845_length_1044_cov_24.561905	477	557	0	80	80	1.0000000
NODE_5846_length_1044_cov_23.720635	294	374	1	17	80	0.2125000
NODE_5846_length_1044_cov_23.720635	294	374	2	63	80	0.7875000
NODE_5846_length_1044_cov_23.720635	347	427	1	28	80	0.3500000
NODE_5846_length_1044_cov_23.720635	347	427	2	52	80	0.6500000
NODE_5846_length_1044_cov_23.720635	423	503	1	12	80	0.1500000
NODE_5846_length_1044_cov_23.720635	423	503	2	4	80	0.0500000
NODE_5846_length_1044_cov_23.720635	423	503	3	26	80	0.3250000
NODE_5846_length_1044_cov_23.720635	423	503	4	38	80	0.4750000
NODE_5846_length_1044_cov_23.720635	476	556	4	41	80	0.5125000
NODE_5846_length_1044_cov_23.720635	476	556	6	39	80	0.4875000
NODE_5847_length_1044_cov_20.871958	462	542	4	10	80	0.1250000
NODE_5847_length_1044_cov_20.871958	462	542	5	20	80	0.2500000
NODE_5847_length_1044_cov_20.871958	462	542	6	50	80	0.6250000
NODE_5847_length_1044_cov_20.871958	515	595	3	5	80	0.0625000
NODE_5847_length_1044_cov_20.871958	515	595	4	49	80	0.6125000
NODE_5847_length_1044_cov_20.871958	515	595	5	5	80	0.0625000
NODE_5847_length_1044_cov_20.871958	515	595	6	21	80	0.2625000
NODE_5847_length_1044_cov_20.871958	591	671	3	39	80	0.4875000
NODE_5847_length_1044_cov_20.871958	591	671	4	32	80	0.4000000
NODE_5847_length_1044_cov_20.871958	591	671	5	9	80	0.1125000
NODE_5847_length_1044_cov_20.871958	644	724	2	22	80	0.2750000
NODE_5847_length_1044_cov_20.871958	644	724	3	58	80	0.7250000
NODE_5848_length_1044_cov_18.596825	433	513	3	18	80	0.2250000
NODE_5848_length_1044_cov_18.596825	433	513	4	62	80	0.7750000
NODE_5848_length_1044_cov_18.596825	486	566	0	5	80	0.0625000
NODE_5848_length_1044_cov_18.596825	486	566	1	45	80	0.5625000
NODE_5848_length_1044_cov_18.596825	486	566	3	21	80	0.2625000
NODE_5848_length_1044_cov_18.596825	486	566	4	9	80	0.1125000
NODE_5849_length_1044_cov_16.102646	414	494	0	44	80	0.5500000
NODE_5849_length_1044_cov_16.102646	414	494	1	13	80	0.1625000
NODE_5849_length_1044_cov_16.102646	414	494	2	23	80	0.2875000
NODE_5849_length_1044_cov_16.102646	467	547	0	4	80	0.0500000
NODE_5849_length_1044_cov_16.102646	467	547	2	76	80	0.9500000
NODE_5850_length_1044_cov_12.156614	578	658	1	10	80	0.1250000
NODE_5850_length_1044_cov_12.156614	578	658	2	70	80	0.8750000
NODE_5850_length_1044_cov_12.156614	631	711	2	80	80	1.0000000
NODE_5851_length_1044_cov_10.661376	506	586	3	15	80	0.1875000
NODE_5851_length_1044_cov_10.661376	506	586	4	35	80	0.4375000
NODE_5851_length_1044_cov_10.661376	506	586	5	30	80	0.3750000
NODE_5851_length_1044_cov_10.661376	559	639	3	5	80	0.0625000
NODE_5851_length_1044_cov_10.661376	559	639	4	51	80	0.6375000
NODE_5851_length_1044_cov_10.661376	559	639	5	24	80	0.3000000
NODE_5852_length_1044_cov_9.534392	461	541	0	70	80	0.8750000
NODE_5852_length_1044_cov_9.534392	461	541	1	10	80	0.1250000
NODE_5852_length_1044_cov_9.534392	514	594	0	17	80	0.2125000
NODE_5852_length_1044_cov_9.534392	514	594	1	63	80	0.7875000
NODE_5853_length_1044_cov_5.517460	434	514	0	80	80	1.0000000
NODE_5853_length_1044_cov_5.517460	487	567	0	80	80	1.0000000
NODE_5856_length_1044_cov_1.502646	769	845	0	40	76	0.5263158
NODE_5856_length_1044_cov_1.502646	769	845	2	36	76	0.4736842
NODE_5860_length_1043_cov_42.288136	452	532	6	4	80	0.0500000
NODE_5860_length_1043_cov_42.288136	452	532	7	1	80	0.0125000
NODE_5860_length_1043_cov_42.288136	452	532	9	12	80	0.1500000
NODE_5860_length_1043_cov_42.288136	452	532	10	37	80	0.4625000
NODE_5860_length_1043_cov_42.288136	452	532	12	26	80	0.3250000
NODE_5860_length_1043_cov_42.288136	505	585	5	9	80	0.1125000
NODE_5860_length_1043_cov_42.288136	505	585	6	23	80	0.2875000
NODE_5860_length_1043_cov_42.288136	505	585	7	4	80	0.0500000
NODE_5860_length_1043_cov_42.288136	505	585	8	4	80	0.0500000
NODE_5860_length_1043_cov_42.288136	505	585	9	22	80	0.2750000
NODE_5860_length_1043_cov_42.288136	505	585	10	9	80	0.1125000
NODE_5860_length_1043_cov_42.288136	505	585	12	9	80	0.1125000
NODE_5861_length_1043_cov_25.987288	350	430	7	1	80	0.0125000
NODE_5861_length_1043_cov_25.987288	350	430	8	8	80	0.1000000
NODE_5861_length_1043_cov_25.987288	350	430	9	15	80	0.1875000
NODE_5861_length_1043_cov_25.987288	350	430	10	11	80	0.1375000
NODE_5861_length_1043_cov_25.987288	350	430	11	1	80	0.0125000
NODE_5861_length_1043_cov_25.987288	350	430	12	8	80	0.1000000
NODE_5861_length_1043_cov_25.987288	350	430	13	14	80	0.1750000
NODE_5861_length_1043_cov_25.987288	350	430	14	12	80	0.1500000
NODE_5861_length_1043_cov_25.987288	350	430	15	10	80	0.1250000
NODE_5861_length_1043_cov_25.987288	403	483	9	6	80	0.0750000
NODE_5861_length_1043_cov_25.987288	403	483	10	8	80	0.1000000
NODE_5861_length_1043_cov_25.987288	403	483	11	33	80	0.4125000
NODE_5861_length_1043_cov_25.987288	403	483	12	4	80	0.0500000
NODE_5861_length_1043_cov_25.987288	403	483	13	12	80	0.1500000
NODE_5861_length_1043_cov_25.987288	403	483	14	4	80	0.0500000
NODE_5861_length_1043_cov_25.987288	403	483	15	13	80	0.1625000
NODE_5861_length_1043_cov_25.987288	479	559	10	22	80	0.2750000
NODE_5861_length_1043_cov_25.987288	479	559	11	8	80	0.1000000
NODE_5861_length_1043_cov_25.987288	479	559	14	11	80	0.1375000
NODE_5861_length_1043_cov_25.987288	479	559	16	3	80	0.0375000
NODE_5861_length_1043_cov_25.987288	479	559	17	3	80	0.0375000
NODE_5861_length_1043_cov_25.987288	479	559	18	2	80	0.0250000
NODE_5861_length_1043_cov_25.987288	479	559	19	16	80	0.2000000
NODE_5861_length_1043_cov_25.987288	479	559	20	8	80	0.1000000
NODE_5861_length_1043_cov_25.987288	479	559	21	2	80	0.0250000
NODE_5861_length_1043_cov_25.987288	479	559	22	2	80	0.0250000
NODE_5861_length_1043_cov_25.987288	479	559	23	3	80	0.0375000
NODE_5861_length_1043_cov_25.987288	532	612	16	16	80	0.2000000
NODE_5861_length_1043_cov_25.987288	532	612	17	14	80	0.1750000
NODE_5861_length_1043_cov_25.987288	532	612	18	14	80	0.1750000
NODE_5861_length_1043_cov_25.987288	532	612	19	24	80	0.3000000
NODE_5861_length_1043_cov_25.987288	532	612	20	5	80	0.0625000
NODE_5861_length_1043_cov_25.987288	532	612	21	2	80	0.0250000
NODE_5861_length_1043_cov_25.987288	532	612	22	2	80	0.0250000
NODE_5861_length_1043_cov_25.987288	532	612	23	3	80	0.0375000
NODE_5862_length_1043_cov_20.838983	561	641	2	1	80	0.0125000
NODE_5862_length_1043_cov_20.838983	561	641	3	79	80	0.9875000
NODE_5862_length_1043_cov_20.838983	614	694	2	1	80	0.0125000
NODE_5862_length_1043_cov_20.838983	614	694	3	79	80	0.9875000
NODE_5863_length_1043_cov_20.312500	489	569	2	67	80	0.8375000
NODE_5863_length_1043_cov_20.312500	489	569	4	13	80	0.1625000
NODE_5863_length_1043_cov_20.312500	542	622	2	59	80	0.7375000
NODE_5863_length_1043_cov_20.312500	542	622	4	21	80	0.2625000
NODE_5864_length_1043_cov_16.320975	569	649	4	80	80	1.0000000
NODE_5864_length_1043_cov_16.320975	622	702	0	8	80	0.1000000
NODE_5864_length_1043_cov_16.320975	622	702	2	39	80	0.4875000
NODE_5864_length_1043_cov_16.320975	622	702	4	33	80	0.4125000
NODE_5865_length_1043_cov_11.176907	521	601	0	17	80	0.2125000
NODE_5865_length_1043_cov_11.176907	521	601	1	2	80	0.0250000
NODE_5865_length_1043_cov_11.176907	521	601	2	54	80	0.6750000
NODE_5865_length_1043_cov_11.176907	521	601	3	7	80	0.0875000
NODE_5865_length_1043_cov_11.176907	574	654	2	20	80	0.2500000
NODE_5865_length_1043_cov_11.176907	574	654	3	34	80	0.4250000
NODE_5865_length_1043_cov_11.176907	574	654	4	26	80	0.3250000
NODE_5866_length_1043_cov_8.146186	530	596	7	3	66	0.0454545
NODE_5866_length_1043_cov_8.146186	530	596	8	28	66	0.4242424
NODE_5866_length_1043_cov_8.146186	530	596	10	35	66	0.5303030
NODE_5866_length_1043_cov_8.146186	569	649	3	15	80	0.1875000
NODE_5866_length_1043_cov_8.146186	569	649	5	2	80	0.0250000
NODE_5866_length_1043_cov_8.146186	569	649	6	1	80	0.0125000
NODE_5866_length_1043_cov_8.146186	569	649	7	38	80	0.4750000
NODE_5866_length_1043_cov_8.146186	569	649	8	24	80	0.3000000
NODE_5868_length_1043_cov_5.347458	646	726	0	80	80	1.0000000
NODE_5868_length_1043_cov_5.347458	699	779	0	80	80	1.0000000
NODE_5879_length_1042_cov_242.728526	820	900	243	1	80	0.0125000
NODE_5879_length_1042_cov_242.728526	820	900	246	1	80	0.0125000
NODE_5879_length_1042_cov_242.728526	820	900	247	2	80	0.0250000
NODE_5879_length_1042_cov_242.728526	820	900	248	1	80	0.0125000
NODE_5879_length_1042_cov_242.728526	820	900	249	2	80	0.0250000
NODE_5879_length_1042_cov_242.728526	820	900	250	1	80	0.0125000
NODE_5879_length_1042_cov_242.728526	820	900	255	1	80	0.0125000
NODE_5879_length_1042_cov_242.728526	820	900	256	1	80	0.0125000
NODE_5879_length_1042_cov_242.728526	820	900	257	2	80	0.0250000
NODE_5879_length_1042_cov_242.728526	820	900	258	2	80	0.0250000
NODE_5879_length_1042_cov_242.728526	820	900	259	1	80	0.0125000
NODE_5879_length_1042_cov_242.728526	820	900	261	3	80	0.0375000
NODE_5879_length_1042_cov_242.728526	820	900	262	4	80	0.0500000
NODE_5879_length_1042_cov_242.728526	820	900	263	2	80	0.0250000
NODE_5879_length_1042_cov_242.728526	820	900	264	1	80	0.0125000
NODE_5879_length_1042_cov_242.728526	820	900	265	1	80	0.0125000
NODE_5879_length_1042_cov_242.728526	820	900	270	1	80	0.0125000
NODE_5879_length_1042_cov_242.728526	820	900	271	2	80	0.0250000
NODE_5879_length_1042_cov_242.728526	820	900	272	2	80	0.0250000
NODE_5879_length_1042_cov_242.728526	820	900	273	1	80	0.0125000
NODE_5879_length_1042_cov_242.728526	820	900	274	1	80	0.0125000
NODE_5879_length_1042_cov_242.728526	820	900	275	1	80	0.0125000
NODE_5879_length_1042_cov_242.728526	820	900	286	2	80	0.0250000
NODE_5879_length_1042_cov_242.728526	820	900	289	1	80	0.0125000
NODE_5879_length_1042_cov_242.728526	820	900	290	1	80	0.0125000
NODE_5879_length_1042_cov_242.728526	820	900	294	3	80	0.0375000
NODE_5879_length_1042_cov_242.728526	820	900	295	1	80	0.0125000
NODE_5879_length_1042_cov_242.728526	820	900	296	5	80	0.0625000
NODE_5879_length_1042_cov_242.728526	820	900	297	2	80	0.0250000
NODE_5879_length_1042_cov_242.728526	820	900	298	4	80	0.0500000
NODE_5879_length_1042_cov_242.728526	820	900	299	3	80	0.0375000
NODE_5879_length_1042_cov_242.728526	820	900	300	3	80	0.0375000
NODE_5879_length_1042_cov_242.728526	820	900	301	1	80	0.0125000
NODE_5879_length_1042_cov_242.728526	820	900	303	3	80	0.0375000
NODE_5879_length_1042_cov_242.728526	820	900	306	3	80	0.0375000
NODE_5879_length_1042_cov_242.728526	820	900	307	8	80	0.1000000
NODE_5879_length_1042_cov_242.728526	820	900	308	3	80	0.0375000
NODE_5879_length_1042_cov_242.728526	820	900	309	1	80	0.0125000
NODE_5879_length_1042_cov_242.728526	820	900	310	2	80	0.0250000
NODE_5879_length_1042_cov_242.728526	873	903	295	1	30	0.0333333
NODE_5879_length_1042_cov_242.728526	873	903	296	1	30	0.0333333
NODE_5879_length_1042_cov_242.728526	873	903	299	2	30	0.0666667
NODE_5879_length_1042_cov_242.728526	873	903	300	2	30	0.0666667
NODE_5879_length_1042_cov_242.728526	873	903	301	1	30	0.0333333
NODE_5879_length_1042_cov_242.728526	873	903	303	3	30	0.1000000
NODE_5879_length_1042_cov_242.728526	873	903	304	1	30	0.0333333
NODE_5879_length_1042_cov_242.728526	873	903	306	5	30	0.1666667
NODE_5879_length_1042_cov_242.728526	873	903	307	8	30	0.2666667
NODE_5879_length_1042_cov_242.728526	873	903	308	3	30	0.1000000
NODE_5879_length_1042_cov_242.728526	873	903	309	1	30	0.0333333
NODE_5879_length_1042_cov_242.728526	873	903	310	2	30	0.0666667
NODE_5880_length_1042_cov_63.214210	355	435	0	80	80	1.0000000
NODE_5880_length_1042_cov_63.214210	408	488	0	80	80	1.0000000
NODE_5881_length_1042_cov_29.581124	497	577	2	19	80	0.2375000
NODE_5881_length_1042_cov_29.581124	497	577	3	15	80	0.1875000
NODE_5881_length_1042_cov_29.581124	497	577	4	38	80	0.4750000
NODE_5881_length_1042_cov_29.581124	497	577	5	8	80	0.1000000
NODE_5881_length_1042_cov_29.581124	550	630	4	33	80	0.4125000
NODE_5881_length_1042_cov_29.581124	550	630	5	37	80	0.4625000
NODE_5881_length_1042_cov_29.581124	550	630	6	10	80	0.1250000
NODE_5882_length_1042_cov_23.861082	519	599	1	8	80	0.1000000
NODE_5882_length_1042_cov_23.861082	519	599	3	6	80	0.0750000
NODE_5882_length_1042_cov_23.861082	519	599	4	66	80	0.8250000
NODE_5882_length_1042_cov_23.861082	572	652	4	37	80	0.4625000
NODE_5882_length_1042_cov_23.861082	572	652	5	19	80	0.2375000
NODE_5882_length_1042_cov_23.861082	572	652	6	24	80	0.3000000
NODE_5882_length_1042_cov_23.861082	648	728	6	49	80	0.6125000
NODE_5882_length_1042_cov_23.861082	648	728	7	27	80	0.3375000
NODE_5882_length_1042_cov_23.861082	648	728	10	4	80	0.0500000
NODE_5882_length_1042_cov_23.861082	701	781	4	3	80	0.0375000
NODE_5882_length_1042_cov_23.861082	701	781	5	19	80	0.2375000
NODE_5882_length_1042_cov_23.861082	701	781	6	58	80	0.7250000
NODE_5883_length_1042_cov_22.247084	555	635	0	6	80	0.0750000
NODE_5883_length_1042_cov_22.247084	555	635	2	36	80	0.4500000
NODE_5883_length_1042_cov_22.247084	555	635	3	29	80	0.3625000
NODE_5883_length_1042_cov_22.247084	555	635	4	4	80	0.0500000
NODE_5883_length_1042_cov_22.247084	555	635	6	5	80	0.0625000
NODE_5883_length_1042_cov_22.247084	608	688	0	59	80	0.7375000
NODE_5883_length_1042_cov_22.247084	608	688	2	21	80	0.2625000
NODE_5884_length_1042_cov_22.117709	335	415	1	2	80	0.0250000
NODE_5884_length_1042_cov_22.117709	335	415	2	7	80	0.0875000
NODE_5884_length_1042_cov_22.117709	335	415	3	71	80	0.8875000
NODE_5884_length_1042_cov_22.117709	388	468	0	28	80	0.3500000
NODE_5884_length_1042_cov_22.117709	388	468	2	32	80	0.4000000
NODE_5884_length_1042_cov_22.117709	388	468	3	20	80	0.2500000
NODE_5884_length_1042_cov_22.117709	464	544	0	34	80	0.4250000
NODE_5884_length_1042_cov_22.117709	464	544	1	46	80	0.5750000
NODE_5884_length_1042_cov_22.117709	517	597	1	80	80	1.0000000
NODE_5885_length_1042_cov_16.831389	27	97	0	70	70	1.0000000
NODE_5885_length_1042_cov_16.831389	372	452	4	1	80	0.0125000
NODE_5885_length_1042_cov_16.831389	372	452	5	12	80	0.1500000
NODE_5885_length_1042_cov_16.831389	372	452	7	25	80	0.3125000
NODE_5885_length_1042_cov_16.831389	372	452	9	31	80	0.3875000
NODE_5885_length_1042_cov_16.831389	372	452	10	11	80	0.1375000
NODE_5885_length_1042_cov_16.831389	425	505	4	4	80	0.0500000
NODE_5885_length_1042_cov_16.831389	425	505	5	10	80	0.1250000
NODE_5885_length_1042_cov_16.831389	425	505	8	18	80	0.2250000
NODE_5885_length_1042_cov_16.831389	425	505	9	46	80	0.5750000
NODE_5885_length_1042_cov_16.831389	425	505	10	2	80	0.0250000
NODE_5886_length_1042_cov_16.662778	416	496	2	3	80	0.0375000
NODE_5886_length_1042_cov_16.662778	416	496	3	21	80	0.2625000
NODE_5886_length_1042_cov_16.662778	416	496	4	49	80	0.6125000
NODE_5886_length_1042_cov_16.662778	416	496	5	7	80	0.0875000
NODE_5886_length_1042_cov_16.662778	469	549	3	35	80	0.4375000
NODE_5886_length_1042_cov_16.662778	469	549	4	10	80	0.1250000
NODE_5886_length_1042_cov_16.662778	469	549	5	35	80	0.4375000
NODE_5887_length_1042_cov_9.474019	361	441	2	80	80	1.0000000
NODE_5887_length_1042_cov_9.474019	414	494	0	14	80	0.1750000
NODE_5887_length_1042_cov_9.474019	414	494	1	38	80	0.4750000
NODE_5887_length_1042_cov_9.474019	414	494	2	28	80	0.3500000
NODE_5888_length_1042_cov_6.725345	356	419	1	63	63	1.0000000
NODE_5888_length_1042_cov_6.725345	392	472	0	37	80	0.4625000
NODE_5888_length_1042_cov_6.725345	392	472	1	43	80	0.5375000
NODE_5896_length_1041_cov_42.960722	335	415	2	80	80	1.0000000
NODE_5896_length_1041_cov_42.960722	388	468	0	15	80	0.1875000
NODE_5896_length_1041_cov_42.960722	388	468	1	8	80	0.1000000
NODE_5896_length_1041_cov_42.960722	388	468	2	57	80	0.7125000
NODE_5896_length_1041_cov_42.960722	464	544	0	80	80	1.0000000
NODE_5896_length_1041_cov_42.960722	517	597	0	80	80	1.0000000
NODE_5897_length_1041_cov_37.331210	513	593	1	8	80	0.1000000
NODE_5897_length_1041_cov_37.331210	513	593	2	72	80	0.9000000
NODE_5897_length_1041_cov_37.331210	566	646	1	34	80	0.4250000
NODE_5897_length_1041_cov_37.331210	566	646	2	46	80	0.5750000
NODE_5897_length_1041_cov_37.331210	642	722	0	51	80	0.6375000
NODE_5897_length_1041_cov_37.331210	642	722	1	29	80	0.3625000
NODE_5897_length_1041_cov_37.331210	695	775	0	80	80	1.0000000
NODE_5898_length_1041_cov_36.477707	455	535	6	46	80	0.5750000
NODE_5898_length_1041_cov_36.477707	455	535	8	34	80	0.4250000
NODE_5898_length_1041_cov_36.477707	508	588	6	2	80	0.0250000
NODE_5898_length_1041_cov_36.477707	508	588	7	11	80	0.1375000
NODE_5898_length_1041_cov_36.477707	508	588	8	51	80	0.6375000
NODE_5898_length_1041_cov_36.477707	508	588	10	16	80	0.2000000
NODE_5898_length_1041_cov_36.477707	584	664	5	25	80	0.3125000
NODE_5898_length_1041_cov_36.477707	584	664	6	2	80	0.0250000
NODE_5898_length_1041_cov_36.477707	584	664	7	52	80	0.6500000
NODE_5898_length_1041_cov_36.477707	584	664	8	1	80	0.0125000
NODE_5898_length_1041_cov_36.477707	637	717	2	20	80	0.2500000
NODE_5898_length_1041_cov_36.477707	637	717	5	1	80	0.0125000
NODE_5898_length_1041_cov_36.477707	637	717	6	1	80	0.0125000
NODE_5898_length_1041_cov_36.477707	637	717	7	31	80	0.3875000
NODE_5898_length_1041_cov_36.477707	637	717	8	22	80	0.2750000
NODE_5898_length_1041_cov_36.477707	637	717	9	5	80	0.0625000
NODE_5898_length_1041_cov_36.477707	753	799	2	7	46	0.1521739
NODE_5898_length_1041_cov_36.477707	753	799	8	4	46	0.0869565
NODE_5898_length_1041_cov_36.477707	753	799	9	35	46	0.7608696
NODE_5899_length_1041_cov_19.286624	468	548	0	29	80	0.3625000
NODE_5899_length_1041_cov_19.286624	468	548	1	6	80	0.0750000
NODE_5899_length_1041_cov_19.286624	468	548	2	2	80	0.0250000
NODE_5899_length_1041_cov_19.286624	468	548	3	40	80	0.5000000
NODE_5899_length_1041_cov_19.286624	468	548	4	3	80	0.0375000
NODE_5899_length_1041_cov_19.286624	521	601	3	24	80	0.3000000
NODE_5899_length_1041_cov_19.286624	521	601	4	14	80	0.1750000
NODE_5899_length_1041_cov_19.286624	521	601	5	42	80	0.5250000
NODE_5900_length_1041_cov_17.072187	578	658	3	10	80	0.1250000
NODE_5900_length_1041_cov_17.072187	578	658	4	13	80	0.1625000
NODE_5900_length_1041_cov_17.072187	578	658	5	57	80	0.7125000
NODE_5900_length_1041_cov_17.072187	631	711	0	27	80	0.3375000
NODE_5900_length_1041_cov_17.072187	631	711	2	1	80	0.0125000
NODE_5900_length_1041_cov_17.072187	631	711	4	38	80	0.4750000
NODE_5900_length_1041_cov_17.072187	631	711	5	14	80	0.1750000
NODE_5901_length_1041_cov_11.887473	437	517	1	4	80	0.0500000
NODE_5901_length_1041_cov_11.887473	437	517	3	76	80	0.9500000
NODE_5901_length_1041_cov_11.887473	490	570	0	39	80	0.4875000
NODE_5901_length_1041_cov_11.887473	490	570	1	18	80	0.2250000
NODE_5901_length_1041_cov_11.887473	490	570	3	23	80	0.2875000
NODE_5902_length_1041_cov_6.957537	354	434	1	17	80	0.2125000
NODE_5902_length_1041_cov_6.957537	354	434	2	37	80	0.4625000
NODE_5902_length_1041_cov_6.957537	354	434	3	26	80	0.3250000
NODE_5902_length_1041_cov_6.957537	407	487	1	1	80	0.0125000
NODE_5902_length_1041_cov_6.957537	407	487	2	16	80	0.2000000
NODE_5902_length_1041_cov_6.957537	407	487	3	63	80	0.7875000
NODE_5913_length_1040_cov_34.618491	478	558	5	18	80	0.2250000
NODE_5913_length_1040_cov_34.618491	478	558	6	10	80	0.1250000
NODE_5913_length_1040_cov_34.618491	478	558	7	52	80	0.6500000
NODE_5913_length_1040_cov_34.618491	531	611	3	18	80	0.2250000
NODE_5913_length_1040_cov_34.618491	531	611	5	1	80	0.0125000
NODE_5913_length_1040_cov_34.618491	531	611	6	12	80	0.1500000
NODE_5913_length_1040_cov_34.618491	531	611	7	47	80	0.5875000
NODE_5913_length_1040_cov_34.618491	531	611	8	2	80	0.0250000
NODE_5914_length_1040_cov_33.061637	485	565	2	80	80	1.0000000
NODE_5914_length_1040_cov_33.061637	538	618	1	7	80	0.0875000
NODE_5914_length_1040_cov_33.061637	538	618	2	73	80	0.9125000
NODE_5915_length_1040_cov_27.818278	402	482	1	19	80	0.2375000
NODE_5915_length_1040_cov_27.818278	402	482	2	26	80	0.3250000
NODE_5915_length_1040_cov_27.818278	402	482	3	35	80	0.4375000
NODE_5915_length_1040_cov_27.818278	455	535	0	10	80	0.1250000
NODE_5915_length_1040_cov_27.818278	455	535	2	69	80	0.8625000
NODE_5915_length_1040_cov_27.818278	455	535	3	1	80	0.0125000
NODE_5916_length_1040_cov_17.933050	487	567	1	19	80	0.2375000
NODE_5916_length_1040_cov_17.933050	487	567	2	20	80	0.2500000
NODE_5916_length_1040_cov_17.933050	487	567	3	33	80	0.4125000
NODE_5916_length_1040_cov_17.933050	487	567	4	8	80	0.1000000
NODE_5916_length_1040_cov_17.933050	540	620	3	19	80	0.2375000
NODE_5916_length_1040_cov_17.933050	540	620	4	61	80	0.7625000
NODE_5917_length_1040_cov_14.327311	237	317	2	27	80	0.3375000
NODE_5917_length_1040_cov_14.327311	237	317	3	53	80	0.6625000
NODE_5917_length_1040_cov_14.327311	290	370	3	35	80	0.4375000
NODE_5917_length_1040_cov_14.327311	290	370	4	39	80	0.4875000
NODE_5917_length_1040_cov_14.327311	290	370	5	3	80	0.0375000
NODE_5917_length_1040_cov_14.327311	290	370	6	3	80	0.0375000
NODE_5917_length_1040_cov_14.327311	366	446	4	10	80	0.1250000
NODE_5917_length_1040_cov_14.327311	366	446	5	26	80	0.3250000
NODE_5917_length_1040_cov_14.327311	366	446	6	44	80	0.5500000
NODE_5917_length_1040_cov_14.327311	419	499	2	15	80	0.1875000
NODE_5917_length_1040_cov_14.327311	419	499	3	2	80	0.0250000
NODE_5917_length_1040_cov_14.327311	419	499	4	7	80	0.0875000
NODE_5917_length_1040_cov_14.327311	419	499	5	52	80	0.6500000
NODE_5917_length_1040_cov_14.327311	419	499	6	4	80	0.0500000
NODE_5918_length_1040_cov_11.910733	369	449	0	45	80	0.5625000
NODE_5918_length_1040_cov_11.910733	369	449	1	35	80	0.4375000
NODE_5918_length_1040_cov_11.910733	422	502	1	34	80	0.4250000
NODE_5918_length_1040_cov_11.910733	422	502	3	46	80	0.5750000
NODE_5919_length_1040_cov_11.521785	355	435	0	80	80	1.0000000
NODE_5919_length_1040_cov_11.521785	408	488	0	80	80	1.0000000
NODE_5920_length_1040_cov_9.573858	632	712	0	80	80	1.0000000
NODE_5920_length_1040_cov_9.573858	685	765	0	80	80	1.0000000
NODE_5921_length_1040_cov_8.148778	349	429	3	27	80	0.3375000
NODE_5921_length_1040_cov_8.148778	349	429	4	44	80	0.5500000
NODE_5921_length_1040_cov_8.148778	349	429	5	9	80	0.1125000
NODE_5921_length_1040_cov_8.148778	402	482	3	11	80	0.1375000
NODE_5921_length_1040_cov_8.148778	402	482	4	50	80	0.6250000
NODE_5921_length_1040_cov_8.148778	402	482	5	6	80	0.0750000
NODE_5921_length_1040_cov_8.148778	402	482	6	10	80	0.1250000
NODE_5921_length_1040_cov_8.148778	402	482	7	3	80	0.0375000
NODE_5922_length_1040_cov_7.927736	282	362	0	19	80	0.2375000
NODE_5922_length_1040_cov_7.927736	282	362	1	33	80	0.4125000
NODE_5922_length_1040_cov_7.927736	282	362	2	22	80	0.2750000
NODE_5922_length_1040_cov_7.927736	282	362	3	6	80	0.0750000
NODE_5922_length_1040_cov_7.927736	335	415	2	21	80	0.2625000
NODE_5922_length_1040_cov_7.927736	335	415	3	59	80	0.7375000
NODE_5927_length_1040_cov_2.317747	2	78	0	76	76	1.0000000
NODE_5934_length_1039_cov_40.150000	487	567	1	79	80	0.9875000
NODE_5934_length_1039_cov_40.150000	487	567	2	1	80	0.0125000
NODE_5934_length_1039_cov_40.150000	540	620	1	62	80	0.7750000
NODE_5934_length_1039_cov_40.150000	540	620	2	18	80	0.2250000
NODE_5934_length_1039_cov_40.150000	616	696	1	1	80	0.0125000
NODE_5934_length_1039_cov_40.150000	616	696	2	43	80	0.5375000
NODE_5934_length_1039_cov_40.150000	616	696	3	36	80	0.4500000
NODE_5934_length_1039_cov_40.150000	669	739	3	70	70	1.0000000
NODE_5935_length_1039_cov_37.940426	175	255	0	80	80	1.0000000
NODE_5935_length_1039_cov_37.940426	228	308	0	80	80	1.0000000
NODE_5935_length_1039_cov_37.940426	304	384	0	60	80	0.7500000
NODE_5935_length_1039_cov_37.940426	304	384	2	20	80	0.2500000
NODE_5935_length_1039_cov_37.940426	357	437	0	7	80	0.0875000
NODE_5935_length_1039_cov_37.940426	357	437	2	73	80	0.9125000
NODE_5936_length_1039_cov_24.567021	371	451	0	13	80	0.1625000
NODE_5936_length_1039_cov_24.567021	371	451	2	2	80	0.0250000
NODE_5936_length_1039_cov_24.567021	371	451	3	11	80	0.1375000
NODE_5936_length_1039_cov_24.567021	371	451	4	54	80	0.6750000
NODE_5936_length_1039_cov_24.567021	424	504	2	31	80	0.3875000
NODE_5936_length_1039_cov_24.567021	424	504	4	49	80	0.6125000
NODE_5937_length_1039_cov_15.790426	293	373	0	62	80	0.7750000
NODE_5937_length_1039_cov_15.790426	293	373	2	18	80	0.2250000
NODE_5937_length_1039_cov_15.790426	346	426	0	9	80	0.1125000
NODE_5937_length_1039_cov_15.790426	346	426	2	71	80	0.8875000
NODE_5938_length_1039_cov_14.670213	591	671	0	23	80	0.2875000
NODE_5938_length_1039_cov_14.670213	591	671	1	5	80	0.0625000
NODE_5938_length_1039_cov_14.670213	591	671	2	52	80	0.6500000
NODE_5938_length_1039_cov_14.670213	644	724	2	80	80	1.0000000
NODE_5939_length_1039_cov_11.568085	439	519	0	58	80	0.7250000
NODE_5939_length_1039_cov_11.568085	439	519	2	22	80	0.2750000
NODE_5939_length_1039_cov_11.568085	492	571	0	5	79	0.0632911
NODE_5939_length_1039_cov_11.568085	492	571	2	74	79	0.9367089
NODE_5947_length_1038_cov_17.191693	549	629	2	80	80	1.0000000
NODE_5947_length_1038_cov_17.191693	602	682	0	34	80	0.4250000
NODE_5947_length_1038_cov_17.191693	602	682	1	18	80	0.2250000
NODE_5947_length_1038_cov_17.191693	602	682	2	28	80	0.3500000
NODE_5948_length_1038_cov_13.520767	516	596	0	80	80	1.0000000
NODE_5948_length_1038_cov_13.520767	569	649	0	80	80	1.0000000
NODE_5949_length_1038_cov_10.541001	487	567	0	80	80	1.0000000
NODE_5949_length_1038_cov_10.541001	540	620	0	80	80	1.0000000
NODE_5950_length_1038_cov_8.826411	432	512	0	4	80	0.0500000
NODE_5950_length_1038_cov_8.826411	432	512	2	76	80	0.9500000
NODE_5950_length_1038_cov_8.826411	485	565	0	57	80	0.7125000
NODE_5950_length_1038_cov_8.826411	485	565	2	23	80	0.2875000
NODE_5952_length_1038_cov_2.587859	673	753	0	80	80	1.0000000
NODE_5952_length_1038_cov_2.587859	726	806	0	80	80	1.0000000
NODE_5963_length_1037_cov_66.968017	402	482	2	25	80	0.3125000
NODE_5963_length_1037_cov_66.968017	402	482	3	13	80	0.1625000
NODE_5963_length_1037_cov_66.968017	402	482	4	42	80	0.5250000
NODE_5963_length_1037_cov_66.968017	455	535	2	18	80	0.2250000
NODE_5963_length_1037_cov_66.968017	455	535	3	15	80	0.1875000
NODE_5963_length_1037_cov_66.968017	455	535	4	47	80	0.5875000
NODE_5964_length_1037_cov_53.639659	527	607	9	6	80	0.0750000
NODE_5964_length_1037_cov_53.639659	527	607	10	15	80	0.1875000
NODE_5964_length_1037_cov_53.639659	527	607	11	6	80	0.0750000
NODE_5964_length_1037_cov_53.639659	527	607	12	10	80	0.1250000
NODE_5964_length_1037_cov_53.639659	527	607	14	4	80	0.0500000
NODE_5964_length_1037_cov_53.639659	527	607	15	9	80	0.1125000
NODE_5964_length_1037_cov_53.639659	527	607	16	1	80	0.0125000
NODE_5964_length_1037_cov_53.639659	527	607	18	20	80	0.2500000
NODE_5964_length_1037_cov_53.639659	527	607	19	9	80	0.1125000
NODE_5964_length_1037_cov_53.639659	580	660	17	30	80	0.3750000
NODE_5964_length_1037_cov_53.639659	580	660	18	35	80	0.4375000
NODE_5964_length_1037_cov_53.639659	580	660	19	15	80	0.1875000
NODE_5965_length_1037_cov_45.353945	542	622	3	80	80	1.0000000
NODE_5965_length_1037_cov_45.353945	595	675	1	7	80	0.0875000
NODE_5965_length_1037_cov_45.353945	595	675	2	9	80	0.1125000
NODE_5965_length_1037_cov_45.353945	595	675	3	64	80	0.8000000
NODE_5966_length_1037_cov_31.078891	356	436	4	12	80	0.1500000
NODE_5966_length_1037_cov_31.078891	356	436	5	34	80	0.4250000
NODE_5966_length_1037_cov_31.078891	356	436	6	34	80	0.4250000
NODE_5966_length_1037_cov_31.078891	409	489	2	48	80	0.6000000
NODE_5966_length_1037_cov_31.078891	409	489	4	17	80	0.2125000
NODE_5966_length_1037_cov_31.078891	409	489	6	15	80	0.1875000
NODE_5967_length_1037_cov_25.453092	421	501	3	80	80	1.0000000
NODE_5967_length_1037_cov_25.453092	474	554	0	33	80	0.4125000
NODE_5967_length_1037_cov_25.453092	474	554	1	13	80	0.1625000
NODE_5967_length_1037_cov_25.453092	474	554	2	6	80	0.0750000
NODE_5967_length_1037_cov_25.453092	474	554	3	28	80	0.3500000
NODE_5967_length_1037_cov_25.453092	550	573	2	23	23	1.0000000
NODE_5968_length_1037_cov_13.740938	348	428	2	50	80	0.6250000
NODE_5968_length_1037_cov_13.740938	348	428	3	7	80	0.0875000
NODE_5968_length_1037_cov_13.740938	348	428	4	23	80	0.2875000
NODE_5968_length_1037_cov_13.740938	401	481	2	4	80	0.0500000
NODE_5968_length_1037_cov_13.740938	401	481	3	28	80	0.3500000
NODE_5968_length_1037_cov_13.740938	401	481	4	48	80	0.6000000
NODE_5969_length_1037_cov_12.632196	564	644	2	17	80	0.2125000
NODE_5969_length_1037_cov_12.632196	564	644	3	19	80	0.2375000
NODE_5969_length_1037_cov_12.632196	564	644	4	24	80	0.3000000
NODE_5969_length_1037_cov_12.632196	564	644	5	20	80	0.2500000
NODE_5969_length_1037_cov_12.632196	617	697	3	59	80	0.7375000
NODE_5969_length_1037_cov_12.632196	617	697	4	1	80	0.0125000
NODE_5969_length_1037_cov_12.632196	617	697	5	20	80	0.2500000
NODE_5970_length_1037_cov_8.904051	640	720	0	80	80	1.0000000
NODE_5970_length_1037_cov_8.904051	693	773	0	80	80	1.0000000
NODE_5978_length_1037_cov_1.859275	31	91	0	60	60	1.0000000
NODE_5986_length_1036_cov_52.270011	493	573	6	2	80	0.0250000
NODE_5986_length_1036_cov_52.270011	493	573	7	31	80	0.3875000
NODE_5986_length_1036_cov_52.270011	493	573	8	18	80	0.2250000
NODE_5986_length_1036_cov_52.270011	493	573	9	29	80	0.3625000
NODE_5986_length_1036_cov_52.270011	546	626	4	13	80	0.1625000
NODE_5986_length_1036_cov_52.270011	546	626	5	10	80	0.1250000
NODE_5986_length_1036_cov_52.270011	546	626	6	32	80	0.4000000
NODE_5986_length_1036_cov_52.270011	546	626	7	16	80	0.2000000
NODE_5986_length_1036_cov_52.270011	546	626	9	9	80	0.1125000
NODE_5987_length_1036_cov_24.080043	369	449	1	12	80	0.1500000
NODE_5987_length_1036_cov_24.080043	369	449	4	46	80	0.5750000
NODE_5987_length_1036_cov_24.080043	369	449	6	13	80	0.1625000
NODE_5987_length_1036_cov_24.080043	369	449	7	9	80	0.1125000
NODE_5987_length_1036_cov_24.080043	422	502	4	5	80	0.0625000
NODE_5987_length_1036_cov_24.080043	422	502	6	13	80	0.1625000
NODE_5987_length_1036_cov_24.080043	422	502	7	57	80	0.7125000
NODE_5987_length_1036_cov_24.080043	422	502	8	5	80	0.0625000
NODE_5988_length_1036_cov_20.533618	513	593	2	80	80	1.0000000
NODE_5988_length_1036_cov_20.533618	566	645	2	76	79	0.9620253
NODE_5988_length_1036_cov_20.533618	566	645	3	3	79	0.0379747
NODE_5988_length_1036_cov_20.533618	648	728	1	76	80	0.9500000
NODE_5988_length_1036_cov_20.533618	648	728	2	3	80	0.0375000
NODE_5988_length_1036_cov_20.533618	648	728	3	1	80	0.0125000
NODE_5988_length_1036_cov_20.533618	701	781	1	54	80	0.6750000
NODE_5988_length_1036_cov_20.533618	701	781	2	26	80	0.3250000
NODE_5989_length_1036_cov_19.715048	467	547	3	22	80	0.2750000
NODE_5989_length_1036_cov_19.715048	467	547	5	39	80	0.4875000
NODE_5989_length_1036_cov_19.715048	467	547	6	19	80	0.2375000
NODE_5989_length_1036_cov_19.715048	520	600	1	10	80	0.1250000
NODE_5989_length_1036_cov_19.715048	520	600	3	36	80	0.4500000
NODE_5989_length_1036_cov_19.715048	520	600	5	34	80	0.4250000
NODE_5990_length_1036_cov_19.452508	399	479	0	9	80	0.1125000
NODE_5990_length_1036_cov_19.452508	399	479	1	20	80	0.2500000
NODE_5990_length_1036_cov_19.452508	399	479	2	17	80	0.2125000
NODE_5990_length_1036_cov_19.452508	399	479	3	34	80	0.4250000
NODE_5990_length_1036_cov_19.452508	452	532	3	80	80	1.0000000
NODE_5990_length_1036_cov_19.452508	528	608	1	13	80	0.1625000
NODE_5990_length_1036_cov_19.452508	528	608	2	35	80	0.4375000
NODE_5990_length_1036_cov_19.452508	528	608	3	32	80	0.4000000
NODE_5990_length_1036_cov_19.452508	581	661	1	66	80	0.8250000
NODE_5990_length_1036_cov_19.452508	581	661	2	14	80	0.1750000
NODE_5991_length_1036_cov_13.840982	635	715	0	80	80	1.0000000
NODE_5991_length_1036_cov_13.840982	688	768	0	80	80	1.0000000
NODE_5992_length_1036_cov_6.913554	424	504	0	17	80	0.2125000
NODE_5992_length_1036_cov_6.913554	424	504	1	23	80	0.2875000
NODE_5992_length_1036_cov_6.913554	424	504	2	40	80	0.5000000
NODE_5992_length_1036_cov_6.913554	477	557	2	59	80	0.7375000
NODE_5992_length_1036_cov_6.913554	477	557	3	21	80	0.2625000
NODE_5993_length_1036_cov_5.880470	436	516	0	80	80	1.0000000
NODE_5993_length_1036_cov_5.880470	489	569	0	80	80	1.0000000
NODE_5994_length_1036_cov_4.638207	531	611	0	10	80	0.1250000
NODE_5994_length_1036_cov_4.638207	531	611	2	54	80	0.6750000
NODE_5994_length_1036_cov_4.638207	531	611	3	16	80	0.2000000
NODE_5994_length_1036_cov_4.638207	584	664	2	11	80	0.1375000
NODE_5994_length_1036_cov_4.638207	584	664	3	27	80	0.3375000
NODE_5994_length_1036_cov_4.638207	584	664	4	42	80	0.5250000
NODE_5998_length_1036_cov_1.293490	19	69	0	50	50	1.0000000
NODE_6001_length_1035_cov_31.941239	590	670	4	80	80	1.0000000
NODE_6001_length_1035_cov_31.941239	643	723	3	17	80	0.2125000
NODE_6001_length_1035_cov_31.941239	643	723	4	63	80	0.7875000
NODE_6002_length_1035_cov_14.917735	396	476	0	80	80	1.0000000
NODE_6002_length_1035_cov_14.917735	449	529	0	80	80	1.0000000
NODE_6003_length_1035_cov_12.552350	467	547	1	10	80	0.1250000
NODE_6003_length_1035_cov_12.552350	467	547	2	6	80	0.0750000
NODE_6003_length_1035_cov_12.552350	467	547	3	4	80	0.0500000
NODE_6003_length_1035_cov_12.552350	467	547	4	7	80	0.0875000
NODE_6003_length_1035_cov_12.552350	467	547	5	53	80	0.6625000
NODE_6003_length_1035_cov_12.552350	520	600	5	69	80	0.8625000
NODE_6003_length_1035_cov_12.552350	520	600	6	11	80	0.1375000
NODE_6004_length_1035_cov_12.050214	40	103	2	1	63	0.0158730
NODE_6004_length_1035_cov_12.050214	40	103	6	32	63	0.5079365
NODE_6004_length_1035_cov_12.050214	40	103	7	4	63	0.0634921
NODE_6004_length_1035_cov_12.050214	40	103	8	12	63	0.1904762
NODE_6004_length_1035_cov_12.050214	40	103	9	3	63	0.0476190
NODE_6004_length_1035_cov_12.050214	40	103	10	3	63	0.0476190
NODE_6004_length_1035_cov_12.050214	40	103	14	3	63	0.0476190
NODE_6004_length_1035_cov_12.050214	40	103	16	5	63	0.0793651
NODE_6004_length_1035_cov_12.050214	138	219	0	2	81	0.0246914
NODE_6004_length_1035_cov_12.050214	138	219	1	1	81	0.0123457
NODE_6004_length_1035_cov_12.050214	138	219	6	1	81	0.0123457
NODE_6004_length_1035_cov_12.050214	138	219	8	3	81	0.0370370
NODE_6004_length_1035_cov_12.050214	138	219	9	7	81	0.0864198
NODE_6004_length_1035_cov_12.050214	138	219	11	2	81	0.0246914
NODE_6004_length_1035_cov_12.050214	138	219	14	3	81	0.0370370
NODE_6004_length_1035_cov_12.050214	138	219	16	4	81	0.0493827
NODE_6004_length_1035_cov_12.050214	138	219	17	12	81	0.1481481
NODE_6004_length_1035_cov_12.050214	138	219	19	3	81	0.0370370
NODE_6004_length_1035_cov_12.050214	138	219	20	11	81	0.1358025
NODE_6004_length_1035_cov_12.050214	138	219	24	32	81	0.3950617
NODE_6005_length_1035_cov_7.020299	350	430	1	33	80	0.4125000
NODE_6005_length_1035_cov_7.020299	350	430	2	47	80	0.5875000
NODE_6005_length_1035_cov_7.020299	403	483	0	10	80	0.1250000
NODE_6005_length_1035_cov_7.020299	403	483	1	70	80	0.8750000
NODE_6006_length_1035_cov_4.726496	531	611	0	80	80	1.0000000
NODE_6006_length_1035_cov_4.726496	584	664	0	80	80	1.0000000
NODE_6018_length_1034_cov_26.810695	322	402	0	80	80	1.0000000
NODE_6018_length_1034_cov_26.810695	375	455	0	80	80	1.0000000
NODE_6018_length_1034_cov_26.810695	451	531	0	80	80	1.0000000
NODE_6018_length_1034_cov_26.810695	504	584	0	80	80	1.0000000
NODE_6032_length_1033_cov_42.574946	462	542	3	42	80	0.5250000
NODE_6032_length_1033_cov_42.574946	462	542	4	8	80	0.1000000
NODE_6032_length_1033_cov_42.574946	462	542	5	8	80	0.1000000
NODE_6032_length_1033_cov_42.574946	462	542	6	22	80	0.2750000
NODE_6032_length_1033_cov_42.574946	515	595	4	14	80	0.1750000
NODE_6032_length_1033_cov_42.574946	515	595	5	8	80	0.1000000
NODE_6032_length_1033_cov_42.574946	515	595	6	58	80	0.7250000
NODE_6033_length_1033_cov_17.073876	464	544	0	10	80	0.1250000
NODE_6033_length_1033_cov_17.073876	464	544	2	31	80	0.3875000
NODE_6033_length_1033_cov_17.073876	464	544	4	23	80	0.2875000
NODE_6033_length_1033_cov_17.073876	464	544	6	16	80	0.2000000
NODE_6033_length_1033_cov_17.073876	517	597	4	11	80	0.1375000
NODE_6033_length_1033_cov_17.073876	517	597	6	33	80	0.4125000
NODE_6033_length_1033_cov_17.073876	517	597	8	36	80	0.4500000
NODE_6034_length_1033_cov_15.791221	309	386	0	51	77	0.6623377
NODE_6034_length_1033_cov_15.791221	309	386	1	1	77	0.0129870
NODE_6034_length_1033_cov_15.791221	309	386	2	25	77	0.3246753
NODE_6034_length_1033_cov_15.791221	359	439	0	1	80	0.0125000
NODE_6034_length_1033_cov_15.791221	359	439	1	1	80	0.0125000
NODE_6034_length_1033_cov_15.791221	359	439	2	78	80	0.9750000
NODE_6035_length_1033_cov_11.340471	437	517	2	14	80	0.1750000
NODE_6035_length_1033_cov_11.340471	437	517	4	66	80	0.8250000
NODE_6035_length_1033_cov_11.340471	490	570	1	27	80	0.3375000
NODE_6035_length_1033_cov_11.340471	490	570	2	40	80	0.5000000
NODE_6035_length_1033_cov_11.340471	490	570	4	13	80	0.1625000
NODE_6045_length_1032_cov_56.511254	466	546	6	12	80	0.1500000
NODE_6045_length_1032_cov_56.511254	466	546	7	7	80	0.0875000
NODE_6045_length_1032_cov_56.511254	466	546	8	18	80	0.2250000
NODE_6045_length_1032_cov_56.511254	466	546	9	43	80	0.5375000
NODE_6045_length_1032_cov_56.511254	519	599	5	29	80	0.3625000
NODE_6045_length_1032_cov_56.511254	519	599	6	9	80	0.1125000
NODE_6045_length_1032_cov_56.511254	519	599	8	33	80	0.4125000
NODE_6045_length_1032_cov_56.511254	519	599	9	9	80	0.1125000
NODE_6046_length_1032_cov_20.752412	479	559	0	18	80	0.2250000
NODE_6046_length_1032_cov_20.752412	479	559	2	62	80	0.7750000
NODE_6046_length_1032_cov_20.752412	532	612	0	7	80	0.0875000
NODE_6046_length_1032_cov_20.752412	532	612	2	73	80	0.9125000
NODE_6047_length_1032_cov_8.166131	257	337	0	48	80	0.6000000
NODE_6047_length_1032_cov_8.166131	257	337	1	32	80	0.4000000
NODE_6047_length_1032_cov_8.166131	310	390	1	80	80	1.0000000
NODE_6048_length_1032_cov_7.991426	277	357	1	60	80	0.7500000
NODE_6048_length_1032_cov_7.991426	277	357	2	20	80	0.2500000
NODE_6048_length_1032_cov_7.991426	330	410	1	7	80	0.0875000
NODE_6048_length_1032_cov_7.991426	330	410	2	22	80	0.2750000
NODE_6048_length_1032_cov_7.991426	330	410	3	44	80	0.5500000
NODE_6048_length_1032_cov_7.991426	330	410	4	7	80	0.0875000
NODE_6049_length_1032_cov_5.276527	371	451	0	37	80	0.4625000
NODE_6049_length_1032_cov_5.276527	371	451	1	14	80	0.1750000
NODE_6049_length_1032_cov_5.276527	371	451	3	29	80	0.3625000
NODE_6049_length_1032_cov_5.276527	424	504	0	35	80	0.4375000
NODE_6049_length_1032_cov_5.276527	424	504	2	45	80	0.5625000
NODE_6055_length_1031_cov_71.154506	586	654	8	9	68	0.1323529
NODE_6055_length_1031_cov_71.154506	586	654	9	16	68	0.2352941
NODE_6055_length_1031_cov_71.154506	586	654	10	32	68	0.4705882
NODE_6055_length_1031_cov_71.154506	586	654	11	11	68	0.1617647
NODE_6055_length_1031_cov_71.154506	616	696	5	16	80	0.2000000
NODE_6055_length_1031_cov_71.154506	616	696	6	1	80	0.0125000
NODE_6055_length_1031_cov_71.154506	616	696	8	6	80	0.0750000
NODE_6055_length_1031_cov_71.154506	616	696	9	6	80	0.0750000
NODE_6055_length_1031_cov_71.154506	616	696	10	45	80	0.5625000
NODE_6055_length_1031_cov_71.154506	616	696	11	6	80	0.0750000
NODE_6055_length_1031_cov_71.154506	669	749	1	4	80	0.0500000
NODE_6055_length_1031_cov_71.154506	669	749	2	20	80	0.2500000
NODE_6055_length_1031_cov_71.154506	669	749	3	7	80	0.0875000
NODE_6055_length_1031_cov_71.154506	669	749	5	38	80	0.4750000
NODE_6055_length_1031_cov_71.154506	669	749	6	1	80	0.0125000
NODE_6055_length_1031_cov_71.154506	669	749	8	4	80	0.0500000
NODE_6055_length_1031_cov_71.154506	669	749	9	6	80	0.0750000
NODE_6056_length_1031_cov_70.221030	409	489	8	3	80	0.0375000
NODE_6056_length_1031_cov_70.221030	409	489	9	1	80	0.0125000
NODE_6056_length_1031_cov_70.221030	409	489	10	32	80	0.4000000
NODE_6056_length_1031_cov_70.221030	409	489	12	4	80	0.0500000
NODE_6056_length_1031_cov_70.221030	409	489	14	8	80	0.1000000
NODE_6056_length_1031_cov_70.221030	409	489	15	8	80	0.1000000
NODE_6056_length_1031_cov_70.221030	409	489	16	7	80	0.0875000
NODE_6056_length_1031_cov_70.221030	409	489	17	17	80	0.2125000
NODE_6056_length_1031_cov_70.221030	462	542	15	3	80	0.0375000
NODE_6056_length_1031_cov_70.221030	462	542	16	9	80	0.1125000
NODE_6056_length_1031_cov_70.221030	462	542	17	30	80	0.3750000
NODE_6056_length_1031_cov_70.221030	462	542	18	5	80	0.0625000
NODE_6056_length_1031_cov_70.221030	462	542	19	5	80	0.0625000
NODE_6056_length_1031_cov_70.221030	462	542	20	1	80	0.0125000
NODE_6056_length_1031_cov_70.221030	462	542	21	13	80	0.1625000
NODE_6056_length_1031_cov_70.221030	462	542	22	7	80	0.0875000
NODE_6056_length_1031_cov_70.221030	462	542	23	7	80	0.0875000
NODE_6056_length_1031_cov_70.221030	538	618	11	4	80	0.0500000
NODE_6056_length_1031_cov_70.221030	538	618	12	7	80	0.0875000
NODE_6056_length_1031_cov_70.221030	538	618	13	12	80	0.1500000
NODE_6056_length_1031_cov_70.221030	538	618	14	15	80	0.1875000
NODE_6056_length_1031_cov_70.221030	538	618	15	38	80	0.4750000
NODE_6056_length_1031_cov_70.221030	538	618	16	2	80	0.0250000
NODE_6056_length_1031_cov_70.221030	538	618	17	2	80	0.0250000
NODE_6056_length_1031_cov_70.221030	591	671	2	6	80	0.0750000
NODE_6056_length_1031_cov_70.221030	591	671	3	13	80	0.1625000
NODE_6056_length_1031_cov_70.221030	591	671	4	20	80	0.2500000
NODE_6056_length_1031_cov_70.221030	591	671	6	9	80	0.1125000
NODE_6056_length_1031_cov_70.221030	591	671	10	1	80	0.0125000
NODE_6056_length_1031_cov_70.221030	591	671	11	8	80	0.1000000
NODE_6056_length_1031_cov_70.221030	591	671	12	7	80	0.0875000
NODE_6056_length_1031_cov_70.221030	591	671	13	12	80	0.1500000
NODE_6056_length_1031_cov_70.221030	591	671	14	1	80	0.0125000
NODE_6056_length_1031_cov_70.221030	591	671	15	3	80	0.0375000
NODE_6057_length_1031_cov_43.618026	462	542	0	16	80	0.2000000
NODE_6057_length_1031_cov_43.618026	462	542	1	64	80	0.8000000
NODE_6057_length_1031_cov_43.618026	515	595	1	33	80	0.4125000
NODE_6057_length_1031_cov_43.618026	515	595	2	47	80	0.5875000
NODE_6058_length_1031_cov_43.581545	303	383	0	80	80	1.0000000
NODE_6058_length_1031_cov_43.581545	356	436	0	80	80	1.0000000
NODE_6058_length_1031_cov_43.581545	432	512	0	14	80	0.1750000
NODE_6058_length_1031_cov_43.581545	432	512	2	66	80	0.8250000
NODE_6058_length_1031_cov_43.581545	485	565	2	34	80	0.4250000
NODE_6058_length_1031_cov_43.581545	485	565	4	46	80	0.5750000
NODE_6059_length_1031_cov_22.310086	382	462	1	37	80	0.4625000
NODE_6059_length_1031_cov_22.310086	382	462	2	43	80	0.5375000
NODE_6059_length_1031_cov_22.310086	435	515	2	80	80	1.0000000
NODE_6060_length_1031_cov_11.547210	481	561	0	20	80	0.2500000
NODE_6060_length_1031_cov_11.547210	481	561	1	34	80	0.4250000
NODE_6060_length_1031_cov_11.547210	481	561	2	26	80	0.3250000
NODE_6060_length_1031_cov_11.547210	534	614	0	73	80	0.9125000
NODE_6060_length_1031_cov_11.547210	534	614	1	7	80	0.0875000
NODE_6066_length_1030_cov_54.380236	363	443	0	44	80	0.5500000
NODE_6066_length_1030_cov_54.380236	363	443	1	36	80	0.4500000
NODE_6066_length_1030_cov_54.380236	416	496	1	47	80	0.5875000
NODE_6066_length_1030_cov_54.380236	416	496	2	32	80	0.4000000
NODE_6066_length_1030_cov_54.380236	416	496	3	1	80	0.0125000
NODE_6066_length_1030_cov_54.380236	492	572	2	3	80	0.0375000
NODE_6066_length_1030_cov_54.380236	492	572	3	31	80	0.3875000
NODE_6066_length_1030_cov_54.380236	492	572	4	46	80	0.5750000
NODE_6066_length_1030_cov_54.380236	545	625	2	13	80	0.1625000
NODE_6066_length_1030_cov_54.380236	545	625	3	55	80	0.6875000
NODE_6066_length_1030_cov_54.380236	545	625	4	12	80	0.1500000
NODE_6067_length_1030_cov_45.040816	334	414	0	19	80	0.2375000
NODE_6067_length_1030_cov_45.040816	334	414	2	61	80	0.7625000
NODE_6067_length_1030_cov_45.040816	387	467	0	72	80	0.9000000
NODE_6067_length_1030_cov_45.040816	387	467	2	8	80	0.1000000
NODE_6067_length_1030_cov_45.040816	463	543	0	29	80	0.3625000
NODE_6067_length_1030_cov_45.040816	463	543	1	7	80	0.0875000
NODE_6067_length_1030_cov_45.040816	463	543	3	44	80	0.5500000
NODE_6067_length_1030_cov_45.040816	516	596	3	80	80	1.0000000
NODE_6068_length_1030_cov_20.491944	511	591	2	9	80	0.1125000
NODE_6068_length_1030_cov_20.491944	511	591	3	51	80	0.6375000
NODE_6068_length_1030_cov_20.491944	511	591	4	20	80	0.2500000
NODE_6068_length_1030_cov_20.491944	564	644	1	5	80	0.0625000
NODE_6068_length_1030_cov_20.491944	564	644	2	5	80	0.0625000
NODE_6068_length_1030_cov_20.491944	564	644	3	70	80	0.8750000
NODE_6069_length_1030_cov_17.253491	524	604	0	4	80	0.0500000
NODE_6069_length_1030_cov_17.253491	524	604	1	11	80	0.1375000
NODE_6069_length_1030_cov_17.253491	524	604	2	30	80	0.3750000
NODE_6069_length_1030_cov_17.253491	524	604	3	35	80	0.4375000
NODE_6069_length_1030_cov_17.253491	577	657	3	80	80	1.0000000
NODE_6070_length_1030_cov_14.337272	564	644	2	80	80	1.0000000
NODE_6070_length_1030_cov_14.337272	617	697	1	3	80	0.0375000
NODE_6070_length_1030_cov_14.337272	617	697	2	77	80	0.9625000
NODE_6071_length_1030_cov_5.742213	474	554	0	76	80	0.9500000
NODE_6071_length_1030_cov_5.742213	474	554	2	4	80	0.0500000
NODE_6071_length_1030_cov_5.742213	527	607	0	23	80	0.2875000
NODE_6071_length_1030_cov_5.742213	527	607	2	57	80	0.7125000
NODE_6073_length_1030_cov_5.208378	978	1030	0	24	52	0.4615385
NODE_6073_length_1030_cov_5.208378	978	1030	2	17	52	0.3269231
NODE_6073_length_1030_cov_5.208378	978	1030	3	11	52	0.2115385
NODE_6077_length_1030_cov_2.146079	979	1010	0	31	31	1.0000000
NODE_6083_length_1029_cov_236.527957	584	666	12	6	82	0.0731707
NODE_6083_length_1029_cov_236.527957	584	666	14	5	82	0.0609756
NODE_6083_length_1029_cov_236.527957	584	666	15	22	82	0.2682927
NODE_6083_length_1029_cov_236.527957	584	666	16	47	82	0.5731707
NODE_6083_length_1029_cov_236.527957	584	666	17	2	82	0.0243902
NODE_6083_length_1029_cov_236.527957	639	702	8	4	63	0.0634921
NODE_6083_length_1029_cov_236.527957	639	702	9	3	63	0.0476190
NODE_6083_length_1029_cov_236.527957	639	702	10	10	63	0.1587302
NODE_6083_length_1029_cov_236.527957	639	702	11	10	63	0.1587302
NODE_6083_length_1029_cov_236.527957	639	702	12	4	63	0.0634921
NODE_6083_length_1029_cov_236.527957	639	702	15	22	63	0.3492064
NODE_6083_length_1029_cov_236.527957	639	702	16	10	63	0.1587302
NODE_6084_length_1029_cov_41.650538	364	444	0	80	80	1.0000000
NODE_6084_length_1029_cov_41.650538	417	497	0	80	80	1.0000000
NODE_6084_length_1029_cov_41.650538	493	573	0	80	80	1.0000000
NODE_6084_length_1029_cov_41.650538	546	626	0	80	80	1.0000000
NODE_6085_length_1029_cov_34.940860	314	360	0	46	46	1.0000000
NODE_6085_length_1029_cov_34.940860	371	451	0	80	80	1.0000000
NODE_6085_length_1029_cov_34.940860	424	502	0	78	78	1.0000000
NODE_6086_length_1029_cov_28.752688	255	335	0	51	80	0.6375000
NODE_6086_length_1029_cov_28.752688	255	335	1	29	80	0.3625000
NODE_6086_length_1029_cov_28.752688	308	388	1	37	80	0.4625000
NODE_6086_length_1029_cov_28.752688	308	388	2	43	80	0.5375000
NODE_6086_length_1029_cov_28.752688	384	464	1	8	80	0.1000000
NODE_6086_length_1029_cov_28.752688	384	464	2	72	80	0.9000000
NODE_6086_length_1029_cov_28.752688	437	517	0	22	80	0.2750000
NODE_6086_length_1029_cov_28.752688	437	517	1	39	80	0.4875000
NODE_6086_length_1029_cov_28.752688	437	517	2	19	80	0.2375000
NODE_6087_length_1029_cov_28.523656	409	489	5	17	80	0.2125000
NODE_6087_length_1029_cov_28.523656	409	489	6	28	80	0.3500000
NODE_6087_length_1029_cov_28.523656	409	489	7	35	80	0.4375000
NODE_6087_length_1029_cov_28.523656	462	542	5	20	80	0.2500000
NODE_6087_length_1029_cov_28.523656	462	542	7	55	80	0.6875000
NODE_6087_length_1029_cov_28.523656	462	542	8	5	80	0.0625000
NODE_6088_length_1029_cov_28.283871	281	361	0	80	80	1.0000000
NODE_6088_length_1029_cov_28.283871	334	414	0	80	80	1.0000000
NODE_6088_length_1029_cov_28.283871	410	490	0	80	80	1.0000000
NODE_6088_length_1029_cov_28.283871	463	546	0	83	83	1.0000000
NODE_6089_length_1029_cov_26.883871	434	514	1	7	80	0.0875000
NODE_6089_length_1029_cov_26.883871	434	514	2	22	80	0.2750000
NODE_6089_length_1029_cov_26.883871	434	514	3	51	80	0.6375000
NODE_6089_length_1029_cov_26.883871	487	567	2	22	80	0.2750000
NODE_6089_length_1029_cov_26.883871	487	567	3	58	80	0.7250000
NODE_6090_length_1029_cov_23.552688	305	385	5	11	80	0.1375000
NODE_6090_length_1029_cov_23.552688	305	385	6	49	80	0.6125000
NODE_6090_length_1029_cov_23.552688	305	385	7	15	80	0.1875000
NODE_6090_length_1029_cov_23.552688	305	385	8	5	80	0.0625000
NODE_6090_length_1029_cov_23.552688	358	438	6	20	80	0.2500000
NODE_6090_length_1029_cov_23.552688	358	438	7	3	80	0.0375000
NODE_6090_length_1029_cov_23.552688	358	438	8	45	80	0.5625000
NODE_6090_length_1029_cov_23.552688	358	438	9	12	80	0.1500000
NODE_6090_length_1029_cov_23.552688	434	514	4	48	80	0.6000000
NODE_6090_length_1029_cov_23.552688	434	514	6	13	80	0.1625000
NODE_6090_length_1029_cov_23.552688	434	514	7	13	80	0.1625000
NODE_6090_length_1029_cov_23.552688	434	514	8	6	80	0.0750000
NODE_6090_length_1029_cov_23.552688	487	567	1	3	80	0.0375000
NODE_6090_length_1029_cov_23.552688	487	567	2	35	80	0.4375000
NODE_6090_length_1029_cov_23.552688	487	567	3	1	80	0.0125000
NODE_6090_length_1029_cov_23.552688	487	567	4	41	80	0.5125000
NODE_6091_length_1029_cov_22.520430	434	514	0	80	80	1.0000000
NODE_6091_length_1029_cov_22.520430	487	567	0	80	80	1.0000000
NODE_6092_length_1029_cov_21.924731	335	415	0	16	80	0.2000000
NODE_6092_length_1029_cov_21.924731	335	415	1	64	80	0.8000000
NODE_6092_length_1029_cov_21.924731	388	468	0	21	80	0.2625000
NODE_6092_length_1029_cov_21.924731	388	468	1	59	80	0.7375000
NODE_6093_length_1029_cov_17.101075	501	581	0	80	80	1.0000000
NODE_6093_length_1029_cov_17.101075	554	634	0	80	80	1.0000000
NODE_6093_length_1029_cov_17.101075	630	710	0	80	80	1.0000000
NODE_6093_length_1029_cov_17.101075	683	755	0	72	72	1.0000000
NODE_6094_length_1029_cov_14.052688	405	485	1	80	80	1.0000000
NODE_6094_length_1029_cov_14.052688	458	538	0	9	80	0.1125000
NODE_6094_length_1029_cov_14.052688	458	538	1	71	80	0.8875000
NODE_6095_length_1029_cov_11.119355	291	369	0	46	78	0.5897436
NODE_6095_length_1029_cov_11.119355	291	369	2	32	78	0.4102564
NODE_6095_length_1029_cov_11.119355	342	422	0	9	80	0.1125000
NODE_6095_length_1029_cov_11.119355	342	422	2	71	80	0.8875000
NODE_6097_length_1029_cov_3.850538	231	311	0	80	80	1.0000000
NODE_6097_length_1029_cov_3.850538	284	364	0	80	80	1.0000000
NODE_6104_length_1028_cov_19.625404	495	575	0	69	80	0.8625000
NODE_6104_length_1028_cov_19.625404	495	575	1	11	80	0.1375000
NODE_6104_length_1028_cov_19.625404	548	628	0	16	80	0.2000000
NODE_6104_length_1028_cov_19.625404	548	628	1	34	80	0.4250000
NODE_6104_length_1028_cov_19.625404	548	628	2	30	80	0.3750000
NODE_6105_length_1028_cov_17.497309	533	613	0	80	80	1.0000000
NODE_6105_length_1028_cov_17.497309	586	666	0	80	80	1.0000000
NODE_6106_length_1028_cov_16.528525	497	577	2	17	80	0.2125000
NODE_6106_length_1028_cov_16.528525	497	577	4	63	80	0.7875000
NODE_6106_length_1028_cov_16.528525	550	630	0	15	80	0.1875000
NODE_6106_length_1028_cov_16.528525	550	630	2	55	80	0.6875000
NODE_6106_length_1028_cov_16.528525	550	630	4	10	80	0.1250000
NODE_6107_length_1028_cov_10.212056	463	543	1	80	80	1.0000000
NODE_6107_length_1028_cov_10.212056	516	596	1	80	80	1.0000000
NODE_6108_length_1028_cov_10.131324	399	479	0	80	80	1.0000000
NODE_6108_length_1028_cov_10.131324	452	532	0	80	80	1.0000000
NODE_6109_length_1028_cov_9.773950	482	562	1	80	80	1.0000000
NODE_6109_length_1028_cov_9.773950	535	615	0	9	80	0.1125000
NODE_6109_length_1028_cov_9.773950	535	615	1	71	80	0.8875000
NODE_6110_length_1028_cov_8.079656	399	479	1	11	80	0.1375000
NODE_6110_length_1028_cov_8.079656	399	479	2	69	80	0.8625000
NODE_6110_length_1028_cov_8.079656	452	532	1	64	80	0.8000000
NODE_6110_length_1028_cov_8.079656	452	532	2	16	80	0.2000000
NODE_6111_length_1028_cov_7.092573	439	519	0	80	80	1.0000000
NODE_6111_length_1028_cov_7.092573	492	572	0	80	80	1.0000000
NODE_6112_length_1028_cov_4.727664	416	488	1	3	72	0.0416667
NODE_6112_length_1028_cov_4.727664	416	488	2	69	72	0.9583333
NODE_6112_length_1028_cov_4.727664	461	541	0	31	80	0.3875000
NODE_6112_length_1028_cov_4.727664	461	541	1	21	80	0.2625000
NODE_6112_length_1028_cov_4.727664	461	541	2	28	80	0.3500000
NODE_6125_length_1027_cov_51.341595	399	479	0	20	80	0.2500000
NODE_6125_length_1027_cov_51.341595	399	479	1	48	80	0.6000000
NODE_6125_length_1027_cov_51.341595	399	479	2	12	80	0.1500000
NODE_6125_length_1027_cov_51.341595	452	532	0	22	80	0.2750000
NODE_6125_length_1027_cov_51.341595	452	532	1	34	80	0.4250000
NODE_6125_length_1027_cov_51.341595	452	532	3	24	80	0.3000000
NODE_6125_length_1027_cov_51.341595	528	608	3	80	80	1.0000000
NODE_6125_length_1027_cov_51.341595	581	661	0	16	80	0.2000000
NODE_6125_length_1027_cov_51.341595	581	661	2	14	80	0.1750000
NODE_6125_length_1027_cov_51.341595	581	661	3	50	80	0.6250000
NODE_6126_length_1027_cov_45.613147	347	427	0	80	80	1.0000000
NODE_6126_length_1027_cov_45.613147	400	480	0	66	80	0.8250000
NODE_6126_length_1027_cov_45.613147	400	480	2	14	80	0.1750000
NODE_6126_length_1027_cov_45.613147	476	556	2	11	80	0.1375000
NODE_6126_length_1027_cov_45.613147	476	556	4	54	80	0.6750000
NODE_6126_length_1027_cov_45.613147	476	556	5	15	80	0.1875000
NODE_6126_length_1027_cov_45.613147	529	609	3	5	80	0.0625000
NODE_6126_length_1027_cov_45.613147	529	609	4	55	80	0.6875000
NODE_6126_length_1027_cov_45.613147	529	609	5	20	80	0.2500000
NODE_6127_length_1027_cov_35.435345	431	511	3	7	80	0.0875000
NODE_6127_length_1027_cov_35.435345	431	511	4	8	80	0.1000000
NODE_6127_length_1027_cov_35.435345	431	511	5	6	80	0.0750000
NODE_6127_length_1027_cov_35.435345	431	511	7	7	80	0.0875000
NODE_6127_length_1027_cov_35.435345	431	511	8	44	80	0.5500000
NODE_6127_length_1027_cov_35.435345	431	511	9	8	80	0.1000000
NODE_6127_length_1027_cov_35.435345	484	564	6	11	80	0.1375000
NODE_6127_length_1027_cov_35.435345	484	564	7	17	80	0.2125000
NODE_6127_length_1027_cov_35.435345	484	564	8	48	80	0.6000000
NODE_6127_length_1027_cov_35.435345	484	564	9	4	80	0.0500000
NODE_6135_length_1026_cov_39.737864	374	454	0	80	80	1.0000000
NODE_6135_length_1026_cov_39.737864	427	509	0	57	82	0.6951219
NODE_6135_length_1026_cov_39.737864	427	509	1	25	82	0.3048781
NODE_6135_length_1026_cov_39.737864	505	585	1	80	80	1.0000000
NODE_6135_length_1026_cov_39.737864	558	638	1	46	80	0.5750000
NODE_6135_length_1026_cov_39.737864	558	638	2	34	80	0.4250000
NODE_6136_length_1026_cov_26.400216	423	503	3	16	80	0.2000000
NODE_6136_length_1026_cov_26.400216	423	503	4	16	80	0.2000000
NODE_6136_length_1026_cov_26.400216	423	503	5	48	80	0.6000000
NODE_6136_length_1026_cov_26.400216	476	556	1	13	80	0.1625000
NODE_6136_length_1026_cov_26.400216	476	556	2	26	80	0.3250000
NODE_6136_length_1026_cov_26.400216	476	556	3	30	80	0.3750000
NODE_6136_length_1026_cov_26.400216	476	556	5	11	80	0.1375000
NODE_6137_length_1026_cov_25.325782	477	557	3	18	80	0.2250000
NODE_6137_length_1026_cov_25.325782	477	557	4	62	80	0.7750000
NODE_6137_length_1026_cov_25.325782	530	610	1	33	80	0.4125000
NODE_6137_length_1026_cov_25.325782	530	610	2	17	80	0.2125000
NODE_6137_length_1026_cov_25.325782	530	610	3	21	80	0.2625000
NODE_6137_length_1026_cov_25.325782	530	610	4	9	80	0.1125000
NODE_6137_length_1026_cov_25.325782	606	686	2	80	80	1.0000000
NODE_6137_length_1026_cov_25.325782	659	739	1	46	80	0.5750000
NODE_6137_length_1026_cov_25.325782	659	739	2	34	80	0.4250000
NODE_6138_length_1026_cov_22.218986	408	488	1	79	80	0.9875000
NODE_6138_length_1026_cov_22.218986	408	488	2	1	80	0.0125000
NODE_6138_length_1026_cov_22.218986	461	541	0	42	80	0.5250000
NODE_6138_length_1026_cov_22.218986	461	541	1	38	80	0.4750000
NODE_6138_length_1026_cov_22.218986	537	617	0	80	80	1.0000000
NODE_6138_length_1026_cov_22.218986	590	670	0	80	80	1.0000000
NODE_6139_length_1026_cov_15.640777	450	530	1	25	80	0.3125000
NODE_6139_length_1026_cov_15.640777	450	530	2	55	80	0.6875000
NODE_6139_length_1026_cov_15.640777	503	583	2	80	80	1.0000000
NODE_6140_length_1026_cov_12.062567	165	245	3	24	80	0.3000000
NODE_6140_length_1026_cov_12.062567	165	245	5	9	80	0.1125000
NODE_6140_length_1026_cov_12.062567	165	245	7	22	80	0.2750000
NODE_6140_length_1026_cov_12.062567	165	245	8	25	80	0.3125000
NODE_6140_length_1026_cov_12.062567	218	298	6	6	80	0.0750000
NODE_6140_length_1026_cov_12.062567	218	298	7	2	80	0.0250000
NODE_6140_length_1026_cov_12.062567	218	298	8	72	80	0.9000000
NODE_6142_length_1026_cov_5.002157	335	415	0	80	80	1.0000000
NODE_6142_length_1026_cov_5.002157	388	468	0	80	80	1.0000000
NODE_6155_length_1025_cov_52.053996	366	446	2	1	80	0.0125000
NODE_6155_length_1025_cov_52.053996	366	446	3	13	80	0.1625000
NODE_6155_length_1025_cov_52.053996	366	446	4	42	80	0.5250000
NODE_6155_length_1025_cov_52.053996	366	446	5	24	80	0.3000000
NODE_6155_length_1025_cov_52.053996	419	499	3	7	80	0.0875000
NODE_6155_length_1025_cov_52.053996	419	499	4	34	80	0.4250000
NODE_6155_length_1025_cov_52.053996	419	499	5	39	80	0.4875000
NODE_6155_length_1025_cov_52.053996	495	575	3	43	80	0.5375000
NODE_6155_length_1025_cov_52.053996	495	575	4	15	80	0.1875000
NODE_6155_length_1025_cov_52.053996	495	575	5	22	80	0.2750000
NODE_6155_length_1025_cov_52.053996	548	628	2	5	80	0.0625000
NODE_6155_length_1025_cov_52.053996	548	628	3	73	80	0.9125000
NODE_6155_length_1025_cov_52.053996	548	628	4	2	80	0.0250000
NODE_6156_length_1025_cov_35.980562	318	375	0	47	57	0.8245614
NODE_6156_length_1025_cov_35.980562	318	375	2	10	57	0.1754386
NODE_6156_length_1025_cov_35.980562	348	428	0	17	80	0.2125000
NODE_6156_length_1025_cov_35.980562	348	428	2	63	80	0.7875000
NODE_6156_length_1025_cov_35.980562	425	482	2	57	57	1.0000000
NODE_6156_length_1025_cov_35.980562	455	521	0	22	66	0.3333333
NODE_6156_length_1025_cov_35.980562	455	521	2	44	66	0.6666667
NODE_6157_length_1025_cov_26.954644	607	687	1	61	80	0.7625000
NODE_6157_length_1025_cov_26.954644	607	687	2	19	80	0.2375000
NODE_6157_length_1025_cov_26.954644	660	740	0	12	80	0.1500000
NODE_6157_length_1025_cov_26.954644	660	740	1	68	80	0.8500000
NODE_6158_length_1025_cov_20.576674	428	508	0	80	80	1.0000000
NODE_6158_length_1025_cov_20.576674	481	561	0	80	80	1.0000000
NODE_6159_length_1025_cov_15.525918	415	495	1	32	80	0.4000000
NODE_6159_length_1025_cov_15.525918	415	495	2	48	80	0.6000000
NODE_6159_length_1025_cov_15.525918	468	548	1	31	80	0.3875000
NODE_6159_length_1025_cov_15.525918	468	548	2	49	80	0.6125000
NODE_6160_length_1025_cov_7.044276	240	320	0	80	80	1.0000000
NODE_6161_length_1025_cov_6.688985	334	414	4	9	80	0.1125000
NODE_6161_length_1025_cov_6.688985	334	414	6	42	80	0.5250000
NODE_6161_length_1025_cov_6.688985	334	414	7	29	80	0.3625000
NODE_6161_length_1025_cov_6.688985	387	467	4	28	80	0.3500000
NODE_6161_length_1025_cov_6.688985	387	467	6	26	80	0.3250000
NODE_6161_length_1025_cov_6.688985	387	467	7	26	80	0.3250000
NODE_6170_length_1024_cov_28.681081	264	344	5	14	80	0.1750000
NODE_6170_length_1024_cov_28.681081	264	344	6	44	80	0.5500000
NODE_6170_length_1024_cov_28.681081	264	344	7	11	80	0.1375000
NODE_6170_length_1024_cov_28.681081	264	344	8	11	80	0.1375000
NODE_6170_length_1024_cov_28.681081	317	397	5	2	80	0.0250000
NODE_6170_length_1024_cov_28.681081	317	397	6	15	80	0.1875000
NODE_6170_length_1024_cov_28.681081	317	397	7	47	80	0.5875000
NODE_6170_length_1024_cov_28.681081	317	397	8	16	80	0.2000000
NODE_6170_length_1024_cov_28.681081	393	477	4	7	84	0.0833333
NODE_6170_length_1024_cov_28.681081	393	477	5	33	84	0.3928571
NODE_6170_length_1024_cov_28.681081	393	477	6	42	84	0.5000000
NODE_6170_length_1024_cov_28.681081	393	477	7	2	84	0.0238095
NODE_6171_length_1024_cov_17.922162	324	404	1	26	80	0.3250000
NODE_6171_length_1024_cov_17.922162	324	404	3	33	80	0.4125000
NODE_6171_length_1024_cov_17.922162	324	404	4	21	80	0.2625000
NODE_6171_length_1024_cov_17.922162	377	457	1	1	80	0.0125000
NODE_6171_length_1024_cov_17.922162	377	457	2	14	80	0.1750000
NODE_6171_length_1024_cov_17.922162	377	457	3	8	80	0.1000000
NODE_6171_length_1024_cov_17.922162	377	457	4	57	80	0.7125000
NODE_6173_length_1024_cov_12.018378	368	448	0	80	80	1.0000000
NODE_6173_length_1024_cov_12.018378	421	501	0	27	80	0.3375000
NODE_6173_length_1024_cov_12.018378	421	501	1	53	80	0.6625000
NODE_6174_length_1024_cov_8.800000	517	597	1	80	80	1.0000000
NODE_6174_length_1024_cov_8.800000	570	650	0	32	80	0.4000000
NODE_6174_length_1024_cov_8.800000	570	650	1	48	80	0.6000000
NODE_6175_length_1024_cov_6.207568	318	398	0	80	80	1.0000000
NODE_6175_length_1024_cov_6.207568	371	451	0	80	80	1.0000000
NODE_6178_length_1024_cov_2.468108	274	324	0	50	50	1.0000000
NODE_6178_length_1024_cov_2.468108	274	322	0	48	48	1.0000000
NODE_6178_length_1024_cov_2.468108	274	324	0	50	50	1.0000000
NODE_6178_length_1024_cov_2.468108	274	323	0	49	49	1.0000000
NODE_6178_length_1024_cov_2.468108	274	322	0	48	48	1.0000000
NODE_6185_length_1023_cov_100.366883	441	521	6	16	80	0.2000000
NODE_6185_length_1023_cov_100.366883	441	521	8	10	80	0.1250000
NODE_6185_length_1023_cov_100.366883	441	521	9	7	80	0.0875000
NODE_6185_length_1023_cov_100.366883	441	521	10	8	80	0.1000000
NODE_6185_length_1023_cov_100.366883	441	521	12	10	80	0.1250000
NODE_6185_length_1023_cov_100.366883	441	521	13	4	80	0.0500000
NODE_6185_length_1023_cov_100.366883	441	521	14	25	80	0.3125000
NODE_6185_length_1023_cov_100.366883	494	574	12	3	80	0.0375000
NODE_6185_length_1023_cov_100.366883	494	574	13	49	80	0.6125000
NODE_6185_length_1023_cov_100.366883	494	574	14	25	80	0.3125000
NODE_6185_length_1023_cov_100.366883	494	574	15	3	80	0.0375000
NODE_6186_length_1023_cov_64.271645	349	429	0	36	80	0.4500000
NODE_6186_length_1023_cov_64.271645	349	429	1	31	80	0.3875000
NODE_6186_length_1023_cov_64.271645	349	429	2	13	80	0.1625000
NODE_6186_length_1023_cov_64.271645	402	482	0	43	80	0.5375000
NODE_6186_length_1023_cov_64.271645	402	482	1	21	80	0.2625000
NODE_6186_length_1023_cov_64.271645	402	482	2	16	80	0.2000000
NODE_6186_length_1023_cov_64.271645	478	558	2	13	80	0.1625000
NODE_6186_length_1023_cov_64.271645	478	558	3	67	80	0.8375000
NODE_6186_length_1023_cov_64.271645	531	611	3	45	80	0.5625000
NODE_6186_length_1023_cov_64.271645	531	611	4	35	80	0.4375000
NODE_6187_length_1023_cov_32.695887	318	398	1	68	80	0.8500000
NODE_6187_length_1023_cov_32.695887	318	398	2	12	80	0.1500000
NODE_6187_length_1023_cov_32.695887	371	451	1	37	80	0.4625000
NODE_6187_length_1023_cov_32.695887	371	451	2	22	80	0.2750000
NODE_6187_length_1023_cov_32.695887	371	451	3	14	80	0.1750000
NODE_6187_length_1023_cov_32.695887	371	451	4	7	80	0.0875000
NODE_6187_length_1023_cov_32.695887	447	527	4	65	80	0.8125000
NODE_6187_length_1023_cov_32.695887	447	527	5	15	80	0.1875000
NODE_6187_length_1023_cov_32.695887	500	580	3	10	80	0.1250000
NODE_6187_length_1023_cov_32.695887	500	580	4	55	80	0.6875000
NODE_6187_length_1023_cov_32.695887	500	580	5	15	80	0.1875000
NODE_6188_length_1023_cov_16.244589	601	681	0	28	80	0.3500000
NODE_6188_length_1023_cov_16.244589	601	681	1	8	80	0.1000000
NODE_6188_length_1023_cov_16.244589	601	681	3	44	80	0.5500000
NODE_6188_length_1023_cov_16.244589	654	734	3	40	80	0.5000000
NODE_6188_length_1023_cov_16.244589	654	734	5	5	80	0.0625000
NODE_6188_length_1023_cov_16.244589	654	734	6	35	80	0.4375000
NODE_6189_length_1023_cov_15.876623	371	451	1	1	80	0.0125000
NODE_6189_length_1023_cov_15.876623	371	451	2	79	80	0.9875000
NODE_6189_length_1023_cov_15.876623	424	504	2	38	80	0.4750000
NODE_6189_length_1023_cov_15.876623	424	504	3	42	80	0.5250000
NODE_6189_length_1023_cov_15.876623	500	580	1	43	80	0.5375000
NODE_6189_length_1023_cov_15.876623	500	580	2	17	80	0.2125000
NODE_6189_length_1023_cov_15.876623	500	580	3	20	80	0.2500000
NODE_6189_length_1023_cov_15.876623	553	633	1	33	80	0.4125000
NODE_6189_length_1023_cov_15.876623	553	633	2	47	80	0.5875000
NODE_6190_length_1023_cov_14.678571	555	635	2	11	80	0.1375000
NODE_6190_length_1023_cov_14.678571	555	635	3	46	80	0.5750000
NODE_6190_length_1023_cov_14.678571	555	635	4	23	80	0.2875000
NODE_6190_length_1023_cov_14.678571	608	688	1	30	80	0.3750000
NODE_6190_length_1023_cov_14.678571	608	688	3	50	80	0.6250000
NODE_6191_length_1023_cov_14.443723	406	486	3	24	80	0.3000000
NODE_6191_length_1023_cov_14.443723	406	486	4	52	80	0.6500000
NODE_6191_length_1023_cov_14.443723	406	486	5	4	80	0.0500000
NODE_6191_length_1023_cov_14.443723	459	539	2	6	80	0.0750000
NODE_6191_length_1023_cov_14.443723	459	539	4	74	80	0.9250000
NODE_6192_length_1023_cov_10.984848	590	670	1	10	80	0.1250000
NODE_6192_length_1023_cov_10.984848	590	670	2	31	80	0.3875000
NODE_6192_length_1023_cov_10.984848	590	670	3	16	80	0.2000000
NODE_6192_length_1023_cov_10.984848	590	670	4	23	80	0.2875000
NODE_6192_length_1023_cov_10.984848	643	723	3	4	80	0.0500000
NODE_6192_length_1023_cov_10.984848	643	723	4	76	80	0.9500000
NODE_6202_length_1022_cov_42.952329	555	636	7	32	81	0.3950617
NODE_6202_length_1022_cov_42.952329	555	636	8	1	81	0.0123457
NODE_6202_length_1022_cov_42.952329	555	636	9	48	81	0.5925926
NODE_6202_length_1022_cov_42.952329	609	689	4	26	80	0.3250000
NODE_6202_length_1022_cov_42.952329	609	689	6	15	80	0.1875000
NODE_6202_length_1022_cov_42.952329	609	689	7	8	80	0.1000000
NODE_6202_length_1022_cov_42.952329	609	689	8	5	80	0.0625000
NODE_6202_length_1022_cov_42.952329	609	689	9	26	80	0.3250000
NODE_6202_length_1022_cov_42.952329	685	765	1	28	80	0.3500000
NODE_6202_length_1022_cov_42.952329	685	765	3	37	80	0.4625000
NODE_6202_length_1022_cov_42.952329	685	765	4	15	80	0.1875000
NODE_6202_length_1022_cov_42.952329	738	818	1	60	80	0.7500000
NODE_6202_length_1022_cov_42.952329	738	818	2	20	80	0.2500000
NODE_6203_length_1022_cov_29.949079	510	590	4	28	80	0.3500000
NODE_6203_length_1022_cov_29.949079	510	590	6	27	80	0.3375000
NODE_6203_length_1022_cov_29.949079	510	590	7	2	80	0.0250000
NODE_6203_length_1022_cov_29.949079	510	590	8	23	80	0.2875000
NODE_6203_length_1022_cov_29.949079	563	643	2	12	80	0.1500000
NODE_6203_length_1022_cov_29.949079	563	643	3	18	80	0.2250000
NODE_6203_length_1022_cov_29.949079	563	643	5	20	80	0.2500000
NODE_6203_length_1022_cov_29.949079	563	643	6	10	80	0.1250000
NODE_6203_length_1022_cov_29.949079	563	643	7	2	80	0.0250000
NODE_6203_length_1022_cov_29.949079	563	643	8	18	80	0.2250000
NODE_6204_length_1022_cov_7.672806	461	541	0	80	80	1.0000000
NODE_6204_length_1022_cov_7.672806	514	594	0	80	80	1.0000000
NODE_6213_length_1021_cov_47.379610	341	421	5	25	80	0.3125000
NODE_6213_length_1021_cov_47.379610	341	421	6	34	80	0.4250000
NODE_6213_length_1021_cov_47.379610	341	421	7	21	80	0.2625000
NODE_6213_length_1021_cov_47.379610	394	474	5	42	80	0.5250000
NODE_6213_length_1021_cov_47.379610	394	474	6	22	80	0.2750000
NODE_6213_length_1021_cov_47.379610	394	474	7	16	80	0.2000000
NODE_6213_length_1021_cov_47.379610	470	550	3	15	80	0.1875000
NODE_6213_length_1021_cov_47.379610	470	550	4	29	80	0.3625000
NODE_6213_length_1021_cov_47.379610	470	550	5	36	80	0.4500000
NODE_6213_length_1021_cov_47.379610	523	603	0	23	80	0.2875000
NODE_6213_length_1021_cov_47.379610	523	603	1	20	80	0.2500000
NODE_6213_length_1021_cov_47.379610	523	603	2	6	80	0.0750000
NODE_6213_length_1021_cov_47.379610	523	603	3	19	80	0.2375000
NODE_6213_length_1021_cov_47.379610	523	603	4	12	80	0.1500000
NODE_6214_length_1021_cov_33.255965	588	668	3	80	80	1.0000000
NODE_6214_length_1021_cov_33.255965	641	721	0	5	80	0.0625000
NODE_6214_length_1021_cov_33.255965	641	721	1	7	80	0.0875000
NODE_6214_length_1021_cov_33.255965	641	721	2	40	80	0.5000000
NODE_6214_length_1021_cov_33.255965	641	721	3	28	80	0.3500000
NODE_6227_length_1020_cov_24.565689	485	565	2	1	80	0.0125000
NODE_6227_length_1020_cov_24.565689	485	565	3	7	80	0.0875000
NODE_6227_length_1020_cov_24.565689	485	565	4	53	80	0.6625000
NODE_6227_length_1020_cov_24.565689	485	565	6	19	80	0.2375000
NODE_6227_length_1020_cov_24.565689	538	618	1	24	80	0.3000000
NODE_6227_length_1020_cov_24.565689	538	618	2	26	80	0.3250000
NODE_6227_length_1020_cov_24.565689	538	618	3	4	80	0.0500000
NODE_6227_length_1020_cov_24.565689	538	618	4	26	80	0.3250000
NODE_6228_length_1020_cov_20.825190	395	475	6	1	80	0.0125000
NODE_6228_length_1020_cov_20.825190	395	475	7	32	80	0.4000000
NODE_6228_length_1020_cov_20.825190	395	475	8	47	80	0.5875000
NODE_6228_length_1020_cov_20.825190	448	528	5	33	80	0.4125000
NODE_6228_length_1020_cov_20.825190	448	528	6	7	80	0.0875000
NODE_6228_length_1020_cov_20.825190	448	528	7	25	80	0.3125000
NODE_6228_length_1020_cov_20.825190	448	528	8	15	80	0.1875000
NODE_6229_length_1020_cov_20.305103	285	365	2	4	80	0.0500000
NODE_6229_length_1020_cov_20.305103	285	365	3	47	80	0.5875000
NODE_6229_length_1020_cov_20.305103	285	365	4	29	80	0.3625000
NODE_6229_length_1020_cov_20.305103	338	418	2	11	80	0.1375000
NODE_6229_length_1020_cov_20.305103	338	418	3	61	80	0.7625000
NODE_6229_length_1020_cov_20.305103	338	418	4	8	80	0.1000000
NODE_6229_length_1020_cov_20.305103	414	494	2	31	80	0.3875000
NODE_6229_length_1020_cov_20.305103	414	494	3	28	80	0.3500000
NODE_6229_length_1020_cov_20.305103	414	494	4	21	80	0.2625000
NODE_6229_length_1020_cov_20.305103	467	548	0	12	81	0.1481481
NODE_6229_length_1020_cov_20.305103	467	548	2	69	81	0.8518519
NODE_6230_length_1020_cov_17.919653	408	488	0	80	80	1.0000000
NODE_6230_length_1020_cov_17.919653	461	541	0	80	80	1.0000000
NODE_6231_length_1020_cov_13.972856	436	516	4	3	80	0.0375000
NODE_6231_length_1020_cov_13.972856	436	516	5	32	80	0.4000000
NODE_6231_length_1020_cov_13.972856	436	516	7	45	80	0.5625000
NODE_6231_length_1020_cov_13.972856	489	569	4	10	80	0.1250000
NODE_6231_length_1020_cov_13.972856	489	569	5	5	80	0.0625000
NODE_6231_length_1020_cov_13.972856	489	569	6	25	80	0.3125000
NODE_6231_length_1020_cov_13.972856	489	569	7	33	80	0.4125000
NODE_6231_length_1020_cov_13.972856	489	569	8	7	80	0.0875000
NODE_6232_length_1020_cov_10.472313	407	487	0	5	80	0.0625000
NODE_6232_length_1020_cov_10.472313	407	487	2	2	80	0.0250000
NODE_6232_length_1020_cov_10.472313	407	487	3	14	80	0.1750000
NODE_6232_length_1020_cov_10.472313	407	487	4	59	80	0.7375000
NODE_6232_length_1020_cov_10.472313	460	540	2	22	80	0.2750000
NODE_6232_length_1020_cov_10.472313	460	540	4	58	80	0.7250000
NODE_6235_length_1020_cov_3.707926	821	901	0	1	80	0.0125000
NODE_6235_length_1020_cov_3.707926	821	901	2	79	80	0.9875000
NODE_6235_length_1020_cov_3.707926	874	954	2	80	80	1.0000000
NODE_6238_length_1020_cov_2.648208	0	70	0	70	70	1.0000000
NODE_6238_length_1020_cov_2.648208	43	88	0	45	45	1.0000000
NODE_6248_length_1019_cov_30.164130	476	556	4	4	80	0.0500000
NODE_6248_length_1019_cov_30.164130	476	556	5	76	80	0.9500000
NODE_6248_length_1019_cov_30.164130	529	609	2	8	80	0.1000000
NODE_6248_length_1019_cov_30.164130	529	609	3	7	80	0.0875000
NODE_6248_length_1019_cov_30.164130	529	609	5	65	80	0.8125000
NODE_6248_length_1019_cov_30.164130	605	685	2	6	80	0.0750000
NODE_6248_length_1019_cov_30.164130	605	685	3	3	80	0.0375000
NODE_6248_length_1019_cov_30.164130	605	685	4	25	80	0.3125000
NODE_6248_length_1019_cov_30.164130	605	685	5	44	80	0.5500000
NODE_6248_length_1019_cov_30.164130	605	685	6	2	80	0.0250000
NODE_6248_length_1019_cov_30.164130	658	738	5	80	80	1.0000000
NODE_6249_length_1019_cov_22.845652	343	423	0	17	80	0.2125000
NODE_6249_length_1019_cov_22.845652	343	423	2	58	80	0.7250000
NODE_6249_length_1019_cov_22.845652	343	423	3	5	80	0.0625000
NODE_6249_length_1019_cov_22.845652	396	476	1	22	80	0.2750000
NODE_6249_length_1019_cov_22.845652	396	476	2	40	80	0.5000000
NODE_6249_length_1019_cov_22.845652	396	476	3	18	80	0.2250000
NODE_6249_length_1019_cov_22.845652	472	552	2	80	80	1.0000000
NODE_6249_length_1019_cov_22.845652	525	605	1	38	80	0.4750000
NODE_6249_length_1019_cov_22.845652	525	605	2	42	80	0.5250000
NODE_6250_length_1019_cov_8.098913	523	601	0	10	78	0.1282051
NODE_6250_length_1019_cov_8.098913	523	601	1	65	78	0.8333333
NODE_6250_length_1019_cov_8.098913	523	601	2	3	78	0.0384615
NODE_6250_length_1019_cov_8.098913	574	654	0	63	80	0.7875000
NODE_6250_length_1019_cov_8.098913	574	654	1	17	80	0.2125000
NODE_6251_length_1019_cov_7.896739	423	503	3	14	80	0.1750000
NODE_6251_length_1019_cov_7.896739	423	503	4	6	80	0.0750000
NODE_6251_length_1019_cov_7.896739	423	503	6	9	80	0.1125000
NODE_6251_length_1019_cov_7.896739	423	503	7	51	80	0.6375000
NODE_6251_length_1019_cov_7.896739	476	556	3	17	80	0.2125000
NODE_6251_length_1019_cov_7.896739	476	556	5	1	80	0.0125000
NODE_6251_length_1019_cov_7.896739	476	556	6	19	80	0.2375000
NODE_6251_length_1019_cov_7.896739	476	556	7	43	80	0.5375000
NODE_6252_length_1019_cov_4.597826	625	696	7	17	71	0.2394366
NODE_6252_length_1019_cov_4.597826	625	696	8	48	71	0.6760563
NODE_6252_length_1019_cov_4.597826	625	696	9	6	71	0.0845070
NODE_6263_length_1019_cov_1.139130	89	165	7	76	76	1.0000000
NODE_6265_length_1018_cov_33.494015	212	292	4	6	80	0.0750000
NODE_6265_length_1018_cov_33.494015	212	292	5	4	80	0.0500000
NODE_6265_length_1018_cov_33.494015	212	292	6	59	80	0.7375000
NODE_6265_length_1018_cov_33.494015	212	292	7	11	80	0.1375000
NODE_6265_length_1018_cov_33.494015	265	345	4	9	80	0.1125000
NODE_6265_length_1018_cov_33.494015	265	345	5	8	80	0.1000000
NODE_6265_length_1018_cov_33.494015	265	345	6	16	80	0.2000000
NODE_6265_length_1018_cov_33.494015	265	345	7	47	80	0.5875000
NODE_6266_length_1018_cov_22.776931	372	452	0	1	80	0.0125000
NODE_6266_length_1018_cov_22.776931	372	452	1	79	80	0.9875000
NODE_6266_length_1018_cov_22.776931	425	505	1	49	80	0.6125000
NODE_6266_length_1018_cov_22.776931	425	505	3	5	80	0.0625000
NODE_6266_length_1018_cov_22.776931	425	505	5	26	80	0.3250000
NODE_6268_length_1018_cov_8.486398	404	484	4	21	80	0.2625000
NODE_6268_length_1018_cov_8.486398	404	484	5	12	80	0.1500000
NODE_6268_length_1018_cov_8.486398	404	484	6	31	80	0.3875000
NODE_6268_length_1018_cov_8.486398	404	484	7	5	80	0.0625000
NODE_6268_length_1018_cov_8.486398	404	484	8	11	80	0.1375000
NODE_6268_length_1018_cov_8.486398	457	537	5	11	80	0.1375000
NODE_6268_length_1018_cov_8.486398	457	537	6	3	80	0.0375000
NODE_6268_length_1018_cov_8.486398	457	537	7	18	80	0.2250000
NODE_6268_length_1018_cov_8.486398	457	537	8	48	80	0.6000000
NODE_6270_length_1018_cov_7.737758	357	437	1	2	80	0.0250000
NODE_6270_length_1018_cov_7.737758	357	437	2	49	80	0.6125000
NODE_6270_length_1018_cov_7.737758	357	437	4	29	80	0.3625000
NODE_6270_length_1018_cov_7.737758	410	490	3	52	80	0.6500000
NODE_6270_length_1018_cov_7.737758	410	490	4	28	80	0.3500000
NODE_6286_length_1017_cov_207.523965	0	41	10	3	41	0.0731707
NODE_6286_length_1017_cov_207.523965	0	41	12	4	41	0.0975610
NODE_6286_length_1017_cov_207.523965	0	41	14	1	41	0.0243902
NODE_6286_length_1017_cov_207.523965	0	41	15	5	41	0.1219512
NODE_6286_length_1017_cov_207.523965	0	41	17	3	41	0.0731707
NODE_6286_length_1017_cov_207.523965	0	41	19	7	41	0.1707317
NODE_6286_length_1017_cov_207.523965	0	41	20	2	41	0.0487805
NODE_6286_length_1017_cov_207.523965	0	41	21	1	41	0.0243902
NODE_6286_length_1017_cov_207.523965	0	41	22	2	41	0.0487805
NODE_6286_length_1017_cov_207.523965	0	41	24	5	41	0.1219512
NODE_6286_length_1017_cov_207.523965	0	41	25	2	41	0.0487805
NODE_6286_length_1017_cov_207.523965	0	41	26	6	41	0.1463415
NODE_6286_length_1017_cov_207.523965	14	94	17	2	80	0.0250000
NODE_6286_length_1017_cov_207.523965	14	94	19	7	80	0.0875000
NODE_6286_length_1017_cov_207.523965	14	94	20	2	80	0.0250000
NODE_6286_length_1017_cov_207.523965	14	94	21	1	80	0.0125000
NODE_6286_length_1017_cov_207.523965	14	94	22	2	80	0.0250000
NODE_6286_length_1017_cov_207.523965	14	94	24	5	80	0.0625000
NODE_6286_length_1017_cov_207.523965	14	94	25	2	80	0.0250000
NODE_6286_length_1017_cov_207.523965	14	94	26	7	80	0.0875000
NODE_6286_length_1017_cov_207.523965	14	94	27	3	80	0.0375000
NODE_6286_length_1017_cov_207.523965	14	94	28	1	80	0.0125000
NODE_6286_length_1017_cov_207.523965	14	94	29	5	80	0.0625000
NODE_6286_length_1017_cov_207.523965	14	94	30	1	80	0.0125000
NODE_6286_length_1017_cov_207.523965	14	94	31	2	80	0.0250000
NODE_6286_length_1017_cov_207.523965	14	94	32	2	80	0.0250000
NODE_6286_length_1017_cov_207.523965	14	94	33	4	80	0.0500000
NODE_6286_length_1017_cov_207.523965	14	94	34	4	80	0.0500000
NODE_6286_length_1017_cov_207.523965	14	94	36	5	80	0.0625000
NODE_6286_length_1017_cov_207.523965	14	94	37	3	80	0.0375000
NODE_6286_length_1017_cov_207.523965	14	94	39	2	80	0.0250000
NODE_6286_length_1017_cov_207.523965	14	94	40	1	80	0.0125000
NODE_6286_length_1017_cov_207.523965	14	94	42	5	80	0.0625000
NODE_6286_length_1017_cov_207.523965	14	94	43	14	80	0.1750000
NODE_6287_length_1017_cov_18.824619	490	570	2	2	80	0.0250000
NODE_6287_length_1017_cov_18.824619	490	570	3	34	80	0.4250000
NODE_6287_length_1017_cov_18.824619	490	570	4	44	80	0.5500000
NODE_6287_length_1017_cov_18.824619	543	623	1	53	80	0.6625000
NODE_6287_length_1017_cov_18.824619	543	623	2	2	80	0.0250000
NODE_6287_length_1017_cov_18.824619	543	623	3	25	80	0.3125000
NODE_6288_length_1017_cov_14.794118	428	508	0	80	80	1.0000000
NODE_6288_length_1017_cov_14.794118	481	561	0	80	80	1.0000000
NODE_6288_length_1017_cov_14.794118	557	637	0	80	80	1.0000000
NODE_6288_length_1017_cov_14.794118	610	690	0	80	80	1.0000000
NODE_6297_length_1016_cov_22.267176	577	657	4	29	80	0.3625000
NODE_6297_length_1016_cov_22.267176	577	657	6	51	80	0.6375000
NODE_6297_length_1016_cov_22.267176	630	710	0	14	80	0.1750000
NODE_6297_length_1016_cov_22.267176	630	710	2	10	80	0.1250000
NODE_6297_length_1016_cov_22.267176	630	710	3	10	80	0.1250000
NODE_6297_length_1016_cov_22.267176	630	710	4	46	80	0.5750000
NODE_6298_length_1016_cov_21.134133	625	705	4	9	80	0.1125000
NODE_6298_length_1016_cov_21.134133	625	705	6	71	80	0.8875000
NODE_6298_length_1016_cov_21.134133	678	758	0	12	80	0.1500000
NODE_6298_length_1016_cov_21.134133	678	758	2	15	80	0.1875000
NODE_6298_length_1016_cov_21.134133	678	758	3	15	80	0.1875000
NODE_6298_length_1016_cov_21.134133	678	758	5	8	80	0.1000000
NODE_6298_length_1016_cov_21.134133	678	758	6	30	80	0.3750000
NODE_6299_length_1016_cov_20.392585	504	584	0	26	80	0.3250000
NODE_6299_length_1016_cov_20.392585	504	584	1	31	80	0.3875000
NODE_6299_length_1016_cov_20.392585	504	584	2	23	80	0.2875000
NODE_6299_length_1016_cov_20.392585	557	637	0	49	80	0.6125000
NODE_6299_length_1016_cov_20.392585	557	637	1	1	80	0.0125000
NODE_6299_length_1016_cov_20.392585	557	637	2	30	80	0.3750000
NODE_6299_length_1016_cov_20.392585	633	713	2	21	80	0.2625000
NODE_6299_length_1016_cov_20.392585	633	713	3	19	80	0.2375000
NODE_6299_length_1016_cov_20.392585	633	713	4	14	80	0.1750000
NODE_6299_length_1016_cov_20.392585	633	713	5	26	80	0.3250000
NODE_6299_length_1016_cov_20.392585	686	766	3	40	80	0.5000000
NODE_6299_length_1016_cov_20.392585	686	766	4	1	80	0.0125000
NODE_6299_length_1016_cov_20.392585	686	766	5	39	80	0.4875000
NODE_6300_length_1016_cov_16.917121	524	604	2	26	80	0.3250000
NODE_6300_length_1016_cov_16.917121	524	604	4	54	80	0.6750000
NODE_6300_length_1016_cov_16.917121	577	657	2	8	80	0.1000000
NODE_6300_length_1016_cov_16.917121	577	657	4	72	80	0.9000000
NODE_6301_length_1016_cov_8.243184	438	518	0	80	80	1.0000000
NODE_6301_length_1016_cov_8.243184	491	571	0	80	80	1.0000000
NODE_6301_length_1016_cov_8.243184	567	647	0	80	80	1.0000000
NODE_6301_length_1016_cov_8.243184	620	700	0	80	80	1.0000000
NODE_6302_length_1016_cov_8.141767	166	256	5	1	90	0.0111111
NODE_6302_length_1016_cov_8.141767	166	256	6	1	90	0.0111111
NODE_6302_length_1016_cov_8.141767	166	256	10	5	90	0.0555556
NODE_6302_length_1016_cov_8.141767	166	256	13	1	90	0.0111111
NODE_6302_length_1016_cov_8.141767	166	256	14	3	90	0.0333333
NODE_6302_length_1016_cov_8.141767	166	256	15	7	90	0.0777778
NODE_6302_length_1016_cov_8.141767	166	256	17	3	90	0.0333333
NODE_6302_length_1016_cov_8.141767	166	256	18	4	90	0.0444444
NODE_6302_length_1016_cov_8.141767	166	256	21	7	90	0.0777778
NODE_6302_length_1016_cov_8.141767	166	256	22	7	90	0.0777778
NODE_6302_length_1016_cov_8.141767	166	256	23	4	90	0.0444444
NODE_6302_length_1016_cov_8.141767	166	256	24	6	90	0.0666667
NODE_6302_length_1016_cov_8.141767	166	256	26	12	90	0.1333333
NODE_6302_length_1016_cov_8.141767	166	256	28	9	90	0.1000000
NODE_6302_length_1016_cov_8.141767	166	256	30	3	90	0.0333333
NODE_6302_length_1016_cov_8.141767	166	256	31	2	90	0.0222222
NODE_6302_length_1016_cov_8.141767	166	256	32	2	90	0.0222222
NODE_6302_length_1016_cov_8.141767	166	256	33	5	90	0.0555556
NODE_6302_length_1016_cov_8.141767	166	256	36	3	90	0.0333333
NODE_6302_length_1016_cov_8.141767	166	256	39	1	90	0.0111111
NODE_6302_length_1016_cov_8.141767	166	256	40	1	90	0.0111111
NODE_6302_length_1016_cov_8.141767	166	256	41	3	90	0.0333333
NODE_6303_length_1016_cov_7.466739	576	656	0	80	80	1.0000000
NODE_6303_length_1016_cov_7.466739	629	709	0	80	80	1.0000000
NODE_6318_length_1015_cov_24.680131	459	539	2	16	80	0.2000000
NODE_6318_length_1015_cov_24.680131	459	539	4	64	80	0.8000000
NODE_6318_length_1015_cov_24.680131	512	592	0	20	80	0.2500000
NODE_6318_length_1015_cov_24.680131	512	592	2	49	80	0.6125000
NODE_6318_length_1015_cov_24.680131	512	592	4	11	80	0.1375000
NODE_6318_length_1015_cov_24.680131	588	668	0	80	80	1.0000000
NODE_6318_length_1015_cov_24.680131	641	721	0	80	80	1.0000000
NODE_6319_length_1015_cov_23.198690	407	487	3	10	80	0.1250000
NODE_6319_length_1015_cov_23.198690	407	487	4	40	80	0.5000000
NODE_6319_length_1015_cov_23.198690	407	487	5	30	80	0.3750000
NODE_6319_length_1015_cov_23.198690	460	540	1	37	80	0.4625000
NODE_6319_length_1015_cov_23.198690	460	540	2	8	80	0.1000000
NODE_6319_length_1015_cov_23.198690	460	540	3	18	80	0.2250000
NODE_6319_length_1015_cov_23.198690	460	540	4	14	80	0.1750000
NODE_6319_length_1015_cov_23.198690	460	540	5	3	80	0.0375000
NODE_6319_length_1015_cov_23.198690	536	616	1	52	80	0.6500000
NODE_6319_length_1015_cov_23.198690	536	616	2	17	80	0.2125000
NODE_6319_length_1015_cov_23.198690	536	616	3	11	80	0.1375000
NODE_6319_length_1015_cov_23.198690	589	669	2	18	80	0.2250000
NODE_6319_length_1015_cov_23.198690	589	669	3	38	80	0.4750000
NODE_6319_length_1015_cov_23.198690	589	669	4	4	80	0.0500000
NODE_6319_length_1015_cov_23.198690	589	669	5	20	80	0.2500000
NODE_6320_length_1015_cov_22.544760	490	570	2	2	80	0.0250000
NODE_6320_length_1015_cov_22.544760	490	570	3	1	80	0.0125000
NODE_6320_length_1015_cov_22.544760	490	570	4	77	80	0.9625000
NODE_6320_length_1015_cov_22.544760	543	623	0	34	80	0.4250000
NODE_6320_length_1015_cov_22.544760	543	623	1	2	80	0.0250000
NODE_6320_length_1015_cov_22.544760	543	623	2	3	80	0.0375000
NODE_6320_length_1015_cov_22.544760	543	623	3	1	80	0.0125000
NODE_6320_length_1015_cov_22.544760	543	623	4	40	80	0.5000000
NODE_6321_length_1015_cov_17.994541	510	590	5	11	80	0.1375000
NODE_6321_length_1015_cov_17.994541	510	590	7	47	80	0.5875000
NODE_6321_length_1015_cov_17.994541	510	590	9	22	80	0.2750000
NODE_6321_length_1015_cov_17.994541	563	643	5	7	80	0.0875000
NODE_6321_length_1015_cov_17.994541	563	643	6	25	80	0.3125000
NODE_6321_length_1015_cov_17.994541	563	643	7	39	80	0.4875000
NODE_6321_length_1015_cov_17.994541	563	643	8	4	80	0.0500000
NODE_6321_length_1015_cov_17.994541	563	643	9	5	80	0.0625000
NODE_6322_length_1015_cov_16.594978	437	517	5	23	80	0.2875000
NODE_6322_length_1015_cov_16.594978	437	517	6	57	80	0.7125000
NODE_6322_length_1015_cov_16.594978	490	570	2	2	80	0.0250000
NODE_6322_length_1015_cov_16.594978	490	570	3	6	80	0.0750000
NODE_6322_length_1015_cov_16.594978	490	570	4	36	80	0.4500000
NODE_6322_length_1015_cov_16.594978	490	570	5	32	80	0.4000000
NODE_6322_length_1015_cov_16.594978	490	570	6	4	80	0.0500000
NODE_6323_length_1015_cov_14.000000	505	585	1	48	80	0.6000000
NODE_6323_length_1015_cov_14.000000	505	585	2	32	80	0.4000000
NODE_6323_length_1015_cov_14.000000	558	638	1	80	80	1.0000000
NODE_6324_length_1015_cov_9.978166	345	425	0	80	80	1.0000000
NODE_6324_length_1015_cov_9.978166	398	478	0	80	80	1.0000000
NODE_6325_length_1015_cov_6.844978	393	473	1	11	80	0.1375000
NODE_6325_length_1015_cov_6.844978	393	473	2	11	80	0.1375000
NODE_6325_length_1015_cov_6.844978	393	473	3	23	80	0.2875000
NODE_6325_length_1015_cov_6.844978	393	473	4	35	80	0.4375000
NODE_6325_length_1015_cov_6.844978	446	526	3	76	80	0.9500000
NODE_6325_length_1015_cov_6.844978	446	526	4	4	80	0.0500000
NODE_6337_length_1014_cov_95.709290	259	335	0	15	76	0.1973684
NODE_6337_length_1014_cov_95.709290	259	335	1	61	76	0.8026316
NODE_6337_length_1014_cov_95.709290	310	390	1	31	80	0.3875000
NODE_6337_length_1014_cov_95.709290	310	390	2	40	80	0.5000000
NODE_6337_length_1014_cov_95.709290	310	390	4	9	80	0.1125000
NODE_6337_length_1014_cov_95.709290	386	466	3	34	80	0.4250000
NODE_6337_length_1014_cov_95.709290	386	466	4	46	80	0.5750000
NODE_6337_length_1014_cov_95.709290	439	519	0	16	80	0.2000000
NODE_6337_length_1014_cov_95.709290	439	519	2	12	80	0.1500000
NODE_6337_length_1014_cov_95.709290	439	519	3	52	80	0.6500000
NODE_6338_length_1014_cov_67.918033	182	262	1	12	80	0.1500000
NODE_6338_length_1014_cov_67.918033	182	262	2	68	80	0.8500000
NODE_6338_length_1014_cov_67.918033	235	315	1	8	80	0.1000000
NODE_6338_length_1014_cov_67.918033	235	315	2	32	80	0.4000000
NODE_6338_length_1014_cov_67.918033	235	315	4	40	80	0.5000000
NODE_6338_length_1014_cov_67.918033	311	391	4	16	80	0.2000000
NODE_6338_length_1014_cov_67.918033	311	391	5	5	80	0.0625000
NODE_6338_length_1014_cov_67.918033	311	391	6	2	80	0.0250000
NODE_6338_length_1014_cov_67.918033	311	391	7	42	80	0.5250000
NODE_6338_length_1014_cov_67.918033	311	391	9	15	80	0.1875000
NODE_6338_length_1014_cov_67.918033	364	444	4	8	80	0.1000000
NODE_6338_length_1014_cov_67.918033	364	444	6	41	80	0.5125000
NODE_6338_length_1014_cov_67.918033	364	444	7	12	80	0.1500000
NODE_6338_length_1014_cov_67.918033	364	444	8	2	80	0.0250000
NODE_6338_length_1014_cov_67.918033	364	444	9	17	80	0.2125000
NODE_6339_length_1014_cov_44.802186	418	498	0	80	80	1.0000000
NODE_6339_length_1014_cov_44.802186	471	551	0	80	80	1.0000000
NODE_6340_length_1014_cov_36.349727	369	449	2	5	80	0.0625000
NODE_6340_length_1014_cov_36.349727	369	449	3	26	80	0.3250000
NODE_6340_length_1014_cov_36.349727	369	449	4	2	80	0.0250000
NODE_6340_length_1014_cov_36.349727	369	449	5	21	80	0.2625000
NODE_6340_length_1014_cov_36.349727	369	449	6	18	80	0.2250000
NODE_6340_length_1014_cov_36.349727	369	449	7	8	80	0.1000000
NODE_6340_length_1014_cov_36.349727	422	502	5	1	80	0.0125000
NODE_6340_length_1014_cov_36.349727	422	502	6	57	80	0.7125000
NODE_6340_length_1014_cov_36.349727	422	502	7	22	80	0.2750000
NODE_6340_length_1014_cov_36.349727	498	578	5	15	80	0.1875000
NODE_6340_length_1014_cov_36.349727	498	578	6	13	80	0.1625000
NODE_6340_length_1014_cov_36.349727	498	578	7	47	80	0.5875000
NODE_6340_length_1014_cov_36.349727	498	578	8	5	80	0.0625000
NODE_6340_length_1014_cov_36.349727	551	631	3	22	80	0.2750000
NODE_6340_length_1014_cov_36.349727	551	631	4	22	80	0.2750000
NODE_6340_length_1014_cov_36.349727	551	631	5	24	80	0.3000000
NODE_6340_length_1014_cov_36.349727	551	631	6	12	80	0.1500000
NODE_6341_length_1014_cov_35.547541	363	441	0	25	78	0.3205128
NODE_6341_length_1014_cov_35.547541	363	441	1	4	78	0.0512821
NODE_6341_length_1014_cov_35.547541	363	441	2	49	78	0.6282051
NODE_6341_length_1014_cov_35.547541	416	494	2	78	78	1.0000000
NODE_6342_length_1014_cov_32.266667	428	508	2	6	80	0.0750000
NODE_6342_length_1014_cov_32.266667	428	508	4	4	80	0.0500000
NODE_6342_length_1014_cov_32.266667	428	508	5	3	80	0.0375000
NODE_6342_length_1014_cov_32.266667	428	508	6	21	80	0.2625000
NODE_6342_length_1014_cov_32.266667	428	508	8	29	80	0.3625000
NODE_6342_length_1014_cov_32.266667	428	508	9	13	80	0.1625000
NODE_6342_length_1014_cov_32.266667	428	508	11	4	80	0.0500000
NODE_6342_length_1014_cov_32.266667	481	561	8	10	80	0.1250000
NODE_6342_length_1014_cov_32.266667	481	561	9	26	80	0.3250000
NODE_6342_length_1014_cov_32.266667	481	561	10	34	80	0.4250000
NODE_6342_length_1014_cov_32.266667	481	561	11	10	80	0.1250000
NODE_6343_length_1014_cov_28.493989	480	560	2	46	80	0.5750000
NODE_6343_length_1014_cov_28.493989	480	560	3	8	80	0.1000000
NODE_6343_length_1014_cov_28.493989	480	560	5	26	80	0.3250000
NODE_6343_length_1014_cov_28.493989	533	613	3	1	80	0.0125000
NODE_6343_length_1014_cov_28.493989	533	613	5	78	80	0.9750000
NODE_6343_length_1014_cov_28.493989	533	613	6	1	80	0.0125000
NODE_6343_length_1014_cov_28.493989	609	689	4	37	80	0.4625000
NODE_6343_length_1014_cov_28.493989	609	689	5	10	80	0.1250000
NODE_6343_length_1014_cov_28.493989	609	689	6	6	80	0.0750000
NODE_6343_length_1014_cov_28.493989	609	689	7	27	80	0.3375000
NODE_6343_length_1014_cov_28.493989	662	742	2	2	80	0.0250000
NODE_6343_length_1014_cov_28.493989	662	742	4	74	80	0.9250000
NODE_6343_length_1014_cov_28.493989	662	742	5	4	80	0.0500000
NODE_6344_length_1014_cov_25.171585	500	580	1	3	80	0.0375000
NODE_6344_length_1014_cov_25.171585	500	580	3	19	80	0.2375000
NODE_6344_length_1014_cov_25.171585	500	580	4	58	80	0.7250000
NODE_6344_length_1014_cov_25.171585	553	633	1	17	80	0.2125000
NODE_6344_length_1014_cov_25.171585	553	633	3	19	80	0.2375000
NODE_6344_length_1014_cov_25.171585	553	633	4	44	80	0.5500000
NODE_6345_length_1014_cov_22.437158	534	614	2	35	80	0.4375000
NODE_6345_length_1014_cov_22.437158	534	614	3	11	80	0.1375000
NODE_6345_length_1014_cov_22.437158	534	614	4	34	80	0.4250000
NODE_6345_length_1014_cov_22.437158	587	667	2	16	80	0.2000000
NODE_6345_length_1014_cov_22.437158	587	667	3	6	80	0.0750000
NODE_6345_length_1014_cov_22.437158	587	667	4	58	80	0.7250000
NODE_6346_length_1014_cov_19.238251	379	459	0	80	80	1.0000000
NODE_6346_length_1014_cov_19.238251	432	512	0	80	80	1.0000000
NODE_6346_length_1014_cov_19.238251	508	585	0	77	77	1.0000000
NODE_6346_length_1014_cov_19.238251	558	638	0	71	80	0.8875000
NODE_6346_length_1014_cov_19.238251	558	638	1	9	80	0.1125000
NODE_6347_length_1014_cov_15.926776	594	674	0	80	80	1.0000000
NODE_6347_length_1014_cov_15.926776	647	727	0	80	80	1.0000000
NODE_6348_length_1014_cov_8.691803	285	365	0	80	80	1.0000000
NODE_6348_length_1014_cov_8.691803	338	418	0	80	80	1.0000000
NODE_6349_length_1014_cov_7.959563	531	611	2	30	80	0.3750000
NODE_6349_length_1014_cov_7.959563	531	611	3	2	80	0.0250000
NODE_6349_length_1014_cov_7.959563	531	611	4	48	80	0.6000000
NODE_6349_length_1014_cov_7.959563	584	664	2	52	80	0.6500000
NODE_6349_length_1014_cov_7.959563	584	664	3	3	80	0.0375000
NODE_6349_length_1014_cov_7.959563	584	664	4	25	80	0.3125000
NODE_6351_length_1014_cov_7.608743	298	378	0	37	80	0.4625000
NODE_6351_length_1014_cov_7.608743	298	378	1	27	80	0.3375000
NODE_6351_length_1014_cov_7.608743	298	378	2	16	80	0.2000000
NODE_6351_length_1014_cov_7.608743	351	431	1	11	80	0.1375000
NODE_6351_length_1014_cov_7.608743	351	431	2	53	80	0.6625000
NODE_6351_length_1014_cov_7.608743	351	431	3	16	80	0.2000000
NODE_6352_length_1014_cov_6.209836	321	401	0	80	80	1.0000000
NODE_6352_length_1014_cov_6.209836	374	454	0	80	80	1.0000000
NODE_6364_length_1013_cov_32.695842	423	503	0	7	80	0.0875000
NODE_6364_length_1013_cov_32.695842	423	503	1	1	80	0.0125000
NODE_6364_length_1013_cov_32.695842	423	503	5	72	80	0.9000000
NODE_6364_length_1013_cov_32.695842	476	556	0	50	80	0.6250000
NODE_6364_length_1013_cov_32.695842	476	556	1	5	80	0.0625000
NODE_6364_length_1013_cov_32.695842	476	556	2	6	80	0.0750000
NODE_6364_length_1013_cov_32.695842	476	556	5	19	80	0.2375000
NODE_6364_length_1013_cov_32.695842	552	632	2	15	80	0.1875000
NODE_6364_length_1013_cov_32.695842	552	632	3	5	80	0.0625000
NODE_6364_length_1013_cov_32.695842	552	632	5	31	80	0.3875000
NODE_6364_length_1013_cov_32.695842	552	632	6	6	80	0.0750000
NODE_6364_length_1013_cov_32.695842	552	632	7	23	80	0.2875000
NODE_6364_length_1013_cov_32.695842	605	685	6	4	80	0.0500000
NODE_6364_length_1013_cov_32.695842	605	685	7	76	80	0.9500000
NODE_6365_length_1013_cov_21.935449	424	503	1	8	79	0.1012658
NODE_6365_length_1013_cov_21.935449	424	503	2	71	79	0.8987342
NODE_6365_length_1013_cov_21.935449	476	556	2	80	80	1.0000000
NODE_6366_length_1013_cov_17.532823	440	520	1	45	80	0.5625000
NODE_6366_length_1013_cov_17.532823	440	520	2	35	80	0.4375000
NODE_6366_length_1013_cov_17.532823	493	573	1	57	80	0.7125000
NODE_6366_length_1013_cov_17.532823	493	573	2	23	80	0.2875000
NODE_6367_length_1013_cov_14.555799	478	558	0	80	80	1.0000000
NODE_6367_length_1013_cov_14.555799	531	611	0	80	80	1.0000000
NODE_6368_length_1013_cov_13.142232	476	556	6	4	80	0.0500000
NODE_6368_length_1013_cov_13.142232	476	556	7	8	80	0.1000000
NODE_6368_length_1013_cov_13.142232	476	556	8	68	80	0.8500000
NODE_6368_length_1013_cov_13.142232	529	609	4	7	80	0.0875000
NODE_6368_length_1013_cov_13.142232	529	609	5	1	80	0.0125000
NODE_6368_length_1013_cov_13.142232	529	609	6	21	80	0.2625000
NODE_6368_length_1013_cov_13.142232	529	609	7	8	80	0.1000000
NODE_6368_length_1013_cov_13.142232	529	609	8	42	80	0.5250000
NODE_6368_length_1013_cov_13.142232	529	609	9	1	80	0.0125000
NODE_6369_length_1013_cov_7.756018	538	618	0	33	80	0.4125000
NODE_6369_length_1013_cov_7.756018	538	618	2	47	80	0.5875000
NODE_6369_length_1013_cov_7.756018	591	671	2	80	80	1.0000000
NODE_6371_length_1013_cov_4.368709	550	630	1	17	80	0.2125000
NODE_6371_length_1013_cov_4.368709	550	630	3	6	80	0.0750000
NODE_6371_length_1013_cov_4.368709	550	630	4	57	80	0.7125000
NODE_6371_length_1013_cov_4.368709	603	683	2	32	80	0.4000000
NODE_6371_length_1013_cov_4.368709	603	683	4	48	80	0.6000000
NODE_6380_length_1012_cov_91.547645	378	458	1	49	80	0.6125000
NODE_6380_length_1012_cov_91.547645	378	458	2	16	80	0.2000000
NODE_6380_length_1012_cov_91.547645	378	458	3	15	80	0.1875000
NODE_6380_length_1012_cov_91.547645	431	511	2	12	80	0.1500000
NODE_6380_length_1012_cov_91.547645	431	511	3	41	80	0.5125000
NODE_6380_length_1012_cov_91.547645	431	511	4	27	80	0.3375000
NODE_6380_length_1012_cov_91.547645	507	587	3	4	80	0.0500000
NODE_6380_length_1012_cov_91.547645	507	587	4	40	80	0.5000000
NODE_6380_length_1012_cov_91.547645	507	587	5	13	80	0.1625000
NODE_6380_length_1012_cov_91.547645	507	587	6	23	80	0.2875000
NODE_6380_length_1012_cov_91.547645	560	640	4	20	80	0.2500000
NODE_6380_length_1012_cov_91.547645	560	640	5	31	80	0.3875000
NODE_6380_length_1012_cov_91.547645	560	640	6	29	80	0.3625000
NODE_6381_length_1012_cov_64.409639	345	425	9	3	80	0.0375000
NODE_6381_length_1012_cov_64.409639	345	425	11	15	80	0.1875000
NODE_6381_length_1012_cov_64.409639	345	425	12	41	80	0.5125000
NODE_6381_length_1012_cov_64.409639	345	425	13	18	80	0.2250000
NODE_6381_length_1012_cov_64.409639	345	425	14	3	80	0.0375000
NODE_6381_length_1012_cov_64.409639	398	478	11	25	80	0.3125000
NODE_6381_length_1012_cov_64.409639	398	478	12	33	80	0.4125000
NODE_6381_length_1012_cov_64.409639	398	478	13	19	80	0.2375000
NODE_6381_length_1012_cov_64.409639	398	478	14	3	80	0.0375000
NODE_6382_length_1012_cov_63.035049	438	518	5	19	80	0.2375000
NODE_6382_length_1012_cov_63.035049	438	518	6	44	80	0.5500000
NODE_6382_length_1012_cov_63.035049	438	518	7	17	80	0.2125000
NODE_6382_length_1012_cov_63.035049	491	571	4	10	80	0.1250000
NODE_6382_length_1012_cov_63.035049	491	571	6	35	80	0.4375000
NODE_6382_length_1012_cov_63.035049	491	571	7	35	80	0.4375000
NODE_6383_length_1012_cov_53.686747	276	356	3	40	80	0.5000000
NODE_6383_length_1012_cov_53.686747	276	356	4	10	80	0.1250000
NODE_6383_length_1012_cov_53.686747	276	356	5	30	80	0.3750000
NODE_6383_length_1012_cov_53.686747	329	409	3	4	80	0.0500000
NODE_6383_length_1012_cov_53.686747	329	409	4	2	80	0.0250000
NODE_6383_length_1012_cov_53.686747	329	409	5	70	80	0.8750000
NODE_6383_length_1012_cov_53.686747	329	409	6	4	80	0.0500000
NODE_6383_length_1012_cov_53.686747	405	485	1	9	80	0.1125000
NODE_6383_length_1012_cov_53.686747	405	485	2	10	80	0.1250000
NODE_6383_length_1012_cov_53.686747	405	485	3	61	80	0.7625000
NODE_6383_length_1012_cov_53.686747	458	538	1	19	80	0.2375000
NODE_6383_length_1012_cov_53.686747	458	538	2	14	80	0.1750000
NODE_6383_length_1012_cov_53.686747	458	538	3	47	80	0.5875000
NODE_6384_length_1012_cov_35.861993	453	533	0	80	80	1.0000000
NODE_6384_length_1012_cov_35.861993	506	581	0	48	75	0.6400000
NODE_6384_length_1012_cov_35.861993	506	581	1	27	75	0.3600000
NODE_6385_length_1012_cov_16.125958	510	590	2	80	80	1.0000000
NODE_6385_length_1012_cov_16.125958	563	643	1	9	80	0.1125000
NODE_6385_length_1012_cov_16.125958	563	643	2	71	80	0.8875000
NODE_6386_length_1012_cov_15.395400	501	581	0	80	80	1.0000000
NODE_6386_length_1012_cov_15.395400	554	634	0	63	80	0.7875000
NODE_6386_length_1012_cov_15.395400	554	634	2	17	80	0.2125000
NODE_6388_length_1012_cov_6.409639	528	608	0	80	80	1.0000000
NODE_6388_length_1012_cov_6.409639	581	661	0	80	80	1.0000000
NODE_6398_length_1011_cov_53.032895	515	595	4	7	80	0.0875000
NODE_6398_length_1011_cov_53.032895	515	595	5	2	80	0.0250000
NODE_6398_length_1011_cov_53.032895	515	595	6	22	80	0.2750000
NODE_6398_length_1011_cov_53.032895	515	595	7	13	80	0.1625000
NODE_6398_length_1011_cov_53.032895	515	595	8	36	80	0.4500000
NODE_6398_length_1011_cov_53.032895	568	648	4	47	80	0.5875000
NODE_6398_length_1011_cov_53.032895	568	648	6	21	80	0.2625000
NODE_6398_length_1011_cov_53.032895	568	648	8	12	80	0.1500000
NODE_6399_length_1011_cov_25.838816	366	446	0	80	80	1.0000000
NODE_6399_length_1011_cov_25.838816	419	499	0	80	80	1.0000000
NODE_6400_length_1011_cov_22.734649	426	506	0	58	80	0.7250000
NODE_6400_length_1011_cov_22.734649	426	506	2	22	80	0.2750000
NODE_6400_length_1011_cov_22.734649	479	559	0	5	80	0.0625000
NODE_6400_length_1011_cov_22.734649	479	559	2	30	80	0.3750000
NODE_6400_length_1011_cov_22.734649	479	559	3	37	80	0.4625000
NODE_6400_length_1011_cov_22.734649	479	559	5	8	80	0.1000000
NODE_6400_length_1011_cov_22.734649	555	636	5	7	81	0.0864198
NODE_6400_length_1011_cov_22.734649	555	636	7	7	81	0.0864198
NODE_6400_length_1011_cov_22.734649	555	636	8	5	81	0.0617284
NODE_6400_length_1011_cov_22.734649	555	636	9	4	81	0.0493827
NODE_6400_length_1011_cov_22.734649	555	636	10	2	81	0.0246914
NODE_6400_length_1011_cov_22.734649	555	636	11	33	81	0.4074074
NODE_6400_length_1011_cov_22.734649	555	636	12	23	81	0.2839506
NODE_6400_length_1011_cov_22.734649	609	689	5	16	80	0.2000000
NODE_6400_length_1011_cov_22.734649	609	689	7	9	80	0.1125000
NODE_6400_length_1011_cov_22.734649	609	689	10	30	80	0.3750000
NODE_6400_length_1011_cov_22.734649	609	689	11	2	80	0.0250000
NODE_6400_length_1011_cov_22.734649	609	689	12	23	80	0.2875000
NODE_6401_length_1011_cov_18.127193	389	469	0	80	80	1.0000000
NODE_6401_length_1011_cov_18.127193	442	520	0	32	78	0.4102564
NODE_6401_length_1011_cov_18.127193	442	520	1	14	78	0.1794872
NODE_6401_length_1011_cov_18.127193	442	520	2	32	78	0.4102564
NODE_6401_length_1011_cov_18.127193	516	596	2	42	80	0.5250000
NODE_6401_length_1011_cov_18.127193	516	596	4	38	80	0.4750000
NODE_6401_length_1011_cov_18.127193	569	649	0	2	80	0.0250000
NODE_6401_length_1011_cov_18.127193	569	649	2	9	80	0.1125000
NODE_6401_length_1011_cov_18.127193	569	649	3	14	80	0.1750000
NODE_6401_length_1011_cov_18.127193	569	649	4	55	80	0.6875000
NODE_6402_length_1011_cov_12.709430	309	389	1	13	80	0.1625000
NODE_6402_length_1011_cov_12.709430	309	389	2	67	80	0.8375000
NODE_6402_length_1011_cov_12.709430	362	442	2	80	80	1.0000000
NODE_6403_length_1011_cov_8.731360	441	521	2	80	80	1.0000000
NODE_6403_length_1011_cov_8.731360	494	574	0	2	80	0.0250000
NODE_6403_length_1011_cov_8.731360	494	574	1	1	80	0.0125000
NODE_6403_length_1011_cov_8.731360	494	574	2	77	80	0.9625000
NODE_6405_length_1011_cov_7.212719	219	299	1	79	80	0.9875000
NODE_6405_length_1011_cov_7.212719	219	299	2	1	80	0.0125000
NODE_6408_length_1011_cov_3.569079	173	253	0	80	80	1.0000000
NODE_6408_length_1011_cov_3.569079	226	306	0	80	80	1.0000000
NODE_6409_length_1011_cov_1.703947	779	851	6	4	72	0.0555556
NODE_6409_length_1011_cov_1.703947	779	851	8	1	72	0.0138889
NODE_6409_length_1011_cov_1.703947	779	851	9	2	72	0.0277778
NODE_6409_length_1011_cov_1.703947	779	851	11	2	72	0.0277778
NODE_6409_length_1011_cov_1.703947	779	851	12	3	72	0.0416667
NODE_6409_length_1011_cov_1.703947	779	851	13	2	72	0.0277778
NODE_6409_length_1011_cov_1.703947	779	851	14	2	72	0.0277778
NODE_6409_length_1011_cov_1.703947	779	851	16	7	72	0.0972222
NODE_6409_length_1011_cov_1.703947	779	851	17	4	72	0.0555556
NODE_6409_length_1011_cov_1.703947	779	851	19	1	72	0.0138889
NODE_6409_length_1011_cov_1.703947	779	851	20	1	72	0.0138889
NODE_6409_length_1011_cov_1.703947	779	851	22	4	72	0.0555556
NODE_6409_length_1011_cov_1.703947	779	851	24	4	72	0.0555556
NODE_6409_length_1011_cov_1.703947	779	851	25	1	72	0.0138889
NODE_6409_length_1011_cov_1.703947	779	851	27	1	72	0.0138889
NODE_6409_length_1011_cov_1.703947	779	851	29	10	72	0.1388889
NODE_6409_length_1011_cov_1.703947	779	851	30	3	72	0.0416667
NODE_6409_length_1011_cov_1.703947	779	851	31	15	72	0.2083333
NODE_6409_length_1011_cov_1.703947	779	851	32	5	72	0.0694444
NODE_6416_length_1010_cov_51.841932	335	415	2	19	80	0.2375000
NODE_6416_length_1010_cov_51.841932	335	415	3	23	80	0.2875000
NODE_6416_length_1010_cov_51.841932	335	415	4	38	80	0.4750000
NODE_6416_length_1010_cov_51.841932	388	468	2	15	80	0.1875000
NODE_6416_length_1010_cov_51.841932	388	468	3	15	80	0.1875000
NODE_6416_length_1010_cov_51.841932	388	468	4	50	80	0.6250000
NODE_6417_length_1010_cov_35.860593	576	656	0	2	80	0.0250000
NODE_6417_length_1010_cov_35.860593	576	656	1	78	80	0.9750000
NODE_6417_length_1010_cov_35.860593	629	709	1	80	80	1.0000000
NODE_6418_length_1010_cov_30.043908	509	589	1	13	80	0.1625000
NODE_6418_length_1010_cov_30.043908	509	589	2	49	80	0.6125000
NODE_6418_length_1010_cov_30.043908	509	589	3	18	80	0.2250000
NODE_6418_length_1010_cov_30.043908	562	642	2	9	80	0.1125000
NODE_6418_length_1010_cov_30.043908	562	642	3	45	80	0.5625000
NODE_6418_length_1010_cov_30.043908	562	642	5	26	80	0.3250000
NODE_6418_length_1010_cov_30.043908	638	718	3	22	80	0.2750000
NODE_6418_length_1010_cov_30.043908	638	718	4	47	80	0.5875000
NODE_6418_length_1010_cov_30.043908	638	718	5	10	80	0.1250000
NODE_6418_length_1010_cov_30.043908	638	718	6	1	80	0.0125000
NODE_6418_length_1010_cov_30.043908	691	771	3	14	80	0.1750000
NODE_6418_length_1010_cov_30.043908	691	771	4	23	80	0.2875000
NODE_6418_length_1010_cov_30.043908	691	771	5	39	80	0.4875000
NODE_6418_length_1010_cov_30.043908	691	771	6	4	80	0.0500000
NODE_6420_length_1010_cov_15.156970	364	444	1	58	80	0.7250000
NODE_6420_length_1010_cov_15.156970	364	444	2	1	80	0.0125000
NODE_6420_length_1010_cov_15.156970	364	444	3	21	80	0.2625000
NODE_6420_length_1010_cov_15.156970	417	497	1	5	80	0.0625000
NODE_6420_length_1010_cov_15.156970	417	497	2	1	80	0.0125000
NODE_6420_length_1010_cov_15.156970	417	497	3	35	80	0.4375000
NODE_6420_length_1010_cov_15.156970	417	497	4	39	80	0.4875000
NODE_6421_length_1010_cov_13.546652	385	465	0	80	80	1.0000000
NODE_6421_length_1010_cov_13.546652	438	518	0	80	80	1.0000000
NODE_6422_length_1010_cov_13.317234	480	560	1	5	80	0.0625000
NODE_6422_length_1010_cov_13.317234	480	560	2	46	80	0.5750000
NODE_6422_length_1010_cov_13.317234	480	560	4	29	80	0.3625000
NODE_6422_length_1010_cov_13.317234	533	613	3	25	80	0.3125000
NODE_6422_length_1010_cov_13.317234	533	613	4	55	80	0.6875000
NODE_6423_length_1010_cov_12.900110	427	507	2	61	80	0.7625000
NODE_6423_length_1010_cov_12.900110	427	507	3	17	80	0.2125000
NODE_6423_length_1010_cov_12.900110	427	507	4	2	80	0.0250000
NODE_6423_length_1010_cov_12.900110	480	560	2	8	80	0.1000000
NODE_6423_length_1010_cov_12.900110	480	560	3	20	80	0.2500000
NODE_6423_length_1010_cov_12.900110	480	560	4	52	80	0.6500000
NODE_6424_length_1010_cov_11.423710	631	711	0	6	80	0.0750000
NODE_6424_length_1010_cov_11.423710	631	711	2	74	80	0.9250000
NODE_6424_length_1010_cov_11.423710	684	764	0	8	80	0.1000000
NODE_6424_length_1010_cov_11.423710	684	764	2	72	80	0.9000000
NODE_6425_length_1010_cov_11.256861	492	572	0	80	80	1.0000000
NODE_6425_length_1010_cov_11.256861	545	625	0	80	80	1.0000000
NODE_6426_length_1010_cov_11.000000	455	535	0	62	80	0.7750000
NODE_6426_length_1010_cov_11.000000	455	535	1	18	80	0.2250000
NODE_6426_length_1010_cov_11.000000	508	588	0	9	80	0.1125000
NODE_6426_length_1010_cov_11.000000	508	588	1	49	80	0.6125000
NODE_6426_length_1010_cov_11.000000	508	588	2	22	80	0.2750000
NODE_6428_length_1010_cov_4.990121	476	556	0	80	80	1.0000000
NODE_6428_length_1010_cov_4.990121	529	609	0	72	80	0.9000000
NODE_6428_length_1010_cov_4.990121	529	609	2	8	80	0.1000000
NODE_6430_length_1010_cov_4.892426	476	556	0	18	80	0.2250000
NODE_6430_length_1010_cov_4.892426	476	556	2	47	80	0.5875000
NODE_6430_length_1010_cov_4.892426	476	556	4	15	80	0.1875000
NODE_6430_length_1010_cov_4.892426	529	609	2	12	80	0.1500000
NODE_6430_length_1010_cov_4.892426	529	609	4	68	80	0.8500000
NODE_6431_length_1010_cov_3.624588	157	196	0	39	39	1.0000000
NODE_6435_length_1010_cov_1.440176	1	58	0	57	57	1.0000000
NODE_6436_length_1009_cov_44.626374	288	362	0	44	74	0.5945946
NODE_6436_length_1009_cov_44.626374	288	362	2	30	74	0.4054054
NODE_6436_length_1009_cov_44.626374	335	415	2	80	80	1.0000000
NODE_6436_length_1009_cov_44.626374	411	491	2	9	80	0.1125000
NODE_6436_length_1009_cov_44.626374	411	491	3	19	80	0.2375000
NODE_6436_length_1009_cov_44.626374	411	491	4	47	80	0.5875000
NODE_6436_length_1009_cov_44.626374	411	491	5	5	80	0.0625000
NODE_6436_length_1009_cov_44.626374	464	544	3	4	80	0.0500000
NODE_6436_length_1009_cov_44.626374	464	544	4	76	80	0.9500000
NODE_6437_length_1009_cov_31.828571	412	492	6	6	80	0.0750000
NODE_6437_length_1009_cov_31.828571	412	492	7	37	80	0.4625000
NODE_6437_length_1009_cov_31.828571	412	492	8	37	80	0.4625000
NODE_6437_length_1009_cov_31.828571	465	545	5	16	80	0.2000000
NODE_6437_length_1009_cov_31.828571	465	545	6	21	80	0.2625000
NODE_6437_length_1009_cov_31.828571	465	545	7	42	80	0.5250000
NODE_6437_length_1009_cov_31.828571	465	545	8	1	80	0.0125000
NODE_6438_length_1009_cov_28.539560	571	651	4	7	80	0.0875000
NODE_6438_length_1009_cov_28.539560	571	651	6	9	80	0.1125000
NODE_6438_length_1009_cov_28.539560	571	651	7	64	80	0.8000000
NODE_6438_length_1009_cov_28.539560	624	704	1	2	80	0.0250000
NODE_6438_length_1009_cov_28.539560	624	704	2	30	80	0.3750000
NODE_6438_length_1009_cov_28.539560	624	704	4	18	80	0.2250000
NODE_6438_length_1009_cov_28.539560	624	704	6	8	80	0.1000000
NODE_6438_length_1009_cov_28.539560	624	704	7	22	80	0.2750000
NODE_6439_length_1009_cov_20.281319	577	657	3	38	80	0.4750000
NODE_6439_length_1009_cov_20.281319	577	657	5	14	80	0.1750000
NODE_6439_length_1009_cov_20.281319	577	657	6	28	80	0.3500000
NODE_6439_length_1009_cov_20.281319	630	710	2	40	80	0.5000000
NODE_6439_length_1009_cov_20.281319	630	710	3	40	80	0.5000000
NODE_6440_length_1009_cov_18.649451	430	510	0	11	80	0.1375000
NODE_6440_length_1009_cov_18.649451	430	510	1	1	80	0.0125000
NODE_6440_length_1009_cov_18.649451	430	510	2	68	80	0.8500000
NODE_6440_length_1009_cov_18.649451	483	563	0	15	80	0.1875000
NODE_6440_length_1009_cov_18.649451	483	563	1	30	80	0.3750000
NODE_6440_length_1009_cov_18.649451	483	563	2	35	80	0.4375000
NODE_6442_length_1009_cov_3.767033	647	727	0	80	80	1.0000000
NODE_6442_length_1009_cov_3.767033	700	780	0	80	80	1.0000000
NODE_6443_length_1009_cov_2.903297	36	63	0	27	27	1.0000000
NODE_6451_length_1008_cov_44.825083	399	479	5	17	80	0.2125000
NODE_6451_length_1008_cov_44.825083	399	479	6	34	80	0.4250000
NODE_6451_length_1008_cov_44.825083	399	479	7	27	80	0.3375000
NODE_6451_length_1008_cov_44.825083	399	479	8	2	80	0.0250000
NODE_6451_length_1008_cov_44.825083	452	532	2	8	80	0.1000000
NODE_6451_length_1008_cov_44.825083	452	532	3	18	80	0.2250000
NODE_6451_length_1008_cov_44.825083	452	532	4	21	80	0.2625000
NODE_6451_length_1008_cov_44.825083	452	532	6	22	80	0.2750000
NODE_6451_length_1008_cov_44.825083	452	532	7	11	80	0.1375000
NODE_6452_length_1008_cov_41.030803	280	360	1	36	80	0.4500000
NODE_6452_length_1008_cov_41.030803	280	360	3	43	80	0.5375000
NODE_6452_length_1008_cov_41.030803	280	360	4	1	80	0.0125000
NODE_6452_length_1008_cov_41.030803	333	413	1	49	80	0.6125000
NODE_6452_length_1008_cov_41.030803	333	413	3	31	80	0.3875000
NODE_6452_length_1008_cov_41.030803	409	489	3	80	80	1.0000000
NODE_6452_length_1008_cov_41.030803	462	542	1	29	80	0.3625000
NODE_6452_length_1008_cov_41.030803	462	542	3	39	80	0.4875000
NODE_6452_length_1008_cov_41.030803	462	542	4	12	80	0.1500000
NODE_6453_length_1008_cov_39.377338	311	391	0	8	80	0.1000000
NODE_6453_length_1008_cov_39.377338	311	391	2	72	80	0.9000000
NODE_6453_length_1008_cov_39.377338	364	444	0	61	80	0.7625000
NODE_6453_length_1008_cov_39.377338	364	444	2	19	80	0.2375000
NODE_6453_length_1008_cov_39.377338	440	520	0	20	80	0.2500000
NODE_6453_length_1008_cov_39.377338	440	520	1	11	80	0.1375000
NODE_6453_length_1008_cov_39.377338	440	520	2	43	80	0.5375000
NODE_6453_length_1008_cov_39.377338	440	520	3	4	80	0.0500000
NODE_6453_length_1008_cov_39.377338	440	520	4	2	80	0.0250000
NODE_6453_length_1008_cov_39.377338	493	573	2	21	80	0.2625000
NODE_6453_length_1008_cov_39.377338	493	573	3	4	80	0.0500000
NODE_6453_length_1008_cov_39.377338	493	573	4	55	80	0.6875000
NODE_6454_length_1008_cov_27.836084	405	485	0	80	80	1.0000000
NODE_6454_length_1008_cov_27.836084	458	538	0	80	80	1.0000000
NODE_6454_length_1008_cov_27.836084	534	614	0	80	80	1.0000000
NODE_6454_length_1008_cov_27.836084	587	667	0	80	80	1.0000000
NODE_6455_length_1008_cov_24.741474	485	565	2	5	80	0.0625000
NODE_6455_length_1008_cov_24.741474	485	565	3	18	80	0.2250000
NODE_6455_length_1008_cov_24.741474	485	565	4	10	80	0.1250000
NODE_6455_length_1008_cov_24.741474	485	565	5	4	80	0.0500000
NODE_6455_length_1008_cov_24.741474	485	565	6	11	80	0.1375000
NODE_6455_length_1008_cov_24.741474	485	565	7	32	80	0.4000000
NODE_6455_length_1008_cov_24.741474	538	618	6	6	80	0.0750000
NODE_6455_length_1008_cov_24.741474	538	618	7	74	80	0.9250000
NODE_6456_length_1008_cov_20.278328	401	481	5	14	80	0.1750000
NODE_6456_length_1008_cov_20.278328	401	481	6	66	80	0.8250000
NODE_6456_length_1008_cov_20.278328	454	534	1	13	80	0.1625000
NODE_6456_length_1008_cov_20.278328	454	534	2	9	80	0.1125000
NODE_6456_length_1008_cov_20.278328	454	534	3	7	80	0.0875000
NODE_6456_length_1008_cov_20.278328	454	534	5	14	80	0.1750000
NODE_6456_length_1008_cov_20.278328	454	534	6	37	80	0.4625000
NODE_6457_length_1008_cov_6.071507	460	540	0	80	80	1.0000000
NODE_6457_length_1008_cov_6.071507	513	593	0	80	80	1.0000000
NODE_6466_length_1008_cov_1.798680	0	64	0	64	64	1.0000000
NODE_6466_length_1008_cov_1.798680	37	104	0	61	67	0.9104478
NODE_6466_length_1008_cov_1.798680	37	104	1	6	67	0.0895522
NODE_6473_length_1007_cov_27.011013	294	371	0	77	77	1.0000000
NODE_6473_length_1007_cov_27.011013	347	424	0	77	77	1.0000000
NODE_6474_length_1007_cov_24.668502	369	449	0	80	80	1.0000000
NODE_6474_length_1007_cov_24.668502	422	502	0	80	80	1.0000000
NODE_6474_length_1007_cov_24.668502	498	578	0	80	80	1.0000000
NODE_6474_length_1007_cov_24.668502	551	631	0	80	80	1.0000000
NODE_6475_length_1007_cov_21.729075	454	534	1	29	80	0.3625000
NODE_6475_length_1007_cov_21.729075	454	534	2	51	80	0.6375000
NODE_6475_length_1007_cov_21.729075	507	587	1	24	80	0.3000000
NODE_6475_length_1007_cov_21.729075	507	587	2	56	80	0.7000000
NODE_6475_length_1007_cov_21.729075	583	663	1	79	80	0.9875000
NODE_6475_length_1007_cov_21.729075	583	663	2	1	80	0.0125000
NODE_6475_length_1007_cov_21.729075	636	716	1	80	80	1.0000000
NODE_6476_length_1007_cov_14.515419	400	480	2	6	80	0.0750000
NODE_6476_length_1007_cov_14.515419	400	480	4	5	80	0.0625000
NODE_6476_length_1007_cov_14.515419	400	480	6	69	80	0.8625000
NODE_6476_length_1007_cov_14.515419	453	533	4	12	80	0.1500000
NODE_6476_length_1007_cov_14.515419	453	533	6	68	80	0.8500000
NODE_6477_length_1007_cov_13.685022	376	456	2	80	80	1.0000000
NODE_6477_length_1007_cov_13.685022	429	509	0	7	80	0.0875000
NODE_6477_length_1007_cov_13.685022	429	509	2	73	80	0.9125000
NODE_6478_length_1007_cov_9.189427	438	518	2	80	80	1.0000000
NODE_6478_length_1007_cov_9.189427	491	571	0	29	80	0.3625000
NODE_6478_length_1007_cov_9.189427	491	571	2	51	80	0.6375000
NODE_6491_length_1006_cov_59.773980	379	459	5	18	80	0.2250000
NODE_6491_length_1006_cov_59.773980	379	459	6	4	80	0.0500000
NODE_6491_length_1006_cov_59.773980	379	459	7	4	80	0.0500000
NODE_6491_length_1006_cov_59.773980	379	459	8	54	80	0.6750000
NODE_6491_length_1006_cov_59.773980	432	512	2	3	80	0.0375000
NODE_6491_length_1006_cov_59.773980	432	512	5	4	80	0.0500000
NODE_6491_length_1006_cov_59.773980	432	512	6	10	80	0.1250000
NODE_6491_length_1006_cov_59.773980	432	512	7	29	80	0.3625000
NODE_6491_length_1006_cov_59.773980	432	512	8	34	80	0.4250000
NODE_6491_length_1006_cov_59.773980	508	588	0	16	80	0.2000000
NODE_6491_length_1006_cov_59.773980	508	588	1	19	80	0.2375000
NODE_6491_length_1006_cov_59.773980	508	588	2	44	80	0.5500000
NODE_6491_length_1006_cov_59.773980	508	588	5	1	80	0.0125000
NODE_6491_length_1006_cov_59.773980	561	641	0	16	80	0.2000000
NODE_6491_length_1006_cov_59.773980	561	641	1	5	80	0.0625000
NODE_6491_length_1006_cov_59.773980	561	641	2	10	80	0.1250000
NODE_6491_length_1006_cov_59.773980	561	641	4	30	80	0.3750000
NODE_6491_length_1006_cov_59.773980	561	641	5	19	80	0.2375000
NODE_6492_length_1006_cov_34.762955	482	562	1	38	80	0.4750000
NODE_6492_length_1006_cov_34.762955	482	562	3	26	80	0.3250000
NODE_6492_length_1006_cov_34.762955	482	562	4	16	80	0.2000000
NODE_6492_length_1006_cov_34.762955	535	615	3	34	80	0.4250000
NODE_6492_length_1006_cov_34.762955	535	615	4	46	80	0.5750000
NODE_6493_length_1006_cov_21.776185	516	596	9	7	80	0.0875000
NODE_6493_length_1006_cov_21.776185	516	596	11	1	80	0.0125000
NODE_6493_length_1006_cov_21.776185	516	596	12	1	80	0.0125000
NODE_6493_length_1006_cov_21.776185	516	596	13	2	80	0.0250000
NODE_6493_length_1006_cov_21.776185	516	596	14	10	80	0.1250000
NODE_6493_length_1006_cov_21.776185	516	596	15	14	80	0.1750000
NODE_6493_length_1006_cov_21.776185	516	596	16	19	80	0.2375000
NODE_6493_length_1006_cov_21.776185	516	596	17	22	80	0.2750000
NODE_6493_length_1006_cov_21.776185	516	596	18	4	80	0.0500000
NODE_6493_length_1006_cov_21.776185	569	649	11	1	80	0.0125000
NODE_6493_length_1006_cov_21.776185	569	649	13	9	80	0.1125000
NODE_6493_length_1006_cov_21.776185	569	649	14	20	80	0.2500000
NODE_6493_length_1006_cov_21.776185	569	649	15	15	80	0.1875000
NODE_6493_length_1006_cov_21.776185	569	649	16	18	80	0.2250000
NODE_6493_length_1006_cov_21.776185	569	649	17	17	80	0.2125000
NODE_6494_length_1006_cov_19.690187	371	451	4	30	80	0.3750000
NODE_6494_length_1006_cov_19.690187	371	451	5	50	80	0.6250000
NODE_6494_length_1006_cov_19.690187	424	504	3	11	80	0.1375000
NODE_6494_length_1006_cov_19.690187	424	504	4	43	80	0.5375000
NODE_6494_length_1006_cov_19.690187	424	504	5	26	80	0.3250000
NODE_6495_length_1006_cov_19.299890	495	575	5	68	80	0.8500000
NODE_6495_length_1006_cov_19.299890	495	575	6	12	80	0.1500000
NODE_6495_length_1006_cov_19.299890	548	628	3	25	80	0.3125000
NODE_6495_length_1006_cov_19.299890	548	628	4	3	80	0.0375000
NODE_6495_length_1006_cov_19.299890	548	628	5	30	80	0.3750000
NODE_6495_length_1006_cov_19.299890	548	628	6	22	80	0.2750000
NODE_6496_length_1006_cov_13.187431	245	325	1	80	80	1.0000000
NODE_6496_length_1006_cov_13.187431	298	378	1	56	80	0.7000000
NODE_6496_length_1006_cov_13.187431	298	378	2	24	80	0.3000000
NODE_6497_length_1006_cov_12.862183	383	463	0	80	80	1.0000000
NODE_6497_length_1006_cov_12.862183	436	516	0	80	80	1.0000000
NODE_6498_length_1006_cov_10.986770	762	842	2	80	80	1.0000000
NODE_6498_length_1006_cov_10.986770	815	895	0	4	80	0.0500000
NODE_6498_length_1006_cov_10.986770	815	895	2	76	80	0.9500000
NODE_6499_length_1006_cov_8.633958	314	394	3	30	80	0.3750000
NODE_6499_length_1006_cov_8.633958	314	394	4	50	80	0.6250000
NODE_6499_length_1006_cov_8.633958	367	447	1	13	80	0.1625000
NODE_6499_length_1006_cov_8.633958	367	447	2	31	80	0.3875000
NODE_6499_length_1006_cov_8.633958	367	447	3	23	80	0.2875000
NODE_6499_length_1006_cov_8.633958	367	447	4	13	80	0.1625000
NODE_6515_length_1005_cov_80.271523	509	589	3	4	80	0.0500000
NODE_6515_length_1005_cov_80.271523	509	589	4	47	80	0.5875000
NODE_6515_length_1005_cov_80.271523	509	589	5	29	80	0.3625000
NODE_6515_length_1005_cov_80.271523	562	642	1	9	80	0.1125000
NODE_6515_length_1005_cov_80.271523	562	642	2	5	80	0.0625000
NODE_6515_length_1005_cov_80.271523	562	642	3	20	80	0.2500000
NODE_6515_length_1005_cov_80.271523	562	642	4	46	80	0.5750000
NODE_6516_length_1005_cov_45.008830	357	437	0	16	80	0.2000000
NODE_6516_length_1005_cov_45.008830	357	437	2	32	80	0.4000000
NODE_6516_length_1005_cov_45.008830	357	437	3	25	80	0.3125000
NODE_6516_length_1005_cov_45.008830	357	437	5	7	80	0.0875000
NODE_6516_length_1005_cov_45.008830	410	490	3	20	80	0.2500000
NODE_6516_length_1005_cov_45.008830	410	490	5	13	80	0.1625000
NODE_6516_length_1005_cov_45.008830	410	490	6	47	80	0.5875000
NODE_6517_length_1005_cov_36.636865	567	647	0	11	80	0.1375000
NODE_6517_length_1005_cov_36.636865	567	647	1	69	80	0.8625000
NODE_6517_length_1005_cov_36.636865	620	700	1	28	80	0.3500000
NODE_6517_length_1005_cov_36.636865	620	700	3	52	80	0.6500000
NODE_6518_length_1005_cov_21.222958	389	409	0	20	20	1.0000000
NODE_6518_length_1005_cov_21.222958	451	519	0	1	68	0.0147059
NODE_6518_length_1005_cov_21.222958	451	519	2	67	68	0.9852941
NODE_6518_length_1005_cov_21.222958	515	595	2	66	80	0.8250000
NODE_6518_length_1005_cov_21.222958	515	595	4	14	80	0.1750000
NODE_6518_length_1005_cov_21.222958	568	648	2	59	80	0.7375000
NODE_6518_length_1005_cov_21.222958	568	648	4	21	80	0.2625000
NODE_6520_length_1005_cov_14.278146	480	560	0	18	80	0.2250000
NODE_6520_length_1005_cov_14.278146	480	560	1	62	80	0.7750000
NODE_6520_length_1005_cov_14.278146	533	613	1	35	80	0.4375000
NODE_6520_length_1005_cov_14.278146	533	613	2	45	80	0.5625000
NODE_6521_length_1005_cov_13.215232	511	591	0	37	80	0.4625000
NODE_6521_length_1005_cov_13.215232	511	591	2	43	80	0.5375000
NODE_6521_length_1005_cov_13.215232	564	644	0	4	80	0.0500000
NODE_6521_length_1005_cov_13.215232	564	644	2	76	80	0.9500000
NODE_6523_length_1005_cov_5.579470	534	614	0	80	80	1.0000000
NODE_6523_length_1005_cov_5.579470	587	667	0	80	80	1.0000000
NODE_6536_length_1004_cov_45.470718	343	423	3	36	80	0.4500000
NODE_6536_length_1004_cov_45.470718	343	423	4	43	80	0.5375000
NODE_6536_length_1004_cov_45.470718	343	423	5	1	80	0.0125000
NODE_6536_length_1004_cov_45.470718	396	476	1	46	80	0.5750000
NODE_6536_length_1004_cov_45.470718	396	476	2	6	80	0.0750000
NODE_6536_length_1004_cov_45.470718	396	476	3	16	80	0.2000000
NODE_6536_length_1004_cov_45.470718	396	476	4	11	80	0.1375000
NODE_6536_length_1004_cov_45.470718	396	476	5	1	80	0.0125000
NODE_6536_length_1004_cov_45.470718	472	552	2	80	80	1.0000000
NODE_6536_length_1004_cov_45.470718	525	605	1	41	80	0.5125000
NODE_6536_length_1004_cov_45.470718	525	605	2	39	80	0.4875000
NODE_6537_length_1004_cov_34.565746	419	499	3	13	80	0.1625000
NODE_6537_length_1004_cov_34.565746	419	499	4	41	80	0.5125000
NODE_6537_length_1004_cov_34.565746	419	499	5	1	80	0.0125000
NODE_6537_length_1004_cov_34.565746	419	499	6	2	80	0.0250000
NODE_6537_length_1004_cov_34.565746	419	499	7	23	80	0.2875000
NODE_6537_length_1004_cov_34.565746	472	552	4	21	80	0.2625000
NODE_6537_length_1004_cov_34.565746	472	552	5	1	80	0.0125000
NODE_6537_length_1004_cov_34.565746	472	552	6	2	80	0.0250000
NODE_6537_length_1004_cov_34.565746	472	552	7	56	80	0.7000000
NODE_6538_length_1004_cov_28.710497	385	465	0	80	80	1.0000000
NODE_6538_length_1004_cov_28.710497	438	518	0	80	80	1.0000000
NODE_6538_length_1004_cov_28.710497	514	594	0	80	80	1.0000000
NODE_6538_length_1004_cov_28.710497	567	647	0	32	80	0.4000000
NODE_6538_length_1004_cov_28.710497	567	647	2	48	80	0.6000000
NODE_6539_length_1004_cov_12.745856	432	512	3	18	80	0.2250000
NODE_6539_length_1004_cov_12.745856	432	512	4	62	80	0.7750000
NODE_6539_length_1004_cov_12.745856	485	565	3	11	80	0.1375000
NODE_6539_length_1004_cov_12.745856	485	565	4	69	80	0.8625000
NODE_6550_length_1003_cov_47.014381	383	463	2	56	80	0.7000000
NODE_6550_length_1003_cov_47.014381	383	463	3	24	80	0.3000000
NODE_6550_length_1003_cov_47.014381	436	516	2	80	80	1.0000000
NODE_6550_length_1003_cov_47.014381	512	592	0	32	80	0.4000000
NODE_6550_length_1003_cov_47.014381	512	592	1	41	80	0.5125000
NODE_6550_length_1003_cov_47.014381	512	592	2	7	80	0.0875000
NODE_6550_length_1003_cov_47.014381	565	645	0	38	80	0.4750000
NODE_6550_length_1003_cov_47.014381	565	645	1	42	80	0.5250000
NODE_6551_length_1003_cov_35.329646	372	452	0	27	80	0.3375000
NODE_6551_length_1003_cov_35.329646	372	452	1	1	80	0.0125000
NODE_6551_length_1003_cov_35.329646	372	452	2	52	80	0.6500000
NODE_6551_length_1003_cov_35.329646	425	505	0	6	80	0.0750000
NODE_6551_length_1003_cov_35.329646	425	505	2	74	80	0.9250000
NODE_6552_length_1003_cov_32.721239	357	437	3	31	80	0.3875000
NODE_6552_length_1003_cov_32.721239	357	437	4	49	80	0.6125000
NODE_6552_length_1003_cov_32.721239	410	490	2	25	80	0.3125000
NODE_6552_length_1003_cov_32.721239	410	490	3	6	80	0.0750000
NODE_6552_length_1003_cov_32.721239	410	490	4	49	80	0.6125000
NODE_6553_length_1003_cov_23.758850	467	547	0	11	80	0.1375000
NODE_6553_length_1003_cov_23.758850	467	547	2	67	80	0.8375000
NODE_6553_length_1003_cov_23.758850	467	547	4	2	80	0.0250000
NODE_6553_length_1003_cov_23.758850	520	600	2	25	80	0.3125000
NODE_6553_length_1003_cov_23.758850	520	600	4	55	80	0.6875000
NODE_6554_length_1003_cov_19.939159	240	320	3	21	80	0.2625000
NODE_6554_length_1003_cov_19.939159	240	320	5	59	80	0.7375000
NODE_6554_length_1003_cov_19.939159	293	373	2	3	80	0.0375000
NODE_6554_length_1003_cov_19.939159	293	373	3	65	80	0.8125000
NODE_6554_length_1003_cov_19.939159	293	373	5	12	80	0.1500000
NODE_6555_length_1003_cov_16.618363	524	604	0	80	80	1.0000000
NODE_6555_length_1003_cov_16.618363	577	657	0	80	80	1.0000000
NODE_6555_length_1003_cov_16.618363	653	733	0	35	80	0.4375000
NODE_6555_length_1003_cov_16.618363	653	733	1	45	80	0.5625000
NODE_6555_length_1003_cov_16.618363	706	786	1	42	80	0.5250000
NODE_6555_length_1003_cov_16.618363	706	786	2	38	80	0.4750000
NODE_6556_length_1003_cov_13.863938	537	617	2	71	80	0.8875000
NODE_6556_length_1003_cov_13.863938	537	617	3	9	80	0.1125000
NODE_6556_length_1003_cov_13.863938	590	670	2	61	80	0.7625000
NODE_6556_length_1003_cov_13.863938	590	670	3	19	80	0.2375000
NODE_6557_length_1003_cov_12.363938	529	609	0	24	80	0.3000000
NODE_6557_length_1003_cov_12.363938	529	609	2	56	80	0.7000000
NODE_6557_length_1003_cov_12.363938	582	662	0	77	80	0.9625000
NODE_6557_length_1003_cov_12.363938	582	662	2	3	80	0.0375000
NODE_6567_length_1002_cov_65.513843	387	467	0	18	80	0.2250000
NODE_6567_length_1002_cov_65.513843	387	467	1	2	80	0.0250000
NODE_6567_length_1002_cov_65.513843	387	467	3	26	80	0.3250000
NODE_6567_length_1002_cov_65.513843	387	467	4	34	80	0.4250000
NODE_6567_length_1002_cov_65.513843	440	520	4	80	80	1.0000000
NODE_6567_length_1002_cov_65.513843	516	596	2	40	80	0.5000000
NODE_6567_length_1002_cov_65.513843	516	596	3	7	80	0.0875000
NODE_6567_length_1002_cov_65.513843	516	596	4	29	80	0.3625000
NODE_6567_length_1002_cov_65.513843	516	596	5	4	80	0.0500000
NODE_6567_length_1002_cov_65.513843	569	649	2	30	80	0.3750000
NODE_6567_length_1002_cov_65.513843	569	649	3	50	80	0.6250000
NODE_6568_length_1002_cov_41.995570	408	488	3	32	80	0.4000000
NODE_6568_length_1002_cov_41.995570	408	488	4	47	80	0.5875000
NODE_6568_length_1002_cov_41.995570	408	488	5	1	80	0.0125000
NODE_6568_length_1002_cov_41.995570	461	541	2	3	80	0.0375000
NODE_6568_length_1002_cov_41.995570	461	541	3	24	80	0.3000000
NODE_6568_length_1002_cov_41.995570	461	541	4	53	80	0.6625000
NODE_6569_length_1002_cov_19.966777	401	481	0	45	80	0.5625000
NODE_6569_length_1002_cov_19.966777	401	481	1	35	80	0.4375000
NODE_6569_length_1002_cov_19.966777	454	534	0	80	80	1.0000000
NODE_6570_length_1002_cov_19.539313	334	414	0	34	80	0.4250000
NODE_6570_length_1002_cov_19.539313	334	414	1	24	80	0.3000000
NODE_6570_length_1002_cov_19.539313	334	414	2	22	80	0.2750000
NODE_6570_length_1002_cov_19.539313	335	414	0	34	79	0.4303797
NODE_6570_length_1002_cov_19.539313	335	414	1	24	79	0.3037975
NODE_6570_length_1002_cov_19.539313	335	414	2	21	79	0.2658228
NODE_6570_length_1002_cov_19.539313	387	467	1	21	80	0.2625000
NODE_6570_length_1002_cov_19.539313	387	467	2	29	80	0.3625000
NODE_6570_length_1002_cov_19.539313	387	467	3	21	80	0.2625000
NODE_6570_length_1002_cov_19.539313	387	467	5	9	80	0.1125000
NODE_6570_length_1002_cov_19.539313	387	467	1	21	80	0.2625000
NODE_6570_length_1002_cov_19.539313	387	467	2	29	80	0.3625000
NODE_6570_length_1002_cov_19.539313	387	467	3	21	80	0.2625000
NODE_6570_length_1002_cov_19.539313	387	467	5	9	80	0.1125000
NODE_6570_length_1002_cov_19.539313	396	467	1	12	71	0.1690141
NODE_6570_length_1002_cov_19.539313	396	467	2	29	71	0.4084507
NODE_6570_length_1002_cov_19.539313	396	467	3	21	71	0.2957746
NODE_6570_length_1002_cov_19.539313	396	467	5	9	71	0.1267606
NODE_6570_length_1002_cov_19.539313	463	543	5	27	80	0.3375000
NODE_6570_length_1002_cov_19.539313	463	543	6	9	80	0.1125000
NODE_6570_length_1002_cov_19.539313	463	543	7	44	80	0.5500000
NODE_6570_length_1002_cov_19.539313	516	596	5	9	80	0.1125000
NODE_6570_length_1002_cov_19.539313	516	596	6	48	80	0.6000000
NODE_6570_length_1002_cov_19.539313	516	596	7	23	80	0.2875000
NODE_6571_length_1002_cov_17.780731	631	711	0	80	80	1.0000000
NODE_6571_length_1002_cov_17.780731	684	764	0	80	80	1.0000000
NODE_6572_length_1002_cov_17.590255	0	58	0	58	58	1.0000000
NODE_6572_length_1002_cov_17.590255	31	77	0	46	46	1.0000000
NODE_6573_length_1002_cov_17.105205	522	602	0	70	80	0.8750000
NODE_6573_length_1002_cov_17.105205	522	602	1	10	80	0.1250000
NODE_6573_length_1002_cov_17.105205	575	655	0	80	80	1.0000000
NODE_6574_length_1002_cov_11.954596	480	560	2	50	80	0.6250000
NODE_6574_length_1002_cov_11.954596	480	560	3	14	80	0.1750000
NODE_6574_length_1002_cov_11.954596	480	560	4	16	80	0.2000000
NODE_6574_length_1002_cov_11.954596	533	613	3	23	80	0.2875000
NODE_6574_length_1002_cov_11.954596	533	613	4	52	80	0.6500000
NODE_6574_length_1002_cov_11.954596	533	613	5	5	80	0.0625000
NODE_6575_length_1002_cov_11.823920	471	551	0	80	80	1.0000000
NODE_6575_length_1002_cov_11.823920	524	614	0	90	90	1.0000000
NODE_6577_length_1002_cov_6.596899	422	502	0	10	80	0.1250000
NODE_6577_length_1002_cov_6.596899	422	502	2	14	80	0.1750000
NODE_6577_length_1002_cov_6.596899	422	502	3	56	80	0.7000000
NODE_6577_length_1002_cov_6.596899	475	555	1	7	80	0.0875000
NODE_6577_length_1002_cov_6.596899	475	555	2	7	80	0.0875000
NODE_6577_length_1002_cov_6.596899	475	555	3	66	80	0.8250000
NODE_6588_length_1002_cov_2.102990	29	110	4	21	81	0.2592593
NODE_6588_length_1002_cov_2.102990	29	110	6	38	81	0.4691358
NODE_6588_length_1002_cov_2.102990	29	110	8	22	81	0.2716049
NODE_6596_length_1001_cov_41.914634	549	629	6	5	80	0.0625000
NODE_6596_length_1001_cov_41.914634	549	629	7	3	80	0.0375000
NODE_6596_length_1001_cov_41.914634	549	629	8	24	80	0.3000000
NODE_6596_length_1001_cov_41.914634	549	629	9	8	80	0.1000000
NODE_6596_length_1001_cov_41.914634	549	629	10	40	80	0.5000000
NODE_6596_length_1001_cov_41.914634	602	682	7	5	80	0.0625000
NODE_6596_length_1001_cov_41.914634	602	682	8	25	80	0.3125000
NODE_6596_length_1001_cov_41.914634	602	682	10	50	80	0.6250000
NODE_6597_length_1001_cov_30.378049	306	386	2	33	80	0.4125000
NODE_6597_length_1001_cov_30.378049	306	386	3	47	80	0.5875000
NODE_6597_length_1001_cov_30.378049	359	439	1	5	80	0.0625000
NODE_6597_length_1001_cov_30.378049	359	439	2	36	80	0.4500000
NODE_6597_length_1001_cov_30.378049	359	439	3	39	80	0.4875000
NODE_6597_length_1001_cov_30.378049	369	439	1	5	70	0.0714286
NODE_6597_length_1001_cov_30.378049	369	439	2	36	70	0.5142857
NODE_6597_length_1001_cov_30.378049	369	439	3	29	70	0.4142857
NODE_6597_length_1001_cov_30.378049	435	515	1	26	80	0.3250000
NODE_6597_length_1001_cov_30.378049	435	515	2	54	80	0.6750000
NODE_6597_length_1001_cov_30.378049	488	568	0	15	80	0.1875000
NODE_6597_length_1001_cov_30.378049	488	568	1	64	80	0.8000000
NODE_6597_length_1001_cov_30.378049	488	568	2	1	80	0.0125000
NODE_6598_length_1001_cov_22.517738	536	616	1	8	80	0.1000000
NODE_6598_length_1001_cov_22.517738	536	616	2	48	80	0.6000000
NODE_6598_length_1001_cov_22.517738	536	616	3	24	80	0.3000000
NODE_6598_length_1001_cov_22.517738	589	670	2	36	81	0.4444444
NODE_6598_length_1001_cov_22.517738	589	670	3	45	81	0.5555556
NODE_6599_length_1001_cov_17.996674	414	456	0	42	42	1.0000000
NODE_6599_length_1001_cov_17.996674	429	509	0	80	80	1.0000000
NODE_6599_length_1001_cov_17.996674	505	585	0	80	80	1.0000000
NODE_6599_length_1001_cov_17.996674	558	638	0	80	80	1.0000000
NODE_6600_length_1001_cov_16.798226	422	502	2	42	80	0.5250000
NODE_6600_length_1001_cov_16.798226	422	502	3	4	80	0.0500000
NODE_6600_length_1001_cov_16.798226	422	502	4	34	80	0.4250000
NODE_6600_length_1001_cov_16.798226	475	555	2	47	80	0.5875000
NODE_6600_length_1001_cov_16.798226	475	555	4	33	80	0.4125000
NODE_6600_length_1001_cov_16.798226	551	631	2	33	80	0.4125000
NODE_6600_length_1001_cov_16.798226	551	631	3	14	80	0.1750000
NODE_6600_length_1001_cov_16.798226	551	631	4	27	80	0.3375000
NODE_6600_length_1001_cov_16.798226	551	631	5	6	80	0.0750000
NODE_6600_length_1001_cov_16.798226	604	684	1	28	80	0.3500000
NODE_6600_length_1001_cov_16.798226	604	684	3	38	80	0.4750000
NODE_6600_length_1001_cov_16.798226	604	684	4	14	80	0.1750000
NODE_6601_length_1001_cov_12.778271	348	428	0	3	80	0.0375000
NODE_6601_length_1001_cov_12.778271	348	428	1	77	80	0.9625000
NODE_6601_length_1001_cov_12.778271	401	481	1	78	80	0.9750000
NODE_6601_length_1001_cov_12.778271	401	481	3	2	80	0.0250000
NODE_6602_length_1001_cov_12.305987	255	335	0	1	80	0.0125000
NODE_6602_length_1001_cov_12.305987	255	335	2	79	80	0.9875000
NODE_6602_length_1001_cov_12.305987	308	388	0	54	80	0.6750000
NODE_6602_length_1001_cov_12.305987	308	388	2	26	80	0.3250000
NODE_6603_length_1001_cov_11.955654	485	569	4	4	84	0.0476190
NODE_6603_length_1001_cov_11.955654	485	569	5	69	84	0.8214286
NODE_6603_length_1001_cov_11.955654	485	569	6	11	84	0.1309524
NODE_6603_length_1001_cov_11.955654	542	622	2	13	80	0.1625000
NODE_6603_length_1001_cov_11.955654	542	622	3	7	80	0.0875000
NODE_6603_length_1001_cov_11.955654	542	622	5	40	80	0.5000000
NODE_6603_length_1001_cov_11.955654	542	622	6	20	80	0.2500000
NODE_6604_length_1001_cov_10.156319	587	667	2	48	80	0.6000000
NODE_6604_length_1001_cov_10.156319	587	667	4	32	80	0.4000000
NODE_6604_length_1001_cov_10.156319	640	720	2	5	80	0.0625000
NODE_6604_length_1001_cov_10.156319	640	720	3	29	80	0.3625000
NODE_6604_length_1001_cov_10.156319	640	720	4	46	80	0.5750000
NODE_6605_length_1001_cov_9.754989	377	457	0	27	80	0.3375000
NODE_6605_length_1001_cov_9.754989	377	457	2	53	80	0.6625000
NODE_6605_length_1001_cov_9.754989	430	510	2	80	80	1.0000000
NODE_6607_length_1001_cov_4.616408	408	488	0	80	80	1.0000000
NODE_6607_length_1001_cov_4.616408	461	541	0	80	80	1.0000000
NODE_6616_length_1000_cov_55.578246	393	473	2	31	80	0.3875000
NODE_6616_length_1000_cov_55.578246	393	473	3	30	80	0.3750000
NODE_6616_length_1000_cov_55.578246	393	473	4	19	80	0.2375000
NODE_6616_length_1000_cov_55.578246	446	526	2	74	80	0.9250000
NODE_6616_length_1000_cov_55.578246	446	526	3	6	80	0.0750000
NODE_6616_length_1000_cov_55.578246	522	598	0	1	76	0.0131579
NODE_6616_length_1000_cov_55.578246	522	598	1	58	76	0.7631579
NODE_6616_length_1000_cov_55.578246	522	598	2	17	76	0.2236842
NODE_6616_length_1000_cov_55.578246	575	649	0	52	74	0.7027027
NODE_6616_length_1000_cov_55.578246	575	649	1	22	74	0.2972973
NODE_6617_length_1000_cov_51.534961	432	512	0	8	80	0.1000000
NODE_6617_length_1000_cov_51.534961	432	512	1	39	80	0.4875000
NODE_6617_length_1000_cov_51.534961	432	512	2	20	80	0.2500000
NODE_6617_length_1000_cov_51.534961	432	512	3	13	80	0.1625000
NODE_6617_length_1000_cov_51.534961	485	565	0	4	80	0.0500000
NODE_6617_length_1000_cov_51.534961	485	565	1	10	80	0.1250000
NODE_6617_length_1000_cov_51.534961	485	565	3	26	80	0.3250000
NODE_6617_length_1000_cov_51.534961	485	565	4	40	80	0.5000000
NODE_6617_length_1000_cov_51.534961	561	641	3	2	80	0.0250000
NODE_6617_length_1000_cov_51.534961	561	641	4	39	80	0.4875000
NODE_6617_length_1000_cov_51.534961	561	641	6	39	80	0.4875000
NODE_6617_length_1000_cov_51.534961	614	694	2	19	80	0.2375000
NODE_6617_length_1000_cov_51.534961	614	694	3	36	80	0.4500000
NODE_6617_length_1000_cov_51.534961	614	694	4	6	80	0.0750000
NODE_6617_length_1000_cov_51.534961	614	694	6	19	80	0.2375000
NODE_6618_length_1000_cov_39.011099	186	266	2	15	80	0.1875000
NODE_6618_length_1000_cov_39.011099	186	266	3	4	80	0.0500000
NODE_6618_length_1000_cov_39.011099	186	266	4	43	80	0.5375000
NODE_6618_length_1000_cov_39.011099	186	266	5	18	80	0.2250000
NODE_6618_length_1000_cov_39.011099	239	319	3	57	80	0.7125000
NODE_6618_length_1000_cov_39.011099	239	319	4	5	80	0.0625000
NODE_6618_length_1000_cov_39.011099	239	319	5	18	80	0.2250000
NODE_6619_length_1000_cov_19.897891	451	531	1	31	80	0.3875000
NODE_6619_length_1000_cov_19.897891	451	531	3	19	80	0.2375000
NODE_6619_length_1000_cov_19.897891	451	531	4	30	80	0.3750000
NODE_6619_length_1000_cov_19.897891	504	584	3	32	80	0.4000000
NODE_6619_length_1000_cov_19.897891	504	584	4	48	80	0.6000000
NODE_6619_length_1000_cov_19.897891	580	660	1	13	80	0.1625000
NODE_6619_length_1000_cov_19.897891	580	660	2	10	80	0.1250000
NODE_6619_length_1000_cov_19.897891	580	660	3	57	80	0.7125000
NODE_6619_length_1000_cov_19.897891	633	713	0	11	80	0.1375000
NODE_6619_length_1000_cov_19.897891	633	713	2	52	80	0.6500000
NODE_6619_length_1000_cov_19.897891	633	713	3	17	80	0.2125000
NODE_6620_length_1000_cov_13.349612	324	404	0	80	80	1.0000000
NODE_6620_length_1000_cov_13.349612	377	457	0	80	80	1.0000000
NODE_6621_length_1000_cov_11.463929	382	462	1	17	80	0.2125000
NODE_6621_length_1000_cov_11.463929	382	462	2	63	80	0.7875000
NODE_6621_length_1000_cov_11.463929	435	515	2	80	80	1.0000000
NODE_6622_length_1000_cov_9.675916	625	705	0	80	80	1.0000000
NODE_6622_length_1000_cov_9.675916	678	758	0	80	80	1.0000000
NODE_6623_length_1000_cov_7.051054	358	438	0	80	80	1.0000000
NODE_6623_length_1000_cov_7.051054	411	491	0	80	80	1.0000000
NODE_6626_length_1000_cov_3.652608	203	265	3	56	62	0.9032258
NODE_6626_length_1000_cov_3.652608	203	265	4	6	62	0.0967742
NODE_6639_length_999_cov_47.442222	604	684	3	19	80	0.2375000
NODE_6639_length_999_cov_47.442222	604	684	4	61	80	0.7625000
NODE_6639_length_999_cov_47.442222	657	723	2	8	66	0.1212121
NODE_6639_length_999_cov_47.442222	657	723	3	12	66	0.1818182
NODE_6639_length_999_cov_47.442222	657	723	4	46	66	0.6969697
NODE_6640_length_999_cov_33.055556	458	540	1	7	82	0.0853659
NODE_6640_length_999_cov_33.055556	458	540	2	1	82	0.0121951
NODE_6640_length_999_cov_33.055556	458	540	4	23	82	0.2804878
NODE_6640_length_999_cov_33.055556	458	540	5	13	82	0.1585366
NODE_6640_length_999_cov_33.055556	458	540	6	38	82	0.4634146
NODE_6640_length_999_cov_33.055556	513	593	5	44	80	0.5500000
NODE_6640_length_999_cov_33.055556	513	593	6	36	80	0.4500000
NODE_6641_length_999_cov_22.755556	493	573	0	23	80	0.2875000
NODE_6641_length_999_cov_22.755556	493	573	1	57	80	0.7125000
NODE_6641_length_999_cov_22.755556	546	626	1	32	80	0.4000000
NODE_6641_length_999_cov_22.755556	546	626	2	48	80	0.6000000
NODE_6642_length_999_cov_21.842222	359	439	1	80	80	1.0000000
NODE_6642_length_999_cov_21.842222	412	492	0	24	80	0.3000000
NODE_6642_length_999_cov_21.842222	412	492	1	56	80	0.7000000
NODE_6643_length_999_cov_20.006667	361	441	1	73	80	0.9125000
NODE_6643_length_999_cov_20.006667	361	441	2	7	80	0.0875000
NODE_6643_length_999_cov_20.006667	414	494	1	20	80	0.2500000
NODE_6643_length_999_cov_20.006667	414	494	2	22	80	0.2750000
NODE_6643_length_999_cov_20.006667	414	494	4	38	80	0.4750000
NODE_6643_length_999_cov_20.006667	490	570	4	6	80	0.0750000
NODE_6643_length_999_cov_20.006667	490	570	5	72	80	0.9000000
NODE_6643_length_999_cov_20.006667	490	570	6	2	80	0.0250000
NODE_6643_length_999_cov_20.006667	543	623	2	40	80	0.5000000
NODE_6643_length_999_cov_20.006667	543	623	3	13	80	0.1625000
NODE_6643_length_999_cov_20.006667	543	623	5	27	80	0.3375000
NODE_6645_length_999_cov_16.794444	438	518	2	28	80	0.3500000
NODE_6645_length_999_cov_16.794444	438	518	3	52	80	0.6500000
NODE_6645_length_999_cov_16.794444	491	571	1	22	80	0.2750000
NODE_6645_length_999_cov_16.794444	491	571	2	17	80	0.2125000
NODE_6645_length_999_cov_16.794444	491	571	3	41	80	0.5125000
NODE_6646_length_999_cov_15.146667	464	544	1	7	80	0.0875000
NODE_6646_length_999_cov_15.146667	464	544	2	73	80	0.9125000
NODE_6646_length_999_cov_15.146667	517	597	2	69	80	0.8625000
NODE_6646_length_999_cov_15.146667	517	597	3	11	80	0.1375000
NODE_6648_length_999_cov_8.771111	361	441	0	80	80	1.0000000
NODE_6648_length_999_cov_8.771111	414	492	0	78	78	1.0000000
NODE_6649_length_999_cov_5.171111	417	497	0	45	80	0.5625000
NODE_6649_length_999_cov_5.171111	417	497	1	35	80	0.4375000
NODE_6649_length_999_cov_5.171111	470	550	0	80	80	1.0000000
NODE_6650_length_999_cov_2.854444	35	101	0	62	66	0.9393939
NODE_6650_length_999_cov_2.854444	35	101	2	4	66	0.0606061
NODE_6657_length_998_cov_30.697442	404	484	0	15	80	0.1875000
NODE_6657_length_998_cov_30.697442	404	484	2	65	80	0.8125000
NODE_6657_length_998_cov_30.697442	457	537	0	68	80	0.8500000
NODE_6657_length_998_cov_30.697442	457	537	2	12	80	0.1500000
NODE_6657_length_998_cov_30.697442	533	613	0	80	80	1.0000000
NODE_6657_length_998_cov_30.697442	586	666	0	80	80	1.0000000
NODE_6658_length_998_cov_23.703003	235	315	2	79	80	0.9875000
NODE_6658_length_998_cov_23.703003	235	315	3	1	80	0.0125000
NODE_6658_length_998_cov_23.703003	288	368	2	31	80	0.3875000
NODE_6658_length_998_cov_23.703003	288	368	3	49	80	0.6125000
NODE_6659_length_998_cov_22.692992	531	611	3	41	80	0.5125000
NODE_6659_length_998_cov_22.692992	531	611	5	39	80	0.4875000
NODE_6659_length_998_cov_22.692992	584	664	0	7	80	0.0875000
NODE_6659_length_998_cov_22.692992	584	664	1	4	80	0.0500000
NODE_6659_length_998_cov_22.692992	584	664	3	13	80	0.1625000
NODE_6659_length_998_cov_22.692992	584	664	4	21	80	0.2625000
NODE_6659_length_998_cov_22.692992	584	664	5	35	80	0.4375000
NODE_6660_length_998_cov_11.152392	514	594	2	26	80	0.3250000
NODE_6660_length_998_cov_11.152392	514	594	3	49	80	0.6125000
NODE_6660_length_998_cov_11.152392	514	594	4	5	80	0.0625000
NODE_6660_length_998_cov_11.152392	567	640	3	47	73	0.6438356
NODE_6660_length_998_cov_11.152392	567	640	4	26	73	0.3561644
NODE_6660_length_998_cov_11.152392	636	716	2	21	80	0.2625000
NODE_6660_length_998_cov_11.152392	636	716	3	59	80	0.7375000
NODE_6660_length_998_cov_11.152392	689	769	1	37	80	0.4625000
NODE_6660_length_998_cov_11.152392	689	769	2	37	80	0.4625000
NODE_6660_length_998_cov_11.152392	689	769	3	6	80	0.0750000
NODE_6661_length_998_cov_10.061179	422	502	0	5	80	0.0625000
NODE_6661_length_998_cov_10.061179	422	502	1	69	80	0.8625000
NODE_6661_length_998_cov_10.061179	422	502	2	6	80	0.0750000
NODE_6661_length_998_cov_10.061179	475	555	0	58	80	0.7250000
NODE_6661_length_998_cov_10.061179	475	555	1	22	80	0.2750000
NODE_6662_length_998_cov_7.126808	353	430	2	24	77	0.3116883
NODE_6662_length_998_cov_7.126808	353	430	4	38	77	0.4935065
NODE_6662_length_998_cov_7.126808	353	430	5	15	77	0.1948052
NODE_6662_length_998_cov_7.126808	403	483	2	24	80	0.3000000
NODE_6662_length_998_cov_7.126808	403	483	4	20	80	0.2500000
NODE_6662_length_998_cov_7.126808	403	483	5	36	80	0.4500000
NODE_6669_length_997_cov_48.518931	445	525	8	51	80	0.6375000
NODE_6669_length_997_cov_48.518931	445	525	9	22	80	0.2750000
NODE_6669_length_997_cov_48.518931	445	525	10	7	80	0.0875000
NODE_6669_length_997_cov_48.518931	498	578	5	2	80	0.0250000
NODE_6669_length_997_cov_48.518931	498	578	6	1	80	0.0125000
NODE_6669_length_997_cov_48.518931	498	578	7	6	80	0.0750000
NODE_6669_length_997_cov_48.518931	498	578	8	68	80	0.8500000
NODE_6669_length_997_cov_48.518931	498	578	9	3	80	0.0375000
NODE_6670_length_997_cov_36.721604	400	480	2	36	80	0.4500000
NODE_6670_length_997_cov_36.721604	400	480	3	11	80	0.1375000
NODE_6670_length_997_cov_36.721604	400	480	5	32	80	0.4000000
NODE_6670_length_997_cov_36.721604	400	480	6	1	80	0.0125000
NODE_6670_length_997_cov_36.721604	453	533	5	27	80	0.3375000
NODE_6670_length_997_cov_36.721604	453	533	6	53	80	0.6625000
NODE_6671_length_997_cov_22.646993	328	408	1	11	80	0.1375000
NODE_6671_length_997_cov_22.646993	328	408	2	36	80	0.4500000
NODE_6671_length_997_cov_22.646993	328	408	3	33	80	0.4125000
NODE_6671_length_997_cov_22.646993	381	461	2	5	80	0.0625000
NODE_6671_length_997_cov_22.646993	381	461	3	75	80	0.9375000
NODE_6672_length_997_cov_19.709354	420	500	3	36	80	0.4500000
NODE_6672_length_997_cov_19.709354	420	500	4	1	80	0.0125000
NODE_6672_length_997_cov_19.709354	420	500	5	43	80	0.5375000
NODE_6672_length_997_cov_19.709354	473	553	3	30	80	0.3750000
NODE_6672_length_997_cov_19.709354	473	553	4	16	80	0.2000000
NODE_6672_length_997_cov_19.709354	473	553	5	32	80	0.4000000
NODE_6672_length_997_cov_19.709354	473	553	6	2	80	0.0250000
NODE_6672_length_997_cov_19.709354	549	629	3	23	80	0.2875000
NODE_6672_length_997_cov_19.709354	549	629	5	55	80	0.6875000
NODE_6672_length_997_cov_19.709354	549	629	6	2	80	0.0250000
NODE_6672_length_997_cov_19.709354	602	682	3	76	80	0.9500000
NODE_6672_length_997_cov_19.709354	602	682	5	4	80	0.0500000
NODE_6673_length_997_cov_17.947661	465	545	2	80	80	1.0000000
NODE_6673_length_997_cov_17.947661	518	598	0	27	80	0.3375000
NODE_6673_length_997_cov_17.947661	518	598	1	6	80	0.0750000
NODE_6673_length_997_cov_17.947661	518	598	2	47	80	0.5875000
NODE_6673_length_997_cov_17.947661	594	674	0	80	80	1.0000000
NODE_6673_length_997_cov_17.947661	647	727	0	80	80	1.0000000
NODE_6674_length_997_cov_14.718263	388	468	0	57	80	0.7125000
NODE_6674_length_997_cov_14.718263	388	468	1	23	80	0.2875000
NODE_6674_length_997_cov_14.718263	441	521	0	80	80	1.0000000
NODE_6675_length_997_cov_7.114699	307	387	0	21	80	0.2625000
NODE_6675_length_997_cov_7.114699	307	387	1	19	80	0.2375000
NODE_6675_length_997_cov_7.114699	307	387	2	40	80	0.5000000
NODE_6675_length_997_cov_7.114699	360	440	2	80	80	1.0000000
NODE_6694_length_996_cov_59.568562	387	467	2	31	80	0.3875000
NODE_6694_length_996_cov_59.568562	387	467	4	46	80	0.5750000
NODE_6694_length_996_cov_59.568562	387	467	5	3	80	0.0375000
NODE_6694_length_996_cov_59.568562	440	520	3	37	80	0.4625000
NODE_6694_length_996_cov_59.568562	440	520	4	32	80	0.4000000
NODE_6694_length_996_cov_59.568562	440	520	5	11	80	0.1375000
NODE_6695_length_996_cov_32.462653	503	583	0	80	80	1.0000000
NODE_6695_length_996_cov_32.462653	556	636	0	80	80	1.0000000
NODE_6696_length_996_cov_23.312152	571	651	4	10	80	0.1250000
NODE_6696_length_996_cov_23.312152	571	651	6	36	80	0.4500000
NODE_6696_length_996_cov_23.312152	571	651	7	3	80	0.0375000
NODE_6696_length_996_cov_23.312152	571	651	8	31	80	0.3875000
NODE_6696_length_996_cov_23.312152	624	704	3	11	80	0.1375000
NODE_6696_length_996_cov_23.312152	624	704	5	12	80	0.1500000
NODE_6696_length_996_cov_23.312152	624	704	7	33	80	0.4125000
NODE_6696_length_996_cov_23.312152	624	704	8	24	80	0.3000000
NODE_6697_length_996_cov_20.979933	533	613	1	2	80	0.0250000
NODE_6697_length_996_cov_20.979933	533	613	2	16	80	0.2000000
NODE_6697_length_996_cov_20.979933	533	613	3	5	80	0.0625000
NODE_6697_length_996_cov_20.979933	533	613	4	57	80	0.7125000
NODE_6697_length_996_cov_20.979933	586	666	3	52	80	0.6500000
NODE_6697_length_996_cov_20.979933	586	666	4	28	80	0.3500000
NODE_6698_length_996_cov_17.865106	535	615	0	80	80	1.0000000
NODE_6698_length_996_cov_17.865106	588	668	0	80	80	1.0000000
NODE_6699_length_996_cov_10.297659	499	579	3	42	80	0.5250000
NODE_6699_length_996_cov_10.297659	499	579	4	1	80	0.0125000
NODE_6699_length_996_cov_10.297659	499	579	5	37	80	0.4625000
NODE_6699_length_996_cov_10.297659	552	630	3	56	78	0.7179487
NODE_6699_length_996_cov_10.297659	552	630	5	22	78	0.2820513
NODE_6702_length_996_cov_3.205128	499	555	0	32	56	0.5714286
NODE_6702_length_996_cov_3.205128	499	555	1	24	56	0.4285714
NODE_6707_length_995_cov_26.131696	543	623	2	14	80	0.1750000
NODE_6707_length_995_cov_26.131696	543	623	3	66	80	0.8250000
NODE_6707_length_995_cov_26.131696	596	676	1	29	80	0.3625000
NODE_6707_length_995_cov_26.131696	596	676	2	2	80	0.0250000
NODE_6707_length_995_cov_26.131696	596	676	3	49	80	0.6125000
NODE_6708_length_995_cov_20.262277	457	537	1	11	80	0.1375000
NODE_6708_length_995_cov_20.262277	457	537	3	68	80	0.8500000
NODE_6708_length_995_cov_20.262277	457	537	4	1	80	0.0125000
NODE_6708_length_995_cov_20.262277	510	590	2	2	80	0.0250000
NODE_6708_length_995_cov_20.262277	510	590	3	49	80	0.6125000
NODE_6708_length_995_cov_20.262277	510	590	4	29	80	0.3625000
NODE_6709_length_995_cov_19.382812	457	537	2	80	80	1.0000000
NODE_6709_length_995_cov_19.382812	510	590	0	48	80	0.6000000
NODE_6709_length_995_cov_19.382812	510	590	2	32	80	0.4000000
NODE_6710_length_995_cov_19.034598	453	533	0	80	80	1.0000000
NODE_6710_length_995_cov_19.034598	506	586	0	44	80	0.5500000
NODE_6710_length_995_cov_19.034598	506	586	1	36	80	0.4500000
NODE_6711_length_995_cov_9.734375	222	323	0	101	101	1.0000000
NODE_6711_length_995_cov_9.734375	296	376	0	80	80	1.0000000
NODE_6723_length_994_cov_74.678212	362	442	1	33	80	0.4125000
NODE_6723_length_994_cov_74.678212	362	442	2	47	80	0.5875000
NODE_6723_length_994_cov_74.678212	415	495	1	7	80	0.0875000
NODE_6723_length_994_cov_74.678212	415	495	2	73	80	0.9125000
NODE_6723_length_994_cov_74.678212	491	571	1	45	80	0.5625000
NODE_6723_length_994_cov_74.678212	491	571	2	35	80	0.4375000
NODE_6723_length_994_cov_74.678212	544	624	0	53	80	0.6625000
NODE_6723_length_994_cov_74.678212	544	624	1	27	80	0.3375000
NODE_6724_length_994_cov_26.045810	442	522	0	26	80	0.3250000
NODE_6724_length_994_cov_26.045810	442	522	2	54	80	0.6750000
NODE_6724_length_994_cov_26.045810	495	575	0	70	80	0.8750000
NODE_6724_length_994_cov_26.045810	495	575	2	10	80	0.1250000
NODE_6725_length_994_cov_25.240223	504	584	2	17	80	0.2125000
NODE_6725_length_994_cov_25.240223	504	584	4	3	80	0.0375000
NODE_6725_length_994_cov_25.240223	504	584	6	11	80	0.1375000
NODE_6725_length_994_cov_25.240223	504	584	7	49	80	0.6125000
NODE_6725_length_994_cov_25.240223	557	637	4	38	80	0.4750000
NODE_6725_length_994_cov_25.240223	557	637	6	25	80	0.3125000
NODE_6725_length_994_cov_25.240223	557	637	7	17	80	0.2125000
NODE_6726_length_994_cov_24.615642	422	502	0	69	80	0.8625000
NODE_6726_length_994_cov_24.615642	422	502	1	11	80	0.1375000
NODE_6726_length_994_cov_24.615642	475	555	0	16	80	0.2000000
NODE_6726_length_994_cov_24.615642	475	555	1	64	80	0.8000000
NODE_6726_length_994_cov_24.615642	551	631	1	70	80	0.8750000
NODE_6726_length_994_cov_24.615642	551	631	2	10	80	0.1250000
NODE_6726_length_994_cov_24.615642	604	684	1	60	80	0.7500000
NODE_6726_length_994_cov_24.615642	604	684	2	20	80	0.2500000
NODE_6727_length_994_cov_22.593296	323	403	0	25	80	0.3125000
NODE_6727_length_994_cov_22.593296	323	403	1	55	80	0.6875000
NODE_6727_length_994_cov_22.593296	376	456	1	32	80	0.4000000
NODE_6727_length_994_cov_22.593296	376	456	2	42	80	0.5250000
NODE_6727_length_994_cov_22.593296	376	456	3	6	80	0.0750000
NODE_6727_length_994_cov_22.593296	452	532	2	28	80	0.3500000
NODE_6727_length_994_cov_22.593296	452	532	3	52	80	0.6500000
NODE_6727_length_994_cov_22.593296	505	585	2	21	80	0.2625000
NODE_6727_length_994_cov_22.593296	505	585	3	6	80	0.0750000
NODE_6727_length_994_cov_22.593296	505	585	4	50	80	0.6250000
NODE_6727_length_994_cov_22.593296	505	585	5	3	80	0.0375000
NODE_6728_length_994_cov_6.985475	0	58	0	3	58	0.0517241
NODE_6728_length_994_cov_6.985475	0	58	1	55	58	0.9482759
NODE_6728_length_994_cov_6.985475	15	95	1	80	80	1.0000000
NODE_6728_length_994_cov_6.985475	68	148	1	37	80	0.4625000
NODE_6728_length_994_cov_6.985475	68	148	3	23	80	0.2875000
NODE_6728_length_994_cov_6.985475	68	148	4	12	80	0.1500000
NODE_6728_length_994_cov_6.985475	68	148	5	8	80	0.1000000
NODE_6740_length_993_cov_56.321029	266	346	0	29	80	0.3625000
NODE_6740_length_993_cov_56.321029	266	346	1	47	80	0.5875000
NODE_6740_length_993_cov_56.321029	266	346	3	4	80	0.0500000
NODE_6740_length_993_cov_56.321029	319	399	1	23	80	0.2875000
NODE_6740_length_993_cov_56.321029	319	399	3	23	80	0.2875000
NODE_6740_length_993_cov_56.321029	319	399	4	22	80	0.2750000
NODE_6740_length_993_cov_56.321029	319	399	5	12	80	0.1500000
NODE_6740_length_993_cov_56.321029	400	470	5	27	70	0.3857143
NODE_6740_length_993_cov_56.321029	400	470	7	39	70	0.5571429
NODE_6740_length_993_cov_56.321029	400	470	8	4	70	0.0571429
NODE_6740_length_993_cov_56.321029	443	523	4	8	80	0.1000000
NODE_6740_length_993_cov_56.321029	443	523	5	23	80	0.2875000
NODE_6740_length_993_cov_56.321029	443	523	7	47	80	0.5875000
NODE_6740_length_993_cov_56.321029	443	523	8	2	80	0.0250000
NODE_6741_length_993_cov_44.695749	385	465	2	30	80	0.3750000
NODE_6741_length_993_cov_44.695749	385	465	3	9	80	0.1125000
NODE_6741_length_993_cov_44.695749	385	465	5	41	80	0.5125000
NODE_6741_length_993_cov_44.695749	438	518	3	2	80	0.0250000
NODE_6741_length_993_cov_44.695749	438	518	5	49	80	0.6125000
NODE_6741_length_993_cov_44.695749	438	518	6	8	80	0.1000000
NODE_6741_length_993_cov_44.695749	438	518	7	21	80	0.2625000
NODE_6742_length_993_cov_40.574944	417	497	3	25	80	0.3125000
NODE_6742_length_993_cov_40.574944	417	497	4	6	80	0.0750000
NODE_6742_length_993_cov_40.574944	417	497	5	49	80	0.6125000
NODE_6742_length_993_cov_40.574944	470	550	4	59	80	0.7375000
NODE_6742_length_993_cov_40.574944	470	550	5	21	80	0.2625000
NODE_6742_length_993_cov_40.574944	546	628	0	14	82	0.1707317
NODE_6742_length_993_cov_40.574944	546	628	2	46	82	0.5609756
NODE_6742_length_993_cov_40.574944	546	628	4	22	82	0.2682927
NODE_6742_length_993_cov_40.574944	601	681	0	67	80	0.8375000
NODE_6742_length_993_cov_40.574944	601	681	2	13	80	0.1625000
NODE_6743_length_993_cov_39.817673	3	83	3	9	80	0.1125000
NODE_6743_length_993_cov_39.817673	3	83	4	71	80	0.8875000
NODE_6744_length_993_cov_30.128635	477	557	2	2	80	0.0250000
NODE_6744_length_993_cov_30.128635	477	557	3	4	80	0.0500000
NODE_6744_length_993_cov_30.128635	477	557	4	41	80	0.5125000
NODE_6744_length_993_cov_30.128635	477	557	5	33	80	0.4125000
NODE_6744_length_993_cov_30.128635	530	610	3	4	80	0.0500000
NODE_6744_length_993_cov_30.128635	530	610	4	16	80	0.2000000
NODE_6744_length_993_cov_30.128635	530	610	5	60	80	0.7500000
NODE_6745_length_993_cov_17.435123	573	653	2	9	80	0.1125000
NODE_6745_length_993_cov_17.435123	573	653	3	12	80	0.1500000
NODE_6745_length_993_cov_17.435123	573	653	5	16	80	0.2000000
NODE_6745_length_993_cov_17.435123	573	653	6	7	80	0.0875000
NODE_6745_length_993_cov_17.435123	573	653	7	36	80	0.4500000
NODE_6745_length_993_cov_17.435123	626	706	5	13	80	0.1625000
NODE_6745_length_993_cov_17.435123	626	706	6	28	80	0.3500000
NODE_6745_length_993_cov_17.435123	626	706	7	39	80	0.4875000
NODE_6746_length_993_cov_13.074944	483	563	0	80	80	1.0000000
NODE_6746_length_993_cov_13.074944	536	616	0	80	80	1.0000000
NODE_6747_length_993_cov_10.190157	500	580	2	54	80	0.6750000
NODE_6747_length_993_cov_10.190157	500	580	3	3	80	0.0375000
NODE_6747_length_993_cov_10.190157	500	580	4	23	80	0.2875000
NODE_6747_length_993_cov_10.190157	553	633	2	80	80	1.0000000
NODE_6756_length_993_cov_0.909396	16	73	0	57	57	1.0000000
NODE_6757_length_992_cov_36.119821	354	434	0	64	80	0.8000000
NODE_6757_length_992_cov_36.119821	354	434	2	16	80	0.2000000
NODE_6757_length_992_cov_36.119821	407	487	0	11	80	0.1375000
NODE_6757_length_992_cov_36.119821	407	487	2	69	80	0.8625000
NODE_6757_length_992_cov_36.119821	483	563	2	73	80	0.9125000
NODE_6757_length_992_cov_36.119821	483	563	4	7	80	0.0875000
NODE_6757_length_992_cov_36.119821	536	616	2	80	80	1.0000000
NODE_6758_length_992_cov_34.802912	443	523	0	80	80	1.0000000
NODE_6758_length_992_cov_34.802912	496	576	0	80	80	1.0000000
NODE_6759_length_992_cov_33.047032	381	461	0	9	80	0.1125000
NODE_6759_length_992_cov_33.047032	381	461	1	49	80	0.6125000
NODE_6759_length_992_cov_33.047032	381	461	3	21	80	0.2625000
NODE_6759_length_992_cov_33.047032	381	461	4	1	80	0.0125000
NODE_6759_length_992_cov_33.047032	434	514	1	5	80	0.0625000
NODE_6759_length_992_cov_33.047032	434	514	3	21	80	0.2625000
NODE_6759_length_992_cov_33.047032	434	514	4	25	80	0.3125000
NODE_6759_length_992_cov_33.047032	434	514	5	29	80	0.3625000
NODE_6759_length_992_cov_33.047032	510	590	0	22	80	0.2750000
NODE_6759_length_992_cov_33.047032	510	590	1	39	80	0.4875000
NODE_6759_length_992_cov_33.047032	510	590	2	15	80	0.1875000
NODE_6759_length_992_cov_33.047032	510	590	4	4	80	0.0500000
NODE_6759_length_992_cov_33.047032	563	643	1	12	80	0.1500000
NODE_6759_length_992_cov_33.047032	563	643	2	68	80	0.8500000
NODE_6760_length_992_cov_23.543113	435	515	3	71	80	0.8875000
NODE_6760_length_992_cov_23.543113	435	515	5	9	80	0.1125000
NODE_6760_length_992_cov_23.543113	488	568	3	37	80	0.4625000
NODE_6760_length_992_cov_23.543113	488	568	4	18	80	0.2250000
NODE_6760_length_992_cov_23.543113	488	568	5	25	80	0.3125000
NODE_6761_length_992_cov_22.608063	440	520	2	65	80	0.8125000
NODE_6761_length_992_cov_22.608063	440	520	4	15	80	0.1875000
NODE_6761_length_992_cov_22.608063	493	573	1	44	80	0.5500000
NODE_6761_length_992_cov_22.608063	493	573	2	36	80	0.4500000
NODE_6762_length_992_cov_21.427772	216	296	1	25	80	0.3125000
NODE_6762_length_992_cov_21.427772	216	296	2	55	80	0.6875000
NODE_6762_length_992_cov_21.427772	269	349	1	45	80	0.5625000
NODE_6762_length_992_cov_21.427772	269	349	2	35	80	0.4375000
NODE_6763_length_992_cov_20.010078	312	392	3	2	80	0.0250000
NODE_6763_length_992_cov_20.010078	312	392	5	26	80	0.3250000
NODE_6763_length_992_cov_20.010078	312	392	7	31	80	0.3875000
NODE_6763_length_992_cov_20.010078	312	392	8	21	80	0.2625000
NODE_6763_length_992_cov_20.010078	365	445	6	1	80	0.0125000
NODE_6763_length_992_cov_20.010078	365	445	7	6	80	0.0750000
NODE_6763_length_992_cov_20.010078	365	445	8	73	80	0.9125000
NODE_6764_length_992_cov_16.524076	465	545	1	1	80	0.0125000
NODE_6764_length_992_cov_16.524076	465	545	2	76	80	0.9500000
NODE_6764_length_992_cov_16.524076	465	545	3	3	80	0.0375000
NODE_6764_length_992_cov_16.524076	518	598	1	1	80	0.0125000
NODE_6764_length_992_cov_16.524076	518	598	2	76	80	0.9500000
NODE_6764_length_992_cov_16.524076	518	598	3	3	80	0.0375000
NODE_6765_length_992_cov_16.266517	396	476	2	10	80	0.1250000
NODE_6765_length_992_cov_16.266517	396	476	3	40	80	0.5000000
NODE_6765_length_992_cov_16.266517	396	476	5	30	80	0.3750000
NODE_6765_length_992_cov_16.266517	449	529	5	53	80	0.6625000
NODE_6765_length_992_cov_16.266517	449	529	6	9	80	0.1125000
NODE_6765_length_992_cov_16.266517	449	529	7	18	80	0.2250000
NODE_6766_length_992_cov_16.146697	272	352	0	16	80	0.2000000
NODE_6766_length_992_cov_16.146697	272	352	1	64	80	0.8000000
NODE_6766_length_992_cov_16.146697	325	405	0	69	80	0.8625000
NODE_6766_length_992_cov_16.146697	325	405	1	11	80	0.1375000
NODE_6767_length_992_cov_15.212766	354	434	1	1	80	0.0125000
NODE_6767_length_992_cov_15.212766	354	434	2	79	80	0.9875000
NODE_6767_length_992_cov_15.212766	407	487	2	58	80	0.7250000
NODE_6767_length_992_cov_15.212766	407	487	3	13	80	0.1625000
NODE_6767_length_992_cov_15.212766	407	487	5	9	80	0.1125000
NODE_6767_length_992_cov_15.212766	483	563	4	12	80	0.1500000
NODE_6767_length_992_cov_15.212766	483	563	5	68	80	0.8500000
NODE_6767_length_992_cov_15.212766	536	616	3	15	80	0.1875000
NODE_6767_length_992_cov_15.212766	536	616	4	18	80	0.2250000
NODE_6767_length_992_cov_15.212766	536	616	5	47	80	0.5875000
NODE_6781_length_991_cov_48.582960	451	531	0	7	80	0.0875000
NODE_6781_length_991_cov_48.582960	451	531	2	32	80	0.4000000
NODE_6781_length_991_cov_48.582960	451	531	3	18	80	0.2250000
NODE_6781_length_991_cov_48.582960	451	531	4	23	80	0.2875000
NODE_6781_length_991_cov_48.582960	504	584	3	4	80	0.0500000
NODE_6781_length_991_cov_48.582960	504	584	4	76	80	0.9500000
NODE_6782_length_991_cov_25.891256	340	420	9	2	80	0.0250000
NODE_6782_length_991_cov_25.891256	340	420	11	2	80	0.0250000
NODE_6782_length_991_cov_25.891256	340	420	12	8	80	0.1000000
NODE_6782_length_991_cov_25.891256	340	420	13	47	80	0.5875000
NODE_6782_length_991_cov_25.891256	340	420	14	21	80	0.2625000
NODE_6782_length_991_cov_25.891256	393	473	7	4	80	0.0500000
NODE_6782_length_991_cov_25.891256	393	473	8	2	80	0.0250000
NODE_6782_length_991_cov_25.891256	393	473	9	24	80	0.3000000
NODE_6782_length_991_cov_25.891256	393	473	10	20	80	0.2500000
NODE_6782_length_991_cov_25.891256	393	473	11	7	80	0.0875000
NODE_6782_length_991_cov_25.891256	393	473	12	6	80	0.0750000
NODE_6782_length_991_cov_25.891256	393	473	14	17	80	0.2125000
NODE_6782_length_991_cov_25.891256	469	549	7	18	80	0.2250000
NODE_6782_length_991_cov_25.891256	469	549	8	52	80	0.6500000
NODE_6782_length_991_cov_25.891256	469	549	9	2	80	0.0250000
NODE_6782_length_991_cov_25.891256	469	549	10	1	80	0.0125000
NODE_6782_length_991_cov_25.891256	469	549	11	7	80	0.0875000
NODE_6782_length_991_cov_25.891256	522	602	7	21	80	0.2625000
NODE_6782_length_991_cov_25.891256	522	602	8	10	80	0.1250000
NODE_6782_length_991_cov_25.891256	522	602	10	12	80	0.1500000
NODE_6782_length_991_cov_25.891256	522	602	11	37	80	0.4625000
NODE_6783_length_991_cov_25.392377	377	457	0	71	80	0.8875000
NODE_6783_length_991_cov_25.392377	377	457	1	5	80	0.0625000
NODE_6783_length_991_cov_25.392377	377	457	2	4	80	0.0500000
NODE_6783_length_991_cov_25.392377	430	510	0	44	80	0.5500000
NODE_6783_length_991_cov_25.392377	430	510	1	3	80	0.0375000
NODE_6783_length_991_cov_25.392377	430	510	2	33	80	0.4125000
NODE_6783_length_991_cov_25.392377	506	586	2	80	80	1.0000000
NODE_6783_length_991_cov_25.392377	559	639	0	16	80	0.2000000
NODE_6783_length_991_cov_25.392377	559	639	2	64	80	0.8000000
NODE_6784_length_991_cov_22.210762	421	501	0	80	80	1.0000000
NODE_6784_length_991_cov_22.210762	474	554	0	80	80	1.0000000
NODE_6785_length_991_cov_18.008969	366	446	0	58	80	0.7250000
NODE_6785_length_991_cov_18.008969	366	446	1	22	80	0.2750000
NODE_6785_length_991_cov_18.008969	419	499	0	5	80	0.0625000
NODE_6785_length_991_cov_18.008969	419	499	1	75	80	0.9375000
NODE_6785_length_991_cov_18.008969	495	575	1	31	80	0.3875000
NODE_6785_length_991_cov_18.008969	495	575	2	49	80	0.6125000
NODE_6785_length_991_cov_18.008969	548	629	1	55	81	0.6790124
NODE_6785_length_991_cov_18.008969	548	629	2	26	81	0.3209876
NODE_6786_length_991_cov_14.727578	426	506	6	14	80	0.1750000
NODE_6786_length_991_cov_14.727578	426	506	7	30	80	0.3750000
NODE_6786_length_991_cov_14.727578	426	506	8	1	80	0.0125000
NODE_6786_length_991_cov_14.727578	426	506	9	25	80	0.3125000
NODE_6786_length_991_cov_14.727578	426	506	10	10	80	0.1250000
NODE_6786_length_991_cov_14.727578	479	559	5	36	80	0.4500000
NODE_6786_length_991_cov_14.727578	479	559	6	13	80	0.1625000
NODE_6786_length_991_cov_14.727578	479	559	7	24	80	0.3000000
NODE_6786_length_991_cov_14.727578	479	559	8	1	80	0.0125000
NODE_6786_length_991_cov_14.727578	479	559	9	6	80	0.0750000
NODE_6787_length_991_cov_13.081839	240	320	2	40	80	0.5000000
NODE_6787_length_991_cov_13.081839	240	320	3	31	80	0.3875000
NODE_6787_length_991_cov_13.081839	240	320	4	5	80	0.0625000
NODE_6787_length_991_cov_13.081839	240	320	5	4	80	0.0500000
NODE_6787_length_991_cov_13.081839	293	373	3	29	80	0.3625000
NODE_6787_length_991_cov_13.081839	293	373	4	36	80	0.4500000
NODE_6787_length_991_cov_13.081839	293	373	5	15	80	0.1875000
NODE_6788_length_991_cov_12.693946	425	505	4	6	80	0.0750000
NODE_6788_length_991_cov_12.693946	425	505	5	20	80	0.2500000
NODE_6788_length_991_cov_12.693946	425	505	6	54	80	0.6750000
NODE_6788_length_991_cov_12.693946	478	558	4	47	80	0.5875000
NODE_6788_length_991_cov_12.693946	478	558	6	33	80	0.4125000
NODE_6789_length_991_cov_9.647982	436	516	0	80	80	1.0000000
NODE_6789_length_991_cov_9.647982	489	569	0	31	80	0.3875000
NODE_6789_length_991_cov_9.647982	489	569	1	49	80	0.6125000
NODE_6790_length_991_cov_5.176009	538	618	1	65	80	0.8125000
NODE_6790_length_991_cov_5.176009	538	618	2	15	80	0.1875000
NODE_6790_length_991_cov_5.176009	591	671	0	19	80	0.2375000
NODE_6790_length_991_cov_5.176009	591	671	1	61	80	0.7625000
NODE_6801_length_990_cov_39.386083	402	482	0	80	80	1.0000000
NODE_6801_length_990_cov_39.386083	455	535	0	80	80	1.0000000
NODE_6802_length_990_cov_35.993266	321	401	2	1	80	0.0125000
NODE_6802_length_990_cov_35.993266	321	401	3	79	80	0.9875000
NODE_6802_length_990_cov_35.993266	374	454	3	42	80	0.5250000
NODE_6802_length_990_cov_35.993266	374	454	4	2	80	0.0250000
NODE_6802_length_990_cov_35.993266	374	454	5	20	80	0.2500000
NODE_6802_length_990_cov_35.993266	374	454	6	16	80	0.2000000
NODE_6802_length_990_cov_35.993266	450	530	4	6	80	0.0750000
NODE_6802_length_990_cov_35.993266	450	530	5	19	80	0.2375000
NODE_6802_length_990_cov_35.993266	450	530	6	55	80	0.6875000
NODE_6802_length_990_cov_35.993266	503	583	2	19	80	0.2375000
NODE_6802_length_990_cov_35.993266	503	583	4	36	80	0.4500000
NODE_6802_length_990_cov_35.993266	503	583	6	25	80	0.3125000
NODE_6803_length_990_cov_24.445567	588	668	3	3	80	0.0375000
NODE_6803_length_990_cov_24.445567	588	668	4	48	80	0.6000000
NODE_6803_length_990_cov_24.445567	588	668	5	17	80	0.2125000
NODE_6803_length_990_cov_24.445567	588	668	6	12	80	0.1500000
NODE_6803_length_990_cov_24.445567	641	721	3	2	80	0.0250000
NODE_6803_length_990_cov_24.445567	641	721	4	59	80	0.7375000
NODE_6803_length_990_cov_24.445567	641	721	5	8	80	0.1000000
NODE_6803_length_990_cov_24.445567	641	721	6	11	80	0.1375000
NODE_6805_length_990_cov_22.378227	430	510	1	57	80	0.7125000
NODE_6805_length_990_cov_22.378227	430	510	2	23	80	0.2875000
NODE_6805_length_990_cov_22.378227	483	563	1	80	80	1.0000000
NODE_6806_length_990_cov_20.150393	408	488	1	4	80	0.0500000
NODE_6806_length_990_cov_20.150393	408	488	2	9	80	0.1125000
NODE_6806_length_990_cov_20.150393	408	488	3	18	80	0.2250000
NODE_6806_length_990_cov_20.150393	408	488	4	49	80	0.6125000
NODE_6806_length_990_cov_20.150393	461	541	0	51	80	0.6375000
NODE_6806_length_990_cov_20.150393	461	541	1	6	80	0.0750000
NODE_6806_length_990_cov_20.150393	461	541	2	9	80	0.1125000
NODE_6806_length_990_cov_20.150393	461	541	3	14	80	0.1750000
NODE_6807_length_990_cov_18.154882	434	514	2	80	80	1.0000000
NODE_6807_length_990_cov_18.154882	487	567	0	18	80	0.2250000
NODE_6807_length_990_cov_18.154882	487	567	2	62	80	0.7750000
NODE_6808_length_990_cov_17.250281	329	409	0	80	80	1.0000000
NODE_6808_length_990_cov_17.250281	382	462	0	73	80	0.9125000
NODE_6808_length_990_cov_17.250281	382	462	1	7	80	0.0875000
NODE_6808_length_990_cov_17.250281	458	538	1	46	80	0.5750000
NODE_6808_length_990_cov_17.250281	458	538	2	34	80	0.4250000
NODE_6808_length_990_cov_17.250281	511	591	2	80	80	1.0000000
NODE_6809_length_990_cov_14.977553	448	528	0	80	80	1.0000000
NODE_6809_length_990_cov_14.977553	501	581	0	80	80	1.0000000
NODE_6810_length_990_cov_13.846240	482	562	0	80	80	1.0000000
NODE_6810_length_990_cov_13.846240	535	615	0	80	80	1.0000000
NODE_6821_length_990_cov_0.978676	79	151	1	2	72	0.0277778
NODE_6821_length_990_cov_0.978676	79	151	2	12	72	0.1666667
NODE_6821_length_990_cov_0.978676	79	151	3	38	72	0.5277778
NODE_6821_length_990_cov_0.978676	79	151	4	20	72	0.2777778
NODE_6821_length_990_cov_0.978676	82	152	1	3	70	0.0428571
NODE_6821_length_990_cov_0.978676	82	152	2	12	70	0.1714286
NODE_6821_length_990_cov_0.978676	82	152	3	35	70	0.5000000
NODE_6821_length_990_cov_0.978676	82	152	4	20	70	0.2857143
NODE_6823_length_989_cov_45.902247	47	127	2	3	80	0.0375000
NODE_6823_length_989_cov_45.902247	47	127	4	6	80	0.0750000
NODE_6823_length_989_cov_45.902247	47	127	6	1	80	0.0125000
NODE_6823_length_989_cov_45.902247	47	127	10	9	80	0.1125000
NODE_6823_length_989_cov_45.902247	47	127	12	61	80	0.7625000
NODE_6823_length_989_cov_45.902247	330	410	4	17	80	0.2125000
NODE_6823_length_989_cov_45.902247	330	410	5	63	80	0.7875000
NODE_6823_length_989_cov_45.902247	383	463	1	8	80	0.1000000
NODE_6823_length_989_cov_45.902247	383	463	2	30	80	0.3750000
NODE_6823_length_989_cov_45.902247	383	463	3	14	80	0.1750000
NODE_6823_length_989_cov_45.902247	383	463	5	28	80	0.3500000
NODE_6824_length_989_cov_35.430337	412	492	3	30	80	0.3750000
NODE_6824_length_989_cov_35.430337	412	492	4	50	80	0.6250000
NODE_6824_length_989_cov_35.430337	465	545	1	5	80	0.0625000
NODE_6824_length_989_cov_35.430337	465	545	3	62	80	0.7750000
NODE_6824_length_989_cov_35.430337	465	545	4	13	80	0.1625000
NODE_6825_length_989_cov_30.124719	477	557	1	5	80	0.0625000
NODE_6825_length_989_cov_30.124719	477	557	3	75	80	0.9375000
NODE_6825_length_989_cov_30.124719	530	610	1	3	80	0.0375000
NODE_6825_length_989_cov_30.124719	530	610	2	5	80	0.0625000
NODE_6825_length_989_cov_30.124719	530	610	3	54	80	0.6750000
NODE_6825_length_989_cov_30.124719	530	610	4	18	80	0.2250000
NODE_6826_length_989_cov_29.347191	447	527	4	80	80	1.0000000
NODE_6826_length_989_cov_29.347191	500	580	1	22	80	0.2750000
NODE_6826_length_989_cov_29.347191	500	580	2	7	80	0.0875000
NODE_6826_length_989_cov_29.347191	500	580	3	14	80	0.1750000
NODE_6826_length_989_cov_29.347191	500	580	4	37	80	0.4625000
NODE_6826_length_989_cov_29.347191	576	656	0	68	80	0.8500000
NODE_6826_length_989_cov_29.347191	576	656	1	12	80	0.1500000
NODE_6826_length_989_cov_29.347191	629	709	0	28	80	0.3500000
NODE_6826_length_989_cov_29.347191	629	709	1	52	80	0.6500000
NODE_6827_length_989_cov_27.886517	245	325	2	15	80	0.1875000
NODE_6827_length_989_cov_27.886517	245	325	3	16	80	0.2000000
NODE_6827_length_989_cov_27.886517	245	325	4	7	80	0.0875000
NODE_6827_length_989_cov_27.886517	245	325	7	38	80	0.4750000
NODE_6827_length_989_cov_27.886517	245	325	8	4	80	0.0500000
NODE_6827_length_989_cov_27.886517	298	378	5	18	80	0.2250000
NODE_6827_length_989_cov_27.886517	298	378	7	58	80	0.7250000
NODE_6827_length_989_cov_27.886517	298	378	8	4	80	0.0500000
NODE_6827_length_989_cov_27.886517	374	454	2	21	80	0.2625000
NODE_6827_length_989_cov_27.886517	374	454	3	7	80	0.0875000
NODE_6827_length_989_cov_27.886517	374	454	4	44	80	0.5500000
NODE_6827_length_989_cov_27.886517	374	454	5	8	80	0.1000000
NODE_6827_length_989_cov_27.886517	427	507	1	53	80	0.6625000
NODE_6827_length_989_cov_27.886517	427	507	2	21	80	0.2625000
NODE_6827_length_989_cov_27.886517	427	507	3	6	80	0.0750000
NODE_6828_length_989_cov_27.515730	393	473	1	21	80	0.2625000
NODE_6828_length_989_cov_27.515730	393	473	2	59	80	0.7375000
NODE_6828_length_989_cov_27.515730	446	526	1	1	80	0.0125000
NODE_6828_length_989_cov_27.515730	446	526	2	61	80	0.7625000
NODE_6828_length_989_cov_27.515730	446	526	4	18	80	0.2250000
NODE_6828_length_989_cov_27.515730	522	602	4	54	80	0.6750000
NODE_6828_length_989_cov_27.515730	522	602	5	26	80	0.3250000
NODE_6828_length_989_cov_27.515730	575	655	2	11	80	0.1375000
NODE_6828_length_989_cov_27.515730	575	655	3	13	80	0.1625000
NODE_6828_length_989_cov_27.515730	575	655	4	56	80	0.7000000
NODE_6829_length_989_cov_23.844944	312	392	3	15	80	0.1875000
NODE_6829_length_989_cov_23.844944	312	392	5	65	80	0.8125000
NODE_6829_length_989_cov_23.844944	365	445	3	44	80	0.5500000
NODE_6829_length_989_cov_23.844944	365	445	5	36	80	0.4500000
NODE_6830_length_989_cov_23.131461	475	555	0	80	80	1.0000000
NODE_6830_length_989_cov_23.131461	528	608	0	80	80	1.0000000
NODE_6831_length_989_cov_20.189888	500	580	2	80	80	1.0000000
NODE_6831_length_989_cov_20.189888	553	633	2	80	80	1.0000000
NODE_6832_length_989_cov_18.429213	190	270	0	80	80	1.0000000
NODE_6832_length_989_cov_18.429213	258	323	0	65	65	1.0000000
NODE_6832_length_989_cov_18.429213	319	399	0	80	80	1.0000000
NODE_6832_length_989_cov_18.429213	372	412	0	40	40	1.0000000
NODE_6833_length_989_cov_10.307865	433	513	0	80	80	1.0000000
NODE_6833_length_989_cov_10.307865	486	570	0	84	84	1.0000000
NODE_6833_length_989_cov_10.307865	566	642	0	15	76	0.1973684
NODE_6833_length_989_cov_10.307865	566	642	1	61	76	0.8026316
NODE_6833_length_989_cov_10.307865	615	695	1	32	80	0.4000000
NODE_6833_length_989_cov_10.307865	615	695	2	48	80	0.6000000
NODE_6834_length_989_cov_8.941573	528	608	0	80	80	1.0000000
NODE_6834_length_989_cov_8.941573	581	661	0	80	80	1.0000000
NODE_6835_length_989_cov_5.132584	459	524	0	30	65	0.4615385
NODE_6835_length_989_cov_5.132584	459	524	1	35	65	0.5384616
NODE_6838_length_989_cov_2.540449	703	783	2	80	80	1.0000000
NODE_6845_length_988_cov_52.168729	361	441	0	80	80	1.0000000
NODE_6845_length_988_cov_52.168729	414	494	0	80	80	1.0000000
NODE_6845_length_988_cov_52.168729	490	570	0	11	80	0.1375000
NODE_6845_length_988_cov_52.168729	490	570	2	69	80	0.8625000
NODE_6845_length_988_cov_52.168729	543	623	0	20	80	0.2500000
NODE_6845_length_988_cov_52.168729	543	623	2	60	80	0.7500000
NODE_6846_length_988_cov_36.733408	390	470	2	64	80	0.8000000
NODE_6846_length_988_cov_36.733408	390	470	4	16	80	0.2000000
NODE_6846_length_988_cov_36.733408	443	523	0	7	80	0.0875000
NODE_6846_length_988_cov_36.733408	443	523	2	73	80	0.9125000
NODE_6847_length_988_cov_36.221597	478	558	3	12	80	0.1500000
NODE_6847_length_988_cov_36.221597	478	558	5	39	80	0.4875000
NODE_6847_length_988_cov_36.221597	478	558	7	26	80	0.3250000
NODE_6847_length_988_cov_36.221597	478	558	8	3	80	0.0375000
NODE_6847_length_988_cov_36.221597	531	611	5	3	80	0.0375000
NODE_6847_length_988_cov_36.221597	531	611	6	45	80	0.5625000
NODE_6847_length_988_cov_36.221597	531	611	7	29	80	0.3625000
NODE_6847_length_988_cov_36.221597	531	611	8	3	80	0.0375000
NODE_6848_length_988_cov_25.895388	389	469	2	12	80	0.1500000
NODE_6848_length_988_cov_25.895388	389	469	4	18	80	0.2250000
NODE_6848_length_988_cov_25.895388	389	469	5	10	80	0.1250000
NODE_6848_length_988_cov_25.895388	389	469	7	37	80	0.4625000
NODE_6848_length_988_cov_25.895388	389	469	8	3	80	0.0375000
NODE_6848_length_988_cov_25.895388	442	522	7	80	80	1.0000000
NODE_6848_length_988_cov_25.895388	518	598	0	19	80	0.2375000
NODE_6848_length_988_cov_25.895388	518	598	1	10	80	0.1250000
NODE_6848_length_988_cov_25.895388	518	598	2	11	80	0.1375000
NODE_6848_length_988_cov_25.895388	518	598	4	31	80	0.3875000
NODE_6848_length_988_cov_25.895388	518	598	7	9	80	0.1125000
NODE_6848_length_988_cov_25.895388	571	651	0	72	80	0.9000000
NODE_6848_length_988_cov_25.895388	571	651	1	8	80	0.1000000
NODE_6849_length_988_cov_20.250844	423	503	0	80	80	1.0000000
NODE_6849_length_988_cov_20.250844	476	556	0	80	80	1.0000000
NODE_6850_length_988_cov_15.812148	474	554	0	80	80	1.0000000
NODE_6850_length_988_cov_15.812148	527	607	0	80	80	1.0000000
NODE_6851_length_988_cov_15.082115	435	517	0	25	82	0.3048781
NODE_6851_length_988_cov_15.082115	435	517	1	57	82	0.6951219
NODE_6851_length_988_cov_15.082115	490	570	1	80	80	1.0000000
NODE_6852_length_988_cov_14.697413	467	547	0	80	80	1.0000000
NODE_6852_length_988_cov_14.697413	520	600	0	80	80	1.0000000
NODE_6853_length_988_cov_7.730034	562	642	0	80	80	1.0000000
NODE_6853_length_988_cov_7.730034	615	695	0	80	80	1.0000000
NODE_6862_length_987_cov_42.784910	383	476	0	93	93	1.0000000
NODE_6862_length_987_cov_42.784910	449	529	0	80	80	1.0000000
NODE_6863_length_987_cov_39.716216	290	370	0	80	80	1.0000000
NODE_6863_length_987_cov_39.716216	343	423	0	49	80	0.6125000
NODE_6863_length_987_cov_39.716216	343	423	1	1	80	0.0125000
NODE_6863_length_987_cov_39.716216	343	423	2	28	80	0.3500000
NODE_6863_length_987_cov_39.716216	343	423	4	2	80	0.0250000
NODE_6863_length_987_cov_39.716216	419	499	2	2	80	0.0250000
NODE_6863_length_987_cov_39.716216	419	499	4	78	80	0.9750000
NODE_6863_length_987_cov_39.716216	472	552	2	9	80	0.1125000
NODE_6863_length_987_cov_39.716216	472	552	3	1	80	0.0125000
NODE_6863_length_987_cov_39.716216	472	552	4	70	80	0.8750000
NODE_6864_length_987_cov_28.171171	406	486	0	45	80	0.5625000
NODE_6864_length_987_cov_28.171171	406	486	2	35	80	0.4375000
NODE_6864_length_987_cov_28.171171	459	539	0	9	80	0.1125000
NODE_6864_length_987_cov_28.171171	459	539	2	71	80	0.8875000
NODE_6864_length_987_cov_28.171171	535	615	0	18	80	0.2250000
NODE_6864_length_987_cov_28.171171	535	615	2	11	80	0.1375000
NODE_6864_length_987_cov_28.171171	535	615	3	2	80	0.0250000
NODE_6864_length_987_cov_28.171171	535	615	4	32	80	0.4000000
NODE_6864_length_987_cov_28.171171	535	615	5	17	80	0.2125000
NODE_6864_length_987_cov_28.171171	588	668	4	30	80	0.3750000
NODE_6864_length_987_cov_28.171171	588	668	5	27	80	0.3375000
NODE_6864_length_987_cov_28.171171	588	668	6	23	80	0.2875000
NODE_6865_length_987_cov_23.627252	331	411	2	1	80	0.0125000
NODE_6865_length_987_cov_23.627252	331	411	3	55	80	0.6875000
NODE_6865_length_987_cov_23.627252	331	411	4	24	80	0.3000000
NODE_6865_length_987_cov_23.627252	384	464	2	30	80	0.3750000
NODE_6865_length_987_cov_23.627252	384	464	3	50	80	0.6250000
NODE_6866_length_987_cov_18.797297	437	517	5	79	80	0.9875000
NODE_6866_length_987_cov_18.797297	437	517	6	1	80	0.0125000
NODE_6866_length_987_cov_18.797297	490	570	3	1	80	0.0125000
NODE_6866_length_987_cov_18.797297	490	570	4	26	80	0.3250000
NODE_6866_length_987_cov_18.797297	490	570	5	53	80	0.6625000
NODE_6867_length_987_cov_15.628378	369	449	1	9	80	0.1125000
NODE_6867_length_987_cov_15.628378	369	449	2	71	80	0.8875000
NODE_6867_length_987_cov_15.628378	422	502	1	21	80	0.2625000
NODE_6867_length_987_cov_15.628378	422	502	2	59	80	0.7375000
NODE_6868_length_987_cov_15.439189	438	518	3	5	80	0.0625000
NODE_6868_length_987_cov_15.439189	438	518	5	62	80	0.7750000
NODE_6868_length_987_cov_15.439189	438	518	6	2	80	0.0250000
NODE_6868_length_987_cov_15.439189	438	518	7	11	80	0.1375000
NODE_6868_length_987_cov_15.439189	491	571	4	30	80	0.3750000
NODE_6868_length_987_cov_15.439189	491	571	5	16	80	0.2000000
NODE_6868_length_987_cov_15.439189	491	571	6	22	80	0.2750000
NODE_6868_length_987_cov_15.439189	491	571	7	12	80	0.1500000
NODE_6869_length_987_cov_14.343468	506	586	0	57	80	0.7125000
NODE_6869_length_987_cov_14.343468	506	586	2	23	80	0.2875000
NODE_6869_length_987_cov_14.343468	559	639	0	80	80	1.0000000
NODE_6870_length_987_cov_13.515766	475	555	0	14	80	0.1750000
NODE_6870_length_987_cov_13.515766	475	555	2	66	80	0.8250000
NODE_6870_length_987_cov_13.515766	528	608	2	80	80	1.0000000
NODE_6871_length_987_cov_9.521396	408	482	1	24	74	0.3243243
NODE_6871_length_987_cov_9.521396	408	482	2	50	74	0.6756757
NODE_6871_length_987_cov_9.521396	455	535	1	77	80	0.9625000
NODE_6871_length_987_cov_9.521396	455	535	2	3	80	0.0375000
NODE_6872_length_987_cov_9.054054	440	520	3	11	80	0.1375000
NODE_6872_length_987_cov_9.054054	440	520	4	12	80	0.1500000
NODE_6872_length_987_cov_9.054054	440	520	5	17	80	0.2125000
NODE_6872_length_987_cov_9.054054	440	520	6	1	80	0.0125000
NODE_6872_length_987_cov_9.054054	440	520	7	39	80	0.4875000
NODE_6872_length_987_cov_9.054054	493	573	3	39	80	0.4875000
NODE_6872_length_987_cov_9.054054	493	573	4	37	80	0.4625000
NODE_6872_length_987_cov_9.054054	493	573	5	4	80	0.0500000
NODE_6875_length_987_cov_5.378378	509	589	0	34	80	0.4250000
NODE_6875_length_987_cov_5.378378	509	589	1	46	80	0.5750000
NODE_6875_length_987_cov_5.378378	562	642	1	80	80	1.0000000
NODE_6889_length_986_cov_36.937993	327	407	4	20	80	0.2500000
NODE_6889_length_986_cov_36.937993	327	407	5	41	80	0.5125000
NODE_6889_length_986_cov_36.937993	327	407	6	19	80	0.2375000
NODE_6889_length_986_cov_36.937993	380	460	1	5	80	0.0625000
NODE_6889_length_986_cov_36.937993	380	460	3	15	80	0.1875000
NODE_6889_length_986_cov_36.937993	380	460	4	20	80	0.2500000
NODE_6889_length_986_cov_36.937993	380	460	5	40	80	0.5000000
NODE_6889_length_986_cov_36.937993	456	536	3	4	80	0.0500000
NODE_6889_length_986_cov_36.937993	456	536	4	32	80	0.4000000
NODE_6889_length_986_cov_36.937993	456	536	5	1	80	0.0125000
NODE_6889_length_986_cov_36.937993	456	536	6	43	80	0.5375000
NODE_6889_length_986_cov_36.937993	509	589	5	27	80	0.3375000
NODE_6889_length_986_cov_36.937993	509	589	6	52	80	0.6500000
NODE_6889_length_986_cov_36.937993	509	589	7	1	80	0.0125000
NODE_6890_length_986_cov_35.130778	325	405	2	80	80	1.0000000
NODE_6890_length_986_cov_35.130778	378	458	2	71	80	0.8875000
NODE_6890_length_986_cov_35.130778	378	458	4	9	80	0.1125000
NODE_6890_length_986_cov_35.130778	454	534	2	4	80	0.0500000
NODE_6890_length_986_cov_35.130778	454	534	3	6	80	0.0750000
NODE_6890_length_986_cov_35.130778	454	534	4	70	80	0.8750000
NODE_6890_length_986_cov_35.130778	507	587	4	80	80	1.0000000
NODE_6891_length_986_cov_24.037204	602	682	2	2	80	0.0250000
NODE_6891_length_986_cov_24.037204	602	682	3	70	80	0.8750000
NODE_6891_length_986_cov_24.037204	602	682	4	8	80	0.1000000
NODE_6891_length_986_cov_24.037204	655	735	3	21	80	0.2625000
NODE_6891_length_986_cov_24.037204	655	735	4	36	80	0.4500000
NODE_6891_length_986_cov_24.037204	655	735	5	23	80	0.2875000
NODE_6891_length_986_cov_24.037204	731	811	4	2	80	0.0250000
NODE_6891_length_986_cov_24.037204	731	811	5	61	80	0.7625000
NODE_6891_length_986_cov_24.037204	731	811	6	17	80	0.2125000
NODE_6891_length_986_cov_24.037204	784	864	5	12	80	0.1500000
NODE_6891_length_986_cov_24.037204	784	864	6	27	80	0.3375000
NODE_6891_length_986_cov_24.037204	784	864	8	29	80	0.3625000
NODE_6891_length_986_cov_24.037204	784	864	9	9	80	0.1125000
NODE_6891_length_986_cov_24.037204	784	864	10	3	80	0.0375000
NODE_6892_length_986_cov_20.591883	395	475	2	35	80	0.4375000
NODE_6892_length_986_cov_20.591883	395	475	3	22	80	0.2750000
NODE_6892_length_986_cov_20.591883	395	475	5	23	80	0.2875000
NODE_6892_length_986_cov_20.591883	448	528	3	65	80	0.8125000
NODE_6892_length_986_cov_20.591883	448	528	4	10	80	0.1250000
NODE_6892_length_986_cov_20.591883	448	528	5	5	80	0.0625000
NODE_6893_length_986_cov_16.815107	389	469	3	65	80	0.8125000
NODE_6893_length_986_cov_16.815107	389	469	4	15	80	0.1875000
NODE_6893_length_986_cov_16.815107	442	522	1	38	80	0.4750000
NODE_6893_length_986_cov_16.815107	442	522	3	17	80	0.2125000
NODE_6893_length_986_cov_16.815107	442	522	4	25	80	0.3125000
NODE_6894_length_986_cov_11.021421	474	554	0	39	80	0.4875000
NODE_6894_length_986_cov_11.021421	474	554	1	41	80	0.5125000
NODE_6894_length_986_cov_11.021421	527	607	0	7	80	0.0875000
NODE_6894_length_986_cov_11.021421	527	607	1	73	80	0.9125000
NODE_6905_length_985_cov_41.707675	443	523	0	27	80	0.3375000
NODE_6905_length_985_cov_41.707675	443	523	2	10	80	0.1250000
NODE_6905_length_985_cov_41.707675	443	523	3	10	80	0.1250000
NODE_6905_length_985_cov_41.707675	443	523	4	33	80	0.4125000
NODE_6905_length_985_cov_41.707675	496	576	3	13	80	0.1625000
NODE_6905_length_985_cov_41.707675	496	576	4	27	80	0.3375000
NODE_6905_length_985_cov_41.707675	496	576	5	40	80	0.5000000
NODE_6911_length_984_cov_64.531073	412	481	1	18	69	0.2608696
NODE_6911_length_984_cov_64.531073	412	481	2	26	69	0.3768116
NODE_6911_length_984_cov_64.531073	412	481	4	25	69	0.3623188
NODE_6911_length_984_cov_64.531073	454	534	2	2	80	0.0250000
NODE_6911_length_984_cov_64.531073	454	534	4	78	80	0.9750000
NODE_6911_length_984_cov_64.531073	475	555	4	80	80	1.0000000
NODE_6911_length_984_cov_64.531073	528	608	0	15	80	0.1875000
NODE_6911_length_984_cov_64.531073	528	608	1	2	80	0.0250000
NODE_6911_length_984_cov_64.531073	528	608	3	23	80	0.2875000
NODE_6911_length_984_cov_64.531073	528	608	4	40	80	0.5000000
NODE_6911_length_984_cov_64.531073	549	629	0	36	80	0.4500000
NODE_6911_length_984_cov_64.531073	549	629	1	2	80	0.0250000
NODE_6911_length_984_cov_64.531073	549	629	3	23	80	0.2875000
NODE_6911_length_984_cov_64.531073	549	629	4	19	80	0.2375000
NODE_6912_length_984_cov_28.832768	430	510	3	35	80	0.4375000
NODE_6912_length_984_cov_28.832768	430	510	4	28	80	0.3500000
NODE_6912_length_984_cov_28.832768	430	510	5	17	80	0.2125000
NODE_6912_length_984_cov_28.832768	483	563	2	28	80	0.3500000
NODE_6912_length_984_cov_28.832768	483	563	3	30	80	0.3750000
NODE_6912_length_984_cov_28.832768	483	563	4	11	80	0.1375000
NODE_6912_length_984_cov_28.832768	483	563	5	11	80	0.1375000
NODE_6913_length_984_cov_27.247458	203	283	1	3	80	0.0375000
NODE_6913_length_984_cov_27.247458	203	283	2	34	80	0.4250000
NODE_6913_length_984_cov_27.247458	203	283	3	25	80	0.3125000
NODE_6913_length_984_cov_27.247458	203	283	4	18	80	0.2250000
NODE_6913_length_984_cov_27.247458	256	336	1	56	80	0.7000000
NODE_6913_length_984_cov_27.247458	256	336	2	24	80	0.3000000
NODE_6913_length_984_cov_27.247458	332	412	1	25	80	0.3125000
NODE_6913_length_984_cov_27.247458	332	412	2	12	80	0.1500000
NODE_6913_length_984_cov_27.247458	332	412	3	19	80	0.2375000
NODE_6913_length_984_cov_27.247458	332	412	4	24	80	0.3000000
NODE_6913_length_984_cov_27.247458	385	465	3	36	80	0.4500000
NODE_6913_length_984_cov_27.247458	385	465	4	44	80	0.5500000
NODE_6914_length_984_cov_25.944633	483	563	2	42	80	0.5250000
NODE_6914_length_984_cov_25.944633	483	563	4	38	80	0.4750000
NODE_6914_length_984_cov_25.944633	536	616	3	5	80	0.0625000
NODE_6914_length_984_cov_25.944633	536	616	4	75	80	0.9375000
NODE_6915_length_984_cov_16.611299	351	431	2	10	80	0.1250000
NODE_6915_length_984_cov_16.611299	351	431	3	5	80	0.0625000
NODE_6915_length_984_cov_16.611299	351	431	4	65	80	0.8125000
NODE_6915_length_984_cov_16.611299	404	484	2	35	80	0.4375000
NODE_6915_length_984_cov_16.611299	404	484	3	12	80	0.1500000
NODE_6915_length_984_cov_16.611299	404	484	4	33	80	0.4125000
NODE_6917_length_984_cov_6.414689	415	495	0	80	80	1.0000000
NODE_6917_length_984_cov_6.414689	468	548	0	80	80	1.0000000
NODE_6918_length_984_cov_4.720904	494	574	1	7	80	0.0875000
NODE_6918_length_984_cov_4.720904	494	574	2	73	80	0.9125000
NODE_6918_length_984_cov_4.720904	547	627	1	18	80	0.2250000
NODE_6918_length_984_cov_4.720904	547	627	2	62	80	0.7750000
NODE_6927_length_984_cov_1.333333	922	971	1	2	49	0.0408163
NODE_6927_length_984_cov_1.333333	922	971	2	47	49	0.9591837
NODE_6931_length_983_cov_34.566742	466	546	0	80	80	1.0000000
NODE_6931_length_983_cov_34.566742	519	599	0	80	80	1.0000000
NODE_6932_length_983_cov_26.011312	449	529	0	50	80	0.6250000
NODE_6932_length_983_cov_26.011312	449	529	1	10	80	0.1250000
NODE_6932_length_983_cov_26.011312	449	529	2	20	80	0.2500000
NODE_6932_length_983_cov_26.011312	502	582	0	80	80	1.0000000
NODE_6932_length_983_cov_26.011312	578	658	0	13	80	0.1625000
NODE_6932_length_983_cov_26.011312	578	658	1	19	80	0.2375000
NODE_6932_length_983_cov_26.011312	578	658	2	48	80	0.6000000
NODE_6932_length_983_cov_26.011312	631	711	2	80	80	1.0000000
NODE_6933_length_983_cov_24.694570	539	619	2	16	80	0.2000000
NODE_6933_length_983_cov_24.694570	539	619	3	48	80	0.6000000
NODE_6933_length_983_cov_24.694570	539	619	4	16	80	0.2000000
NODE_6933_length_983_cov_24.694570	592	672	3	11	80	0.1375000
NODE_6933_length_983_cov_24.694570	592	672	4	66	80	0.8250000
NODE_6933_length_983_cov_24.694570	592	672	5	3	80	0.0375000
NODE_6934_length_983_cov_22.214932	395	475	2	13	80	0.1625000
NODE_6934_length_983_cov_22.214932	395	475	3	37	80	0.4625000
NODE_6934_length_983_cov_22.214932	395	475	4	24	80	0.3000000
NODE_6934_length_983_cov_22.214932	395	475	5	6	80	0.0750000
NODE_6934_length_983_cov_22.214932	448	528	0	42	80	0.5250000
NODE_6934_length_983_cov_22.214932	448	528	1	10	80	0.1250000
NODE_6934_length_983_cov_22.214932	448	528	2	14	80	0.1750000
NODE_6934_length_983_cov_22.214932	448	528	3	14	80	0.1750000
NODE_6935_length_983_cov_19.132353	377	457	3	69	80	0.8625000
NODE_6935_length_983_cov_19.132353	377	457	4	1	80	0.0125000
NODE_6935_length_983_cov_19.132353	377	457	6	10	80	0.1250000
NODE_6935_length_983_cov_19.132353	430	510	3	16	80	0.2000000
NODE_6935_length_983_cov_19.132353	430	510	4	38	80	0.4750000
NODE_6935_length_983_cov_19.132353	430	510	5	4	80	0.0500000
NODE_6935_length_983_cov_19.132353	430	510	6	22	80	0.2750000
NODE_6936_length_983_cov_16.875566	419	499	1	13	80	0.1625000
NODE_6936_length_983_cov_16.875566	419	499	2	67	80	0.8375000
NODE_6936_length_983_cov_16.875566	472	552	1	8	80	0.1000000
NODE_6936_length_983_cov_16.875566	472	552	2	30	80	0.3750000
NODE_6936_length_983_cov_16.875566	472	552	3	11	80	0.1375000
NODE_6936_length_983_cov_16.875566	472	552	4	31	80	0.3875000
NODE_6936_length_983_cov_16.875566	548	628	3	63	80	0.7875000
NODE_6936_length_983_cov_16.875566	548	628	4	17	80	0.2125000
NODE_6936_length_983_cov_16.875566	601	681	0	10	80	0.1250000
NODE_6936_length_983_cov_16.875566	601	681	1	11	80	0.1375000
NODE_6936_length_983_cov_16.875566	601	681	2	30	80	0.3750000
NODE_6936_length_983_cov_16.875566	601	681	3	29	80	0.3625000
NODE_6937_length_983_cov_7.240950	487	567	0	80	80	1.0000000
NODE_6937_length_983_cov_7.240950	540	620	0	80	80	1.0000000
NODE_6949_length_982_cov_30.750849	357	437	0	46	80	0.5750000
NODE_6949_length_982_cov_30.750849	357	437	1	1	80	0.0125000
NODE_6949_length_982_cov_30.750849	357	437	2	31	80	0.3875000
NODE_6949_length_982_cov_30.750849	357	437	3	2	80	0.0250000
NODE_6949_length_982_cov_30.750849	410	490	2	25	80	0.3125000
NODE_6949_length_982_cov_30.750849	410	490	3	27	80	0.3375000
NODE_6949_length_982_cov_30.750849	410	490	4	28	80	0.3500000
NODE_6950_length_982_cov_29.901472	516	596	0	24	80	0.3000000
NODE_6950_length_982_cov_29.901472	516	596	2	56	80	0.7000000
NODE_6950_length_982_cov_29.901472	569	649	2	80	80	1.0000000
NODE_6951_length_982_cov_18.251416	356	436	4	4	80	0.0500000
NODE_6951_length_982_cov_18.251416	356	436	6	68	80	0.8500000
NODE_6951_length_982_cov_18.251416	356	436	7	6	80	0.0750000
NODE_6951_length_982_cov_18.251416	356	436	8	2	80	0.0250000
NODE_6951_length_982_cov_18.251416	409	489	4	55	80	0.6875000
NODE_6951_length_982_cov_18.251416	409	489	5	2	80	0.0250000
NODE_6951_length_982_cov_18.251416	409	489	6	15	80	0.1875000
NODE_6951_length_982_cov_18.251416	409	489	7	6	80	0.0750000
NODE_6951_length_982_cov_18.251416	409	489	8	2	80	0.0250000
NODE_6951_length_982_cov_18.251416	485	565	3	15	80	0.1875000
NODE_6951_length_982_cov_18.251416	485	565	4	65	80	0.8125000
NODE_6951_length_982_cov_18.251416	538	618	1	11	80	0.1375000
NODE_6951_length_982_cov_18.251416	538	618	2	38	80	0.4750000
NODE_6951_length_982_cov_18.251416	538	618	4	31	80	0.3875000
NODE_6952_length_982_cov_13.840317	608	688	1	5	80	0.0625000
NODE_6952_length_982_cov_13.840317	608	688	2	9	80	0.1125000
NODE_6952_length_982_cov_13.840317	608	688	3	66	80	0.8250000
NODE_6952_length_982_cov_13.840317	661	741	0	12	80	0.1500000
NODE_6952_length_982_cov_13.840317	661	741	2	50	80	0.6250000
NODE_6952_length_982_cov_13.840317	661	741	3	18	80	0.2250000
NODE_6953_length_982_cov_13.227633	317	397	0	52	80	0.6500000
NODE_6953_length_982_cov_13.227633	317	397	2	28	80	0.3500000
NODE_6953_length_982_cov_13.227633	370	450	0	80	80	1.0000000
NODE_6954_length_982_cov_10.918460	209	289	0	61	80	0.7625000
NODE_6954_length_982_cov_10.918460	209	289	2	19	80	0.2375000
NODE_6954_length_982_cov_10.918460	262	342	0	8	80	0.1000000
NODE_6954_length_982_cov_10.918460	262	342	2	72	80	0.9000000
NODE_6956_length_982_cov_7.210646	216	296	0	46	80	0.5750000
NODE_6956_length_982_cov_7.210646	216	296	1	1	80	0.0125000
NODE_6956_length_982_cov_7.210646	216	296	2	33	80	0.4125000
NODE_6956_length_982_cov_7.210646	269	349	2	80	80	1.0000000
NODE_6973_length_981_cov_55.260771	410	490	0	80	80	1.0000000
NODE_6973_length_981_cov_55.260771	463	543	0	80	80	1.0000000
NODE_6973_length_981_cov_55.260771	539	619	0	80	80	1.0000000
NODE_6973_length_981_cov_55.260771	592	672	0	80	80	1.0000000
NODE_6974_length_981_cov_33.287982	362	441	1	14	79	0.1772152
NODE_6974_length_981_cov_33.287982	362	441	2	48	79	0.6075949
NODE_6974_length_981_cov_33.287982	362	441	3	17	79	0.2151899
NODE_6974_length_981_cov_33.287982	414	495	1	55	81	0.6790124
NODE_6974_length_981_cov_33.287982	414	495	2	26	81	0.3209876
NODE_6974_length_981_cov_33.287982	491	571	1	22	80	0.2750000
NODE_6974_length_981_cov_33.287982	491	571	3	11	80	0.1375000
NODE_6974_length_981_cov_33.287982	491	571	4	4	80	0.0500000
NODE_6974_length_981_cov_33.287982	491	571	5	43	80	0.5375000
NODE_6974_length_981_cov_33.287982	544	624	3	15	80	0.1875000
NODE_6974_length_981_cov_33.287982	544	624	4	8	80	0.1000000
NODE_6974_length_981_cov_33.287982	544	624	5	57	80	0.7125000
NODE_6975_length_981_cov_33.121315	269	349	5	19	80	0.2375000
NODE_6975_length_981_cov_33.121315	269	349	6	17	80	0.2125000
NODE_6975_length_981_cov_33.121315	269	349	7	12	80	0.1500000
NODE_6975_length_981_cov_33.121315	269	349	8	32	80	0.4000000
NODE_6975_length_981_cov_33.121315	322	402	5	9	80	0.1125000
NODE_6975_length_981_cov_33.121315	322	402	6	33	80	0.4125000
NODE_6975_length_981_cov_33.121315	322	402	7	33	80	0.4125000
NODE_6975_length_981_cov_33.121315	322	402	11	5	80	0.0625000
NODE_6975_length_981_cov_33.121315	398	478	6	39	80	0.4875000
NODE_6975_length_981_cov_33.121315	398	478	7	32	80	0.4000000
NODE_6975_length_981_cov_33.121315	398	478	10	4	80	0.0500000
NODE_6975_length_981_cov_33.121315	398	478	11	5	80	0.0625000
NODE_6975_length_981_cov_33.121315	451	531	4	50	80	0.6250000
NODE_6975_length_981_cov_33.121315	451	531	6	30	80	0.3750000
NODE_6976_length_981_cov_26.732426	397	477	1	14	80	0.1750000
NODE_6976_length_981_cov_26.732426	397	477	2	66	80	0.8250000
NODE_6976_length_981_cov_26.732426	450	530	1	28	80	0.3500000
NODE_6976_length_981_cov_26.732426	450	530	2	52	80	0.6500000
NODE_6977_length_981_cov_24.304989	390	470	2	28	80	0.3500000
NODE_6977_length_981_cov_24.304989	390	470	3	17	80	0.2125000
NODE_6977_length_981_cov_24.304989	390	470	6	16	80	0.2000000
NODE_6977_length_981_cov_24.304989	390	470	7	19	80	0.2375000
NODE_6977_length_981_cov_24.304989	443	523	6	34	80	0.4250000
NODE_6977_length_981_cov_24.304989	443	523	7	46	80	0.5750000
NODE_6978_length_981_cov_10.485261	363	443	0	21	80	0.2625000
NODE_6978_length_981_cov_10.485261	363	443	2	59	80	0.7375000
NODE_6978_length_981_cov_10.485261	416	496	2	80	80	1.0000000
NODE_6980_length_981_cov_5.328798	821	885	2	64	64	1.0000000
NODE_6980_length_981_cov_5.328798	847	884	2	37	37	1.0000000
NODE_6998_length_980_cov_40.710556	329	409	1	80	80	1.0000000
NODE_6998_length_980_cov_40.710556	382	462	0	12	80	0.1500000
NODE_6998_length_980_cov_40.710556	382	462	1	68	80	0.8500000
NODE_6998_length_980_cov_40.710556	458	538	0	80	80	1.0000000
NODE_6998_length_980_cov_40.710556	511	591	0	80	80	1.0000000
NODE_6999_length_980_cov_37.634506	666	746	5	3	80	0.0375000
NODE_6999_length_980_cov_37.634506	666	746	7	6	80	0.0750000
NODE_6999_length_980_cov_37.634506	666	746	9	53	80	0.6625000
NODE_6999_length_980_cov_37.634506	666	746	11	18	80	0.2250000
NODE_6999_length_980_cov_37.634506	719	799	6	1	80	0.0125000
NODE_6999_length_980_cov_37.634506	719	799	7	8	80	0.1000000
NODE_6999_length_980_cov_37.634506	719	799	9	17	80	0.2125000
NODE_6999_length_980_cov_37.634506	719	799	10	11	80	0.1375000
NODE_6999_length_980_cov_37.634506	719	799	11	43	80	0.5375000
NODE_7000_length_980_cov_36.261067	331	411	5	8	80	0.1000000
NODE_7000_length_980_cov_36.261067	331	411	6	45	80	0.5625000
NODE_7000_length_980_cov_36.261067	331	411	7	27	80	0.3375000
NODE_7000_length_980_cov_36.261067	384	453	5	8	69	0.1159420
NODE_7000_length_980_cov_36.261067	384	453	6	45	69	0.6521739
NODE_7000_length_980_cov_36.261067	384	453	7	16	69	0.2318841
NODE_7000_length_980_cov_36.261067	465	545	5	6	80	0.0750000
NODE_7000_length_980_cov_36.261067	465	545	7	35	80	0.4375000
NODE_7000_length_980_cov_36.261067	465	545	8	36	80	0.4500000
NODE_7000_length_980_cov_36.261067	465	545	9	3	80	0.0375000
NODE_7000_length_980_cov_36.261067	518	598	6	12	80	0.1500000
NODE_7000_length_980_cov_36.261067	518	598	7	17	80	0.2125000
NODE_7000_length_980_cov_36.261067	518	598	8	32	80	0.4000000
NODE_7000_length_980_cov_36.261067	518	598	9	19	80	0.2375000
NODE_7001_length_980_cov_28.514188	430	510	0	19	80	0.2375000
NODE_7001_length_980_cov_28.514188	430	510	2	36	80	0.4500000
NODE_7001_length_980_cov_28.514188	430	510	3	25	80	0.3125000
NODE_7001_length_980_cov_28.514188	483	563	1	15	80	0.1875000
NODE_7001_length_980_cov_28.514188	483	563	2	2	80	0.0250000
NODE_7001_length_980_cov_28.514188	483	563	3	63	80	0.7875000
NODE_7002_length_980_cov_25.205448	497	577	2	33	80	0.4125000
NODE_7002_length_980_cov_25.205448	497	577	3	47	80	0.5875000
NODE_7002_length_980_cov_25.205448	550	630	2	49	80	0.6125000
NODE_7002_length_980_cov_25.205448	550	630	3	31	80	0.3875000
NODE_7003_length_980_cov_24.321226	417	497	5	45	80	0.5625000
NODE_7003_length_980_cov_24.321226	417	497	7	18	80	0.2250000
NODE_7003_length_980_cov_24.321226	417	497	9	17	80	0.2125000
NODE_7003_length_980_cov_24.321226	470	550	3	23	80	0.2875000
NODE_7003_length_980_cov_24.321226	470	550	5	1	80	0.0125000
NODE_7003_length_980_cov_24.321226	470	550	7	35	80	0.4375000
NODE_7003_length_980_cov_24.321226	470	550	8	6	80	0.0750000
NODE_7003_length_980_cov_24.321226	470	550	9	15	80	0.1875000
NODE_7004_length_980_cov_20.460840	388	468	1	25	80	0.3125000
NODE_7004_length_980_cov_20.460840	388	468	3	55	80	0.6875000
NODE_7004_length_980_cov_20.460840	441	521	3	71	80	0.8875000
NODE_7004_length_980_cov_20.460840	441	521	4	9	80	0.1125000
NODE_7005_length_980_cov_19.969353	486	566	3	59	80	0.7375000
NODE_7005_length_980_cov_19.969353	486	566	4	21	80	0.2625000
NODE_7005_length_980_cov_19.969353	539	619	1	3	80	0.0375000
NODE_7005_length_980_cov_19.969353	539	619	2	2	80	0.0250000
NODE_7005_length_980_cov_19.969353	539	619	3	7	80	0.0875000
NODE_7005_length_980_cov_19.969353	539	619	4	68	80	0.8500000
NODE_7006_length_980_cov_13.736663	350	430	2	3	80	0.0375000
NODE_7006_length_980_cov_13.736663	350	430	3	70	80	0.8750000
NODE_7006_length_980_cov_13.736663	350	430	4	7	80	0.0875000
NODE_7006_length_980_cov_13.736663	403	483	3	80	80	1.0000000
NODE_7006_length_980_cov_13.736663	479	559	0	45	80	0.5625000
NODE_7006_length_980_cov_13.736663	479	559	1	11	80	0.1375000
NODE_7006_length_980_cov_13.736663	479	559	2	15	80	0.1875000
NODE_7006_length_980_cov_13.736663	479	559	3	9	80	0.1125000
NODE_7006_length_980_cov_13.736663	532	612	0	80	80	1.0000000
NODE_7008_length_980_cov_10.842225	517	597	0	12	80	0.1500000
NODE_7008_length_980_cov_10.842225	517	597	1	50	80	0.6250000
NODE_7008_length_980_cov_10.842225	517	597	2	18	80	0.2250000
NODE_7008_length_980_cov_10.842225	570	650	1	9	80	0.1125000
NODE_7008_length_980_cov_10.842225	570	650	2	40	80	0.5000000
NODE_7008_length_980_cov_10.842225	570	650	3	31	80	0.3875000
NODE_7009_length_980_cov_10.087401	341	424	3	19	83	0.2289157
NODE_7009_length_980_cov_10.087401	341	424	4	33	83	0.3975904
NODE_7009_length_980_cov_10.087401	341	424	5	31	83	0.3734940
NODE_7009_length_980_cov_10.087401	397	477	0	33	80	0.4125000
NODE_7009_length_980_cov_10.087401	397	477	2	17	80	0.2125000
NODE_7009_length_980_cov_10.087401	397	477	3	22	80	0.2750000
NODE_7009_length_980_cov_10.087401	397	477	4	8	80	0.1000000
NODE_7010_length_980_cov_9.643587	267	347	0	15	80	0.1875000
NODE_7010_length_980_cov_9.643587	267	347	1	65	80	0.8125000
NODE_7010_length_980_cov_9.643587	320	400	1	33	80	0.4125000
NODE_7010_length_980_cov_9.643587	320	400	2	15	80	0.1875000
NODE_7010_length_980_cov_9.643587	320	400	4	32	80	0.4000000
NODE_7010_length_980_cov_9.643587	396	476	3	20	80	0.2500000
NODE_7010_length_980_cov_9.643587	396	476	4	14	80	0.1750000
NODE_7010_length_980_cov_9.643587	396	476	5	12	80	0.1500000
NODE_7010_length_980_cov_9.643587	396	476	6	34	80	0.4250000
NODE_7010_length_980_cov_9.643587	449	529	4	26	80	0.3250000
NODE_7010_length_980_cov_9.643587	449	529	5	38	80	0.4750000
NODE_7010_length_980_cov_9.643587	449	529	6	16	80	0.2000000
NODE_7026_length_979_cov_22.576136	442	522	0	80	80	1.0000000
NODE_7026_length_979_cov_22.576136	495	575	0	80	80	1.0000000
NODE_7027_length_979_cov_19.739773	445	524	3	79	79	1.0000000
NODE_7027_length_979_cov_19.739773	497	577	0	28	80	0.3500000
NODE_7027_length_979_cov_19.739773	497	577	1	3	80	0.0375000
NODE_7027_length_979_cov_19.739773	497	577	2	7	80	0.0875000
NODE_7027_length_979_cov_19.739773	497	577	3	42	80	0.5250000
NODE_7028_length_979_cov_19.480682	436	516	0	28	80	0.3500000
NODE_7028_length_979_cov_19.480682	436	516	2	52	80	0.6500000
NODE_7028_length_979_cov_19.480682	489	569	2	80	80	1.0000000
NODE_7028_length_979_cov_19.480682	565	645	0	44	80	0.5500000
NODE_7028_length_979_cov_19.480682	565	645	2	36	80	0.4500000
NODE_7028_length_979_cov_19.480682	618	698	0	80	80	1.0000000
NODE_7029_length_979_cov_18.901136	470	550	0	56	80	0.7000000
NODE_7029_length_979_cov_18.901136	470	550	2	20	80	0.2500000
NODE_7029_length_979_cov_18.901136	470	550	4	4	80	0.0500000
NODE_7029_length_979_cov_18.901136	523	603	0	3	80	0.0375000
NODE_7029_length_979_cov_18.901136	523	603	2	20	80	0.2500000
NODE_7029_length_979_cov_18.901136	523	603	4	57	80	0.7125000
NODE_7031_length_979_cov_3.519318	101	168	4	4	67	0.0597015
NODE_7031_length_979_cov_3.519318	101	168	6	2	67	0.0298507
NODE_7031_length_979_cov_3.519318	101	168	7	9	67	0.1343284
NODE_7031_length_979_cov_3.519318	101	168	9	8	67	0.1194030
NODE_7031_length_979_cov_3.519318	101	168	11	37	67	0.5522388
NODE_7031_length_979_cov_3.519318	101	168	13	7	67	0.1044776
NODE_7040_length_978_cov_23.195677	424	504	5	17	80	0.2125000
NODE_7040_length_978_cov_23.195677	424	504	6	14	80	0.1750000
NODE_7040_length_978_cov_23.195677	424	504	7	14	80	0.1750000
NODE_7040_length_978_cov_23.195677	424	504	8	24	80	0.3000000
NODE_7040_length_978_cov_23.195677	424	504	9	11	80	0.1375000
NODE_7040_length_978_cov_23.195677	477	557	5	25	80	0.3125000
NODE_7040_length_978_cov_23.195677	477	557	6	34	80	0.4250000
NODE_7040_length_978_cov_23.195677	477	557	7	10	80	0.1250000
NODE_7040_length_978_cov_23.195677	477	557	9	11	80	0.1375000
NODE_7041_length_978_cov_18.866894	440	520	1	6	80	0.0750000
NODE_7041_length_978_cov_18.866894	440	520	2	9	80	0.1125000
NODE_7041_length_978_cov_18.866894	440	520	3	65	80	0.8125000
NODE_7041_length_978_cov_18.866894	493	573	3	57	80	0.7125000
NODE_7041_length_978_cov_18.866894	493	573	4	23	80	0.2875000
NODE_7042_length_978_cov_15.614334	341	421	0	80	80	1.0000000
NODE_7042_length_978_cov_15.614334	394	474	0	80	80	1.0000000
NODE_7042_length_978_cov_15.614334	470	550	0	80	80	1.0000000
NODE_7042_length_978_cov_15.614334	523	603	0	80	80	1.0000000
NODE_7043_length_978_cov_15.253697	327	407	0	36	80	0.4500000
NODE_7043_length_978_cov_15.253697	327	407	2	44	80	0.5500000
NODE_7043_length_978_cov_15.253697	380	460	2	68	80	0.8500000
NODE_7043_length_978_cov_15.253697	380	460	3	12	80	0.1500000
NODE_7043_length_978_cov_15.253697	456	536	2	37	80	0.4625000
NODE_7043_length_978_cov_15.253697	456	536	3	4	80	0.0500000
NODE_7043_length_978_cov_15.253697	456	536	4	39	80	0.4875000
NODE_7043_length_978_cov_15.253697	509	589	2	75	80	0.9375000
NODE_7043_length_978_cov_15.253697	509	589	3	5	80	0.0625000
NODE_7044_length_978_cov_14.730375	407	487	0	80	80	1.0000000
NODE_7044_length_978_cov_14.730375	460	540	0	80	80	1.0000000
NODE_7045_length_978_cov_7.257110	571	651	0	18	80	0.2250000
NODE_7045_length_978_cov_7.257110	571	651	1	4	80	0.0500000
NODE_7045_length_978_cov_7.257110	571	651	2	58	80	0.7250000
NODE_7045_length_978_cov_7.257110	624	704	2	80	80	1.0000000
NODE_7062_length_977_cov_47.484055	427	507	0	80	80	1.0000000
NODE_7062_length_977_cov_47.484055	480	560	0	43	80	0.5375000
NODE_7062_length_977_cov_47.484055	480	560	1	15	80	0.1875000
NODE_7062_length_977_cov_47.484055	480	560	2	22	80	0.2750000
NODE_7063_length_977_cov_47.116173	428	508	0	6	80	0.0750000
NODE_7063_length_977_cov_47.116173	428	508	2	74	80	0.9250000
NODE_7063_length_977_cov_47.116173	481	561	0	59	80	0.7375000
NODE_7063_length_977_cov_47.116173	481	561	2	21	80	0.2625000
NODE_7063_length_977_cov_47.116173	557	637	0	80	80	1.0000000
NODE_7063_length_977_cov_47.116173	610	690	0	80	80	1.0000000
NODE_7064_length_977_cov_32.542141	486	566	8	1	80	0.0125000
NODE_7064_length_977_cov_32.542141	486	566	10	27	80	0.3375000
NODE_7064_length_977_cov_32.542141	486	566	11	37	80	0.4625000
NODE_7064_length_977_cov_32.542141	486	566	12	15	80	0.1875000
NODE_7064_length_977_cov_32.542141	539	619	5	12	80	0.1500000
NODE_7064_length_977_cov_32.542141	539	619	6	11	80	0.1375000
NODE_7064_length_977_cov_32.542141	539	619	7	15	80	0.1875000
NODE_7064_length_977_cov_32.542141	539	619	8	3	80	0.0375000
NODE_7064_length_977_cov_32.542141	539	619	10	16	80	0.2000000
NODE_7064_length_977_cov_32.542141	539	619	11	8	80	0.1000000
NODE_7064_length_977_cov_32.542141	539	619	12	15	80	0.1875000
NODE_7065_length_977_cov_30.676538	361	441	0	80	80	1.0000000
NODE_7065_length_977_cov_30.676538	414	494	0	80	80	1.0000000
NODE_7066_length_977_cov_28.348519	455	535	1	2	80	0.0250000
NODE_7066_length_977_cov_28.348519	455	535	2	18	80	0.2250000
NODE_7066_length_977_cov_28.348519	455	535	3	13	80	0.1625000
NODE_7066_length_977_cov_28.348519	455	535	4	47	80	0.5875000
NODE_7066_length_977_cov_28.348519	508	588	1	2	80	0.0250000
NODE_7066_length_977_cov_28.348519	508	588	2	18	80	0.2250000
NODE_7066_length_977_cov_28.348519	508	588	3	20	80	0.2500000
NODE_7066_length_977_cov_28.348519	508	588	4	20	80	0.2500000
NODE_7066_length_977_cov_28.348519	508	588	5	20	80	0.2500000
NODE_7067_length_977_cov_26.571754	343	423	7	2	80	0.0250000
NODE_7067_length_977_cov_26.571754	343	423	8	28	80	0.3500000
NODE_7067_length_977_cov_26.571754	343	423	9	10	80	0.1250000
NODE_7067_length_977_cov_26.571754	343	423	10	40	80	0.5000000
NODE_7067_length_977_cov_26.571754	396	476	4	6	80	0.0750000
NODE_7067_length_977_cov_26.571754	396	476	6	7	80	0.0875000
NODE_7067_length_977_cov_26.571754	396	476	7	2	80	0.0250000
NODE_7067_length_977_cov_26.571754	396	476	8	6	80	0.0750000
NODE_7067_length_977_cov_26.571754	396	476	9	42	80	0.5250000
NODE_7067_length_977_cov_26.571754	396	476	10	17	80	0.2125000
NODE_7067_length_977_cov_26.571754	472	552	1	16	80	0.2000000
NODE_7067_length_977_cov_26.571754	472	552	2	46	80	0.5750000
NODE_7067_length_977_cov_26.571754	472	552	3	6	80	0.0750000
NODE_7067_length_977_cov_26.571754	472	552	4	12	80	0.1500000
NODE_7067_length_977_cov_26.571754	525	600	1	8	75	0.1066667
NODE_7067_length_977_cov_26.571754	525	600	2	42	75	0.5600000
NODE_7067_length_977_cov_26.571754	525	600	3	25	75	0.3333333
NODE_7068_length_977_cov_24.898633	470	550	0	38	80	0.4750000
NODE_7068_length_977_cov_24.898633	470	550	1	42	80	0.5250000
NODE_7068_length_977_cov_24.898633	523	603	0	80	80	1.0000000
NODE_7069_length_977_cov_22.986333	313	393	1	16	80	0.2000000
NODE_7069_length_977_cov_22.986333	313	393	2	37	80	0.4625000
NODE_7069_length_977_cov_22.986333	313	393	5	17	80	0.2125000
NODE_7069_length_977_cov_22.986333	313	393	6	10	80	0.1250000
NODE_7069_length_977_cov_22.986333	366	446	4	9	80	0.1125000
NODE_7069_length_977_cov_22.986333	366	446	5	17	80	0.2125000
NODE_7069_length_977_cov_22.986333	366	446	6	54	80	0.6750000
NODE_7069_length_977_cov_22.986333	442	522	1	52	80	0.6500000
NODE_7069_length_977_cov_22.986333	442	522	2	5	80	0.0625000
NODE_7069_length_977_cov_22.986333	442	522	3	2	80	0.0250000
NODE_7069_length_977_cov_22.986333	442	522	4	21	80	0.2625000
NODE_7069_length_977_cov_22.986333	495	575	0	41	80	0.5125000
NODE_7069_length_977_cov_22.986333	495	575	1	39	80	0.4875000
NODE_7070_length_977_cov_10.753986	290	370	1	58	80	0.7250000
NODE_7070_length_977_cov_10.753986	290	370	2	22	80	0.2750000
NODE_7070_length_977_cov_10.753986	343	423	1	7	80	0.0875000
NODE_7070_length_977_cov_10.753986	343	423	2	73	80	0.9125000
NODE_7071_length_977_cov_9.924829	401	456	5	2	55	0.0363636
NODE_7071_length_977_cov_9.924829	401	456	6	53	55	0.9636363
NODE_7073_length_977_cov_6.391800	483	563	1	80	80	1.0000000
NODE_7073_length_977_cov_6.391800	536	616	1	78	80	0.9750000
NODE_7073_length_977_cov_6.391800	536	616	2	2	80	0.0250000
NODE_7075_length_977_cov_2.907745	191	241	4	23	50	0.4600000
NODE_7075_length_977_cov_2.907745	191	241	5	3	50	0.0600000
NODE_7075_length_977_cov_2.907745	191	241	6	24	50	0.4800000
NODE_7085_length_976_cov_38.192702	326	406	1	16	80	0.2000000
NODE_7085_length_976_cov_38.192702	326	406	2	4	80	0.0500000
NODE_7085_length_976_cov_38.192702	326	406	3	4	80	0.0500000
NODE_7085_length_976_cov_38.192702	326	406	4	21	80	0.2625000
NODE_7085_length_976_cov_38.192702	326	406	5	11	80	0.1375000
NODE_7085_length_976_cov_38.192702	326	406	6	24	80	0.3000000
NODE_7085_length_976_cov_38.192702	379	459	5	16	80	0.2000000
NODE_7085_length_976_cov_38.192702	379	459	6	64	80	0.8000000
NODE_7085_length_976_cov_38.192702	455	535	5	9	80	0.1125000
NODE_7085_length_976_cov_38.192702	455	535	6	9	80	0.1125000
NODE_7085_length_976_cov_38.192702	455	535	7	23	80	0.2875000
NODE_7085_length_976_cov_38.192702	455	535	8	19	80	0.2375000
NODE_7085_length_976_cov_38.192702	455	535	9	20	80	0.2500000
NODE_7085_length_976_cov_38.192702	455	536	5	9	81	0.1111111
NODE_7085_length_976_cov_38.192702	455	536	6	9	81	0.1111111
NODE_7085_length_976_cov_38.192702	455	536	7	24	81	0.2962963
NODE_7085_length_976_cov_38.192702	455	536	8	19	81	0.2345679
NODE_7085_length_976_cov_38.192702	455	536	9	20	81	0.2469136
NODE_7085_length_976_cov_38.192702	455	519	5	9	64	0.1406250
NODE_7085_length_976_cov_38.192702	455	519	6	9	64	0.1406250
NODE_7085_length_976_cov_38.192702	455	519	7	20	64	0.3125000
NODE_7085_length_976_cov_38.192702	455	519	8	8	64	0.1250000
NODE_7085_length_976_cov_38.192702	455	519	9	18	64	0.2812500
NODE_7085_length_976_cov_38.192702	508	588	7	26	80	0.3250000
NODE_7085_length_976_cov_38.192702	508	588	8	48	80	0.6000000
NODE_7085_length_976_cov_38.192702	508	588	9	6	80	0.0750000
NODE_7086_length_976_cov_26.275941	499	579	0	3	80	0.0375000
NODE_7086_length_976_cov_26.275941	499	579	2	77	80	0.9625000
NODE_7086_length_976_cov_26.275941	552	632	0	17	80	0.2125000
NODE_7086_length_976_cov_26.275941	552	632	2	63	80	0.7875000
NODE_7087_length_976_cov_25.559863	376	456	0	7	80	0.0875000
NODE_7087_length_976_cov_25.559863	376	456	1	73	80	0.9125000
NODE_7087_length_976_cov_25.559863	429	509	1	29	80	0.3625000
NODE_7087_length_976_cov_25.559863	429	509	2	42	80	0.5250000
NODE_7087_length_976_cov_25.559863	429	509	3	9	80	0.1125000
NODE_7088_length_976_cov_17.961231	572	652	2	4	80	0.0500000
NODE_7088_length_976_cov_17.961231	572	652	3	76	80	0.9500000
NODE_7088_length_976_cov_17.961231	625	705	2	53	80	0.6625000
NODE_7088_length_976_cov_17.961231	625	705	3	27	80	0.3375000
NODE_7089_length_976_cov_5.567845	789	851	0	38	62	0.6129032
NODE_7089_length_976_cov_5.567845	789	851	2	24	62	0.3870968
NODE_7089_length_976_cov_5.567845	842	904	2	62	62	1.0000000
NODE_7101_length_975_cov_192.211187	722	802	682	1	80	0.0125000
NODE_7101_length_975_cov_192.211187	722	802	683	1	80	0.0125000
NODE_7101_length_975_cov_192.211187	722	802	684	1	80	0.0125000
NODE_7101_length_975_cov_192.211187	722	802	686	2	80	0.0250000
NODE_7101_length_975_cov_192.211187	722	802	687	2	80	0.0250000
NODE_7101_length_975_cov_192.211187	722	802	688	1	80	0.0125000
NODE_7101_length_975_cov_192.211187	722	802	694	1	80	0.0125000
NODE_7101_length_975_cov_192.211187	722	802	696	1	80	0.0125000
NODE_7101_length_975_cov_192.211187	722	802	699	3	80	0.0375000
NODE_7101_length_975_cov_192.211187	722	802	700	1	80	0.0125000
NODE_7101_length_975_cov_192.211187	722	802	701	1	80	0.0125000
NODE_7101_length_975_cov_192.211187	722	802	702	1	80	0.0125000
NODE_7101_length_975_cov_192.211187	722	802	703	1	80	0.0125000
NODE_7101_length_975_cov_192.211187	722	802	704	2	80	0.0250000
NODE_7101_length_975_cov_192.211187	722	802	705	2	80	0.0250000
NODE_7101_length_975_cov_192.211187	722	802	709	1	80	0.0125000
NODE_7101_length_975_cov_192.211187	722	802	710	1	80	0.0125000
NODE_7101_length_975_cov_192.211187	722	802	712	1	80	0.0125000
NODE_7101_length_975_cov_192.211187	722	802	713	1	80	0.0125000
NODE_7101_length_975_cov_192.211187	722	802	718	1	80	0.0125000
NODE_7101_length_975_cov_192.211187	722	802	720	3	80	0.0375000
NODE_7101_length_975_cov_192.211187	722	802	721	2	80	0.0250000
NODE_7101_length_975_cov_192.211187	722	802	724	2	80	0.0250000
NODE_7101_length_975_cov_192.211187	722	802	725	3	80	0.0375000
NODE_7101_length_975_cov_192.211187	722	802	726	2	80	0.0250000
NODE_7101_length_975_cov_192.211187	722	802	727	3	80	0.0375000
NODE_7101_length_975_cov_192.211187	722	802	729	4	80	0.0500000
NODE_7101_length_975_cov_192.211187	722	802	730	3	80	0.0375000
NODE_7101_length_975_cov_192.211187	722	802	731	3	80	0.0375000
NODE_7101_length_975_cov_192.211187	722	802	732	1	80	0.0125000
NODE_7101_length_975_cov_192.211187	722	802	733	3	80	0.0375000
NODE_7101_length_975_cov_192.211187	722	802	734	4	80	0.0500000
NODE_7101_length_975_cov_192.211187	722	802	735	2	80	0.0250000
NODE_7101_length_975_cov_192.211187	722	802	736	2	80	0.0250000
NODE_7101_length_975_cov_192.211187	722	802	738	2	80	0.0250000
NODE_7101_length_975_cov_192.211187	722	802	739	2	80	0.0250000
NODE_7101_length_975_cov_192.211187	722	802	740	1	80	0.0125000
NODE_7101_length_975_cov_192.211187	722	802	742	1	80	0.0125000
NODE_7101_length_975_cov_192.211187	722	802	744	1	80	0.0125000
NODE_7101_length_975_cov_192.211187	722	802	745	2	80	0.0250000
NODE_7101_length_975_cov_192.211187	722	802	746	3	80	0.0375000
NODE_7101_length_975_cov_192.211187	722	802	747	2	80	0.0250000
NODE_7101_length_975_cov_192.211187	722	802	749	1	80	0.0125000
NODE_7101_length_975_cov_192.211187	722	802	753	1	80	0.0125000
NODE_7101_length_975_cov_192.211187	722	802	754	1	80	0.0125000
NODE_7102_length_975_cov_41.446347	414	494	2	1	80	0.0125000
NODE_7102_length_975_cov_41.446347	414	494	3	34	80	0.4250000
NODE_7102_length_975_cov_41.446347	414	494	4	14	80	0.1750000
NODE_7102_length_975_cov_41.446347	414	494	6	23	80	0.2875000
NODE_7102_length_975_cov_41.446347	414	494	7	8	80	0.1000000
NODE_7102_length_975_cov_41.446347	467	547	5	5	80	0.0625000
NODE_7102_length_975_cov_41.446347	467	547	6	19	80	0.2375000
NODE_7102_length_975_cov_41.446347	467	547	7	56	80	0.7000000
NODE_7103_length_975_cov_37.618721	375	455	0	80	80	1.0000000
NODE_7103_length_975_cov_37.618721	428	508	0	80	80	1.0000000
NODE_7104_length_975_cov_34.265982	424	504	1	7	80	0.0875000
NODE_7104_length_975_cov_34.265982	424	504	3	2	80	0.0250000
NODE_7104_length_975_cov_34.265982	424	504	4	14	80	0.1750000
NODE_7104_length_975_cov_34.265982	424	504	5	17	80	0.2125000
NODE_7104_length_975_cov_34.265982	424	504	7	7	80	0.0875000
NODE_7104_length_975_cov_34.265982	424	504	9	33	80	0.4125000
NODE_7104_length_975_cov_34.265982	477	557	4	1	80	0.0125000
NODE_7104_length_975_cov_34.265982	477	557	6	16	80	0.2000000
NODE_7104_length_975_cov_34.265982	477	557	8	28	80	0.3500000
NODE_7104_length_975_cov_34.265982	477	557	9	35	80	0.4375000
NODE_7105_length_975_cov_31.888128	461	541	3	24	80	0.3000000
NODE_7105_length_975_cov_31.888128	461	541	4	28	80	0.3500000
NODE_7105_length_975_cov_31.888128	461	541	5	28	80	0.3500000
NODE_7105_length_975_cov_31.888128	514	594	2	4	80	0.0500000
NODE_7105_length_975_cov_31.888128	514	594	3	5	80	0.0625000
NODE_7105_length_975_cov_31.888128	514	594	4	4	80	0.0500000
NODE_7105_length_975_cov_31.888128	514	594	5	67	80	0.8375000
NODE_7106_length_975_cov_22.093607	392	472	5	16	80	0.2000000
NODE_7106_length_975_cov_22.093607	392	472	6	15	80	0.1875000
NODE_7106_length_975_cov_22.093607	392	472	7	49	80	0.6125000
NODE_7106_length_975_cov_22.093607	445	525	3	6	80	0.0750000
NODE_7106_length_975_cov_22.093607	445	525	5	11	80	0.1375000
NODE_7106_length_975_cov_22.093607	445	525	7	63	80	0.7875000
NODE_7107_length_975_cov_15.091324	403	483	4	5	80	0.0625000
NODE_7107_length_975_cov_15.091324	403	483	5	75	80	0.9375000
NODE_7107_length_975_cov_15.091324	456	536	2	18	80	0.2250000
NODE_7107_length_975_cov_15.091324	456	536	3	6	80	0.0750000
NODE_7107_length_975_cov_15.091324	456	536	4	5	80	0.0625000
NODE_7107_length_975_cov_15.091324	456	536	5	51	80	0.6375000
NODE_7108_length_975_cov_15.046804	63	143	2	19	80	0.2375000
NODE_7108_length_975_cov_15.046804	63	143	3	35	80	0.4375000
NODE_7108_length_975_cov_15.046804	63	143	4	26	80	0.3250000
NODE_7108_length_975_cov_15.046804	116	196	2	19	80	0.2375000
NODE_7108_length_975_cov_15.046804	116	196	3	1	80	0.0125000
NODE_7108_length_975_cov_15.046804	116	196	4	60	80	0.7500000
NODE_7109_length_975_cov_12.043379	535	615	2	27	80	0.3375000
NODE_7109_length_975_cov_12.043379	535	615	3	1	80	0.0125000
NODE_7109_length_975_cov_12.043379	535	615	4	52	80	0.6500000
NODE_7109_length_975_cov_12.043379	588	668	2	6	80	0.0750000
NODE_7109_length_975_cov_12.043379	588	668	3	20	80	0.2500000
NODE_7109_length_975_cov_12.043379	588	668	4	54	80	0.6750000
NODE_7110_length_975_cov_11.772831	276	354	0	46	78	0.5897436
NODE_7110_length_975_cov_11.772831	276	354	1	32	78	0.4102564
NODE_7110_length_975_cov_11.772831	327	407	1	80	80	1.0000000
NODE_7111_length_975_cov_10.599315	405	485	1	13	80	0.1625000
NODE_7111_length_975_cov_10.599315	405	485	2	66	80	0.8250000
NODE_7111_length_975_cov_10.599315	405	485	3	1	80	0.0125000
NODE_7111_length_975_cov_10.599315	458	538	2	26	80	0.3250000
NODE_7111_length_975_cov_10.599315	458	538	3	54	80	0.6750000
NODE_7112_length_975_cov_8.089041	430	510	0	7	80	0.0875000
NODE_7112_length_975_cov_8.089041	430	510	1	26	80	0.3250000
NODE_7112_length_975_cov_8.089041	430	510	2	47	80	0.5875000
NODE_7112_length_975_cov_8.089041	483	563	0	7	80	0.0875000
NODE_7112_length_975_cov_8.089041	483	563	1	25	80	0.3125000
NODE_7112_length_975_cov_8.089041	483	563	2	48	80	0.6000000
NODE_7114_length_975_cov_3.728311	254	334	1	2	80	0.0250000
NODE_7114_length_975_cov_3.728311	254	334	2	78	80	0.9750000
NODE_7114_length_975_cov_3.728311	307	387	0	4	80	0.0500000
NODE_7114_length_975_cov_3.728311	307	387	1	51	80	0.6375000
NODE_7114_length_975_cov_3.728311	307	387	2	25	80	0.3125000
NODE_7125_length_974_cov_293.334857	564	642	95	2	78	0.0256410
NODE_7125_length_974_cov_293.334857	564	642	96	4	78	0.0512821
NODE_7125_length_974_cov_293.334857	564	642	97	3	78	0.0384615
NODE_7125_length_974_cov_293.334857	564	642	98	4	78	0.0512821
NODE_7125_length_974_cov_293.334857	564	642	99	2	78	0.0256410
NODE_7125_length_974_cov_293.334857	564	642	101	1	78	0.0128205
NODE_7125_length_974_cov_293.334857	564	642	102	2	78	0.0256410
NODE_7125_length_974_cov_293.334857	564	642	103	5	78	0.0641026
NODE_7125_length_974_cov_293.334857	564	642	104	5	78	0.0641026
NODE_7125_length_974_cov_293.334857	564	642	105	9	78	0.1153846
NODE_7125_length_974_cov_293.334857	564	642	106	8	78	0.1025641
NODE_7125_length_974_cov_293.334857	564	642	107	9	78	0.1153846
NODE_7125_length_974_cov_293.334857	564	642	108	5	78	0.0641026
NODE_7125_length_974_cov_293.334857	564	642	109	1	78	0.0128205
NODE_7125_length_974_cov_293.334857	564	642	111	1	78	0.0128205
NODE_7125_length_974_cov_293.334857	564	642	118	2	78	0.0256410
NODE_7125_length_974_cov_293.334857	564	642	121	1	78	0.0128205
NODE_7125_length_974_cov_293.334857	564	642	123	1	78	0.0128205
NODE_7125_length_974_cov_293.334857	564	642	127	1	78	0.0128205
NODE_7125_length_974_cov_293.334857	564	642	129	1	78	0.0128205
NODE_7125_length_974_cov_293.334857	564	642	134	1	78	0.0128205
NODE_7125_length_974_cov_293.334857	564	642	135	2	78	0.0256410
NODE_7125_length_974_cov_293.334857	564	642	136	1	78	0.0128205
NODE_7125_length_974_cov_293.334857	564	642	137	1	78	0.0128205
NODE_7125_length_974_cov_293.334857	564	642	141	1	78	0.0128205
NODE_7125_length_974_cov_293.334857	564	642	149	1	78	0.0128205
NODE_7125_length_974_cov_293.334857	564	642	150	2	78	0.0256410
NODE_7125_length_974_cov_293.334857	564	642	151	2	78	0.0256410
NODE_7125_length_974_cov_293.334857	564	642	95	2	78	0.0256410
NODE_7125_length_974_cov_293.334857	564	642	96	4	78	0.0512821
NODE_7125_length_974_cov_293.334857	564	642	97	3	78	0.0384615
NODE_7125_length_974_cov_293.334857	564	642	98	4	78	0.0512821
NODE_7125_length_974_cov_293.334857	564	642	99	2	78	0.0256410
NODE_7125_length_974_cov_293.334857	564	642	101	1	78	0.0128205
NODE_7125_length_974_cov_293.334857	564	642	102	2	78	0.0256410
NODE_7125_length_974_cov_293.334857	564	642	103	5	78	0.0641026
NODE_7125_length_974_cov_293.334857	564	642	104	5	78	0.0641026
NODE_7125_length_974_cov_293.334857	564	642	105	9	78	0.1153846
NODE_7125_length_974_cov_293.334857	564	642	106	8	78	0.1025641
NODE_7125_length_974_cov_293.334857	564	642	107	9	78	0.1153846
NODE_7125_length_974_cov_293.334857	564	642	108	5	78	0.0641026
NODE_7125_length_974_cov_293.334857	564	642	109	1	78	0.0128205
NODE_7125_length_974_cov_293.334857	564	642	111	1	78	0.0128205
NODE_7125_length_974_cov_293.334857	564	642	118	2	78	0.0256410
NODE_7125_length_974_cov_293.334857	564	642	121	1	78	0.0128205
NODE_7125_length_974_cov_293.334857	564	642	123	1	78	0.0128205
NODE_7125_length_974_cov_293.334857	564	642	127	1	78	0.0128205
NODE_7125_length_974_cov_293.334857	564	642	129	1	78	0.0128205
NODE_7125_length_974_cov_293.334857	564	642	134	1	78	0.0128205
NODE_7125_length_974_cov_293.334857	564	642	135	2	78	0.0256410
NODE_7125_length_974_cov_293.334857	564	642	136	1	78	0.0128205
NODE_7125_length_974_cov_293.334857	564	642	137	1	78	0.0128205
NODE_7125_length_974_cov_293.334857	564	642	141	1	78	0.0128205
NODE_7125_length_974_cov_293.334857	564	642	149	1	78	0.0128205
NODE_7125_length_974_cov_293.334857	564	642	150	2	78	0.0256410
NODE_7125_length_974_cov_293.334857	564	642	151	2	78	0.0256410
NODE_7125_length_974_cov_293.334857	564	633	95	2	69	0.0289855
NODE_7125_length_974_cov_293.334857	564	633	96	4	69	0.0579710
NODE_7125_length_974_cov_293.334857	564	633	97	3	69	0.0434783
NODE_7125_length_974_cov_293.334857	564	633	98	4	69	0.0579710
NODE_7125_length_974_cov_293.334857	564	633	99	2	69	0.0289855
NODE_7125_length_974_cov_293.334857	564	633	101	1	69	0.0144928
NODE_7125_length_974_cov_293.334857	564	633	103	3	69	0.0434783
NODE_7125_length_974_cov_293.334857	564	633	104	2	69	0.0289855
NODE_7125_length_974_cov_293.334857	564	633	105	8	69	0.1159420
NODE_7125_length_974_cov_293.334857	564	633	106	7	69	0.1014493
NODE_7125_length_974_cov_293.334857	564	633	107	9	69	0.1304348
NODE_7125_length_974_cov_293.334857	564	633	108	5	69	0.0724638
NODE_7125_length_974_cov_293.334857	564	633	109	1	69	0.0144928
NODE_7125_length_974_cov_293.334857	564	633	111	1	69	0.0144928
NODE_7125_length_974_cov_293.334857	564	633	118	2	69	0.0289855
NODE_7125_length_974_cov_293.334857	564	633	121	1	69	0.0144928
NODE_7125_length_974_cov_293.334857	564	633	123	1	69	0.0144928
NODE_7125_length_974_cov_293.334857	564	633	127	1	69	0.0144928
NODE_7125_length_974_cov_293.334857	564	633	129	1	69	0.0144928
NODE_7125_length_974_cov_293.334857	564	633	134	1	69	0.0144928
NODE_7125_length_974_cov_293.334857	564	633	135	2	69	0.0289855
NODE_7125_length_974_cov_293.334857	564	633	136	1	69	0.0144928
NODE_7125_length_974_cov_293.334857	564	633	137	1	69	0.0144928
NODE_7125_length_974_cov_293.334857	564	633	141	1	69	0.0144928
NODE_7125_length_974_cov_293.334857	564	633	149	1	69	0.0144928
NODE_7125_length_974_cov_293.334857	564	633	150	2	69	0.0289855
NODE_7125_length_974_cov_293.334857	564	633	151	2	69	0.0289855
NODE_7126_length_974_cov_49.884571	459	539	4	19	80	0.2375000
NODE_7126_length_974_cov_49.884571	459	539	5	26	80	0.3250000
NODE_7126_length_974_cov_49.884571	459	539	6	35	80	0.4375000
NODE_7126_length_974_cov_49.884571	512	592	1	19	80	0.2375000
NODE_7126_length_974_cov_49.884571	512	592	2	19	80	0.2375000
NODE_7126_length_974_cov_49.884571	512	592	4	34	80	0.4250000
NODE_7126_length_974_cov_49.884571	512	592	5	8	80	0.1000000
NODE_7127_length_974_cov_38.384000	430	508	2	24	78	0.3076923
NODE_7127_length_974_cov_38.384000	430	508	3	44	78	0.5641026
NODE_7127_length_974_cov_38.384000	430	508	5	10	78	0.1282051
NODE_7127_length_974_cov_38.384000	483	561	2	14	78	0.1794872
NODE_7127_length_974_cov_38.384000	483	561	3	1	78	0.0128205
NODE_7127_length_974_cov_38.384000	483	561	4	31	78	0.3974359
NODE_7127_length_974_cov_38.384000	483	561	5	32	78	0.4102564
NODE_7128_length_974_cov_26.008000	391	471	0	80	80	1.0000000
NODE_7128_length_974_cov_26.008000	444	524	0	61	80	0.7625000
NODE_7128_length_974_cov_26.008000	444	524	1	19	80	0.2375000
NODE_7128_length_974_cov_26.008000	520	600	1	45	80	0.5625000
NODE_7128_length_974_cov_26.008000	520	600	2	35	80	0.4375000
NODE_7128_length_974_cov_26.008000	573	653	2	80	80	1.0000000
NODE_7129_length_974_cov_21.160000	460	540	2	80	80	1.0000000
NODE_7129_length_974_cov_21.160000	513	593	0	16	80	0.2000000
NODE_7129_length_974_cov_21.160000	513	593	2	64	80	0.8000000
NODE_7131_length_974_cov_11.384000	290	370	7	34	80	0.4250000
NODE_7131_length_974_cov_11.384000	290	370	9	20	80	0.2500000
NODE_7131_length_974_cov_11.384000	290	370	11	26	80	0.3250000
NODE_7131_length_974_cov_11.384000	343	423	7	48	80	0.6000000
NODE_7131_length_974_cov_11.384000	343	423	8	28	80	0.3500000
NODE_7131_length_974_cov_11.384000	343	423	11	4	80	0.0500000
NODE_7132_length_974_cov_11.216000	543	623	1	69	80	0.8625000
NODE_7132_length_974_cov_11.216000	543	623	2	11	80	0.1375000
NODE_7132_length_974_cov_11.216000	596	668	1	59	72	0.8194444
NODE_7132_length_974_cov_11.216000	596	668	2	13	72	0.1805556
NODE_7133_length_974_cov_9.601143	436	516	2	29	80	0.3625000
NODE_7133_length_974_cov_9.601143	436	516	3	42	80	0.5250000
NODE_7133_length_974_cov_9.601143	436	516	4	9	80	0.1125000
NODE_7133_length_974_cov_9.601143	489	569	2	67	80	0.8375000
NODE_7133_length_974_cov_9.601143	489	569	3	13	80	0.1625000
NODE_7134_length_974_cov_7.436571	382	462	0	17	80	0.2125000
NODE_7134_length_974_cov_7.436571	382	462	1	63	80	0.7875000
NODE_7134_length_974_cov_7.436571	436	515	1	40	79	0.5063291
NODE_7134_length_974_cov_7.436571	436	515	2	39	79	0.4936709
NODE_7147_length_973_cov_46.012586	349	429	6	80	80	1.0000000
NODE_7147_length_973_cov_46.012586	402	482	0	24	80	0.3000000
NODE_7147_length_973_cov_46.012586	402	482	2	20	80	0.2500000
NODE_7147_length_973_cov_46.012586	402	482	6	36	80	0.4500000
NODE_7147_length_973_cov_46.012586	478	558	0	6	80	0.0750000
NODE_7147_length_973_cov_46.012586	478	558	2	7	80	0.0875000
NODE_7147_length_973_cov_46.012586	478	558	3	2	80	0.0250000
NODE_7147_length_973_cov_46.012586	478	558	4	65	80	0.8125000
NODE_7147_length_973_cov_46.012586	531	611	2	13	80	0.1625000
NODE_7147_length_973_cov_46.012586	531	611	4	67	80	0.8375000
NODE_7148_length_973_cov_40.305492	364	444	2	7	80	0.0875000
NODE_7148_length_973_cov_40.305492	364	444	3	17	80	0.2125000
NODE_7148_length_973_cov_40.305492	364	444	4	22	80	0.2750000
NODE_7148_length_973_cov_40.305492	364	444	5	6	80	0.0750000
NODE_7148_length_973_cov_40.305492	364	444	6	28	80	0.3500000
NODE_7148_length_973_cov_40.305492	417	497	5	36	80	0.4500000
NODE_7148_length_973_cov_40.305492	417	497	6	44	80	0.5500000
NODE_7149_length_973_cov_24.105263	460	540	2	32	80	0.4000000
NODE_7149_length_973_cov_24.105263	460	540	3	3	80	0.0375000
NODE_7149_length_973_cov_24.105263	460	540	4	35	80	0.4375000
NODE_7149_length_973_cov_24.105263	460	540	5	10	80	0.1250000
NODE_7149_length_973_cov_24.105263	513	593	4	74	80	0.9250000
NODE_7149_length_973_cov_24.105263	513	593	5	6	80	0.0750000
NODE_7150_length_973_cov_22.106407	342	422	1	80	80	1.0000000
NODE_7150_length_973_cov_22.106407	395	475	1	51	80	0.6375000
NODE_7150_length_973_cov_22.106407	395	475	2	8	80	0.1000000
NODE_7150_length_973_cov_22.106407	395	475	3	21	80	0.2625000
NODE_7150_length_973_cov_22.106407	471	550	2	79	79	1.0000000
NODE_7150_length_973_cov_22.106407	526	604	0	6	78	0.0769231
NODE_7150_length_973_cov_22.106407	526	604	1	2	78	0.0256410
NODE_7150_length_973_cov_22.106407	526	604	2	70	78	0.8974359
NODE_7151_length_973_cov_10.994279	430	510	0	80	80	1.0000000
NODE_7151_length_973_cov_10.994279	483	563	0	80	80	1.0000000
NODE_7151_length_973_cov_10.994279	559	635	0	76	76	1.0000000
NODE_7151_length_973_cov_10.994279	608	688	0	80	80	1.0000000
NODE_7153_length_973_cov_2.973684	734	814	0	78	80	0.9750000
NODE_7153_length_973_cov_2.973684	734	814	1	2	80	0.0250000
NODE_7153_length_973_cov_2.973684	820	890	0	3	70	0.0428571
NODE_7153_length_973_cov_2.973684	820	890	1	11	70	0.1571429
NODE_7153_length_973_cov_2.973684	820	890	3	56	70	0.8000000
NODE_7153_length_973_cov_2.973684	863	944	3	81	81	1.0000000
NODE_7166_length_972_cov_32.547537	299	379	0	23	80	0.2875000
NODE_7166_length_972_cov_32.547537	299	379	1	31	80	0.3875000
NODE_7166_length_972_cov_32.547537	299	379	2	26	80	0.3250000
NODE_7166_length_972_cov_32.547537	352	432	1	1	80	0.0125000
NODE_7166_length_972_cov_32.547537	352	432	2	61	80	0.7625000
NODE_7166_length_972_cov_32.547537	352	432	3	12	80	0.1500000
NODE_7166_length_972_cov_32.547537	352	432	4	1	80	0.0125000
NODE_7166_length_972_cov_32.547537	352	432	5	5	80	0.0625000
NODE_7166_length_972_cov_32.547537	428	508	3	5	80	0.0625000
NODE_7166_length_972_cov_32.547537	428	508	4	31	80	0.3875000
NODE_7166_length_972_cov_32.547537	428	508	5	44	80	0.5500000
NODE_7166_length_972_cov_32.547537	481	561	2	30	80	0.3750000
NODE_7166_length_972_cov_32.547537	481	561	3	14	80	0.1750000
NODE_7166_length_972_cov_32.547537	481	561	4	36	80	0.4500000
NODE_7167_length_972_cov_31.010309	474	554	0	47	80	0.5875000
NODE_7167_length_972_cov_31.010309	474	554	2	33	80	0.4125000
NODE_7167_length_972_cov_31.010309	527	607	2	70	80	0.8750000
NODE_7167_length_972_cov_31.010309	527	607	3	10	80	0.1250000
NODE_7168_length_972_cov_29.810997	481	561	6	19	80	0.2375000
NODE_7168_length_972_cov_29.810997	481	561	7	45	80	0.5625000
NODE_7168_length_972_cov_29.810997	481	561	8	16	80	0.2000000
NODE_7168_length_972_cov_29.810997	534	614	7	48	80	0.6000000
NODE_7168_length_972_cov_29.810997	534	614	8	32	80	0.4000000
NODE_7169_length_972_cov_23.438717	442	522	1	80	80	1.0000000
NODE_7169_length_972_cov_23.438717	495	575	1	80	80	1.0000000
NODE_7170_length_972_cov_18.886598	453	533	0	80	80	1.0000000
NODE_7170_length_972_cov_18.886598	506	585	0	79	79	1.0000000
NODE_7171_length_972_cov_15.100802	329	409	0	80	80	1.0000000
NODE_7171_length_972_cov_15.100802	382	462	0	80	80	1.0000000
NODE_7172_length_972_cov_12.674685	444	524	0	80	80	1.0000000
NODE_7172_length_972_cov_12.674685	497	577	0	80	80	1.0000000
NODE_7173_length_972_cov_11.235968	504	584	1	29	80	0.3625000
NODE_7173_length_972_cov_11.235968	504	584	2	51	80	0.6375000
NODE_7173_length_972_cov_11.235968	557	637	1	20	80	0.2500000
NODE_7173_length_972_cov_11.235968	557	637	2	60	80	0.7500000
NODE_7174_length_972_cov_10.983963	402	482	2	2	80	0.0250000
NODE_7174_length_972_cov_10.983963	402	482	3	33	80	0.4125000
NODE_7174_length_972_cov_10.983963	402	482	4	45	80	0.5625000
NODE_7174_length_972_cov_10.983963	455	535	2	25	80	0.3125000
NODE_7174_length_972_cov_10.983963	455	535	3	29	80	0.3625000
NODE_7174_length_972_cov_10.983963	455	535	4	26	80	0.3250000
NODE_7175_length_972_cov_8.887743	302	382	0	53	80	0.6625000
NODE_7175_length_972_cov_8.887743	302	382	2	27	80	0.3375000
NODE_7175_length_972_cov_8.887743	355	430	0	75	75	1.0000000
NODE_7176_length_972_cov_8.265750	488	568	0	67	80	0.8375000
NODE_7176_length_972_cov_8.265750	488	568	1	13	80	0.1625000
NODE_7176_length_972_cov_8.265750	541	621	0	80	80	1.0000000
NODE_7182_length_972_cov_2.714777	165	241	1	12	76	0.1578947
NODE_7182_length_972_cov_2.714777	165	241	2	22	76	0.2894737
NODE_7182_length_972_cov_2.714777	165	241	3	7	76	0.0921053
NODE_7182_length_972_cov_2.714777	165	241	5	18	76	0.2368421
NODE_7182_length_972_cov_2.714777	165	241	6	17	76	0.2236842
NODE_7195_length_971_cov_52.575688	398	478	3	9	80	0.1125000
NODE_7195_length_971_cov_52.575688	398	478	5	2	80	0.0250000
NODE_7195_length_971_cov_52.575688	398	478	6	42	80	0.5250000
NODE_7195_length_971_cov_52.575688	398	478	7	27	80	0.3375000
NODE_7195_length_971_cov_52.575688	451	531	4	29	80	0.3625000
NODE_7195_length_971_cov_52.575688	451	531	5	5	80	0.0625000
NODE_7195_length_971_cov_52.575688	451	531	6	46	80	0.5750000
NODE_7195_length_971_cov_52.575688	527	607	1	21	80	0.2625000
NODE_7195_length_971_cov_52.575688	527	607	2	10	80	0.1250000
NODE_7195_length_971_cov_52.575688	527	607	3	26	80	0.3250000
NODE_7195_length_971_cov_52.575688	527	607	4	7	80	0.0875000
NODE_7195_length_971_cov_52.575688	527	607	5	16	80	0.2000000
NODE_7195_length_971_cov_52.575688	580	660	1	4	80	0.0500000
NODE_7195_length_971_cov_52.575688	580	660	2	6	80	0.0750000
NODE_7195_length_971_cov_52.575688	580	660	3	10	80	0.1250000
NODE_7195_length_971_cov_52.575688	580	660	4	60	80	0.7500000
NODE_7196_length_971_cov_44.464450	280	360	1	51	80	0.6375000
NODE_7196_length_971_cov_44.464450	280	360	2	26	80	0.3250000
NODE_7196_length_971_cov_44.464450	280	360	3	3	80	0.0375000
NODE_7196_length_971_cov_44.464450	333	413	2	25	80	0.3125000
NODE_7196_length_971_cov_44.464450	333	413	3	3	80	0.0375000
NODE_7196_length_971_cov_44.464450	333	413	4	14	80	0.1750000
NODE_7196_length_971_cov_44.464450	333	413	5	11	80	0.1375000
NODE_7196_length_971_cov_44.464450	333	413	6	9	80	0.1125000
NODE_7196_length_971_cov_44.464450	333	413	7	6	80	0.0750000
NODE_7196_length_971_cov_44.464450	333	413	8	5	80	0.0625000
NODE_7196_length_971_cov_44.464450	333	413	10	7	80	0.0875000
NODE_7196_length_971_cov_44.464450	409	489	10	15	80	0.1875000
NODE_7196_length_971_cov_44.464450	409	489	11	12	80	0.1500000
NODE_7196_length_971_cov_44.464450	409	489	12	5	80	0.0625000
NODE_7196_length_971_cov_44.464450	409	489	14	19	80	0.2375000
NODE_7196_length_971_cov_44.464450	409	489	15	18	80	0.2250000
NODE_7196_length_971_cov_44.464450	409	489	16	11	80	0.1375000
NODE_7196_length_971_cov_44.464450	462	542	10	11	80	0.1375000
NODE_7196_length_971_cov_44.464450	462	542	11	1	80	0.0125000
NODE_7196_length_971_cov_44.464450	462	542	13	7	80	0.0875000
NODE_7196_length_971_cov_44.464450	462	542	14	1	80	0.0125000
NODE_7196_length_971_cov_44.464450	462	542	15	40	80	0.5000000
NODE_7196_length_971_cov_44.464450	462	542	16	20	80	0.2500000
NODE_7197_length_971_cov_32.721330	509	589	1	3	80	0.0375000
NODE_7197_length_971_cov_32.721330	509	589	2	77	80	0.9625000
NODE_7197_length_971_cov_32.721330	562	642	0	9	80	0.1125000
NODE_7197_length_971_cov_32.721330	562	642	1	47	80	0.5875000
NODE_7197_length_971_cov_32.721330	562	642	2	24	80	0.3000000
NODE_7198_length_971_cov_30.264908	474	554	3	37	80	0.4625000
NODE_7198_length_971_cov_30.264908	474	554	4	17	80	0.2125000
NODE_7198_length_971_cov_30.264908	474	554	5	26	80	0.3250000
NODE_7198_length_971_cov_30.264908	527	607	4	31	80	0.3875000
NODE_7198_length_971_cov_30.264908	527	607	5	38	80	0.4750000
NODE_7198_length_971_cov_30.264908	527	607	6	11	80	0.1375000
NODE_7199_length_971_cov_26.631881	434	514	0	80	80	1.0000000
NODE_7199_length_971_cov_26.631881	487	567	0	66	80	0.8250000
NODE_7199_length_971_cov_26.631881	487	567	1	14	80	0.1750000
NODE_7200_length_971_cov_25.635321	404	484	0	80	80	1.0000000
NODE_7200_length_971_cov_25.635321	457	537	0	80	80	1.0000000
NODE_7201_length_971_cov_23.334862	363	443	3	26	80	0.3250000
NODE_7201_length_971_cov_23.334862	363	443	4	27	80	0.3375000
NODE_7201_length_971_cov_23.334862	363	443	5	27	80	0.3375000
NODE_7201_length_971_cov_23.334862	416	497	2	45	81	0.5555556
NODE_7201_length_971_cov_23.334862	416	497	4	17	81	0.2098765
NODE_7201_length_971_cov_23.334862	416	497	5	19	81	0.2345679
NODE_7202_length_971_cov_18.254587	468	548	2	80	80	1.0000000
NODE_7202_length_971_cov_18.254587	521	601	0	16	80	0.2000000
NODE_7202_length_971_cov_18.254587	521	601	2	64	80	0.8000000
NODE_7203_length_971_cov_18.229358	392	472	3	34	80	0.4250000
NODE_7203_length_971_cov_18.229358	392	472	4	13	80	0.1625000
NODE_7203_length_971_cov_18.229358	392	472	5	28	80	0.3500000
NODE_7203_length_971_cov_18.229358	392	472	6	5	80	0.0625000
NODE_7203_length_971_cov_18.229358	445	525	3	37	80	0.4625000
NODE_7203_length_971_cov_18.229358	445	525	5	37	80	0.4625000
NODE_7203_length_971_cov_18.229358	445	525	6	6	80	0.0750000
NODE_7204_length_971_cov_16.591743	481	561	0	80	80	1.0000000
NODE_7204_length_971_cov_16.591743	534	614	0	80	80	1.0000000
NODE_7205_length_971_cov_15.563073	463	543	2	65	80	0.8125000
NODE_7205_length_971_cov_15.563073	463	543	3	15	80	0.1875000
NODE_7205_length_971_cov_15.563073	516	596	2	28	80	0.3500000
NODE_7205_length_971_cov_15.563073	516	596	3	52	80	0.6500000
NODE_7206_length_971_cov_12.141055	415	495	0	80	80	1.0000000
NODE_7206_length_971_cov_12.141055	468	548	0	80	80	1.0000000
NODE_7222_length_970_cov_34.928817	438	518	3	54	80	0.6750000
NODE_7222_length_970_cov_34.928817	438	518	4	1	80	0.0125000
NODE_7222_length_970_cov_34.928817	438	518	5	25	80	0.3125000
NODE_7222_length_970_cov_34.928817	491	571	3	44	80	0.5500000
NODE_7222_length_970_cov_34.928817	491	571	4	18	80	0.2250000
NODE_7222_length_970_cov_34.928817	491	571	5	18	80	0.2250000
NODE_7223_length_970_cov_34.445465	540	620	4	55	80	0.6875000
NODE_7223_length_970_cov_34.445465	540	620	5	8	80	0.1000000
NODE_7223_length_970_cov_34.445465	540	620	7	17	80	0.2125000
NODE_7223_length_970_cov_34.445465	593	673	0	25	80	0.3125000
NODE_7223_length_970_cov_34.445465	593	673	1	5	80	0.0625000
NODE_7223_length_970_cov_34.445465	593	673	2	22	80	0.2750000
NODE_7223_length_970_cov_34.445465	593	673	4	28	80	0.3500000
NODE_7224_length_970_cov_34.257176	352	432	2	28	80	0.3500000
NODE_7224_length_970_cov_34.257176	352	432	3	52	80	0.6500000
NODE_7224_length_970_cov_34.257176	405	485	2	30	80	0.3750000
NODE_7224_length_970_cov_34.257176	405	485	3	50	80	0.6250000
NODE_7225_length_970_cov_26.904707	297	372	8	9	75	0.1200000
NODE_7225_length_970_cov_26.904707	297	372	9	10	75	0.1333333
NODE_7225_length_970_cov_26.904707	297	372	10	23	75	0.3066667
NODE_7225_length_970_cov_26.904707	297	372	11	5	75	0.0666667
NODE_7225_length_970_cov_26.904707	297	372	12	28	75	0.3733333
NODE_7225_length_970_cov_26.904707	303	376	8	3	73	0.0410959
NODE_7225_length_970_cov_26.904707	303	376	9	10	73	0.1369863
NODE_7225_length_970_cov_26.904707	303	376	10	23	73	0.3150685
NODE_7225_length_970_cov_26.904707	303	376	11	5	73	0.0684932
NODE_7225_length_970_cov_26.904707	303	376	12	28	73	0.3835616
NODE_7225_length_970_cov_26.904707	303	376	13	4	73	0.0547945
NODE_7225_length_970_cov_26.904707	311	377	9	9	66	0.1363636
NODE_7225_length_970_cov_26.904707	311	377	10	19	66	0.2878788
NODE_7225_length_970_cov_26.904707	311	377	11	5	66	0.0757576
NODE_7225_length_970_cov_26.904707	311	377	12	28	66	0.4242424
NODE_7225_length_970_cov_26.904707	311	377	13	5	66	0.0757576
NODE_7225_length_970_cov_26.904707	350	429	9	6	79	0.0759494
NODE_7225_length_970_cov_26.904707	350	429	10	5	79	0.0632911
NODE_7225_length_970_cov_26.904707	350	429	11	2	79	0.0253165
NODE_7225_length_970_cov_26.904707	350	429	12	22	79	0.2784810
NODE_7225_length_970_cov_26.904707	350	429	13	25	79	0.3164557
NODE_7225_length_970_cov_26.904707	350	429	14	5	79	0.0632911
NODE_7225_length_970_cov_26.904707	350	429	15	13	79	0.1645570
NODE_7225_length_970_cov_26.904707	350	429	16	1	79	0.0126582
NODE_7225_length_970_cov_26.904707	350	429	9	6	79	0.0759494
NODE_7225_length_970_cov_26.904707	350	429	10	5	79	0.0632911
NODE_7225_length_970_cov_26.904707	350	429	11	2	79	0.0253165
NODE_7225_length_970_cov_26.904707	350	429	12	22	79	0.2784810
NODE_7225_length_970_cov_26.904707	350	429	13	25	79	0.3164557
NODE_7225_length_970_cov_26.904707	350	429	14	5	79	0.0632911
NODE_7225_length_970_cov_26.904707	350	429	15	13	79	0.1645570
NODE_7225_length_970_cov_26.904707	350	429	16	1	79	0.0126582
NODE_7225_length_970_cov_26.904707	350	429	9	6	79	0.0759494
NODE_7225_length_970_cov_26.904707	350	429	10	5	79	0.0632911
NODE_7225_length_970_cov_26.904707	350	429	11	2	79	0.0253165
NODE_7225_length_970_cov_26.904707	350	429	12	22	79	0.2784810
NODE_7225_length_970_cov_26.904707	350	429	13	25	79	0.3164557
NODE_7225_length_970_cov_26.904707	350	429	14	5	79	0.0632911
NODE_7225_length_970_cov_26.904707	350	429	15	13	79	0.1645570
NODE_7225_length_970_cov_26.904707	350	429	16	1	79	0.0126582
NODE_7226_length_970_cov_26.040184	266	346	1	40	80	0.5000000
NODE_7226_length_970_cov_26.040184	266	346	2	39	80	0.4875000
NODE_7226_length_970_cov_26.040184	266	346	3	1	80	0.0125000
NODE_7226_length_970_cov_26.040184	319	399	2	48	80	0.6000000
NODE_7226_length_970_cov_26.040184	319	399	3	15	80	0.1875000
NODE_7226_length_970_cov_26.040184	319	399	4	17	80	0.2125000
NODE_7226_length_970_cov_26.040184	395	475	4	8	80	0.1000000
NODE_7226_length_970_cov_26.040184	395	475	5	24	80	0.3000000
NODE_7226_length_970_cov_26.040184	395	475	6	9	80	0.1125000
NODE_7226_length_970_cov_26.040184	395	475	7	39	80	0.4875000
NODE_7226_length_970_cov_26.040184	448	528	5	51	80	0.6375000
NODE_7226_length_970_cov_26.040184	448	528	6	26	80	0.3250000
NODE_7226_length_970_cov_26.040184	448	528	7	3	80	0.0375000
NODE_7227_length_970_cov_19.291619	415	495	0	80	80	1.0000000
NODE_7227_length_970_cov_19.291619	468	548	0	80	80	1.0000000
NODE_7228_length_970_cov_17.731343	557	637	0	23	80	0.2875000
NODE_7228_length_970_cov_17.731343	557	637	1	5	80	0.0625000
NODE_7228_length_970_cov_17.731343	557	637	2	52	80	0.6500000
NODE_7228_length_970_cov_17.731343	610	690	0	10	80	0.1250000
NODE_7228_length_970_cov_17.731343	610	690	2	70	80	0.8750000
NODE_7229_length_970_cov_15.135476	407	487	0	80	80	1.0000000
NODE_7229_length_970_cov_15.135476	460	540	0	80	80	1.0000000
NODE_7230_length_970_cov_12.675086	534	614	2	80	80	1.0000000
NODE_7230_length_970_cov_12.675086	587	667	1	15	80	0.1875000
NODE_7230_length_970_cov_12.675086	587	667	2	65	80	0.8125000
NODE_7231_length_970_cov_8.095293	487	567	0	80	80	1.0000000
NODE_7231_length_970_cov_8.095293	540	620	0	80	80	1.0000000
NODE_7233_length_970_cov_7.127440	336	416	0	80	80	1.0000000
NODE_7233_length_970_cov_7.127440	389	469	0	80	80	1.0000000
NODE_7234_length_970_cov_5.824340	0	56	0	56	56	1.0000000
NODE_7246_length_969_cov_47.172414	419	499	3	24	80	0.3000000
NODE_7246_length_969_cov_47.172414	419	499	4	32	80	0.4000000
NODE_7246_length_969_cov_47.172414	419	499	5	6	80	0.0750000
NODE_7246_length_969_cov_47.172414	419	499	6	18	80	0.2250000
NODE_7246_length_969_cov_47.172414	472	552	4	9	80	0.1125000
NODE_7246_length_969_cov_47.172414	472	552	6	44	80	0.5500000
NODE_7246_length_969_cov_47.172414	472	552	7	13	80	0.1625000
NODE_7246_length_969_cov_47.172414	472	552	8	14	80	0.1750000
NODE_7247_length_969_cov_28.234483	327	407	3	43	80	0.5375000
NODE_7247_length_969_cov_28.234483	327	407	4	37	80	0.4625000
NODE_7247_length_969_cov_28.234483	380	460	2	22	80	0.2750000
NODE_7247_length_969_cov_28.234483	380	460	3	58	80	0.7250000
NODE_7248_length_969_cov_27.131034	392	472	0	21	80	0.2625000
NODE_7248_length_969_cov_27.131034	392	472	2	16	80	0.2000000
NODE_7248_length_969_cov_27.131034	392	472	3	37	80	0.4625000
NODE_7248_length_969_cov_27.131034	392	472	4	6	80	0.0750000
NODE_7248_length_969_cov_27.131034	445	525	3	21	80	0.2625000
NODE_7248_length_969_cov_27.131034	445	525	4	59	80	0.7375000
NODE_7249_length_969_cov_26.345977	466	542	0	11	76	0.1447368
NODE_7249_length_969_cov_26.345977	466	542	1	65	76	0.8552632
NODE_7249_length_969_cov_26.345977	515	595	0	15	80	0.1875000
NODE_7249_length_969_cov_26.345977	515	595	1	65	80	0.8125000
NODE_7250_length_969_cov_18.954023	274	354	2	80	80	1.0000000
NODE_7250_length_969_cov_18.954023	327	407	1	29	80	0.3625000
NODE_7250_length_969_cov_18.954023	327	407	2	51	80	0.6375000
NODE_7251_length_969_cov_17.952874	410	490	2	73	80	0.9125000
NODE_7251_length_969_cov_17.952874	410	490	3	7	80	0.0875000
NODE_7251_length_969_cov_17.952874	463	543	1	47	80	0.5875000
NODE_7251_length_969_cov_17.952874	463	543	2	20	80	0.2500000
NODE_7251_length_969_cov_17.952874	463	543	3	13	80	0.1625000
NODE_7251_length_969_cov_17.952874	693	773	2	4	80	0.0500000
NODE_7251_length_969_cov_17.952874	693	773	3	2	80	0.0250000
NODE_7251_length_969_cov_17.952874	693	773	4	74	80	0.9250000
NODE_7251_length_969_cov_17.952874	746	826	3	26	80	0.3250000
NODE_7251_length_969_cov_17.952874	746	826	4	43	80	0.5375000
NODE_7251_length_969_cov_17.952874	746	826	5	11	80	0.1375000
NODE_7252_length_969_cov_15.942529	446	526	1	20	80	0.2500000
NODE_7252_length_969_cov_15.942529	446	526	2	24	80	0.3000000
NODE_7252_length_969_cov_15.942529	446	526	3	36	80	0.4500000
NODE_7252_length_969_cov_15.942529	499	579	1	32	80	0.4000000
NODE_7252_length_969_cov_15.942529	499	579	2	41	80	0.5125000
NODE_7252_length_969_cov_15.942529	499	579	3	7	80	0.0875000
NODE_7253_length_969_cov_9.926437	573	653	0	2	80	0.0250000
NODE_7253_length_969_cov_9.926437	573	653	2	14	80	0.1750000
NODE_7253_length_969_cov_9.926437	573	653	3	64	80	0.8000000
NODE_7253_length_969_cov_9.926437	626	706	0	6	80	0.0750000
NODE_7253_length_969_cov_9.926437	626	706	1	49	80	0.6125000
NODE_7253_length_969_cov_9.926437	626	706	2	14	80	0.1750000
NODE_7253_length_969_cov_9.926437	626	706	3	11	80	0.1375000
NODE_7265_length_968_cov_59.162255	376	456	3	62	80	0.7750000
NODE_7265_length_968_cov_59.162255	376	456	4	18	80	0.2250000
NODE_7265_length_968_cov_59.162255	429	509	1	7	80	0.0875000
NODE_7265_length_968_cov_59.162255	429	509	2	42	80	0.5250000
NODE_7265_length_968_cov_59.162255	429	509	3	9	80	0.1125000
NODE_7265_length_968_cov_59.162255	429	509	4	22	80	0.2750000
NODE_7265_length_968_cov_59.162255	505	585	1	80	80	1.0000000
NODE_7265_length_968_cov_59.162255	558	638	1	28	80	0.3500000
NODE_7265_length_968_cov_59.162255	558	638	2	34	80	0.4250000
NODE_7265_length_968_cov_59.162255	558	638	3	18	80	0.2250000
NODE_7266_length_968_cov_40.005754	514	594	2	1	80	0.0125000
NODE_7266_length_968_cov_40.005754	514	594	3	22	80	0.2750000
NODE_7266_length_968_cov_40.005754	514	594	4	57	80	0.7125000
NODE_7266_length_968_cov_40.005754	567	647	1	37	80	0.4625000
NODE_7266_length_968_cov_40.005754	567	647	2	17	80	0.2125000
NODE_7266_length_968_cov_40.005754	567	647	3	16	80	0.2000000
NODE_7266_length_968_cov_40.005754	567	647	4	10	80	0.1250000
NODE_7267_length_968_cov_36.521289	450	530	1	9	80	0.1125000
NODE_7267_length_968_cov_36.521289	450	530	2	42	80	0.5250000
NODE_7267_length_968_cov_36.521289	450	530	3	29	80	0.3625000
NODE_7267_length_968_cov_36.521289	503	583	1	62	80	0.7750000
NODE_7267_length_968_cov_36.521289	503	583	2	18	80	0.2250000
NODE_7268_length_968_cov_34.799770	474	554	3	63	80	0.7875000
NODE_7268_length_968_cov_34.799770	474	554	4	17	80	0.2125000
NODE_7268_length_968_cov_34.799770	527	607	3	49	80	0.6125000
NODE_7268_length_968_cov_34.799770	527	607	4	31	80	0.3875000
NODE_7269_length_968_cov_26.929804	293	372	0	9	79	0.1139240
NODE_7269_length_968_cov_26.929804	293	372	2	70	79	0.8860760
NODE_7269_length_968_cov_26.929804	345	425	0	12	80	0.1500000
NODE_7269_length_968_cov_26.929804	345	425	2	68	80	0.8500000
NODE_7269_length_968_cov_26.929804	421	501	0	25	80	0.3125000
NODE_7269_length_968_cov_26.929804	421	501	2	55	80	0.6875000
NODE_7269_length_968_cov_26.929804	474	554	0	10	80	0.1250000
NODE_7269_length_968_cov_26.929804	474	554	2	70	80	0.8750000
NODE_7270_length_968_cov_24.468354	434	514	2	24	80	0.3000000
NODE_7270_length_968_cov_24.468354	434	514	4	27	80	0.3375000
NODE_7270_length_968_cov_24.468354	434	514	6	29	80	0.3625000
NODE_7270_length_968_cov_24.468354	487	567	1	51	80	0.6375000
NODE_7270_length_968_cov_24.468354	487	567	2	26	80	0.3250000
NODE_7270_length_968_cov_24.468354	487	567	4	3	80	0.0375000
NODE_7271_length_968_cov_23.204833	344	424	2	42	80	0.5250000
NODE_7271_length_968_cov_23.204833	344	424	3	38	80	0.4750000
NODE_7271_length_968_cov_23.204833	397	477	2	11	80	0.1375000
NODE_7271_length_968_cov_23.204833	397	477	3	69	80	0.8625000
NODE_7271_length_968_cov_23.204833	473	553	1	36	80	0.4500000
NODE_7271_length_968_cov_23.204833	473	553	2	44	80	0.5500000
NODE_7271_length_968_cov_23.204833	526	606	1	70	80	0.8750000
NODE_7271_length_968_cov_23.204833	526	606	2	10	80	0.1250000
NODE_7272_length_968_cov_22.321059	417	497	2	24	80	0.3000000
NODE_7272_length_968_cov_22.321059	417	497	4	56	80	0.7000000
NODE_7272_length_968_cov_22.321059	470	550	2	2	80	0.0250000
NODE_7272_length_968_cov_22.321059	470	550	3	2	80	0.0250000
NODE_7272_length_968_cov_22.321059	470	550	4	76	80	0.9500000
NODE_7273_length_968_cov_20.897583	313	393	2	80	80	1.0000000
NODE_7273_length_968_cov_20.897583	366	446	0	46	80	0.5750000
NODE_7273_length_968_cov_20.897583	366	446	2	34	80	0.4250000
NODE_7274_length_968_cov_19.296893	401	481	1	29	80	0.3625000
NODE_7274_length_968_cov_19.296893	401	481	3	51	80	0.6375000
NODE_7274_length_968_cov_19.296893	454	534	2	22	80	0.2750000
NODE_7274_length_968_cov_19.296893	454	534	3	58	80	0.7250000
NODE_7275_length_968_cov_18.100115	573	653	2	4	80	0.0500000
NODE_7275_length_968_cov_18.100115	573	653	3	11	80	0.1375000
NODE_7275_length_968_cov_18.100115	573	653	4	65	80	0.8125000
NODE_7275_length_968_cov_18.100115	626	706	2	57	80	0.7125000
NODE_7275_length_968_cov_18.100115	626	706	4	23	80	0.2875000
NODE_7276_length_968_cov_15.576525	472	552	3	1	80	0.0125000
NODE_7276_length_968_cov_15.576525	472	552	4	12	80	0.1500000
NODE_7276_length_968_cov_15.576525	472	552	5	63	80	0.7875000
NODE_7276_length_968_cov_15.576525	472	552	6	4	80	0.0500000
NODE_7276_length_968_cov_15.576525	525	605	4	11	80	0.1375000
NODE_7276_length_968_cov_15.576525	525	605	5	12	80	0.1500000
NODE_7276_length_968_cov_15.576525	525	605	6	57	80	0.7125000
NODE_7277_length_968_cov_15.024166	329	409	1	51	80	0.6375000
NODE_7277_length_968_cov_15.024166	329	409	2	29	80	0.3625000
NODE_7277_length_968_cov_15.024166	382	462	1	28	80	0.3500000
NODE_7277_length_968_cov_15.024166	382	462	2	39	80	0.4875000
NODE_7277_length_968_cov_15.024166	382	462	3	13	80	0.1625000
NODE_7277_length_968_cov_15.024166	458	538	2	21	80	0.2625000
NODE_7277_length_968_cov_15.024166	458	538	3	59	80	0.7375000
NODE_7277_length_968_cov_15.024166	511	591	1	17	80	0.2125000
NODE_7277_length_968_cov_15.024166	511	591	2	57	80	0.7125000
NODE_7277_length_968_cov_15.024166	511	591	3	6	80	0.0750000
NODE_7278_length_968_cov_13.911392	674	754	0	80	80	1.0000000
NODE_7278_length_968_cov_13.911392	727	807	0	80	80	1.0000000
NODE_7279_length_968_cov_11.698504	598	678	1	18	80	0.2250000
NODE_7279_length_968_cov_11.698504	598	678	2	9	80	0.1125000
NODE_7279_length_968_cov_11.698504	598	678	3	30	80	0.3750000
NODE_7279_length_968_cov_11.698504	598	678	4	6	80	0.0750000
NODE_7279_length_968_cov_11.698504	598	678	5	17	80	0.2125000
NODE_7279_length_968_cov_11.698504	651	731	3	10	80	0.1250000
NODE_7279_length_968_cov_11.698504	651	731	5	70	80	0.8750000
NODE_7280_length_968_cov_6.490219	538	618	3	26	80	0.3250000
NODE_7280_length_968_cov_6.490219	538	618	4	16	80	0.2000000
NODE_7280_length_968_cov_6.490219	538	618	5	38	80	0.4750000
NODE_7280_length_968_cov_6.490219	591	671	2	13	80	0.1625000
NODE_7280_length_968_cov_6.490219	591	671	3	66	80	0.8250000
NODE_7280_length_968_cov_6.490219	591	671	4	1	80	0.0125000
NODE_7294_length_967_cov_25.572581	332	412	1	23	80	0.2875000
NODE_7294_length_967_cov_25.572581	332	412	2	25	80	0.3125000
NODE_7294_length_967_cov_25.572581	332	412	3	32	80	0.4000000
NODE_7294_length_967_cov_25.572581	385	465	2	5	80	0.0625000
NODE_7294_length_967_cov_25.572581	385	465	3	75	80	0.9375000
NODE_7295_length_967_cov_24.919355	396	476	0	80	80	1.0000000
NODE_7295_length_967_cov_24.919355	449	529	0	80	80	1.0000000
NODE_7296_length_967_cov_19.137097	374	454	0	28	80	0.3500000
NODE_7296_length_967_cov_19.137097	374	454	1	39	80	0.4875000
NODE_7296_length_967_cov_19.137097	374	454	2	9	80	0.1125000
NODE_7296_length_967_cov_19.137097	374	454	3	4	80	0.0500000
NODE_7296_length_967_cov_19.137097	427	507	1	14	80	0.1750000
NODE_7296_length_967_cov_19.137097	427	507	2	9	80	0.1125000
NODE_7296_length_967_cov_19.137097	427	507	3	34	80	0.4250000
NODE_7296_length_967_cov_19.137097	427	507	4	23	80	0.2875000
NODE_7296_length_967_cov_19.137097	503	583	4	45	80	0.5625000
NODE_7296_length_967_cov_19.137097	503	583	5	35	80	0.4375000
NODE_7296_length_967_cov_19.137097	556	636	1	2	80	0.0250000
NODE_7296_length_967_cov_19.137097	556	636	2	34	80	0.4250000
NODE_7296_length_967_cov_19.137097	556	636	3	9	80	0.1125000
NODE_7296_length_967_cov_19.137097	556	636	4	35	80	0.4375000
NODE_7297_length_967_cov_14.654378	453	533	1	52	80	0.6500000
NODE_7297_length_967_cov_14.654378	453	533	2	28	80	0.3500000
NODE_7297_length_967_cov_14.654378	506	586	2	47	80	0.5875000
NODE_7297_length_967_cov_14.654378	506	586	3	33	80	0.4125000
NODE_7298_length_967_cov_8.027650	280	360	0	5	80	0.0625000
NODE_7298_length_967_cov_8.027650	280	360	1	32	80	0.4000000
NODE_7298_length_967_cov_8.027650	280	360	2	22	80	0.2750000
NODE_7298_length_967_cov_8.027650	280	360	4	21	80	0.2625000
NODE_7298_length_967_cov_8.027650	333	413	2	6	80	0.0750000
NODE_7298_length_967_cov_8.027650	333	413	4	74	80	0.9250000
NODE_7310_length_966_cov_43.154556	401	474	5	19	73	0.2602740
NODE_7310_length_966_cov_43.154556	401	474	6	21	73	0.2876712
NODE_7310_length_966_cov_43.154556	401	474	8	16	73	0.2191781
NODE_7310_length_966_cov_43.154556	401	474	9	17	73	0.2328767
NODE_7310_length_966_cov_43.154556	447	527	8	25	80	0.3125000
NODE_7310_length_966_cov_43.154556	447	527	9	24	80	0.3000000
NODE_7310_length_966_cov_43.154556	447	527	10	31	80	0.3875000
NODE_7311_length_966_cov_42.877739	477	557	3	7	80	0.0875000
NODE_7311_length_966_cov_42.877739	477	557	4	35	80	0.4375000
NODE_7311_length_966_cov_42.877739	477	557	5	8	80	0.1000000
NODE_7311_length_966_cov_42.877739	477	557	6	16	80	0.2000000
NODE_7311_length_966_cov_42.877739	477	557	7	11	80	0.1375000
NODE_7311_length_966_cov_42.877739	477	557	8	3	80	0.0375000
NODE_7311_length_966_cov_42.877739	530	610	1	6	80	0.0750000
NODE_7311_length_966_cov_42.877739	530	610	3	7	80	0.0875000
NODE_7311_length_966_cov_42.877739	530	610	4	67	80	0.8375000
NODE_7312_length_966_cov_39.956171	283	363	0	34	80	0.4250000
NODE_7312_length_966_cov_39.956171	283	363	2	15	80	0.1875000
NODE_7312_length_966_cov_39.956171	283	363	3	2	80	0.0250000
NODE_7312_length_966_cov_39.956171	283	363	4	29	80	0.3625000
NODE_7312_length_966_cov_39.956171	336	416	3	2	80	0.0250000
NODE_7312_length_966_cov_39.956171	336	416	4	40	80	0.5000000
NODE_7312_length_966_cov_39.956171	336	416	5	38	80	0.4750000
NODE_7312_length_966_cov_39.956171	412	494	4	10	82	0.1219512
NODE_7312_length_966_cov_39.956171	412	494	5	59	82	0.7195122
NODE_7312_length_966_cov_39.956171	412	494	6	13	82	0.1585366
NODE_7312_length_966_cov_39.956171	467	547	3	21	80	0.2625000
NODE_7312_length_966_cov_39.956171	467	547	4	42	80	0.5250000
NODE_7312_length_966_cov_39.956171	467	547	5	4	80	0.0500000
NODE_7312_length_966_cov_39.956171	467	547	6	13	80	0.1625000
NODE_7313_length_966_cov_36.160323	461	541	9	17	80	0.2125000
NODE_7313_length_966_cov_36.160323	461	541	11	13	80	0.1625000
NODE_7313_length_966_cov_36.160323	461	541	13	36	80	0.4500000
NODE_7313_length_966_cov_36.160323	461	541	14	14	80	0.1750000
NODE_7313_length_966_cov_36.160323	461	541	9	17	80	0.2125000
NODE_7313_length_966_cov_36.160323	461	541	11	13	80	0.1625000
NODE_7313_length_966_cov_36.160323	461	541	13	36	80	0.4500000
NODE_7313_length_966_cov_36.160323	461	541	14	14	80	0.1750000
NODE_7313_length_966_cov_36.160323	514	594	3	6	80	0.0750000
NODE_7313_length_966_cov_36.160323	514	594	4	3	80	0.0375000
NODE_7313_length_966_cov_36.160323	514	594	5	1	80	0.0125000
NODE_7313_length_966_cov_36.160323	514	594	6	15	80	0.1875000
NODE_7313_length_966_cov_36.160323	514	594	8	23	80	0.2875000
NODE_7313_length_966_cov_36.160323	514	594	9	20	80	0.2500000
NODE_7313_length_966_cov_36.160323	514	594	10	2	80	0.0250000
NODE_7313_length_966_cov_36.160323	514	594	11	10	80	0.1250000
NODE_7314_length_966_cov_18.658593	408	488	0	80	80	1.0000000
NODE_7314_length_966_cov_18.658593	461	541	0	80	80	1.0000000
NODE_7315_length_966_cov_17.606690	341	421	0	80	80	1.0000000
NODE_7315_length_966_cov_17.606690	394	474	0	75	80	0.9375000
NODE_7315_length_966_cov_17.606690	394	474	2	5	80	0.0625000
NODE_7316_length_966_cov_16.064591	296	376	3	47	80	0.5875000
NODE_7316_length_966_cov_16.064591	296	376	4	29	80	0.3625000
NODE_7316_length_966_cov_16.064591	296	376	5	4	80	0.0500000
NODE_7316_length_966_cov_16.064591	349	429	3	2	80	0.0250000
NODE_7316_length_966_cov_16.064591	349	429	4	47	80	0.5875000
NODE_7316_length_966_cov_16.064591	349	429	5	31	80	0.3875000
NODE_7317_length_966_cov_15.155709	562	642	0	18	80	0.2250000
NODE_7317_length_966_cov_15.155709	562	642	1	45	80	0.5625000
NODE_7317_length_966_cov_15.155709	562	642	2	7	80	0.0875000
NODE_7317_length_966_cov_15.155709	562	642	3	10	80	0.1250000
NODE_7317_length_966_cov_15.155709	615	695	1	10	80	0.1250000
NODE_7317_length_966_cov_15.155709	615	695	2	7	80	0.0875000
NODE_7317_length_966_cov_15.155709	615	695	3	63	80	0.7875000
NODE_7318_length_966_cov_7.726644	280	360	1	33	80	0.4125000
NODE_7318_length_966_cov_7.726644	280	360	3	47	80	0.5875000
NODE_7318_length_966_cov_7.726644	334	414	1	2	80	0.0250000
NODE_7318_length_966_cov_7.726644	334	414	2	16	80	0.2000000
NODE_7318_length_966_cov_7.726644	334	414	3	33	80	0.4125000
NODE_7318_length_966_cov_7.726644	334	414	4	29	80	0.3625000
NODE_7335_length_965_cov_51.524249	197	277	0	51	80	0.6375000
NODE_7335_length_965_cov_51.524249	197	277	2	29	80	0.3625000
NODE_7335_length_965_cov_51.524249	250	327	0	77	77	1.0000000
NODE_7335_length_965_cov_51.524249	329	406	0	10	77	0.1298701
NODE_7335_length_965_cov_51.524249	329	406	1	14	77	0.1818182
NODE_7335_length_965_cov_51.524249	329	406	3	12	77	0.1558442
NODE_7335_length_965_cov_51.524249	329	406	5	15	77	0.1948052
NODE_7335_length_965_cov_51.524249	329	406	6	6	77	0.0779221
NODE_7335_length_965_cov_51.524249	329	406	7	20	77	0.2597403
NODE_7335_length_965_cov_51.524249	379	459	5	1	80	0.0125000
NODE_7335_length_965_cov_51.524249	379	459	6	6	80	0.0750000
NODE_7335_length_965_cov_51.524249	379	459	7	73	80	0.9125000
NODE_7336_length_965_cov_18.072748	515	595	0	29	80	0.3625000
NODE_7336_length_965_cov_18.072748	515	595	2	51	80	0.6375000
NODE_7336_length_965_cov_18.072748	568	648	2	80	80	1.0000000
NODE_7337_length_965_cov_14.277136	342	422	2	80	80	1.0000000
NODE_7337_length_965_cov_14.277136	395	470	0	2	75	0.0266667
NODE_7337_length_965_cov_14.277136	395	470	1	30	75	0.4000000
NODE_7337_length_965_cov_14.277136	395	470	2	43	75	0.5733333
NODE_7338_length_965_cov_7.808314	567	647	1	64	80	0.8000000
NODE_7338_length_965_cov_7.808314	567	647	2	16	80	0.2000000
NODE_7338_length_965_cov_7.808314	620	700	1	30	80	0.3750000
NODE_7338_length_965_cov_7.808314	620	700	2	50	80	0.6250000
NODE_7344_length_964_cov_60.153757	197	277	20	3	80	0.0375000
NODE_7344_length_964_cov_60.153757	197	277	23	2	80	0.0250000
NODE_7344_length_964_cov_60.153757	197	277	24	1	80	0.0125000
NODE_7344_length_964_cov_60.153757	197	277	25	2	80	0.0250000
NODE_7344_length_964_cov_60.153757	197	277	26	3	80	0.0375000
NODE_7344_length_964_cov_60.153757	197	277	31	5	80	0.0625000
NODE_7344_length_964_cov_60.153757	197	277	34	1	80	0.0125000
NODE_7344_length_964_cov_60.153757	197	277	35	2	80	0.0250000
NODE_7344_length_964_cov_60.153757	197	277	36	4	80	0.0500000
NODE_7344_length_964_cov_60.153757	197	277	37	2	80	0.0250000
NODE_7344_length_964_cov_60.153757	197	277	39	1	80	0.0125000
NODE_7344_length_964_cov_60.153757	197	277	40	5	80	0.0625000
NODE_7344_length_964_cov_60.153757	197	277	42	1	80	0.0125000
NODE_7344_length_964_cov_60.153757	197	277	43	1	80	0.0125000
NODE_7344_length_964_cov_60.153757	197	277	44	3	80	0.0375000
NODE_7344_length_964_cov_60.153757	197	277	50	1	80	0.0125000
NODE_7344_length_964_cov_60.153757	197	277	51	2	80	0.0250000
NODE_7344_length_964_cov_60.153757	197	277	52	4	80	0.0500000
NODE_7344_length_964_cov_60.153757	197	277	54	1	80	0.0125000
NODE_7344_length_964_cov_60.153757	197	277	56	1	80	0.0125000
NODE_7344_length_964_cov_60.153757	197	277	57	1	80	0.0125000
NODE_7344_length_964_cov_60.153757	197	277	60	1	80	0.0125000
NODE_7344_length_964_cov_60.153757	197	277	62	1	80	0.0125000
NODE_7344_length_964_cov_60.153757	197	277	64	1	80	0.0125000
NODE_7344_length_964_cov_60.153757	197	277	65	1	80	0.0125000
NODE_7344_length_964_cov_60.153757	197	277	66	1	80	0.0125000
NODE_7344_length_964_cov_60.153757	197	277	67	1	80	0.0125000
NODE_7344_length_964_cov_60.153757	197	277	68	1	80	0.0125000
NODE_7344_length_964_cov_60.153757	197	277	70	1	80	0.0125000
NODE_7344_length_964_cov_60.153757	197	277	72	1	80	0.0125000
NODE_7344_length_964_cov_60.153757	197	277	73	2	80	0.0250000
NODE_7344_length_964_cov_60.153757	197	277	74	1	80	0.0125000
NODE_7344_length_964_cov_60.153757	197	277	75	1	80	0.0125000
NODE_7344_length_964_cov_60.153757	197	277	79	1	80	0.0125000
NODE_7344_length_964_cov_60.153757	197	277	83	1	80	0.0125000
NODE_7344_length_964_cov_60.153757	197	277	84	2	80	0.0250000
NODE_7344_length_964_cov_60.153757	197	277	85	2	80	0.0250000
NODE_7344_length_964_cov_60.153757	197	277	90	1	80	0.0125000
NODE_7344_length_964_cov_60.153757	197	277	93	1	80	0.0125000
NODE_7344_length_964_cov_60.153757	197	277	95	4	80	0.0500000
NODE_7344_length_964_cov_60.153757	197	277	97	1	80	0.0125000
NODE_7344_length_964_cov_60.153757	197	277	98	2	80	0.0250000
NODE_7344_length_964_cov_60.153757	197	277	99	1	80	0.0125000
NODE_7344_length_964_cov_60.153757	197	277	101	1	80	0.0125000
NODE_7344_length_964_cov_60.153757	197	277	103	1	80	0.0125000
NODE_7344_length_964_cov_60.153757	197	277	104	1	80	0.0125000
NODE_7344_length_964_cov_60.153757	197	277	106	1	80	0.0125000
NODE_7344_length_964_cov_60.153757	197	277	107	1	80	0.0125000
NODE_7344_length_964_cov_60.153757	250	314	5	1	64	0.0156250
NODE_7344_length_964_cov_60.153757	250	314	6	1	64	0.0156250
NODE_7344_length_964_cov_60.153757	250	314	7	2	64	0.0312500
NODE_7344_length_964_cov_60.153757	250	314	8	5	64	0.0781250
NODE_7344_length_964_cov_60.153757	250	314	9	6	64	0.0937500
NODE_7344_length_964_cov_60.153757	250	314	10	1	64	0.0156250
NODE_7344_length_964_cov_60.153757	250	314	11	1	64	0.0156250
NODE_7344_length_964_cov_60.153757	250	314	14	7	64	0.1093750
NODE_7344_length_964_cov_60.153757	250	314	15	7	64	0.1093750
NODE_7344_length_964_cov_60.153757	250	314	17	3	64	0.0468750
NODE_7344_length_964_cov_60.153757	250	314	18	2	64	0.0312500
NODE_7344_length_964_cov_60.153757	250	314	19	1	64	0.0156250
NODE_7344_length_964_cov_60.153757	250	314	20	3	64	0.0468750
NODE_7344_length_964_cov_60.153757	250	314	23	2	64	0.0312500
NODE_7344_length_964_cov_60.153757	250	314	24	1	64	0.0156250
NODE_7344_length_964_cov_60.153757	250	314	25	2	64	0.0312500
NODE_7344_length_964_cov_60.153757	250	314	26	3	64	0.0468750
NODE_7344_length_964_cov_60.153757	250	314	31	5	64	0.0781250
NODE_7344_length_964_cov_60.153757	250	314	34	1	64	0.0156250
NODE_7344_length_964_cov_60.153757	250	314	35	2	64	0.0312500
NODE_7344_length_964_cov_60.153757	250	314	36	4	64	0.0625000
NODE_7344_length_964_cov_60.153757	250	314	37	2	64	0.0312500
NODE_7344_length_964_cov_60.153757	250	314	39	1	64	0.0156250
NODE_7344_length_964_cov_60.153757	250	314	40	1	64	0.0156250
NODE_7344_length_964_cov_60.153757	672	752	0	80	80	1.0000000
NODE_7344_length_964_cov_60.153757	725	805	0	80	80	1.0000000
NODE_7345_length_964_cov_45.564162	314	394	3	31	80	0.3875000
NODE_7345_length_964_cov_45.564162	314	394	6	5	80	0.0625000
NODE_7345_length_964_cov_45.564162	314	394	8	12	80	0.1500000
NODE_7345_length_964_cov_45.564162	314	394	9	10	80	0.1250000
NODE_7345_length_964_cov_45.564162	314	394	10	1	80	0.0125000
NODE_7345_length_964_cov_45.564162	314	394	12	2	80	0.0250000
NODE_7345_length_964_cov_45.564162	314	394	13	4	80	0.0500000
NODE_7345_length_964_cov_45.564162	314	394	15	4	80	0.0500000
NODE_7345_length_964_cov_45.564162	314	394	16	10	80	0.1250000
NODE_7345_length_964_cov_45.564162	314	394	17	1	80	0.0125000
NODE_7345_length_964_cov_45.564162	367	447	9	5	80	0.0625000
NODE_7345_length_964_cov_45.564162	367	447	10	1	80	0.0125000
NODE_7345_length_964_cov_45.564162	367	447	12	2	80	0.0250000
NODE_7345_length_964_cov_45.564162	367	447	13	4	80	0.0500000
NODE_7345_length_964_cov_45.564162	367	447	15	4	80	0.0500000
NODE_7345_length_964_cov_45.564162	367	447	16	10	80	0.1250000
NODE_7345_length_964_cov_45.564162	367	447	17	16	80	0.2000000
NODE_7345_length_964_cov_45.564162	367	447	18	16	80	0.2000000
NODE_7345_length_964_cov_45.564162	367	447	19	13	80	0.1625000
NODE_7345_length_964_cov_45.564162	367	447	20	7	80	0.0875000
NODE_7345_length_964_cov_45.564162	367	447	22	2	80	0.0250000
NODE_7345_length_964_cov_45.564162	443	523	15	1	80	0.0125000
NODE_7345_length_964_cov_45.564162	443	523	16	10	80	0.1250000
NODE_7345_length_964_cov_45.564162	443	523	17	1	80	0.0125000
NODE_7345_length_964_cov_45.564162	443	523	19	18	80	0.2250000
NODE_7345_length_964_cov_45.564162	443	523	20	15	80	0.1875000
NODE_7345_length_964_cov_45.564162	443	523	21	9	80	0.1125000
NODE_7345_length_964_cov_45.564162	443	523	22	10	80	0.1250000
NODE_7345_length_964_cov_45.564162	443	523	24	11	80	0.1375000
NODE_7345_length_964_cov_45.564162	443	523	25	1	80	0.0125000
NODE_7345_length_964_cov_45.564162	443	523	26	4	80	0.0500000
NODE_7345_length_964_cov_45.564162	496	566	10	13	70	0.1857143
NODE_7345_length_964_cov_45.564162	496	566	11	10	70	0.1428571
NODE_7345_length_964_cov_45.564162	496	566	12	10	70	0.1428571
NODE_7345_length_964_cov_45.564162	496	566	13	4	70	0.0571429
NODE_7345_length_964_cov_45.564162	496	566	15	7	70	0.1000000
NODE_7345_length_964_cov_45.564162	496	566	16	10	70	0.1428571
NODE_7345_length_964_cov_45.564162	496	566	17	1	70	0.0142857
NODE_7345_length_964_cov_45.564162	496	566	19	15	70	0.2142857
NODE_7346_length_964_cov_33.487861	363	443	2	39	80	0.4875000
NODE_7346_length_964_cov_33.487861	363	443	3	16	80	0.2000000
NODE_7346_length_964_cov_33.487861	363	443	4	25	80	0.3125000
NODE_7346_length_964_cov_33.487861	416	496	3	8	80	0.1000000
NODE_7346_length_964_cov_33.487861	416	496	4	72	80	0.9000000
NODE_7347_length_964_cov_33.077457	408	488	0	80	80	1.0000000
NODE_7347_length_964_cov_33.077457	461	541	0	80	80	1.0000000
NODE_7347_length_964_cov_33.077457	537	617	0	80	80	1.0000000
NODE_7347_length_964_cov_33.077457	590	670	0	66	80	0.8250000
NODE_7347_length_964_cov_33.077457	590	670	1	14	80	0.1750000
NODE_7348_length_964_cov_29.250867	419	499	4	4	80	0.0500000
NODE_7348_length_964_cov_29.250867	419	499	5	4	80	0.0500000
NODE_7348_length_964_cov_29.250867	419	499	6	6	80	0.0750000
NODE_7348_length_964_cov_29.250867	419	499	8	13	80	0.1625000
NODE_7348_length_964_cov_29.250867	419	499	9	16	80	0.2000000
NODE_7348_length_964_cov_29.250867	419	499	10	37	80	0.4625000
NODE_7348_length_964_cov_29.250867	472	552	7	20	80	0.2500000
NODE_7348_length_964_cov_29.250867	472	552	9	5	80	0.0625000
NODE_7348_length_964_cov_29.250867	472	552	10	55	80	0.6875000
NODE_7349_length_964_cov_20.191908	228	301	1	73	73	1.0000000
NODE_7349_length_964_cov_20.191908	349	429	1	80	80	1.0000000
NODE_7349_length_964_cov_20.191908	402	482	1	80	80	1.0000000
NODE_7350_length_964_cov_18.510983	486	566	2	8	80	0.1000000
NODE_7350_length_964_cov_18.510983	486	566	3	36	80	0.4500000
NODE_7350_length_964_cov_18.510983	486	566	4	35	80	0.4375000
NODE_7350_length_964_cov_18.510983	486	566	5	1	80	0.0125000
NODE_7350_length_964_cov_18.510983	539	619	1	40	80	0.5000000
NODE_7350_length_964_cov_18.510983	539	619	2	3	80	0.0375000
NODE_7350_length_964_cov_18.510983	539	619	3	37	80	0.4625000
NODE_7351_length_964_cov_16.613873	464	544	1	20	80	0.2500000
NODE_7351_length_964_cov_16.613873	464	544	2	42	80	0.5250000
NODE_7351_length_964_cov_16.613873	464	544	3	12	80	0.1500000
NODE_7351_length_964_cov_16.613873	464	544	4	6	80	0.0750000
NODE_7351_length_964_cov_16.613873	517	597	2	9	80	0.1125000
NODE_7351_length_964_cov_16.613873	517	597	3	18	80	0.2250000
NODE_7351_length_964_cov_16.613873	517	597	4	42	80	0.5250000
NODE_7351_length_964_cov_16.613873	517	597	5	11	80	0.1375000
NODE_7352_length_964_cov_15.717919	411	491	1	13	80	0.1625000
NODE_7352_length_964_cov_15.717919	411	491	2	5	80	0.0625000
NODE_7352_length_964_cov_15.717919	411	491	3	37	80	0.4625000
NODE_7352_length_964_cov_15.717919	411	491	4	25	80	0.3125000
NODE_7352_length_964_cov_15.717919	464	544	3	80	80	1.0000000
NODE_7352_length_964_cov_15.717919	540	620	0	46	80	0.5750000
NODE_7352_length_964_cov_15.717919	540	620	1	24	80	0.3000000
NODE_7352_length_964_cov_15.717919	540	620	3	10	80	0.1250000
NODE_7352_length_964_cov_15.717919	593	668	0	75	75	1.0000000
NODE_7353_length_964_cov_14.591908	521	601	1	30	80	0.3750000
NODE_7353_length_964_cov_14.591908	521	601	2	50	80	0.6250000
NODE_7353_length_964_cov_14.591908	574	654	1	33	80	0.4125000
NODE_7353_length_964_cov_14.591908	574	654	2	47	80	0.5875000
NODE_7354_length_964_cov_11.589595	475	555	0	22	80	0.2750000
NODE_7354_length_964_cov_11.589595	475	555	2	58	80	0.7250000
NODE_7354_length_964_cov_11.589595	528	608	0	75	80	0.9375000
NODE_7354_length_964_cov_11.589595	528	608	2	5	80	0.0625000
NODE_7355_length_964_cov_7.639306	420	500	0	80	80	1.0000000
NODE_7355_length_964_cov_7.639306	473	553	0	80	80	1.0000000
NODE_7356_length_964_cov_7.596532	534	614	1	8	80	0.1000000
NODE_7356_length_964_cov_7.596532	534	614	2	72	80	0.9000000
NODE_7356_length_964_cov_7.596532	587	667	2	80	80	1.0000000
NODE_7357_length_964_cov_6.568786	368	448	1	80	80	1.0000000
NODE_7357_length_964_cov_6.568786	421	501	0	3	80	0.0375000
NODE_7357_length_964_cov_6.568786	421	501	1	77	80	0.9625000
NODE_7359_length_964_cov_6.027746	890	940	5	16	50	0.3200000
NODE_7359_length_964_cov_6.027746	890	940	7	29	50	0.5800000
NODE_7359_length_964_cov_6.027746	890	940	8	2	50	0.0400000
NODE_7359_length_964_cov_6.027746	890	940	10	3	50	0.0600000
NODE_7361_length_964_cov_4.665896	706	772	0	10	66	0.1515152
NODE_7361_length_964_cov_4.665896	706	772	1	56	66	0.8484849
NODE_7376_length_963_cov_66.251157	456	536	1	74	80	0.9250000
NODE_7376_length_963_cov_66.251157	456	536	2	6	80	0.0750000
NODE_7376_length_963_cov_66.251157	509	589	1	80	80	1.0000000
NODE_7376_length_963_cov_66.251157	585	665	0	43	80	0.5375000
NODE_7376_length_963_cov_66.251157	585	665	1	7	80	0.0875000
NODE_7376_length_963_cov_66.251157	585	665	2	30	80	0.3750000
NODE_7376_length_963_cov_66.251157	638	718	2	80	80	1.0000000
NODE_7377_length_963_cov_35.638889	381	461	2	56	80	0.7000000
NODE_7377_length_963_cov_35.638889	381	461	4	24	80	0.3000000
NODE_7377_length_963_cov_35.638889	434	514	2	3	80	0.0375000
NODE_7377_length_963_cov_35.638889	434	514	4	77	80	0.9625000
NODE_7377_length_963_cov_35.638889	510	590	0	3	80	0.0375000
NODE_7377_length_963_cov_35.638889	510	590	2	65	80	0.8125000
NODE_7377_length_963_cov_35.638889	510	590	4	12	80	0.1500000
NODE_7377_length_963_cov_35.638889	563	643	0	56	80	0.7000000
NODE_7377_length_963_cov_35.638889	563	643	2	24	80	0.3000000
NODE_7378_length_963_cov_33.642361	347	427	3	50	80	0.6250000
NODE_7378_length_963_cov_33.642361	347	427	4	30	80	0.3750000
NODE_7378_length_963_cov_33.642361	400	480	1	16	80	0.2000000
NODE_7378_length_963_cov_33.642361	400	480	3	64	80	0.8000000
NODE_7379_length_963_cov_18.626157	392	472	0	80	80	1.0000000
NODE_7379_length_963_cov_18.626157	445	525	0	80	80	1.0000000
NODE_7380_length_963_cov_17.750000	402	482	2	40	80	0.5000000
NODE_7380_length_963_cov_17.750000	402	482	4	40	80	0.5000000
NODE_7380_length_963_cov_17.750000	455	535	0	1	80	0.0125000
NODE_7380_length_963_cov_17.750000	455	535	2	62	80	0.7750000
NODE_7380_length_963_cov_17.750000	455	535	4	17	80	0.2125000
NODE_7381_length_963_cov_17.023148	542	622	1	53	80	0.6625000
NODE_7381_length_963_cov_17.023148	542	622	2	27	80	0.3375000
NODE_7381_length_963_cov_17.023148	595	675	2	48	80	0.6000000
NODE_7381_length_963_cov_17.023148	595	675	3	32	80	0.4000000
NODE_7382_length_963_cov_16.642361	481	561	3	29	80	0.3625000
NODE_7382_length_963_cov_16.642361	481	561	4	19	80	0.2375000
NODE_7382_length_963_cov_16.642361	481	561	5	32	80	0.4000000
NODE_7382_length_963_cov_16.642361	534	614	3	10	80	0.1250000
NODE_7382_length_963_cov_16.642361	534	614	5	70	80	0.8750000
NODE_7382_length_963_cov_16.642361	572	629	2	13	57	0.2280702
NODE_7382_length_963_cov_16.642361	572	629	3	10	57	0.1754386
NODE_7382_length_963_cov_16.642361	572	629	4	2	57	0.0350877
NODE_7382_length_963_cov_16.642361	572	629	5	32	57	0.5614035
NODE_7383_length_963_cov_14.961806	283	363	0	58	80	0.7250000
NODE_7383_length_963_cov_14.961806	283	363	1	22	80	0.2750000
NODE_7383_length_963_cov_14.961806	336	416	0	11	80	0.1375000
NODE_7383_length_963_cov_14.961806	336	416	1	69	80	0.8625000
NODE_7384_length_963_cov_13.341435	558	638	2	10	80	0.1250000
NODE_7384_length_963_cov_13.341435	558	638	4	27	80	0.3375000
NODE_7384_length_963_cov_13.341435	558	638	5	32	80	0.4000000
NODE_7384_length_963_cov_13.341435	558	638	6	11	80	0.1375000
NODE_7384_length_963_cov_13.341435	611	691	0	17	80	0.2125000
NODE_7384_length_963_cov_13.341435	611	691	1	24	80	0.3000000
NODE_7384_length_963_cov_13.341435	611	691	2	22	80	0.2750000
NODE_7384_length_963_cov_13.341435	611	691	4	17	80	0.2125000
NODE_7386_length_963_cov_9.520833	459	539	0	80	80	1.0000000
NODE_7386_length_963_cov_9.520833	512	592	0	80	80	1.0000000
NODE_7386_length_963_cov_9.520833	588	662	0	20	74	0.2702703
NODE_7386_length_963_cov_9.520833	588	662	1	10	74	0.1351351
NODE_7386_length_963_cov_9.520833	588	662	2	44	74	0.5945946
NODE_7386_length_963_cov_9.520833	641	724	1	3	83	0.0361446
NODE_7386_length_963_cov_9.520833	641	724	2	80	83	0.9638554
NODE_7388_length_963_cov_7.510417	781	842	7	11	61	0.1803279
NODE_7388_length_963_cov_7.510417	781	842	8	1	61	0.0163934
NODE_7388_length_963_cov_7.510417	781	842	9	1	61	0.0163934
NODE_7388_length_963_cov_7.510417	781	842	10	2	61	0.0327869
NODE_7388_length_963_cov_7.510417	781	842	11	1	61	0.0163934
NODE_7388_length_963_cov_7.510417	781	842	12	1	61	0.0163934
NODE_7388_length_963_cov_7.510417	781	842	14	1	61	0.0163934
NODE_7388_length_963_cov_7.510417	781	842	15	1	61	0.0163934
NODE_7388_length_963_cov_7.510417	781	842	16	5	61	0.0819672
NODE_7388_length_963_cov_7.510417	781	842	18	9	61	0.1475410
NODE_7388_length_963_cov_7.510417	781	842	19	3	61	0.0491803
NODE_7388_length_963_cov_7.510417	781	842	21	25	61	0.4098361
NODE_7388_length_963_cov_7.510417	815	894	19	5	79	0.0632911
NODE_7388_length_963_cov_7.510417	815	894	20	1	79	0.0126582
NODE_7388_length_963_cov_7.510417	815	894	21	27	79	0.3417721
NODE_7388_length_963_cov_7.510417	815	894	23	46	79	0.5822785
NODE_7392_length_963_cov_3.755787	378	458	0	70	80	0.8750000
NODE_7392_length_963_cov_3.755787	378	458	1	10	80	0.1250000
NODE_7392_length_963_cov_3.755787	431	511	0	17	80	0.2125000
NODE_7392_length_963_cov_3.755787	431	511	1	63	80	0.7875000
NODE_7397_length_963_cov_1.931713	426	485	0	31	59	0.5254237
NODE_7397_length_963_cov_1.931713	426	485	1	28	59	0.4745763
NODE_7404_length_962_cov_37.169177	356	436	3	80	80	1.0000000
NODE_7404_length_962_cov_37.169177	409	489	0	2	80	0.0250000
NODE_7404_length_962_cov_37.169177	409	489	1	40	80	0.5000000
NODE_7404_length_962_cov_37.169177	409	489	3	38	80	0.4750000
NODE_7405_length_962_cov_28.852839	474	554	0	80	80	1.0000000
NODE_7405_length_962_cov_28.852839	527	607	0	80	80	1.0000000
NODE_7405_length_962_cov_28.852839	603	683	0	80	80	1.0000000
NODE_7405_length_962_cov_28.852839	656	736	0	80	80	1.0000000
NODE_7406_length_962_cov_27.859791	441	521	0	13	80	0.1625000
NODE_7406_length_962_cov_27.859791	441	521	2	67	80	0.8375000
NODE_7406_length_962_cov_27.859791	494	574	0	12	80	0.1500000
NODE_7406_length_962_cov_27.859791	494	574	2	68	80	0.8500000
NODE_7407_length_962_cov_21.019699	318	398	0	76	80	0.9500000
NODE_7407_length_962_cov_21.019699	318	398	1	4	80	0.0500000
NODE_7407_length_962_cov_21.019699	371	451	0	23	80	0.2875000
NODE_7407_length_962_cov_21.019699	371	451	1	35	80	0.4375000
NODE_7407_length_962_cov_21.019699	371	451	2	22	80	0.2750000
NODE_7408_length_962_cov_16.792584	350	430	2	9	80	0.1125000
NODE_7408_length_962_cov_16.792584	350	430	3	71	80	0.8875000
NODE_7408_length_962_cov_16.792584	403	483	2	8	80	0.1000000
NODE_7408_length_962_cov_16.792584	403	483	3	41	80	0.5125000
NODE_7408_length_962_cov_16.792584	403	483	4	21	80	0.2625000
NODE_7408_length_962_cov_16.792584	403	483	5	6	80	0.0750000
NODE_7408_length_962_cov_16.792584	403	483	6	4	80	0.0500000
NODE_7409_length_962_cov_14.650058	477	557	2	80	80	1.0000000
NODE_7409_length_962_cov_14.650058	530	610	0	44	80	0.5500000
NODE_7409_length_962_cov_14.650058	530	610	2	36	80	0.4500000
NODE_7410_length_962_cov_7.993048	308	345	8	36	37	0.9729730
NODE_7410_length_962_cov_7.993048	308	345	9	1	37	0.0270270
NODE_7411_length_962_cov_7.835458	447	527	0	80	80	1.0000000
NODE_7411_length_962_cov_7.835458	500	580	0	80	80	1.0000000
NODE_7412_length_962_cov_6.855156	490	570	1	13	80	0.1625000
NODE_7412_length_962_cov_6.855156	490	570	2	67	80	0.8375000
NODE_7412_length_962_cov_6.855156	543	623	1	16	80	0.2000000
NODE_7412_length_962_cov_6.855156	543	623	2	64	80	0.8000000
NODE_7417_length_962_cov_1.840093	88	151	0	2	63	0.0317460
NODE_7417_length_962_cov_1.840093	88	151	2	1	63	0.0158730
NODE_7417_length_962_cov_1.840093	88	151	4	2	63	0.0317460
NODE_7417_length_962_cov_1.840093	88	151	6	6	63	0.0952381
NODE_7417_length_962_cov_1.840093	88	151	10	31	63	0.4920635
NODE_7417_length_962_cov_1.840093	88	151	12	1	63	0.0158730
NODE_7417_length_962_cov_1.840093	88	151	14	10	63	0.1587302
NODE_7417_length_962_cov_1.840093	88	151	16	10	63	0.1587302
NODE_7422_length_961_cov_61.019722	453	533	3	57	80	0.7125000
NODE_7422_length_961_cov_61.019722	453	533	4	9	80	0.1125000
NODE_7422_length_961_cov_61.019722	453	533	5	4	80	0.0500000
NODE_7422_length_961_cov_61.019722	453	533	7	1	80	0.0125000
NODE_7422_length_961_cov_61.019722	453	533	9	9	80	0.1125000
NODE_7422_length_961_cov_61.019722	506	586	3	4	80	0.0500000
NODE_7422_length_961_cov_61.019722	506	586	4	9	80	0.1125000
NODE_7422_length_961_cov_61.019722	506	586	5	4	80	0.0500000
NODE_7422_length_961_cov_61.019722	506	586	7	10	80	0.1250000
NODE_7422_length_961_cov_61.019722	506	586	8	18	80	0.2250000
NODE_7422_length_961_cov_61.019722	506	586	9	35	80	0.4375000
NODE_7422_length_961_cov_61.019722	614	672	3	12	58	0.2068966
NODE_7422_length_961_cov_61.019722	614	672	4	37	58	0.6379310
NODE_7422_length_961_cov_61.019722	614	672	5	6	58	0.1034483
NODE_7422_length_961_cov_61.019722	614	672	7	3	58	0.0517241
NODE_7423_length_961_cov_51.005800	334	414	14	19	80	0.2375000
NODE_7423_length_961_cov_51.005800	334	414	15	61	80	0.7625000
NODE_7423_length_961_cov_51.005800	387	467	9	17	80	0.2125000
NODE_7423_length_961_cov_51.005800	387	467	10	9	80	0.1125000
NODE_7423_length_961_cov_51.005800	387	467	12	4	80	0.0500000
NODE_7423_length_961_cov_51.005800	387	467	13	9	80	0.1125000
NODE_7423_length_961_cov_51.005800	387	467	14	18	80	0.2250000
NODE_7423_length_961_cov_51.005800	387	467	15	23	80	0.2875000
NODE_7424_length_961_cov_45.923434	391	471	0	41	80	0.5125000
NODE_7424_length_961_cov_45.923434	391	471	1	39	80	0.4875000
NODE_7424_length_961_cov_45.923434	444	524	1	59	80	0.7375000
NODE_7424_length_961_cov_45.923434	444	524	2	21	80	0.2625000
NODE_7426_length_961_cov_21.410673	313	393	1	17	80	0.2125000
NODE_7426_length_961_cov_21.410673	313	393	2	5	80	0.0625000
NODE_7426_length_961_cov_21.410673	313	393	3	39	80	0.4875000
NODE_7426_length_961_cov_21.410673	313	393	4	19	80	0.2375000
NODE_7426_length_961_cov_21.410673	366	446	3	80	80	1.0000000
NODE_7427_length_961_cov_18.592807	403	483	0	80	80	1.0000000
NODE_7427_length_961_cov_18.592807	456	536	0	80	80	1.0000000
NODE_7428_length_961_cov_17.701856	433	513	0	80	80	1.0000000
NODE_7428_length_961_cov_17.701856	486	566	0	80	80	1.0000000
NODE_7429_length_961_cov_17.020882	505	585	0	80	80	1.0000000
NODE_7429_length_961_cov_17.020882	558	638	0	80	80	1.0000000
NODE_7430_length_961_cov_16.235499	328	408	2	7	80	0.0875000
NODE_7430_length_961_cov_16.235499	328	408	3	8	80	0.1000000
NODE_7430_length_961_cov_16.235499	328	408	4	33	80	0.4125000
NODE_7430_length_961_cov_16.235499	328	408	5	32	80	0.4000000
NODE_7430_length_961_cov_16.235499	381	461	5	27	80	0.3375000
NODE_7430_length_961_cov_16.235499	381	461	6	9	80	0.1125000
NODE_7430_length_961_cov_16.235499	381	461	7	13	80	0.1625000
NODE_7430_length_961_cov_16.235499	381	461	8	31	80	0.3875000
NODE_7432_length_961_cov_12.968677	347	427	0	80	80	1.0000000
NODE_7432_length_961_cov_12.968677	400	480	0	80	80	1.0000000
NODE_7433_length_961_cov_9.875870	439	519	2	6	80	0.0750000
NODE_7433_length_961_cov_9.875870	439	519	3	10	80	0.1250000
NODE_7433_length_961_cov_9.875870	439	519	4	64	80	0.8000000
NODE_7433_length_961_cov_9.875870	492	572	2	6	80	0.0750000
NODE_7433_length_961_cov_9.875870	492	572	3	63	80	0.7875000
NODE_7433_length_961_cov_9.875870	492	572	4	11	80	0.1375000
NODE_7434_length_961_cov_6.172854	624	704	2	16	80	0.2000000
NODE_7434_length_961_cov_6.172854	624	704	4	11	80	0.1375000
NODE_7434_length_961_cov_6.172854	624	704	5	48	80	0.6000000
NODE_7434_length_961_cov_6.172854	624	704	6	5	80	0.0625000
NODE_7434_length_961_cov_6.172854	677	757	4	9	80	0.1125000
NODE_7434_length_961_cov_6.172854	677	757	5	22	80	0.2750000
NODE_7434_length_961_cov_6.172854	677	757	6	49	80	0.6125000
NODE_7435_length_961_cov_4.553364	451	531	2	68	80	0.8500000
NODE_7435_length_961_cov_4.553364	451	531	3	12	80	0.1500000
NODE_7435_length_961_cov_4.553364	504	584	2	80	80	1.0000000
NODE_7440_length_960_cov_35.649245	65	145	0	80	80	1.0000000
NODE_7440_length_960_cov_35.649245	118	198	0	80	80	1.0000000
NODE_7440_length_960_cov_35.649245	446	526	0	80	80	1.0000000
NODE_7440_length_960_cov_35.649245	499	579	0	30	80	0.3750000
NODE_7440_length_960_cov_35.649245	499	579	1	4	80	0.0500000
NODE_7440_length_960_cov_35.649245	499	579	2	3	80	0.0375000
NODE_7440_length_960_cov_35.649245	499	579	3	21	80	0.2625000
NODE_7440_length_960_cov_35.649245	499	579	4	22	80	0.2750000
NODE_7441_length_960_cov_34.886179	386	466	1	15	80	0.1875000
NODE_7441_length_960_cov_34.886179	386	466	2	5	80	0.0625000
NODE_7441_length_960_cov_34.886179	386	466	3	43	80	0.5375000
NODE_7441_length_960_cov_34.886179	386	466	7	17	80	0.2125000
NODE_7441_length_960_cov_34.886179	439	519	3	10	80	0.1250000
NODE_7441_length_960_cov_34.886179	439	519	6	18	80	0.2250000
NODE_7441_length_960_cov_34.886179	439	519	7	52	80	0.6500000
NODE_7443_length_960_cov_25.133566	413	493	1	59	80	0.7375000
NODE_7443_length_960_cov_25.133566	413	493	2	21	80	0.2625000
NODE_7443_length_960_cov_25.133566	466	546	1	6	80	0.0750000
NODE_7443_length_960_cov_25.133566	466	546	2	42	80	0.5250000
NODE_7443_length_960_cov_25.133566	466	546	4	7	80	0.0875000
NODE_7443_length_960_cov_25.133566	466	546	5	25	80	0.3125000
NODE_7444_length_960_cov_19.336818	385	465	0	80	80	1.0000000
NODE_7444_length_960_cov_19.336818	438	518	0	80	80	1.0000000
NODE_7445_length_960_cov_13.221835	460	539	2	18	79	0.2278481
NODE_7445_length_960_cov_13.221835	460	539	3	38	79	0.4810127
NODE_7445_length_960_cov_13.221835	460	539	4	23	79	0.2911392
NODE_7445_length_960_cov_13.221835	512	592	3	13	80	0.1625000
NODE_7445_length_960_cov_13.221835	512	592	4	67	80	0.8375000
NODE_7446_length_960_cov_12.804878	347	427	0	80	80	1.0000000
NODE_7446_length_960_cov_12.804878	400	480	0	80	80	1.0000000
NODE_7462_length_959_cov_39.394186	326	406	0	80	80	1.0000000
NODE_7462_length_959_cov_39.394186	379	459	0	80	80	1.0000000
NODE_7463_length_959_cov_28.895349	327	407	1	42	80	0.5250000
NODE_7463_length_959_cov_28.895349	327	407	2	23	80	0.2875000
NODE_7463_length_959_cov_28.895349	327	407	3	15	80	0.1875000
NODE_7463_length_959_cov_28.895349	380	460	2	65	80	0.8125000
NODE_7463_length_959_cov_28.895349	380	460	3	15	80	0.1875000
NODE_7464_length_959_cov_26.634884	563	643	3	1	80	0.0125000
NODE_7464_length_959_cov_26.634884	563	643	4	79	80	0.9875000
NODE_7464_length_959_cov_26.634884	616	696	1	16	80	0.2000000
NODE_7464_length_959_cov_26.634884	616	696	3	31	80	0.3875000
NODE_7464_length_959_cov_26.634884	616	696	4	33	80	0.4125000
NODE_7464_length_959_cov_26.634884	692	772	0	58	80	0.7250000
NODE_7464_length_959_cov_26.634884	692	772	1	22	80	0.2750000
NODE_7464_length_959_cov_26.634884	745	825	0	80	80	1.0000000
NODE_7465_length_959_cov_18.862791	320	400	0	32	80	0.4000000
NODE_7465_length_959_cov_18.862791	320	400	2	48	80	0.6000000
NODE_7465_length_959_cov_18.862791	373	453	0	15	80	0.1875000
NODE_7465_length_959_cov_18.862791	373	453	2	65	80	0.8125000
NODE_7466_length_959_cov_17.910465	358	438	2	80	80	1.0000000
NODE_7466_length_959_cov_17.910465	411	491	0	32	80	0.4000000
NODE_7466_length_959_cov_17.910465	411	491	1	4	80	0.0500000
NODE_7466_length_959_cov_17.910465	411	491	2	44	80	0.5500000
NODE_7467_length_959_cov_15.337209	267	347	1	28	80	0.3500000
NODE_7467_length_959_cov_15.337209	267	347	2	52	80	0.6500000
NODE_7467_length_959_cov_15.337209	320	400	1	39	80	0.4875000
NODE_7467_length_959_cov_15.337209	320	400	2	41	80	0.5125000
NODE_7468_length_959_cov_9.005814	529	609	1	64	80	0.8000000
NODE_7468_length_959_cov_9.005814	529	609	2	16	80	0.2000000
NODE_7468_length_959_cov_9.005814	582	662	0	19	80	0.2375000
NODE_7468_length_959_cov_9.005814	582	662	1	61	80	0.7625000
NODE_7469_length_959_cov_8.163953	392	472	4	10	80	0.1250000
NODE_7469_length_959_cov_8.163953	392	472	5	70	80	0.8750000
NODE_7469_length_959_cov_8.163953	445	525	3	12	80	0.1500000
NODE_7469_length_959_cov_8.163953	445	525	4	17	80	0.2125000
NODE_7469_length_959_cov_8.163953	445	525	5	51	80	0.6375000
NODE_7470_length_959_cov_7.097674	401	481	2	33	80	0.4125000
NODE_7470_length_959_cov_7.097674	401	481	3	47	80	0.5875000
NODE_7470_length_959_cov_7.097674	454	534	1	9	80	0.1125000
NODE_7470_length_959_cov_7.097674	454	534	2	38	80	0.4750000
NODE_7470_length_959_cov_7.097674	454	534	3	33	80	0.4125000
NODE_7472_length_959_cov_4.603488	596	676	0	80	80	1.0000000
NODE_7472_length_959_cov_4.603488	649	729	0	80	80	1.0000000
NODE_7486_length_958_cov_57.015134	328	408	0	31	80	0.3875000
NODE_7486_length_958_cov_57.015134	328	408	1	34	80	0.4250000
NODE_7486_length_958_cov_57.015134	328	408	3	15	80	0.1875000
NODE_7486_length_958_cov_57.015134	381	461	1	12	80	0.1500000
NODE_7486_length_958_cov_57.015134	381	461	3	22	80	0.2750000
NODE_7486_length_958_cov_57.015134	381	461	4	46	80	0.5750000
NODE_7486_length_958_cov_57.015134	457	537	3	50	80	0.6250000
NODE_7486_length_958_cov_57.015134	457	537	4	24	80	0.3000000
NODE_7486_length_958_cov_57.015134	457	537	5	6	80	0.0750000
NODE_7486_length_958_cov_57.015134	510	590	2	26	80	0.3250000
NODE_7486_length_958_cov_57.015134	510	590	3	54	80	0.6750000
NODE_7487_length_958_cov_42.265425	418	498	3	45	80	0.5625000
NODE_7487_length_958_cov_42.265425	418	498	4	6	80	0.0750000
NODE_7487_length_958_cov_42.265425	418	498	5	21	80	0.2625000
NODE_7487_length_958_cov_42.265425	418	498	6	8	80	0.1000000
NODE_7487_length_958_cov_42.265425	471	551	3	25	80	0.3125000
NODE_7487_length_958_cov_42.265425	471	551	5	37	80	0.4625000
NODE_7487_length_958_cov_42.265425	471	551	6	18	80	0.2250000
NODE_7488_length_958_cov_28.618161	336	416	2	25	80	0.3125000
NODE_7488_length_958_cov_28.618161	336	416	3	21	80	0.2625000
NODE_7488_length_958_cov_28.618161	336	416	4	34	80	0.4250000
NODE_7488_length_958_cov_28.618161	389	469	2	33	80	0.4125000
NODE_7488_length_958_cov_28.618161	389	469	3	10	80	0.1250000
NODE_7488_length_958_cov_28.618161	389	469	4	22	80	0.2750000
NODE_7488_length_958_cov_28.618161	389	469	5	15	80	0.1875000
NODE_7488_length_958_cov_28.618161	465	545	4	54	80	0.6750000
NODE_7488_length_958_cov_28.618161	465	545	5	26	80	0.3250000
NODE_7488_length_958_cov_28.618161	518	598	3	7	80	0.0875000
NODE_7488_length_958_cov_28.618161	518	598	4	58	80	0.7250000
NODE_7488_length_958_cov_28.618161	518	598	5	15	80	0.1875000
NODE_7489_length_958_cov_16.452852	446	526	2	4	80	0.0500000
NODE_7489_length_958_cov_16.452852	446	526	3	70	80	0.8750000
NODE_7489_length_958_cov_16.452852	446	526	4	6	80	0.0750000
NODE_7489_length_958_cov_16.452852	499	579	3	56	80	0.7000000
NODE_7489_length_958_cov_16.452852	499	579	4	24	80	0.3000000
NODE_7490_length_958_cov_16.008149	446	526	0	1	80	0.0125000
NODE_7490_length_958_cov_16.008149	446	526	2	3	80	0.0375000
NODE_7490_length_958_cov_16.008149	446	526	3	38	80	0.4750000
NODE_7490_length_958_cov_16.008149	446	526	4	38	80	0.4750000
NODE_7490_length_958_cov_16.008149	499	579	4	43	80	0.5375000
NODE_7490_length_958_cov_16.008149	499	579	5	21	80	0.2625000
NODE_7490_length_958_cov_16.008149	499	579	6	16	80	0.2000000
NODE_7491_length_958_cov_14.154831	516	596	3	57	80	0.7125000
NODE_7491_length_958_cov_14.154831	516	596	4	23	80	0.2875000
NODE_7491_length_958_cov_14.154831	569	649	3	4	80	0.0500000
NODE_7491_length_958_cov_14.154831	569	649	4	76	80	0.9500000
NODE_7492_length_958_cov_12.381839	454	534	7	59	80	0.7375000
NODE_7492_length_958_cov_12.381839	454	534	9	21	80	0.2625000
NODE_7492_length_958_cov_12.381839	507	587	5	21	80	0.2625000
NODE_7492_length_958_cov_12.381839	507	587	7	21	80	0.2625000
NODE_7492_length_958_cov_12.381839	507	587	9	38	80	0.4750000
NODE_7493_length_958_cov_11.782305	479	559	2	80	80	1.0000000
NODE_7493_length_958_cov_11.782305	532	612	0	29	80	0.3625000
NODE_7493_length_958_cov_11.782305	532	612	2	51	80	0.6375000
NODE_7501_length_957_cov_40.837995	746	826	6	4	80	0.0500000
NODE_7501_length_957_cov_40.837995	746	826	8	9	80	0.1125000
NODE_7501_length_957_cov_40.837995	746	826	9	23	80	0.2875000
NODE_7501_length_957_cov_40.837995	746	826	10	44	80	0.5500000
NODE_7501_length_957_cov_40.837995	799	879	6	6	80	0.0750000
NODE_7501_length_957_cov_40.837995	799	879	8	28	80	0.3500000
NODE_7501_length_957_cov_40.837995	799	879	9	16	80	0.2000000
NODE_7501_length_957_cov_40.837995	799	879	10	30	80	0.3750000
NODE_7502_length_957_cov_25.976690	631	711	2	80	80	1.0000000
NODE_7502_length_957_cov_25.976690	684	764	1	13	80	0.1625000
NODE_7502_length_957_cov_25.976690	684	764	2	67	80	0.8375000
NODE_7503_length_957_cov_25.855478	57	131	2	5	74	0.0675676
NODE_7503_length_957_cov_25.855478	57	131	4	69	74	0.9324324
NODE_7503_length_957_cov_25.855478	414	494	0	80	80	1.0000000
NODE_7503_length_957_cov_25.855478	467	547	0	80	80	1.0000000
NODE_7504_length_957_cov_24.625874	445	525	3	1	80	0.0125000
NODE_7504_length_957_cov_24.625874	445	525	4	56	80	0.7000000
NODE_7504_length_957_cov_24.625874	445	525	5	23	80	0.2875000
NODE_7504_length_957_cov_24.625874	498	578	3	2	80	0.0250000
NODE_7504_length_957_cov_24.625874	498	578	4	18	80	0.2250000
NODE_7504_length_957_cov_24.625874	498	578	5	60	80	0.7500000
NODE_7505_length_957_cov_19.955711	286	366	2	5	80	0.0625000
NODE_7505_length_957_cov_19.955711	286	366	3	40	80	0.5000000
NODE_7505_length_957_cov_19.955711	286	366	4	35	80	0.4375000
NODE_7505_length_957_cov_19.955711	339	419	2	14	80	0.1750000
NODE_7505_length_957_cov_19.955711	339	419	3	10	80	0.1250000
NODE_7505_length_957_cov_19.955711	339	419	4	56	80	0.7000000
NODE_7506_length_957_cov_18.861305	414	494	3	2	80	0.0250000
NODE_7506_length_957_cov_18.861305	414	494	4	8	80	0.1000000
NODE_7506_length_957_cov_18.861305	414	494	5	7	80	0.0875000
NODE_7506_length_957_cov_18.861305	414	494	6	24	80	0.3000000
NODE_7506_length_957_cov_18.861305	414	494	7	2	80	0.0250000
NODE_7506_length_957_cov_18.861305	414	494	8	32	80	0.4000000
NODE_7506_length_957_cov_18.861305	414	494	9	5	80	0.0625000
NODE_7506_length_957_cov_18.861305	467	547	7	13	80	0.1625000
NODE_7506_length_957_cov_18.861305	467	547	8	57	80	0.7125000
NODE_7506_length_957_cov_18.861305	467	547	9	10	80	0.1250000
NODE_7507_length_957_cov_17.356643	361	441	1	80	80	1.0000000
NODE_7507_length_957_cov_17.356643	414	494	0	40	80	0.5000000
NODE_7507_length_957_cov_17.356643	414	494	1	40	80	0.5000000
NODE_7508_length_957_cov_13.569930	162	242	0	80	80	1.0000000
NODE_7508_length_957_cov_13.569930	215	299	0	84	84	1.0000000
NODE_7509_length_957_cov_12.334499	314	394	0	80	80	1.0000000
NODE_7509_length_957_cov_12.334499	367	447	0	80	80	1.0000000
NODE_7510_length_957_cov_12.017483	173	253	0	24	80	0.3000000
NODE_7510_length_957_cov_12.017483	173	253	2	56	80	0.7000000
NODE_7510_length_957_cov_12.017483	226	306	2	80	80	1.0000000
NODE_7511_length_957_cov_10.026807	446	526	2	80	80	1.0000000
NODE_7511_length_957_cov_10.026807	499	579	1	43	80	0.5375000
NODE_7511_length_957_cov_10.026807	499	579	2	37	80	0.4625000
NODE_7529_length_956_cov_48.047841	479	559	0	59	80	0.7375000
NODE_7529_length_956_cov_48.047841	479	559	1	12	80	0.1500000
NODE_7529_length_956_cov_48.047841	479	559	2	9	80	0.1125000
NODE_7529_length_956_cov_48.047841	532	612	0	54	80	0.6750000
NODE_7529_length_956_cov_48.047841	532	612	1	13	80	0.1625000
NODE_7529_length_956_cov_48.047841	532	612	2	13	80	0.1625000
NODE_7529_length_956_cov_48.047841	608	688	2	80	80	1.0000000
NODE_7529_length_956_cov_48.047841	661	741	0	7	80	0.0875000
NODE_7529_length_956_cov_48.047841	661	741	1	4	80	0.0500000
NODE_7529_length_956_cov_48.047841	661	741	2	69	80	0.8625000
NODE_7530_length_956_cov_34.539090	298	378	1	62	80	0.7750000
NODE_7530_length_956_cov_34.539090	298	378	2	5	80	0.0625000
NODE_7530_length_956_cov_34.539090	298	378	3	1	80	0.0125000
NODE_7530_length_956_cov_34.539090	298	378	4	12	80	0.1500000
NODE_7530_length_956_cov_34.539090	351	431	1	9	80	0.1125000
NODE_7530_length_956_cov_34.539090	351	431	2	5	80	0.0625000
NODE_7530_length_956_cov_34.539090	351	431	3	1	80	0.0125000
NODE_7530_length_956_cov_34.539090	351	431	4	37	80	0.4625000
NODE_7530_length_956_cov_34.539090	351	431	5	8	80	0.1000000
NODE_7530_length_956_cov_34.539090	351	431	6	20	80	0.2500000
NODE_7530_length_956_cov_34.539090	427	507	6	18	80	0.2250000
NODE_7530_length_956_cov_34.539090	427	507	8	8	80	0.1000000
NODE_7530_length_956_cov_34.539090	427	507	9	54	80	0.6750000
NODE_7530_length_956_cov_34.539090	480	560	5	7	80	0.0875000
NODE_7530_length_956_cov_34.539090	480	560	6	6	80	0.0750000
NODE_7530_length_956_cov_34.539090	480	560	7	32	80	0.4000000
NODE_7530_length_956_cov_34.539090	480	560	8	5	80	0.0625000
NODE_7530_length_956_cov_34.539090	480	560	9	30	80	0.3750000
NODE_7531_length_956_cov_24.355893	398	478	1	26	80	0.3250000
NODE_7531_length_956_cov_24.355893	398	478	2	37	80	0.4625000
NODE_7531_length_956_cov_24.355893	398	478	4	13	80	0.1625000
NODE_7531_length_956_cov_24.355893	398	478	6	4	80	0.0500000
NODE_7531_length_956_cov_24.355893	451	531	2	10	80	0.1250000
NODE_7531_length_956_cov_24.355893	451	531	4	13	80	0.1625000
NODE_7531_length_956_cov_24.355893	451	531	6	57	80	0.7125000
NODE_7532_length_956_cov_21.940490	373	453	0	80	80	1.0000000
NODE_7532_length_956_cov_21.940490	426	506	0	76	80	0.9500000
NODE_7532_length_956_cov_21.940490	426	506	1	4	80	0.0500000
NODE_7532_length_956_cov_21.940490	502	582	1	80	80	1.0000000
NODE_7532_length_956_cov_21.940490	555	635	1	48	80	0.6000000
NODE_7532_length_956_cov_21.940490	555	635	2	32	80	0.4000000
NODE_7533_length_956_cov_19.435239	274	354	2	45	80	0.5625000
NODE_7533_length_956_cov_19.435239	274	354	3	32	80	0.4000000
NODE_7533_length_956_cov_19.435239	274	354	4	3	80	0.0375000
NODE_7533_length_956_cov_19.435239	274	301	2	23	27	0.8518519
NODE_7533_length_956_cov_19.435239	274	301	3	1	27	0.0370370
NODE_7533_length_956_cov_19.435239	274	301	4	3	27	0.1111111
NODE_7534_length_956_cov_17.819137	378	458	0	56	80	0.7000000
NODE_7534_length_956_cov_17.819137	378	458	1	24	80	0.3000000
NODE_7534_length_956_cov_17.819137	431	511	0	80	80	1.0000000
NODE_7535_length_956_cov_16.098016	551	631	2	80	80	1.0000000
NODE_7535_length_956_cov_16.098016	604	684	1	3	80	0.0375000
NODE_7535_length_956_cov_16.098016	604	684	2	77	80	0.9625000
NODE_7536_length_956_cov_15.229872	490	570	0	3	80	0.0375000
NODE_7536_length_956_cov_15.229872	490	570	1	77	80	0.9625000
NODE_7536_length_956_cov_15.229872	543	623	0	45	80	0.5625000
NODE_7536_length_956_cov_15.229872	543	623	1	35	80	0.4375000
NODE_7537_length_956_cov_7.533256	439	519	0	80	80	1.0000000
NODE_7537_length_956_cov_7.533256	497	572	0	75	75	1.0000000
NODE_7545_length_955_cov_30.821262	438	518	1	5	80	0.0625000
NODE_7545_length_955_cov_30.821262	438	518	2	75	80	0.9375000
NODE_7545_length_955_cov_30.821262	491	571	1	58	80	0.7250000
NODE_7545_length_955_cov_30.821262	491	571	2	22	80	0.2750000
NODE_7546_length_955_cov_30.574766	380	460	1	14	80	0.1750000
NODE_7546_length_955_cov_30.574766	380	460	3	36	80	0.4500000
NODE_7546_length_955_cov_30.574766	380	460	4	30	80	0.3750000
NODE_7546_length_955_cov_30.574766	433	513	1	47	80	0.5875000
NODE_7546_length_955_cov_30.574766	433	513	2	20	80	0.2500000
NODE_7546_length_955_cov_30.574766	433	513	4	13	80	0.1625000
NODE_7546_length_955_cov_30.574766	509	589	2	18	80	0.2250000
NODE_7546_length_955_cov_30.574766	509	589	3	37	80	0.4625000
NODE_7546_length_955_cov_30.574766	509	589	5	23	80	0.2875000
NODE_7546_length_955_cov_30.574766	509	589	6	2	80	0.0250000
NODE_7546_length_955_cov_30.574766	562	642	3	2	80	0.0250000
NODE_7546_length_955_cov_30.574766	562	642	5	76	80	0.9500000
NODE_7546_length_955_cov_30.574766	562	642	6	2	80	0.0250000
NODE_7547_length_955_cov_27.734813	373	453	3	20	80	0.2500000
NODE_7547_length_955_cov_27.734813	373	453	4	7	80	0.0875000
NODE_7547_length_955_cov_27.734813	373	453	5	27	80	0.3375000
NODE_7547_length_955_cov_27.734813	373	453	6	26	80	0.3250000
NODE_7547_length_955_cov_27.734813	426	506	1	8	80	0.1000000
NODE_7547_length_955_cov_27.734813	426	506	2	24	80	0.3000000
NODE_7547_length_955_cov_27.734813	426	506	3	35	80	0.4375000
NODE_7547_length_955_cov_27.734813	426	506	4	13	80	0.1625000
NODE_7548_length_955_cov_24.475467	439	519	2	4	80	0.0500000
NODE_7548_length_955_cov_24.475467	439	519	3	20	80	0.2500000
NODE_7548_length_955_cov_24.475467	439	519	4	56	80	0.7000000
NODE_7548_length_955_cov_24.475467	492	572	2	54	80	0.6750000
NODE_7548_length_955_cov_24.475467	492	572	3	20	80	0.2500000
NODE_7548_length_955_cov_24.475467	492	572	4	6	80	0.0750000
NODE_7549_length_955_cov_22.146028	351	431	0	66	80	0.8250000
NODE_7549_length_955_cov_22.146028	351	431	2	14	80	0.1750000
NODE_7549_length_955_cov_22.146028	404	484	0	13	80	0.1625000
NODE_7549_length_955_cov_22.146028	404	484	2	67	80	0.8375000
NODE_7550_length_955_cov_16.212617	441	521	3	22	80	0.2750000
NODE_7550_length_955_cov_16.212617	441	521	4	24	80	0.3000000
NODE_7550_length_955_cov_16.212617	441	521	5	34	80	0.4250000
NODE_7550_length_955_cov_16.212617	494	574	3	33	80	0.4125000
NODE_7550_length_955_cov_16.212617	494	574	5	47	80	0.5875000
NODE_7551_length_955_cov_13.334112	269	349	0	80	80	1.0000000
NODE_7551_length_955_cov_13.334112	322	402	0	80	80	1.0000000
NODE_7552_length_955_cov_12.544393	363	443	0	6	80	0.0750000
NODE_7552_length_955_cov_12.544393	363	443	1	74	80	0.9250000
NODE_7552_length_955_cov_12.544393	416	496	1	60	80	0.7500000
NODE_7552_length_955_cov_12.544393	416	496	2	20	80	0.2500000
NODE_7553_length_955_cov_8.204439	358	438	0	80	80	1.0000000
NODE_7553_length_955_cov_8.204439	411	491	0	80	80	1.0000000
NODE_7563_length_954_cov_35.691228	381	461	1	56	80	0.7000000
NODE_7563_length_954_cov_35.691228	381	461	2	24	80	0.3000000
NODE_7563_length_954_cov_35.691228	434	514	1	3	80	0.0375000
NODE_7563_length_954_cov_35.691228	434	514	2	77	80	0.9625000
NODE_7564_length_954_cov_30.769591	408	488	0	21	80	0.2625000
NODE_7564_length_954_cov_30.769591	408	488	1	59	80	0.7375000
NODE_7564_length_954_cov_30.769591	461	541	1	68	80	0.8500000
NODE_7564_length_954_cov_30.769591	461	541	2	12	80	0.1500000
NODE_7565_length_954_cov_27.247953	418	498	2	4	80	0.0500000
NODE_7565_length_954_cov_27.247953	418	498	4	20	80	0.2500000
NODE_7565_length_954_cov_27.247953	418	498	5	2	80	0.0250000
NODE_7565_length_954_cov_27.247953	418	498	6	54	80	0.6750000
NODE_7565_length_954_cov_27.247953	471	551	4	1	80	0.0125000
NODE_7565_length_954_cov_27.247953	471	551	6	79	80	0.9875000
NODE_7566_length_954_cov_22.796491	270	350	0	80	80	1.0000000
NODE_7566_length_954_cov_22.796491	323	403	0	80	80	1.0000000
NODE_7567_length_954_cov_15.645614	337	417	2	26	80	0.3250000
NODE_7567_length_954_cov_15.645614	337	417	3	12	80	0.1500000
NODE_7567_length_954_cov_15.645614	337	417	4	11	80	0.1375000
NODE_7567_length_954_cov_15.645614	337	417	5	31	80	0.3875000
NODE_7567_length_954_cov_15.645614	390	470	3	56	80	0.7000000
NODE_7567_length_954_cov_15.645614	390	470	4	9	80	0.1125000
NODE_7567_length_954_cov_15.645614	390	470	5	15	80	0.1875000
NODE_7568_length_954_cov_13.538012	346	426	0	22	80	0.2750000
NODE_7568_length_954_cov_13.538012	346	426	2	58	80	0.7250000
NODE_7568_length_954_cov_13.538012	399	479	0	23	80	0.2875000
NODE_7568_length_954_cov_13.538012	399	479	2	57	80	0.7125000
NODE_7569_length_954_cov_12.162573	155	217	0	7	62	0.1129032
NODE_7569_length_954_cov_12.162573	155	217	1	23	62	0.3709677
NODE_7569_length_954_cov_12.162573	155	217	2	1	62	0.0161290
NODE_7569_length_954_cov_12.162573	155	217	3	5	62	0.0806452
NODE_7569_length_954_cov_12.162573	155	217	4	2	62	0.0322581
NODE_7569_length_954_cov_12.162573	155	217	6	3	62	0.0483871
NODE_7569_length_954_cov_12.162573	155	217	8	7	62	0.1129032
NODE_7569_length_954_cov_12.162573	155	217	10	5	62	0.0806452
NODE_7569_length_954_cov_12.162573	155	217	11	1	62	0.0161290
NODE_7569_length_954_cov_12.162573	155	217	12	2	62	0.0322581
NODE_7569_length_954_cov_12.162573	155	217	13	6	62	0.0967742
NODE_7570_length_954_cov_10.714620	239	319	4	9	80	0.1125000
NODE_7570_length_954_cov_10.714620	239	319	5	8	80	0.1000000
NODE_7570_length_954_cov_10.714620	239	319	6	26	80	0.3250000
NODE_7570_length_954_cov_10.714620	239	319	7	31	80	0.3875000
NODE_7570_length_954_cov_10.714620	239	319	8	6	80	0.0750000
NODE_7570_length_954_cov_10.714620	292	372	7	21	80	0.2625000
NODE_7570_length_954_cov_10.714620	292	372	8	59	80	0.7375000
NODE_7571_length_954_cov_5.670175	431	511	0	80	80	1.0000000
NODE_7571_length_954_cov_5.670175	484	564	0	80	80	1.0000000
NODE_7582_length_953_cov_35.789227	425	505	8	1	80	0.0125000
NODE_7582_length_953_cov_35.789227	425	505	9	71	80	0.8875000
NODE_7582_length_953_cov_35.789227	425	505	10	8	80	0.1000000
NODE_7582_length_953_cov_35.789227	478	558	4	1	80	0.0125000
NODE_7582_length_953_cov_35.789227	478	558	5	10	80	0.1250000
NODE_7582_length_953_cov_35.789227	478	558	6	2	80	0.0250000
NODE_7582_length_953_cov_35.789227	478	558	8	11	80	0.1375000
NODE_7582_length_953_cov_35.789227	478	558	9	56	80	0.7000000
NODE_7583_length_953_cov_33.940281	430	510	6	80	80	1.0000000
NODE_7583_length_953_cov_33.940281	483	563	2	31	80	0.3875000
NODE_7583_length_953_cov_33.940281	483	563	3	6	80	0.0750000
NODE_7583_length_953_cov_33.940281	483	563	4	1	80	0.0125000
NODE_7583_length_953_cov_33.940281	483	563	6	42	80	0.5250000
NODE_7584_length_953_cov_26.844262	333	413	0	80	80	1.0000000
NODE_7584_length_953_cov_26.844262	386	466	0	67	80	0.8375000
NODE_7584_length_953_cov_26.844262	386	466	2	13	80	0.1625000
NODE_7584_length_953_cov_26.844262	462	542	2	80	80	1.0000000
NODE_7584_length_953_cov_26.844262	515	595	2	80	80	1.0000000
NODE_7585_length_953_cov_20.770492	301	381	1	20	80	0.2500000
NODE_7585_length_953_cov_20.770492	301	381	2	60	80	0.7500000
NODE_7585_length_953_cov_20.770492	354	434	2	80	80	1.0000000
NODE_7586_length_953_cov_17.514052	421	501	1	19	80	0.2375000
NODE_7586_length_953_cov_17.514052	421	501	2	48	80	0.6000000
NODE_7586_length_953_cov_17.514052	421	501	3	13	80	0.1625000
NODE_7586_length_953_cov_17.514052	474	554	1	37	80	0.4625000
NODE_7586_length_953_cov_17.514052	474	554	2	43	80	0.5375000
NODE_7586_length_953_cov_17.514052	550	630	1	30	80	0.3750000
NODE_7586_length_953_cov_17.514052	550	630	2	19	80	0.2375000
NODE_7586_length_953_cov_17.514052	550	630	3	17	80	0.2125000
NODE_7586_length_953_cov_17.514052	550	630	4	14	80	0.1750000
NODE_7586_length_953_cov_17.514052	603	683	2	13	80	0.1625000
NODE_7586_length_953_cov_17.514052	603	683	4	67	80	0.8375000
NODE_7587_length_953_cov_11.579625	332	412	0	80	80	1.0000000
NODE_7587_length_953_cov_11.579625	385	465	0	80	80	1.0000000
NODE_7588_length_953_cov_7.281030	276	356	0	80	80	1.0000000
NODE_7588_length_953_cov_7.281030	329	409	0	27	80	0.3375000
NODE_7588_length_953_cov_7.281030	329	409	1	53	80	0.6625000
NODE_7599_length_952_cov_44.880422	447	527	0	14	80	0.1750000
NODE_7599_length_952_cov_44.880422	447	527	1	4	80	0.0500000
NODE_7599_length_952_cov_44.880422	447	527	2	62	80	0.7750000
NODE_7599_length_952_cov_44.880422	500	580	2	80	80	1.0000000
NODE_7599_length_952_cov_44.880422	871	951	0	80	80	1.0000000
NODE_7600_length_952_cov_42.485346	402	482	0	80	80	1.0000000
NODE_7600_length_952_cov_42.485346	455	535	0	80	80	1.0000000
NODE_7601_length_952_cov_40.065651	422	502	4	80	80	1.0000000
NODE_7601_length_952_cov_40.065651	475	555	0	13	80	0.1625000
NODE_7601_length_952_cov_40.065651	475	555	1	3	80	0.0375000
NODE_7601_length_952_cov_40.065651	475	555	2	20	80	0.2500000
NODE_7601_length_952_cov_40.065651	475	555	3	6	80	0.0750000
NODE_7601_length_952_cov_40.065651	475	555	4	38	80	0.4750000
NODE_7602_length_952_cov_34.813599	308	388	1	13	80	0.1625000
NODE_7602_length_952_cov_34.813599	308	388	2	67	80	0.8375000
NODE_7602_length_952_cov_34.813599	361	441	0	37	80	0.4625000
NODE_7602_length_952_cov_34.813599	361	441	1	29	80	0.3625000
NODE_7602_length_952_cov_34.813599	361	441	2	14	80	0.1750000
NODE_7603_length_952_cov_28.055100	661	741	0	56	80	0.7000000
NODE_7603_length_952_cov_28.055100	661	741	1	24	80	0.3000000
NODE_7603_length_952_cov_28.055100	714	794	0	80	80	1.0000000
NODE_7604_length_952_cov_23.739742	435	515	0	3	80	0.0375000
NODE_7604_length_952_cov_23.739742	435	515	2	77	80	0.9625000
NODE_7604_length_952_cov_23.739742	488	568	0	43	80	0.5375000
NODE_7604_length_952_cov_23.739742	488	568	2	37	80	0.4625000
NODE_7606_length_952_cov_11.478312	245	324	0	3	79	0.0379747
NODE_7606_length_952_cov_11.478312	245	324	1	8	79	0.1012658
NODE_7606_length_952_cov_11.478312	245	324	3	7	79	0.0886076
NODE_7606_length_952_cov_11.478312	245	324	4	8	79	0.1012658
NODE_7606_length_952_cov_11.478312	245	324	6	53	79	0.6708861
NODE_7606_length_952_cov_11.478312	297	377	6	80	80	1.0000000
NODE_7607_length_952_cov_11.284877	272	352	0	80	80	1.0000000
NODE_7607_length_952_cov_11.284877	325	405	0	80	80	1.0000000
NODE_7608_length_952_cov_10.807737	458	538	3	80	80	1.0000000
NODE_7608_length_952_cov_10.807737	511	591	0	31	80	0.3875000
NODE_7608_length_952_cov_10.807737	511	591	1	4	80	0.0500000
NODE_7608_length_952_cov_10.807737	511	591	2	9	80	0.1125000
NODE_7608_length_952_cov_10.807737	511	591	3	36	80	0.4500000
NODE_7609_length_952_cov_8.770223	375	455	2	80	80	1.0000000
NODE_7609_length_952_cov_8.770223	428	508	0	51	80	0.6375000
NODE_7609_length_952_cov_8.770223	428	508	2	29	80	0.3625000
NODE_7623_length_951_cov_54.397887	354	434	0	28	80	0.3500000
NODE_7623_length_951_cov_54.397887	354	434	2	24	80	0.3000000
NODE_7623_length_951_cov_54.397887	354	434	3	28	80	0.3500000
NODE_7623_length_951_cov_54.397887	407	487	3	40	80	0.5000000
NODE_7623_length_951_cov_54.397887	407	487	4	31	80	0.3875000
NODE_7623_length_951_cov_54.397887	407	487	5	9	80	0.1125000
NODE_7623_length_951_cov_54.397887	483	563	5	19	80	0.2375000
NODE_7623_length_951_cov_54.397887	483	563	6	1	80	0.0125000
NODE_7623_length_951_cov_54.397887	483	563	7	2	80	0.0250000
NODE_7623_length_951_cov_54.397887	483	563	8	31	80	0.3875000
NODE_7623_length_951_cov_54.397887	483	563	9	27	80	0.3375000
NODE_7623_length_951_cov_54.397887	544	616	4	1	72	0.0138889
NODE_7623_length_951_cov_54.397887	544	616	5	3	72	0.0416667
NODE_7623_length_951_cov_54.397887	544	616	6	2	72	0.0277778
NODE_7623_length_951_cov_54.397887	544	616	7	13	72	0.1805556
NODE_7623_length_951_cov_54.397887	544	616	8	41	72	0.5694444
NODE_7623_length_951_cov_54.397887	544	616	9	12	72	0.1666667
NODE_7624_length_951_cov_47.881455	355	435	0	76	80	0.9500000
NODE_7624_length_951_cov_47.881455	355	435	1	4	80	0.0500000
NODE_7624_length_951_cov_47.881455	408	488	0	23	80	0.2875000
NODE_7624_length_951_cov_47.881455	408	488	1	53	80	0.6625000
NODE_7624_length_951_cov_47.881455	408	488	2	4	80	0.0500000
NODE_7624_length_951_cov_47.881455	484	564	2	80	80	1.0000000
NODE_7624_length_951_cov_47.881455	537	617	1	36	80	0.4500000
NODE_7624_length_951_cov_47.881455	537	617	2	44	80	0.5500000
NODE_7625_length_951_cov_24.322770	479	559	7	32	80	0.4000000
NODE_7625_length_951_cov_24.322770	479	559	8	48	80	0.6000000
NODE_7625_length_951_cov_24.322770	532	612	4	25	80	0.3125000
NODE_7625_length_951_cov_24.322770	532	612	5	7	80	0.0875000
NODE_7625_length_951_cov_24.322770	532	612	6	5	80	0.0625000
NODE_7625_length_951_cov_24.322770	532	612	7	13	80	0.1625000
NODE_7625_length_951_cov_24.322770	532	612	8	30	80	0.3750000
NODE_7626_length_951_cov_23.001174	470	550	1	63	80	0.7875000
NODE_7626_length_951_cov_23.001174	470	550	2	17	80	0.2125000
NODE_7626_length_951_cov_23.001174	523	603	1	25	80	0.3125000
NODE_7626_length_951_cov_23.001174	523	603	2	55	80	0.6875000
NODE_7627_length_951_cov_22.059859	562	642	0	57	80	0.7125000
NODE_7627_length_951_cov_22.059859	562	642	2	23	80	0.2875000
NODE_7627_length_951_cov_22.059859	615	695	0	4	80	0.0500000
NODE_7627_length_951_cov_22.059859	615	695	2	76	80	0.9500000
NODE_7628_length_951_cov_19.413146	456	536	1	44	80	0.5500000
NODE_7628_length_951_cov_19.413146	456	536	2	17	80	0.2125000
NODE_7628_length_951_cov_19.413146	456	536	4	19	80	0.2375000
NODE_7628_length_951_cov_19.413146	509	589	2	8	80	0.1000000
NODE_7628_length_951_cov_19.413146	509	589	3	15	80	0.1875000
NODE_7628_length_951_cov_19.413146	509	589	4	57	80	0.7125000
NODE_7628_length_951_cov_19.413146	830	877	0	47	47	1.0000000
NODE_7629_length_951_cov_18.970657	384	464	1	51	80	0.6375000
NODE_7629_length_951_cov_18.970657	384	464	2	29	80	0.3625000
NODE_7629_length_951_cov_18.970657	437	517	1	59	80	0.7375000
NODE_7629_length_951_cov_18.970657	437	517	2	21	80	0.2625000
NODE_7629_length_951_cov_18.970657	513	593	0	14	80	0.1750000
NODE_7629_length_951_cov_18.970657	513	593	1	66	80	0.8250000
NODE_7629_length_951_cov_18.970657	566	646	0	67	80	0.8375000
NODE_7629_length_951_cov_18.970657	566	646	1	13	80	0.1625000
NODE_7630_length_951_cov_17.164319	409	490	1	15	81	0.1851852
NODE_7630_length_951_cov_17.164319	409	490	2	66	81	0.8148148
NODE_7630_length_951_cov_17.164319	463	543	2	80	80	1.0000000
NODE_7631_length_951_cov_17.009390	393	473	3	80	80	1.0000000
NODE_7631_length_951_cov_17.009390	446	526	2	4	80	0.0500000
NODE_7631_length_951_cov_17.009390	446	526	3	76	80	0.9500000
NODE_7632_length_951_cov_15.551643	520	600	0	66	80	0.8250000
NODE_7632_length_951_cov_15.551643	520	600	2	14	80	0.1750000
NODE_7632_length_951_cov_15.551643	573	653	0	13	80	0.1625000
NODE_7632_length_951_cov_15.551643	573	653	2	67	80	0.8375000
NODE_7633_length_951_cov_13.562207	364	444	0	64	80	0.8000000
NODE_7633_length_951_cov_13.562207	364	444	1	16	80	0.2000000
NODE_7633_length_951_cov_13.562207	417	497	0	11	80	0.1375000
NODE_7633_length_951_cov_13.562207	417	497	1	69	80	0.8625000
NODE_7634_length_951_cov_13.086854	450	530	0	80	80	1.0000000
NODE_7634_length_951_cov_13.086854	503	583	0	69	80	0.8625000
NODE_7634_length_951_cov_13.086854	503	583	2	11	80	0.1375000
NODE_7635_length_951_cov_6.812207	350	430	2	14	80	0.1750000
NODE_7635_length_951_cov_6.812207	350	430	3	35	80	0.4375000
NODE_7635_length_951_cov_6.812207	350	430	4	31	80	0.3875000
NODE_7635_length_951_cov_6.812207	403	483	0	6	80	0.0750000
NODE_7635_length_951_cov_6.812207	403	483	2	37	80	0.4625000
NODE_7635_length_951_cov_6.812207	403	483	3	37	80	0.4625000
NODE_7636_length_951_cov_5.076291	80	160	0	5	80	0.0625000
NODE_7636_length_951_cov_5.076291	80	160	1	75	80	0.9375000
NODE_7636_length_951_cov_5.076291	133	213	1	80	80	1.0000000
NODE_7649_length_950_cov_62.151586	731	794	20	2	63	0.0317460
NODE_7649_length_950_cov_62.151586	731	794	21	3	63	0.0476190
NODE_7649_length_950_cov_62.151586	731	794	22	11	63	0.1746032
NODE_7649_length_950_cov_62.151586	731	794	23	9	63	0.1428571
NODE_7649_length_950_cov_62.151586	731	794	24	1	63	0.0158730
NODE_7649_length_950_cov_62.151586	731	794	25	6	63	0.0952381
NODE_7649_length_950_cov_62.151586	731	794	26	4	63	0.0634921
NODE_7649_length_950_cov_62.151586	731	794	27	2	63	0.0317460
NODE_7649_length_950_cov_62.151586	731	794	28	2	63	0.0317460
NODE_7649_length_950_cov_62.151586	731	794	29	1	63	0.0158730
NODE_7649_length_950_cov_62.151586	731	794	30	3	63	0.0476190
NODE_7649_length_950_cov_62.151586	731	794	31	1	63	0.0158730
NODE_7649_length_950_cov_62.151586	731	794	32	5	63	0.0793651
NODE_7649_length_950_cov_62.151586	731	794	33	1	63	0.0158730
NODE_7649_length_950_cov_62.151586	731	794	34	1	63	0.0158730
NODE_7649_length_950_cov_62.151586	731	794	35	1	63	0.0158730
NODE_7649_length_950_cov_62.151586	731	794	37	1	63	0.0158730
NODE_7649_length_950_cov_62.151586	731	794	39	2	63	0.0317460
NODE_7649_length_950_cov_62.151586	731	794	42	1	63	0.0158730
NODE_7649_length_950_cov_62.151586	731	794	43	2	63	0.0317460
NODE_7649_length_950_cov_62.151586	731	794	44	1	63	0.0158730
NODE_7649_length_950_cov_62.151586	731	794	46	1	63	0.0158730
NODE_7649_length_950_cov_62.151586	731	794	48	2	63	0.0317460
NODE_7650_length_950_cov_56.088132	354	434	0	59	80	0.7375000
NODE_7650_length_950_cov_56.088132	354	434	1	12	80	0.1500000
NODE_7650_length_950_cov_56.088132	354	434	2	9	80	0.1125000
NODE_7650_length_950_cov_56.088132	407	487	0	6	80	0.0750000
NODE_7650_length_950_cov_56.088132	407	487	1	12	80	0.1500000
NODE_7650_length_950_cov_56.088132	407	487	2	16	80	0.2000000
NODE_7650_length_950_cov_56.088132	407	487	3	28	80	0.3500000
NODE_7650_length_950_cov_56.088132	407	487	5	2	80	0.0250000
NODE_7650_length_950_cov_56.088132	407	487	6	16	80	0.2000000
NODE_7650_length_950_cov_56.088132	483	563	6	13	80	0.1625000
NODE_7650_length_950_cov_56.088132	483	563	7	10	80	0.1250000
NODE_7650_length_950_cov_56.088132	483	563	8	16	80	0.2000000
NODE_7650_length_950_cov_56.088132	483	563	10	7	80	0.0875000
NODE_7650_length_950_cov_56.088132	483	563	11	34	80	0.4250000
NODE_7650_length_950_cov_56.088132	536	616	7	25	80	0.3125000
NODE_7650_length_950_cov_56.088132	536	616	8	16	80	0.2000000
NODE_7650_length_950_cov_56.088132	536	616	9	2	80	0.0250000
NODE_7650_length_950_cov_56.088132	536	616	10	3	80	0.0375000
NODE_7650_length_950_cov_56.088132	536	616	11	34	80	0.4250000
NODE_7651_length_950_cov_29.780259	501	581	3	7	80	0.0875000
NODE_7651_length_950_cov_29.780259	501	581	4	7	80	0.0875000
NODE_7651_length_950_cov_29.780259	501	581	5	41	80	0.5125000
NODE_7651_length_950_cov_29.780259	501	581	6	25	80	0.3125000
NODE_7651_length_950_cov_29.780259	554	634	2	8	80	0.1000000
NODE_7651_length_950_cov_29.780259	554	634	3	52	80	0.6500000
NODE_7651_length_950_cov_29.780259	554	634	4	7	80	0.0875000
NODE_7651_length_950_cov_29.780259	554	634	5	13	80	0.1625000
NODE_7652_length_950_cov_27.278496	388	468	4	27	80	0.3375000
NODE_7652_length_950_cov_27.278496	388	468	5	42	80	0.5250000
NODE_7652_length_950_cov_27.278496	388	468	7	11	80	0.1375000
NODE_7652_length_950_cov_27.278496	441	519	3	6	78	0.0769231
NODE_7652_length_950_cov_27.278496	441	519	4	72	78	0.9230769
NODE_7653_length_950_cov_26.766157	322	402	0	7	80	0.0875000
NODE_7653_length_950_cov_26.766157	322	402	2	73	80	0.9125000
NODE_7653_length_950_cov_26.766157	375	455	2	80	80	1.0000000
NODE_7653_length_950_cov_26.766157	451	531	0	72	80	0.9000000
NODE_7653_length_950_cov_26.766157	451	531	2	8	80	0.1000000
NODE_7653_length_950_cov_26.766157	504	584	0	80	80	1.0000000
NODE_7654_length_950_cov_19.638073	421	501	0	18	80	0.2250000
NODE_7654_length_950_cov_19.638073	421	501	1	19	80	0.2375000
NODE_7654_length_950_cov_19.638073	421	501	2	43	80	0.5375000
NODE_7654_length_950_cov_19.638073	474	554	2	80	80	1.0000000
NODE_7654_length_950_cov_19.638073	550	630	2	15	80	0.1875000
NODE_7654_length_950_cov_19.638073	550	630	3	22	80	0.2750000
NODE_7654_length_950_cov_19.638073	550	630	4	38	80	0.4750000
NODE_7654_length_950_cov_19.638073	550	630	5	5	80	0.0625000
NODE_7654_length_950_cov_19.638073	603	683	3	28	80	0.3500000
NODE_7654_length_950_cov_19.638073	603	683	4	52	80	0.6500000
NODE_7655_length_950_cov_14.686251	376	456	2	9	80	0.1125000
NODE_7655_length_950_cov_14.686251	376	456	3	22	80	0.2750000
NODE_7655_length_950_cov_14.686251	376	456	4	22	80	0.2750000
NODE_7655_length_950_cov_14.686251	376	456	5	27	80	0.3375000
NODE_7655_length_950_cov_14.686251	429	509	5	50	80	0.6250000
NODE_7655_length_950_cov_14.686251	429	509	6	30	80	0.3750000
NODE_7656_length_950_cov_14.215041	339	419	3	2	80	0.0250000
NODE_7656_length_950_cov_14.215041	339	419	4	14	80	0.1750000
NODE_7656_length_950_cov_14.215041	339	419	5	30	80	0.3750000
NODE_7656_length_950_cov_14.215041	339	419	6	34	80	0.4250000
NODE_7656_length_950_cov_14.215041	392	472	1	26	80	0.3250000
NODE_7656_length_950_cov_14.215041	392	472	2	6	80	0.0750000
NODE_7656_length_950_cov_14.215041	392	472	3	8	80	0.1000000
NODE_7656_length_950_cov_14.215041	392	472	5	40	80	0.5000000
NODE_7657_length_950_cov_6.397180	370	450	0	80	80	1.0000000
NODE_7657_length_950_cov_6.397180	423	504	0	81	81	1.0000000
NODE_7659_length_950_cov_4.430082	594	674	0	47	80	0.5875000
NODE_7659_length_950_cov_4.430082	594	674	1	33	80	0.4125000
NODE_7659_length_950_cov_4.430082	647	727	1	42	80	0.5250000
NODE_7659_length_950_cov_4.430082	647	727	2	38	80	0.4750000
NODE_7672_length_949_cov_25.550588	371	451	0	7	80	0.0875000
NODE_7672_length_949_cov_25.550588	371	451	2	73	80	0.9125000
NODE_7672_length_949_cov_25.550588	500	580	0	27	80	0.3375000
NODE_7672_length_949_cov_25.550588	500	580	2	53	80	0.6625000
NODE_7672_length_949_cov_25.550588	553	633	0	2	80	0.0250000
NODE_7672_length_949_cov_25.550588	553	633	2	78	80	0.9750000
NODE_7673_length_949_cov_20.949412	252	332	4	65	80	0.8125000
NODE_7673_length_949_cov_20.949412	252	332	5	15	80	0.1875000
NODE_7673_length_949_cov_20.949412	305	385	2	6	80	0.0750000
NODE_7673_length_949_cov_20.949412	305	385	4	12	80	0.1500000
NODE_7673_length_949_cov_20.949412	305	385	5	33	80	0.4125000
NODE_7673_length_949_cov_20.949412	305	385	6	29	80	0.3625000
NODE_7674_length_949_cov_20.601176	364	444	0	80	80	1.0000000
NODE_7674_length_949_cov_20.601176	417	497	0	80	80	1.0000000
NODE_7674_length_949_cov_20.601176	493	573	0	80	80	1.0000000
NODE_7674_length_949_cov_20.601176	546	626	0	80	80	1.0000000
NODE_7675_length_949_cov_20.575294	481	561	1	51	80	0.6375000
NODE_7675_length_949_cov_20.575294	481	561	2	8	80	0.1000000
NODE_7675_length_949_cov_20.575294	481	561	3	21	80	0.2625000
NODE_7675_length_949_cov_20.575294	534	614	2	6	80	0.0750000
NODE_7675_length_949_cov_20.575294	534	614	3	23	80	0.2875000
NODE_7675_length_949_cov_20.575294	534	614	4	51	80	0.6375000
NODE_7676_length_949_cov_19.483529	340	420	0	80	80	1.0000000
NODE_7676_length_949_cov_19.483529	393	473	0	80	80	1.0000000
NODE_7676_length_949_cov_19.483529	469	549	0	80	80	1.0000000
NODE_7676_length_949_cov_19.483529	522	602	0	80	80	1.0000000
NODE_7677_length_949_cov_19.407059	433	513	0	80	80	1.0000000
NODE_7677_length_949_cov_19.407059	486	566	0	80	80	1.0000000
NODE_7677_length_949_cov_19.407059	562	642	0	80	80	1.0000000
NODE_7677_length_949_cov_19.407059	615	695	0	80	80	1.0000000
NODE_7678_length_949_cov_10.903529	561	641	7	14	80	0.1750000
NODE_7678_length_949_cov_10.903529	561	641	8	16	80	0.2000000
NODE_7678_length_949_cov_10.903529	561	641	9	17	80	0.2125000
NODE_7678_length_949_cov_10.903529	561	641	10	10	80	0.1250000
NODE_7678_length_949_cov_10.903529	561	641	11	21	80	0.2625000
NODE_7678_length_949_cov_10.903529	561	641	12	2	80	0.0250000
NODE_7678_length_949_cov_10.903529	614	694	7	21	80	0.2625000
NODE_7678_length_949_cov_10.903529	614	694	8	30	80	0.3750000
NODE_7678_length_949_cov_10.903529	614	694	9	29	80	0.3625000
NODE_7679_length_949_cov_7.245882	0	71	0	71	71	1.0000000
NODE_7679_length_949_cov_7.245882	0	71	0	71	71	1.0000000
NODE_7679_length_949_cov_7.245882	44	124	0	80	80	1.0000000
NODE_7680_length_949_cov_6.998824	494	574	1	21	80	0.2625000
NODE_7680_length_949_cov_6.998824	494	574	3	59	80	0.7375000
NODE_7680_length_949_cov_6.998824	547	627	3	72	80	0.9000000
NODE_7680_length_949_cov_6.998824	547	627	4	8	80	0.1000000
NODE_7702_length_948_cov_37.201413	510	590	1	58	80	0.7250000
NODE_7702_length_948_cov_37.201413	510	590	2	22	80	0.2750000
NODE_7702_length_948_cov_37.201413	563	643	1	5	80	0.0625000
NODE_7702_length_948_cov_37.201413	563	643	2	75	80	0.9375000
NODE_7703_length_948_cov_20.082450	58	99	0	41	41	1.0000000
NODE_7703_length_948_cov_20.082450	113	193	7	20	80	0.2500000
NODE_7703_length_948_cov_20.082450	113	193	8	9	80	0.1125000
NODE_7703_length_948_cov_20.082450	113	193	9	3	80	0.0375000
NODE_7703_length_948_cov_20.082450	113	193	11	24	80	0.3000000
NODE_7703_length_948_cov_20.082450	113	193	12	18	80	0.2250000
NODE_7703_length_948_cov_20.082450	113	193	13	6	80	0.0750000
NODE_7703_length_948_cov_20.082450	166	246	6	4	80	0.0500000
NODE_7703_length_948_cov_20.082450	166	246	7	4	80	0.0500000
NODE_7703_length_948_cov_20.082450	166	246	8	17	80	0.2125000
NODE_7703_length_948_cov_20.082450	166	246	9	2	80	0.0250000
NODE_7703_length_948_cov_20.082450	166	246	10	18	80	0.2250000
NODE_7703_length_948_cov_20.082450	166	246	11	5	80	0.0625000
NODE_7703_length_948_cov_20.082450	166	246	12	24	80	0.3000000
NODE_7703_length_948_cov_20.082450	166	246	13	6	80	0.0750000
NODE_7704_length_948_cov_16.785630	308	388	5	15	80	0.1875000
NODE_7704_length_948_cov_16.785630	308	388	6	25	80	0.3125000
NODE_7704_length_948_cov_16.785630	308	388	7	40	80	0.5000000
NODE_7704_length_948_cov_16.785630	361	441	5	12	80	0.1500000
NODE_7704_length_948_cov_16.785630	361	441	6	1	80	0.0125000
NODE_7704_length_948_cov_16.785630	361	441	7	67	80	0.8375000
NODE_7704_length_948_cov_16.785630	437	517	1	14	80	0.1750000
NODE_7704_length_948_cov_16.785630	437	517	2	16	80	0.2000000
NODE_7704_length_948_cov_16.785630	437	517	3	14	80	0.1750000
NODE_7704_length_948_cov_16.785630	437	517	4	26	80	0.3250000
NODE_7704_length_948_cov_16.785630	437	517	5	10	80	0.1250000
NODE_7704_length_948_cov_16.785630	490	570	1	67	80	0.8375000
NODE_7704_length_948_cov_16.785630	490	570	2	13	80	0.1625000
NODE_7705_length_948_cov_12.740872	400	480	1	1	80	0.0125000
NODE_7705_length_948_cov_12.740872	400	480	3	11	80	0.1375000
NODE_7705_length_948_cov_12.740872	400	480	5	68	80	0.8500000
NODE_7705_length_948_cov_12.740872	453	533	1	32	80	0.4000000
NODE_7705_length_948_cov_12.740872	453	533	2	22	80	0.2750000
NODE_7705_length_948_cov_12.740872	453	533	3	11	80	0.1375000
NODE_7705_length_948_cov_12.740872	453	533	5	15	80	0.1875000
NODE_7706_length_948_cov_10.220259	465	545	0	80	80	1.0000000
NODE_7706_length_948_cov_10.220259	518	598	0	80	80	1.0000000
NODE_7707_length_948_cov_8.504122	456	536	0	47	80	0.5875000
NODE_7707_length_948_cov_8.504122	456	536	2	33	80	0.4125000
NODE_7707_length_948_cov_8.504122	509	589	2	80	80	1.0000000
NODE_7709_length_948_cov_5.425206	641	721	0	80	80	1.0000000
NODE_7709_length_948_cov_5.425206	694	774	0	80	80	1.0000000
NODE_7711_length_948_cov_3.586572	696	776	0	80	80	1.0000000
NODE_7715_length_948_cov_2.786808	259	324	0	65	65	1.0000000
NODE_7715_length_948_cov_2.786808	297	377	0	53	80	0.6625000
NODE_7715_length_948_cov_2.786808	297	377	2	27	80	0.3375000
NODE_7721_length_947_cov_91.466981	393	473	5	9	80	0.1125000
NODE_7721_length_947_cov_91.466981	393	473	7	25	80	0.3125000
NODE_7721_length_947_cov_91.466981	393	473	8	43	80	0.5375000
NODE_7721_length_947_cov_91.466981	393	473	9	3	80	0.0375000
NODE_7721_length_947_cov_91.466981	446	526	6	19	80	0.2375000
NODE_7721_length_947_cov_91.466981	446	526	7	6	80	0.0750000
NODE_7721_length_947_cov_91.466981	446	526	8	45	80	0.5625000
NODE_7721_length_947_cov_91.466981	446	526	9	10	80	0.1250000
NODE_7722_length_947_cov_61.139151	402	482	1	21	80	0.2625000
NODE_7722_length_947_cov_61.139151	402	482	2	40	80	0.5000000
NODE_7722_length_947_cov_61.139151	402	482	3	6	80	0.0750000
NODE_7722_length_947_cov_61.139151	402	482	4	13	80	0.1625000
NODE_7722_length_947_cov_61.139151	455	535	2	8	80	0.1000000
NODE_7722_length_947_cov_61.139151	455	535	3	6	80	0.0750000
NODE_7722_length_947_cov_61.139151	455	535	4	21	80	0.2625000
NODE_7722_length_947_cov_61.139151	455	535	5	37	80	0.4625000
NODE_7722_length_947_cov_61.139151	455	535	6	8	80	0.1000000
NODE_7723_length_947_cov_50.009434	488	568	2	29	80	0.3625000
NODE_7723_length_947_cov_50.009434	488	568	4	51	80	0.6375000
NODE_7723_length_947_cov_50.009434	541	621	0	45	80	0.5625000
NODE_7723_length_947_cov_50.009434	541	621	2	35	80	0.4375000
NODE_7724_length_947_cov_36.271226	511	591	4	10	80	0.1250000
NODE_7724_length_947_cov_36.271226	511	591	5	15	80	0.1875000
NODE_7724_length_947_cov_36.271226	511	591	6	55	80	0.6875000
NODE_7724_length_947_cov_36.271226	564	644	4	28	80	0.3500000
NODE_7724_length_947_cov_36.271226	564	644	6	52	80	0.6500000
NODE_7725_length_947_cov_23.384434	425	505	1	20	80	0.2500000
NODE_7725_length_947_cov_23.384434	425	505	2	35	80	0.4375000
NODE_7725_length_947_cov_23.384434	425	505	3	18	80	0.2250000
NODE_7725_length_947_cov_23.384434	425	505	4	7	80	0.0875000
NODE_7725_length_947_cov_23.384434	478	558	2	2	80	0.0250000
NODE_7725_length_947_cov_23.384434	478	558	3	70	80	0.8750000
NODE_7725_length_947_cov_23.384434	478	558	4	8	80	0.1000000
NODE_7726_length_947_cov_19.103774	316	396	6	80	80	1.0000000
NODE_7726_length_947_cov_19.103774	369	449	1	11	80	0.1375000
NODE_7726_length_947_cov_19.103774	369	449	2	10	80	0.1250000
NODE_7726_length_947_cov_19.103774	369	449	3	1	80	0.0125000
NODE_7726_length_947_cov_19.103774	369	449	4	18	80	0.2250000
NODE_7726_length_947_cov_19.103774	369	449	5	4	80	0.0500000
NODE_7726_length_947_cov_19.103774	369	449	6	33	80	0.4125000
NODE_7726_length_947_cov_19.103774	369	449	7	3	80	0.0375000
NODE_7727_length_947_cov_18.853774	516	596	3	22	80	0.2750000
NODE_7727_length_947_cov_18.853774	516	596	4	44	80	0.5500000
NODE_7727_length_947_cov_18.853774	516	596	6	14	80	0.1750000
NODE_7727_length_947_cov_18.853774	569	649	4	48	80	0.6000000
NODE_7727_length_947_cov_18.853774	569	649	5	5	80	0.0625000
NODE_7727_length_947_cov_18.853774	569	649	6	27	80	0.3375000
NODE_7728_length_947_cov_18.077830	315	395	0	31	80	0.3875000
NODE_7728_length_947_cov_18.077830	315	395	1	49	80	0.6125000
NODE_7728_length_947_cov_18.077830	368	448	1	55	80	0.6875000
NODE_7728_length_947_cov_18.077830	368	448	2	25	80	0.3125000
NODE_7729_length_947_cov_17.713443	403	483	0	16	80	0.2000000
NODE_7729_length_947_cov_17.713443	403	483	2	64	80	0.8000000
NODE_7729_length_947_cov_17.713443	456	536	0	21	80	0.2625000
NODE_7729_length_947_cov_17.713443	456	536	2	59	80	0.7375000
NODE_7730_length_947_cov_14.492925	358	438	0	80	80	1.0000000
NODE_7730_length_947_cov_14.492925	411	491	0	37	80	0.4625000
NODE_7730_length_947_cov_14.492925	411	491	2	43	80	0.5375000
NODE_7730_length_947_cov_14.492925	487	567	2	80	80	1.0000000
NODE_7730_length_947_cov_14.492925	540	620	1	3	80	0.0375000
NODE_7730_length_947_cov_14.492925	540	620	2	67	80	0.8375000
NODE_7730_length_947_cov_14.492925	540	620	3	10	80	0.1250000
NODE_7731_length_947_cov_10.573113	550	630	0	80	80	1.0000000
NODE_7731_length_947_cov_10.573113	603	683	0	80	80	1.0000000
NODE_7732_length_947_cov_7.762972	550	630	2	10	80	0.1250000
NODE_7732_length_947_cov_7.762972	550	630	3	35	80	0.4375000
NODE_7732_length_947_cov_7.762972	550	630	4	32	80	0.4000000
NODE_7732_length_947_cov_7.762972	550	630	5	3	80	0.0375000
NODE_7732_length_947_cov_7.762972	607	683	2	63	76	0.8289474
NODE_7732_length_947_cov_7.762972	607	683	3	13	76	0.1710526
NODE_7747_length_946_cov_39.726092	378	458	2	11	80	0.1375000
NODE_7747_length_946_cov_39.726092	378	458	3	69	80	0.8625000
NODE_7747_length_946_cov_39.726092	431	511	0	34	80	0.4250000
NODE_7747_length_946_cov_39.726092	431	511	1	6	80	0.0750000
NODE_7747_length_946_cov_39.726092	431	511	2	24	80	0.3000000
NODE_7747_length_946_cov_39.726092	431	511	3	16	80	0.2000000
NODE_7747_length_946_cov_39.726092	507	587	0	80	80	1.0000000
NODE_7747_length_946_cov_39.726092	560	640	0	80	80	1.0000000
NODE_7748_length_946_cov_32.728453	404	484	2	26	80	0.3250000
NODE_7748_length_946_cov_32.728453	404	484	3	54	80	0.6750000
NODE_7748_length_946_cov_32.728453	457	537	0	2	80	0.0250000
NODE_7748_length_946_cov_32.728453	457	537	1	6	80	0.0750000
NODE_7748_length_946_cov_32.728453	457	537	2	71	80	0.8875000
NODE_7748_length_946_cov_32.728453	457	537	3	1	80	0.0125000
NODE_7749_length_946_cov_27.548996	280	360	5	40	80	0.5000000
NODE_7749_length_946_cov_27.548996	280	360	6	40	80	0.5000000
NODE_7749_length_946_cov_27.548996	333	413	2	32	80	0.4000000
NODE_7749_length_946_cov_27.548996	333	413	3	6	80	0.0750000
NODE_7749_length_946_cov_27.548996	333	413	4	14	80	0.1750000
NODE_7749_length_946_cov_27.548996	333	413	5	20	80	0.2500000
NODE_7749_length_946_cov_27.548996	333	413	6	8	80	0.1000000
NODE_7750_length_946_cov_24.622196	352	432	0	33	80	0.4125000
NODE_7750_length_946_cov_24.622196	352	432	2	47	80	0.5875000
NODE_7750_length_946_cov_24.622196	405	486	2	81	81	1.0000000
NODE_7751_length_946_cov_18.082645	492	572	2	3	80	0.0375000
NODE_7751_length_946_cov_18.082645	492	572	3	77	80	0.9625000
NODE_7751_length_946_cov_18.082645	545	625	2	4	80	0.0500000
NODE_7751_length_946_cov_18.082645	545	625	3	76	80	0.9500000
NODE_7752_length_946_cov_18.031877	433	513	1	23	80	0.2875000
NODE_7752_length_946_cov_18.031877	433	513	2	57	80	0.7125000
NODE_7752_length_946_cov_18.031877	486	566	2	57	80	0.7125000
NODE_7752_length_946_cov_18.031877	486	566	3	23	80	0.2875000
NODE_7753_length_946_cov_15.188902	472	552	1	2	80	0.0250000
NODE_7753_length_946_cov_15.188902	472	552	2	78	80	0.9750000
NODE_7753_length_946_cov_15.188902	525	605	1	3	80	0.0375000
NODE_7753_length_946_cov_15.188902	525	605	2	77	80	0.9625000
NODE_7754_length_946_cov_11.201889	408	488	0	80	80	1.0000000
NODE_7754_length_946_cov_11.201889	461	541	0	80	80	1.0000000
NODE_7768_length_945_cov_42.997636	361	441	2	24	80	0.3000000
NODE_7768_length_945_cov_42.997636	361	441	3	1	80	0.0125000
NODE_7768_length_945_cov_42.997636	361	441	4	42	80	0.5250000
NODE_7768_length_945_cov_42.997636	361	441	5	13	80	0.1625000
NODE_7768_length_945_cov_42.997636	414	494	0	25	80	0.3125000
NODE_7768_length_945_cov_42.997636	414	494	2	52	80	0.6500000
NODE_7768_length_945_cov_42.997636	414	494	3	1	80	0.0125000
NODE_7768_length_945_cov_42.997636	414	494	4	2	80	0.0250000
NODE_7769_length_945_cov_31.223404	357	437	1	13	80	0.1625000
NODE_7769_length_945_cov_31.223404	357	437	3	44	80	0.5500000
NODE_7769_length_945_cov_31.223404	357	437	5	23	80	0.2875000
NODE_7769_length_945_cov_31.223404	410	490	2	1	80	0.0125000
NODE_7769_length_945_cov_31.223404	410	490	3	4	80	0.0500000
NODE_7769_length_945_cov_31.223404	410	490	4	18	80	0.2250000
NODE_7769_length_945_cov_31.223404	410	490	5	57	80	0.7125000
NODE_7770_length_945_cov_26.348700	331	411	1	19	80	0.2375000
NODE_7770_length_945_cov_26.348700	331	411	2	4	80	0.0500000
NODE_7770_length_945_cov_26.348700	331	411	3	31	80	0.3875000
NODE_7770_length_945_cov_26.348700	331	411	4	14	80	0.1750000
NODE_7770_length_945_cov_26.348700	331	411	5	12	80	0.1500000
NODE_7770_length_945_cov_26.348700	384	464	1	19	80	0.2375000
NODE_7770_length_945_cov_26.348700	384	464	2	16	80	0.2000000
NODE_7770_length_945_cov_26.348700	384	464	3	45	80	0.5625000
NODE_7771_length_945_cov_20.349882	435	515	3	74	80	0.9250000
NODE_7771_length_945_cov_20.349882	435	515	4	6	80	0.0750000
NODE_7771_length_945_cov_20.349882	488	568	3	80	80	1.0000000
NODE_7772_length_945_cov_14.771868	386	466	1	64	80	0.8000000
NODE_7772_length_945_cov_14.771868	386	466	2	16	80	0.2000000
NODE_7772_length_945_cov_14.771868	439	519	1	11	80	0.1375000
NODE_7772_length_945_cov_14.771868	439	519	2	42	80	0.5250000
NODE_7772_length_945_cov_14.771868	439	519	3	27	80	0.3375000
NODE_7773_length_945_cov_10.158392	599	679	6	1	80	0.0125000
NODE_7773_length_945_cov_10.158392	599	679	7	2	80	0.0250000
NODE_7773_length_945_cov_10.158392	599	679	8	43	80	0.5375000
NODE_7773_length_945_cov_10.158392	599	679	9	34	80	0.4250000
NODE_7773_length_945_cov_10.158392	652	732	5	6	80	0.0750000
NODE_7773_length_945_cov_10.158392	652	732	7	9	80	0.1125000
NODE_7773_length_945_cov_10.158392	652	732	8	49	80	0.6125000
NODE_7773_length_945_cov_10.158392	652	732	9	16	80	0.2000000
NODE_7775_length_945_cov_5.403073	357	437	0	80	80	1.0000000
NODE_7775_length_945_cov_5.403073	410	490	0	80	80	1.0000000
NODE_7785_length_944_cov_42.401183	358	438	1	74	80	0.9250000
NODE_7785_length_944_cov_42.401183	358	438	2	6	80	0.0750000
NODE_7785_length_944_cov_42.401183	411	498	1	70	87	0.8045977
NODE_7785_length_944_cov_42.401183	411	498	2	17	87	0.1954023
NODE_7786_length_944_cov_32.712426	377	457	0	80	80	1.0000000
NODE_7786_length_944_cov_32.712426	430	510	0	80	80	1.0000000
NODE_7787_length_944_cov_27.839053	417	497	1	80	80	1.0000000
NODE_7787_length_944_cov_27.839053	470	550	1	78	80	0.9750000
NODE_7787_length_944_cov_27.839053	470	550	2	2	80	0.0250000
NODE_7788_length_944_cov_24.702959	413	493	0	80	80	1.0000000
NODE_7788_length_944_cov_24.702959	466	546	0	80	80	1.0000000
NODE_7789_length_944_cov_11.951479	347	427	1	6	80	0.0750000
NODE_7789_length_944_cov_11.951479	347	427	3	74	80	0.9250000
NODE_7789_length_944_cov_11.951479	400	480	2	9	80	0.1125000
NODE_7789_length_944_cov_11.951479	400	480	3	71	80	0.8875000
NODE_7789_length_944_cov_11.951479	476	556	0	14	80	0.1750000
NODE_7789_length_944_cov_11.951479	476	556	1	52	80	0.6500000
NODE_7789_length_944_cov_11.951479	476	556	2	14	80	0.1750000
NODE_7789_length_944_cov_11.951479	529	609	1	80	80	1.0000000
NODE_7790_length_944_cov_6.745562	366	446	0	63	80	0.7875000
NODE_7790_length_944_cov_6.745562	366	446	1	17	80	0.2125000
NODE_7790_length_944_cov_6.745562	419	499	0	10	80	0.1250000
NODE_7790_length_944_cov_6.745562	419	499	1	70	80	0.8750000
NODE_7792_length_944_cov_4.420118	236	316	0	80	80	1.0000000
NODE_7792_length_944_cov_4.420118	289	369	0	80	80	1.0000000
NODE_7800_length_943_cov_40.111374	536	614	1	13	78	0.1666667
NODE_7800_length_943_cov_40.111374	536	614	2	43	78	0.5512820
NODE_7800_length_943_cov_40.111374	536	614	3	22	78	0.2820513
NODE_7800_length_943_cov_40.111374	587	667	1	66	80	0.8250000
NODE_7800_length_943_cov_40.111374	587	667	2	14	80	0.1750000
NODE_7801_length_943_cov_29.446682	338	418	0	80	80	1.0000000
NODE_7801_length_943_cov_29.446682	391	471	0	80	80	1.0000000
NODE_7802_length_943_cov_28.289100	393	473	3	46	80	0.5750000
NODE_7802_length_943_cov_28.289100	393	473	4	34	80	0.4250000
NODE_7802_length_943_cov_28.289100	446	526	1	3	80	0.0375000
NODE_7802_length_943_cov_28.289100	446	526	2	48	80	0.6000000
NODE_7802_length_943_cov_28.289100	446	526	3	29	80	0.3625000
NODE_7803_length_943_cov_27.225118	343	423	0	47	80	0.5875000
NODE_7803_length_943_cov_27.225118	343	423	2	33	80	0.4125000
NODE_7803_length_943_cov_27.225118	396	476	2	80	80	1.0000000
NODE_7804_length_943_cov_26.536730	275	303	7	17	28	0.6071429
NODE_7804_length_943_cov_26.536730	275	303	8	9	28	0.3214286
NODE_7804_length_943_cov_26.536730	275	303	9	2	28	0.0714286
NODE_7804_length_943_cov_26.536730	299	379	8	2	80	0.0250000
NODE_7804_length_943_cov_26.536730	299	379	9	19	80	0.2375000
NODE_7804_length_943_cov_26.536730	299	379	10	8	80	0.1000000
NODE_7804_length_943_cov_26.536730	299	379	11	3	80	0.0375000
NODE_7804_length_943_cov_26.536730	299	379	12	2	80	0.0250000
NODE_7804_length_943_cov_26.536730	299	379	13	10	80	0.1250000
NODE_7804_length_943_cov_26.536730	299	379	14	15	80	0.1875000
NODE_7804_length_943_cov_26.536730	299	379	15	16	80	0.2000000
NODE_7804_length_943_cov_26.536730	299	379	16	5	80	0.0625000
NODE_7804_length_943_cov_26.536730	352	432	9	4	80	0.0500000
NODE_7804_length_943_cov_26.536730	352	432	12	19	80	0.2375000
NODE_7804_length_943_cov_26.536730	352	432	13	12	80	0.1500000
NODE_7804_length_943_cov_26.536730	352	432	14	15	80	0.1875000
NODE_7804_length_943_cov_26.536730	352	432	15	8	80	0.1000000
NODE_7804_length_943_cov_26.536730	352	432	16	22	80	0.2750000
NODE_7805_length_943_cov_24.992891	374	454	2	25	80	0.3125000
NODE_7805_length_943_cov_24.992891	374	454	3	55	80	0.6875000
NODE_7805_length_943_cov_24.992891	427	507	1	4	80	0.0500000
NODE_7805_length_943_cov_24.992891	427	507	2	24	80	0.3000000
NODE_7805_length_943_cov_24.992891	427	507	3	52	80	0.6500000
NODE_7805_length_943_cov_24.992891	503	583	1	34	80	0.4250000
NODE_7805_length_943_cov_24.992891	503	583	2	46	80	0.5750000
NODE_7805_length_943_cov_24.992891	556	636	1	80	80	1.0000000
NODE_7806_length_943_cov_24.758294	403	483	10	80	80	1.0000000
NODE_7806_length_943_cov_24.758294	456	536	1	6	80	0.0750000
NODE_7806_length_943_cov_24.758294	456	536	2	3	80	0.0375000
NODE_7806_length_943_cov_24.758294	456	536	3	1	80	0.0125000
NODE_7806_length_943_cov_24.758294	456	536	4	3	80	0.0375000
NODE_7806_length_943_cov_24.758294	456	536	6	18	80	0.2250000
NODE_7806_length_943_cov_24.758294	456	536	7	9	80	0.1125000
NODE_7806_length_943_cov_24.758294	456	536	8	6	80	0.0750000
NODE_7806_length_943_cov_24.758294	456	536	10	34	80	0.4250000
NODE_7807_length_943_cov_22.316351	432	512	1	66	80	0.8250000
NODE_7807_length_943_cov_22.316351	432	512	2	14	80	0.1750000
NODE_7807_length_943_cov_22.316351	485	565	1	65	80	0.8125000
NODE_7807_length_943_cov_22.316351	485	565	2	15	80	0.1875000
NODE_7808_length_943_cov_22.149289	393	473	1	15	80	0.1875000
NODE_7808_length_943_cov_22.149289	393	473	2	23	80	0.2875000
NODE_7808_length_943_cov_22.149289	393	473	4	3	80	0.0375000
NODE_7808_length_943_cov_22.149289	393	473	5	18	80	0.2250000
NODE_7808_length_943_cov_22.149289	393	473	6	21	80	0.2625000
NODE_7808_length_943_cov_22.149289	446	526	5	23	80	0.2875000
NODE_7808_length_943_cov_22.149289	446	526	6	57	80	0.7125000
NODE_7809_length_943_cov_20.055687	412	492	4	33	80	0.4125000
NODE_7809_length_943_cov_20.055687	412	492	5	45	80	0.5625000
NODE_7809_length_943_cov_20.055687	412	492	6	2	80	0.0250000
NODE_7809_length_943_cov_20.055687	465	545	2	24	80	0.3000000
NODE_7809_length_943_cov_20.055687	465	545	3	3	80	0.0375000
NODE_7809_length_943_cov_20.055687	465	545	4	14	80	0.1750000
NODE_7809_length_943_cov_20.055687	465	545	5	25	80	0.3125000
NODE_7809_length_943_cov_20.055687	465	545	6	14	80	0.1750000
NODE_7810_length_943_cov_16.022512	338	418	0	7	80	0.0875000
NODE_7810_length_943_cov_16.022512	338	418	1	14	80	0.1750000
NODE_7810_length_943_cov_16.022512	338	418	2	23	80	0.2875000
NODE_7810_length_943_cov_16.022512	338	418	3	3	80	0.0375000
NODE_7810_length_943_cov_16.022512	338	418	4	27	80	0.3375000
NODE_7810_length_943_cov_16.022512	338	418	5	6	80	0.0750000
NODE_7810_length_943_cov_16.022512	391	471	4	21	80	0.2625000
NODE_7810_length_943_cov_16.022512	391	471	5	20	80	0.2500000
NODE_7810_length_943_cov_16.022512	391	471	6	14	80	0.1750000
NODE_7810_length_943_cov_16.022512	391	471	7	1	80	0.0125000
NODE_7810_length_943_cov_16.022512	391	471	8	24	80	0.3000000
NODE_7811_length_943_cov_10.939573	474	554	2	62	80	0.7750000
NODE_7811_length_943_cov_10.939573	474	554	4	18	80	0.2250000
NODE_7811_length_943_cov_10.939573	527	607	0	11	80	0.1375000
NODE_7811_length_943_cov_10.939573	527	607	2	69	80	0.8625000
NODE_7812_length_943_cov_9.483412	422	502	2	80	80	1.0000000
NODE_7812_length_943_cov_9.483412	475	555	0	26	80	0.3250000
NODE_7812_length_943_cov_9.483412	475	555	2	54	80	0.6750000
NODE_7830_length_942_cov_58.088968	384	464	8	18	80	0.2250000
NODE_7830_length_942_cov_58.088968	384	464	10	1	80	0.0125000
NODE_7830_length_942_cov_58.088968	384	464	11	19	80	0.2375000
NODE_7830_length_942_cov_58.088968	384	464	13	26	80	0.3250000
NODE_7830_length_942_cov_58.088968	384	464	14	15	80	0.1875000
NODE_7830_length_942_cov_58.088968	384	464	15	1	80	0.0125000
NODE_7830_length_942_cov_58.088968	437	517	5	11	80	0.1375000
NODE_7830_length_942_cov_58.088968	437	517	7	3	80	0.0375000
NODE_7830_length_942_cov_58.088968	437	517	8	10	80	0.1250000
NODE_7830_length_942_cov_58.088968	437	517	10	21	80	0.2625000
NODE_7830_length_942_cov_58.088968	437	517	11	14	80	0.1750000
NODE_7830_length_942_cov_58.088968	437	517	13	14	80	0.1750000
NODE_7830_length_942_cov_58.088968	437	517	14	7	80	0.0875000
NODE_7832_length_942_cov_27.466192	360	440	0	80	80	1.0000000
NODE_7832_length_942_cov_27.466192	413	493	0	80	80	1.0000000
NODE_7833_length_942_cov_26.914591	346	426	1	18	80	0.2250000
NODE_7833_length_942_cov_26.914591	346	426	2	1	80	0.0125000
NODE_7833_length_942_cov_26.914591	346	426	3	35	80	0.4375000
NODE_7833_length_942_cov_26.914591	346	426	4	26	80	0.3250000
NODE_7833_length_942_cov_26.914591	399	479	3	48	80	0.6000000
NODE_7833_length_942_cov_26.914591	399	479	4	32	80	0.4000000
NODE_7834_length_942_cov_17.911032	390	470	0	58	80	0.7250000
NODE_7834_length_942_cov_17.911032	390	470	1	22	80	0.2750000
NODE_7834_length_942_cov_17.911032	443	523	0	80	80	1.0000000
NODE_7835_length_942_cov_14.695136	442	522	1	80	80	1.0000000
NODE_7835_length_942_cov_14.695136	495	575	0	14	80	0.1750000
NODE_7835_length_942_cov_14.695136	495	575	1	66	80	0.8250000
NODE_7836_length_942_cov_14.097272	547	627	1	18	80	0.2250000
NODE_7836_length_942_cov_14.097272	547	627	2	28	80	0.3500000
NODE_7836_length_942_cov_14.097272	547	627	3	34	80	0.4250000
NODE_7836_length_942_cov_14.097272	600	680	3	74	80	0.9250000
NODE_7836_length_942_cov_14.097272	600	680	4	6	80	0.0750000
NODE_7837_length_942_cov_13.174377	322	402	0	19	80	0.2375000
NODE_7837_length_942_cov_13.174377	322	402	2	61	80	0.7625000
NODE_7837_length_942_cov_13.174377	375	455	0	47	80	0.5875000
NODE_7837_length_942_cov_13.174377	375	455	2	33	80	0.4125000
NODE_7858_length_941_cov_36.592637	259	339	0	42	80	0.5250000
NODE_7858_length_941_cov_36.592637	259	339	1	38	80	0.4750000
NODE_7858_length_941_cov_36.592637	312	392	1	42	80	0.5250000
NODE_7858_length_941_cov_36.592637	312	392	2	2	80	0.0250000
NODE_7858_length_941_cov_36.592637	312	392	3	36	80	0.4500000
NODE_7858_length_941_cov_36.592637	388	468	2	1	80	0.0125000
NODE_7858_length_941_cov_36.592637	388	468	3	63	80	0.7875000
NODE_7858_length_941_cov_36.592637	388	468	4	16	80	0.2000000
NODE_7858_length_941_cov_36.592637	441	521	2	16	80	0.2000000
NODE_7858_length_941_cov_36.592637	441	521	3	12	80	0.1500000
NODE_7858_length_941_cov_36.592637	441	521	4	52	80	0.6500000
NODE_7859_length_941_cov_35.375297	352	432	0	4	80	0.0500000
NODE_7859_length_941_cov_35.375297	352	432	1	59	80	0.7375000
NODE_7859_length_941_cov_35.375297	352	432	2	17	80	0.2125000
NODE_7859_length_941_cov_35.375297	405	485	1	10	80	0.1250000
NODE_7859_length_941_cov_35.375297	405	485	2	35	80	0.4375000
NODE_7859_length_941_cov_35.375297	405	485	3	7	80	0.0875000
NODE_7859_length_941_cov_35.375297	405	485	5	1	80	0.0125000
NODE_7859_length_941_cov_35.375297	405	485	6	27	80	0.3375000
NODE_7859_length_941_cov_35.375297	481	561	5	9	80	0.1125000
NODE_7859_length_941_cov_35.375297	481	561	6	55	80	0.6875000
NODE_7859_length_941_cov_35.375297	481	561	7	16	80	0.2000000
NODE_7859_length_941_cov_35.375297	534	614	2	6	80	0.0750000
NODE_7859_length_941_cov_35.375297	534	614	3	8	80	0.1000000
NODE_7859_length_941_cov_35.375297	534	614	4	35	80	0.4375000
NODE_7859_length_941_cov_35.375297	534	614	5	5	80	0.0625000
NODE_7859_length_941_cov_35.375297	534	614	6	10	80	0.1250000
NODE_7859_length_941_cov_35.375297	534	614	7	16	80	0.2000000
NODE_7860_length_941_cov_32.222090	407	487	0	80	80	1.0000000
NODE_7860_length_941_cov_32.222090	460	540	0	80	80	1.0000000
NODE_7861_length_941_cov_28.442993	391	471	3	32	80	0.4000000
NODE_7861_length_941_cov_28.442993	391	471	4	5	80	0.0625000
NODE_7861_length_941_cov_28.442993	391	471	5	5	80	0.0625000
NODE_7861_length_941_cov_28.442993	391	471	6	29	80	0.3625000
NODE_7861_length_941_cov_28.442993	391	471	7	9	80	0.1125000
NODE_7861_length_941_cov_28.442993	444	524	3	80	80	1.0000000
NODE_7862_length_941_cov_20.788599	341	421	2	33	80	0.4125000
NODE_7862_length_941_cov_20.788599	341	421	4	29	80	0.3625000
NODE_7862_length_941_cov_20.788599	341	421	5	18	80	0.2250000
NODE_7862_length_941_cov_20.788599	394	474	1	17	80	0.2125000
NODE_7862_length_941_cov_20.788599	394	474	3	5	80	0.0625000
NODE_7862_length_941_cov_20.788599	394	474	4	9	80	0.1125000
NODE_7862_length_941_cov_20.788599	394	474	5	49	80	0.6125000
NODE_7863_length_941_cov_18.000000	364	444	4	1	80	0.0125000
NODE_7863_length_941_cov_18.000000	364	444	5	79	80	0.9875000
NODE_7863_length_941_cov_18.000000	417	497	1	21	80	0.2625000
NODE_7863_length_941_cov_18.000000	417	497	3	22	80	0.2750000
NODE_7863_length_941_cov_18.000000	417	497	5	37	80	0.4625000
NODE_7864_length_941_cov_11.020190	325	405	0	1	80	0.0125000
NODE_7864_length_941_cov_11.020190	325	405	2	79	80	0.9875000
NODE_7864_length_941_cov_11.020190	378	458	0	54	80	0.6750000
NODE_7864_length_941_cov_11.020190	378	458	2	26	80	0.3250000
NODE_7865_length_941_cov_6.020190	260	287	0	27	27	1.0000000
NODE_7865_length_941_cov_6.020190	260	340	0	80	80	1.0000000
NODE_7867_length_941_cov_3.745843	867	941	0	74	74	1.0000000
NODE_7877_length_940_cov_43.954816	243	323	3	51	80	0.6375000
NODE_7877_length_940_cov_43.954816	243	323	4	29	80	0.3625000
NODE_7877_length_940_cov_43.954816	296	376	3	11	80	0.1375000
NODE_7877_length_940_cov_43.954816	296	376	4	69	80	0.8625000
NODE_7877_length_940_cov_43.954816	372	452	3	31	80	0.3875000
NODE_7877_length_940_cov_43.954816	372	452	4	44	80	0.5500000
NODE_7877_length_940_cov_43.954816	372	452	5	5	80	0.0625000
NODE_7877_length_940_cov_43.954816	425	505	3	15	80	0.1875000
NODE_7877_length_940_cov_43.954816	425	505	4	61	80	0.7625000
NODE_7877_length_940_cov_43.954816	425	505	5	4	80	0.0500000
NODE_7878_length_940_cov_27.763377	423	503	3	17	80	0.2125000
NODE_7878_length_940_cov_27.763377	423	503	4	18	80	0.2250000
NODE_7878_length_940_cov_27.763377	423	503	5	45	80	0.5625000
NODE_7878_length_940_cov_27.763377	476	556	4	28	80	0.3500000
NODE_7878_length_940_cov_27.763377	476	556	5	52	80	0.6500000
NODE_7897_length_939_cov_58.982143	363	443	16	13	80	0.1625000
NODE_7897_length_939_cov_58.982143	363	443	17	7	80	0.0875000
NODE_7897_length_939_cov_58.982143	363	443	19	2	80	0.0250000
NODE_7897_length_939_cov_58.982143	363	443	21	2	80	0.0250000
NODE_7897_length_939_cov_58.982143	363	443	22	3	80	0.0375000
NODE_7897_length_939_cov_58.982143	363	443	23	13	80	0.1625000
NODE_7897_length_939_cov_58.982143	363	443	24	14	80	0.1750000
NODE_7897_length_939_cov_58.982143	363	443	25	26	80	0.3250000
NODE_7897_length_939_cov_58.982143	416	496	13	4	80	0.0500000
NODE_7897_length_939_cov_58.982143	416	496	14	2	80	0.0250000
NODE_7897_length_939_cov_58.982143	416	496	15	6	80	0.0750000
NODE_7897_length_939_cov_58.982143	416	496	16	8	80	0.1000000
NODE_7897_length_939_cov_58.982143	416	496	17	2	80	0.0250000
NODE_7897_length_939_cov_58.982143	416	496	18	4	80	0.0500000
NODE_7897_length_939_cov_58.982143	416	496	21	9	80	0.1125000
NODE_7897_length_939_cov_58.982143	416	496	22	6	80	0.0750000
NODE_7897_length_939_cov_58.982143	416	496	23	10	80	0.1250000
NODE_7897_length_939_cov_58.982143	416	496	24	16	80	0.2000000
NODE_7897_length_939_cov_58.982143	416	496	25	13	80	0.1625000
NODE_7898_length_939_cov_32.469048	327	407	5	50	80	0.6250000
NODE_7898_length_939_cov_32.469048	327	407	6	30	80	0.3750000
NODE_7898_length_939_cov_32.469048	380	460	4	24	80	0.3000000
NODE_7898_length_939_cov_32.469048	380	460	5	11	80	0.1375000
NODE_7898_length_939_cov_32.469048	380	460	6	45	80	0.5625000
NODE_7899_length_939_cov_31.895238	265	345	1	80	80	1.0000000
NODE_7899_length_939_cov_31.895238	318	398	0	50	80	0.6250000
NODE_7899_length_939_cov_31.895238	318	398	1	30	80	0.3750000
NODE_7900_length_939_cov_25.354762	439	519	5	1	80	0.0125000
NODE_7900_length_939_cov_25.354762	439	519	6	12	80	0.1500000
NODE_7900_length_939_cov_25.354762	439	519	7	11	80	0.1375000
NODE_7900_length_939_cov_25.354762	439	519	8	15	80	0.1875000
NODE_7900_length_939_cov_25.354762	439	519	9	41	80	0.5125000
NODE_7900_length_939_cov_25.354762	492	572	8	3	80	0.0375000
NODE_7900_length_939_cov_25.354762	492	572	9	34	80	0.4250000
NODE_7900_length_939_cov_25.354762	492	572	10	7	80	0.0875000
NODE_7900_length_939_cov_25.354762	492	572	11	5	80	0.0625000
NODE_7900_length_939_cov_25.354762	492	572	12	31	80	0.3875000
NODE_7901_length_939_cov_24.892857	370	450	0	50	80	0.6250000
NODE_7901_length_939_cov_24.892857	370	450	2	30	80	0.3750000
NODE_7901_length_939_cov_24.892857	423	503	2	80	80	1.0000000
NODE_7902_length_939_cov_24.246429	422	502	2	80	80	1.0000000
NODE_7902_length_939_cov_24.246429	475	555	0	19	80	0.2375000
NODE_7902_length_939_cov_24.246429	475	555	2	59	80	0.7375000
NODE_7902_length_939_cov_24.246429	475	555	4	2	80	0.0250000
NODE_7902_length_939_cov_24.246429	551	631	2	2	80	0.0250000
NODE_7902_length_939_cov_24.246429	551	631	4	42	80	0.5250000
NODE_7902_length_939_cov_24.246429	551	631	6	36	80	0.4500000
NODE_7902_length_939_cov_24.246429	604	684	2	20	80	0.2500000
NODE_7902_length_939_cov_24.246429	604	684	4	3	80	0.0375000
NODE_7902_length_939_cov_24.246429	604	684	6	45	80	0.5625000
NODE_7902_length_939_cov_24.246429	604	684	7	7	80	0.0875000
NODE_7902_length_939_cov_24.246429	604	684	8	5	80	0.0625000
NODE_7903_length_939_cov_21.141667	368	448	1	37	80	0.4625000
NODE_7903_length_939_cov_21.141667	368	448	2	43	80	0.5375000
NODE_7903_length_939_cov_21.141667	421	501	1	52	80	0.6500000
NODE_7903_length_939_cov_21.141667	421	501	2	28	80	0.3500000
NODE_7904_length_939_cov_16.425000	327	407	1	39	80	0.4875000
NODE_7904_length_939_cov_16.425000	327	407	2	41	80	0.5125000
NODE_7904_length_939_cov_16.425000	380	460	1	35	80	0.4375000
NODE_7904_length_939_cov_16.425000	380	460	2	45	80	0.5625000
NODE_7905_length_939_cov_13.828571	469	548	0	3	79	0.0379747
NODE_7905_length_939_cov_13.828571	469	548	2	76	79	0.9620253
NODE_7905_length_939_cov_13.828571	522	603	2	81	81	1.0000000
NODE_7906_length_939_cov_13.521429	402	482	0	80	80	1.0000000
NODE_7906_length_939_cov_13.521429	455	535	0	80	80	1.0000000
NODE_7907_length_939_cov_12.955952	398	478	2	59	80	0.7375000
NODE_7907_length_939_cov_12.955952	398	478	3	21	80	0.2625000
NODE_7907_length_939_cov_12.955952	451	531	2	23	80	0.2875000
NODE_7907_length_939_cov_12.955952	451	531	3	42	80	0.5250000
NODE_7907_length_939_cov_12.955952	451	531	4	15	80	0.1875000
NODE_7908_length_939_cov_6.564286	523	545	0	22	22	1.0000000
NODE_7922_length_938_cov_44.458880	362	442	1	28	80	0.3500000
NODE_7922_length_938_cov_44.458880	362	442	3	52	80	0.6500000
NODE_7922_length_938_cov_44.458880	415	495	3	80	80	1.0000000
NODE_7923_length_938_cov_44.435042	748	815	5	51	67	0.7611941
NODE_7923_length_938_cov_44.435042	748	815	6	13	67	0.1940299
NODE_7923_length_938_cov_44.435042	748	815	7	3	67	0.0447761
NODE_7924_length_938_cov_32.177592	466	546	2	17	80	0.2125000
NODE_7924_length_938_cov_32.177592	466	546	4	36	80	0.4500000
NODE_7924_length_938_cov_32.177592	466	546	6	27	80	0.3375000
NODE_7924_length_938_cov_32.177592	519	599	5	11	80	0.1375000
NODE_7924_length_938_cov_32.177592	519	599	6	34	80	0.4250000
NODE_7924_length_938_cov_32.177592	519	599	7	8	80	0.1000000
NODE_7924_length_938_cov_32.177592	519	599	8	27	80	0.3375000
NODE_7925_length_938_cov_21.139452	474	554	0	80	80	1.0000000
NODE_7925_length_938_cov_21.139452	527	607	0	80	80	1.0000000
NODE_7927_length_938_cov_8.791418	300	380	2	28	80	0.3500000
NODE_7927_length_938_cov_8.791418	300	380	3	52	80	0.6500000
NODE_7927_length_938_cov_8.791418	353	433	2	18	80	0.2250000
NODE_7927_length_938_cov_8.791418	353	433	3	62	80	0.7750000
NODE_7932_length_938_cov_2.693683	59	139	0	28	80	0.3500000
NODE_7932_length_938_cov_2.693683	59	139	1	42	80	0.5250000
NODE_7932_length_938_cov_2.693683	59	139	2	10	80	0.1250000
NODE_7932_length_938_cov_2.693683	112	192	1	17	80	0.2125000
NODE_7932_length_938_cov_2.693683	112	192	2	63	80	0.7875000
NODE_7946_length_937_cov_31.890215	407	487	7	4	80	0.0500000
NODE_7946_length_937_cov_31.890215	407	487	8	7	80	0.0875000
NODE_7946_length_937_cov_31.890215	407	487	9	46	80	0.5750000
NODE_7946_length_937_cov_31.890215	407	487	10	23	80	0.2875000
NODE_7946_length_937_cov_31.890215	460	536	5	3	76	0.0394737
NODE_7946_length_937_cov_31.890215	460	536	6	23	76	0.3026316
NODE_7946_length_937_cov_31.890215	460	536	8	2	76	0.0263158
NODE_7946_length_937_cov_31.890215	460	536	9	25	76	0.3289474
NODE_7946_length_937_cov_31.890215	460	536	10	23	76	0.3026316
NODE_7947_length_937_cov_31.198091	425	505	2	57	80	0.7125000
NODE_7947_length_937_cov_31.198091	425	505	3	23	80	0.2875000
NODE_7947_length_937_cov_31.198091	478	558	2	6	80	0.0750000
NODE_7947_length_937_cov_31.198091	478	558	3	42	80	0.5250000
NODE_7947_length_937_cov_31.198091	478	558	4	32	80	0.4000000
NODE_7948_length_937_cov_29.742243	296	376	1	9	80	0.1125000
NODE_7948_length_937_cov_29.742243	296	376	2	59	80	0.7375000
NODE_7948_length_937_cov_29.742243	296	376	3	12	80	0.1500000
NODE_7948_length_937_cov_29.742243	349	429	1	29	80	0.3625000
NODE_7948_length_937_cov_29.742243	349	429	2	43	80	0.5375000
NODE_7948_length_937_cov_29.742243	349	429	3	8	80	0.1000000
NODE_7948_length_937_cov_29.742243	425	505	3	21	80	0.2625000
NODE_7948_length_937_cov_29.742243	425	505	4	1	80	0.0125000
NODE_7948_length_937_cov_29.742243	425	505	5	4	80	0.0500000
NODE_7948_length_937_cov_29.742243	425	505	6	13	80	0.1625000
NODE_7948_length_937_cov_29.742243	425	505	7	28	80	0.3500000
NODE_7948_length_937_cov_29.742243	425	505	8	13	80	0.1625000
NODE_7948_length_937_cov_29.742243	478	558	7	55	80	0.6875000
NODE_7948_length_937_cov_29.742243	478	558	8	25	80	0.3125000
NODE_7950_length_937_cov_26.153938	487	567	1	72	80	0.9000000
NODE_7950_length_937_cov_26.153938	487	567	2	8	80	0.1000000
NODE_7950_length_937_cov_26.153938	540	620	1	20	80	0.2500000
NODE_7950_length_937_cov_26.153938	540	620	2	48	80	0.6000000
NODE_7950_length_937_cov_26.153938	540	620	3	12	80	0.1500000
NODE_7951_length_937_cov_20.898568	515	595	2	46	80	0.5750000
NODE_7951_length_937_cov_20.898568	515	595	3	5	80	0.0625000
NODE_7951_length_937_cov_20.898568	515	595	4	29	80	0.3625000
NODE_7951_length_937_cov_20.898568	568	648	2	76	80	0.9500000
NODE_7951_length_937_cov_20.898568	568	648	3	4	80	0.0500000
NODE_7952_length_937_cov_20.502387	181	261	1	80	80	1.0000000
NODE_7952_length_937_cov_20.502387	234	314	1	80	80	1.0000000
NODE_7952_length_937_cov_20.502387	310	390	1	58	80	0.7250000
NODE_7952_length_937_cov_20.502387	310	390	2	7	80	0.0875000
NODE_7952_length_937_cov_20.502387	310	390	3	15	80	0.1875000
NODE_7952_length_937_cov_20.502387	363	443	1	5	80	0.0625000
NODE_7952_length_937_cov_20.502387	363	443	2	49	80	0.6125000
NODE_7952_length_937_cov_20.502387	363	443	3	26	80	0.3250000
NODE_7953_length_937_cov_15.219570	526	606	1	8	80	0.1000000
NODE_7953_length_937_cov_15.219570	526	606	2	14	80	0.1750000
NODE_7953_length_937_cov_15.219570	526	606	3	58	80	0.7250000
NODE_7953_length_937_cov_15.219570	579	659	1	8	80	0.1000000
NODE_7953_length_937_cov_15.219570	579	659	2	19	80	0.2375000
NODE_7953_length_937_cov_15.219570	579	659	3	44	80	0.5500000
NODE_7953_length_937_cov_15.219570	579	659	4	9	80	0.1125000
NODE_7954_length_937_cov_9.633652	521	601	0	17	80	0.2125000
NODE_7954_length_937_cov_9.633652	521	601	1	63	80	0.7875000
NODE_7954_length_937_cov_9.633652	574	654	0	70	80	0.8750000
NODE_7954_length_937_cov_9.633652	574	654	1	10	80	0.1250000
NODE_7956_length_937_cov_6.630072	305	385	0	80	80	1.0000000
NODE_7956_length_937_cov_6.630072	358	438	0	80	80	1.0000000
NODE_7957_length_937_cov_4.649165	470	550	0	7	80	0.0875000
NODE_7957_length_937_cov_4.649165	470	550	1	73	80	0.9125000
NODE_7957_length_937_cov_4.649165	523	603	1	80	80	1.0000000
NODE_7969_length_936_cov_57.105137	267	347	1	42	80	0.5250000
NODE_7969_length_936_cov_57.105137	267	347	2	31	80	0.3875000
NODE_7969_length_936_cov_57.105137	267	347	3	7	80	0.0875000
NODE_7969_length_936_cov_57.105137	320	400	2	20	80	0.2500000
NODE_7969_length_936_cov_57.105137	320	400	3	27	80	0.3375000
NODE_7969_length_936_cov_57.105137	320	400	4	26	80	0.3250000
NODE_7969_length_936_cov_57.105137	320	400	5	7	80	0.0875000
NODE_7969_length_936_cov_57.105137	396	476	4	1	80	0.0125000
NODE_7969_length_936_cov_57.105137	396	476	5	19	80	0.2375000
NODE_7969_length_936_cov_57.105137	396	476	6	4	80	0.0500000
NODE_7969_length_936_cov_57.105137	396	476	7	1	80	0.0125000
NODE_7969_length_936_cov_57.105137	396	476	8	12	80	0.1500000
NODE_7969_length_936_cov_57.105137	396	476	9	43	80	0.5375000
NODE_7969_length_936_cov_57.105137	449	529	8	27	80	0.3375000
NODE_7969_length_936_cov_57.105137	449	529	9	53	80	0.6625000
NODE_7970_length_936_cov_39.983274	433	513	0	1	80	0.0125000
NODE_7970_length_936_cov_39.983274	433	513	2	79	80	0.9875000
NODE_7970_length_936_cov_39.983274	486	566	2	30	80	0.3750000
NODE_7970_length_936_cov_39.983274	486	566	3	50	80	0.6250000
NODE_7971_length_936_cov_22.486260	534	614	0	80	80	1.0000000
NODE_7971_length_936_cov_22.486260	587	667	0	29	80	0.3625000
NODE_7971_length_936_cov_22.486260	587	667	2	6	80	0.0750000
NODE_7971_length_936_cov_22.486260	587	667	3	45	80	0.5625000
NODE_7972_length_936_cov_19.639188	409	489	2	80	80	1.0000000
NODE_7972_length_936_cov_19.639188	462	542	0	5	80	0.0625000
NODE_7972_length_936_cov_19.639188	462	542	1	41	80	0.5125000
NODE_7972_length_936_cov_19.639188	462	542	2	34	80	0.4250000
NODE_7973_length_936_cov_15.083632	322	402	2	9	80	0.1125000
NODE_7973_length_936_cov_15.083632	322	402	3	70	80	0.8750000
NODE_7973_length_936_cov_15.083632	322	402	5	1	80	0.0125000
NODE_7973_length_936_cov_15.083632	375	455	3	26	80	0.3250000
NODE_7973_length_936_cov_15.083632	375	455	4	5	80	0.0625000
NODE_7973_length_936_cov_15.083632	375	455	5	19	80	0.2375000
NODE_7973_length_936_cov_15.083632	375	455	6	30	80	0.3750000
NODE_7974_length_936_cov_13.962963	356	424	7	2	68	0.0294118
NODE_7974_length_936_cov_13.962963	356	424	8	18	68	0.2647059
NODE_7974_length_936_cov_13.962963	356	424	9	48	68	0.7058824
NODE_7975_length_936_cov_12.502987	447	527	1	80	80	1.0000000
NODE_7975_length_936_cov_12.502987	500	580	1	80	80	1.0000000
NODE_7976_length_936_cov_12.279570	340	420	0	26	80	0.3250000
NODE_7976_length_936_cov_12.279570	340	420	1	47	80	0.5875000
NODE_7976_length_936_cov_12.279570	340	420	3	7	80	0.0875000
NODE_7976_length_936_cov_12.279570	393	473	0	5	80	0.0625000
NODE_7976_length_936_cov_12.279570	393	473	1	75	80	0.9375000
NODE_7977_length_936_cov_7.906810	587	667	3	28	80	0.3500000
NODE_7977_length_936_cov_7.906810	587	667	4	40	80	0.5000000
NODE_7977_length_936_cov_7.906810	587	667	5	12	80	0.1500000
NODE_7977_length_936_cov_7.906810	640	720	3	27	80	0.3375000
NODE_7977_length_936_cov_7.906810	640	720	4	28	80	0.3500000
NODE_7977_length_936_cov_7.906810	640	720	5	25	80	0.3125000
NODE_7978_length_936_cov_6.845878	322	402	2	80	80	1.0000000
NODE_7978_length_936_cov_6.845878	375	455	1	10	80	0.1250000
NODE_7978_length_936_cov_6.845878	375	455	2	70	80	0.8750000
NODE_7979_length_936_cov_6.434886	556	635	2	18	79	0.2278481
NODE_7979_length_936_cov_6.434886	556	635	3	5	79	0.0632911
NODE_7979_length_936_cov_6.434886	556	635	4	56	79	0.7088608
NODE_7979_length_936_cov_6.434886	608	688	3	28	80	0.3500000
NODE_7979_length_936_cov_6.434886	608	688	4	52	80	0.6500000
NODE_7993_length_935_cov_38.209330	57	137	22	1	80	0.0125000
NODE_7993_length_935_cov_38.209330	57	137	24	1	80	0.0125000
NODE_7993_length_935_cov_38.209330	57	137	25	3	80	0.0375000
NODE_7993_length_935_cov_38.209330	57	137	26	1	80	0.0125000
NODE_7993_length_935_cov_38.209330	57	137	30	3	80	0.0375000
NODE_7993_length_935_cov_38.209330	57	137	31	2	80	0.0250000
NODE_7993_length_935_cov_38.209330	57	137	33	9	80	0.1125000
NODE_7993_length_935_cov_38.209330	57	137	34	5	80	0.0625000
NODE_7993_length_935_cov_38.209330	57	137	35	55	80	0.6875000
NODE_7994_length_935_cov_27.306220	439	519	8	11	80	0.1375000
NODE_7994_length_935_cov_27.306220	439	519	9	21	80	0.2625000
NODE_7994_length_935_cov_27.306220	439	519	10	2	80	0.0250000
NODE_7994_length_935_cov_27.306220	439	519	11	3	80	0.0375000
NODE_7994_length_935_cov_27.306220	439	519	12	11	80	0.1375000
NODE_7994_length_935_cov_27.306220	439	519	13	26	80	0.3250000
NODE_7994_length_935_cov_27.306220	439	519	14	6	80	0.0750000
NODE_7994_length_935_cov_27.306220	492	572	5	2	80	0.0250000
NODE_7994_length_935_cov_27.306220	492	572	6	1	80	0.0125000
NODE_7994_length_935_cov_27.306220	492	572	7	16	80	0.2000000
NODE_7994_length_935_cov_27.306220	492	572	8	2	80	0.0250000
NODE_7994_length_935_cov_27.306220	492	572	9	8	80	0.1000000
NODE_7994_length_935_cov_27.306220	492	572	10	1	80	0.0125000
NODE_7994_length_935_cov_27.306220	492	572	11	25	80	0.3125000
NODE_7994_length_935_cov_27.306220	492	572	12	2	80	0.0250000
NODE_7994_length_935_cov_27.306220	492	572	13	17	80	0.2125000
NODE_7994_length_935_cov_27.306220	492	572	14	6	80	0.0750000
NODE_7995_length_935_cov_26.562201	321	401	1	4	80	0.0500000
NODE_7995_length_935_cov_26.562201	321	401	2	1	80	0.0125000
NODE_7995_length_935_cov_26.562201	321	401	3	6	80	0.0750000
NODE_7995_length_935_cov_26.562201	321	401	4	69	80	0.8625000
NODE_7995_length_935_cov_26.562201	374	454	4	62	80	0.7750000
NODE_7995_length_935_cov_26.562201	374	454	6	18	80	0.2250000
NODE_7995_length_935_cov_26.562201	450	530	2	48	80	0.6000000
NODE_7995_length_935_cov_26.562201	450	530	3	6	80	0.0750000
NODE_7995_length_935_cov_26.562201	450	530	4	1	80	0.0125000
NODE_7995_length_935_cov_26.562201	450	530	5	5	80	0.0625000
NODE_7995_length_935_cov_26.562201	450	530	6	20	80	0.2500000
NODE_7995_length_935_cov_26.562201	503	583	2	80	80	1.0000000
NODE_7996_length_935_cov_25.098086	356	436	0	1	80	0.0125000
NODE_7996_length_935_cov_25.098086	356	436	1	6	80	0.0750000
NODE_7996_length_935_cov_25.098086	356	436	2	73	80	0.9125000
NODE_7996_length_935_cov_25.098086	409	489	1	57	80	0.7125000
NODE_7996_length_935_cov_25.098086	409	489	2	23	80	0.2875000
NODE_7997_length_935_cov_24.316986	467	547	0	10	80	0.1250000
NODE_7997_length_935_cov_24.316986	467	547	2	70	80	0.8750000
NODE_7997_length_935_cov_24.316986	520	600	0	12	80	0.1500000
NODE_7997_length_935_cov_24.316986	520	600	2	68	80	0.8500000
NODE_7998_length_935_cov_19.221292	397	477	1	41	80	0.5125000
NODE_7998_length_935_cov_19.221292	397	477	3	14	80	0.1750000
NODE_7998_length_935_cov_19.221292	397	477	4	25	80	0.3125000
NODE_7998_length_935_cov_19.221292	450	530	3	3	80	0.0375000
NODE_7998_length_935_cov_19.221292	450	530	4	77	80	0.9625000
NODE_7999_length_935_cov_15.016746	404	484	0	70	80	0.8750000
NODE_7999_length_935_cov_15.016746	404	484	2	10	80	0.1250000
NODE_7999_length_935_cov_15.016746	457	537	0	80	80	1.0000000
NODE_8000_length_935_cov_13.138756	341	421	0	80	80	1.0000000
NODE_8000_length_935_cov_13.138756	394	474	0	80	80	1.0000000
NODE_8002_length_935_cov_6.485646	512	592	2	18	80	0.2250000
NODE_8002_length_935_cov_6.485646	512	592	4	2	80	0.0250000
NODE_8002_length_935_cov_6.485646	512	592	5	58	80	0.7250000
NODE_8002_length_935_cov_6.485646	512	592	6	2	80	0.0250000
NODE_8002_length_935_cov_6.485646	565	645	2	71	80	0.8875000
NODE_8002_length_935_cov_6.485646	565	645	4	2	80	0.0250000
NODE_8002_length_935_cov_6.485646	565	645	5	7	80	0.0875000
NODE_8003_length_935_cov_6.467703	250	330	0	49	80	0.6125000
NODE_8003_length_935_cov_6.467703	250	330	1	31	80	0.3875000
NODE_8003_length_935_cov_6.467703	303	383	1	55	80	0.6875000
NODE_8003_length_935_cov_6.467703	303	383	3	25	80	0.3125000
NODE_8004_length_935_cov_6.144737	478	558	0	18	80	0.2250000
NODE_8004_length_935_cov_6.144737	478	558	2	62	80	0.7750000
NODE_8004_length_935_cov_6.144737	531	611	2	80	80	1.0000000
NODE_8005_length_935_cov_3.905502	39	119	4	2	80	0.0250000
NODE_8005_length_935_cov_3.905502	39	119	5	4	80	0.0500000
NODE_8005_length_935_cov_3.905502	39	119	6	6	80	0.0750000
NODE_8005_length_935_cov_3.905502	39	119	7	18	80	0.2250000
NODE_8005_length_935_cov_3.905502	39	119	8	27	80	0.3375000
NODE_8005_length_935_cov_3.905502	39	119	9	23	80	0.2875000
NODE_8005_length_935_cov_3.905502	92	166	5	3	74	0.0405405
NODE_8005_length_935_cov_3.905502	92	166	6	53	74	0.7162162
NODE_8005_length_935_cov_3.905502	92	166	7	5	74	0.0675676
NODE_8005_length_935_cov_3.905502	92	166	9	13	74	0.1756757
NODE_8028_length_934_cov_22.898204	403	483	5	5	80	0.0625000
NODE_8028_length_934_cov_22.898204	403	483	6	49	80	0.6125000
NODE_8028_length_934_cov_22.898204	403	483	7	18	80	0.2250000
NODE_8028_length_934_cov_22.898204	403	483	8	8	80	0.1000000
NODE_8028_length_934_cov_22.898204	456	536	6	7	80	0.0875000
NODE_8028_length_934_cov_22.898204	456	536	7	32	80	0.4000000
NODE_8028_length_934_cov_22.898204	456	536	8	41	80	0.5125000
NODE_8029_length_934_cov_17.746108	246	326	0	80	80	1.0000000
NODE_8029_length_934_cov_17.746108	299	379	0	80	80	1.0000000
NODE_8030_length_934_cov_16.049102	367	447	5	5	80	0.0625000
NODE_8030_length_934_cov_16.049102	367	447	6	3	80	0.0375000
NODE_8030_length_934_cov_16.049102	367	447	7	30	80	0.3750000
NODE_8030_length_934_cov_16.049102	367	447	9	42	80	0.5250000
NODE_8030_length_934_cov_16.049102	420	500	3	17	80	0.2125000
NODE_8030_length_934_cov_16.049102	420	500	4	17	80	0.2125000
NODE_8030_length_934_cov_16.049102	420	500	5	24	80	0.3000000
NODE_8030_length_934_cov_16.049102	420	500	6	3	80	0.0375000
NODE_8030_length_934_cov_16.049102	420	500	7	6	80	0.0750000
NODE_8030_length_934_cov_16.049102	420	500	9	13	80	0.1625000
NODE_8031_length_934_cov_13.738922	379	459	0	80	80	1.0000000
NODE_8031_length_934_cov_13.738922	432	459	0	27	27	1.0000000
NODE_8031_length_934_cov_13.738922	470	512	0	42	42	1.0000000
NODE_8032_length_934_cov_9.091018	407	487	0	80	80	1.0000000
NODE_8032_length_934_cov_9.091018	460	540	0	80	80	1.0000000
NODE_8034_length_934_cov_5.349701	583	663	0	80	80	1.0000000
NODE_8050_length_933_cov_36.557554	462	542	0	80	80	1.0000000
NODE_8050_length_933_cov_36.557554	515	595	0	80	80	1.0000000
NODE_8051_length_933_cov_27.645084	476	556	2	43	80	0.5375000
NODE_8051_length_933_cov_27.645084	476	556	3	37	80	0.4625000
NODE_8051_length_933_cov_27.645084	529	609	1	16	80	0.2000000
NODE_8051_length_933_cov_27.645084	529	609	2	6	80	0.0750000
NODE_8051_length_933_cov_27.645084	529	609	3	58	80	0.7250000
NODE_8052_length_933_cov_26.749400	611	691	0	80	80	1.0000000
NODE_8052_length_933_cov_26.749400	664	744	0	80	80	1.0000000
NODE_8053_length_933_cov_26.308153	430	510	2	4	80	0.0500000
NODE_8053_length_933_cov_26.308153	430	510	3	76	80	0.9500000
NODE_8053_length_933_cov_26.308153	483	563	0	52	80	0.6500000
NODE_8053_length_933_cov_26.308153	483	563	2	5	80	0.0625000
NODE_8053_length_933_cov_26.308153	483	563	3	23	80	0.2875000
NODE_8054_length_933_cov_19.966427	444	530	4	27	86	0.3139535
NODE_8054_length_933_cov_19.966427	444	530	5	2	86	0.0232558
NODE_8054_length_933_cov_19.966427	444	530	6	46	86	0.5348837
NODE_8054_length_933_cov_19.966427	444	530	7	11	86	0.1279070
NODE_8054_length_933_cov_19.966427	497	583	4	32	86	0.3720930
NODE_8054_length_933_cov_19.966427	497	583	5	11	86	0.1279070
NODE_8054_length_933_cov_19.966427	497	583	6	31	86	0.3604651
NODE_8054_length_933_cov_19.966427	497	583	7	12	86	0.1395349
NODE_8055_length_933_cov_16.870504	284	364	2	39	80	0.4875000
NODE_8055_length_933_cov_16.870504	284	364	3	10	80	0.1250000
NODE_8055_length_933_cov_16.870504	284	364	4	31	80	0.3875000
NODE_8055_length_933_cov_16.870504	337	415	3	1	78	0.0128205
NODE_8055_length_933_cov_16.870504	337	415	4	77	78	0.9871795
NODE_8056_length_933_cov_16.699041	366	446	2	4	80	0.0500000
NODE_8056_length_933_cov_16.699041	366	446	3	13	80	0.1625000
NODE_8056_length_933_cov_16.699041	366	446	4	25	80	0.3125000
NODE_8056_length_933_cov_16.699041	366	446	6	38	80	0.4750000
NODE_8056_length_933_cov_16.699041	419	499	4	6	80	0.0750000
NODE_8056_length_933_cov_16.699041	419	499	5	34	80	0.4250000
NODE_8056_length_933_cov_16.699041	419	499	6	40	80	0.5000000
NODE_8057_length_933_cov_11.171463	197	277	0	80	80	1.0000000
NODE_8057_length_933_cov_11.171463	250	330	0	80	80	1.0000000
NODE_8073_length_932_cov_26.656663	397	477	0	26	80	0.3250000
NODE_8073_length_932_cov_26.656663	397	477	1	19	80	0.2375000
NODE_8073_length_932_cov_26.656663	397	477	3	35	80	0.4375000
NODE_8073_length_932_cov_26.656663	450	530	3	80	80	1.0000000
NODE_8074_length_932_cov_16.581032	407	485	7	6	78	0.0769231
NODE_8074_length_932_cov_16.581032	407	485	8	12	78	0.1538462
NODE_8074_length_932_cov_16.581032	407	485	9	7	78	0.0897436
NODE_8074_length_932_cov_16.581032	407	485	10	23	78	0.2948718
NODE_8074_length_932_cov_16.581032	407	485	11	30	78	0.3846154
NODE_8074_length_932_cov_16.581032	460	538	4	4	78	0.0512821
NODE_8074_length_932_cov_16.581032	460	538	5	26	78	0.3333333
NODE_8074_length_932_cov_16.581032	460	538	7	15	78	0.1923077
NODE_8074_length_932_cov_16.581032	460	538	8	26	78	0.3333333
NODE_8074_length_932_cov_16.581032	460	538	9	5	78	0.0641026
NODE_8074_length_932_cov_16.581032	460	538	11	2	78	0.0256410
NODE_8075_length_932_cov_13.462185	413	493	5	73	80	0.9125000
NODE_8075_length_932_cov_13.462185	413	493	6	7	80	0.0875000
NODE_8075_length_932_cov_13.462185	466	546	2	18	80	0.2250000
NODE_8075_length_932_cov_13.462185	466	546	3	1	80	0.0125000
NODE_8075_length_932_cov_13.462185	466	546	4	6	80	0.0750000
NODE_8075_length_932_cov_13.462185	466	546	5	30	80	0.3750000
NODE_8075_length_932_cov_13.462185	466	546	6	25	80	0.3125000
NODE_8076_length_932_cov_13.442977	386	466	0	80	80	1.0000000
NODE_8076_length_932_cov_13.442977	439	519	0	80	80	1.0000000
NODE_8077_length_932_cov_11.947179	344	424	2	80	80	1.0000000
NODE_8077_length_932_cov_11.947179	397	477	0	31	80	0.3875000
NODE_8077_length_932_cov_11.947179	397	477	1	10	80	0.1250000
NODE_8077_length_932_cov_11.947179	397	477	2	39	80	0.4875000
NODE_8079_length_932_cov_10.849940	409	489	0	80	80	1.0000000
NODE_8079_length_932_cov_10.849940	462	542	0	80	80	1.0000000
NODE_8080_length_932_cov_10.174070	342	422	0	80	80	1.0000000
NODE_8080_length_932_cov_10.174070	395	475	0	80	80	1.0000000
NODE_8082_length_932_cov_9.200480	184	264	0	80	80	1.0000000
NODE_8082_length_932_cov_9.200480	237	317	0	80	80	1.0000000
NODE_8090_length_932_cov_2.689076	598	676	0	78	78	1.0000000
NODE_8090_length_932_cov_2.689076	798	845	0	47	47	1.0000000
NODE_8103_length_931_cov_51.451923	320	400	2	76	80	0.9500000
NODE_8103_length_931_cov_51.451923	320	400	3	4	80	0.0500000
NODE_8103_length_931_cov_51.451923	373	453	1	13	80	0.1625000
NODE_8103_length_931_cov_51.451923	373	453	2	30	80	0.3750000
NODE_8103_length_931_cov_51.451923	373	453	3	37	80	0.4625000
NODE_8104_length_931_cov_46.621394	527	607	1	13	80	0.1625000
NODE_8104_length_931_cov_46.621394	527	607	3	30	80	0.3750000
NODE_8104_length_931_cov_46.621394	527	607	4	37	80	0.4625000
NODE_8104_length_931_cov_46.621394	580	660	2	1	80	0.0125000
NODE_8104_length_931_cov_46.621394	580	660	3	29	80	0.3625000
NODE_8104_length_931_cov_46.621394	580	660	4	50	80	0.6250000
NODE_8105_length_931_cov_36.334135	347	427	0	80	80	1.0000000
NODE_8105_length_931_cov_36.334135	400	480	0	35	80	0.4375000
NODE_8105_length_931_cov_36.334135	400	480	1	45	80	0.5625000
NODE_8106_length_931_cov_32.495192	482	562	3	5	80	0.0625000
NODE_8106_length_931_cov_32.495192	482	562	4	35	80	0.4375000
NODE_8106_length_931_cov_32.495192	482	562	5	40	80	0.5000000
NODE_8106_length_931_cov_32.495192	535	617	2	18	82	0.2195122
NODE_8106_length_931_cov_32.495192	535	617	3	42	82	0.5121951
NODE_8106_length_931_cov_32.495192	535	617	5	22	82	0.2682927
NODE_8107_length_931_cov_22.100962	375	455	1	6	80	0.0750000
NODE_8107_length_931_cov_22.100962	375	455	3	74	80	0.9250000
NODE_8107_length_931_cov_22.100962	428	508	2	46	80	0.5750000
NODE_8107_length_931_cov_22.100962	428	508	3	34	80	0.4250000
NODE_8108_length_931_cov_21.781250	347	427	0	43	80	0.5375000
NODE_8108_length_931_cov_21.781250	347	427	1	37	80	0.4625000
NODE_8108_length_931_cov_21.781250	400	480	0	75	80	0.9375000
NODE_8108_length_931_cov_21.781250	400	480	1	5	80	0.0625000
NODE_8109_length_931_cov_19.084135	411	491	2	7	80	0.0875000
NODE_8109_length_931_cov_19.084135	411	491	3	46	80	0.5750000
NODE_8109_length_931_cov_19.084135	411	491	4	27	80	0.3375000
NODE_8109_length_931_cov_19.084135	464	544	1	14	80	0.1750000
NODE_8109_length_931_cov_19.084135	464	544	2	21	80	0.2625000
NODE_8109_length_931_cov_19.084135	464	544	3	45	80	0.5625000
NODE_8110_length_931_cov_14.879808	444	524	0	80	80	1.0000000
NODE_8110_length_931_cov_14.879808	497	577	0	80	80	1.0000000
NODE_8111_length_931_cov_13.087740	759	800	3	8	41	0.1951219
NODE_8111_length_931_cov_13.087740	759	800	4	33	41	0.8048781
NODE_8112_length_931_cov_10.534856	399	479	0	80	80	1.0000000
NODE_8112_length_931_cov_10.534856	452	532	0	80	80	1.0000000
NODE_8113_length_931_cov_9.865385	236	316	0	80	80	1.0000000
NODE_8113_length_931_cov_9.865385	289	369	0	80	80	1.0000000
NODE_8115_length_931_cov_6.201923	479	559	0	80	80	1.0000000
NODE_8115_length_931_cov_6.201923	532	612	0	80	80	1.0000000
NODE_8124_length_931_cov_1.780048	832	902	0	70	70	1.0000000
NODE_8126_length_931_cov_1.433894	220	284	6	17	64	0.2656250
NODE_8126_length_931_cov_1.433894	220	284	7	7	64	0.1093750
NODE_8126_length_931_cov_1.433894	220	284	9	21	64	0.3281250
NODE_8126_length_931_cov_1.433894	220	284	10	8	64	0.1250000
NODE_8126_length_931_cov_1.433894	220	284	11	6	64	0.0937500
NODE_8126_length_931_cov_1.433894	220	284	12	5	64	0.0781250
NODE_8131_length_930_cov_49.052948	252	332	0	80	80	1.0000000
NODE_8131_length_930_cov_49.052948	305	385	0	80	80	1.0000000
NODE_8131_length_930_cov_49.052948	381	462	0	8	81	0.0987654
NODE_8131_length_930_cov_49.052948	381	462	3	43	81	0.5308642
NODE_8131_length_930_cov_49.052948	381	462	4	26	81	0.3209876
NODE_8131_length_930_cov_49.052948	381	462	6	4	81	0.0493827
NODE_8131_length_930_cov_49.052948	435	515	3	4	80	0.0500000
NODE_8131_length_930_cov_49.052948	435	515	4	27	80	0.3375000
NODE_8131_length_930_cov_49.052948	435	515	5	39	80	0.4875000
NODE_8131_length_930_cov_49.052948	435	515	6	10	80	0.1250000
NODE_8132_length_930_cov_31.510229	400	482	4	6	82	0.0731707
NODE_8132_length_930_cov_31.510229	400	482	6	14	82	0.1707317
NODE_8132_length_930_cov_31.510229	400	482	8	17	82	0.2073171
NODE_8132_length_930_cov_31.510229	400	482	9	18	82	0.2195122
NODE_8132_length_930_cov_31.510229	400	482	10	27	82	0.3292683
NODE_8132_length_930_cov_31.510229	453	535	3	3	82	0.0365854
NODE_8132_length_930_cov_31.510229	453	535	4	56	82	0.6829268
NODE_8132_length_930_cov_31.510229	453	535	6	14	82	0.1707317
NODE_8132_length_930_cov_31.510229	453	535	8	9	82	0.1097561
NODE_8133_length_930_cov_29.139591	329	409	3	9	80	0.1125000
NODE_8133_length_930_cov_29.139591	329	409	5	40	80	0.5000000
NODE_8133_length_930_cov_29.139591	329	409	6	31	80	0.3875000
NODE_8133_length_930_cov_29.139591	382	462	3	19	80	0.2375000
NODE_8133_length_930_cov_29.139591	382	462	5	61	80	0.7625000
NODE_8134_length_930_cov_24.787004	518	598	0	23	80	0.2875000
NODE_8134_length_930_cov_24.787004	518	598	1	1	80	0.0125000
NODE_8134_length_930_cov_24.787004	518	598	3	34	80	0.4250000
NODE_8134_length_930_cov_24.787004	518	598	4	22	80	0.2750000
NODE_8134_length_930_cov_24.787004	571	651	2	15	80	0.1875000
NODE_8134_length_930_cov_24.787004	571	651	3	5	80	0.0625000
NODE_8134_length_930_cov_24.787004	571	651	4	60	80	0.7500000
NODE_8135_length_930_cov_24.608905	300	380	0	80	80	1.0000000
NODE_8135_length_930_cov_24.608905	353	433	0	80	80	1.0000000
NODE_8136_length_930_cov_16.494585	482	562	8	18	80	0.2250000
NODE_8136_length_930_cov_16.494585	482	562	10	62	80	0.7750000
NODE_8136_length_930_cov_16.494585	535	615	3	19	80	0.2375000
NODE_8136_length_930_cov_16.494585	535	615	5	5	80	0.0625000
NODE_8136_length_930_cov_16.494585	535	615	7	10	80	0.1250000
NODE_8136_length_930_cov_16.494585	535	615	8	1	80	0.0125000
NODE_8136_length_930_cov_16.494585	535	615	9	1	80	0.0125000
NODE_8136_length_930_cov_16.494585	535	615	10	44	80	0.5500000
NODE_8137_length_930_cov_13.296029	249	329	4	24	80	0.3000000
NODE_8137_length_930_cov_13.296029	249	329	5	12	80	0.1500000
NODE_8137_length_930_cov_13.296029	249	329	6	44	80	0.5500000
NODE_8137_length_930_cov_13.296029	302	382	4	45	80	0.5625000
NODE_8137_length_930_cov_13.296029	302	382	5	1	80	0.0125000
NODE_8137_length_930_cov_13.296029	302	382	6	34	80	0.4250000
NODE_8137_length_930_cov_13.296029	378	458	3	33	80	0.4125000
NODE_8137_length_930_cov_13.296029	378	458	4	13	80	0.1625000
NODE_8137_length_930_cov_13.296029	378	458	5	33	80	0.4125000
NODE_8137_length_930_cov_13.296029	378	458	6	1	80	0.0125000
NODE_8137_length_930_cov_13.296029	431	511	3	80	80	1.0000000
NODE_8138_length_930_cov_11.758123	463	543	0	46	80	0.5750000
NODE_8138_length_930_cov_11.758123	463	543	1	23	80	0.2875000
NODE_8138_length_930_cov_11.758123	463	543	3	11	80	0.1375000
NODE_8138_length_930_cov_11.758123	516	596	1	16	80	0.2000000
NODE_8138_length_930_cov_11.758123	516	596	3	64	80	0.8000000
NODE_8139_length_930_cov_7.576414	531	611	2	80	80	1.0000000
NODE_8139_length_930_cov_7.576414	584	664	0	9	80	0.1125000
NODE_8139_length_930_cov_7.576414	584	664	1	3	80	0.0375000
NODE_8139_length_930_cov_7.576414	584	664	2	68	80	0.8500000
NODE_8156_length_930_cov_0.821901	676	736	1	23	60	0.3833333
NODE_8156_length_930_cov_0.821901	676	736	3	37	60	0.6166667
NODE_8157_length_929_cov_54.485542	313	393	5	4	80	0.0500000
NODE_8157_length_929_cov_54.485542	313	393	6	3	80	0.0375000
NODE_8157_length_929_cov_54.485542	313	393	7	13	80	0.1625000
NODE_8157_length_929_cov_54.485542	313	393	8	32	80	0.4000000
NODE_8157_length_929_cov_54.485542	313	393	9	27	80	0.3375000
NODE_8157_length_929_cov_54.485542	313	393	10	1	80	0.0125000
NODE_8157_length_929_cov_54.485542	366	446	3	15	80	0.1875000
NODE_8157_length_929_cov_54.485542	366	446	4	17	80	0.2125000
NODE_8157_length_929_cov_54.485542	366	446	5	25	80	0.3125000
NODE_8157_length_929_cov_54.485542	366	446	7	13	80	0.1625000
NODE_8157_length_929_cov_54.485542	366	446	9	10	80	0.1250000
NODE_8157_length_929_cov_54.485542	442	522	0	18	80	0.2250000
NODE_8157_length_929_cov_54.485542	442	522	1	5	80	0.0625000
NODE_8157_length_929_cov_54.485542	442	522	2	37	80	0.4625000
NODE_8157_length_929_cov_54.485542	442	522	3	20	80	0.2500000
NODE_8157_length_929_cov_54.485542	495	575	0	71	80	0.8875000
NODE_8157_length_929_cov_54.485542	495	575	1	5	80	0.0625000
NODE_8157_length_929_cov_54.485542	495	575	2	4	80	0.0500000
NODE_8158_length_929_cov_49.865060	429	509	5	13	80	0.1625000
NODE_8158_length_929_cov_49.865060	429	509	6	15	80	0.1875000
NODE_8158_length_929_cov_49.865060	429	509	7	23	80	0.2875000
NODE_8158_length_929_cov_49.865060	429	509	9	6	80	0.0750000
NODE_8158_length_929_cov_49.865060	429	509	11	5	80	0.0625000
NODE_8158_length_929_cov_49.865060	429	509	12	7	80	0.0875000
NODE_8158_length_929_cov_49.865060	429	509	14	7	80	0.0875000
NODE_8158_length_929_cov_49.865060	429	509	15	4	80	0.0500000
NODE_8158_length_929_cov_49.865060	482	562	9	4	80	0.0500000
NODE_8158_length_929_cov_49.865060	482	562	11	5	80	0.0625000
NODE_8158_length_929_cov_49.865060	482	562	12	7	80	0.0875000
NODE_8158_length_929_cov_49.865060	482	562	13	15	80	0.1875000
NODE_8158_length_929_cov_49.865060	482	562	14	7	80	0.0875000
NODE_8158_length_929_cov_49.865060	482	562	15	41	80	0.5125000
NODE_8158_length_929_cov_49.865060	482	562	16	1	80	0.0125000
NODE_8159_length_929_cov_34.634940	358	438	2	80	80	1.0000000
NODE_8159_length_929_cov_34.634940	411	491	1	15	80	0.1875000
NODE_8159_length_929_cov_34.634940	411	491	2	65	80	0.8125000
NODE_8161_length_929_cov_20.815663	365	445	0	80	80	1.0000000
NODE_8161_length_929_cov_20.815663	418	498	0	80	80	1.0000000
NODE_8162_length_929_cov_17.798795	376	456	3	15	80	0.1875000
NODE_8162_length_929_cov_17.798795	376	456	5	18	80	0.2250000
NODE_8162_length_929_cov_17.798795	376	456	6	39	80	0.4875000
NODE_8162_length_929_cov_17.798795	376	456	7	8	80	0.1000000
NODE_8162_length_929_cov_17.798795	429	509	4	27	80	0.3375000
NODE_8162_length_929_cov_17.798795	429	509	5	38	80	0.4750000
NODE_8162_length_929_cov_17.798795	429	509	6	7	80	0.0875000
NODE_8162_length_929_cov_17.798795	429	509	7	8	80	0.1000000
NODE_8163_length_929_cov_16.622892	331	408	1	10	77	0.1298701
NODE_8163_length_929_cov_16.622892	331	408	2	3	77	0.0389610
NODE_8163_length_929_cov_16.622892	331	408	3	64	77	0.8311688
NODE_8163_length_929_cov_16.622892	381	461	1	63	80	0.7875000
NODE_8163_length_929_cov_16.622892	381	461	3	17	80	0.2125000
NODE_8163_length_929_cov_16.622892	457	537	0	42	80	0.5250000
NODE_8163_length_929_cov_16.622892	457	537	1	38	80	0.4750000
NODE_8163_length_929_cov_16.622892	510	590	0	16	80	0.2000000
NODE_8163_length_929_cov_16.622892	510	590	1	64	80	0.8000000
NODE_8164_length_929_cov_15.242169	302	382	2	26	80	0.3250000
NODE_8164_length_929_cov_15.242169	302	382	3	31	80	0.3875000
NODE_8164_length_929_cov_15.242169	302	382	4	23	80	0.2875000
NODE_8164_length_929_cov_15.242169	355	435	1	45	80	0.5625000
NODE_8164_length_929_cov_15.242169	355	435	2	18	80	0.2250000
NODE_8164_length_929_cov_15.242169	355	435	3	17	80	0.2125000
NODE_8164_length_929_cov_15.242169	431	511	1	80	80	1.0000000
NODE_8164_length_929_cov_15.242169	484	564	0	47	80	0.5875000
NODE_8164_length_929_cov_15.242169	484	564	1	33	80	0.4125000
NODE_8165_length_929_cov_13.197590	259	339	0	80	80	1.0000000
NODE_8165_length_929_cov_13.197590	312	392	0	80	80	1.0000000
NODE_8167_length_929_cov_7.766265	385	465	0	80	80	1.0000000
NODE_8167_length_929_cov_7.766265	438	518	0	80	80	1.0000000
NODE_8168_length_929_cov_5.750602	382	462	0	80	80	1.0000000
NODE_8168_length_929_cov_5.750602	435	515	0	80	80	1.0000000
NODE_8181_length_928_cov_35.226779	273	353	0	80	80	1.0000000
NODE_8181_length_928_cov_35.226779	326	406	0	80	80	1.0000000
NODE_8181_length_928_cov_35.226779	402	482	0	80	80	1.0000000
NODE_8181_length_928_cov_35.226779	455	535	0	80	80	1.0000000
NODE_8182_length_928_cov_25.218335	299	379	3	5	80	0.0625000
NODE_8182_length_928_cov_25.218335	299	379	4	4	80	0.0500000
NODE_8182_length_928_cov_25.218335	299	379	5	26	80	0.3250000
NODE_8182_length_928_cov_25.218335	299	379	7	8	80	0.1000000
NODE_8182_length_928_cov_25.218335	299	379	8	33	80	0.4125000
NODE_8182_length_928_cov_25.218335	299	379	9	4	80	0.0500000
NODE_8182_length_928_cov_25.218335	352	432	6	29	80	0.3625000
NODE_8182_length_928_cov_25.218335	352	432	7	32	80	0.4000000
NODE_8182_length_928_cov_25.218335	352	432	8	19	80	0.2375000
NODE_8183_length_928_cov_22.815440	342	422	1	80	80	1.0000000
NODE_8183_length_928_cov_22.815440	395	475	0	7	80	0.0875000
NODE_8183_length_928_cov_22.815440	395	475	1	71	80	0.8875000
NODE_8183_length_928_cov_22.815440	395	475	2	2	80	0.0250000
NODE_8183_length_928_cov_22.815440	471	551	1	2	80	0.0250000
NODE_8183_length_928_cov_22.815440	471	551	2	78	80	0.9750000
NODE_8183_length_928_cov_22.815440	524	604	1	18	80	0.2250000
NODE_8183_length_928_cov_22.815440	524	604	2	62	80	0.7750000
NODE_8184_length_928_cov_20.718938	365	445	4	45	80	0.5625000
NODE_8184_length_928_cov_20.718938	365	445	5	14	80	0.1750000
NODE_8184_length_928_cov_20.718938	365	445	6	16	80	0.2000000
NODE_8184_length_928_cov_20.718938	365	445	7	5	80	0.0625000
NODE_8184_length_928_cov_20.718938	418	498	3	7	80	0.0875000
NODE_8184_length_928_cov_20.718938	418	498	4	53	80	0.6625000
NODE_8184_length_928_cov_20.718938	418	498	6	15	80	0.1875000
NODE_8184_length_928_cov_20.718938	418	498	7	5	80	0.0625000
NODE_8185_length_928_cov_19.418577	420	500	3	11	80	0.1375000
NODE_8185_length_928_cov_19.418577	420	500	4	6	80	0.0750000
NODE_8185_length_928_cov_19.418577	420	500	5	29	80	0.3625000
NODE_8185_length_928_cov_19.418577	420	500	6	34	80	0.4250000
NODE_8185_length_928_cov_19.418577	473	553	1	7	80	0.0875000
NODE_8185_length_928_cov_19.418577	473	553	4	1	80	0.0125000
NODE_8185_length_928_cov_19.418577	473	553	5	4	80	0.0500000
NODE_8185_length_928_cov_19.418577	473	553	6	68	80	0.8500000
NODE_8185_length_928_cov_19.418577	549	591	1	42	42	1.0000000
NODE_8186_length_928_cov_13.354644	323	403	0	80	80	1.0000000
NODE_8186_length_928_cov_13.354644	376	456	0	80	80	1.0000000
NODE_8187_length_928_cov_13.096502	361	441	0	31	80	0.3875000
NODE_8187_length_928_cov_13.096502	361	441	1	49	80	0.6125000
NODE_8187_length_928_cov_13.096502	414	494	1	51	80	0.6375000
NODE_8187_length_928_cov_13.096502	414	494	2	29	80	0.3625000
NODE_8189_length_928_cov_10.399276	447	527	0	80	80	1.0000000
NODE_8189_length_928_cov_10.399276	500	580	0	80	80	1.0000000
NODE_8207_length_927_cov_19.516908	398	478	3	3	80	0.0375000
NODE_8207_length_927_cov_19.516908	398	478	4	77	80	0.9625000
NODE_8207_length_927_cov_19.516908	451	531	0	32	80	0.4000000
NODE_8207_length_927_cov_19.516908	451	531	2	10	80	0.1250000
NODE_8207_length_927_cov_19.516908	451	531	3	14	80	0.1750000
NODE_8207_length_927_cov_19.516908	451	531	4	24	80	0.3000000
NODE_8208_length_927_cov_11.190821	358	438	1	80	80	1.0000000
NODE_8208_length_927_cov_11.190821	411	491	1	80	80	1.0000000
NODE_8209_length_927_cov_8.123188	239	319	1	80	80	1.0000000
NODE_8209_length_927_cov_8.123188	292	372	0	27	80	0.3375000
NODE_8209_length_927_cov_8.123188	292	372	1	53	80	0.6625000
NODE_8210_length_927_cov_4.585749	515	595	0	80	80	1.0000000
NODE_8210_length_927_cov_4.585749	568	648	0	80	80	1.0000000
NODE_8222_length_927_cov_1.250000	626	706	0	80	80	1.0000000
NODE_8222_length_927_cov_1.250000	679	759	0	27	80	0.3375000
NODE_8222_length_927_cov_1.250000	679	759	1	53	80	0.6625000
NODE_8227_length_926_cov_78.382104	433	513	6	14	80	0.1750000
NODE_8227_length_926_cov_78.382104	433	513	7	26	80	0.3250000
NODE_8227_length_926_cov_78.382104	433	513	8	40	80	0.5000000
NODE_8227_length_926_cov_78.382104	486	566	4	19	80	0.2375000
NODE_8227_length_926_cov_78.382104	486	566	5	12	80	0.1500000
NODE_8227_length_926_cov_78.382104	486	566	6	12	80	0.1500000
NODE_8227_length_926_cov_78.382104	486	566	7	36	80	0.4500000
NODE_8227_length_926_cov_78.382104	486	566	8	1	80	0.0125000
NODE_8228_length_926_cov_44.385732	383	463	18	9	80	0.1125000
NODE_8228_length_926_cov_44.385732	383	463	19	3	80	0.0375000
NODE_8228_length_926_cov_44.385732	383	463	20	7	80	0.0875000
NODE_8228_length_926_cov_44.385732	383	463	21	10	80	0.1250000
NODE_8228_length_926_cov_44.385732	383	463	22	29	80	0.3625000
NODE_8228_length_926_cov_44.385732	383	463	23	22	80	0.2750000
NODE_8228_length_926_cov_44.385732	436	516	12	4	80	0.0500000
NODE_8228_length_926_cov_44.385732	436	516	13	4	80	0.0500000
NODE_8228_length_926_cov_44.385732	436	516	14	3	80	0.0375000
NODE_8228_length_926_cov_44.385732	436	516	15	2	80	0.0250000
NODE_8228_length_926_cov_44.385732	436	516	16	16	80	0.2000000
NODE_8228_length_926_cov_44.385732	436	516	17	5	80	0.0625000
NODE_8228_length_926_cov_44.385732	436	516	18	9	80	0.1125000
NODE_8228_length_926_cov_44.385732	436	516	19	13	80	0.1625000
NODE_8228_length_926_cov_44.385732	436	516	20	7	80	0.0875000
NODE_8228_length_926_cov_44.385732	436	516	21	7	80	0.0875000
NODE_8228_length_926_cov_44.385732	436	516	22	10	80	0.1250000
NODE_8229_length_926_cov_43.446191	362	442	1	29	80	0.3625000
NODE_8229_length_926_cov_43.446191	362	442	2	42	80	0.5250000
NODE_8229_length_926_cov_43.446191	362	442	3	9	80	0.1125000
NODE_8229_length_926_cov_43.446191	415	495	2	39	80	0.4875000
NODE_8229_length_926_cov_43.446191	415	495	3	41	80	0.5125000
NODE_8229_length_926_cov_43.446191	491	571	1	22	80	0.2750000
NODE_8229_length_926_cov_43.446191	491	571	2	8	80	0.1000000
NODE_8229_length_926_cov_43.446191	491	571	3	50	80	0.6250000
NODE_8229_length_926_cov_43.446191	544	624	0	20	80	0.2500000
NODE_8229_length_926_cov_43.446191	544	624	1	55	80	0.6875000
NODE_8229_length_926_cov_43.446191	544	624	2	5	80	0.0625000
NODE_8230_length_926_cov_40.163241	42	61	0	19	19	1.0000000
NODE_8230_length_926_cov_40.163241	279	359	0	5	80	0.0625000
NODE_8230_length_926_cov_40.163241	279	359	1	1	80	0.0125000
NODE_8230_length_926_cov_40.163241	279	359	3	74	80	0.9250000
NODE_8230_length_926_cov_40.163241	332	412	0	58	80	0.7250000
NODE_8230_length_926_cov_40.163241	332	412	1	1	80	0.0125000
NODE_8230_length_926_cov_40.163241	332	412	3	21	80	0.2625000
NODE_8230_length_926_cov_40.163241	408	488	0	80	80	1.0000000
NODE_8230_length_926_cov_40.163241	461	541	0	80	80	1.0000000
NODE_8231_length_926_cov_29.923821	372	452	0	12	80	0.1500000
NODE_8231_length_926_cov_29.923821	372	452	3	31	80	0.3875000
NODE_8231_length_926_cov_29.923821	372	452	5	18	80	0.2250000
NODE_8231_length_926_cov_29.923821	372	452	7	19	80	0.2375000
NODE_8231_length_926_cov_29.923821	425	505	5	8	80	0.1000000
NODE_8231_length_926_cov_29.923821	425	505	6	6	80	0.0750000
NODE_8231_length_926_cov_29.923821	425	505	7	29	80	0.3625000
NODE_8231_length_926_cov_29.923821	425	505	8	37	80	0.4625000
NODE_8232_length_926_cov_24.657799	350	430	3	2	80	0.0250000
NODE_8232_length_926_cov_24.657799	350	430	5	16	80	0.2000000
NODE_8232_length_926_cov_24.657799	350	430	6	62	80	0.7750000
NODE_8232_length_926_cov_24.657799	403	483	3	19	80	0.2375000
NODE_8232_length_926_cov_24.657799	403	483	4	20	80	0.2500000
NODE_8232_length_926_cov_24.657799	403	483	6	41	80	0.5125000
NODE_8233_length_926_cov_17.438936	360	440	0	80	80	1.0000000
NODE_8233_length_926_cov_17.438936	413	493	0	80	80	1.0000000
NODE_8234_length_926_cov_12.413543	418	491	0	2	73	0.0273973
NODE_8234_length_926_cov_12.413543	418	491	2	71	73	0.9726027
NODE_8234_length_926_cov_12.413543	464	544	0	2	80	0.0250000
NODE_8234_length_926_cov_12.413543	464	544	1	1	80	0.0125000
NODE_8234_length_926_cov_12.413543	464	544	2	77	80	0.9625000
NODE_8235_length_926_cov_5.771463	453	533	0	80	80	1.0000000
NODE_8235_length_926_cov_5.771463	505	586	0	81	81	1.0000000
NODE_8236_length_926_cov_5.209190	435	515	2	25	80	0.3125000
NODE_8236_length_926_cov_5.209190	435	515	3	45	80	0.5625000
NODE_8236_length_926_cov_5.209190	435	515	4	10	80	0.1250000
NODE_8236_length_926_cov_5.209190	488	568	3	17	80	0.2125000
NODE_8236_length_926_cov_5.209190	488	568	4	53	80	0.6625000
NODE_8236_length_926_cov_5.209190	488	568	5	10	80	0.1250000
NODE_8247_length_925_cov_40.767554	514	594	3	22	80	0.2750000
NODE_8247_length_925_cov_40.767554	514	594	4	48	80	0.6000000
NODE_8247_length_925_cov_40.767554	514	594	5	10	80	0.1250000
NODE_8247_length_925_cov_40.767554	567	647	2	3	80	0.0375000
NODE_8247_length_925_cov_40.767554	567	647	4	55	80	0.6875000
NODE_8247_length_925_cov_40.767554	567	647	5	22	80	0.2750000
NODE_8248_length_925_cov_30.226392	262	342	0	53	80	0.6625000
NODE_8248_length_925_cov_30.226392	262	342	1	15	80	0.1875000
NODE_8248_length_925_cov_30.226392	262	342	2	12	80	0.1500000
NODE_8248_length_925_cov_30.226392	315	395	1	15	80	0.1875000
NODE_8248_length_925_cov_30.226392	315	395	2	65	80	0.8125000
NODE_8248_length_925_cov_30.226392	391	471	2	27	80	0.3375000
NODE_8248_length_925_cov_30.226392	391	471	3	53	80	0.6625000
NODE_8248_length_925_cov_30.226392	444	524	1	44	80	0.5500000
NODE_8248_length_925_cov_30.226392	444	524	2	15	80	0.1875000
NODE_8248_length_925_cov_30.226392	444	524	3	21	80	0.2625000
NODE_8249_length_925_cov_22.075061	334	414	3	12	80	0.1500000
NODE_8249_length_925_cov_22.075061	334	414	4	19	80	0.2375000
NODE_8249_length_925_cov_22.075061	334	414	5	49	80	0.6125000
NODE_8249_length_925_cov_22.075061	387	467	2	29	80	0.3625000
NODE_8249_length_925_cov_22.075061	387	467	3	16	80	0.2000000
NODE_8249_length_925_cov_22.075061	387	467	4	9	80	0.1125000
NODE_8249_length_925_cov_22.075061	387	467	5	26	80	0.3250000
NODE_8250_length_925_cov_18.164649	410	490	0	43	80	0.5375000
NODE_8250_length_925_cov_18.164649	410	490	2	37	80	0.4625000
NODE_8250_length_925_cov_18.164649	464	543	2	79	79	1.0000000
NODE_8251_length_925_cov_14.067797	472	548	0	16	76	0.2105263
NODE_8251_length_925_cov_14.067797	472	548	1	60	76	0.7894737
NODE_8251_length_925_cov_14.067797	525	601	1	76	76	1.0000000
NODE_8252_length_925_cov_7.098063	418	498	0	80	80	1.0000000
NODE_8252_length_925_cov_7.098063	471	551	0	80	80	1.0000000
NODE_8266_length_924_cov_61.292121	397	477	4	15	80	0.1875000
NODE_8266_length_924_cov_61.292121	397	477	5	9	80	0.1125000
NODE_8266_length_924_cov_61.292121	397	477	6	33	80	0.4125000
NODE_8266_length_924_cov_61.292121	397	477	7	3	80	0.0375000
NODE_8266_length_924_cov_61.292121	397	477	8	20	80	0.2500000
NODE_8266_length_924_cov_61.292121	450	530	3	9	80	0.1125000
NODE_8266_length_924_cov_61.292121	450	530	4	59	80	0.7375000
NODE_8266_length_924_cov_61.292121	450	530	5	9	80	0.1125000
NODE_8266_length_924_cov_61.292121	450	530	6	3	80	0.0375000
NODE_8267_length_924_cov_31.522424	375	455	1	46	80	0.5750000
NODE_8267_length_924_cov_31.522424	375	455	2	34	80	0.4250000
NODE_8267_length_924_cov_31.522424	428	508	1	41	80	0.5125000
NODE_8267_length_924_cov_31.522424	428	508	2	39	80	0.4875000
NODE_8268_length_924_cov_30.446061	299	379	0	80	80	1.0000000
NODE_8268_length_924_cov_30.446061	352	432	0	80	80	1.0000000
NODE_8268_length_924_cov_30.446061	428	508	0	80	80	1.0000000
NODE_8268_length_924_cov_30.446061	481	561	0	80	80	1.0000000
NODE_8269_length_924_cov_28.877576	542	622	4	80	80	1.0000000
NODE_8269_length_924_cov_28.877576	595	675	0	24	80	0.3000000
NODE_8269_length_924_cov_28.877576	595	675	2	4	80	0.0500000
NODE_8269_length_924_cov_28.877576	595	675	4	52	80	0.6500000
NODE_8270_length_924_cov_27.261818	506	586	2	11	80	0.1375000
NODE_8270_length_924_cov_27.261818	506	586	4	1	80	0.0125000
NODE_8270_length_924_cov_27.261818	506	586	5	54	80	0.6750000
NODE_8270_length_924_cov_27.261818	506	586	6	14	80	0.1750000
NODE_8270_length_924_cov_27.261818	559	639	2	10	80	0.1250000
NODE_8270_length_924_cov_27.261818	559	639	3	15	80	0.1875000
NODE_8270_length_924_cov_27.261818	559	639	5	17	80	0.2125000
NODE_8270_length_924_cov_27.261818	559	639	6	38	80	0.4750000
NODE_8271_length_924_cov_25.946667	371	451	0	80	80	1.0000000
NODE_8271_length_924_cov_25.946667	424	504	0	80	80	1.0000000
NODE_8271_length_924_cov_25.946667	500	580	0	13	80	0.1625000
NODE_8271_length_924_cov_25.946667	500	580	1	14	80	0.1750000
NODE_8271_length_924_cov_25.946667	500	580	3	53	80	0.6625000
NODE_8271_length_924_cov_25.946667	553	633	3	80	80	1.0000000
NODE_8272_length_924_cov_25.113939	305	385	0	80	80	1.0000000
NODE_8272_length_924_cov_25.113939	358	438	0	67	80	0.8375000
NODE_8272_length_924_cov_25.113939	358	438	2	13	80	0.1625000
NODE_8272_length_924_cov_25.113939	434	514	2	10	80	0.1250000
NODE_8272_length_924_cov_25.113939	434	514	3	1	80	0.0125000
NODE_8272_length_924_cov_25.113939	434	514	4	19	80	0.2375000
NODE_8272_length_924_cov_25.113939	434	514	6	50	80	0.6250000
NODE_8272_length_924_cov_25.113939	487	567	4	11	80	0.1375000
NODE_8272_length_924_cov_25.113939	487	567	6	69	80	0.8625000
NODE_8273_length_924_cov_16.343030	481	561	0	61	80	0.7625000
NODE_8273_length_924_cov_16.343030	481	561	2	19	80	0.2375000
NODE_8273_length_924_cov_16.343030	534	614	0	8	80	0.1000000
NODE_8273_length_924_cov_16.343030	534	614	2	72	80	0.9000000
NODE_8274_length_924_cov_14.793939	299	379	0	80	80	1.0000000
NODE_8274_length_924_cov_14.793939	352	432	0	80	80	1.0000000
NODE_8275_length_924_cov_14.209697	485	562	2	25	77	0.3246753
NODE_8275_length_924_cov_14.209697	485	562	3	52	77	0.6753247
NODE_8275_length_924_cov_14.209697	535	615	1	15	80	0.1875000
NODE_8275_length_924_cov_14.209697	535	615	2	28	80	0.3500000
NODE_8275_length_924_cov_14.209697	535	615	3	37	80	0.4625000
NODE_8276_length_924_cov_13.423030	287	367	0	63	80	0.7875000
NODE_8276_length_924_cov_13.423030	287	367	2	17	80	0.2125000
NODE_8276_length_924_cov_13.423030	340	420	0	10	80	0.1250000
NODE_8276_length_924_cov_13.423030	340	420	2	62	80	0.7750000
NODE_8276_length_924_cov_13.423030	340	420	3	8	80	0.1000000
NODE_8277_length_924_cov_12.008485	237	307	1	40	70	0.5714286
NODE_8277_length_924_cov_12.008485	237	307	2	26	70	0.3714286
NODE_8277_length_924_cov_12.008485	237	307	3	4	70	0.0571429
NODE_8279_length_924_cov_8.619394	560	640	0	80	80	1.0000000
NODE_8279_length_924_cov_8.619394	613	693	0	80	80	1.0000000
NODE_8280_length_924_cov_4.640000	426	506	3	61	80	0.7625000
NODE_8280_length_924_cov_4.640000	426	506	4	19	80	0.2375000
NODE_8280_length_924_cov_4.640000	479	559	1	27	80	0.3375000
NODE_8280_length_924_cov_4.640000	479	559	2	13	80	0.1625000
NODE_8280_length_924_cov_4.640000	479	559	3	40	80	0.5000000
NODE_8290_length_924_cov_1.467879	352	381	1	12	29	0.4137931
NODE_8290_length_924_cov_1.467879	352	381	2	17	29	0.5862069
NODE_8296_length_924_cov_0.648485	830	890	0	60	60	1.0000000
NODE_8296_length_924_cov_0.648485	863	924	0	61	61	1.0000000
NODE_8297_length_923_cov_43.213592	371	451	0	80	80	1.0000000
NODE_8297_length_923_cov_43.213592	424	504	0	80	80	1.0000000
NODE_8297_length_923_cov_43.213592	500	580	0	80	80	1.0000000
NODE_8297_length_923_cov_43.213592	553	633	0	80	80	1.0000000
NODE_8298_length_923_cov_34.108010	370	450	1	24	80	0.3000000
NODE_8298_length_923_cov_34.108010	370	450	2	10	80	0.1250000
NODE_8298_length_923_cov_34.108010	370	450	4	24	80	0.3000000
NODE_8298_length_923_cov_34.108010	370	450	5	20	80	0.2500000
NODE_8298_length_923_cov_34.108010	370	450	6	2	80	0.0250000
NODE_8298_length_923_cov_34.108010	423	503	3	5	80	0.0625000
NODE_8298_length_923_cov_34.108010	423	503	4	5	80	0.0625000
NODE_8298_length_923_cov_34.108010	423	503	5	49	80	0.6125000
NODE_8298_length_923_cov_34.108010	423	503	6	21	80	0.2625000
NODE_8299_length_923_cov_29.163835	392	472	4	4	80	0.0500000
NODE_8299_length_923_cov_29.163835	392	472	5	34	80	0.4250000
NODE_8299_length_923_cov_29.163835	392	472	6	14	80	0.1750000
NODE_8299_length_923_cov_29.163835	392	472	7	15	80	0.1875000
NODE_8299_length_923_cov_29.163835	392	472	8	13	80	0.1625000
NODE_8299_length_923_cov_29.163835	445	525	4	18	80	0.2250000
NODE_8299_length_923_cov_29.163835	445	525	5	13	80	0.1625000
NODE_8299_length_923_cov_29.163835	445	525	6	22	80	0.2750000
NODE_8299_length_923_cov_29.163835	445	525	7	14	80	0.1750000
NODE_8299_length_923_cov_29.163835	445	525	8	13	80	0.1625000
NODE_8300_length_923_cov_19.139563	375	455	0	80	80	1.0000000
NODE_8300_length_923_cov_19.139563	428	508	0	80	80	1.0000000
NODE_8301_length_923_cov_17.433252	512	592	2	21	80	0.2625000
NODE_8301_length_923_cov_17.433252	512	592	3	59	80	0.7375000
NODE_8301_length_923_cov_17.433252	565	645	1	12	80	0.1500000
NODE_8301_length_923_cov_17.433252	565	645	3	68	80	0.8500000
NODE_8302_length_923_cov_16.597087	279	359	0	80	80	1.0000000
NODE_8302_length_923_cov_16.597087	332	412	0	80	80	1.0000000
NODE_8303_length_923_cov_15.229369	446	526	0	80	80	1.0000000
NODE_8303_length_923_cov_15.229369	499	579	0	80	80	1.0000000
NODE_8304_length_923_cov_14.007282	304	349	0	6	45	0.1333333
NODE_8304_length_923_cov_14.007282	304	349	2	39	45	0.8666667
NODE_8304_length_923_cov_14.007282	345	427	2	37	82	0.4512195
NODE_8304_length_923_cov_14.007282	345	427	3	2	82	0.0243902
NODE_8304_length_923_cov_14.007282	345	427	4	24	82	0.2926829
NODE_8304_length_923_cov_14.007282	345	427	5	19	82	0.2317073
NODE_8304_length_923_cov_14.007282	397	480	3	24	83	0.2891566
NODE_8304_length_923_cov_14.007282	397	480	4	36	83	0.4337350
NODE_8304_length_923_cov_14.007282	397	480	5	23	83	0.2771084
NODE_8305_length_923_cov_6.500000	308	388	0	13	80	0.1625000
NODE_8305_length_923_cov_6.500000	308	388	2	67	80	0.8375000
NODE_8305_length_923_cov_6.500000	361	441	0	8	80	0.1000000
NODE_8305_length_923_cov_6.500000	361	441	2	72	80	0.9000000
NODE_8307_length_923_cov_6.115291	447	527	0	44	80	0.5500000
NODE_8307_length_923_cov_6.115291	447	527	1	21	80	0.2625000
NODE_8307_length_923_cov_6.115291	447	527	2	15	80	0.1875000
NODE_8307_length_923_cov_6.115291	500	580	1	12	80	0.1500000
NODE_8307_length_923_cov_6.115291	500	580	2	68	80	0.8500000
NODE_8308_length_923_cov_5.351942	363	445	0	82	82	1.0000000
NODE_8308_length_923_cov_5.351942	365	445	0	80	80	1.0000000
NODE_8317_length_923_cov_1.059466	63	143	0	80	80	1.0000000
NODE_8320_length_922_cov_40.331713	243	289	74	2	46	0.0434783
NODE_8320_length_922_cov_40.331713	243	289	75	1	46	0.0217391
NODE_8320_length_922_cov_40.331713	243	289	76	3	46	0.0652174
NODE_8320_length_922_cov_40.331713	243	289	77	3	46	0.0652174
NODE_8320_length_922_cov_40.331713	243	289	78	2	46	0.0434783
NODE_8320_length_922_cov_40.331713	243	289	79	5	46	0.1086956
NODE_8320_length_922_cov_40.331713	243	289	80	3	46	0.0652174
NODE_8320_length_922_cov_40.331713	243	289	81	4	46	0.0869565
NODE_8320_length_922_cov_40.331713	243	289	83	2	46	0.0434783
NODE_8320_length_922_cov_40.331713	243	289	85	3	46	0.0652174
NODE_8320_length_922_cov_40.331713	243	289	86	2	46	0.0434783
NODE_8320_length_922_cov_40.331713	243	289	88	4	46	0.0869565
NODE_8320_length_922_cov_40.331713	243	289	90	1	46	0.0217391
NODE_8320_length_922_cov_40.331713	243	289	93	3	46	0.0652174
NODE_8320_length_922_cov_40.331713	243	289	96	2	46	0.0434783
NODE_8320_length_922_cov_40.331713	243	289	99	2	46	0.0434783
NODE_8320_length_922_cov_40.331713	243	289	100	2	46	0.0434783
NODE_8320_length_922_cov_40.331713	243	289	102	2	46	0.0434783
NODE_8320_length_922_cov_40.331713	262	342	74	1	80	0.0125000
NODE_8320_length_922_cov_40.331713	262	342	75	1	80	0.0125000
NODE_8320_length_922_cov_40.331713	262	342	77	1	80	0.0125000
NODE_8320_length_922_cov_40.331713	262	342	78	1	80	0.0125000
NODE_8320_length_922_cov_40.331713	262	342	79	3	80	0.0375000
NODE_8320_length_922_cov_40.331713	262	342	80	3	80	0.0375000
NODE_8320_length_922_cov_40.331713	262	342	81	2	80	0.0250000
NODE_8320_length_922_cov_40.331713	262	342	83	1	80	0.0125000
NODE_8320_length_922_cov_40.331713	262	342	88	2	80	0.0250000
NODE_8320_length_922_cov_40.331713	262	342	90	1	80	0.0125000
NODE_8320_length_922_cov_40.331713	262	342	93	3	80	0.0375000
NODE_8320_length_922_cov_40.331713	262	342	96	2	80	0.0250000
NODE_8320_length_922_cov_40.331713	262	342	99	2	80	0.0250000
NODE_8320_length_922_cov_40.331713	262	342	100	2	80	0.0250000
NODE_8320_length_922_cov_40.331713	262	342	102	2	80	0.0250000
NODE_8320_length_922_cov_40.331713	262	342	103	2	80	0.0250000
NODE_8320_length_922_cov_40.331713	262	342	107	2	80	0.0250000
NODE_8320_length_922_cov_40.331713	262	342	108	10	80	0.1250000
NODE_8320_length_922_cov_40.331713	262	342	109	2	80	0.0250000
NODE_8320_length_922_cov_40.331713	262	342	110	10	80	0.1250000
NODE_8320_length_922_cov_40.331713	262	342	111	6	80	0.0750000
NODE_8320_length_922_cov_40.331713	262	342	112	11	80	0.1375000
NODE_8320_length_922_cov_40.331713	262	342	113	7	80	0.0875000
NODE_8320_length_922_cov_40.331713	262	342	114	2	80	0.0250000
NODE_8320_length_922_cov_40.331713	262	342	115	1	80	0.0125000
NODE_8320_length_922_cov_40.331713	780	860	2	18	80	0.2250000
NODE_8320_length_922_cov_40.331713	780	860	3	19	80	0.2375000
NODE_8320_length_922_cov_40.331713	780	860	4	31	80	0.3875000
NODE_8320_length_922_cov_40.331713	780	860	5	12	80	0.1500000
NODE_8320_length_922_cov_40.331713	833	913	0	28	80	0.3500000
NODE_8320_length_922_cov_40.331713	833	913	2	43	80	0.5375000
NODE_8320_length_922_cov_40.331713	833	913	3	9	80	0.1125000
NODE_8321_length_922_cov_38.549210	126	177	137	2	51	0.0392157
NODE_8321_length_922_cov_38.549210	126	177	144	1	51	0.0196078
NODE_8321_length_922_cov_38.549210	126	177	152	1	51	0.0196078
NODE_8321_length_922_cov_38.549210	126	177	157	3	51	0.0588235
NODE_8321_length_922_cov_38.549210	126	177	166	1	51	0.0196078
NODE_8321_length_922_cov_38.549210	126	177	169	1	51	0.0196078
NODE_8321_length_922_cov_38.549210	126	177	171	2	51	0.0392157
NODE_8321_length_922_cov_38.549210	126	177	173	1	51	0.0196078
NODE_8321_length_922_cov_38.549210	126	177	188	1	51	0.0196078
NODE_8321_length_922_cov_38.549210	126	177	197	1	51	0.0196078
NODE_8321_length_922_cov_38.549210	126	177	207	1	51	0.0196078
NODE_8321_length_922_cov_38.549210	126	177	213	1	51	0.0196078
NODE_8321_length_922_cov_38.549210	126	177	217	1	51	0.0196078
NODE_8321_length_922_cov_38.549210	126	177	220	1	51	0.0196078
NODE_8321_length_922_cov_38.549210	126	177	221	1	51	0.0196078
NODE_8321_length_922_cov_38.549210	126	177	223	1	51	0.0196078
NODE_8321_length_922_cov_38.549210	126	177	224	1	51	0.0196078
NODE_8321_length_922_cov_38.549210	126	177	225	1	51	0.0196078
NODE_8321_length_922_cov_38.549210	126	177	227	1	51	0.0196078
NODE_8321_length_922_cov_38.549210	126	177	228	1	51	0.0196078
NODE_8321_length_922_cov_38.549210	126	177	231	2	51	0.0392157
NODE_8321_length_922_cov_38.549210	126	177	233	1	51	0.0196078
NODE_8321_length_922_cov_38.549210	126	177	240	1	51	0.0196078
NODE_8321_length_922_cov_38.549210	126	177	244	1	51	0.0196078
NODE_8321_length_922_cov_38.549210	126	177	246	1	51	0.0196078
NODE_8321_length_922_cov_38.549210	126	177	248	1	51	0.0196078
NODE_8321_length_922_cov_38.549210	126	177	250	2	51	0.0392157
NODE_8321_length_922_cov_38.549210	126	177	252	1	51	0.0196078
NODE_8321_length_922_cov_38.549210	126	177	254	1	51	0.0196078
NODE_8321_length_922_cov_38.549210	126	177	256	1	51	0.0196078
NODE_8321_length_922_cov_38.549210	126	177	260	1	51	0.0196078
NODE_8321_length_922_cov_38.549210	126	177	264	1	51	0.0196078
NODE_8321_length_922_cov_38.549210	126	177	270	1	51	0.0196078
NODE_8321_length_922_cov_38.549210	126	177	271	1	51	0.0196078
NODE_8321_length_922_cov_38.549210	126	177	273	1	51	0.0196078
NODE_8321_length_922_cov_38.549210	126	177	276	1	51	0.0196078
NODE_8321_length_922_cov_38.549210	126	177	277	1	51	0.0196078
NODE_8321_length_922_cov_38.549210	126	177	280	1	51	0.0196078
NODE_8321_length_922_cov_38.549210	126	177	282	1	51	0.0196078
NODE_8321_length_922_cov_38.549210	126	177	284	3	51	0.0588235
NODE_8321_length_922_cov_38.549210	126	177	286	1	51	0.0196078
NODE_8321_length_922_cov_38.549210	126	177	288	1	51	0.0196078
NODE_8321_length_922_cov_38.549210	126	177	290	1	51	0.0196078
NODE_8321_length_922_cov_38.549210	308	383	0	75	75	1.0000000
NODE_8321_length_922_cov_38.549210	356	393	0	37	37	1.0000000
NODE_8321_length_922_cov_38.549210	818	898	0	57	80	0.7125000
NODE_8321_length_922_cov_38.549210	818	898	2	23	80	0.2875000
NODE_8321_length_922_cov_38.549210	871	908	0	37	37	1.0000000
NODE_8322_length_922_cov_35.041312	385	465	0	6	80	0.0750000
NODE_8322_length_922_cov_35.041312	385	465	1	6	80	0.0750000
NODE_8322_length_922_cov_35.041312	385	465	2	29	80	0.3625000
NODE_8322_length_922_cov_35.041312	385	465	3	39	80	0.4875000
NODE_8322_length_922_cov_35.041312	438	518	2	33	80	0.4125000
NODE_8322_length_922_cov_35.041312	438	518	3	7	80	0.0875000
NODE_8322_length_922_cov_35.041312	438	518	4	40	80	0.5000000
NODE_8323_length_922_cov_30.749696	426	506	6	26	80	0.3250000
NODE_8323_length_922_cov_30.749696	426	506	8	54	80	0.6750000
NODE_8323_length_922_cov_30.749696	479	559	2	6	80	0.0750000
NODE_8323_length_922_cov_30.749696	479	559	3	14	80	0.1750000
NODE_8323_length_922_cov_30.749696	479	559	5	16	80	0.2000000
NODE_8323_length_922_cov_30.749696	479	559	6	15	80	0.1875000
NODE_8323_length_922_cov_30.749696	479	559	8	29	80	0.3625000
NODE_8324_length_922_cov_25.558931	291	370	0	13	79	0.1645570
NODE_8324_length_922_cov_25.558931	291	370	1	66	79	0.8354430
NODE_8324_length_922_cov_25.558931	344	423	1	79	79	1.0000000
NODE_8325_length_922_cov_25.527339	391	471	0	80	80	1.0000000
NODE_8325_length_922_cov_25.527339	444	524	0	80	80	1.0000000
NODE_8326_length_922_cov_23.630620	224	304	2	65	80	0.8125000
NODE_8326_length_922_cov_23.630620	224	304	3	15	80	0.1875000
NODE_8326_length_922_cov_23.630620	277	357	2	12	80	0.1500000
NODE_8326_length_922_cov_23.630620	277	357	3	28	80	0.3500000
NODE_8326_length_922_cov_23.630620	277	357	4	40	80	0.5000000
NODE_8326_length_922_cov_23.630620	353	433	2	23	80	0.2875000
NODE_8326_length_922_cov_23.630620	353	433	3	21	80	0.2625000
NODE_8326_length_922_cov_23.630620	353	433	4	36	80	0.4500000
NODE_8326_length_922_cov_23.630620	406	486	2	31	80	0.3875000
NODE_8326_length_922_cov_23.630620	406	486	3	16	80	0.2000000
NODE_8326_length_922_cov_23.630620	406	486	4	33	80	0.4125000
NODE_8327_length_922_cov_22.388821	465	545	0	80	80	1.0000000
NODE_8327_length_922_cov_22.388821	518	598	0	80	80	1.0000000
NODE_8328_length_922_cov_20.320778	421	501	1	10	80	0.1250000
NODE_8328_length_922_cov_20.320778	421	501	2	70	80	0.8750000
NODE_8328_length_922_cov_20.320778	474	554	1	35	80	0.4375000
NODE_8328_length_922_cov_20.320778	474	554	2	45	80	0.5625000
NODE_8329_length_922_cov_17.645200	413	479	2	66	66	1.0000000
NODE_8330_length_922_cov_12.574727	454	534	7	2	80	0.0250000
NODE_8330_length_922_cov_12.574727	454	534	8	30	80	0.3750000
NODE_8330_length_922_cov_12.574727	454	534	9	22	80	0.2750000
NODE_8330_length_922_cov_12.574727	454	534	10	26	80	0.3250000
NODE_8330_length_922_cov_12.574727	507	587	7	17	80	0.2125000
NODE_8330_length_922_cov_12.574727	507	587	8	56	80	0.7000000
NODE_8330_length_922_cov_12.574727	507	587	9	7	80	0.0875000
NODE_8331_length_922_cov_11.934386	255	335	2	4	80	0.0500000
NODE_8331_length_922_cov_11.934386	255	335	3	24	80	0.3000000
NODE_8331_length_922_cov_11.934386	255	335	4	10	80	0.1250000
NODE_8331_length_922_cov_11.934386	255	335	6	42	80	0.5250000
NODE_8331_length_922_cov_11.934386	308	388	4	22	80	0.2750000
NODE_8331_length_922_cov_11.934386	308	388	5	26	80	0.3250000
NODE_8331_length_922_cov_11.934386	308	388	6	32	80	0.4000000
NODE_8332_length_922_cov_11.068044	423	503	2	35	80	0.4375000
NODE_8332_length_922_cov_11.068044	423	503	3	16	80	0.2000000
NODE_8332_length_922_cov_11.068044	423	503	4	29	80	0.3625000
NODE_8332_length_922_cov_11.068044	476	557	2	24	81	0.2962963
NODE_8332_length_922_cov_11.068044	476	557	4	57	81	0.7037037
NODE_8333_length_922_cov_7.907655	441	521	0	80	80	1.0000000
NODE_8333_length_922_cov_7.907655	494	574	0	80	80	1.0000000
NODE_8334_length_922_cov_7.737546	463	543	1	23	80	0.2875000
NODE_8334_length_922_cov_7.737546	463	543	2	57	80	0.7125000
NODE_8334_length_922_cov_7.737546	516	596	1	58	80	0.7250000
NODE_8334_length_922_cov_7.737546	516	596	2	22	80	0.2750000
NODE_8335_length_922_cov_7.241798	298	378	0	80	80	1.0000000
NODE_8335_length_922_cov_7.241798	351	431	0	80	80	1.0000000
NODE_8347_length_921_cov_21.317518	457	537	1	28	80	0.3500000
NODE_8347_length_921_cov_21.317518	457	537	2	52	80	0.6500000
NODE_8347_length_921_cov_21.317518	510	590	1	80	80	1.0000000
NODE_8348_length_921_cov_18.462287	519	599	1	34	80	0.4250000
NODE_8348_length_921_cov_18.462287	519	599	2	46	80	0.5750000
NODE_8348_length_921_cov_18.462287	572	652	1	80	80	1.0000000
NODE_8349_length_921_cov_15.440389	373	453	0	80	80	1.0000000
NODE_8349_length_921_cov_15.440389	426	506	0	80	80	1.0000000
NODE_8350_length_921_cov_13.216545	465	545	0	80	80	1.0000000
NODE_8350_length_921_cov_13.216545	518	598	0	80	80	1.0000000
NODE_8351_length_921_cov_9.283455	399	439	0	40	40	1.0000000
NODE_8351_length_921_cov_9.283455	532	612	0	80	80	1.0000000
NODE_8351_length_921_cov_9.283455	585	665	0	80	80	1.0000000
NODE_8352_length_921_cov_8.253041	289	369	0	80	80	1.0000000
NODE_8352_length_921_cov_8.253041	342	422	0	80	80	1.0000000
NODE_8364_length_920_cov_47.493301	543	623	4	14	80	0.1750000
NODE_8364_length_920_cov_47.493301	543	623	5	1	80	0.0125000
NODE_8364_length_920_cov_47.493301	543	623	6	22	80	0.2750000
NODE_8364_length_920_cov_47.493301	543	623	7	15	80	0.1875000
NODE_8364_length_920_cov_47.493301	543	623	8	28	80	0.3500000
NODE_8364_length_920_cov_47.493301	596	676	5	54	80	0.6750000
NODE_8364_length_920_cov_47.493301	596	676	6	16	80	0.2000000
NODE_8364_length_920_cov_47.493301	596	676	8	10	80	0.1250000
NODE_8365_length_920_cov_30.404385	543	623	0	59	80	0.7375000
NODE_8365_length_920_cov_30.404385	543	623	1	11	80	0.1375000
NODE_8365_length_920_cov_30.404385	543	623	2	10	80	0.1250000
NODE_8365_length_920_cov_30.404385	596	676	0	6	80	0.0750000
NODE_8365_length_920_cov_30.404385	596	676	1	11	80	0.1375000
NODE_8365_length_920_cov_30.404385	596	676	2	63	80	0.7875000
NODE_8366_length_920_cov_25.360536	413	493	0	18	80	0.2250000
NODE_8366_length_920_cov_25.360536	413	493	1	62	80	0.7750000
NODE_8366_length_920_cov_25.360536	466	546	1	80	80	1.0000000
NODE_8366_length_920_cov_25.360536	542	615	1	8	73	0.1095890
NODE_8366_length_920_cov_25.360536	542	615	3	5	73	0.0684932
NODE_8366_length_920_cov_25.360536	542	615	4	9	73	0.1232877
NODE_8366_length_920_cov_25.360536	542	615	5	31	73	0.4246575
NODE_8366_length_920_cov_25.360536	542	615	6	12	73	0.1643836
NODE_8366_length_920_cov_25.360536	542	615	7	8	73	0.1095890
NODE_8366_length_920_cov_25.360536	588	668	5	7	80	0.0875000
NODE_8366_length_920_cov_25.360536	588	668	6	12	80	0.1500000
NODE_8366_length_920_cov_25.360536	588	668	7	40	80	0.5000000
NODE_8366_length_920_cov_25.360536	588	668	8	4	80	0.0500000
NODE_8366_length_920_cov_25.360536	588	668	9	17	80	0.2125000
NODE_8367_length_920_cov_24.918392	403	483	3	77	80	0.9625000
NODE_8367_length_920_cov_24.918392	403	483	4	3	80	0.0375000
NODE_8367_length_920_cov_24.918392	456	536	1	22	80	0.2750000
NODE_8367_length_920_cov_24.918392	456	536	3	58	80	0.7250000
NODE_8368_length_920_cov_18.517661	353	433	6	22	80	0.2750000
NODE_8368_length_920_cov_18.517661	353	433	7	10	80	0.1250000
NODE_8368_length_920_cov_18.517661	353	433	8	4	80	0.0500000
NODE_8368_length_920_cov_18.517661	353	433	9	5	80	0.0625000
NODE_8368_length_920_cov_18.517661	353	433	10	39	80	0.4875000
NODE_8368_length_920_cov_18.517661	406	486	2	5	80	0.0625000
NODE_8368_length_920_cov_18.517661	406	486	3	36	80	0.4500000
NODE_8368_length_920_cov_18.517661	406	486	4	1	80	0.0125000
NODE_8368_length_920_cov_18.517661	406	486	5	9	80	0.1125000
NODE_8368_length_920_cov_18.517661	406	486	6	24	80	0.3000000
NODE_8368_length_920_cov_18.517661	406	486	7	5	80	0.0625000
NODE_8369_length_920_cov_17.710110	310	390	1	47	80	0.5875000
NODE_8369_length_920_cov_17.710110	310	390	2	33	80	0.4125000
NODE_8369_length_920_cov_17.710110	363	443	1	13	80	0.1625000
NODE_8369_length_920_cov_17.710110	363	443	2	67	80	0.8375000
NODE_8370_length_920_cov_15.650426	403	458	1	10	55	0.1818182
NODE_8370_length_920_cov_15.650426	403	458	3	45	55	0.8181818
NODE_8371_length_920_cov_12.588307	454	534	0	80	80	1.0000000
NODE_8371_length_920_cov_12.588307	507	586	0	79	79	1.0000000
NODE_8372_length_920_cov_10.822168	354	434	0	43	80	0.5375000
NODE_8372_length_920_cov_10.822168	354	434	1	37	80	0.4625000
NODE_8372_length_920_cov_10.822168	407	487	1	30	80	0.3750000
NODE_8372_length_920_cov_10.822168	407	487	2	50	80	0.6250000
NODE_8374_length_920_cov_8.297199	453	533	0	80	80	1.0000000
NODE_8374_length_920_cov_8.297199	506	583	0	77	77	1.0000000
NODE_8378_length_920_cov_2.992692	501	581	0	80	80	1.0000000
NODE_8378_length_920_cov_2.992692	554	634	0	80	80	1.0000000
NODE_8389_length_919_cov_44.813415	338	418	1	6	80	0.0750000
NODE_8389_length_919_cov_44.813415	338	418	2	50	80	0.6250000
NODE_8389_length_919_cov_44.813415	338	418	3	24	80	0.3000000
NODE_8389_length_919_cov_44.813415	391	471	1	6	80	0.0750000
NODE_8389_length_919_cov_44.813415	391	471	2	74	80	0.9250000
NODE_8389_length_919_cov_44.813415	467	547	1	66	80	0.8250000
NODE_8389_length_919_cov_44.813415	467	547	2	14	80	0.1750000
NODE_8389_length_919_cov_44.813415	520	600	0	50	80	0.6250000
NODE_8389_length_919_cov_44.813415	520	600	1	30	80	0.3750000
NODE_8390_length_919_cov_37.459756	389	469	3	49	80	0.6125000
NODE_8390_length_919_cov_37.459756	389	469	4	27	80	0.3375000
NODE_8390_length_919_cov_37.459756	389	469	5	4	80	0.0500000
NODE_8390_length_919_cov_37.459756	442	522	3	23	80	0.2875000
NODE_8390_length_919_cov_37.459756	442	522	4	27	80	0.3375000
NODE_8390_length_919_cov_37.459756	442	522	5	30	80	0.3750000
NODE_8390_length_919_cov_37.459756	518	598	3	13	80	0.1625000
NODE_8390_length_919_cov_37.459756	518	598	4	46	80	0.5750000
NODE_8390_length_919_cov_37.459756	518	598	5	21	80	0.2625000
NODE_8390_length_919_cov_37.459756	571	651	3	27	80	0.3375000
NODE_8390_length_919_cov_37.459756	571	651	4	24	80	0.3000000
NODE_8390_length_919_cov_37.459756	571	651	5	29	80	0.3625000
NODE_8391_length_919_cov_35.002439	474	554	0	80	80	1.0000000
NODE_8391_length_919_cov_35.002439	527	607	0	80	80	1.0000000
NODE_8392_length_919_cov_29.935366	246	326	0	64	80	0.8000000
NODE_8392_length_919_cov_29.935366	246	326	2	16	80	0.2000000
NODE_8392_length_919_cov_29.935366	299	379	0	11	80	0.1375000
NODE_8392_length_919_cov_29.935366	299	379	2	69	80	0.8625000
NODE_8393_length_919_cov_28.190244	470	550	2	24	80	0.3000000
NODE_8393_length_919_cov_28.190244	470	550	3	1	80	0.0125000
NODE_8393_length_919_cov_28.190244	470	550	4	13	80	0.1625000
NODE_8393_length_919_cov_28.190244	470	550	6	42	80	0.5250000
NODE_8393_length_919_cov_28.190244	523	603	2	77	80	0.9625000
NODE_8393_length_919_cov_28.190244	523	603	3	1	80	0.0125000
NODE_8393_length_919_cov_28.190244	523	603	4	2	80	0.0250000
NODE_8394_length_919_cov_27.119512	454	534	1	19	80	0.2375000
NODE_8394_length_919_cov_27.119512	454	534	2	61	80	0.7625000
NODE_8394_length_919_cov_27.119512	507	587	1	3	80	0.0375000
NODE_8394_length_919_cov_27.119512	507	587	2	77	80	0.9625000
NODE_8395_length_919_cov_21.836585	545	625	3	48	80	0.6000000
NODE_8395_length_919_cov_21.836585	545	625	4	17	80	0.2125000
NODE_8395_length_919_cov_21.836585	545	625	5	15	80	0.1875000
NODE_8395_length_919_cov_21.836585	598	677	3	12	79	0.1518987
NODE_8395_length_919_cov_21.836585	598	677	4	9	79	0.1139240
NODE_8395_length_919_cov_21.836585	598	677	5	58	79	0.7341772
NODE_8396_length_919_cov_17.442683	385	465	0	80	80	1.0000000
NODE_8396_length_919_cov_17.442683	438	518	0	80	80	1.0000000
NODE_8397_length_919_cov_16.685366	309	389	1	1	80	0.0125000
NODE_8397_length_919_cov_16.685366	309	389	2	79	80	0.9875000
NODE_8397_length_919_cov_16.685366	362	442	1	9	80	0.1125000
NODE_8397_length_919_cov_16.685366	362	442	2	71	80	0.8875000
NODE_8398_length_919_cov_14.013415	435	515	0	44	80	0.5500000
NODE_8398_length_919_cov_14.013415	435	515	2	36	80	0.4500000
NODE_8398_length_919_cov_14.013415	488	568	2	80	80	1.0000000
NODE_8399_length_919_cov_12.013415	340	420	0	80	80	1.0000000
NODE_8399_length_919_cov_12.013415	393	473	0	80	80	1.0000000
NODE_8403_length_919_cov_3.529268	424	504	0	80	80	1.0000000
NODE_8403_length_919_cov_3.529268	477	557	0	80	80	1.0000000
NODE_8404_length_919_cov_3.200000	444	524	0	80	80	1.0000000
NODE_8404_length_919_cov_3.200000	497	577	0	80	80	1.0000000
NODE_8415_length_918_cov_41.115995	387	467	9	43	80	0.5375000
NODE_8415_length_918_cov_41.115995	387	467	10	20	80	0.2500000
NODE_8415_length_918_cov_41.115995	387	467	11	17	80	0.2125000
NODE_8415_length_918_cov_41.115995	440	520	5	12	80	0.1500000
NODE_8415_length_918_cov_41.115995	440	520	6	6	80	0.0750000
NODE_8415_length_918_cov_41.115995	440	520	7	29	80	0.3625000
NODE_8415_length_918_cov_41.115995	440	520	9	22	80	0.2750000
NODE_8415_length_918_cov_41.115995	440	520	11	11	80	0.1375000
NODE_8416_length_918_cov_37.405372	427	507	2	80	80	1.0000000
NODE_8416_length_918_cov_37.405372	480	560	0	1	80	0.0125000
NODE_8416_length_918_cov_37.405372	480	560	1	9	80	0.1125000
NODE_8416_length_918_cov_37.405372	480	560	2	70	80	0.8750000
NODE_8417_length_918_cov_31.559219	289	369	4	12	80	0.1500000
NODE_8417_length_918_cov_31.559219	289	369	5	31	80	0.3875000
NODE_8417_length_918_cov_31.559219	289	369	6	37	80	0.4625000
NODE_8417_length_918_cov_31.559219	342	422	3	2	80	0.0250000
NODE_8417_length_918_cov_31.559219	342	422	4	13	80	0.1625000
NODE_8417_length_918_cov_31.559219	342	422	5	6	80	0.0750000
NODE_8417_length_918_cov_31.559219	342	422	6	59	80	0.7375000
NODE_8417_length_918_cov_31.559219	418	498	3	16	80	0.2000000
NODE_8417_length_918_cov_31.559219	418	498	4	40	80	0.5000000
NODE_8417_length_918_cov_31.559219	418	498	5	24	80	0.3000000
NODE_8417_length_918_cov_31.559219	471	551	2	7	80	0.0875000
NODE_8417_length_918_cov_31.559219	471	551	3	62	80	0.7750000
NODE_8417_length_918_cov_31.559219	471	551	4	11	80	0.1375000
NODE_8418_length_918_cov_25.195360	429	509	0	80	80	1.0000000
NODE_8418_length_918_cov_25.195360	482	562	0	80	80	1.0000000
NODE_8420_length_918_cov_10.537241	361	441	0	27	80	0.3375000
NODE_8420_length_918_cov_10.537241	361	441	1	13	80	0.1625000
NODE_8420_length_918_cov_10.537241	361	441	3	9	80	0.1125000
NODE_8420_length_918_cov_10.537241	361	441	4	31	80	0.3875000
NODE_8420_length_918_cov_10.537241	414	492	4	78	78	1.0000000
NODE_8421_length_918_cov_9.821734	283	363	3	80	80	1.0000000
NODE_8421_length_918_cov_9.821734	336	416	1	24	80	0.3000000
NODE_8421_length_918_cov_9.821734	336	416	2	25	80	0.3125000
NODE_8421_length_918_cov_9.821734	336	416	3	31	80	0.3875000
NODE_8422_length_918_cov_9.714286	365	445	0	80	80	1.0000000
NODE_8422_length_918_cov_9.714286	418	498	0	80	80	1.0000000
NODE_8441_length_917_cov_38.845966	405	476	5	71	71	1.0000000
NODE_8441_length_917_cov_38.845966	458	538	4	20	80	0.2500000
NODE_8441_length_917_cov_38.845966	458	538	5	35	80	0.4375000
NODE_8441_length_917_cov_38.845966	458	538	6	25	80	0.3125000
NODE_8442_length_917_cov_37.775061	505	585	5	5	80	0.0625000
NODE_8442_length_917_cov_37.775061	505	585	6	18	80	0.2250000
NODE_8442_length_917_cov_37.775061	505	585	7	57	80	0.7125000
NODE_8442_length_917_cov_37.775061	558	638	2	20	80	0.2500000
NODE_8442_length_917_cov_37.775061	558	638	3	7	80	0.0875000
NODE_8442_length_917_cov_37.775061	558	638	5	31	80	0.3875000
NODE_8442_length_917_cov_37.775061	558	638	6	18	80	0.2250000
NODE_8442_length_917_cov_37.775061	558	638	7	4	80	0.0500000
NODE_8443_length_917_cov_33.195599	335	415	0	28	80	0.3500000
NODE_8443_length_917_cov_33.195599	335	415	1	8	80	0.1000000
NODE_8443_length_917_cov_33.195599	335	415	2	44	80	0.5500000
NODE_8443_length_917_cov_33.195599	388	468	0	35	80	0.4375000
NODE_8443_length_917_cov_33.195599	388	468	1	7	80	0.0875000
NODE_8443_length_917_cov_33.195599	388	468	3	38	80	0.4750000
NODE_8443_length_917_cov_33.195599	464	544	2	22	80	0.2750000
NODE_8443_length_917_cov_33.195599	464	544	3	18	80	0.2250000
NODE_8443_length_917_cov_33.195599	464	544	4	40	80	0.5000000
NODE_8443_length_917_cov_33.195599	517	597	2	41	80	0.5125000
NODE_8443_length_917_cov_33.195599	517	597	3	6	80	0.0750000
NODE_8443_length_917_cov_33.195599	517	597	4	33	80	0.4125000
NODE_8444_length_917_cov_22.871638	463	543	0	80	80	1.0000000
NODE_8444_length_917_cov_22.871638	516	593	0	77	77	1.0000000
NODE_8445_length_917_cov_16.899756	321	401	0	80	80	1.0000000
NODE_8445_length_917_cov_16.899756	374	454	0	80	80	1.0000000
NODE_8446_length_917_cov_12.283619	397	477	0	10	80	0.1250000
NODE_8446_length_917_cov_12.283619	397	477	1	63	80	0.7875000
NODE_8446_length_917_cov_12.283619	397	477	2	7	80	0.0875000
NODE_8446_length_917_cov_12.283619	450	530	0	34	80	0.4250000
NODE_8446_length_917_cov_12.283619	450	530	1	46	80	0.5750000
NODE_8447_length_917_cov_12.172372	380	460	1	80	80	1.0000000
NODE_8447_length_917_cov_12.172372	433	513	1	57	80	0.7125000
NODE_8447_length_917_cov_12.172372	433	513	2	23	80	0.2875000
NODE_8447_length_917_cov_12.172372	545	597	2	52	52	1.0000000
NODE_8448_length_917_cov_8.277506	564	644	1	80	80	1.0000000
NODE_8448_length_917_cov_8.277506	617	697	0	4	80	0.0500000
NODE_8448_length_917_cov_8.277506	617	697	1	76	80	0.9500000
NODE_8449_length_917_cov_8.145477	155	235	1	52	80	0.6500000
NODE_8449_length_917_cov_8.145477	155	235	2	28	80	0.3500000
NODE_8449_length_917_cov_8.145477	208	288	1	58	80	0.7250000
NODE_8449_length_917_cov_8.145477	208	288	2	22	80	0.2750000
NODE_8451_length_917_cov_6.073350	366	446	0	80	80	1.0000000
NODE_8451_length_917_cov_6.073350	419	499	0	80	80	1.0000000
NODE_8463_length_916_cov_32.867809	347	427	4	1	80	0.0125000
NODE_8463_length_916_cov_32.867809	347	427	6	12	80	0.1500000
NODE_8463_length_916_cov_32.867809	347	427	7	4	80	0.0500000
NODE_8463_length_916_cov_32.867809	347	427	8	42	80	0.5250000
NODE_8463_length_916_cov_32.867809	347	427	9	21	80	0.2625000
NODE_8463_length_916_cov_32.867809	400	480	3	12	80	0.1500000
NODE_8463_length_916_cov_32.867809	400	480	4	15	80	0.1875000
NODE_8463_length_916_cov_32.867809	400	480	6	14	80	0.1750000
NODE_8463_length_916_cov_32.867809	400	480	7	10	80	0.1250000
NODE_8463_length_916_cov_32.867809	400	480	8	6	80	0.0750000
NODE_8463_length_916_cov_32.867809	400	480	9	23	80	0.2875000
NODE_8464_length_916_cov_27.673195	450	530	5	57	80	0.7125000
NODE_8464_length_916_cov_27.673195	450	530	6	23	80	0.2875000
NODE_8464_length_916_cov_27.673195	503	583	1	21	80	0.2625000
NODE_8464_length_916_cov_27.673195	503	583	2	19	80	0.2375000
NODE_8464_length_916_cov_27.673195	503	583	3	10	80	0.1250000
NODE_8464_length_916_cov_27.673195	503	583	5	30	80	0.3750000
NODE_8465_length_916_cov_27.146879	223	303	0	80	80	1.0000000
NODE_8465_length_916_cov_27.146879	276	356	0	80	80	1.0000000
NODE_8466_length_916_cov_25.604651	398	478	5	14	80	0.1750000
NODE_8466_length_916_cov_25.604651	398	478	6	66	80	0.8250000
NODE_8466_length_916_cov_25.604651	451	531	2	38	80	0.4750000
NODE_8466_length_916_cov_25.604651	451	531	4	9	80	0.1125000
NODE_8466_length_916_cov_25.604651	451	531	6	33	80	0.4125000
NODE_8467_length_916_cov_18.035496	456	536	1	80	80	1.0000000
NODE_8467_length_916_cov_18.035496	509	589	0	26	80	0.3250000
NODE_8467_length_916_cov_18.035496	509	589	1	54	80	0.6750000
NODE_8468_length_916_cov_12.651163	500	580	0	80	80	1.0000000
NODE_8468_length_916_cov_12.651163	553	633	0	80	80	1.0000000
NODE_8469_length_916_cov_11.337821	530	610	3	63	80	0.7875000
NODE_8469_length_916_cov_11.337821	530	610	4	17	80	0.2125000
NODE_8469_length_916_cov_11.337821	583	663	2	4	80	0.0500000
NODE_8469_length_916_cov_11.337821	583	663	3	21	80	0.2625000
NODE_8469_length_916_cov_11.337821	583	663	4	55	80	0.6875000
NODE_8470_length_916_cov_9.640147	293	373	2	19	80	0.2375000
NODE_8470_length_916_cov_9.640147	293	373	3	61	80	0.7625000
NODE_8470_length_916_cov_9.640147	346	426	1	30	80	0.3750000
NODE_8470_length_916_cov_9.640147	346	426	3	50	80	0.6250000
NODE_8472_length_916_cov_8.042840	426	506	3	30	80	0.3750000
NODE_8472_length_916_cov_8.042840	426	506	4	25	80	0.3125000
NODE_8472_length_916_cov_8.042840	426	506	5	21	80	0.2625000
NODE_8472_length_916_cov_8.042840	426	506	6	4	80	0.0500000
NODE_8472_length_916_cov_8.042840	479	559	3	4	80	0.0500000
NODE_8472_length_916_cov_8.042840	479	559	4	70	80	0.8750000
NODE_8472_length_916_cov_8.042840	479	559	5	2	80	0.0250000
NODE_8472_length_916_cov_8.042840	479	559	6	4	80	0.0500000
NODE_8473_length_916_cov_7.123623	785	847	2	3	62	0.0483871
NODE_8473_length_916_cov_7.123623	785	847	4	59	62	0.9516129
NODE_8473_length_916_cov_7.123623	820	900	4	80	80	1.0000000
NODE_8481_length_915_cov_59.289216	398	478	0	15	80	0.1875000
NODE_8481_length_915_cov_59.289216	398	478	1	1	80	0.0125000
NODE_8481_length_915_cov_59.289216	398	478	2	64	80	0.8000000
NODE_8481_length_915_cov_59.289216	451	531	2	80	80	1.0000000
NODE_8481_length_915_cov_59.289216	527	607	0	43	80	0.5375000
NODE_8481_length_915_cov_59.289216	527	607	1	1	80	0.0125000
NODE_8481_length_915_cov_59.289216	527	607	2	36	80	0.4500000
NODE_8481_length_915_cov_59.289216	580	660	0	80	80	1.0000000
NODE_8482_length_915_cov_45.104167	153	228	1	75	75	1.0000000
NODE_8482_length_915_cov_45.104167	206	286	1	42	80	0.5250000
NODE_8482_length_915_cov_45.104167	206	286	2	23	80	0.2875000
NODE_8482_length_915_cov_45.104167	206	286	3	15	80	0.1875000
NODE_8482_length_915_cov_45.104167	282	362	2	13	80	0.1625000
NODE_8482_length_915_cov_45.104167	282	362	4	67	80	0.8375000
NODE_8482_length_915_cov_45.104167	335	415	4	57	80	0.7125000
NODE_8482_length_915_cov_45.104167	335	415	5	23	80	0.2875000
NODE_8483_length_915_cov_37.599265	397	477	0	66	80	0.8250000
NODE_8483_length_915_cov_37.599265	397	477	2	14	80	0.1750000
NODE_8483_length_915_cov_37.599265	450	530	0	13	80	0.1625000
NODE_8483_length_915_cov_37.599265	450	530	2	67	80	0.8375000
NODE_8485_length_915_cov_20.458333	297	377	1	44	80	0.5500000
NODE_8485_length_915_cov_20.458333	297	377	2	18	80	0.2250000
NODE_8485_length_915_cov_20.458333	297	377	3	18	80	0.2250000
NODE_8485_length_915_cov_20.458333	350	430	1	80	80	1.0000000
NODE_8485_length_915_cov_20.458333	426	506	1	48	80	0.6000000
NODE_8485_length_915_cov_20.458333	426	506	2	32	80	0.4000000
NODE_8485_length_915_cov_20.458333	479	559	1	72	80	0.9000000
NODE_8485_length_915_cov_20.458333	479	559	3	8	80	0.1000000
NODE_8486_length_915_cov_14.397059	175	255	1	48	80	0.6000000
NODE_8486_length_915_cov_14.397059	175	255	2	10	80	0.1250000
NODE_8486_length_915_cov_14.397059	175	255	3	13	80	0.1625000
NODE_8486_length_915_cov_14.397059	175	255	4	5	80	0.0625000
NODE_8486_length_915_cov_14.397059	175	255	5	4	80	0.0500000
NODE_8486_length_915_cov_14.397059	228	308	0	24	80	0.3000000
NODE_8486_length_915_cov_14.397059	228	308	1	56	80	0.7000000
NODE_8487_length_915_cov_8.741422	295	375	0	80	80	1.0000000
NODE_8487_length_915_cov_8.741422	348	428	0	80	80	1.0000000
NODE_8488_length_915_cov_7.719363	823	894	0	71	71	1.0000000
NODE_8488_length_915_cov_7.719363	828	894	0	66	66	1.0000000
NODE_8488_length_915_cov_7.719363	867	915	0	48	48	1.0000000
NODE_8488_length_915_cov_7.719363	867	915	0	48	48	1.0000000
NODE_8488_length_915_cov_7.719363	867	915	0	48	48	1.0000000
NODE_8489_length_915_cov_7.648284	370	450	0	5	80	0.0625000
NODE_8489_length_915_cov_7.648284	370	450	1	75	80	0.9375000
NODE_8489_length_915_cov_7.648284	423	503	1	80	80	1.0000000
NODE_8490_length_915_cov_6.848039	434	514	1	44	80	0.5500000
NODE_8490_length_915_cov_6.848039	434	514	2	36	80	0.4500000
NODE_8490_length_915_cov_6.848039	487	567	1	27	80	0.3375000
NODE_8490_length_915_cov_6.848039	487	567	2	53	80	0.6625000
NODE_8497_length_915_cov_2.011029	24	99	0	75	75	1.0000000
NODE_8505_length_914_cov_89.814724	0	41	19	2	41	0.0487805
NODE_8505_length_914_cov_89.814724	0	41	21	1	41	0.0243902
NODE_8505_length_914_cov_89.814724	0	41	24	2	41	0.0487805
NODE_8505_length_914_cov_89.814724	0	41	26	1	41	0.0243902
NODE_8505_length_914_cov_89.814724	0	41	28	2	41	0.0487805
NODE_8505_length_914_cov_89.814724	0	41	29	1	41	0.0243902
NODE_8505_length_914_cov_89.814724	0	41	30	1	41	0.0243902
NODE_8505_length_914_cov_89.814724	0	41	31	1	41	0.0243902
NODE_8505_length_914_cov_89.814724	0	41	34	1	41	0.0243902
NODE_8505_length_914_cov_89.814724	0	41	36	1	41	0.0243902
NODE_8505_length_914_cov_89.814724	0	41	43	1	41	0.0243902
NODE_8505_length_914_cov_89.814724	0	41	46	1	41	0.0243902
NODE_8505_length_914_cov_89.814724	0	41	48	1	41	0.0243902
NODE_8505_length_914_cov_89.814724	0	41	50	1	41	0.0243902
NODE_8505_length_914_cov_89.814724	0	41	51	2	41	0.0487805
NODE_8505_length_914_cov_89.814724	0	41	56	1	41	0.0243902
NODE_8505_length_914_cov_89.814724	0	41	61	1	41	0.0243902
NODE_8505_length_914_cov_89.814724	0	41	65	1	41	0.0243902
NODE_8505_length_914_cov_89.814724	0	41	68	1	41	0.0243902
NODE_8505_length_914_cov_89.814724	0	41	71	1	41	0.0243902
NODE_8505_length_914_cov_89.814724	0	41	72	1	41	0.0243902
NODE_8505_length_914_cov_89.814724	0	41	78	1	41	0.0243902
NODE_8505_length_914_cov_89.814724	0	41	82	1	41	0.0243902
NODE_8505_length_914_cov_89.814724	0	41	84	1	41	0.0243902
NODE_8505_length_914_cov_89.814724	0	41	86	1	41	0.0243902
NODE_8505_length_914_cov_89.814724	0	41	87	1	41	0.0243902
NODE_8505_length_914_cov_89.814724	0	41	88	1	41	0.0243902
NODE_8505_length_914_cov_89.814724	0	41	89	1	41	0.0243902
NODE_8505_length_914_cov_89.814724	0	41	91	1	41	0.0243902
NODE_8505_length_914_cov_89.814724	0	41	93	1	41	0.0243902
NODE_8505_length_914_cov_89.814724	0	41	96	2	41	0.0487805
NODE_8505_length_914_cov_89.814724	0	41	98	1	41	0.0243902
NODE_8505_length_914_cov_89.814724	0	41	102	1	41	0.0243902
NODE_8505_length_914_cov_89.814724	0	41	103	2	41	0.0487805
NODE_8505_length_914_cov_89.814724	0	41	104	1	41	0.0243902
NODE_8505_length_914_cov_89.814724	19	94	56	1	75	0.0133333
NODE_8505_length_914_cov_89.814724	19	94	61	1	75	0.0133333
NODE_8505_length_914_cov_89.814724	19	94	65	1	75	0.0133333
NODE_8505_length_914_cov_89.814724	19	94	68	1	75	0.0133333
NODE_8505_length_914_cov_89.814724	19	94	71	1	75	0.0133333
NODE_8505_length_914_cov_89.814724	19	94	72	1	75	0.0133333
NODE_8505_length_914_cov_89.814724	19	94	78	1	75	0.0133333
NODE_8505_length_914_cov_89.814724	19	94	82	1	75	0.0133333
NODE_8505_length_914_cov_89.814724	19	94	84	1	75	0.0133333
NODE_8505_length_914_cov_89.814724	19	94	86	1	75	0.0133333
NODE_8505_length_914_cov_89.814724	19	94	87	1	75	0.0133333
NODE_8505_length_914_cov_89.814724	19	94	88	1	75	0.0133333
NODE_8505_length_914_cov_89.814724	19	94	89	1	75	0.0133333
NODE_8505_length_914_cov_89.814724	19	94	91	1	75	0.0133333
NODE_8505_length_914_cov_89.814724	19	94	93	1	75	0.0133333
NODE_8505_length_914_cov_89.814724	19	94	96	2	75	0.0266667
NODE_8505_length_914_cov_89.814724	19	94	98	1	75	0.0133333
NODE_8505_length_914_cov_89.814724	19	94	102	1	75	0.0133333
NODE_8505_length_914_cov_89.814724	19	94	103	2	75	0.0266667
NODE_8505_length_914_cov_89.814724	19	94	104	1	75	0.0133333
NODE_8505_length_914_cov_89.814724	19	94	106	4	75	0.0533333
NODE_8505_length_914_cov_89.814724	19	94	108	1	75	0.0133333
NODE_8505_length_914_cov_89.814724	19	94	109	2	75	0.0266667
NODE_8505_length_914_cov_89.814724	19	94	110	1	75	0.0133333
NODE_8505_length_914_cov_89.814724	19	94	113	4	75	0.0533333
NODE_8505_length_914_cov_89.814724	19	94	114	1	75	0.0133333
NODE_8505_length_914_cov_89.814724	19	94	116	1	75	0.0133333
NODE_8505_length_914_cov_89.814724	19	94	122	1	75	0.0133333
NODE_8505_length_914_cov_89.814724	19	94	123	1	75	0.0133333
NODE_8505_length_914_cov_89.814724	19	94	126	2	75	0.0266667
NODE_8505_length_914_cov_89.814724	19	94	131	1	75	0.0133333
NODE_8505_length_914_cov_89.814724	19	94	133	3	75	0.0400000
NODE_8505_length_914_cov_89.814724	19	94	134	1	75	0.0133333
NODE_8505_length_914_cov_89.814724	19	94	136	1	75	0.0133333
NODE_8505_length_914_cov_89.814724	19	94	137	5	75	0.0666667
NODE_8505_length_914_cov_89.814724	19	94	138	2	75	0.0266667
NODE_8505_length_914_cov_89.814724	19	94	139	1	75	0.0133333
NODE_8505_length_914_cov_89.814724	19	94	142	1	75	0.0133333
NODE_8505_length_914_cov_89.814724	19	94	144	3	75	0.0400000
NODE_8505_length_914_cov_89.814724	19	94	146	3	75	0.0400000
NODE_8505_length_914_cov_89.814724	19	94	152	2	75	0.0266667
NODE_8505_length_914_cov_89.814724	19	94	153	1	75	0.0133333
NODE_8505_length_914_cov_89.814724	19	94	154	1	75	0.0133333
NODE_8505_length_914_cov_89.814724	19	94	156	1	75	0.0133333
NODE_8505_length_914_cov_89.814724	19	94	158	3	75	0.0400000
NODE_8505_length_914_cov_89.814724	19	94	159	2	75	0.0266667
NODE_8505_length_914_cov_89.814724	19	94	160	2	75	0.0266667
NODE_8505_length_914_cov_89.814724	19	94	161	2	75	0.0266667
NODE_8506_length_914_cov_33.755828	400	480	2	28	80	0.3500000
NODE_8506_length_914_cov_33.755828	400	480	4	36	80	0.4500000
NODE_8506_length_914_cov_33.755828	400	480	6	16	80	0.2000000
NODE_8506_length_914_cov_33.755828	453	533	2	32	80	0.4000000
NODE_8506_length_914_cov_33.755828	453	533	4	46	80	0.5750000
NODE_8506_length_914_cov_33.755828	453	533	6	2	80	0.0250000
NODE_8507_length_914_cov_31.557055	368	448	8	10	80	0.1250000
NODE_8507_length_914_cov_31.557055	368	448	9	16	80	0.2000000
NODE_8507_length_914_cov_31.557055	368	448	10	5	80	0.0625000
NODE_8507_length_914_cov_31.557055	368	448	11	28	80	0.3500000
NODE_8507_length_914_cov_31.557055	368	448	12	7	80	0.0875000
NODE_8507_length_914_cov_31.557055	368	448	13	14	80	0.1750000
NODE_8507_length_914_cov_31.557055	421	501	9	58	80	0.7250000
NODE_8507_length_914_cov_31.557055	421	501	10	5	80	0.0625000
NODE_8507_length_914_cov_31.557055	421	501	11	17	80	0.2125000
NODE_8508_length_914_cov_29.087117	331	411	6	32	80	0.4000000
NODE_8508_length_914_cov_29.087117	331	411	7	26	80	0.3250000
NODE_8508_length_914_cov_29.087117	331	411	8	22	80	0.2750000
NODE_8508_length_914_cov_29.087117	384	464	4	29	80	0.3625000
NODE_8508_length_914_cov_29.087117	384	464	5	4	80	0.0500000
NODE_8508_length_914_cov_29.087117	384	464	6	47	80	0.5875000
NODE_8509_length_914_cov_28.490798	273	353	0	80	80	1.0000000
NODE_8509_length_914_cov_28.490798	326	406	0	80	80	1.0000000
NODE_8509_length_914_cov_28.490798	402	482	0	80	80	1.0000000
NODE_8509_length_914_cov_28.490798	455	535	0	80	80	1.0000000
NODE_8510_length_914_cov_25.429448	393	473	1	7	80	0.0875000
NODE_8510_length_914_cov_25.429448	393	473	2	3	80	0.0375000
NODE_8510_length_914_cov_25.429448	393	473	3	70	80	0.8750000
NODE_8510_length_914_cov_25.429448	446	526	1	31	80	0.3875000
NODE_8510_length_914_cov_25.429448	446	526	2	32	80	0.4000000
NODE_8510_length_914_cov_25.429448	446	526	3	17	80	0.2125000
NODE_8510_length_914_cov_25.429448	522	602	1	80	80	1.0000000
NODE_8510_length_914_cov_25.429448	575	655	0	35	80	0.4375000
NODE_8510_length_914_cov_25.429448	575	655	1	45	80	0.5625000
NODE_8511_length_914_cov_19.111656	354	434	1	4	80	0.0500000
NODE_8511_length_914_cov_19.111656	354	434	3	34	80	0.4250000
NODE_8511_length_914_cov_19.111656	354	434	5	11	80	0.1375000
NODE_8511_length_914_cov_19.111656	354	434	6	29	80	0.3625000
NODE_8511_length_914_cov_19.111656	354	434	7	2	80	0.0250000
NODE_8511_length_914_cov_19.111656	407	487	4	18	80	0.2250000
NODE_8511_length_914_cov_19.111656	407	487	5	1	80	0.0125000
NODE_8511_length_914_cov_19.111656	407	487	6	36	80	0.4500000
NODE_8511_length_914_cov_19.111656	407	487	7	25	80	0.3125000
NODE_8512_length_914_cov_13.423313	603	683	3	8	80	0.1000000
NODE_8512_length_914_cov_13.423313	603	683	4	72	80	0.9000000
NODE_8512_length_914_cov_13.423313	656	736	1	22	80	0.2750000
NODE_8512_length_914_cov_13.423313	656	736	3	10	80	0.1250000
NODE_8512_length_914_cov_13.423313	656	736	4	48	80	0.6000000
NODE_8513_length_914_cov_10.947239	341	411	1	1	70	0.0142857
NODE_8513_length_914_cov_10.947239	341	411	2	32	70	0.4571429
NODE_8513_length_914_cov_10.947239	341	411	3	32	70	0.4571429
NODE_8513_length_914_cov_10.947239	341	411	4	5	70	0.0714286
NODE_8513_length_914_cov_10.947239	384	464	2	14	80	0.1750000
NODE_8513_length_914_cov_10.947239	384	464	3	8	80	0.1000000
NODE_8513_length_914_cov_10.947239	384	464	4	12	80	0.1500000
NODE_8513_length_914_cov_10.947239	384	464	5	46	80	0.5750000
NODE_8518_length_914_cov_1.931288	833	873	1	10	40	0.2500000
NODE_8518_length_914_cov_1.931288	833	873	2	7	40	0.1750000
NODE_8518_length_914_cov_1.931288	833	873	4	4	40	0.1000000
NODE_8518_length_914_cov_1.931288	833	873	5	14	40	0.3500000
NODE_8518_length_914_cov_1.931288	833	873	6	5	40	0.1250000
NODE_8526_length_913_cov_49.665848	31	111	31	1	80	0.0125000
NODE_8526_length_913_cov_49.665848	31	111	32	3	80	0.0375000
NODE_8526_length_913_cov_49.665848	31	111	33	1	80	0.0125000
NODE_8526_length_913_cov_49.665848	31	111	35	1	80	0.0125000
NODE_8526_length_913_cov_49.665848	31	111	36	1	80	0.0125000
NODE_8526_length_913_cov_49.665848	31	111	40	1	80	0.0125000
NODE_8526_length_913_cov_49.665848	31	111	41	1	80	0.0125000
NODE_8526_length_913_cov_49.665848	31	111	43	2	80	0.0250000
NODE_8526_length_913_cov_49.665848	31	111	45	4	80	0.0500000
NODE_8526_length_913_cov_49.665848	31	111	46	1	80	0.0125000
NODE_8526_length_913_cov_49.665848	31	111	48	1	80	0.0125000
NODE_8526_length_913_cov_49.665848	31	111	51	1	80	0.0125000
NODE_8526_length_913_cov_49.665848	31	111	53	1	80	0.0125000
NODE_8526_length_913_cov_49.665848	31	111	55	1	80	0.0125000
NODE_8526_length_913_cov_49.665848	31	111	56	3	80	0.0375000
NODE_8526_length_913_cov_49.665848	31	111	61	3	80	0.0375000
NODE_8526_length_913_cov_49.665848	31	111	62	1	80	0.0125000
NODE_8526_length_913_cov_49.665848	31	111	67	1	80	0.0125000
NODE_8526_length_913_cov_49.665848	31	111	70	1	80	0.0125000
NODE_8526_length_913_cov_49.665848	31	111	71	1	80	0.0125000
NODE_8526_length_913_cov_49.665848	31	111	74	1	80	0.0125000
NODE_8526_length_913_cov_49.665848	31	111	75	1	80	0.0125000
NODE_8526_length_913_cov_49.665848	31	111	78	2	80	0.0250000
NODE_8526_length_913_cov_49.665848	31	111	80	2	80	0.0250000
NODE_8526_length_913_cov_49.665848	31	111	81	1	80	0.0125000
NODE_8526_length_913_cov_49.665848	31	111	83	1	80	0.0125000
NODE_8526_length_913_cov_49.665848	31	111	86	3	80	0.0375000
NODE_8526_length_913_cov_49.665848	31	111	89	1	80	0.0125000
NODE_8526_length_913_cov_49.665848	31	111	92	1	80	0.0125000
NODE_8526_length_913_cov_49.665848	31	111	93	1	80	0.0125000
NODE_8526_length_913_cov_49.665848	31	111	98	1	80	0.0125000
NODE_8526_length_913_cov_49.665848	31	111	103	1	80	0.0125000
NODE_8526_length_913_cov_49.665848	31	111	108	2	80	0.0250000
NODE_8526_length_913_cov_49.665848	31	111	109	3	80	0.0375000
NODE_8526_length_913_cov_49.665848	31	111	111	2	80	0.0250000
NODE_8526_length_913_cov_49.665848	31	111	112	1	80	0.0125000
NODE_8526_length_913_cov_49.665848	31	111	113	2	80	0.0250000
NODE_8526_length_913_cov_49.665848	31	111	114	1	80	0.0125000
NODE_8526_length_913_cov_49.665848	31	111	116	1	80	0.0125000
NODE_8526_length_913_cov_49.665848	31	111	119	4	80	0.0500000
NODE_8526_length_913_cov_49.665848	31	111	121	1	80	0.0125000
NODE_8526_length_913_cov_49.665848	31	111	123	1	80	0.0125000
NODE_8526_length_913_cov_49.665848	31	111	126	2	80	0.0250000
NODE_8526_length_913_cov_49.665848	31	111	127	2	80	0.0250000
NODE_8526_length_913_cov_49.665848	31	111	128	1	80	0.0125000
NODE_8526_length_913_cov_49.665848	31	111	130	1	80	0.0125000
NODE_8526_length_913_cov_49.665848	31	111	131	2	80	0.0250000
NODE_8526_length_913_cov_49.665848	31	111	133	1	80	0.0125000
NODE_8526_length_913_cov_49.665848	31	111	135	2	80	0.0250000
NODE_8526_length_913_cov_49.665848	31	111	137	2	80	0.0250000
NODE_8526_length_913_cov_49.665848	31	111	140	3	80	0.0375000
NODE_8526_length_913_cov_49.665848	136	155	166	1	19	0.0526316
NODE_8526_length_913_cov_49.665848	136	155	167	2	19	0.1052632
NODE_8526_length_913_cov_49.665848	136	155	168	1	19	0.0526316
NODE_8526_length_913_cov_49.665848	136	155	169	2	19	0.1052632
NODE_8526_length_913_cov_49.665848	136	155	170	1	19	0.0526316
NODE_8526_length_913_cov_49.665848	136	155	174	2	19	0.1052632
NODE_8526_length_913_cov_49.665848	136	155	175	2	19	0.1052632
NODE_8526_length_913_cov_49.665848	136	155	176	4	19	0.2105263
NODE_8526_length_913_cov_49.665848	136	155	177	1	19	0.0526316
NODE_8526_length_913_cov_49.665848	136	155	179	2	19	0.1052632
NODE_8526_length_913_cov_49.665848	136	155	180	1	19	0.0526316
NODE_8527_length_913_cov_47.115479	367	447	3	13	80	0.1625000
NODE_8527_length_913_cov_47.115479	367	447	4	20	80	0.2500000
NODE_8527_length_913_cov_47.115479	367	447	5	45	80	0.5625000
NODE_8527_length_913_cov_47.115479	367	447	6	2	80	0.0250000
NODE_8527_length_913_cov_47.115479	420	500	4	3	80	0.0375000
NODE_8527_length_913_cov_47.115479	420	500	5	25	80	0.3125000
NODE_8527_length_913_cov_47.115479	420	500	6	23	80	0.2875000
NODE_8527_length_913_cov_47.115479	420	500	7	29	80	0.3625000
NODE_8528_length_913_cov_36.541769	502	582	6	80	80	1.0000000
NODE_8528_length_913_cov_36.541769	555	635	3	28	80	0.3500000
NODE_8528_length_913_cov_36.541769	555	635	5	19	80	0.2375000
NODE_8528_length_913_cov_36.541769	555	635	6	32	80	0.4000000
NODE_8528_length_913_cov_36.541769	555	635	7	1	80	0.0125000
NODE_8529_length_913_cov_33.679361	433	513	4	27	80	0.3375000
NODE_8529_length_913_cov_33.679361	433	513	5	2	80	0.0250000
NODE_8529_length_913_cov_33.679361	433	513	6	11	80	0.1375000
NODE_8529_length_913_cov_33.679361	433	513	7	40	80	0.5000000
NODE_8529_length_913_cov_33.679361	486	566	4	28	80	0.3500000
NODE_8529_length_913_cov_33.679361	486	566	5	23	80	0.2875000
NODE_8529_length_913_cov_33.679361	486	566	6	4	80	0.0500000
NODE_8529_length_913_cov_33.679361	486	566	7	25	80	0.3125000
NODE_8530_length_913_cov_29.675676	408	488	0	70	80	0.8750000
NODE_8530_length_913_cov_29.675676	408	488	2	3	80	0.0375000
NODE_8530_length_913_cov_29.675676	408	488	3	7	80	0.0875000
NODE_8530_length_913_cov_29.675676	461	541	0	17	80	0.2125000
NODE_8530_length_913_cov_29.675676	461	541	2	3	80	0.0375000
NODE_8530_length_913_cov_29.675676	461	541	3	60	80	0.7500000
NODE_8531_length_913_cov_24.901720	342	422	0	80	80	1.0000000
NODE_8531_length_913_cov_24.901720	395	475	0	80	80	1.0000000
NODE_8532_length_913_cov_24.625307	396	476	1	3	80	0.0375000
NODE_8532_length_913_cov_24.625307	396	476	2	2	80	0.0250000
NODE_8532_length_913_cov_24.625307	396	476	3	2	80	0.0250000
NODE_8532_length_913_cov_24.625307	396	476	4	29	80	0.3625000
NODE_8532_length_913_cov_24.625307	396	476	5	2	80	0.0250000
NODE_8532_length_913_cov_24.625307	396	476	6	10	80	0.1250000
NODE_8532_length_913_cov_24.625307	396	476	8	32	80	0.4000000
NODE_8532_length_913_cov_24.625307	449	529	7	37	80	0.4625000
NODE_8532_length_913_cov_24.625307	449	529	8	43	80	0.5375000
NODE_8533_length_913_cov_15.094595	525	589	0	25	64	0.3906250
NODE_8533_length_913_cov_15.094595	525	589	1	2	64	0.0312500
NODE_8533_length_913_cov_15.094595	525	589	2	26	64	0.4062500
NODE_8533_length_913_cov_15.094595	525	589	3	11	64	0.1718750
NODE_8533_length_913_cov_15.094595	562	642	2	16	80	0.2000000
NODE_8533_length_913_cov_15.094595	562	642	3	64	80	0.8000000
NODE_8534_length_913_cov_8.633907	305	385	0	80	80	1.0000000
NODE_8534_length_913_cov_8.633907	358	429	0	71	71	1.0000000
NODE_8546_length_912_cov_25.110701	419	499	5	38	80	0.4750000
NODE_8546_length_912_cov_25.110701	419	499	6	25	80	0.3125000
NODE_8546_length_912_cov_25.110701	419	499	7	17	80	0.2125000
NODE_8546_length_912_cov_25.110701	472	552	4	27	80	0.3375000
NODE_8546_length_912_cov_25.110701	472	552	5	53	80	0.6625000
NODE_8547_length_912_cov_20.045510	306	386	5	38	80	0.4750000
NODE_8547_length_912_cov_20.045510	306	386	6	3	80	0.0375000
NODE_8547_length_912_cov_20.045510	306	386	7	39	80	0.4875000
NODE_8547_length_912_cov_20.045510	359	439	2	16	80	0.2000000
NODE_8547_length_912_cov_20.045510	359	439	4	10	80	0.1250000
NODE_8547_length_912_cov_20.045510	359	439	5	30	80	0.3750000
NODE_8547_length_912_cov_20.045510	359	439	6	3	80	0.0375000
NODE_8547_length_912_cov_20.045510	359	439	7	21	80	0.2625000
NODE_8548_length_912_cov_19.635916	326	406	2	65	80	0.8125000
NODE_8548_length_912_cov_19.635916	326	406	3	15	80	0.1875000
NODE_8548_length_912_cov_19.635916	379	459	1	36	80	0.4500000
NODE_8548_length_912_cov_19.635916	379	459	2	12	80	0.1500000
NODE_8548_length_912_cov_19.635916	379	459	3	32	80	0.4000000
NODE_8549_length_912_cov_17.714637	395	475	0	64	80	0.8000000
NODE_8549_length_912_cov_17.714637	395	475	1	16	80	0.2000000
NODE_8549_length_912_cov_17.714637	448	528	0	11	80	0.1375000
NODE_8549_length_912_cov_17.714637	448	528	1	68	80	0.8500000
NODE_8549_length_912_cov_17.714637	448	528	2	1	80	0.0125000
NODE_8550_length_912_cov_15.546125	355	435	3	14	80	0.1750000
NODE_8550_length_912_cov_15.546125	355	435	4	3	80	0.0375000
NODE_8550_length_912_cov_15.546125	355	435	5	62	80	0.7750000
NODE_8550_length_912_cov_15.546125	355	435	6	1	80	0.0125000
NODE_8550_length_912_cov_15.546125	408	488	5	80	80	1.0000000
NODE_8551_length_912_cov_15.077491	255	291	1	36	36	1.0000000
NODE_8551_length_912_cov_15.077491	264	328	1	57	64	0.8906250
NODE_8551_length_912_cov_15.077491	264	328	2	7	64	0.1093750
NODE_8551_length_912_cov_15.077491	415	495	2	24	80	0.3000000
NODE_8551_length_912_cov_15.077491	415	495	3	56	80	0.7000000
NODE_8551_length_912_cov_15.077491	468	548	1	29	80	0.3625000
NODE_8551_length_912_cov_15.077491	468	548	2	48	80	0.6000000
NODE_8551_length_912_cov_15.077491	468	548	3	3	80	0.0375000
NODE_8552_length_912_cov_15.023370	361	441	2	9	80	0.1125000
NODE_8552_length_912_cov_15.023370	361	441	3	6	80	0.0750000
NODE_8552_length_912_cov_15.023370	361	441	4	65	80	0.8125000
NODE_8552_length_912_cov_15.023370	414	494	1	12	80	0.1500000
NODE_8552_length_912_cov_15.023370	414	494	2	9	80	0.1125000
NODE_8552_length_912_cov_15.023370	414	494	3	47	80	0.5875000
NODE_8552_length_912_cov_15.023370	414	494	4	12	80	0.1500000
NODE_8553_length_912_cov_13.600246	61	141	2	45	80	0.5625000
NODE_8553_length_912_cov_13.600246	61	141	4	35	80	0.4375000
NODE_8553_length_912_cov_13.600246	460	540	1	37	80	0.4625000
NODE_8553_length_912_cov_13.600246	460	540	2	43	80	0.5375000
NODE_8553_length_912_cov_13.600246	513	593	0	20	80	0.2500000
NODE_8553_length_912_cov_13.600246	513	593	1	60	80	0.7500000
NODE_8554_length_912_cov_13.113161	385	465	4	6	80	0.0750000
NODE_8554_length_912_cov_13.113161	385	465	5	74	80	0.9250000
NODE_8554_length_912_cov_13.113161	438	518	0	8	80	0.1000000
NODE_8554_length_912_cov_13.113161	438	518	2	37	80	0.4625000
NODE_8554_length_912_cov_13.113161	438	518	3	4	80	0.0500000
NODE_8554_length_912_cov_13.113161	438	518	4	10	80	0.1250000
NODE_8554_length_912_cov_13.113161	438	518	5	21	80	0.2625000
NODE_8555_length_912_cov_11.110701	353	433	0	80	80	1.0000000
NODE_8555_length_912_cov_11.110701	406	486	0	80	80	1.0000000
NODE_8555_length_912_cov_11.110701	827	907	0	80	80	1.0000000
NODE_8555_length_912_cov_11.110701	831	854	0	23	23	1.0000000
NODE_8584_length_911_cov_173.171182	580	660	471	1	80	0.0125000
NODE_8584_length_911_cov_173.171182	580	660	472	2	80	0.0250000
NODE_8584_length_911_cov_173.171182	580	660	473	1	80	0.0125000
NODE_8584_length_911_cov_173.171182	580	660	474	3	80	0.0375000
NODE_8584_length_911_cov_173.171182	580	660	475	1	80	0.0125000
NODE_8584_length_911_cov_173.171182	580	660	476	1	80	0.0125000
NODE_8584_length_911_cov_173.171182	580	660	477	1	80	0.0125000
NODE_8584_length_911_cov_173.171182	580	660	478	1	80	0.0125000
NODE_8584_length_911_cov_173.171182	580	660	480	1	80	0.0125000
NODE_8584_length_911_cov_173.171182	580	660	483	1	80	0.0125000
NODE_8584_length_911_cov_173.171182	580	660	485	1	80	0.0125000
NODE_8584_length_911_cov_173.171182	580	660	486	1	80	0.0125000
NODE_8584_length_911_cov_173.171182	580	660	487	1	80	0.0125000
NODE_8584_length_911_cov_173.171182	580	660	491	1	80	0.0125000
NODE_8584_length_911_cov_173.171182	580	660	494	1	80	0.0125000
NODE_8584_length_911_cov_173.171182	580	660	495	1	80	0.0125000
NODE_8584_length_911_cov_173.171182	580	660	498	1	80	0.0125000
NODE_8584_length_911_cov_173.171182	580	660	499	1	80	0.0125000
NODE_8584_length_911_cov_173.171182	580	660	501	5	80	0.0625000
NODE_8584_length_911_cov_173.171182	580	660	502	3	80	0.0375000
NODE_8584_length_911_cov_173.171182	580	660	503	4	80	0.0500000
NODE_8584_length_911_cov_173.171182	580	660	504	2	80	0.0250000
NODE_8584_length_911_cov_173.171182	580	660	505	2	80	0.0250000
NODE_8584_length_911_cov_173.171182	580	660	506	6	80	0.0750000
NODE_8584_length_911_cov_173.171182	580	660	507	2	80	0.0250000
NODE_8584_length_911_cov_173.171182	580	660	508	1	80	0.0125000
NODE_8584_length_911_cov_173.171182	580	660	510	1	80	0.0125000
NODE_8584_length_911_cov_173.171182	580	660	511	2	80	0.0250000
NODE_8584_length_911_cov_173.171182	580	660	512	1	80	0.0125000
NODE_8584_length_911_cov_173.171182	580	660	513	3	80	0.0375000
NODE_8584_length_911_cov_173.171182	580	660	515	1	80	0.0125000
NODE_8584_length_911_cov_173.171182	580	660	516	1	80	0.0125000
NODE_8584_length_911_cov_173.171182	580	660	517	2	80	0.0250000
NODE_8584_length_911_cov_173.171182	580	660	518	1	80	0.0125000
NODE_8584_length_911_cov_173.171182	580	660	519	4	80	0.0500000
NODE_8584_length_911_cov_173.171182	580	660	520	1	80	0.0125000
NODE_8584_length_911_cov_173.171182	580	660	521	2	80	0.0250000
NODE_8584_length_911_cov_173.171182	580	660	522	1	80	0.0125000
NODE_8584_length_911_cov_173.171182	580	660	523	3	80	0.0375000
NODE_8584_length_911_cov_173.171182	580	660	524	1	80	0.0125000
NODE_8584_length_911_cov_173.171182	580	660	526	4	80	0.0500000
NODE_8584_length_911_cov_173.171182	580	660	527	2	80	0.0250000
NODE_8584_length_911_cov_173.171182	580	660	528	1	80	0.0125000
NODE_8584_length_911_cov_173.171182	580	660	531	3	80	0.0375000
NODE_8584_length_911_cov_173.171182	633	713	451	1	80	0.0125000
NODE_8584_length_911_cov_173.171182	633	713	452	1	80	0.0125000
NODE_8584_length_911_cov_173.171182	633	713	454	1	80	0.0125000
NODE_8584_length_911_cov_173.171182	633	713	455	1	80	0.0125000
NODE_8584_length_911_cov_173.171182	633	713	458	2	80	0.0250000
NODE_8584_length_911_cov_173.171182	633	713	460	1	80	0.0125000
NODE_8584_length_911_cov_173.171182	633	713	466	1	80	0.0125000
NODE_8584_length_911_cov_173.171182	633	713	467	1	80	0.0125000
NODE_8584_length_911_cov_173.171182	633	713	468	1	80	0.0125000
NODE_8584_length_911_cov_173.171182	633	713	470	1	80	0.0125000
NODE_8584_length_911_cov_173.171182	633	713	471	2	80	0.0250000
NODE_8584_length_911_cov_173.171182	633	713	472	4	80	0.0500000
NODE_8584_length_911_cov_173.171182	633	713	473	3	80	0.0375000
NODE_8584_length_911_cov_173.171182	633	713	474	4	80	0.0500000
NODE_8584_length_911_cov_173.171182	633	713	475	1	80	0.0125000
NODE_8584_length_911_cov_173.171182	633	713	476	2	80	0.0250000
NODE_8584_length_911_cov_173.171182	633	713	477	4	80	0.0500000
NODE_8584_length_911_cov_173.171182	633	713	478	4	80	0.0500000
NODE_8584_length_911_cov_173.171182	633	713	479	1	80	0.0125000
NODE_8584_length_911_cov_173.171182	633	713	480	3	80	0.0375000
NODE_8584_length_911_cov_173.171182	633	713	482	2	80	0.0250000
NODE_8584_length_911_cov_173.171182	633	713	483	5	80	0.0625000
NODE_8584_length_911_cov_173.171182	633	713	484	3	80	0.0375000
NODE_8584_length_911_cov_173.171182	633	713	485	2	80	0.0250000
NODE_8584_length_911_cov_173.171182	633	713	486	2	80	0.0250000
NODE_8584_length_911_cov_173.171182	633	713	487	2	80	0.0250000
NODE_8584_length_911_cov_173.171182	633	713	488	1	80	0.0125000
NODE_8584_length_911_cov_173.171182	633	713	489	1	80	0.0125000
NODE_8584_length_911_cov_173.171182	633	713	490	3	80	0.0375000
NODE_8584_length_911_cov_173.171182	633	713	491	2	80	0.0250000
NODE_8584_length_911_cov_173.171182	633	713	494	2	80	0.0250000
NODE_8584_length_911_cov_173.171182	633	713	498	2	80	0.0250000
NODE_8584_length_911_cov_173.171182	633	713	499	2	80	0.0250000
NODE_8584_length_911_cov_173.171182	633	713	500	2	80	0.0250000
NODE_8584_length_911_cov_173.171182	633	713	501	2	80	0.0250000
NODE_8584_length_911_cov_173.171182	633	713	502	2	80	0.0250000
NODE_8584_length_911_cov_173.171182	633	713	503	2	80	0.0250000
NODE_8584_length_911_cov_173.171182	633	713	504	1	80	0.0125000
NODE_8584_length_911_cov_173.171182	633	713	506	1	80	0.0125000
NODE_8584_length_911_cov_173.171182	633	713	507	1	80	0.0125000
NODE_8584_length_911_cov_173.171182	633	713	508	1	80	0.0125000
NODE_8585_length_911_cov_88.250000	525	605	2	23	80	0.2875000
NODE_8585_length_911_cov_88.250000	525	605	3	57	80	0.7125000
NODE_8585_length_911_cov_88.250000	578	658	1	5	80	0.0625000
NODE_8585_length_911_cov_88.250000	578	658	3	75	80	0.9375000
NODE_8586_length_911_cov_46.854680	255	335	9	35	80	0.4375000
NODE_8586_length_911_cov_46.854680	255	335	10	33	80	0.4125000
NODE_8586_length_911_cov_46.854680	255	335	11	12	80	0.1500000
NODE_8586_length_911_cov_46.854680	308	388	2	7	80	0.0875000
NODE_8586_length_911_cov_46.854680	308	388	3	3	80	0.0375000
NODE_8586_length_911_cov_46.854680	308	388	4	3	80	0.0375000
NODE_8586_length_911_cov_46.854680	308	388	5	14	80	0.1750000
NODE_8586_length_911_cov_46.854680	308	388	6	5	80	0.0625000
NODE_8586_length_911_cov_46.854680	308	388	7	5	80	0.0625000
NODE_8586_length_911_cov_46.854680	308	388	9	43	80	0.5375000
NODE_8586_length_911_cov_46.854680	384	464	1	22	80	0.2750000
NODE_8586_length_911_cov_46.854680	384	464	2	9	80	0.1125000
NODE_8586_length_911_cov_46.854680	384	464	3	49	80	0.6125000
NODE_8586_length_911_cov_46.854680	437	517	1	18	80	0.2250000
NODE_8586_length_911_cov_46.854680	437	517	3	62	80	0.7750000
NODE_8587_length_911_cov_31.362069	301	381	0	80	80	1.0000000
NODE_8587_length_911_cov_31.362069	354	434	0	72	80	0.9000000
NODE_8587_length_911_cov_31.362069	354	434	2	8	80	0.1000000
NODE_8588_length_911_cov_19.235222	445	525	1	80	80	1.0000000
NODE_8588_length_911_cov_19.235222	498	578	1	44	80	0.5500000
NODE_8588_length_911_cov_19.235222	498	578	2	36	80	0.4500000
NODE_8589_length_911_cov_16.230296	233	313	2	80	80	1.0000000
NODE_8589_length_911_cov_16.230296	286	366	2	80	80	1.0000000
NODE_8590_length_911_cov_14.979064	472	552	0	80	80	1.0000000
NODE_8590_length_911_cov_14.979064	525	605	0	80	80	1.0000000
NODE_8591_length_911_cov_12.089901	357	409	4	34	52	0.6538461
NODE_8591_length_911_cov_12.089901	357	409	5	7	52	0.1346154
NODE_8591_length_911_cov_12.089901	357	409	6	11	52	0.2115385
NODE_8591_length_911_cov_12.089901	401	462	1	2	61	0.0327869
NODE_8591_length_911_cov_12.089901	401	462	2	10	61	0.1639344
NODE_8591_length_911_cov_12.089901	401	462	3	36	61	0.5901639
NODE_8591_length_911_cov_12.089901	401	462	4	13	61	0.2131148
NODE_8606_length_910_cov_27.838471	347	427	1	3	80	0.0375000
NODE_8606_length_910_cov_27.838471	347	427	2	5	80	0.0625000
NODE_8606_length_910_cov_27.838471	347	427	3	32	80	0.4000000
NODE_8606_length_910_cov_27.838471	347	427	4	1	80	0.0125000
NODE_8606_length_910_cov_27.838471	347	427	5	39	80	0.4875000
NODE_8606_length_910_cov_27.838471	400	480	4	44	80	0.5500000
NODE_8606_length_910_cov_27.838471	400	480	5	36	80	0.4500000
NODE_8607_length_910_cov_25.895191	361	441	1	80	80	1.0000000
NODE_8607_length_910_cov_25.895191	414	494	0	34	80	0.4250000
NODE_8607_length_910_cov_25.895191	414	494	1	46	80	0.5750000
NODE_8608_length_910_cov_25.604192	294	374	2	80	80	1.0000000
NODE_8608_length_910_cov_25.604192	347	427	2	33	80	0.4125000
NODE_8608_length_910_cov_25.604192	347	427	3	47	80	0.5875000
NODE_8608_length_910_cov_25.604192	423	503	2	74	80	0.9250000
NODE_8608_length_910_cov_25.604192	423	503	3	6	80	0.0750000
NODE_8608_length_910_cov_25.604192	476	556	1	26	80	0.3250000
NODE_8608_length_910_cov_25.604192	476	556	2	54	80	0.6750000
NODE_8609_length_910_cov_16.066584	656	736	0	80	80	1.0000000
NODE_8609_length_910_cov_16.066584	709	789	0	80	80	1.0000000
NODE_8610_length_910_cov_14.696671	417	497	3	12	80	0.1500000
NODE_8610_length_910_cov_14.696671	417	497	4	39	80	0.4875000
NODE_8610_length_910_cov_14.696671	417	497	5	29	80	0.3625000
NODE_8610_length_910_cov_14.696671	470	550	1	36	80	0.4500000
NODE_8610_length_910_cov_14.696671	470	550	2	16	80	0.2000000
NODE_8610_length_910_cov_14.696671	470	550	3	13	80	0.1625000
NODE_8610_length_910_cov_14.696671	470	550	4	11	80	0.1375000
NODE_8610_length_910_cov_14.696671	470	550	5	4	80	0.0500000
NODE_8612_length_910_cov_7.114673	442	522	0	15	80	0.1875000
NODE_8612_length_910_cov_7.114673	442	522	2	21	80	0.2625000
NODE_8612_length_910_cov_7.114673	442	522	3	25	80	0.3125000
NODE_8612_length_910_cov_7.114673	442	522	4	19	80	0.2375000
NODE_8612_length_910_cov_7.114673	495	575	3	8	80	0.1000000
NODE_8612_length_910_cov_7.114673	495	575	4	53	80	0.6625000
NODE_8612_length_910_cov_7.114673	495	575	5	19	80	0.2375000
NODE_8614_length_910_cov_2.992602	196	269	17	1	73	0.0136986
NODE_8614_length_910_cov_2.992602	196	269	18	4	73	0.0547945
NODE_8614_length_910_cov_2.992602	196	269	19	2	73	0.0273973
NODE_8614_length_910_cov_2.992602	196	269	20	5	73	0.0684932
NODE_8614_length_910_cov_2.992602	196	269	22	3	73	0.0410959
NODE_8614_length_910_cov_2.992602	196	269	25	1	73	0.0136986
NODE_8614_length_910_cov_2.992602	196	269	28	1	73	0.0136986
NODE_8614_length_910_cov_2.992602	196	269	30	2	73	0.0273973
NODE_8614_length_910_cov_2.992602	196	269	32	6	73	0.0821918
NODE_8614_length_910_cov_2.992602	196	269	33	1	73	0.0136986
NODE_8614_length_910_cov_2.992602	196	269	34	6	73	0.0821918
NODE_8614_length_910_cov_2.992602	196	269	35	3	73	0.0410959
NODE_8614_length_910_cov_2.992602	196	269	36	2	73	0.0273973
NODE_8614_length_910_cov_2.992602	196	269	38	3	73	0.0410959
NODE_8614_length_910_cov_2.992602	196	269	40	1	73	0.0136986
NODE_8614_length_910_cov_2.992602	196	269	44	3	73	0.0410959
NODE_8614_length_910_cov_2.992602	196	269	45	2	73	0.0273973
NODE_8614_length_910_cov_2.992602	196	269	46	8	73	0.1095890
NODE_8614_length_910_cov_2.992602	196	269	47	1	73	0.0136986
NODE_8614_length_910_cov_2.992602	196	269	48	9	73	0.1232877
NODE_8614_length_910_cov_2.992602	196	269	49	9	73	0.1232877
NODE_8614_length_910_cov_2.992602	249	329	46	1	80	0.0125000
NODE_8614_length_910_cov_2.992602	249	329	47	1	80	0.0125000
NODE_8614_length_910_cov_2.992602	249	329	48	9	80	0.1125000
NODE_8614_length_910_cov_2.992602	249	329	49	9	80	0.1125000
NODE_8614_length_910_cov_2.992602	249	329	51	1	80	0.0125000
NODE_8614_length_910_cov_2.992602	249	329	52	2	80	0.0250000
NODE_8614_length_910_cov_2.992602	249	329	53	8	80	0.1000000
NODE_8614_length_910_cov_2.992602	249	329	55	5	80	0.0625000
NODE_8614_length_910_cov_2.992602	249	329	58	3	80	0.0375000
NODE_8614_length_910_cov_2.992602	249	329	59	4	80	0.0500000
NODE_8614_length_910_cov_2.992602	249	329	60	1	80	0.0125000
NODE_8614_length_910_cov_2.992602	249	329	61	2	80	0.0250000
NODE_8614_length_910_cov_2.992602	249	329	62	1	80	0.0125000
NODE_8614_length_910_cov_2.992602	249	329	63	1	80	0.0125000
NODE_8614_length_910_cov_2.992602	249	329	65	7	80	0.0875000
NODE_8614_length_910_cov_2.992602	249	329	67	7	80	0.0875000
NODE_8614_length_910_cov_2.992602	249	329	68	13	80	0.1625000
NODE_8614_length_910_cov_2.992602	249	329	70	4	80	0.0500000
NODE_8614_length_910_cov_2.992602	249	329	71	1	80	0.0125000
NODE_8614_length_910_cov_2.992602	386	439	16	1	53	0.0188679
NODE_8614_length_910_cov_2.992602	386	439	17	2	53	0.0377358
NODE_8614_length_910_cov_2.992602	386	439	18	1	53	0.0188679
NODE_8614_length_910_cov_2.992602	386	439	24	2	53	0.0377358
NODE_8614_length_910_cov_2.992602	386	439	28	11	53	0.2075472
NODE_8614_length_910_cov_2.992602	386	439	29	7	53	0.1320755
NODE_8614_length_910_cov_2.992602	386	439	30	15	53	0.2830189
NODE_8614_length_910_cov_2.992602	386	439	32	3	53	0.0566038
NODE_8614_length_910_cov_2.992602	386	439	33	4	53	0.0754717
NODE_8614_length_910_cov_2.992602	386	439	34	2	53	0.0377358
NODE_8614_length_910_cov_2.992602	386	439	36	3	53	0.0566038
NODE_8614_length_910_cov_2.992602	386	439	38	2	53	0.0377358
NODE_8623_length_909_cov_35.291358	426	506	7	9	80	0.1125000
NODE_8623_length_909_cov_35.291358	426	506	8	6	80	0.0750000
NODE_8623_length_909_cov_35.291358	426	506	9	7	80	0.0875000
NODE_8623_length_909_cov_35.291358	426	506	10	6	80	0.0750000
NODE_8623_length_909_cov_35.291358	426	506	12	1	80	0.0125000
NODE_8623_length_909_cov_35.291358	426	506	14	27	80	0.3375000
NODE_8623_length_909_cov_35.291358	426	506	15	1	80	0.0125000
NODE_8623_length_909_cov_35.291358	426	506	16	23	80	0.2875000
NODE_8623_length_909_cov_35.291358	479	559	11	14	80	0.1750000
NODE_8623_length_909_cov_35.291358	479	559	12	10	80	0.1250000
NODE_8623_length_909_cov_35.291358	479	559	14	35	80	0.4375000
NODE_8623_length_909_cov_35.291358	479	559	16	21	80	0.2625000
NODE_8624_length_909_cov_27.449383	311	391	1	25	80	0.3125000
NODE_8624_length_909_cov_27.449383	311	391	2	7	80	0.0875000
NODE_8624_length_909_cov_27.449383	311	391	4	37	80	0.4625000
NODE_8624_length_909_cov_27.449383	311	391	6	11	80	0.1375000
NODE_8624_length_909_cov_27.449383	364	444	4	16	80	0.2000000
NODE_8624_length_909_cov_27.449383	364	444	6	64	80	0.8000000
NODE_8625_length_909_cov_25.212346	295	375	0	80	80	1.0000000
NODE_8625_length_909_cov_25.212346	348	428	0	80	80	1.0000000
NODE_8626_length_909_cov_23.604938	403	483	0	45	80	0.5625000
NODE_8626_length_909_cov_23.604938	403	483	2	35	80	0.4375000
NODE_8626_length_909_cov_23.604938	456	536	0	13	80	0.1625000
NODE_8626_length_909_cov_23.604938	456	536	2	67	80	0.8375000
NODE_8627_length_909_cov_19.070370	441	521	0	36	80	0.4500000
NODE_8627_length_909_cov_19.070370	441	521	1	4	80	0.0500000
NODE_8627_length_909_cov_19.070370	441	521	2	10	80	0.1250000
NODE_8627_length_909_cov_19.070370	441	521	4	30	80	0.3750000
NODE_8627_length_909_cov_19.070370	494	574	2	18	80	0.2250000
NODE_8627_length_909_cov_19.070370	494	574	3	1	80	0.0125000
NODE_8627_length_909_cov_19.070370	494	574	4	61	80	0.7625000
NODE_8628_length_909_cov_11.533333	332	412	0	80	80	1.0000000
NODE_8628_length_909_cov_11.533333	385	465	0	80	80	1.0000000
NODE_8629_length_909_cov_10.229630	497	577	0	80	80	1.0000000
NODE_8629_length_909_cov_10.229630	550	622	0	72	72	1.0000000
NODE_8631_length_909_cov_7.122222	328	408	0	80	80	1.0000000
NODE_8631_length_909_cov_7.122222	381	461	0	80	80	1.0000000
NODE_8632_length_909_cov_4.664198	775	855	1	13	80	0.1625000
NODE_8632_length_909_cov_4.664198	775	855	2	12	80	0.1500000
NODE_8632_length_909_cov_4.664198	775	855	4	2	80	0.0250000
NODE_8632_length_909_cov_4.664198	775	855	5	2	80	0.0250000
NODE_8632_length_909_cov_4.664198	775	855	6	16	80	0.2000000
NODE_8632_length_909_cov_4.664198	775	855	8	5	80	0.0625000
NODE_8632_length_909_cov_4.664198	775	855	9	1	80	0.0125000
NODE_8632_length_909_cov_4.664198	775	855	10	3	80	0.0375000
NODE_8632_length_909_cov_4.664198	775	855	11	2	80	0.0250000
NODE_8632_length_909_cov_4.664198	775	855	12	2	80	0.0250000
NODE_8632_length_909_cov_4.664198	775	855	13	12	80	0.1500000
NODE_8632_length_909_cov_4.664198	775	855	14	3	80	0.0375000
NODE_8632_length_909_cov_4.664198	775	855	15	7	80	0.0875000
NODE_8632_length_909_cov_4.664198	828	885	0	16	57	0.2807018
NODE_8632_length_909_cov_4.664198	828	885	1	27	57	0.4736842
NODE_8632_length_909_cov_4.664198	828	885	2	12	57	0.2105263
NODE_8632_length_909_cov_4.664198	828	885	4	2	57	0.0350877
NODE_8644_length_908_cov_55.546354	409	489	0	70	80	0.8750000
NODE_8644_length_908_cov_55.546354	409	489	1	10	80	0.1250000
NODE_8644_length_908_cov_55.546354	462	542	0	37	80	0.4625000
NODE_8644_length_908_cov_55.546354	462	542	1	43	80	0.5375000
NODE_8645_length_908_cov_18.720643	329	409	0	15	80	0.1875000
NODE_8645_length_908_cov_18.720643	329	409	2	29	80	0.3625000
NODE_8645_length_908_cov_18.720643	329	409	3	17	80	0.2125000
NODE_8645_length_908_cov_18.720643	329	409	4	19	80	0.2375000
NODE_8645_length_908_cov_18.720643	382	462	3	8	80	0.1000000
NODE_8645_length_908_cov_18.720643	382	462	4	72	80	0.9000000
NODE_8646_length_908_cov_14.640297	430	510	1	80	80	1.0000000
NODE_8646_length_908_cov_14.640297	483	562	1	46	79	0.5822785
NODE_8646_length_908_cov_14.640297	483	562	2	33	79	0.4177215
NODE_8648_length_908_cov_10.789864	370	450	0	80	80	1.0000000
NODE_8648_length_908_cov_10.789864	423	503	0	80	80	1.0000000
NODE_8651_length_908_cov_3.737948	251	331	0	80	80	1.0000000
NODE_8651_length_908_cov_3.737948	304	384	0	80	80	1.0000000
NODE_8664_length_907_cov_22.110149	459	539	0	80	80	1.0000000
NODE_8664_length_907_cov_22.110149	512	592	0	80	80	1.0000000
NODE_8665_length_907_cov_20.943069	410	490	0	80	80	1.0000000
NODE_8665_length_907_cov_20.943069	463	543	0	45	80	0.5625000
NODE_8665_length_907_cov_20.943069	463	543	1	18	80	0.2250000
NODE_8665_length_907_cov_20.943069	463	543	2	17	80	0.2125000
NODE_8666_length_907_cov_19.519802	411	488	0	5	77	0.0649351
NODE_8666_length_907_cov_19.519802	411	488	2	72	77	0.9350649
NODE_8666_length_907_cov_19.519802	461	541	0	58	80	0.7250000
NODE_8666_length_907_cov_19.519802	461	541	2	22	80	0.2750000
NODE_8667_length_907_cov_17.928218	329	405	0	76	76	1.0000000
NODE_8667_length_907_cov_17.928218	382	462	0	80	80	1.0000000
NODE_8668_length_907_cov_13.060644	293	373	0	71	80	0.8875000
NODE_8668_length_907_cov_13.060644	293	373	2	9	80	0.1125000
NODE_8668_length_907_cov_13.060644	346	426	0	18	80	0.2250000
NODE_8668_length_907_cov_13.060644	346	426	2	62	80	0.7750000
NODE_8669_length_907_cov_11.155941	401	462	1	9	61	0.1475410
NODE_8669_length_907_cov_11.155941	401	462	2	52	61	0.8524590
NODE_8669_length_907_cov_11.155941	607	687	1	80	80	1.0000000
NODE_8670_length_907_cov_9.237624	247	327	1	14	80	0.1750000
NODE_8670_length_907_cov_9.237624	247	327	2	34	80	0.4250000
NODE_8670_length_907_cov_9.237624	247	327	3	32	80	0.4000000
NODE_8670_length_907_cov_9.237624	300	380	2	2	80	0.0250000
NODE_8670_length_907_cov_9.237624	300	380	3	78	80	0.9750000
NODE_8671_length_907_cov_8.686881	275	365	4	9	90	0.1000000
NODE_8671_length_907_cov_8.686881	275	365	5	42	90	0.4666667
NODE_8671_length_907_cov_8.686881	275	365	6	39	90	0.4333333
NODE_8671_length_907_cov_8.686881	338	418	2	4	80	0.0500000
NODE_8671_length_907_cov_8.686881	338	418	3	5	80	0.0625000
NODE_8671_length_907_cov_8.686881	338	418	4	2	80	0.0250000
NODE_8671_length_907_cov_8.686881	338	418	5	20	80	0.2500000
NODE_8671_length_907_cov_8.686881	338	418	6	49	80	0.6125000
NODE_8680_length_907_cov_2.949257	503	526	2	23	23	1.0000000
NODE_8686_length_906_cov_32.369269	447	527	2	25	80	0.3125000
NODE_8686_length_906_cov_32.369269	447	527	3	7	80	0.0875000
NODE_8686_length_906_cov_32.369269	447	527	5	10	80	0.1250000
NODE_8686_length_906_cov_32.369269	447	527	6	4	80	0.0500000
NODE_8686_length_906_cov_32.369269	447	527	7	19	80	0.2375000
NODE_8686_length_906_cov_32.369269	447	527	8	15	80	0.1875000
NODE_8686_length_906_cov_32.369269	500	580	7	72	80	0.9000000
NODE_8686_length_906_cov_32.369269	500	580	8	8	80	0.1000000
NODE_8687_length_906_cov_23.594796	196	276	1	43	80	0.5375000
NODE_8687_length_906_cov_23.594796	196	276	2	37	80	0.4625000
NODE_8687_length_906_cov_23.594796	249	329	1	52	80	0.6500000
NODE_8687_length_906_cov_23.594796	249	329	2	28	80	0.3500000
NODE_8688_length_906_cov_21.443618	404	484	1	52	80	0.6500000
NODE_8688_length_906_cov_21.443618	404	484	2	28	80	0.3500000
NODE_8688_length_906_cov_21.443618	457	537	1	15	80	0.1875000
NODE_8688_length_906_cov_21.443618	457	537	2	65	80	0.8125000
NODE_8689_length_906_cov_20.596035	593	634	20	1	41	0.0243902
NODE_8689_length_906_cov_20.596035	593	634	22	4	41	0.0975610
NODE_8689_length_906_cov_20.596035	593	634	23	6	41	0.1463415
NODE_8689_length_906_cov_20.596035	593	634	24	12	41	0.2926829
NODE_8689_length_906_cov_20.596035	593	634	25	16	41	0.3902439
NODE_8689_length_906_cov_20.596035	593	634	26	2	41	0.0487805
NODE_8690_length_906_cov_20.429988	410	490	0	9	80	0.1125000
NODE_8690_length_906_cov_20.429988	410	490	1	44	80	0.5500000
NODE_8690_length_906_cov_20.429988	410	490	2	27	80	0.3375000
NODE_8690_length_906_cov_20.429988	463	543	2	80	80	1.0000000
NODE_8691_length_906_cov_20.395291	523	603	1	80	80	1.0000000
NODE_8691_length_906_cov_20.395291	576	656	0	8	80	0.1000000
NODE_8691_length_906_cov_20.395291	576	656	1	72	80	0.9000000
NODE_8692_length_906_cov_19.297398	255	335	0	80	80	1.0000000
NODE_8692_length_906_cov_19.297398	308	388	0	80	80	1.0000000
NODE_8693_length_906_cov_18.505576	357	437	3	3	80	0.0375000
NODE_8693_length_906_cov_18.505576	357	437	5	7	80	0.0875000
NODE_8693_length_906_cov_18.505576	357	437	6	70	80	0.8750000
NODE_8693_length_906_cov_18.505576	410	490	1	18	80	0.2250000
NODE_8693_length_906_cov_18.505576	410	490	2	5	80	0.0625000
NODE_8693_length_906_cov_18.505576	410	490	3	33	80	0.4125000
NODE_8693_length_906_cov_18.505576	410	490	5	7	80	0.0875000
NODE_8693_length_906_cov_18.505576	410	490	6	17	80	0.2125000
NODE_8694_length_906_cov_10.068154	191	271	2	80	80	1.0000000
NODE_8694_length_906_cov_10.068154	244	324	0	45	80	0.5625000
NODE_8694_length_906_cov_10.068154	244	324	2	35	80	0.4375000
NODE_8695_length_906_cov_10.006196	304	384	0	80	80	1.0000000
NODE_8695_length_906_cov_10.006196	357	437	0	80	80	1.0000000
NODE_8696_length_906_cov_8.562577	370	454	0	84	84	1.0000000
NODE_8696_length_906_cov_8.562577	423	507	0	84	84	1.0000000
NODE_8716_length_905_cov_39.203474	406	486	1	7	80	0.0875000
NODE_8716_length_905_cov_39.203474	406	486	2	73	80	0.9125000
NODE_8716_length_905_cov_39.203474	459	539	2	60	80	0.7500000
NODE_8716_length_905_cov_39.203474	459	539	3	20	80	0.2500000
NODE_8717_length_905_cov_37.053350	411	491	0	80	80	1.0000000
NODE_8717_length_905_cov_37.053350	464	544	0	80	80	1.0000000
NODE_8718_length_905_cov_27.426799	288	368	2	17	80	0.2125000
NODE_8718_length_905_cov_27.426799	288	368	3	2	80	0.0250000
NODE_8718_length_905_cov_27.426799	288	368	5	4	80	0.0500000
NODE_8718_length_905_cov_27.426799	288	368	6	57	80	0.7125000
NODE_8718_length_905_cov_27.426799	341	421	5	56	80	0.7000000
NODE_8718_length_905_cov_27.426799	341	421	6	24	80	0.3000000
NODE_8719_length_905_cov_26.332506	375	455	3	2	80	0.0250000
NODE_8719_length_905_cov_26.332506	375	455	5	23	80	0.2875000
NODE_8719_length_905_cov_26.332506	375	455	6	26	80	0.3250000
NODE_8719_length_905_cov_26.332506	375	455	7	2	80	0.0250000
NODE_8719_length_905_cov_26.332506	375	455	8	27	80	0.3375000
NODE_8719_length_905_cov_26.332506	428	508	2	3	80	0.0375000
NODE_8719_length_905_cov_26.332506	428	508	3	16	80	0.2000000
NODE_8719_length_905_cov_26.332506	428	508	5	10	80	0.1250000
NODE_8719_length_905_cov_26.332506	428	508	8	51	80	0.6375000
NODE_8720_length_905_cov_20.651365	377	457	4	34	80	0.4250000
NODE_8720_length_905_cov_20.651365	377	457	6	46	80	0.5750000
NODE_8720_length_905_cov_20.651365	430	510	3	31	80	0.3875000
NODE_8720_length_905_cov_20.651365	430	510	4	7	80	0.0875000
NODE_8720_length_905_cov_20.651365	430	510	5	8	80	0.1000000
NODE_8720_length_905_cov_20.651365	430	510	6	34	80	0.4250000
NODE_8721_length_905_cov_19.718362	365	445	1	14	80	0.1750000
NODE_8721_length_905_cov_19.718362	365	445	3	36	80	0.4500000
NODE_8721_length_905_cov_19.718362	365	445	5	30	80	0.3750000
NODE_8721_length_905_cov_19.718362	418	498	5	80	80	1.0000000
NODE_8722_length_905_cov_13.696030	366	420	2	5	54	0.0925926
NODE_8722_length_905_cov_13.696030	366	420	4	33	54	0.6111111
NODE_8722_length_905_cov_13.696030	366	420	6	10	54	0.1851852
NODE_8722_length_905_cov_13.696030	366	420	7	6	54	0.1111111
NODE_8723_length_905_cov_9.978908	222	302	1	80	80	1.0000000
NODE_8723_length_905_cov_9.978908	275	355	0	31	80	0.3875000
NODE_8723_length_905_cov_9.978908	275	355	1	49	80	0.6125000
NODE_8725_length_905_cov_7.980149	321	401	2	63	80	0.7875000
NODE_8725_length_905_cov_7.980149	321	401	3	17	80	0.2125000
NODE_8725_length_905_cov_7.980149	374	454	1	31	80	0.3875000
NODE_8725_length_905_cov_7.980149	374	454	2	12	80	0.1500000
NODE_8725_length_905_cov_7.980149	374	454	3	37	80	0.4625000
NODE_8727_length_905_cov_6.064516	459	539	1	11	80	0.1375000
NODE_8727_length_905_cov_6.064516	459	539	2	69	80	0.8625000
NODE_8727_length_905_cov_6.064516	512	592	1	30	80	0.3750000
NODE_8727_length_905_cov_6.064516	512	592	2	50	80	0.6250000
NODE_8742_length_905_cov_1.040943	73	119	8	46	46	1.0000000
NODE_8742_length_905_cov_1.040943	126	172	0	5	46	0.1086956
NODE_8742_length_905_cov_1.040943	126	172	1	20	46	0.4347826
NODE_8742_length_905_cov_1.040943	126	172	2	3	46	0.0652174
NODE_8742_length_905_cov_1.040943	126	172	3	2	46	0.0434783
NODE_8742_length_905_cov_1.040943	126	172	5	3	46	0.0652174
NODE_8742_length_905_cov_1.040943	126	172	7	7	46	0.1521739
NODE_8742_length_905_cov_1.040943	126	172	8	6	46	0.1304348
NODE_8743_length_904_cov_29.532919	338	418	0	33	80	0.4125000
NODE_8743_length_904_cov_29.532919	338	418	1	13	80	0.1625000
NODE_8743_length_904_cov_29.532919	338	418	2	34	80	0.4250000
NODE_8743_length_904_cov_29.532919	391	471	2	73	80	0.9125000
NODE_8743_length_904_cov_29.532919	391	471	3	7	80	0.0875000
NODE_8743_length_904_cov_29.532919	467	547	1	7	80	0.0875000
NODE_8743_length_904_cov_29.532919	467	547	2	14	80	0.1750000
NODE_8743_length_904_cov_29.532919	467	547	3	54	80	0.6750000
NODE_8743_length_904_cov_29.532919	467	547	4	5	80	0.0625000
NODE_8743_length_904_cov_29.532919	520	600	1	7	80	0.0875000
NODE_8743_length_904_cov_29.532919	520	600	2	14	80	0.1750000
NODE_8743_length_904_cov_29.532919	520	600	3	1	80	0.0125000
NODE_8743_length_904_cov_29.532919	520	600	4	58	80	0.7250000
NODE_8744_length_904_cov_28.844720	371	451	1	11	80	0.1375000
NODE_8744_length_904_cov_28.844720	371	451	2	69	80	0.8625000
NODE_8744_length_904_cov_28.844720	424	504	1	48	80	0.6000000
NODE_8744_length_904_cov_28.844720	424	504	2	32	80	0.4000000
NODE_8745_length_904_cov_26.977640	488	568	0	80	80	1.0000000
NODE_8745_length_904_cov_26.977640	541	621	0	80	80	1.0000000
NODE_8746_length_904_cov_24.529193	464	544	0	43	80	0.5375000
NODE_8746_length_904_cov_24.529193	464	544	2	1	80	0.0125000
NODE_8746_length_904_cov_24.529193	464	544	3	4	80	0.0500000
NODE_8746_length_904_cov_24.529193	464	544	4	16	80	0.2000000
NODE_8746_length_904_cov_24.529193	464	544	5	16	80	0.2000000
NODE_8746_length_904_cov_24.529193	517	597	0	80	80	1.0000000
NODE_8747_length_904_cov_24.452174	507	587	5	44	80	0.5500000
NODE_8747_length_904_cov_24.452174	507	587	6	36	80	0.4500000
NODE_8747_length_904_cov_24.452174	560	640	6	38	80	0.4750000
NODE_8747_length_904_cov_24.452174	560	640	7	42	80	0.5250000
NODE_8748_length_904_cov_19.649689	307	387	6	10	80	0.1250000
NODE_8748_length_904_cov_19.649689	307	387	7	7	80	0.0875000
NODE_8748_length_904_cov_19.649689	307	387	8	63	80	0.7875000
NODE_8748_length_904_cov_19.649689	360	440	2	13	80	0.1625000
NODE_8748_length_904_cov_19.649689	360	440	3	14	80	0.1750000
NODE_8748_length_904_cov_19.649689	360	440	4	10	80	0.1250000
NODE_8748_length_904_cov_19.649689	360	440	6	11	80	0.1375000
NODE_8748_length_904_cov_19.649689	360	440	8	32	80	0.4000000
NODE_8748_length_904_cov_19.649689	595	675	0	31	80	0.3875000
NODE_8748_length_904_cov_19.649689	595	675	2	25	80	0.3125000
NODE_8748_length_904_cov_19.649689	595	675	3	22	80	0.2750000
NODE_8748_length_904_cov_19.649689	595	675	4	2	80	0.0250000
NODE_8748_length_904_cov_19.649689	648	728	2	14	80	0.1750000
NODE_8748_length_904_cov_19.649689	648	728	3	22	80	0.2750000
NODE_8748_length_904_cov_19.649689	648	728	4	44	80	0.5500000
NODE_8750_length_904_cov_16.608696	252	332	2	21	80	0.2625000
NODE_8750_length_904_cov_16.608696	252	332	3	59	80	0.7375000
NODE_8750_length_904_cov_16.608696	305	385	2	29	80	0.3625000
NODE_8750_length_904_cov_16.608696	305	385	3	51	80	0.6375000
NODE_8750_length_904_cov_16.608696	381	461	2	42	80	0.5250000
NODE_8750_length_904_cov_16.608696	381	461	3	38	80	0.4750000
NODE_8750_length_904_cov_16.608696	434	514	2	62	80	0.7750000
NODE_8750_length_904_cov_16.608696	434	514	3	18	80	0.2250000
NODE_8751_length_904_cov_15.811180	431	511	0	77	80	0.9625000
NODE_8751_length_904_cov_15.811180	431	511	2	3	80	0.0375000
NODE_8751_length_904_cov_15.811180	484	564	0	24	80	0.3000000
NODE_8751_length_904_cov_15.811180	484	564	2	56	80	0.7000000
NODE_8752_length_904_cov_9.249689	581	661	0	80	80	1.0000000
NODE_8752_length_904_cov_9.249689	634	714	0	80	80	1.0000000
NODE_8756_length_904_cov_4.772671	318	398	2	80	80	1.0000000
NODE_8756_length_904_cov_4.772671	371	451	0	12	80	0.1500000
NODE_8756_length_904_cov_4.772671	371	451	1	25	80	0.3125000
NODE_8756_length_904_cov_4.772671	371	451	2	43	80	0.5375000
NODE_8773_length_903_cov_58.723881	386	466	11	6	80	0.0750000
NODE_8773_length_903_cov_58.723881	386	466	12	1	80	0.0125000
NODE_8773_length_903_cov_58.723881	386	466	13	2	80	0.0250000
NODE_8773_length_903_cov_58.723881	386	466	14	10	80	0.1250000
NODE_8773_length_903_cov_58.723881	386	466	16	3	80	0.0375000
NODE_8773_length_903_cov_58.723881	386	466	17	16	80	0.2000000
NODE_8773_length_903_cov_58.723881	386	466	18	29	80	0.3625000
NODE_8773_length_903_cov_58.723881	386	466	19	13	80	0.1625000
NODE_8773_length_903_cov_58.723881	439	519	15	17	80	0.2125000
NODE_8773_length_903_cov_58.723881	439	519	16	21	80	0.2625000
NODE_8773_length_903_cov_58.723881	439	519	17	25	80	0.3125000
NODE_8773_length_903_cov_58.723881	439	519	18	4	80	0.0500000
NODE_8773_length_903_cov_58.723881	439	519	19	13	80	0.1625000
NODE_8773_length_903_cov_58.723881	515	595	9	24	80	0.3000000
NODE_8773_length_903_cov_58.723881	515	595	10	17	80	0.2125000
NODE_8773_length_903_cov_58.723881	515	595	11	11	80	0.1375000
NODE_8773_length_903_cov_58.723881	515	595	14	1	80	0.0125000
NODE_8773_length_903_cov_58.723881	515	595	15	15	80	0.1875000
NODE_8773_length_903_cov_58.723881	515	595	16	6	80	0.0750000
NODE_8773_length_903_cov_58.723881	515	595	17	4	80	0.0500000
NODE_8773_length_903_cov_58.723881	515	595	18	2	80	0.0250000
NODE_8773_length_903_cov_58.723881	568	648	6	11	80	0.1375000
NODE_8773_length_903_cov_58.723881	568	648	8	30	80	0.3750000
NODE_8773_length_903_cov_58.723881	568	648	9	32	80	0.4000000
NODE_8773_length_903_cov_58.723881	568	648	10	7	80	0.0875000
NODE_8774_length_903_cov_41.298507	397	477	2	21	80	0.2625000
NODE_8774_length_903_cov_41.298507	397	477	3	59	80	0.7375000
NODE_8774_length_903_cov_41.298507	450	530	3	80	80	1.0000000
NODE_8775_length_903_cov_28.691542	394	474	2	29	80	0.3625000
NODE_8775_length_903_cov_28.691542	394	474	3	17	80	0.2125000
NODE_8775_length_903_cov_28.691542	394	474	4	34	80	0.4250000
NODE_8775_length_903_cov_28.691542	447	527	2	5	80	0.0625000
NODE_8775_length_903_cov_28.691542	447	527	4	75	80	0.9375000
NODE_8776_length_903_cov_26.276119	441	521	1	22	80	0.2750000
NODE_8776_length_903_cov_26.276119	441	521	3	9	80	0.1125000
NODE_8776_length_903_cov_26.276119	441	521	4	49	80	0.6125000
NODE_8776_length_903_cov_26.276119	494	574	0	20	80	0.2500000
NODE_8776_length_903_cov_26.276119	494	574	1	55	80	0.6875000
NODE_8776_length_903_cov_26.276119	494	574	3	5	80	0.0625000
NODE_8778_length_903_cov_18.166667	351	431	0	78	80	0.9750000
NODE_8778_length_903_cov_18.166667	351	431	1	2	80	0.0250000
NODE_8778_length_903_cov_18.166667	404	484	0	59	80	0.7375000
NODE_8778_length_903_cov_18.166667	404	484	1	21	80	0.2625000
NODE_8779_length_903_cov_15.460199	440	520	0	80	80	1.0000000
NODE_8779_length_903_cov_15.460199	493	573	0	80	80	1.0000000
NODE_8780_length_903_cov_15.084577	352	432	0	10	80	0.1250000
NODE_8780_length_903_cov_15.084577	352	432	1	11	80	0.1375000
NODE_8780_length_903_cov_15.084577	352	432	2	4	80	0.0500000
NODE_8780_length_903_cov_15.084577	352	432	3	9	80	0.1125000
NODE_8780_length_903_cov_15.084577	352	432	5	46	80	0.5750000
NODE_8780_length_903_cov_15.084577	405	485	5	40	80	0.5000000
NODE_8780_length_903_cov_15.084577	405	485	6	20	80	0.2500000
NODE_8780_length_903_cov_15.084577	405	485	7	20	80	0.2500000
NODE_8781_length_903_cov_15.070896	367	447	6	30	80	0.3750000
NODE_8781_length_903_cov_15.070896	367	447	7	45	80	0.5625000
NODE_8781_length_903_cov_15.070896	367	447	8	5	80	0.0625000
NODE_8781_length_903_cov_15.070896	420	500	2	13	80	0.1625000
NODE_8781_length_903_cov_15.070896	420	500	4	26	80	0.3250000
NODE_8781_length_903_cov_15.070896	420	500	6	35	80	0.4375000
NODE_8781_length_903_cov_15.070896	420	500	7	1	80	0.0125000
NODE_8781_length_903_cov_15.070896	420	500	8	5	80	0.0625000
NODE_8782_length_903_cov_14.004975	318	399	0	25	81	0.3086420
NODE_8782_length_903_cov_14.004975	318	399	2	40	81	0.4938272
NODE_8782_length_903_cov_14.004975	318	399	4	16	81	0.1975309
NODE_8782_length_903_cov_14.004975	372	452	2	11	80	0.1375000
NODE_8782_length_903_cov_14.004975	372	452	4	69	80	0.8625000
NODE_8783_length_903_cov_10.546020	150	230	4	39	80	0.4875000
NODE_8783_length_903_cov_10.546020	150	230	5	26	80	0.3250000
NODE_8783_length_903_cov_10.546020	150	230	7	10	80	0.1250000
NODE_8783_length_903_cov_10.546020	150	230	8	5	80	0.0625000
NODE_8783_length_903_cov_10.546020	203	283	2	1	80	0.0125000
NODE_8783_length_903_cov_10.546020	203	283	3	19	80	0.2375000
NODE_8783_length_903_cov_10.546020	203	283	4	11	80	0.1375000
NODE_8783_length_903_cov_10.546020	203	283	5	49	80	0.6125000
NODE_8784_length_903_cov_9.288557	373	453	0	80	80	1.0000000
NODE_8784_length_903_cov_9.288557	426	506	0	80	80	1.0000000
NODE_8785_length_903_cov_8.052239	439	519	0	80	80	1.0000000
NODE_8785_length_903_cov_8.052239	492	572	0	27	80	0.3375000
NODE_8785_length_903_cov_8.052239	492	572	1	53	80	0.6625000
NODE_8798_length_902_cov_64.459527	355	435	0	9	80	0.1125000
NODE_8798_length_902_cov_64.459527	355	435	1	13	80	0.1625000
NODE_8798_length_902_cov_64.459527	355	435	2	50	80	0.6250000
NODE_8798_length_902_cov_64.459527	355	435	3	8	80	0.1000000
NODE_8798_length_902_cov_64.459527	408	488	2	19	80	0.2375000
NODE_8798_length_902_cov_64.459527	408	488	3	61	80	0.7625000
NODE_8798_length_902_cov_64.459527	484	564	1	11	80	0.1375000
NODE_8798_length_902_cov_64.459527	484	564	2	23	80	0.2875000
NODE_8798_length_902_cov_64.459527	484	564	3	46	80	0.5750000
NODE_8798_length_902_cov_64.459527	537	617	2	42	80	0.5250000
NODE_8798_length_902_cov_64.459527	537	617	3	38	80	0.4750000
NODE_8799_length_902_cov_60.823163	395	475	3	15	80	0.1875000
NODE_8799_length_902_cov_60.823163	395	475	5	65	80	0.8125000
NODE_8799_length_902_cov_60.823163	448	528	1	20	80	0.2500000
NODE_8799_length_902_cov_60.823163	448	528	2	17	80	0.2125000
NODE_8799_length_902_cov_60.823163	448	528	3	17	80	0.2125000
NODE_8799_length_902_cov_60.823163	448	528	4	14	80	0.1750000
NODE_8799_length_902_cov_60.823163	448	528	5	12	80	0.1500000
NODE_8800_length_902_cov_44.002491	383	463	3	51	80	0.6375000
NODE_8800_length_902_cov_44.002491	383	463	5	29	80	0.3625000
NODE_8800_length_902_cov_44.002491	436	516	1	11	80	0.1375000
NODE_8800_length_902_cov_44.002491	436	516	3	7	80	0.0875000
NODE_8800_length_902_cov_44.002491	436	516	5	62	80	0.7750000
NODE_8801_length_902_cov_41.059776	378	458	5	3	80	0.0375000
NODE_8801_length_902_cov_41.059776	378	458	7	13	80	0.1625000
NODE_8801_length_902_cov_41.059776	378	458	8	64	80	0.8000000
NODE_8801_length_902_cov_41.059776	431	511	1	16	80	0.2000000
NODE_8801_length_902_cov_41.059776	431	511	2	26	80	0.3250000
NODE_8801_length_902_cov_41.059776	431	511	3	1	80	0.0125000
NODE_8801_length_902_cov_41.059776	431	511	4	2	80	0.0250000
NODE_8801_length_902_cov_41.059776	431	511	5	11	80	0.1375000
NODE_8801_length_902_cov_41.059776	431	511	7	2	80	0.0250000
NODE_8801_length_902_cov_41.059776	431	511	8	22	80	0.2750000
NODE_8802_length_902_cov_38.952677	372	452	0	2	80	0.0250000
NODE_8802_length_902_cov_38.952677	372	452	1	41	80	0.5125000
NODE_8802_length_902_cov_38.952677	372	452	3	7	80	0.0875000
NODE_8802_length_902_cov_38.952677	372	452	5	30	80	0.3750000
NODE_8802_length_902_cov_38.952677	425	505	5	37	80	0.4625000
NODE_8802_length_902_cov_38.952677	425	505	6	43	80	0.5375000
NODE_8803_length_902_cov_34.156912	373	453	4	26	80	0.3250000
NODE_8803_length_902_cov_34.156912	373	453	5	36	80	0.4500000
NODE_8803_length_902_cov_34.156912	373	453	6	18	80	0.2250000
NODE_8803_length_902_cov_34.156912	426	506	4	36	80	0.4500000
NODE_8803_length_902_cov_34.156912	426	506	5	33	80	0.4125000
NODE_8803_length_902_cov_34.156912	426	506	6	11	80	0.1375000
NODE_8804_length_902_cov_23.007472	295	375	1	13	80	0.1625000
NODE_8804_length_902_cov_23.007472	295	375	2	67	80	0.8375000
NODE_8804_length_902_cov_23.007472	348	428	1	9	80	0.1125000
NODE_8804_length_902_cov_23.007472	348	428	2	71	80	0.8875000
NODE_8805_length_902_cov_19.491905	238	291	2	32	53	0.6037736
NODE_8805_length_902_cov_19.491905	238	291	3	21	53	0.3962264
NODE_8805_length_902_cov_19.491905	264	344	2	6	80	0.0750000
NODE_8805_length_902_cov_19.491905	264	344	3	40	80	0.5000000
NODE_8805_length_902_cov_19.491905	264	344	4	18	80	0.2250000
NODE_8805_length_902_cov_19.491905	264	344	5	16	80	0.2000000
NODE_8806_length_902_cov_10.794521	214	294	0	13	80	0.1625000
NODE_8806_length_902_cov_10.794521	214	294	2	67	80	0.8375000
NODE_8806_length_902_cov_10.794521	267	347	2	80	80	1.0000000
NODE_8807_length_902_cov_9.520548	518	598	0	80	80	1.0000000
NODE_8807_length_902_cov_9.520548	571	651	0	80	80	1.0000000
NODE_8808_length_902_cov_8.323786	337	417	0	9	80	0.1125000
NODE_8808_length_902_cov_8.323786	337	417	1	37	80	0.4625000
NODE_8808_length_902_cov_8.323786	337	417	3	18	80	0.2250000
NODE_8808_length_902_cov_8.323786	337	417	4	16	80	0.2000000
NODE_8808_length_902_cov_8.323786	390	470	3	23	80	0.2875000
NODE_8808_length_902_cov_8.323786	390	470	4	57	80	0.7125000
NODE_8811_length_902_cov_7.300125	434	514	0	80	80	1.0000000
NODE_8811_length_902_cov_7.300125	487	567	0	80	80	1.0000000
NODE_8812_length_902_cov_4.185554	505	585	0	80	80	1.0000000
NODE_8812_length_902_cov_4.185554	558	588	0	30	30	1.0000000
NODE_8812_length_902_cov_4.185554	610	662	0	52	52	1.0000000
NODE_8830_length_902_cov_0.963885	82	106	0	18	24	0.7500000
NODE_8830_length_902_cov_0.963885	82	106	1	6	24	0.2500000
NODE_8832_length_901_cov_36.066085	412	490	6	19	78	0.2435897
NODE_8832_length_901_cov_36.066085	412	490	7	10	78	0.1282051
NODE_8832_length_901_cov_36.066085	412	490	8	24	78	0.3076923
NODE_8832_length_901_cov_36.066085	412	490	9	12	78	0.1538462
NODE_8832_length_901_cov_36.066085	412	490	10	13	78	0.1666667
NODE_8832_length_901_cov_36.066085	463	543	4	25	80	0.3125000
NODE_8832_length_901_cov_36.066085	463	543	5	9	80	0.1125000
NODE_8832_length_901_cov_36.066085	463	543	7	29	80	0.3625000
NODE_8832_length_901_cov_36.066085	463	543	9	12	80	0.1500000
NODE_8832_length_901_cov_36.066085	463	543	10	5	80	0.0625000
NODE_8833_length_901_cov_28.129676	377	457	2	80	80	1.0000000
NODE_8833_length_901_cov_28.129676	430	510	0	53	80	0.6625000
NODE_8833_length_901_cov_28.129676	430	510	2	27	80	0.3375000
NODE_8834_length_901_cov_26.763092	272	352	3	26	80	0.3250000
NODE_8834_length_901_cov_26.763092	272	352	4	39	80	0.4875000
NODE_8834_length_901_cov_26.763092	272	352	5	15	80	0.1875000
NODE_8834_length_901_cov_26.763092	325	405	3	26	80	0.3250000
NODE_8834_length_901_cov_26.763092	325	405	4	18	80	0.2250000
NODE_8834_length_901_cov_26.763092	325	405	5	36	80	0.4500000
NODE_8834_length_901_cov_26.763092	401	481	1	33	80	0.4125000
NODE_8834_length_901_cov_26.763092	401	481	3	29	80	0.3625000
NODE_8834_length_901_cov_26.763092	401	481	4	18	80	0.2250000
NODE_8834_length_901_cov_26.763092	454	534	1	37	80	0.4625000
NODE_8834_length_901_cov_26.763092	454	534	2	11	80	0.1375000
NODE_8834_length_901_cov_26.763092	454	534	3	32	80	0.4000000
NODE_8835_length_901_cov_25.628429	369	449	0	80	80	1.0000000
NODE_8835_length_901_cov_25.628429	422	502	0	80	80	1.0000000
NODE_8836_length_901_cov_17.857855	408	488	1	29	80	0.3625000
NODE_8836_length_901_cov_17.857855	408	488	2	51	80	0.6375000
NODE_8836_length_901_cov_17.857855	461	541	1	21	80	0.2625000
NODE_8836_length_901_cov_17.857855	461	541	2	59	80	0.7375000
NODE_8837_length_901_cov_16.254364	362	442	1	80	80	1.0000000
NODE_8837_length_901_cov_16.254364	415	495	0	53	80	0.6625000
NODE_8837_length_901_cov_16.254364	415	495	1	27	80	0.3375000
NODE_8838_length_901_cov_8.346633	321	401	2	44	80	0.5500000
NODE_8838_length_901_cov_8.346633	321	401	4	36	80	0.4500000
NODE_8838_length_901_cov_8.346633	374	454	0	1	80	0.0125000
NODE_8838_length_901_cov_8.346633	374	454	2	13	80	0.1625000
NODE_8838_length_901_cov_8.346633	374	454	3	15	80	0.1875000
NODE_8838_length_901_cov_8.346633	374	454	4	51	80	0.6375000
NODE_8840_length_901_cov_6.044888	363	443	0	80	80	1.0000000
NODE_8840_length_901_cov_6.044888	416	496	0	80	80	1.0000000
NODE_8845_length_901_cov_3.814214	194	274	0	80	80	1.0000000
NODE_8845_length_901_cov_3.814214	247	326	0	48	79	0.6075949
NODE_8845_length_901_cov_3.814214	247	326	2	31	79	0.3924051
NODE_8857_length_900_cov_30.284644	407	487	4	24	80	0.3000000
NODE_8857_length_900_cov_30.284644	407	487	5	20	80	0.2500000
NODE_8857_length_900_cov_30.284644	407	487	6	36	80	0.4500000
NODE_8857_length_900_cov_30.284644	460	540	2	5	80	0.0625000
NODE_8857_length_900_cov_30.284644	460	540	3	6	80	0.0750000
NODE_8857_length_900_cov_30.284644	460	540	4	23	80	0.2875000
NODE_8857_length_900_cov_30.284644	460	540	5	39	80	0.4875000
NODE_8857_length_900_cov_30.284644	460	540	6	7	80	0.0875000
NODE_8858_length_900_cov_29.679151	425	505	2	16	80	0.2000000
NODE_8858_length_900_cov_29.679151	425	505	3	12	80	0.1500000
NODE_8858_length_900_cov_29.679151	425	505	4	9	80	0.1125000
NODE_8858_length_900_cov_29.679151	425	505	5	9	80	0.1125000
NODE_8858_length_900_cov_29.679151	425	505	6	14	80	0.1750000
NODE_8858_length_900_cov_29.679151	425	505	7	3	80	0.0375000
NODE_8858_length_900_cov_29.679151	425	505	9	5	80	0.0625000
NODE_8858_length_900_cov_29.679151	425	505	11	12	80	0.1500000
NODE_8858_length_900_cov_29.679151	478	558	6	7	80	0.0875000
NODE_8858_length_900_cov_29.679151	478	558	7	4	80	0.0500000
NODE_8858_length_900_cov_29.679151	478	558	8	2	80	0.0250000
NODE_8858_length_900_cov_29.679151	478	558	9	5	80	0.0625000
NODE_8858_length_900_cov_29.679151	478	558	10	6	80	0.0750000
NODE_8858_length_900_cov_29.679151	478	558	11	56	80	0.7000000
NODE_8859_length_900_cov_25.963795	321	401	1	30	80	0.3750000
NODE_8859_length_900_cov_25.963795	321	401	2	39	80	0.4875000
NODE_8859_length_900_cov_25.963795	321	401	4	9	80	0.1125000
NODE_8859_length_900_cov_25.963795	321	401	5	2	80	0.0250000
NODE_8859_length_900_cov_25.963795	374	454	2	16	80	0.2000000
NODE_8859_length_900_cov_25.963795	374	454	4	9	80	0.1125000
NODE_8859_length_900_cov_25.963795	374	454	5	49	80	0.6125000
NODE_8859_length_900_cov_25.963795	374	454	6	6	80	0.0750000
NODE_8860_length_900_cov_17.681648	530	606	1	26	76	0.3421053
NODE_8860_length_900_cov_17.681648	530	606	2	50	76	0.6578947
NODE_8860_length_900_cov_17.681648	583	659	1	46	76	0.6052632
NODE_8860_length_900_cov_17.681648	583	659	2	30	76	0.3947369
NODE_8861_length_900_cov_16.294632	316	396	0	80	80	1.0000000
NODE_8861_length_900_cov_16.294632	369	449	0	80	80	1.0000000
NODE_8863_length_900_cov_5.962547	0	70	0	4	70	0.0571429
NODE_8863_length_900_cov_5.962547	0	70	2	66	70	0.9428571
NODE_8863_length_900_cov_5.962547	43	108	0	4	65	0.0615385
NODE_8863_length_900_cov_5.962547	43	108	2	61	65	0.9384615
NODE_8870_length_900_cov_2.521848	85	165	0	80	80	1.0000000
NODE_8870_length_900_cov_2.521848	138	218	0	74	80	0.9250000
NODE_8870_length_900_cov_2.521848	138	218	1	6	80	0.0750000
NODE_8879_length_899_cov_45.853750	380	460	4	44	80	0.5500000
NODE_8879_length_899_cov_45.853750	380	460	5	9	80	0.1125000
NODE_8879_length_899_cov_45.853750	380	460	6	21	80	0.2625000
NODE_8879_length_899_cov_45.853750	380	460	7	6	80	0.0750000
NODE_8879_length_899_cov_45.853750	433	516	3	39	83	0.4698795
NODE_8879_length_899_cov_45.853750	433	516	4	37	83	0.4457831
NODE_8879_length_899_cov_45.853750	433	516	5	7	83	0.0843373
NODE_8880_length_899_cov_37.758750	381	461	1	54	80	0.6750000
NODE_8880_length_899_cov_37.758750	381	461	3	18	80	0.2250000
NODE_8880_length_899_cov_37.758750	381	461	4	8	80	0.1000000
NODE_8880_length_899_cov_37.758750	434	514	1	1	80	0.0125000
NODE_8880_length_899_cov_37.758750	434	514	3	70	80	0.8750000
NODE_8880_length_899_cov_37.758750	434	514	4	9	80	0.1125000
NODE_8881_length_899_cov_27.362500	413	493	2	10	80	0.1250000
NODE_8881_length_899_cov_27.362500	413	493	4	39	80	0.4875000
NODE_8881_length_899_cov_27.362500	413	493	5	4	80	0.0500000
NODE_8881_length_899_cov_27.362500	413	493	7	27	80	0.3375000
NODE_8881_length_899_cov_27.362500	466	546	5	17	80	0.2125000
NODE_8881_length_899_cov_27.362500	466	546	6	14	80	0.1750000
NODE_8881_length_899_cov_27.362500	466	546	7	49	80	0.6125000
NODE_8882_length_899_cov_20.563750	379	459	0	80	80	1.0000000
NODE_8882_length_899_cov_20.563750	432	507	0	75	75	1.0000000
NODE_8884_length_899_cov_17.130000	319	399	1	44	80	0.5500000
NODE_8884_length_899_cov_17.130000	319	399	2	36	80	0.4500000
NODE_8884_length_899_cov_17.130000	372	452	1	55	80	0.6875000
NODE_8884_length_899_cov_17.130000	372	452	2	25	80	0.3125000
NODE_8885_length_899_cov_16.317500	270	350	3	9	80	0.1125000
NODE_8885_length_899_cov_16.317500	270	350	5	57	80	0.7125000
NODE_8885_length_899_cov_16.317500	270	350	6	7	80	0.0875000
NODE_8885_length_899_cov_16.317500	270	350	7	7	80	0.0875000
NODE_8885_length_899_cov_16.317500	323	403	3	3	80	0.0375000
NODE_8885_length_899_cov_16.317500	323	403	5	40	80	0.5000000
NODE_8885_length_899_cov_16.317500	323	403	6	3	80	0.0375000
NODE_8885_length_899_cov_16.317500	323	403	7	34	80	0.4250000
NODE_8886_length_899_cov_16.190000	284	364	0	31	80	0.3875000
NODE_8886_length_899_cov_16.190000	284	364	2	49	80	0.6125000
NODE_8886_length_899_cov_16.190000	337	417	2	80	80	1.0000000
NODE_8887_length_899_cov_13.873750	317	397	3	45	80	0.5625000
NODE_8887_length_899_cov_13.873750	317	397	4	35	80	0.4375000
NODE_8887_length_899_cov_13.873750	370	450	3	57	80	0.7125000
NODE_8887_length_899_cov_13.873750	370	450	4	23	80	0.2875000
NODE_8888_length_899_cov_12.957500	240	320	0	52	80	0.6500000
NODE_8888_length_899_cov_12.957500	240	320	1	28	80	0.3500000
NODE_8888_length_899_cov_12.957500	293	373	1	80	80	1.0000000
NODE_8889_length_899_cov_12.516250	387	467	0	80	80	1.0000000
NODE_8889_length_899_cov_12.516250	440	520	0	80	80	1.0000000
NODE_8890_length_899_cov_10.846250	348	428	0	32	80	0.4000000
NODE_8890_length_899_cov_10.846250	348	428	2	48	80	0.6000000
NODE_8890_length_899_cov_10.846250	401	485	2	84	84	1.0000000
NODE_8891_length_899_cov_9.185000	347	427	2	80	80	1.0000000
NODE_8891_length_899_cov_9.185000	400	480	0	20	80	0.2500000
NODE_8891_length_899_cov_9.185000	400	480	1	21	80	0.2625000
NODE_8891_length_899_cov_9.185000	400	480	2	39	80	0.4875000
NODE_8892_length_899_cov_8.655000	498	578	3	5	80	0.0625000
NODE_8892_length_899_cov_8.655000	498	578	5	63	80	0.7875000
NODE_8892_length_899_cov_8.655000	498	578	7	12	80	0.1500000
NODE_8892_length_899_cov_8.655000	551	631	5	15	80	0.1875000
NODE_8892_length_899_cov_8.655000	551	631	7	28	80	0.3500000
NODE_8892_length_899_cov_8.655000	551	631	8	37	80	0.4625000
NODE_8893_length_899_cov_3.551250	0	54	0	1	54	0.0185185
NODE_8893_length_899_cov_3.551250	0	54	2	4	54	0.0740741
NODE_8893_length_899_cov_3.551250	0	54	4	4	54	0.0740741
NODE_8893_length_899_cov_3.551250	0	54	6	5	54	0.0925926
NODE_8893_length_899_cov_3.551250	0	54	9	2	54	0.0370370
NODE_8893_length_899_cov_3.551250	0	54	10	14	54	0.2592593
NODE_8893_length_899_cov_3.551250	0	54	12	6	54	0.1111111
NODE_8893_length_899_cov_3.551250	0	54	14	6	54	0.1111111
NODE_8893_length_899_cov_3.551250	0	54	16	12	54	0.2222222
NODE_8893_length_899_cov_3.551250	27	107	10	3	80	0.0375000
NODE_8893_length_899_cov_3.551250	27	107	12	6	80	0.0750000
NODE_8893_length_899_cov_3.551250	27	107	14	8	80	0.1000000
NODE_8893_length_899_cov_3.551250	27	107	16	63	80	0.7875000
NODE_8893_length_899_cov_3.551250	103	183	0	11	80	0.1375000
NODE_8893_length_899_cov_3.551250	103	183	2	6	80	0.0750000
NODE_8893_length_899_cov_3.551250	103	183	3	2	80	0.0250000
NODE_8893_length_899_cov_3.551250	103	183	4	13	80	0.1625000
NODE_8893_length_899_cov_3.551250	103	183	6	1	80	0.0125000
NODE_8893_length_899_cov_3.551250	103	183	8	3	80	0.0375000
NODE_8893_length_899_cov_3.551250	103	183	10	10	80	0.1250000
NODE_8893_length_899_cov_3.551250	103	183	12	15	80	0.1875000
NODE_8893_length_899_cov_3.551250	103	183	14	17	80	0.2125000
NODE_8893_length_899_cov_3.551250	103	183	16	2	80	0.0250000
NODE_8893_length_899_cov_3.551250	156	179	0	7	23	0.3043478
NODE_8893_length_899_cov_3.551250	156	179	2	6	23	0.2608696
NODE_8893_length_899_cov_3.551250	156	179	3	2	23	0.0869565
NODE_8893_length_899_cov_3.551250	156	179	4	8	23	0.3478261
NODE_8914_length_898_cov_52.405507	299	379	0	67	80	0.8375000
NODE_8914_length_898_cov_52.405507	299	379	1	13	80	0.1625000
NODE_8914_length_898_cov_52.405507	352	432	0	14	80	0.1750000
NODE_8914_length_898_cov_52.405507	352	432	1	58	80	0.7250000
NODE_8914_length_898_cov_52.405507	352	432	2	8	80	0.1000000
NODE_8914_length_898_cov_52.405507	428	508	2	80	80	1.0000000
NODE_8914_length_898_cov_52.405507	481	561	1	45	80	0.5625000
NODE_8914_length_898_cov_52.405507	481	561	2	35	80	0.4375000
NODE_8915_length_898_cov_44.973717	363	443	2	29	80	0.3625000
NODE_8915_length_898_cov_44.973717	363	443	3	51	80	0.6375000
NODE_8915_length_898_cov_44.973717	416	496	1	44	80	0.5500000
NODE_8915_length_898_cov_44.973717	416	496	3	36	80	0.4500000
NODE_8916_length_898_cov_38.269086	425	505	4	55	80	0.6875000
NODE_8916_length_898_cov_38.269086	425	505	5	25	80	0.3125000
NODE_8916_length_898_cov_38.269086	478	558	2	1	80	0.0125000
NODE_8916_length_898_cov_38.269086	478	558	3	3	80	0.0375000
NODE_8916_length_898_cov_38.269086	478	558	4	43	80	0.5375000
NODE_8916_length_898_cov_38.269086	478	558	5	33	80	0.4125000
NODE_8917_length_898_cov_27.006258	465	545	2	25	80	0.3125000
NODE_8917_length_898_cov_27.006258	465	545	4	3	80	0.0375000
NODE_8917_length_898_cov_27.006258	465	545	5	3	80	0.0375000
NODE_8917_length_898_cov_27.006258	465	545	6	3	80	0.0375000
NODE_8917_length_898_cov_27.006258	465	545	7	6	80	0.0750000
NODE_8917_length_898_cov_27.006258	465	545	8	21	80	0.2625000
NODE_8917_length_898_cov_27.006258	465	545	9	12	80	0.1500000
NODE_8917_length_898_cov_27.006258	465	545	10	7	80	0.0875000
NODE_8917_length_898_cov_27.006258	518	598	8	8	80	0.1000000
NODE_8917_length_898_cov_27.006258	518	598	9	37	80	0.4625000
NODE_8917_length_898_cov_27.006258	518	598	10	35	80	0.4375000
NODE_8918_length_898_cov_25.902378	185	265	0	80	80	1.0000000
NODE_8918_length_898_cov_25.902378	238	318	0	80	80	1.0000000
NODE_8918_length_898_cov_25.902378	314	394	0	80	80	1.0000000
NODE_8918_length_898_cov_25.902378	367	447	0	80	80	1.0000000
NODE_8919_length_898_cov_25.209011	368	448	1	80	80	1.0000000
NODE_8919_length_898_cov_25.209011	421	501	1	27	80	0.3375000
NODE_8919_length_898_cov_25.209011	421	501	2	51	80	0.6375000
NODE_8919_length_898_cov_25.209011	421	501	3	2	80	0.0250000
NODE_8920_length_898_cov_21.923655	325	405	1	77	80	0.9625000
NODE_8920_length_898_cov_21.923655	325	405	2	3	80	0.0375000
NODE_8920_length_898_cov_21.923655	378	458	1	80	80	1.0000000
NODE_8921_length_898_cov_21.065081	306	386	1	17	80	0.2125000
NODE_8921_length_898_cov_21.065081	306	386	2	12	80	0.1500000
NODE_8921_length_898_cov_21.065081	306	386	3	2	80	0.0250000
NODE_8921_length_898_cov_21.065081	306	386	4	49	80	0.6125000
NODE_8921_length_898_cov_21.065081	359	439	4	62	80	0.7750000
NODE_8921_length_898_cov_21.065081	359	439	5	18	80	0.2250000
NODE_8922_length_898_cov_20.954944	374	454	5	14	80	0.1750000
NODE_8922_length_898_cov_20.954944	374	454	6	5	80	0.0625000
NODE_8922_length_898_cov_20.954944	374	454	7	4	80	0.0500000
NODE_8922_length_898_cov_20.954944	374	454	8	14	80	0.1750000
NODE_8922_length_898_cov_20.954944	374	454	9	7	80	0.0875000
NODE_8922_length_898_cov_20.954944	374	454	10	18	80	0.2250000
NODE_8922_length_898_cov_20.954944	374	454	11	18	80	0.2250000
NODE_8922_length_898_cov_20.954944	427	507	7	25	80	0.3125000
NODE_8922_length_898_cov_20.954944	427	507	10	42	80	0.5250000
NODE_8922_length_898_cov_20.954944	427	507	11	13	80	0.1625000
NODE_8923_length_898_cov_17.387985	398	478	3	39	80	0.4875000
NODE_8923_length_898_cov_17.387985	398	478	4	41	80	0.5125000
NODE_8923_length_898_cov_17.387985	451	531	2	39	80	0.4875000
NODE_8923_length_898_cov_17.387985	451	531	3	37	80	0.4625000
NODE_8923_length_898_cov_17.387985	451	531	4	4	80	0.0500000
NODE_8924_length_898_cov_17.252816	265	345	2	23	80	0.2875000
NODE_8924_length_898_cov_17.252816	265	345	4	57	80	0.7125000
NODE_8924_length_898_cov_17.252816	318	398	0	30	80	0.3750000
NODE_8924_length_898_cov_17.252816	318	398	1	4	80	0.0500000
NODE_8924_length_898_cov_17.252816	318	398	2	42	80	0.5250000
NODE_8924_length_898_cov_17.252816	318	398	4	4	80	0.0500000
NODE_8926_length_898_cov_13.152691	455	535	0	15	80	0.1875000
NODE_8926_length_898_cov_13.152691	455	535	2	65	80	0.8125000
NODE_8926_length_898_cov_13.152691	508	588	2	80	80	1.0000000
NODE_8927_length_898_cov_12.612015	375	455	3	10	80	0.1250000
NODE_8927_length_898_cov_12.612015	375	455	4	14	80	0.1750000
NODE_8927_length_898_cov_12.612015	375	455	5	56	80	0.7000000
NODE_8927_length_898_cov_12.612015	428	508	4	37	80	0.4625000
NODE_8927_length_898_cov_12.612015	428	508	5	43	80	0.5375000
NODE_8928_length_898_cov_12.498123	428	508	0	80	80	1.0000000
NODE_8928_length_898_cov_12.498123	481	561	0	80	80	1.0000000
NODE_8932_length_898_cov_1.790989	0	56	0	56	56	1.0000000
NODE_8932_length_898_cov_1.790989	29	93	0	64	64	1.0000000
NODE_8944_length_897_cov_63.921053	350	430	4	2	80	0.0250000
NODE_8944_length_897_cov_63.921053	350	430	6	1	80	0.0125000
NODE_8944_length_897_cov_63.921053	350	430	7	10	80	0.1250000
NODE_8944_length_897_cov_63.921053	350	430	8	37	80	0.4625000
NODE_8944_length_897_cov_63.921053	350	430	9	12	80	0.1500000
NODE_8944_length_897_cov_63.921053	350	430	10	18	80	0.2250000
NODE_8944_length_897_cov_63.921053	403	483	4	50	80	0.6250000
NODE_8944_length_897_cov_63.921053	403	483	5	5	80	0.0625000
NODE_8944_length_897_cov_63.921053	403	483	6	1	80	0.0125000
NODE_8944_length_897_cov_63.921053	403	483	7	10	80	0.1250000
NODE_8944_length_897_cov_63.921053	403	483	8	3	80	0.0375000
NODE_8944_length_897_cov_63.921053	403	483	10	11	80	0.1375000
NODE_8945_length_897_cov_58.921053	316	396	0	5	80	0.0625000
NODE_8945_length_897_cov_58.921053	316	396	1	2	80	0.0250000
NODE_8945_length_897_cov_58.921053	316	396	2	14	80	0.1750000
NODE_8945_length_897_cov_58.921053	316	396	4	23	80	0.2875000
NODE_8945_length_897_cov_58.921053	316	396	5	15	80	0.1875000
NODE_8945_length_897_cov_58.921053	316	396	6	16	80	0.2000000
NODE_8945_length_897_cov_58.921053	316	396	8	3	80	0.0375000
NODE_8945_length_897_cov_58.921053	316	396	10	2	80	0.0250000
NODE_8945_length_897_cov_58.921053	369	449	5	6	80	0.0750000
NODE_8945_length_897_cov_58.921053	369	449	6	16	80	0.2000000
NODE_8945_length_897_cov_58.921053	369	449	8	18	80	0.2250000
NODE_8945_length_897_cov_58.921053	369	449	9	7	80	0.0875000
NODE_8945_length_897_cov_58.921053	369	449	10	33	80	0.4125000
NODE_8946_length_897_cov_35.946115	324	404	2	49	80	0.6125000
NODE_8946_length_897_cov_35.946115	324	404	3	31	80	0.3875000
NODE_8946_length_897_cov_35.946115	377	457	2	9	80	0.1125000
NODE_8946_length_897_cov_35.946115	377	457	3	71	80	0.8875000
NODE_8947_length_897_cov_25.548872	238	318	2	20	80	0.2500000
NODE_8947_length_897_cov_25.548872	238	318	3	2	80	0.0250000
NODE_8947_length_897_cov_25.548872	238	318	4	58	80	0.7250000
NODE_8947_length_897_cov_25.548872	291	371	2	43	80	0.5375000
NODE_8947_length_897_cov_25.548872	291	371	3	6	80	0.0750000
NODE_8947_length_897_cov_25.548872	291	371	4	31	80	0.3875000
NODE_8948_length_897_cov_24.913534	399	479	4	10	80	0.1250000
NODE_8948_length_897_cov_24.913534	399	479	6	18	80	0.2250000
NODE_8948_length_897_cov_24.913534	399	479	7	39	80	0.4875000
NODE_8948_length_897_cov_24.913534	399	479	8	11	80	0.1375000
NODE_8948_length_897_cov_24.913534	399	479	9	2	80	0.0250000
NODE_8948_length_897_cov_24.913534	452	532	3	7	80	0.0875000
NODE_8948_length_897_cov_24.913534	452	532	4	45	80	0.5625000
NODE_8948_length_897_cov_24.913534	452	532	6	18	80	0.2250000
NODE_8948_length_897_cov_24.913534	452	532	7	10	80	0.1250000
NODE_8949_length_897_cov_21.839599	308	388	1	7	80	0.0875000
NODE_8949_length_897_cov_21.839599	308	388	2	38	80	0.4750000
NODE_8949_length_897_cov_21.839599	308	388	4	35	80	0.4375000
NODE_8949_length_897_cov_21.839599	361	441	3	22	80	0.2750000
NODE_8949_length_897_cov_21.839599	361	441	4	58	80	0.7250000
NODE_8950_length_897_cov_19.355890	489	569	3	80	80	1.0000000
NODE_8950_length_897_cov_19.355890	542	622	1	37	80	0.4625000
NODE_8950_length_897_cov_19.355890	542	622	3	43	80	0.5375000
NODE_8951_length_897_cov_16.295739	209	289	0	44	80	0.5500000
NODE_8951_length_897_cov_16.295739	209	289	1	1	80	0.0125000
NODE_8951_length_897_cov_16.295739	209	289	2	35	80	0.4375000
NODE_8951_length_897_cov_16.295739	262	342	2	79	80	0.9875000
NODE_8951_length_897_cov_16.295739	262	342	3	1	80	0.0125000
NODE_8952_length_897_cov_14.766917	395	475	0	48	80	0.6000000
NODE_8952_length_897_cov_14.766917	395	475	2	32	80	0.4000000
NODE_8952_length_897_cov_14.766917	448	528	2	75	80	0.9375000
NODE_8952_length_897_cov_14.766917	448	528	4	5	80	0.0625000
NODE_8953_length_897_cov_14.219298	253	333	3	53	80	0.6625000
NODE_8953_length_897_cov_14.219298	253	333	4	14	80	0.1750000
NODE_8953_length_897_cov_14.219298	253	333	5	3	80	0.0375000
NODE_8953_length_897_cov_14.219298	253	333	6	10	80	0.1250000
NODE_8953_length_897_cov_14.219298	306	386	3	5	80	0.0625000
NODE_8953_length_897_cov_14.219298	306	386	4	9	80	0.1125000
NODE_8953_length_897_cov_14.219298	306	386	5	3	80	0.0375000
NODE_8953_length_897_cov_14.219298	306	386	6	16	80	0.2000000
NODE_8953_length_897_cov_14.219298	306	386	7	47	80	0.5875000
NODE_8954_length_897_cov_11.116541	182	262	0	80	80	1.0000000
NODE_8954_length_897_cov_11.116541	235	315	0	80	80	1.0000000
NODE_8955_length_897_cov_8.211779	303	383	0	7	80	0.0875000
NODE_8955_length_897_cov_8.211779	303	383	2	73	80	0.9125000
NODE_8955_length_897_cov_8.211779	356	436	0	39	80	0.4875000
NODE_8955_length_897_cov_8.211779	356	436	2	41	80	0.5125000
NODE_8973_length_896_cov_48.249686	397	477	3	11	80	0.1375000
NODE_8973_length_896_cov_48.249686	397	477	4	61	80	0.7625000
NODE_8973_length_896_cov_48.249686	397	477	5	4	80	0.0500000
NODE_8973_length_896_cov_48.249686	397	477	6	4	80	0.0500000
NODE_8973_length_896_cov_48.249686	450	530	3	51	80	0.6375000
NODE_8973_length_896_cov_48.249686	450	530	4	19	80	0.2375000
NODE_8973_length_896_cov_48.249686	450	530	5	6	80	0.0750000
NODE_8973_length_896_cov_48.249686	450	530	6	4	80	0.0500000
NODE_8974_length_896_cov_24.824341	213	293	0	30	80	0.3750000
NODE_8974_length_896_cov_24.824341	213	293	2	50	80	0.6250000
NODE_8974_length_896_cov_24.824341	266	346	2	80	80	1.0000000
NODE_8975_length_896_cov_23.130489	333	413	1	40	80	0.5000000
NODE_8975_length_896_cov_23.130489	333	413	3	20	80	0.2500000
NODE_8975_length_896_cov_23.130489	333	413	4	20	80	0.2500000
NODE_8975_length_896_cov_23.130489	386	466	3	24	80	0.3000000
NODE_8975_length_896_cov_23.130489	386	466	4	56	80	0.7000000
NODE_8975_length_896_cov_23.130489	462	542	2	74	80	0.9250000
NODE_8975_length_896_cov_23.130489	462	542	4	6	80	0.0750000
NODE_8975_length_896_cov_23.130489	515	595	1	52	80	0.6500000
NODE_8975_length_896_cov_23.130489	515	595	2	28	80	0.3500000
NODE_8976_length_896_cov_20.673777	361	441	2	80	80	1.0000000
NODE_8976_length_896_cov_20.673777	414	497	0	30	83	0.3614458
NODE_8976_length_896_cov_20.673777	414	497	1	16	83	0.1927711
NODE_8976_length_896_cov_20.673777	414	497	2	37	83	0.4457831
NODE_8977_length_896_cov_18.979925	418	498	3	65	80	0.8125000
NODE_8977_length_896_cov_18.979925	418	498	4	15	80	0.1875000
NODE_8977_length_896_cov_18.979925	471	551	1	8	80	0.1000000
NODE_8977_length_896_cov_18.979925	471	551	2	20	80	0.2500000
NODE_8977_length_896_cov_18.979925	471	551	3	22	80	0.2750000
NODE_8977_length_896_cov_18.979925	471	551	4	30	80	0.3750000
NODE_8978_length_896_cov_15.875784	340	420	2	80	80	1.0000000
NODE_8978_length_896_cov_15.875784	393	473	2	80	80	1.0000000
NODE_8980_length_896_cov_10.646173	337	417	1	80	80	1.0000000
NODE_8980_length_896_cov_10.646173	390	470	1	77	80	0.9625000
NODE_8980_length_896_cov_10.646173	390	470	2	3	80	0.0375000
NODE_8981_length_896_cov_10.351317	327	407	1	22	80	0.2750000
NODE_8981_length_896_cov_10.351317	327	407	2	9	80	0.1125000
NODE_8981_length_896_cov_10.351317	327	407	3	9	80	0.1125000
NODE_8981_length_896_cov_10.351317	327	407	4	33	80	0.4125000
NODE_8981_length_896_cov_10.351317	327	407	5	7	80	0.0875000
NODE_8981_length_896_cov_10.351317	380	460	4	32	80	0.4000000
NODE_8981_length_896_cov_10.351317	380	460	5	48	80	0.6000000
NODE_8982_length_896_cov_9.754078	411	491	2	80	80	1.0000000
NODE_8982_length_896_cov_9.754078	464	544	1	48	80	0.6000000
NODE_8982_length_896_cov_9.754078	464	544	2	32	80	0.4000000
NODE_8983_length_896_cov_8.069009	340	422	3	82	82	1.0000000
NODE_8983_length_896_cov_8.069009	395	475	2	52	80	0.6500000
NODE_8983_length_896_cov_8.069009	395	475	3	27	80	0.3375000
NODE_8983_length_896_cov_8.069009	395	475	4	1	80	0.0125000
NODE_8986_length_896_cov_4.939774	384	464	0	53	80	0.6625000
NODE_8986_length_896_cov_4.939774	384	464	1	27	80	0.3375000
NODE_8986_length_896_cov_4.939774	437	517	0	69	80	0.8625000
NODE_8986_length_896_cov_4.939774	437	517	1	11	80	0.1375000
NODE_9005_length_895_cov_54.949749	378	458	0	74	80	0.9250000
NODE_9005_length_895_cov_54.949749	378	458	2	6	80	0.0750000
NODE_9005_length_895_cov_54.949749	431	511	0	21	80	0.2625000
NODE_9005_length_895_cov_54.949749	431	511	2	59	80	0.7375000
NODE_9006_length_895_cov_53.945980	306	386	0	80	80	1.0000000
NODE_9006_length_895_cov_53.945980	359	439	0	80	80	1.0000000
NODE_9007_length_895_cov_48.915829	369	449	2	41	80	0.5125000
NODE_9007_length_895_cov_48.915829	369	449	3	39	80	0.4875000
NODE_9007_length_895_cov_48.915829	422	502	2	8	80	0.1000000
NODE_9007_length_895_cov_48.915829	422	502	3	71	80	0.8875000
NODE_9007_length_895_cov_48.915829	422	502	4	1	80	0.0125000
NODE_9007_length_895_cov_48.915829	498	578	3	46	80	0.5750000
NODE_9007_length_895_cov_48.915829	498	578	4	34	80	0.4250000
NODE_9007_length_895_cov_48.915829	551	631	2	1	80	0.0125000
NODE_9007_length_895_cov_48.915829	551	631	3	70	80	0.8750000
NODE_9007_length_895_cov_48.915829	551	631	4	9	80	0.1125000
NODE_9008_length_895_cov_38.347990	452	532	3	17	80	0.2125000
NODE_9008_length_895_cov_38.347990	452	532	4	16	80	0.2000000
NODE_9008_length_895_cov_38.347990	452	532	5	28	80	0.3500000
NODE_9008_length_895_cov_38.347990	452	532	6	19	80	0.2375000
NODE_9008_length_895_cov_38.347990	505	585	4	44	80	0.5500000
NODE_9008_length_895_cov_38.347990	505	585	5	36	80	0.4500000
NODE_9009_length_895_cov_33.716080	418	499	2	51	81	0.6296296
NODE_9009_length_895_cov_33.716080	418	499	4	30	81	0.3703704
NODE_9009_length_895_cov_33.716080	472	552	1	25	80	0.3125000
NODE_9009_length_895_cov_33.716080	472	552	2	55	80	0.6875000
NODE_9010_length_895_cov_21.630653	392	468	4	27	76	0.3552631
NODE_9010_length_895_cov_21.630653	392	468	5	24	76	0.3157895
NODE_9010_length_895_cov_21.630653	392	468	6	24	76	0.3157895
NODE_9010_length_895_cov_21.630653	392	468	7	1	76	0.0131579
NODE_9010_length_895_cov_21.630653	441	521	5	4	80	0.0500000
NODE_9010_length_895_cov_21.630653	441	521	6	38	80	0.4750000
NODE_9010_length_895_cov_21.630653	441	521	7	38	80	0.4750000
NODE_9011_length_895_cov_19.932161	331	411	0	80	80	1.0000000
NODE_9011_length_895_cov_19.932161	384	464	0	80	80	1.0000000
NODE_9011_length_895_cov_19.932161	460	540	0	29	80	0.3625000
NODE_9011_length_895_cov_19.932161	460	540	2	51	80	0.6375000
NODE_9011_length_895_cov_19.932161	513	593	0	8	80	0.1000000
NODE_9011_length_895_cov_19.932161	513	593	2	72	80	0.9000000
NODE_9012_length_895_cov_16.037688	403	479	3	3	76	0.0394737
NODE_9012_length_895_cov_16.037688	403	479	4	73	76	0.9605263
NODE_9012_length_895_cov_16.037688	452	532	0	10	80	0.1250000
NODE_9012_length_895_cov_16.037688	452	532	1	20	80	0.2500000
NODE_9012_length_895_cov_16.037688	452	532	3	26	80	0.3250000
NODE_9012_length_895_cov_16.037688	452	532	4	24	80	0.3000000
NODE_9013_length_895_cov_13.003769	372	452	0	80	80	1.0000000
NODE_9013_length_895_cov_13.003769	425	491	0	66	66	1.0000000
NODE_9014_length_895_cov_12.736181	280	360	0	80	80	1.0000000
NODE_9014_length_895_cov_12.736181	333	413	0	80	80	1.0000000
NODE_9015_length_895_cov_11.090452	505	585	1	35	80	0.4375000
NODE_9015_length_895_cov_11.090452	505	585	2	45	80	0.5625000
NODE_9015_length_895_cov_11.090452	558	638	2	80	80	1.0000000
NODE_9016_length_895_cov_9.266332	468	548	0	80	80	1.0000000
NODE_9016_length_895_cov_9.266332	521	601	0	80	80	1.0000000
NODE_9018_length_895_cov_5.659548	472	552	0	18	80	0.2250000
NODE_9018_length_895_cov_5.659548	472	552	2	59	80	0.7375000
NODE_9018_length_895_cov_5.659548	472	552	4	3	80	0.0375000
NODE_9018_length_895_cov_5.659548	525	605	2	24	80	0.3000000
NODE_9018_length_895_cov_5.659548	525	605	4	56	80	0.7000000
NODE_9019_length_895_cov_5.383166	42	123	0	81	81	1.0000000
NODE_9030_length_894_cov_60.153459	446	526	0	21	80	0.2625000
NODE_9030_length_894_cov_60.153459	446	526	2	59	80	0.7375000
NODE_9030_length_894_cov_60.153459	499	579	2	80	80	1.0000000
NODE_9031_length_894_cov_49.618868	373	453	2	10	80	0.1250000
NODE_9031_length_894_cov_49.618868	373	453	4	70	80	0.8750000
NODE_9031_length_894_cov_49.618868	426	506	2	10	80	0.1250000
NODE_9031_length_894_cov_49.618868	426	506	4	70	80	0.8750000
NODE_9032_length_894_cov_33.228931	459	539	3	7	80	0.0875000
NODE_9032_length_894_cov_33.228931	459	539	4	10	80	0.1250000
NODE_9032_length_894_cov_33.228931	459	539	5	63	80	0.7875000
NODE_9032_length_894_cov_33.228931	512	592	2	41	80	0.5125000
NODE_9032_length_894_cov_33.228931	512	592	4	20	80	0.2500000
NODE_9032_length_894_cov_33.228931	512	592	5	19	80	0.2375000
NODE_9033_length_894_cov_31.933333	411	491	0	62	80	0.7750000
NODE_9033_length_894_cov_31.933333	411	491	1	18	80	0.2250000
NODE_9033_length_894_cov_31.933333	464	544	0	9	80	0.1125000
NODE_9033_length_894_cov_31.933333	464	544	1	71	80	0.8875000
NODE_9034_length_894_cov_30.499371	270	350	2	72	80	0.9000000
NODE_9034_length_894_cov_30.499371	270	350	3	8	80	0.1000000
NODE_9034_length_894_cov_30.499371	323	403	2	19	80	0.2375000
NODE_9034_length_894_cov_30.499371	323	403	3	11	80	0.1375000
NODE_9034_length_894_cov_30.499371	323	403	4	19	80	0.2375000
NODE_9034_length_894_cov_30.499371	323	403	5	11	80	0.1375000
NODE_9034_length_894_cov_30.499371	323	403	6	8	80	0.1000000
NODE_9034_length_894_cov_30.499371	323	403	7	12	80	0.1500000
NODE_9034_length_894_cov_30.499371	399	479	5	1	80	0.0125000
NODE_9034_length_894_cov_30.499371	399	479	6	67	80	0.8375000
NODE_9034_length_894_cov_30.499371	399	479	7	12	80	0.1500000
NODE_9034_length_894_cov_30.499371	452	532	4	10	80	0.1250000
NODE_9034_length_894_cov_30.499371	452	532	5	19	80	0.2375000
NODE_9034_length_894_cov_30.499371	452	532	6	38	80	0.4750000
NODE_9034_length_894_cov_30.499371	452	532	7	13	80	0.1625000
NODE_9035_length_894_cov_23.046541	79	159	0	46	80	0.5750000
NODE_9035_length_894_cov_23.046541	79	159	1	34	80	0.4250000
NODE_9035_length_894_cov_23.046541	132	212	1	80	80	1.0000000
NODE_9036_length_894_cov_22.266667	381	461	2	25	80	0.3125000
NODE_9036_length_894_cov_22.266667	381	461	4	12	80	0.1500000
NODE_9036_length_894_cov_22.266667	381	461	5	25	80	0.3125000
NODE_9036_length_894_cov_22.266667	381	461	6	18	80	0.2250000
NODE_9036_length_894_cov_22.266667	434	514	5	21	80	0.2625000
NODE_9036_length_894_cov_22.266667	434	514	6	59	80	0.7375000
NODE_9037_length_894_cov_21.997484	332	412	0	80	80	1.0000000
NODE_9037_length_894_cov_21.997484	385	465	0	80	80	1.0000000
NODE_9038_length_894_cov_21.205031	319	399	2	21	80	0.2625000
NODE_9038_length_894_cov_21.205031	319	399	3	1	80	0.0125000
NODE_9038_length_894_cov_21.205031	319	399	4	58	80	0.7250000
NODE_9038_length_894_cov_21.205031	372	452	0	3	80	0.0375000
NODE_9038_length_894_cov_21.205031	372	452	1	29	80	0.3625000
NODE_9038_length_894_cov_21.205031	372	452	2	42	80	0.5250000
NODE_9038_length_894_cov_21.205031	372	452	3	1	80	0.0125000
NODE_9038_length_894_cov_21.205031	372	452	4	5	80	0.0625000
NODE_9038_length_894_cov_21.205031	448	528	0	79	80	0.9875000
NODE_9038_length_894_cov_21.205031	448	528	1	1	80	0.0125000
NODE_9038_length_894_cov_21.205031	501	581	0	80	80	1.0000000
NODE_9039_length_894_cov_21.132075	422	502	0	80	80	1.0000000
NODE_9039_length_894_cov_21.132075	475	555	0	80	80	1.0000000
NODE_9040_length_894_cov_15.598742	338	418	2	80	80	1.0000000
NODE_9040_length_894_cov_15.598742	391	471	0	10	80	0.1250000
NODE_9040_length_894_cov_15.598742	391	471	1	34	80	0.4250000
NODE_9040_length_894_cov_15.598742	391	471	2	36	80	0.4500000
NODE_9041_length_894_cov_14.079245	344	424	1	58	80	0.7250000
NODE_9041_length_894_cov_14.079245	344	424	3	22	80	0.2750000
NODE_9041_length_894_cov_14.079245	397	477	1	5	80	0.0625000
NODE_9041_length_894_cov_14.079245	397	477	3	69	80	0.8625000
NODE_9041_length_894_cov_14.079245	397	477	4	6	80	0.0750000
NODE_9042_length_894_cov_13.031447	336	416	1	44	80	0.5500000
NODE_9042_length_894_cov_13.031447	336	416	2	36	80	0.4500000
NODE_9042_length_894_cov_13.031447	389	469	0	11	80	0.1375000
NODE_9042_length_894_cov_13.031447	389	469	1	69	80	0.8625000
NODE_9043_length_894_cov_13.031447	353	433	2	75	80	0.9375000
NODE_9043_length_894_cov_13.031447	353	433	3	5	80	0.0625000
NODE_9043_length_894_cov_13.031447	406	486	2	38	80	0.4750000
NODE_9043_length_894_cov_13.031447	406	486	3	30	80	0.3750000
NODE_9043_length_894_cov_13.031447	406	486	4	12	80	0.1500000
NODE_9044_length_894_cov_9.706918	330	410	0	52	80	0.6500000
NODE_9044_length_894_cov_9.706918	330	410	1	28	80	0.3500000
NODE_9045_length_894_cov_6.963522	378	458	0	80	80	1.0000000
NODE_9045_length_894_cov_6.963522	431	511	0	80	80	1.0000000
NODE_9046_length_894_cov_4.993711	365	445	1	47	80	0.5875000
NODE_9046_length_894_cov_4.993711	365	445	2	33	80	0.4125000
NODE_9046_length_894_cov_4.993711	418	498	1	74	80	0.9250000
NODE_9046_length_894_cov_4.993711	418	498	2	6	80	0.0750000
NODE_9066_length_893_cov_59.134761	261	341	0	49	80	0.6125000
NODE_9066_length_893_cov_59.134761	261	341	1	3	80	0.0375000
NODE_9066_length_893_cov_59.134761	261	341	2	11	80	0.1375000
NODE_9066_length_893_cov_59.134761	261	341	4	17	80	0.2125000
NODE_9066_length_893_cov_59.134761	314	394	2	10	80	0.1250000
NODE_9066_length_893_cov_59.134761	314	394	4	70	80	0.8750000
NODE_9067_length_893_cov_58.991184	388	468	1	36	80	0.4500000
NODE_9067_length_893_cov_58.991184	388	468	2	44	80	0.5500000
NODE_9067_length_893_cov_58.991184	441	521	1	65	80	0.8125000
NODE_9067_length_893_cov_58.991184	441	521	2	15	80	0.1875000
NODE_9067_length_893_cov_58.991184	517	597	1	63	80	0.7875000
NODE_9067_length_893_cov_58.991184	517	597	2	17	80	0.2125000
NODE_9067_length_893_cov_58.991184	570	650	1	80	80	1.0000000
NODE_9068_length_893_cov_55.644836	434	514	0	65	80	0.8125000
NODE_9068_length_893_cov_55.644836	434	514	2	15	80	0.1875000
NODE_9068_length_893_cov_55.644836	487	567	0	77	80	0.9625000
NODE_9068_length_893_cov_55.644836	487	567	1	3	80	0.0375000
NODE_9068_length_893_cov_55.644836	563	643	0	1	80	0.0125000
NODE_9068_length_893_cov_55.644836	563	643	1	23	80	0.2875000
NODE_9068_length_893_cov_55.644836	563	643	3	31	80	0.3875000
NODE_9068_length_893_cov_55.644836	563	643	4	25	80	0.3125000
NODE_9068_length_893_cov_55.644836	616	696	2	5	80	0.0625000
NODE_9068_length_893_cov_55.644836	616	696	3	2	80	0.0250000
NODE_9068_length_893_cov_55.644836	616	696	4	73	80	0.9125000
NODE_9069_length_893_cov_54.803526	479	559	0	57	80	0.7125000
NODE_9069_length_893_cov_54.803526	479	559	2	23	80	0.2875000
NODE_9069_length_893_cov_54.803526	532	612	0	4	80	0.0500000
NODE_9069_length_893_cov_54.803526	532	612	2	76	80	0.9500000
NODE_9070_length_893_cov_38.147355	391	471	2	8	80	0.1000000
NODE_9070_length_893_cov_38.147355	391	471	4	14	80	0.1750000
NODE_9070_length_893_cov_38.147355	391	471	5	38	80	0.4750000
NODE_9070_length_893_cov_38.147355	391	471	6	20	80	0.2500000
NODE_9070_length_893_cov_38.147355	444	524	5	13	80	0.1625000
NODE_9070_length_893_cov_38.147355	444	524	6	29	80	0.3625000
NODE_9070_length_893_cov_38.147355	444	524	7	27	80	0.3375000
NODE_9070_length_893_cov_38.147355	444	524	8	11	80	0.1375000
NODE_9071_length_893_cov_33.690176	387	467	0	5	80	0.0625000
NODE_9071_length_893_cov_33.690176	387	467	1	21	80	0.2625000
NODE_9071_length_893_cov_33.690176	387	467	2	54	80	0.6750000
NODE_9071_length_893_cov_33.690176	440	520	2	80	80	1.0000000
NODE_9072_length_893_cov_32.162469	524	604	2	5	80	0.0625000
NODE_9072_length_893_cov_32.162469	524	604	3	3	80	0.0375000
NODE_9072_length_893_cov_32.162469	524	604	4	66	80	0.8250000
NODE_9072_length_893_cov_32.162469	524	604	5	6	80	0.0750000
NODE_9072_length_893_cov_32.162469	577	657	2	5	80	0.0625000
NODE_9072_length_893_cov_32.162469	577	657	3	28	80	0.3500000
NODE_9072_length_893_cov_32.162469	577	657	4	47	80	0.5875000
NODE_9073_length_893_cov_31.916877	344	424	4	51	80	0.6375000
NODE_9073_length_893_cov_31.916877	344	424	5	29	80	0.3625000
NODE_9073_length_893_cov_31.916877	397	477	1	35	80	0.4375000
NODE_9073_length_893_cov_31.916877	397	477	2	10	80	0.1250000
NODE_9073_length_893_cov_31.916877	397	477	3	7	80	0.0875000
NODE_9073_length_893_cov_31.916877	397	477	4	28	80	0.3500000
NODE_9074_length_893_cov_28.693955	437	517	3	3	80	0.0375000
NODE_9074_length_893_cov_28.693955	437	517	4	21	80	0.2625000
NODE_9074_length_893_cov_28.693955	437	517	5	13	80	0.1625000
NODE_9074_length_893_cov_28.693955	437	517	6	43	80	0.5375000
NODE_9074_length_893_cov_28.693955	490	570	2	45	80	0.5625000
NODE_9074_length_893_cov_28.693955	490	570	3	11	80	0.1375000
NODE_9074_length_893_cov_28.693955	490	570	4	9	80	0.1125000
NODE_9074_length_893_cov_28.693955	490	570	5	13	80	0.1625000
NODE_9074_length_893_cov_28.693955	490	570	6	2	80	0.0250000
NODE_9075_length_893_cov_23.564232	363	443	0	30	80	0.3750000
NODE_9075_length_893_cov_23.564232	363	443	2	50	80	0.6250000
NODE_9075_length_893_cov_23.564232	416	496	0	80	80	1.0000000
NODE_9076_length_893_cov_22.633501	272	352	4	1	80	0.0125000
NODE_9076_length_893_cov_22.633501	272	352	7	4	80	0.0500000
NODE_9076_length_893_cov_22.633501	272	352	9	9	80	0.1125000
NODE_9076_length_893_cov_22.633501	272	352	11	21	80	0.2625000
NODE_9076_length_893_cov_22.633501	272	352	13	6	80	0.0750000
NODE_9076_length_893_cov_22.633501	272	352	14	3	80	0.0375000
NODE_9076_length_893_cov_22.633501	272	352	15	1	80	0.0125000
NODE_9076_length_893_cov_22.633501	272	352	16	7	80	0.0875000
NODE_9076_length_893_cov_22.633501	272	352	17	28	80	0.3500000
NODE_9076_length_893_cov_22.633501	272	352	4	1	80	0.0125000
NODE_9076_length_893_cov_22.633501	272	352	7	4	80	0.0500000
NODE_9076_length_893_cov_22.633501	272	352	9	9	80	0.1125000
NODE_9076_length_893_cov_22.633501	272	352	11	21	80	0.2625000
NODE_9076_length_893_cov_22.633501	272	352	13	6	80	0.0750000
NODE_9076_length_893_cov_22.633501	272	352	14	3	80	0.0375000
NODE_9076_length_893_cov_22.633501	272	352	15	1	80	0.0125000
NODE_9076_length_893_cov_22.633501	272	352	16	7	80	0.0875000
NODE_9076_length_893_cov_22.633501	272	352	17	28	80	0.3500000
NODE_9076_length_893_cov_22.633501	272	352	4	1	80	0.0125000
NODE_9076_length_893_cov_22.633501	272	352	7	4	80	0.0500000
NODE_9076_length_893_cov_22.633501	272	352	9	9	80	0.1125000
NODE_9076_length_893_cov_22.633501	272	352	11	21	80	0.2625000
NODE_9076_length_893_cov_22.633501	272	352	13	6	80	0.0750000
NODE_9076_length_893_cov_22.633501	272	352	14	3	80	0.0375000
NODE_9076_length_893_cov_22.633501	272	352	15	1	80	0.0125000
NODE_9076_length_893_cov_22.633501	272	352	16	7	80	0.0875000
NODE_9076_length_893_cov_22.633501	272	352	17	28	80	0.3500000
NODE_9076_length_893_cov_22.633501	325	405	11	4	80	0.0500000
NODE_9076_length_893_cov_22.633501	325	405	12	3	80	0.0375000
NODE_9076_length_893_cov_22.633501	325	405	13	7	80	0.0875000
NODE_9076_length_893_cov_22.633501	325	405	14	7	80	0.0875000
NODE_9076_length_893_cov_22.633501	325	405	15	18	80	0.2250000
NODE_9076_length_893_cov_22.633501	325	405	16	11	80	0.1375000
NODE_9076_length_893_cov_22.633501	325	405	17	30	80	0.3750000
NODE_9076_length_893_cov_22.633501	325	405	11	4	80	0.0500000
NODE_9076_length_893_cov_22.633501	325	405	12	3	80	0.0375000
NODE_9076_length_893_cov_22.633501	325	405	13	7	80	0.0875000
NODE_9076_length_893_cov_22.633501	325	405	14	7	80	0.0875000
NODE_9076_length_893_cov_22.633501	325	405	15	18	80	0.2250000
NODE_9076_length_893_cov_22.633501	325	405	16	11	80	0.1375000
NODE_9076_length_893_cov_22.633501	325	405	17	30	80	0.3750000
NODE_9076_length_893_cov_22.633501	325	405	11	4	80	0.0500000
NODE_9076_length_893_cov_22.633501	325	405	12	3	80	0.0375000
NODE_9076_length_893_cov_22.633501	325	405	13	7	80	0.0875000
NODE_9076_length_893_cov_22.633501	325	405	14	7	80	0.0875000
NODE_9076_length_893_cov_22.633501	325	405	15	18	80	0.2250000
NODE_9076_length_893_cov_22.633501	325	405	16	11	80	0.1375000
NODE_9076_length_893_cov_22.633501	325	405	17	30	80	0.3750000
NODE_9076_length_893_cov_22.633501	401	481	10	53	80	0.6625000
NODE_9076_length_893_cov_22.633501	401	481	11	21	80	0.2625000
NODE_9076_length_893_cov_22.633501	401	481	12	6	80	0.0750000
NODE_9076_length_893_cov_22.633501	454	534	7	3	80	0.0375000
NODE_9076_length_893_cov_22.633501	454	534	8	16	80	0.2000000
NODE_9076_length_893_cov_22.633501	454	534	9	4	80	0.0500000
NODE_9076_length_893_cov_22.633501	454	534	10	27	80	0.3375000
NODE_9076_length_893_cov_22.633501	454	534	11	25	80	0.3125000
NODE_9076_length_893_cov_22.633501	454	534	12	5	80	0.0625000
NODE_9077_length_893_cov_22.403023	453	533	0	80	80	1.0000000
NODE_9077_length_893_cov_22.403023	506	586	0	80	80	1.0000000
NODE_9078_length_893_cov_19.423174	298	378	2	4	80	0.0500000
NODE_9078_length_893_cov_19.423174	298	378	3	65	80	0.8125000
NODE_9078_length_893_cov_19.423174	298	378	4	11	80	0.1375000
NODE_9078_length_893_cov_19.423174	351	431	3	16	80	0.2000000
NODE_9078_length_893_cov_19.423174	351	431	4	12	80	0.1500000
NODE_9078_length_893_cov_19.423174	351	431	5	2	80	0.0250000
NODE_9078_length_893_cov_19.423174	351	431	6	13	80	0.1625000
NODE_9078_length_893_cov_19.423174	351	431	7	3	80	0.0375000
NODE_9078_length_893_cov_19.423174	351	431	8	1	80	0.0125000
NODE_9078_length_893_cov_19.423174	351	431	9	7	80	0.0875000
NODE_9078_length_893_cov_19.423174	351	431	10	26	80	0.3250000
NODE_9078_length_893_cov_19.423174	427	507	9	1	80	0.0125000
NODE_9078_length_893_cov_19.423174	427	507	10	3	80	0.0375000
NODE_9078_length_893_cov_19.423174	427	507	11	11	80	0.1375000
NODE_9078_length_893_cov_19.423174	427	507	12	21	80	0.2625000
NODE_9078_length_893_cov_19.423174	427	507	13	36	80	0.4500000
NODE_9078_length_893_cov_19.423174	427	507	15	3	80	0.0375000
NODE_9078_length_893_cov_19.423174	427	507	16	5	80	0.0625000
NODE_9078_length_893_cov_19.423174	480	560	10	1	80	0.0125000
NODE_9078_length_893_cov_19.423174	480	560	11	11	80	0.1375000
NODE_9078_length_893_cov_19.423174	480	560	13	21	80	0.2625000
NODE_9078_length_893_cov_19.423174	480	560	14	16	80	0.2000000
NODE_9078_length_893_cov_19.423174	480	560	15	4	80	0.0500000
NODE_9078_length_893_cov_19.423174	480	560	16	19	80	0.2375000
NODE_9078_length_893_cov_19.423174	480	560	17	8	80	0.1000000
NODE_9079_length_893_cov_19.389169	360	440	1	14	80	0.1750000
NODE_9079_length_893_cov_19.389169	360	440	2	43	80	0.5375000
NODE_9079_length_893_cov_19.389169	360	440	3	23	80	0.2875000
NODE_9079_length_893_cov_19.389169	413	493	2	24	80	0.3000000
NODE_9079_length_893_cov_19.389169	413	493	3	56	80	0.7000000
NODE_9079_length_893_cov_19.389169	489	569	1	21	80	0.2625000
NODE_9079_length_893_cov_19.389169	489	569	2	59	80	0.7375000
NODE_9079_length_893_cov_19.389169	542	622	1	49	80	0.6125000
NODE_9079_length_893_cov_19.389169	542	622	2	31	80	0.3875000
NODE_9080_length_893_cov_18.152393	394	474	2	80	80	1.0000000
NODE_9080_length_893_cov_18.152393	447	527	1	45	80	0.5625000
NODE_9080_length_893_cov_18.152393	447	527	2	35	80	0.4375000
NODE_9081_length_893_cov_15.960957	442	522	0	42	80	0.5250000
NODE_9081_length_893_cov_15.960957	442	522	2	38	80	0.4750000
NODE_9081_length_893_cov_15.960957	495	575	2	80	80	1.0000000
NODE_9082_length_893_cov_13.119647	473	553	0	47	80	0.5875000
NODE_9082_length_893_cov_13.119647	473	553	2	33	80	0.4125000
NODE_9082_length_893_cov_13.119647	526	606	2	80	80	1.0000000
NODE_9084_length_893_cov_5.549118	353	415	1	12	62	0.1935484
NODE_9084_length_893_cov_5.549118	353	415	2	50	62	0.8064516
NODE_9100_length_893_cov_1.141058	28	108	2	48	80	0.6000000
NODE_9100_length_893_cov_1.141058	28	108	3	32	80	0.4000000
NODE_9104_length_892_cov_74.968474	333	413	4	11	80	0.1375000
NODE_9104_length_892_cov_74.968474	333	413	6	17	80	0.2125000
NODE_9104_length_892_cov_74.968474	333	413	7	6	80	0.0750000
NODE_9104_length_892_cov_74.968474	333	413	8	15	80	0.1875000
NODE_9104_length_892_cov_74.968474	333	413	9	31	80	0.3875000
NODE_9104_length_892_cov_74.968474	386	466	2	13	80	0.1625000
NODE_9104_length_892_cov_74.968474	386	466	3	28	80	0.3500000
NODE_9104_length_892_cov_74.968474	386	466	4	23	80	0.2875000
NODE_9104_length_892_cov_74.968474	386	466	6	16	80	0.2000000
NODE_9104_length_892_cov_74.968474	462	542	1	4	80	0.0500000
NODE_9104_length_892_cov_74.968474	462	542	2	76	80	0.9500000
NODE_9104_length_892_cov_74.968474	515	595	1	23	80	0.2875000
NODE_9104_length_892_cov_74.968474	515	595	2	57	80	0.7125000
NODE_9105_length_892_cov_54.549811	463	550	4	26	87	0.2988506
NODE_9105_length_892_cov_54.549811	463	550	6	10	87	0.1149425
NODE_9105_length_892_cov_54.549811	463	550	7	18	87	0.2068966
NODE_9105_length_892_cov_54.549811	463	550	8	14	87	0.1609195
NODE_9105_length_892_cov_54.549811	463	550	9	19	87	0.2183908
NODE_9105_length_892_cov_54.549811	523	603	4	1	80	0.0125000
NODE_9105_length_892_cov_54.549811	523	603	5	7	80	0.0875000
NODE_9105_length_892_cov_54.549811	523	603	6	9	80	0.1125000
NODE_9105_length_892_cov_54.549811	523	603	8	15	80	0.1875000
NODE_9105_length_892_cov_54.549811	523	603	9	48	80	0.6000000
NODE_9105_length_892_cov_54.549811	599	679	1	9	80	0.1125000
NODE_9105_length_892_cov_54.549811	599	679	2	21	80	0.2625000
NODE_9105_length_892_cov_54.549811	599	679	3	37	80	0.4625000
NODE_9105_length_892_cov_54.549811	599	679	4	10	80	0.1250000
NODE_9105_length_892_cov_54.549811	599	679	5	3	80	0.0375000
NODE_9106_length_892_cov_37.887768	373	453	3	7	80	0.0875000
NODE_9106_length_892_cov_37.887768	373	453	5	16	80	0.2000000
NODE_9106_length_892_cov_37.887768	373	453	6	16	80	0.2000000
NODE_9106_length_892_cov_37.887768	373	453	7	16	80	0.2000000
NODE_9106_length_892_cov_37.887768	373	453	9	18	80	0.2250000
NODE_9106_length_892_cov_37.887768	373	453	10	7	80	0.0875000
NODE_9106_length_892_cov_37.887768	426	506	7	22	80	0.2750000
NODE_9106_length_892_cov_37.887768	426	506	9	42	80	0.5250000
NODE_9106_length_892_cov_37.887768	426	506	10	12	80	0.1500000
NODE_9106_length_892_cov_37.887768	426	506	11	4	80	0.0500000
NODE_9107_length_892_cov_19.732661	361	441	2	80	80	1.0000000
NODE_9107_length_892_cov_19.732661	414	494	1	14	80	0.1750000
NODE_9107_length_892_cov_19.732661	414	494	2	66	80	0.8250000
NODE_9108_length_892_cov_19.052963	290	370	1	17	80	0.2125000
NODE_9108_length_892_cov_19.052963	290	370	2	63	80	0.7875000
NODE_9108_length_892_cov_19.052963	343	423	1	70	80	0.8750000
NODE_9108_length_892_cov_19.052963	343	423	2	10	80	0.1250000
NODE_9108_length_892_cov_19.052963	419	499	1	40	80	0.5000000
NODE_9108_length_892_cov_19.052963	419	499	2	40	80	0.5000000
NODE_9108_length_892_cov_19.052963	472	552	2	80	80	1.0000000
NODE_9109_length_892_cov_17.276166	341	421	5	80	80	1.0000000
NODE_9109_length_892_cov_17.276166	394	474	1	14	80	0.1750000
NODE_9109_length_892_cov_17.276166	394	474	3	6	80	0.0750000
NODE_9109_length_892_cov_17.276166	394	474	4	3	80	0.0375000
NODE_9109_length_892_cov_17.276166	394	474	5	57	80	0.7125000
NODE_9110_length_892_cov_16.312736	411	491	2	12	80	0.1500000
NODE_9110_length_892_cov_16.312736	411	491	3	68	80	0.8500000
NODE_9110_length_892_cov_16.312736	464	544	2	33	80	0.4125000
NODE_9110_length_892_cov_16.312736	464	544	3	47	80	0.5875000
NODE_9111_length_892_cov_15.808323	395	475	0	80	80	1.0000000
NODE_9111_length_892_cov_15.808323	448	528	0	80	80	1.0000000
NODE_9112_length_892_cov_14.020177	522	602	0	33	80	0.4125000
NODE_9112_length_892_cov_14.020177	522	602	1	47	80	0.5875000
NODE_9112_length_892_cov_14.020177	575	655	1	45	80	0.5625000
NODE_9112_length_892_cov_14.020177	575	655	2	35	80	0.4375000
NODE_9114_length_892_cov_8.798235	400	480	1	3	80	0.0375000
NODE_9114_length_892_cov_8.798235	400	480	2	1	80	0.0125000
NODE_9114_length_892_cov_8.798235	400	480	3	76	80	0.9500000
NODE_9114_length_892_cov_8.798235	453	533	3	42	80	0.5250000
NODE_9114_length_892_cov_8.798235	453	533	4	38	80	0.4750000
NODE_9115_length_892_cov_8.413619	428	508	4	9	80	0.1125000
NODE_9115_length_892_cov_8.413619	428	508	5	3	80	0.0375000
NODE_9115_length_892_cov_8.413619	428	508	7	36	80	0.4500000
NODE_9115_length_892_cov_8.413619	428	508	8	6	80	0.0750000
NODE_9115_length_892_cov_8.413619	428	508	10	25	80	0.3125000
NODE_9115_length_892_cov_8.413619	428	508	12	1	80	0.0125000
NODE_9115_length_892_cov_8.413619	481	561	8	31	80	0.3875000
NODE_9115_length_892_cov_8.413619	481	561	9	6	80	0.0750000
NODE_9115_length_892_cov_8.413619	481	561	10	33	80	0.4125000
NODE_9115_length_892_cov_8.413619	481	561	12	10	80	0.1250000
NODE_9116_length_892_cov_6.694830	374	454	4	28	80	0.3500000
NODE_9116_length_892_cov_6.694830	374	454	5	42	80	0.5250000
NODE_9116_length_892_cov_6.694830	374	454	6	10	80	0.1250000
NODE_9116_length_892_cov_6.694830	427	507	4	5	80	0.0625000
NODE_9116_length_892_cov_6.694830	427	507	5	65	80	0.8125000
NODE_9116_length_892_cov_6.694830	427	507	6	10	80	0.1250000
NODE_9134_length_891_cov_30.166667	295	375	6	28	80	0.3500000
NODE_9134_length_891_cov_30.166667	295	375	7	4	80	0.0500000
NODE_9134_length_891_cov_30.166667	295	375	8	18	80	0.2250000
NODE_9134_length_891_cov_30.166667	295	375	9	10	80	0.1250000
NODE_9134_length_891_cov_30.166667	295	375	12	4	80	0.0500000
NODE_9134_length_891_cov_30.166667	295	375	14	16	80	0.2000000
NODE_9134_length_891_cov_30.166667	348	428	8	3	80	0.0375000
NODE_9134_length_891_cov_30.166667	348	428	9	4	80	0.0500000
NODE_9134_length_891_cov_30.166667	348	428	11	7	80	0.0875000
NODE_9134_length_891_cov_30.166667	348	428	12	19	80	0.2375000
NODE_9134_length_891_cov_30.166667	348	428	13	16	80	0.2000000
NODE_9134_length_891_cov_30.166667	348	428	14	31	80	0.3875000
NODE_9135_length_891_cov_26.333333	319	399	1	17	80	0.2125000
NODE_9135_length_891_cov_26.333333	319	399	3	2	80	0.0250000
NODE_9135_length_891_cov_26.333333	319	399	4	2	80	0.0250000
NODE_9135_length_891_cov_26.333333	319	399	5	6	80	0.0750000
NODE_9135_length_891_cov_26.333333	319	399	6	21	80	0.2625000
NODE_9135_length_891_cov_26.333333	319	399	7	15	80	0.1875000
NODE_9135_length_891_cov_26.333333	319	399	8	17	80	0.2125000
NODE_9135_length_891_cov_26.333333	372	452	3	3	80	0.0375000
NODE_9135_length_891_cov_26.333333	372	452	4	4	80	0.0500000
NODE_9135_length_891_cov_26.333333	372	452	5	21	80	0.2625000
NODE_9135_length_891_cov_26.333333	372	452	7	40	80	0.5000000
NODE_9135_length_891_cov_26.333333	372	452	8	12	80	0.1500000
NODE_9136_length_891_cov_22.228535	336	416	0	11	80	0.1375000
NODE_9136_length_891_cov_22.228535	336	416	2	69	80	0.8625000
NODE_9136_length_891_cov_22.228535	389	469	2	80	80	1.0000000
NODE_9137_length_891_cov_20.446970	377	457	0	80	80	1.0000000
NODE_9137_length_891_cov_20.446970	430	510	0	80	80	1.0000000
NODE_9138_length_891_cov_20.226010	310	390	0	80	80	1.0000000
NODE_9138_length_891_cov_20.226010	363	443	0	80	80	1.0000000
NODE_9140_length_891_cov_13.207071	392	472	1	25	80	0.3125000
NODE_9140_length_891_cov_13.207071	392	472	2	10	80	0.1250000
NODE_9140_length_891_cov_13.207071	392	472	3	45	80	0.5625000
NODE_9140_length_891_cov_13.207071	445	525	3	55	80	0.6875000
NODE_9140_length_891_cov_13.207071	445	525	4	25	80	0.3125000
NODE_9141_length_891_cov_11.579545	379	459	0	80	80	1.0000000
NODE_9141_length_891_cov_11.579545	432	512	0	80	80	1.0000000
NODE_9142_length_891_cov_11.117424	499	579	0	13	80	0.1625000
NODE_9142_length_891_cov_11.117424	499	579	2	67	80	0.8375000
NODE_9142_length_891_cov_11.117424	552	632	2	80	80	1.0000000
NODE_9153_length_890_cov_29.070796	284	364	1	80	80	1.0000000
NODE_9153_length_890_cov_29.070796	337	417	1	31	80	0.3875000
NODE_9153_length_890_cov_29.070796	337	417	2	33	80	0.4125000
NODE_9153_length_890_cov_29.070796	337	417	3	16	80	0.2000000
NODE_9153_length_890_cov_29.070796	413	497	1	30	84	0.3571429
NODE_9153_length_890_cov_29.070796	413	497	2	14	84	0.1666667
NODE_9153_length_890_cov_29.070796	413	497	3	40	84	0.4761905
NODE_9153_length_890_cov_29.070796	470	550	1	62	80	0.7750000
NODE_9153_length_890_cov_29.070796	470	550	2	7	80	0.0875000
NODE_9153_length_890_cov_29.070796	470	550	3	11	80	0.1375000
NODE_9154_length_890_cov_27.295828	550	630	1	73	80	0.9125000
NODE_9154_length_890_cov_27.295828	550	630	2	7	80	0.0875000
NODE_9154_length_890_cov_27.295828	603	683	1	80	80	1.0000000
NODE_9155_length_890_cov_18.088496	80	135	1	30	55	0.5454546
NODE_9155_length_890_cov_18.088496	80	135	3	25	55	0.4545455
NODE_9155_length_890_cov_18.088496	276	356	0	80	80	1.0000000
NODE_9155_length_890_cov_18.088496	329	406	0	77	77	1.0000000
NODE_9156_length_890_cov_16.831858	402	482	9	4	80	0.0500000
NODE_9156_length_890_cov_16.831858	402	482	10	7	80	0.0875000
NODE_9156_length_890_cov_16.831858	402	482	11	7	80	0.0875000
NODE_9156_length_890_cov_16.831858	402	482	12	6	80	0.0750000
NODE_9156_length_890_cov_16.831858	402	482	13	20	80	0.2500000
NODE_9156_length_890_cov_16.831858	402	482	14	9	80	0.1125000
NODE_9156_length_890_cov_16.831858	402	482	16	3	80	0.0375000
NODE_9156_length_890_cov_16.831858	402	482	17	5	80	0.0625000
NODE_9156_length_890_cov_16.831858	402	482	18	19	80	0.2375000
NODE_9156_length_890_cov_16.831858	455	535	13	4	80	0.0500000
NODE_9156_length_890_cov_16.831858	455	535	14	14	80	0.1750000
NODE_9156_length_890_cov_16.831858	455	535	15	6	80	0.0750000
NODE_9156_length_890_cov_16.831858	455	535	16	17	80	0.2125000
NODE_9156_length_890_cov_16.831858	455	535	17	20	80	0.2500000
NODE_9156_length_890_cov_16.831858	455	535	18	19	80	0.2375000
NODE_9157_length_890_cov_11.881163	222	302	1	26	80	0.3250000
NODE_9157_length_890_cov_11.881163	222	302	2	10	80	0.1250000
NODE_9157_length_890_cov_11.881163	222	302	3	15	80	0.1875000
NODE_9157_length_890_cov_11.881163	222	302	4	21	80	0.2625000
NODE_9157_length_890_cov_11.881163	222	302	5	8	80	0.1000000
NODE_9157_length_890_cov_11.881163	275	355	4	58	80	0.7250000
NODE_9157_length_890_cov_11.881163	275	355	5	22	80	0.2750000
NODE_9158_length_890_cov_8.676359	335	415	0	80	80	1.0000000
NODE_9158_length_890_cov_8.676359	388	468	0	80	80	1.0000000
NODE_9183_length_889_cov_61.520253	334	414	0	7	80	0.0875000
NODE_9183_length_889_cov_61.520253	334	414	1	8	80	0.1000000
NODE_9183_length_889_cov_61.520253	334	414	3	8	80	0.1000000
NODE_9183_length_889_cov_61.520253	334	414	4	15	80	0.1875000
NODE_9183_length_889_cov_61.520253	334	414	5	42	80	0.5250000
NODE_9183_length_889_cov_61.520253	387	467	5	80	80	1.0000000
NODE_9183_length_889_cov_61.520253	463	543	2	21	80	0.2625000
NODE_9183_length_889_cov_61.520253	463	543	3	15	80	0.1875000
NODE_9183_length_889_cov_61.520253	463	543	4	16	80	0.2000000
NODE_9183_length_889_cov_61.520253	463	543	5	25	80	0.3125000
NODE_9183_length_889_cov_61.520253	463	543	7	3	80	0.0375000
NODE_9183_length_889_cov_61.520253	516	596	2	25	80	0.3125000
NODE_9183_length_889_cov_61.520253	516	596	3	23	80	0.2875000
NODE_9183_length_889_cov_61.520253	516	596	4	32	80	0.4000000
NODE_9184_length_889_cov_30.012658	311	391	3	9	80	0.1125000
NODE_9184_length_889_cov_30.012658	311	391	4	28	80	0.3500000
NODE_9184_length_889_cov_30.012658	311	391	5	3	80	0.0375000
NODE_9184_length_889_cov_30.012658	311	391	6	20	80	0.2500000
NODE_9184_length_889_cov_30.012658	311	391	7	20	80	0.2500000
NODE_9184_length_889_cov_30.012658	364	444	5	27	80	0.3375000
NODE_9184_length_889_cov_30.012658	364	444	6	39	80	0.4875000
NODE_9184_length_889_cov_30.012658	364	444	7	14	80	0.1750000
NODE_9185_length_889_cov_28.217722	413	483	0	70	70	1.0000000
NODE_9185_length_889_cov_28.217722	466	542	0	72	76	0.9473684
NODE_9185_length_889_cov_28.217722	466	542	1	4	76	0.0526316
NODE_9186_length_889_cov_27.924051	379	449	4	20	70	0.2857143
NODE_9186_length_889_cov_27.924051	379	449	5	47	70	0.6714286
NODE_9186_length_889_cov_27.924051	379	449	6	3	70	0.0428571
NODE_9186_length_889_cov_27.924051	432	512	1	15	80	0.1875000
NODE_9186_length_889_cov_27.924051	432	512	2	12	80	0.1500000
NODE_9186_length_889_cov_27.924051	432	512	3	2	80	0.0250000
NODE_9186_length_889_cov_27.924051	432	512	4	38	80	0.4750000
NODE_9186_length_889_cov_27.924051	432	512	5	10	80	0.1250000
NODE_9186_length_889_cov_27.924051	432	512	6	3	80	0.0375000
NODE_9187_length_889_cov_25.887342	227	285	7	5	58	0.0862069
NODE_9187_length_889_cov_25.887342	227	285	8	17	58	0.2931035
NODE_9187_length_889_cov_25.887342	227	285	9	1	58	0.0172414
NODE_9187_length_889_cov_25.887342	227	285	10	14	58	0.2413793
NODE_9187_length_889_cov_25.887342	227	285	12	21	58	0.3620690
NODE_9187_length_889_cov_25.887342	258	337	7	12	79	0.1518987
NODE_9187_length_889_cov_25.887342	258	337	8	32	79	0.4050633
NODE_9187_length_889_cov_25.887342	258	337	10	8	79	0.1012658
NODE_9187_length_889_cov_25.887342	258	337	12	27	79	0.3417721
NODE_9188_length_889_cov_22.992405	451	531	4	46	80	0.5750000
NODE_9188_length_889_cov_22.992405	451	531	5	34	80	0.4250000
NODE_9188_length_889_cov_22.992405	504	584	3	20	80	0.2500000
NODE_9188_length_889_cov_22.992405	504	584	4	43	80	0.5375000
NODE_9188_length_889_cov_22.992405	504	584	5	17	80	0.2125000
NODE_9189_length_889_cov_20.703797	331	411	2	80	80	1.0000000
NODE_9189_length_889_cov_20.703797	384	464	2	78	80	0.9750000
NODE_9189_length_889_cov_20.703797	384	464	3	2	80	0.0250000
NODE_9190_length_889_cov_20.226582	234	314	0	80	80	1.0000000
NODE_9190_length_889_cov_20.226582	287	367	0	80	80	1.0000000
NODE_9191_length_889_cov_15.587342	407	487	2	1	80	0.0125000
NODE_9191_length_889_cov_15.587342	407	487	3	2	80	0.0250000
NODE_9191_length_889_cov_15.587342	407	487	4	3	80	0.0375000
NODE_9191_length_889_cov_15.587342	407	487	5	23	80	0.2875000
NODE_9191_length_889_cov_15.587342	407	487	6	51	80	0.6375000
NODE_9191_length_889_cov_15.587342	460	540	6	61	80	0.7625000
NODE_9191_length_889_cov_15.587342	460	540	8	12	80	0.1500000
NODE_9191_length_889_cov_15.587342	460	540	9	3	80	0.0375000
NODE_9191_length_889_cov_15.587342	460	540	10	4	80	0.0500000
NODE_9192_length_889_cov_12.669620	313	393	1	60	80	0.7500000
NODE_9192_length_889_cov_12.669620	313	393	2	20	80	0.2500000
NODE_9192_length_889_cov_12.669620	366	446	1	67	80	0.8375000
NODE_9192_length_889_cov_12.669620	366	446	2	13	80	0.1625000
NODE_9193_length_889_cov_12.198734	399	479	0	80	80	1.0000000
NODE_9193_length_889_cov_12.198734	452	532	0	80	80	1.0000000
NODE_9197_length_889_cov_3.841772	187	267	0	80	80	1.0000000
NODE_9197_length_889_cov_3.841772	240	320	0	80	80	1.0000000
NODE_9213_length_888_cov_37.102662	490	570	7	1	80	0.0125000
NODE_9213_length_888_cov_37.102662	490	570	8	8	80	0.1000000
NODE_9213_length_888_cov_37.102662	490	570	9	13	80	0.1625000
NODE_9213_length_888_cov_37.102662	490	570	10	48	80	0.6000000
NODE_9213_length_888_cov_37.102662	490	570	12	10	80	0.1250000
NODE_9213_length_888_cov_37.102662	543	623	5	4	80	0.0500000
NODE_9213_length_888_cov_37.102662	543	623	7	10	80	0.1250000
NODE_9213_length_888_cov_37.102662	543	623	9	2	80	0.0250000
NODE_9213_length_888_cov_37.102662	543	623	10	19	80	0.2375000
NODE_9213_length_888_cov_37.102662	543	623	11	14	80	0.1750000
NODE_9213_length_888_cov_37.102662	543	623	12	31	80	0.3875000
NODE_9214_length_888_cov_28.230672	366	446	0	35	80	0.4375000
NODE_9214_length_888_cov_28.230672	366	446	1	31	80	0.3875000
NODE_9214_length_888_cov_28.230672	366	446	2	6	80	0.0750000
NODE_9214_length_888_cov_28.230672	366	446	3	8	80	0.1000000
NODE_9214_length_888_cov_28.230672	419	499	1	18	80	0.2250000
NODE_9214_length_888_cov_28.230672	419	499	2	1	80	0.0125000
NODE_9214_length_888_cov_28.230672	419	499	3	28	80	0.3500000
NODE_9214_length_888_cov_28.230672	419	499	4	33	80	0.4125000
NODE_9215_length_888_cov_25.243346	391	471	0	80	80	1.0000000
NODE_9215_length_888_cov_25.243346	444	524	0	80	80	1.0000000
NODE_9216_length_888_cov_21.045627	236	316	0	11	80	0.1375000
NODE_9216_length_888_cov_21.045627	236	316	1	29	80	0.3625000
NODE_9216_length_888_cov_21.045627	236	316	2	40	80	0.5000000
NODE_9216_length_888_cov_21.045627	289	367	2	78	78	1.0000000
NODE_9218_length_888_cov_13.447402	515	595	2	8	80	0.1000000
NODE_9218_length_888_cov_13.447402	515	595	3	6	80	0.0750000
NODE_9218_length_888_cov_13.447402	515	595	4	66	80	0.8250000
NODE_9218_length_888_cov_13.447402	568	648	1	2	80	0.0250000
NODE_9218_length_888_cov_13.447402	568	648	2	6	80	0.0750000
NODE_9218_length_888_cov_13.447402	568	648	3	38	80	0.4750000
NODE_9218_length_888_cov_13.447402	568	648	4	34	80	0.4250000
NODE_9219_length_888_cov_12.806084	179	259	2	14	80	0.1750000
NODE_9219_length_888_cov_12.806084	179	259	3	19	80	0.2375000
NODE_9219_length_888_cov_12.806084	179	259	4	9	80	0.1125000
NODE_9219_length_888_cov_12.806084	179	259	5	35	80	0.4375000
NODE_9219_length_888_cov_12.806084	179	259	6	3	80	0.0375000
NODE_9219_length_888_cov_12.806084	232	312	5	24	80	0.3000000
NODE_9219_length_888_cov_12.806084	232	312	6	56	80	0.7000000
NODE_9219_length_888_cov_12.806084	308	388	3	11	80	0.1375000
NODE_9219_length_888_cov_12.806084	308	388	4	30	80	0.3750000
NODE_9219_length_888_cov_12.806084	308	388	5	18	80	0.2250000
NODE_9219_length_888_cov_12.806084	308	388	6	13	80	0.1625000
NODE_9219_length_888_cov_12.806084	308	388	7	8	80	0.1000000
NODE_9219_length_888_cov_12.806084	361	441	2	33	80	0.4125000
NODE_9219_length_888_cov_12.806084	361	441	3	31	80	0.3875000
NODE_9219_length_888_cov_12.806084	361	441	4	15	80	0.1875000
NODE_9219_length_888_cov_12.806084	361	441	5	1	80	0.0125000
NODE_9220_length_888_cov_12.551331	365	445	6	64	80	0.8000000
NODE_9220_length_888_cov_12.551331	365	445	8	16	80	0.2000000
NODE_9220_length_888_cov_12.551331	418	498	2	36	80	0.4500000
NODE_9220_length_888_cov_12.551331	418	498	4	1	80	0.0125000
NODE_9220_length_888_cov_12.551331	418	498	6	33	80	0.4125000
NODE_9220_length_888_cov_12.551331	418	498	8	10	80	0.1250000
NODE_9228_length_888_cov_2.041825	42	102	0	60	60	1.0000000
NODE_9237_length_887_cov_32.927665	514	594	0	80	80	1.0000000
NODE_9237_length_887_cov_32.927665	567	647	0	80	80	1.0000000
NODE_9238_length_887_cov_26.920051	358	438	0	5	80	0.0625000
NODE_9238_length_887_cov_26.920051	358	438	1	75	80	0.9375000
NODE_9238_length_887_cov_26.920051	411	491	1	80	80	1.0000000
NODE_9239_length_887_cov_20.714467	304	384	0	4	80	0.0500000
NODE_9239_length_887_cov_20.714467	304	384	1	9	80	0.1125000
NODE_9239_length_887_cov_20.714467	304	384	2	55	80	0.6875000
NODE_9239_length_887_cov_20.714467	304	384	3	12	80	0.1500000
NODE_9239_length_887_cov_20.714467	357	433	2	15	76	0.1973684
NODE_9239_length_887_cov_20.714467	357	433	3	61	76	0.8026316
NODE_9240_length_887_cov_19.771574	407	487	4	80	80	1.0000000
NODE_9240_length_887_cov_19.771574	460	540	1	5	80	0.0625000
NODE_9240_length_887_cov_19.771574	460	540	2	1	80	0.0125000
NODE_9240_length_887_cov_19.771574	460	540	3	16	80	0.2000000
NODE_9240_length_887_cov_19.771574	460	540	4	58	80	0.7250000
NODE_9241_length_887_cov_14.535533	333	413	2	7	80	0.0875000
NODE_9241_length_887_cov_14.535533	333	413	3	11	80	0.1375000
NODE_9241_length_887_cov_14.535533	333	413	4	34	80	0.4250000
NODE_9241_length_887_cov_14.535533	333	413	5	28	80	0.3500000
NODE_9241_length_887_cov_14.535533	386	466	0	37	80	0.4625000
NODE_9241_length_887_cov_14.535533	386	466	2	23	80	0.2875000
NODE_9241_length_887_cov_14.535533	386	466	3	11	80	0.1375000
NODE_9241_length_887_cov_14.535533	386	466	4	9	80	0.1125000
NODE_9242_length_887_cov_14.114213	345	425	0	80	80	1.0000000
NODE_9242_length_887_cov_14.114213	398	478	0	80	80	1.0000000
NODE_9243_length_887_cov_9.451777	406	486	1	80	80	1.0000000
NODE_9243_length_887_cov_9.451777	459	539	0	35	80	0.4375000
NODE_9243_length_887_cov_9.451777	459	539	1	45	80	0.5625000
NODE_9245_length_887_cov_6.656091	473	553	0	9	80	0.1125000
NODE_9245_length_887_cov_6.656091	473	553	1	20	80	0.2500000
NODE_9245_length_887_cov_6.656091	473	553	2	51	80	0.6375000
NODE_9245_length_887_cov_6.656091	526	606	2	80	80	1.0000000
NODE_9246_length_887_cov_4.719543	420	500	2	80	80	1.0000000
NODE_9246_length_887_cov_4.719543	473	553	2	80	80	1.0000000
NODE_9250_length_887_cov_2.583756	385	429	0	4	44	0.0909091
NODE_9250_length_887_cov_2.583756	385	429	2	4	44	0.0909091
NODE_9250_length_887_cov_2.583756	385	429	3	36	44	0.8181818
NODE_9250_length_887_cov_2.583756	393	428	0	3	35	0.0857143
NODE_9250_length_887_cov_2.583756	393	428	2	4	35	0.1142857
NODE_9250_length_887_cov_2.583756	393	428	3	28	35	0.8000000
NODE_9261_length_887_cov_1.087563	754	829	0	75	75	1.0000000
NODE_9264_length_886_cov_35.482846	365	445	5	2	80	0.0250000
NODE_9264_length_886_cov_35.482846	365	445	7	26	80	0.3250000
NODE_9264_length_886_cov_35.482846	365	445	8	1	80	0.0125000
NODE_9264_length_886_cov_35.482846	365	445	9	34	80	0.4250000
NODE_9264_length_886_cov_35.482846	365	445	11	4	80	0.0500000
NODE_9264_length_886_cov_35.482846	365	445	12	13	80	0.1625000
NODE_9264_length_886_cov_35.482846	418	498	6	14	80	0.1750000
NODE_9264_length_886_cov_35.482846	418	498	7	5	80	0.0625000
NODE_9264_length_886_cov_35.482846	418	498	8	16	80	0.2000000
NODE_9264_length_886_cov_35.482846	418	498	9	11	80	0.1375000
NODE_9264_length_886_cov_35.482846	418	498	10	12	80	0.1500000
NODE_9264_length_886_cov_35.482846	418	498	11	6	80	0.0750000
NODE_9264_length_886_cov_35.482846	418	498	12	16	80	0.2000000
NODE_9265_length_886_cov_31.939009	438	518	0	28	80	0.3500000
NODE_9265_length_886_cov_31.939009	438	518	2	11	80	0.1375000
NODE_9265_length_886_cov_31.939009	438	518	3	23	80	0.2875000
NODE_9265_length_886_cov_31.939009	438	518	4	18	80	0.2250000
NODE_9265_length_886_cov_31.939009	491	571	2	64	80	0.8000000
NODE_9265_length_886_cov_31.939009	491	571	4	16	80	0.2000000
NODE_9266_length_886_cov_25.301144	326	406	2	15	80	0.1875000
NODE_9266_length_886_cov_25.301144	326	406	3	3	80	0.0375000
NODE_9266_length_886_cov_25.301144	326	406	5	2	80	0.0250000
NODE_9266_length_886_cov_25.301144	326	406	7	33	80	0.4125000
NODE_9266_length_886_cov_25.301144	326	406	9	8	80	0.1000000
NODE_9266_length_886_cov_25.301144	326	406	10	19	80	0.2375000
NODE_9266_length_886_cov_25.301144	326	406	2	15	80	0.1875000
NODE_9266_length_886_cov_25.301144	326	406	3	3	80	0.0375000
NODE_9266_length_886_cov_25.301144	326	406	5	2	80	0.0250000
NODE_9266_length_886_cov_25.301144	326	406	7	33	80	0.4125000
NODE_9266_length_886_cov_25.301144	326	406	9	8	80	0.1000000
NODE_9266_length_886_cov_25.301144	326	406	10	19	80	0.2375000
NODE_9266_length_886_cov_25.301144	379	459	6	3	80	0.0375000
NODE_9266_length_886_cov_25.301144	379	459	8	23	80	0.2875000
NODE_9266_length_886_cov_25.301144	379	459	9	8	80	0.1000000
NODE_9266_length_886_cov_25.301144	379	459	10	46	80	0.5750000
NODE_9266_length_886_cov_25.301144	379	459	6	3	80	0.0375000
NODE_9266_length_886_cov_25.301144	379	459	8	23	80	0.2875000
NODE_9266_length_886_cov_25.301144	379	459	9	8	80	0.1000000
NODE_9266_length_886_cov_25.301144	379	459	10	46	80	0.5750000
NODE_9267_length_886_cov_14.463787	327	407	3	6	80	0.0750000
NODE_9267_length_886_cov_14.463787	327	407	5	71	80	0.8875000
NODE_9267_length_886_cov_14.463787	327	407	6	3	80	0.0375000
NODE_9267_length_886_cov_14.463787	380	460	0	39	80	0.4875000
NODE_9267_length_886_cov_14.463787	380	460	1	8	80	0.1000000
NODE_9267_length_886_cov_14.463787	380	460	3	12	80	0.1500000
NODE_9267_length_886_cov_14.463787	380	460	5	21	80	0.2625000
NODE_9286_length_885_cov_35.510178	373	453	2	49	80	0.6125000
NODE_9286_length_885_cov_35.510178	373	453	3	26	80	0.3250000
NODE_9286_length_885_cov_35.510178	373	453	4	5	80	0.0625000
NODE_9286_length_885_cov_35.510178	426	506	2	80	80	1.0000000
NODE_9287_length_885_cov_31.857506	368	448	3	16	80	0.2000000
NODE_9287_length_885_cov_31.857506	368	448	4	63	80	0.7875000
NODE_9287_length_885_cov_31.857506	368	448	5	1	80	0.0125000
NODE_9287_length_885_cov_31.857506	421	501	2	16	80	0.2000000
NODE_9287_length_885_cov_31.857506	421	501	3	37	80	0.4625000
NODE_9287_length_885_cov_31.857506	421	501	4	27	80	0.3375000
NODE_9288_length_885_cov_31.195929	395	475	2	71	80	0.8875000
NODE_9288_length_885_cov_31.195929	395	475	3	9	80	0.1125000
NODE_9288_length_885_cov_31.195929	448	528	1	24	80	0.3000000
NODE_9288_length_885_cov_31.195929	448	528	2	56	80	0.7000000
NODE_9289_length_885_cov_23.735369	356	436	0	20	80	0.2500000
NODE_9289_length_885_cov_23.735369	356	436	1	60	80	0.7500000
NODE_9289_length_885_cov_23.735369	409	489	1	80	80	1.0000000
NODE_9289_length_885_cov_23.735369	485	565	0	38	80	0.4750000
NODE_9289_length_885_cov_23.735369	485	565	1	42	80	0.5250000
NODE_9289_length_885_cov_23.735369	538	618	0	80	80	1.0000000
NODE_9290_length_885_cov_22.174300	340	420	0	80	80	1.0000000
NODE_9290_length_885_cov_22.174300	393	473	0	80	80	1.0000000
NODE_9290_length_885_cov_22.174300	469	549	0	4	80	0.0500000
NODE_9290_length_885_cov_22.174300	469	549	2	76	80	0.9500000
NODE_9290_length_885_cov_22.174300	522	602	0	21	80	0.2625000
NODE_9290_length_885_cov_22.174300	522	602	2	59	80	0.7375000
NODE_9291_length_885_cov_17.852417	413	493	2	80	80	1.0000000
NODE_9291_length_885_cov_17.852417	466	546	0	18	80	0.2250000
NODE_9291_length_885_cov_17.852417	466	546	2	62	80	0.7750000
NODE_9292_length_885_cov_15.652672	346	426	0	80	80	1.0000000
NODE_9292_length_885_cov_15.652672	399	479	0	80	80	1.0000000
NODE_9292_length_885_cov_15.652672	475	555	0	80	80	1.0000000
NODE_9292_length_885_cov_15.652672	528	608	0	80	80	1.0000000
NODE_9293_length_885_cov_11.648855	530	610	2	80	80	1.0000000
NODE_9293_length_885_cov_11.648855	583	663	0	41	80	0.5125000
NODE_9293_length_885_cov_11.648855	583	663	2	39	80	0.4875000
NODE_9294_length_885_cov_9.707379	611	691	0	22	80	0.2750000
NODE_9294_length_885_cov_9.707379	611	691	1	58	80	0.7250000
NODE_9294_length_885_cov_9.707379	664	744	0	75	80	0.9375000
NODE_9294_length_885_cov_9.707379	664	744	1	5	80	0.0625000
NODE_9311_length_884_cov_73.050955	536	616	4	59	80	0.7375000
NODE_9311_length_884_cov_73.050955	536	616	5	16	80	0.2000000
NODE_9311_length_884_cov_73.050955	536	616	6	5	80	0.0625000
NODE_9311_length_884_cov_73.050955	589	669	1	9	80	0.1125000
NODE_9311_length_884_cov_73.050955	589	669	2	18	80	0.2250000
NODE_9311_length_884_cov_73.050955	589	669	3	25	80	0.3125000
NODE_9311_length_884_cov_73.050955	589	669	4	28	80	0.3500000
NODE_9312_length_884_cov_28.373248	381	461	6	12	80	0.1500000
NODE_9312_length_884_cov_28.373248	381	461	8	23	80	0.2875000
NODE_9312_length_884_cov_28.373248	381	461	10	6	80	0.0750000
NODE_9312_length_884_cov_28.373248	381	461	11	6	80	0.0750000
NODE_9312_length_884_cov_28.373248	381	461	12	33	80	0.4125000
NODE_9312_length_884_cov_28.373248	434	514	4	6	80	0.0750000
NODE_9312_length_884_cov_28.373248	434	514	5	9	80	0.1125000
NODE_9312_length_884_cov_28.373248	434	514	6	1	80	0.0125000
NODE_9312_length_884_cov_28.373248	434	514	8	25	80	0.3125000
NODE_9312_length_884_cov_28.373248	434	514	10	14	80	0.1750000
NODE_9312_length_884_cov_28.373248	434	514	12	25	80	0.3125000
NODE_9313_length_884_cov_20.649682	463	543	2	80	80	1.0000000
NODE_9313_length_884_cov_20.649682	516	596	1	2	80	0.0250000
NODE_9313_length_884_cov_20.649682	516	596	2	78	80	0.9750000
NODE_9314_length_884_cov_13.391083	225	305	4	80	80	1.0000000
NODE_9314_length_884_cov_13.391083	278	358	0	16	80	0.2000000
NODE_9314_length_884_cov_13.391083	278	358	2	17	80	0.2125000
NODE_9314_length_884_cov_13.391083	278	358	4	47	80	0.5875000
NODE_9315_length_884_cov_9.192357	278	358	0	2	80	0.0250000
NODE_9315_length_884_cov_9.192357	278	358	2	78	80	0.9750000
NODE_9315_length_884_cov_9.192357	331	411	2	80	80	1.0000000
NODE_9315_length_884_cov_9.192357	407	487	0	75	80	0.9375000
NODE_9315_length_884_cov_9.192357	407	487	2	5	80	0.0625000
NODE_9315_length_884_cov_9.192357	460	540	0	80	80	1.0000000
NODE_9335_length_883_cov_46.780612	344	424	6	12	80	0.1500000
NODE_9335_length_883_cov_46.780612	344	424	8	21	80	0.2625000
NODE_9335_length_883_cov_46.780612	344	424	10	27	80	0.3375000
NODE_9335_length_883_cov_46.780612	344	424	11	20	80	0.2500000
NODE_9335_length_883_cov_46.780612	397	477	1	36	80	0.4500000
NODE_9335_length_883_cov_46.780612	397	477	3	9	80	0.1125000
NODE_9335_length_883_cov_46.780612	397	477	5	2	80	0.0250000
NODE_9335_length_883_cov_46.780612	397	477	6	18	80	0.2250000
NODE_9335_length_883_cov_46.780612	397	477	8	15	80	0.1875000
NODE_9336_length_883_cov_46.304847	387	467	1	46	80	0.5750000
NODE_9336_length_883_cov_46.304847	387	467	2	27	80	0.3375000
NODE_9336_length_883_cov_46.304847	387	467	3	1	80	0.0125000
NODE_9336_length_883_cov_46.304847	387	467	4	6	80	0.0750000
NODE_9336_length_883_cov_46.304847	440	520	1	2	80	0.0250000
NODE_9336_length_883_cov_46.304847	440	520	2	19	80	0.2375000
NODE_9336_length_883_cov_46.304847	440	520	4	42	80	0.5250000
NODE_9336_length_883_cov_46.304847	440	520	5	17	80	0.2125000
NODE_9337_length_883_cov_39.579082	410	490	2	79	80	0.9875000
NODE_9337_length_883_cov_39.579082	410	490	3	1	80	0.0125000
NODE_9337_length_883_cov_39.579082	463	543	1	11	80	0.1375000
NODE_9337_length_883_cov_39.579082	463	543	2	69	80	0.8625000
NODE_9338_length_883_cov_28.307398	379	459	0	26	80	0.3250000
NODE_9338_length_883_cov_28.307398	379	459	1	54	80	0.6750000
NODE_9338_length_883_cov_28.307398	432	512	0	79	80	0.9875000
NODE_9338_length_883_cov_28.307398	432	512	1	1	80	0.0125000
NODE_9339_length_883_cov_24.927296	429	509	0	15	80	0.1875000
NODE_9339_length_883_cov_24.927296	429	509	1	65	80	0.8125000
NODE_9339_length_883_cov_24.927296	482	562	1	80	80	1.0000000
NODE_9341_length_883_cov_17.445153	326	406	1	18	80	0.2250000
NODE_9341_length_883_cov_17.445153	326	406	2	4	80	0.0500000
NODE_9341_length_883_cov_17.445153	326	406	3	14	80	0.1750000
NODE_9341_length_883_cov_17.445153	326	406	5	15	80	0.1875000
NODE_9341_length_883_cov_17.445153	326	406	7	29	80	0.3625000
NODE_9341_length_883_cov_17.445153	379	459	7	40	80	0.5000000
NODE_9341_length_883_cov_17.445153	379	459	8	40	80	0.5000000
NODE_9342_length_883_cov_14.660714	319	395	1	7	76	0.0921053
NODE_9342_length_883_cov_14.660714	319	395	2	35	76	0.4605263
NODE_9342_length_883_cov_14.660714	319	395	4	7	76	0.0921053
NODE_9342_length_883_cov_14.660714	319	395	5	27	76	0.3552631
NODE_9342_length_883_cov_14.660714	740	816	0	76	76	1.0000000
NODE_9343_length_883_cov_11.052296	223	303	4	11	80	0.1375000
NODE_9343_length_883_cov_11.052296	223	303	5	69	80	0.8625000
NODE_9343_length_883_cov_11.052296	276	356	3	21	80	0.2625000
NODE_9343_length_883_cov_11.052296	276	356	4	15	80	0.1875000
NODE_9343_length_883_cov_11.052296	276	356	5	44	80	0.5500000
NODE_9344_length_883_cov_6.873724	0	66	0	13	66	0.1969697
NODE_9344_length_883_cov_6.873724	0	66	2	53	66	0.8030303
NODE_9345_length_883_cov_3.873724	471	551	0	80	80	1.0000000
NODE_9345_length_883_cov_3.873724	524	604	0	80	80	1.0000000
NODE_9346_length_883_cov_3.247449	294	374	0	80	80	1.0000000
NODE_9346_length_883_cov_3.247449	347	427	0	80	80	1.0000000
NODE_9370_length_882_cov_24.241379	438	518	9	6	80	0.0750000
NODE_9370_length_882_cov_24.241379	438	518	10	2	80	0.0250000
NODE_9370_length_882_cov_24.241379	438	518	11	1	80	0.0125000
NODE_9370_length_882_cov_24.241379	438	518	12	11	80	0.1375000
NODE_9370_length_882_cov_24.241379	438	518	13	15	80	0.1875000
NODE_9370_length_882_cov_24.241379	438	518	14	19	80	0.2375000
NODE_9370_length_882_cov_24.241379	438	518	15	3	80	0.0375000
NODE_9370_length_882_cov_24.241379	438	518	16	23	80	0.2875000
NODE_9370_length_882_cov_24.241379	491	571	10	17	80	0.2125000
NODE_9370_length_882_cov_24.241379	491	571	11	24	80	0.3000000
NODE_9370_length_882_cov_24.241379	491	571	12	4	80	0.0500000
NODE_9370_length_882_cov_24.241379	491	571	13	3	80	0.0375000
NODE_9370_length_882_cov_24.241379	491	571	14	11	80	0.1375000
NODE_9370_length_882_cov_24.241379	491	571	16	21	80	0.2625000
NODE_9371_length_882_cov_23.145594	355	435	0	80	80	1.0000000
NODE_9371_length_882_cov_23.145594	408	488	0	80	80	1.0000000
NODE_9372_length_882_cov_21.401022	335	415	4	24	80	0.3000000
NODE_9372_length_882_cov_21.401022	335	415	6	56	80	0.7000000
NODE_9372_length_882_cov_21.401022	388	468	2	44	80	0.5500000
NODE_9372_length_882_cov_21.401022	388	468	4	7	80	0.0875000
NODE_9372_length_882_cov_21.401022	388	468	6	29	80	0.3625000
NODE_9373_length_882_cov_19.579821	456	511	4	41	55	0.7454545
NODE_9373_length_882_cov_19.579821	456	511	5	14	55	0.2545455
NODE_9373_length_882_cov_19.579821	506	586	2	19	80	0.2375000
NODE_9373_length_882_cov_19.579821	506	586	4	20	80	0.2500000
NODE_9373_length_882_cov_19.579821	506	586	5	28	80	0.3500000
NODE_9373_length_882_cov_19.579821	506	586	6	13	80	0.1625000
NODE_9373_length_882_cov_19.579821	559	639	2	72	80	0.9000000
NODE_9373_length_882_cov_19.579821	559	639	4	8	80	0.1000000
NODE_9374_length_882_cov_19.342273	298	378	0	80	80	1.0000000
NODE_9374_length_882_cov_19.342273	351	431	0	80	80	1.0000000
NODE_9374_length_882_cov_19.342273	427	508	0	33	81	0.4074074
NODE_9374_length_882_cov_19.342273	427	508	2	48	81	0.5925926
NODE_9374_length_882_cov_19.342273	481	561	0	21	80	0.2625000
NODE_9374_length_882_cov_19.342273	481	561	2	59	80	0.7375000
NODE_9375_length_882_cov_11.873563	267	347	1	80	80	1.0000000
NODE_9375_length_882_cov_11.873563	320	400	1	80	80	1.0000000
NODE_9376_length_882_cov_8.794381	430	510	0	35	80	0.4375000
NODE_9376_length_882_cov_8.794381	430	510	2	45	80	0.5625000
NODE_9376_length_882_cov_8.794381	483	563	2	41	80	0.5125000
NODE_9376_length_882_cov_8.794381	483	563	3	1	80	0.0125000
NODE_9376_length_882_cov_8.794381	483	563	4	38	80	0.4750000
NODE_9377_length_882_cov_7.537676	527	608	1	37	81	0.4567901
NODE_9377_length_882_cov_7.537676	527	608	2	44	81	0.5432099
NODE_9379_length_882_cov_6.696041	355	435	1	60	80	0.7500000
NODE_9379_length_882_cov_6.696041	355	435	2	20	80	0.2500000
NODE_9379_length_882_cov_6.696041	408	488	0	3	80	0.0375000
NODE_9379_length_882_cov_6.696041	408	488	1	77	80	0.9625000
NODE_9380_length_882_cov_4.734355	585	665	0	31	80	0.3875000
NODE_9380_length_882_cov_4.734355	585	665	2	49	80	0.6125000
NODE_9380_length_882_cov_4.734355	638	718	0	7	80	0.0875000
NODE_9380_length_882_cov_4.734355	638	718	2	73	80	0.9125000
NODE_9398_length_881_cov_32.875959	444	524	0	13	80	0.1625000
NODE_9398_length_881_cov_32.875959	444	524	1	6	80	0.0750000
NODE_9398_length_881_cov_32.875959	444	524	2	61	80	0.7625000
NODE_9398_length_881_cov_32.875959	497	577	1	5	80	0.0625000
NODE_9398_length_881_cov_32.875959	497	577	2	33	80	0.4125000
NODE_9398_length_881_cov_32.875959	497	577	3	42	80	0.5250000
NODE_9399_length_881_cov_25.750639	43	117	8	6	74	0.0810811
NODE_9399_length_881_cov_25.750639	43	117	9	10	74	0.1351351
NODE_9399_length_881_cov_25.750639	43	117	11	20	74	0.2702703
NODE_9399_length_881_cov_25.750639	43	117	15	3	74	0.0405405
NODE_9399_length_881_cov_25.750639	43	117	16	20	74	0.2702703
NODE_9399_length_881_cov_25.750639	43	117	18	7	74	0.0945946
NODE_9399_length_881_cov_25.750639	43	117	19	8	74	0.1081081
NODE_9399_length_881_cov_25.750639	116	193	11	1	77	0.0129870
NODE_9399_length_881_cov_25.750639	116	193	12	7	77	0.0909091
NODE_9399_length_881_cov_25.750639	116	193	15	5	77	0.0649351
NODE_9399_length_881_cov_25.750639	116	193	16	7	77	0.0909091
NODE_9399_length_881_cov_25.750639	116	193	17	12	77	0.1558442
NODE_9399_length_881_cov_25.750639	116	193	19	14	77	0.1818182
NODE_9399_length_881_cov_25.750639	116	193	20	19	77	0.2467532
NODE_9399_length_881_cov_25.750639	116	193	21	12	77	0.1558442
NODE_9400_length_881_cov_23.897698	286	365	0	39	79	0.4936709
NODE_9400_length_881_cov_23.897698	286	365	2	40	79	0.5063291
NODE_9400_length_881_cov_23.897698	338	418	0	43	80	0.5375000
NODE_9400_length_881_cov_23.897698	338	418	2	37	80	0.4625000
NODE_9401_length_881_cov_20.656010	359	439	0	80	80	1.0000000
NODE_9401_length_881_cov_20.656010	412	492	0	80	80	1.0000000
NODE_9402_length_881_cov_20.340153	242	322	0	80	80	1.0000000
NODE_9402_length_881_cov_20.340153	295	375	0	80	80	1.0000000
NODE_9403_length_881_cov_18.234015	420	500	1	68	80	0.8500000
NODE_9403_length_881_cov_18.234015	420	500	2	12	80	0.1500000
NODE_9403_length_881_cov_18.234015	473	553	0	50	80	0.6250000
NODE_9403_length_881_cov_18.234015	473	553	1	30	80	0.3750000
NODE_9404_length_881_cov_17.748082	291	371	2	2	80	0.0250000
NODE_9404_length_881_cov_17.748082	291	371	3	78	80	0.9750000
NODE_9404_length_881_cov_17.748082	344	424	2	55	80	0.6875000
NODE_9404_length_881_cov_17.748082	344	424	3	25	80	0.3125000
NODE_9405_length_881_cov_12.884910	332	412	1	29	80	0.3625000
NODE_9405_length_881_cov_12.884910	332	412	2	51	80	0.6375000
NODE_9405_length_881_cov_12.884910	385	465	0	11	80	0.1375000
NODE_9405_length_881_cov_12.884910	385	465	1	69	80	0.8625000
NODE_9406_length_881_cov_6.473146	474	553	2	20	79	0.2531646
NODE_9406_length_881_cov_6.473146	474	553	3	2	79	0.0253165
NODE_9406_length_881_cov_6.473146	474	553	4	28	79	0.3544304
NODE_9406_length_881_cov_6.473146	474	553	5	29	79	0.3670886
NODE_9406_length_881_cov_6.473146	514	594	4	14	80	0.1750000
NODE_9406_length_881_cov_6.473146	514	594	5	38	80	0.4750000
NODE_9406_length_881_cov_6.473146	514	594	6	6	80	0.0750000
NODE_9406_length_881_cov_6.473146	514	594	7	22	80	0.2750000
NODE_9406_length_881_cov_6.473146	526	565	4	2	39	0.0512821
NODE_9406_length_881_cov_6.473146	526	565	5	32	39	0.8205128
NODE_9406_length_881_cov_6.473146	526	565	6	5	39	0.1282051
NODE_9406_length_881_cov_6.473146	555	606	5	23	51	0.4509804
NODE_9406_length_881_cov_6.473146	555	606	6	6	51	0.1176471
NODE_9406_length_881_cov_6.473146	555	606	7	22	51	0.4313726
NODE_9406_length_881_cov_6.473146	567	647	4	2	80	0.0250000
NODE_9406_length_881_cov_6.473146	567	647	5	56	80	0.7000000
NODE_9406_length_881_cov_6.473146	567	647	7	22	80	0.2750000
NODE_9407_length_881_cov_5.615090	547	627	1	80	80	1.0000000
NODE_9407_length_881_cov_5.615090	600	680	0	30	80	0.3750000
NODE_9407_length_881_cov_5.615090	600	680	1	50	80	0.6250000
NODE_9424_length_880_cov_26.663252	320	400	4	64	80	0.8000000
NODE_9424_length_880_cov_26.663252	320	400	5	16	80	0.2000000
NODE_9424_length_880_cov_26.663252	373	453	1	24	80	0.3000000
NODE_9424_length_880_cov_26.663252	373	453	4	56	80	0.7000000
NODE_9425_length_880_cov_21.828425	328	408	4	18	80	0.2250000
NODE_9425_length_880_cov_21.828425	328	408	5	22	80	0.2750000
NODE_9425_length_880_cov_21.828425	328	408	7	15	80	0.1875000
NODE_9425_length_880_cov_21.828425	328	408	8	25	80	0.3125000
NODE_9425_length_880_cov_21.828425	381	461	6	22	80	0.2750000
NODE_9425_length_880_cov_21.828425	381	461	7	22	80	0.2750000
NODE_9425_length_880_cov_21.828425	381	461	8	36	80	0.4500000
NODE_9426_length_880_cov_20.245839	427	507	0	15	80	0.1875000
NODE_9426_length_880_cov_20.245839	427	507	1	61	80	0.7625000
NODE_9426_length_880_cov_20.245839	427	507	2	4	80	0.0500000
NODE_9426_length_880_cov_20.245839	480	560	0	68	80	0.8500000
NODE_9426_length_880_cov_20.245839	480	560	1	12	80	0.1500000
NODE_9427_length_880_cov_19.434059	0	69	0	69	69	1.0000000
NODE_9428_length_880_cov_11.843790	363	430	0	3	67	0.0447761
NODE_9428_length_880_cov_11.843790	363	430	1	16	67	0.2388060
NODE_9428_length_880_cov_11.843790	363	430	2	48	67	0.7164179
NODE_9429_length_880_cov_11.544174	185	265	0	80	80	1.0000000
NODE_9429_length_880_cov_11.544174	238	318	0	80	80	1.0000000
NODE_9430_length_880_cov_10.956466	354	434	3	9	80	0.1125000
NODE_9430_length_880_cov_10.956466	354	434	4	52	80	0.6500000
NODE_9430_length_880_cov_10.956466	354	434	5	19	80	0.2375000
NODE_9430_length_880_cov_10.956466	407	487	4	8	80	0.1000000
NODE_9430_length_880_cov_10.956466	407	487	5	48	80	0.6000000
NODE_9430_length_880_cov_10.956466	407	487	6	24	80	0.3000000
NODE_9431_length_880_cov_10.008963	395	474	1	43	79	0.5443038
NODE_9431_length_880_cov_10.008963	395	474	3	34	79	0.4303797
NODE_9431_length_880_cov_10.008963	395	474	4	2	79	0.0253165
NODE_9431_length_880_cov_10.008963	448	527	3	77	79	0.9746835
NODE_9431_length_880_cov_10.008963	448	527	4	2	79	0.0253165
NODE_9453_length_879_cov_23.565385	326	406	1	3	80	0.0375000
NODE_9453_length_879_cov_23.565385	326	406	2	51	80	0.6375000
NODE_9453_length_879_cov_23.565385	326	406	3	18	80	0.2250000
NODE_9453_length_879_cov_23.565385	326	406	4	6	80	0.0750000
NODE_9453_length_879_cov_23.565385	326	406	5	2	80	0.0250000
NODE_9453_length_879_cov_23.565385	379	459	2	1	80	0.0125000
NODE_9453_length_879_cov_23.565385	379	459	3	18	80	0.2250000
NODE_9453_length_879_cov_23.565385	379	459	4	6	80	0.0750000
NODE_9453_length_879_cov_23.565385	379	459	5	13	80	0.1625000
NODE_9453_length_879_cov_23.565385	379	459	6	42	80	0.5250000
NODE_9453_length_879_cov_23.565385	455	535	5	14	80	0.1750000
NODE_9453_length_879_cov_23.565385	455	535	6	63	80	0.7875000
NODE_9453_length_879_cov_23.565385	455	535	7	3	80	0.0375000
NODE_9453_length_879_cov_23.565385	508	586	2	19	78	0.2435897
NODE_9453_length_879_cov_23.565385	508	586	3	13	78	0.1666667
NODE_9453_length_879_cov_23.565385	508	586	4	6	78	0.0769231
NODE_9453_length_879_cov_23.565385	508	586	5	18	78	0.2307692
NODE_9453_length_879_cov_23.565385	508	586	6	22	78	0.2820513
NODE_9454_length_879_cov_20.758974	355	439	2	76	84	0.9047619
NODE_9454_length_879_cov_20.758974	355	439	4	8	84	0.0952381
NODE_9454_length_879_cov_20.758974	412	492	2	72	80	0.9000000
NODE_9454_length_879_cov_20.758974	412	492	4	8	80	0.1000000
NODE_9455_length_879_cov_19.685897	295	375	6	2	80	0.0250000
NODE_9455_length_879_cov_19.685897	295	375	7	12	80	0.1500000
NODE_9455_length_879_cov_19.685897	295	375	8	13	80	0.1625000
NODE_9455_length_879_cov_19.685897	295	375	10	2	80	0.0250000
NODE_9455_length_879_cov_19.685897	295	375	11	4	80	0.0500000
NODE_9455_length_879_cov_19.685897	295	375	12	31	80	0.3875000
NODE_9455_length_879_cov_19.685897	295	375	13	16	80	0.2000000
NODE_9455_length_879_cov_19.685897	348	428	9	11	80	0.1375000
NODE_9455_length_879_cov_19.685897	348	428	11	6	80	0.0750000
NODE_9455_length_879_cov_19.685897	348	428	12	46	80	0.5750000
NODE_9455_length_879_cov_19.685897	348	428	13	17	80	0.2125000
NODE_9456_length_879_cov_17.738462	413	488	6	62	75	0.8266667
NODE_9456_length_879_cov_17.738462	413	488	7	4	75	0.0533333
NODE_9456_length_879_cov_17.738462	413	488	8	9	75	0.1200000
NODE_9456_length_879_cov_17.738462	569	649	0	21	80	0.2625000
NODE_9456_length_879_cov_17.738462	569	649	1	55	80	0.6875000
NODE_9456_length_879_cov_17.738462	569	649	2	4	80	0.0500000
NODE_9456_length_879_cov_17.738462	569	649	0	21	80	0.2625000
NODE_9456_length_879_cov_17.738462	569	649	1	55	80	0.6875000
NODE_9456_length_879_cov_17.738462	569	649	2	4	80	0.0500000
NODE_9456_length_879_cov_17.738462	569	649	0	21	80	0.2625000
NODE_9456_length_879_cov_17.738462	569	649	1	55	80	0.6875000
NODE_9456_length_879_cov_17.738462	569	649	2	4	80	0.0500000
NODE_9456_length_879_cov_17.738462	622	676	1	54	54	1.0000000
NODE_9458_length_879_cov_10.756410	335	415	4	7	80	0.0875000
NODE_9458_length_879_cov_10.756410	335	415	5	28	80	0.3500000
NODE_9458_length_879_cov_10.756410	335	415	6	4	80	0.0500000
NODE_9458_length_879_cov_10.756410	335	415	7	1	80	0.0125000
NODE_9458_length_879_cov_10.756410	335	415	8	40	80	0.5000000
NODE_9458_length_879_cov_10.756410	388	468	5	26	80	0.3250000
NODE_9458_length_879_cov_10.756410	388	468	6	8	80	0.1000000
NODE_9458_length_879_cov_10.756410	388	468	7	8	80	0.1000000
NODE_9458_length_879_cov_10.756410	388	468	8	38	80	0.4750000
NODE_9459_length_879_cov_7.432051	234	314	3	36	80	0.4500000
NODE_9459_length_879_cov_7.432051	234	314	4	44	80	0.5500000
NODE_9459_length_879_cov_7.432051	288	367	2	1	79	0.0126582
NODE_9459_length_879_cov_7.432051	288	367	4	78	79	0.9873418
NODE_9473_length_878_cov_230.436457	415	495	4	1	80	0.0125000
NODE_9473_length_878_cov_230.436457	415	495	5	17	80	0.2125000
NODE_9473_length_878_cov_230.436457	415	495	6	27	80	0.3375000
NODE_9473_length_878_cov_230.436457	415	495	7	35	80	0.4375000
NODE_9473_length_878_cov_230.436457	468	548	3	2	80	0.0250000
NODE_9473_length_878_cov_230.436457	468	548	4	1	80	0.0125000
NODE_9473_length_878_cov_230.436457	468	548	5	20	80	0.2500000
NODE_9473_length_878_cov_230.436457	468	548	6	57	80	0.7125000
NODE_9474_length_878_cov_49.514763	410	490	3	6	80	0.0750000
NODE_9474_length_878_cov_49.514763	410	490	4	41	80	0.5125000
NODE_9474_length_878_cov_49.514763	410	490	5	1	80	0.0125000
NODE_9474_length_878_cov_49.514763	410	490	6	32	80	0.4000000
NODE_9474_length_878_cov_49.514763	463	543	5	20	80	0.2500000
NODE_9474_length_878_cov_49.514763	463	543	6	60	80	0.7500000
NODE_9475_length_878_cov_38.862644	365	445	0	41	80	0.5125000
NODE_9475_length_878_cov_38.862644	365	445	1	21	80	0.2625000
NODE_9475_length_878_cov_38.862644	365	445	2	18	80	0.2250000
NODE_9475_length_878_cov_38.862644	418	498	1	9	80	0.1125000
NODE_9475_length_878_cov_38.862644	418	498	2	71	80	0.8875000
NODE_9476_length_878_cov_36.517330	346	426	0	14	80	0.1750000
NODE_9476_length_878_cov_36.517330	346	426	2	66	80	0.8250000
NODE_9476_length_878_cov_36.517330	399	479	2	80	80	1.0000000
NODE_9476_length_878_cov_36.517330	475	555	0	48	80	0.6000000
NODE_9476_length_878_cov_36.517330	475	555	2	32	80	0.4000000
NODE_9476_length_878_cov_36.517330	528	608	0	80	80	1.0000000
NODE_9477_length_878_cov_34.404365	627	707	13	2	80	0.0250000
NODE_9477_length_878_cov_34.404365	627	707	14	4	80	0.0500000
NODE_9477_length_878_cov_34.404365	627	707	15	6	80	0.0750000
NODE_9477_length_878_cov_34.404365	627	707	16	14	80	0.1750000
NODE_9477_length_878_cov_34.404365	627	707	17	18	80	0.2250000
NODE_9477_length_878_cov_34.404365	627	707	18	28	80	0.3500000
NODE_9477_length_878_cov_34.404365	627	707	19	8	80	0.1000000
NODE_9477_length_878_cov_34.404365	627	695	13	2	68	0.0294118
NODE_9477_length_878_cov_34.404365	627	695	14	4	68	0.0588235
NODE_9477_length_878_cov_34.404365	627	695	15	3	68	0.0441176
NODE_9477_length_878_cov_34.404365	627	695	16	14	68	0.2058824
NODE_9477_length_878_cov_34.404365	627	695	17	15	68	0.2205882
NODE_9477_length_878_cov_34.404365	627	695	18	22	68	0.3235294
NODE_9477_length_878_cov_34.404365	627	695	19	8	68	0.1176471
NODE_9477_length_878_cov_34.404365	680	760	15	3	80	0.0375000
NODE_9477_length_878_cov_34.404365	680	760	17	3	80	0.0375000
NODE_9477_length_878_cov_34.404365	680	760	18	23	80	0.2875000
NODE_9477_length_878_cov_34.404365	680	760	19	1	80	0.0125000
NODE_9477_length_878_cov_34.404365	680	760	20	7	80	0.0875000
NODE_9477_length_878_cov_34.404365	680	760	21	2	80	0.0250000
NODE_9477_length_878_cov_34.404365	680	760	22	3	80	0.0375000
NODE_9477_length_878_cov_34.404365	680	760	31	1	80	0.0125000
NODE_9477_length_878_cov_34.404365	680	760	32	1	80	0.0125000
NODE_9477_length_878_cov_34.404365	680	760	34	2	80	0.0250000
NODE_9477_length_878_cov_34.404365	680	760	37	3	80	0.0375000
NODE_9477_length_878_cov_34.404365	680	760	38	1	80	0.0125000
NODE_9477_length_878_cov_34.404365	680	760	39	5	80	0.0625000
NODE_9477_length_878_cov_34.404365	680	760	41	1	80	0.0125000
NODE_9477_length_878_cov_34.404365	680	760	42	2	80	0.0250000
NODE_9477_length_878_cov_34.404365	680	760	43	3	80	0.0375000
NODE_9477_length_878_cov_34.404365	680	760	44	5	80	0.0625000
NODE_9477_length_878_cov_34.404365	680	760	45	2	80	0.0250000
NODE_9477_length_878_cov_34.404365	680	760	47	2	80	0.0250000
NODE_9477_length_878_cov_34.404365	680	760	49	3	80	0.0375000
NODE_9477_length_878_cov_34.404365	680	760	50	1	80	0.0125000
NODE_9477_length_878_cov_34.404365	680	760	51	2	80	0.0250000
NODE_9477_length_878_cov_34.404365	680	760	52	2	80	0.0250000
NODE_9477_length_878_cov_34.404365	680	760	53	1	80	0.0125000
NODE_9477_length_878_cov_34.404365	680	760	55	1	80	0.0125000
NODE_9478_length_878_cov_28.761232	467	547	0	80	80	1.0000000
NODE_9478_length_878_cov_28.761232	520	600	0	80	80	1.0000000
NODE_9479_length_878_cov_24.899872	316	396	0	80	80	1.0000000
NODE_9479_length_878_cov_24.899872	369	449	0	80	80	1.0000000
NODE_9479_length_878_cov_24.899872	445	525	0	5	80	0.0625000
NODE_9479_length_878_cov_24.899872	445	525	2	7	80	0.0875000
NODE_9479_length_878_cov_24.899872	445	525	3	8	80	0.1000000
NODE_9479_length_878_cov_24.899872	445	525	4	20	80	0.2500000
NODE_9479_length_878_cov_24.899872	445	525	5	18	80	0.2250000
NODE_9479_length_878_cov_24.899872	445	525	6	22	80	0.2750000
NODE_9479_length_878_cov_24.899872	498	578	5	5	80	0.0625000
NODE_9479_length_878_cov_24.899872	498	578	6	75	80	0.9375000
NODE_9480_length_878_cov_21.446727	377	457	1	40	80	0.5000000
NODE_9480_length_878_cov_21.446727	377	457	2	40	80	0.5000000
NODE_9480_length_878_cov_21.446727	430	510	1	44	80	0.5500000
NODE_9480_length_878_cov_21.446727	430	510	2	36	80	0.4500000
NODE_9481_length_878_cov_20.553273	424	504	3	16	80	0.2000000
NODE_9481_length_878_cov_20.553273	424	504	4	15	80	0.1875000
NODE_9481_length_878_cov_20.553273	424	504	5	24	80	0.3000000
NODE_9481_length_878_cov_20.553273	424	504	6	25	80	0.3125000
NODE_9481_length_878_cov_20.553273	477	557	3	19	80	0.2375000
NODE_9481_length_878_cov_20.553273	477	557	5	35	80	0.4375000
NODE_9481_length_878_cov_20.553273	477	557	6	26	80	0.3250000
NODE_9482_length_878_cov_14.016688	214	294	0	80	80	1.0000000
NODE_9482_length_878_cov_14.016688	267	347	0	80	80	1.0000000
NODE_9483_length_878_cov_9.252888	423	503	0	39	80	0.4875000
NODE_9483_length_878_cov_9.252888	423	503	1	41	80	0.5125000
NODE_9483_length_878_cov_9.252888	476	556	1	80	80	1.0000000
NODE_9484_length_878_cov_8.695764	333	413	0	4	80	0.0500000
NODE_9484_length_878_cov_8.695764	333	413	2	76	80	0.9500000
NODE_9484_length_878_cov_8.695764	386	466	0	57	80	0.7125000
NODE_9484_length_878_cov_8.695764	386	466	2	23	80	0.2875000
NODE_9485_length_878_cov_6.686778	65	145	0	80	80	1.0000000
NODE_9485_length_878_cov_6.686778	118	198	0	31	80	0.3875000
NODE_9485_length_878_cov_6.686778	118	198	1	49	80	0.6125000
NODE_9487_length_878_cov_6.328626	426	506	0	63	80	0.7875000
NODE_9487_length_878_cov_6.328626	426	506	1	17	80	0.2125000
NODE_9487_length_878_cov_6.328626	479	559	0	10	80	0.1250000
NODE_9487_length_878_cov_6.328626	479	559	1	33	80	0.4125000
NODE_9487_length_878_cov_6.328626	479	559	2	37	80	0.4625000
NODE_9488_length_878_cov_5.771502	470	513	1	31	43	0.7209302
NODE_9488_length_878_cov_5.771502	470	513	3	12	43	0.2790698
NODE_9490_length_878_cov_2.672657	499	579	0	10	80	0.1250000
NODE_9490_length_878_cov_2.672657	499	579	1	70	80	0.8750000
NODE_9490_length_878_cov_2.672657	552	631	1	79	79	1.0000000
NODE_9507_length_877_cov_59.021851	324	404	1	63	80	0.7875000
NODE_9507_length_877_cov_59.021851	324	404	2	17	80	0.2125000
NODE_9507_length_877_cov_59.021851	377	457	1	28	80	0.3500000
NODE_9507_length_877_cov_59.021851	377	457	2	52	80	0.6500000
NODE_9508_length_877_cov_54.422879	418	498	0	25	80	0.3125000
NODE_9508_length_877_cov_54.422879	418	498	1	21	80	0.2625000
NODE_9508_length_877_cov_54.422879	418	498	2	34	80	0.4250000
NODE_9508_length_877_cov_54.422879	471	551	0	7	80	0.0875000
NODE_9508_length_877_cov_54.422879	471	551	1	19	80	0.2375000
NODE_9508_length_877_cov_54.422879	471	551	2	54	80	0.6750000
NODE_9509_length_877_cov_47.672237	451	527	0	8	76	0.1052632
NODE_9509_length_877_cov_47.672237	451	527	2	20	76	0.2631579
NODE_9509_length_877_cov_47.672237	451	527	3	48	76	0.6315789
NODE_9509_length_877_cov_47.672237	500	580	1	34	80	0.4250000
NODE_9509_length_877_cov_47.672237	500	580	3	46	80	0.5750000
NODE_9510_length_877_cov_29.884319	349	429	10	13	80	0.1625000
NODE_9510_length_877_cov_29.884319	349	429	11	23	80	0.2875000
NODE_9510_length_877_cov_29.884319	349	429	12	21	80	0.2625000
NODE_9510_length_877_cov_29.884319	349	429	13	22	80	0.2750000
NODE_9510_length_877_cov_29.884319	349	429	14	1	80	0.0125000
NODE_9510_length_877_cov_29.884319	402	482	3	7	80	0.0875000
NODE_9510_length_877_cov_29.884319	402	482	4	3	80	0.0375000
NODE_9510_length_877_cov_29.884319	402	482	5	6	80	0.0750000
NODE_9510_length_877_cov_29.884319	402	482	6	8	80	0.1000000
NODE_9510_length_877_cov_29.884319	402	482	7	11	80	0.1375000
NODE_9510_length_877_cov_29.884319	402	482	9	1	80	0.0125000
NODE_9510_length_877_cov_29.884319	402	482	10	22	80	0.2750000
NODE_9510_length_877_cov_29.884319	402	482	11	11	80	0.1375000
NODE_9510_length_877_cov_29.884319	402	482	12	7	80	0.0875000
NODE_9510_length_877_cov_29.884319	402	482	13	4	80	0.0500000
NODE_9511_length_877_cov_17.681234	423	503	2	80	80	1.0000000
NODE_9511_length_877_cov_17.681234	476	556	1	32	80	0.4000000
NODE_9511_length_877_cov_17.681234	476	556	2	48	80	0.6000000
NODE_9512_length_877_cov_17.520566	228	308	0	24	80	0.3000000
NODE_9512_length_877_cov_17.520566	228	308	2	56	80	0.7000000
NODE_9512_length_877_cov_17.520566	281	361	2	80	80	1.0000000
NODE_9513_length_877_cov_17.374036	362	442	0	10	80	0.1250000
NODE_9513_length_877_cov_17.374036	362	442	1	9	80	0.1125000
NODE_9513_length_877_cov_17.374036	362	442	2	19	80	0.2375000
NODE_9513_length_877_cov_17.374036	362	442	4	42	80	0.5250000
NODE_9513_length_877_cov_17.374036	415	495	4	80	80	1.0000000
NODE_9515_length_877_cov_9.320051	395	475	1	17	80	0.2125000
NODE_9515_length_877_cov_9.320051	395	475	2	4	80	0.0500000
NODE_9515_length_877_cov_9.320051	395	475	4	59	80	0.7375000
NODE_9515_length_877_cov_9.320051	448	528	3	27	80	0.3375000
NODE_9515_length_877_cov_9.320051	448	528	4	53	80	0.6625000
NODE_9517_length_877_cov_6.755784	222	302	0	80	80	1.0000000
NODE_9517_length_877_cov_6.755784	275	354	0	79	79	1.0000000
NODE_9537_length_876_cov_46.021879	389	469	0	80	80	1.0000000
NODE_9537_length_876_cov_46.021879	442	522	0	80	80	1.0000000
NODE_9538_length_876_cov_34.441441	379	459	3	16	80	0.2000000
NODE_9538_length_876_cov_34.441441	379	459	5	27	80	0.3375000
NODE_9538_length_876_cov_34.441441	379	459	6	37	80	0.4625000
NODE_9538_length_876_cov_34.441441	432	512	6	72	80	0.9000000
NODE_9538_length_876_cov_34.441441	432	512	8	8	80	0.1000000
NODE_9539_length_876_cov_30.742600	344	424	2	14	80	0.1750000
NODE_9539_length_876_cov_30.742600	344	424	4	66	80	0.8250000
NODE_9539_length_876_cov_30.742600	397	477	2	3	80	0.0375000
NODE_9539_length_876_cov_30.742600	397	477	4	77	80	0.9625000
NODE_9540_length_876_cov_28.476190	345	425	3	80	80	1.0000000
NODE_9540_length_876_cov_28.476190	398	478	0	3	80	0.0375000
NODE_9540_length_876_cov_28.476190	398	478	1	41	80	0.5125000
NODE_9540_length_876_cov_28.476190	398	478	2	2	80	0.0250000
NODE_9540_length_876_cov_28.476190	398	478	3	34	80	0.4250000
NODE_9541_length_876_cov_22.722008	324	404	0	80	80	1.0000000
NODE_9541_length_876_cov_22.722008	377	457	0	80	80	1.0000000
NODE_9542_length_876_cov_17.458172	367	447	0	80	80	1.0000000
NODE_9542_length_876_cov_17.458172	420	500	0	80	80	1.0000000
NODE_9561_length_875_cov_52.965206	190	270	0	2	80	0.0250000
NODE_9561_length_875_cov_52.965206	190	270	1	22	80	0.2750000
NODE_9561_length_875_cov_52.965206	190	270	2	56	80	0.7000000
NODE_9561_length_875_cov_52.965206	243	323	0	19	80	0.2375000
NODE_9561_length_875_cov_52.965206	243	323	1	22	80	0.2750000
NODE_9561_length_875_cov_52.965206	243	323	2	39	80	0.4875000
NODE_9561_length_875_cov_52.965206	319	399	2	80	80	1.0000000
NODE_9561_length_875_cov_52.965206	372	447	0	15	75	0.2000000
NODE_9561_length_875_cov_52.965206	372	447	2	60	75	0.8000000
NODE_9562_length_875_cov_35.634021	260	340	0	14	80	0.1750000
NODE_9562_length_875_cov_35.634021	260	340	1	16	80	0.2000000
NODE_9562_length_875_cov_35.634021	260	340	2	45	80	0.5625000
NODE_9562_length_875_cov_35.634021	260	340	3	5	80	0.0625000
NODE_9562_length_875_cov_35.634021	313	393	2	22	80	0.2750000
NODE_9562_length_875_cov_35.634021	313	393	3	16	80	0.2000000
NODE_9562_length_875_cov_35.634021	313	393	4	19	80	0.2375000
NODE_9562_length_875_cov_35.634021	313	393	5	6	80	0.0750000
NODE_9562_length_875_cov_35.634021	313	393	7	17	80	0.2125000
NODE_9562_length_875_cov_35.634021	389	469	7	43	80	0.5375000
NODE_9562_length_875_cov_35.634021	389	469	8	19	80	0.2375000
NODE_9562_length_875_cov_35.634021	389	469	9	18	80	0.2250000
NODE_9562_length_875_cov_35.634021	442	522	4	3	80	0.0375000
NODE_9562_length_875_cov_35.634021	442	522	5	21	80	0.2625000
NODE_9562_length_875_cov_35.634021	442	522	6	13	80	0.1625000
NODE_9562_length_875_cov_35.634021	442	522	7	43	80	0.5375000
NODE_9563_length_875_cov_33.771907	363	441	1	12	78	0.1538462
NODE_9563_length_875_cov_33.771907	363	441	2	32	78	0.4102564
NODE_9563_length_875_cov_33.771907	363	441	3	34	78	0.4358974
NODE_9563_length_875_cov_33.771907	414	494	2	25	80	0.3125000
NODE_9563_length_875_cov_33.771907	414	494	3	55	80	0.6875000
NODE_9564_length_875_cov_29.698454	322	402	5	31	80	0.3875000
NODE_9564_length_875_cov_29.698454	322	402	7	6	80	0.0750000
NODE_9564_length_875_cov_29.698454	322	402	9	11	80	0.1375000
NODE_9564_length_875_cov_29.698454	322	402	10	5	80	0.0625000
NODE_9564_length_875_cov_29.698454	322	402	11	27	80	0.3375000
NODE_9564_length_875_cov_29.698454	375	455	6	4	80	0.0500000
NODE_9564_length_875_cov_29.698454	375	455	7	1	80	0.0125000
NODE_9564_length_875_cov_29.698454	375	455	8	14	80	0.1750000
NODE_9564_length_875_cov_29.698454	375	455	9	1	80	0.0125000
NODE_9564_length_875_cov_29.698454	375	455	11	36	80	0.4500000
NODE_9564_length_875_cov_29.698454	375	455	12	24	80	0.3000000
NODE_9565_length_875_cov_23.041237	364	444	0	18	80	0.2250000
NODE_9565_length_875_cov_23.041237	364	444	1	62	80	0.7750000
NODE_9565_length_875_cov_23.041237	417	497	1	80	80	1.0000000
NODE_9565_length_875_cov_23.041237	493	573	0	39	80	0.4875000
NODE_9565_length_875_cov_23.041237	493	573	1	41	80	0.5125000
NODE_9565_length_875_cov_23.041237	546	626	0	80	80	1.0000000
NODE_9566_length_875_cov_9.800258	242	322	2	40	80	0.5000000
NODE_9566_length_875_cov_9.800258	242	322	3	40	80	0.5000000
NODE_9566_length_875_cov_9.800258	295	376	0	8	81	0.0987654
NODE_9566_length_875_cov_9.800258	295	376	1	41	81	0.5061728
NODE_9566_length_875_cov_9.800258	295	376	2	32	81	0.3950617
NODE_9567_length_875_cov_8.195876	407	487	0	80	80	1.0000000
NODE_9567_length_875_cov_8.195876	460	540	0	80	80	1.0000000
NODE_9585_length_874_cov_48.925161	185	265	5	50	80	0.6250000
NODE_9585_length_874_cov_48.925161	185	265	6	30	80	0.3750000
NODE_9585_length_874_cov_48.925161	238	318	3	27	80	0.3375000
NODE_9585_length_874_cov_48.925161	238	318	4	15	80	0.1875000
NODE_9585_length_874_cov_48.925161	238	318	5	37	80	0.4625000
NODE_9585_length_874_cov_48.925161	238	318	6	1	80	0.0125000
NODE_9587_length_874_cov_37.354839	199	279	0	74	80	0.9250000
NODE_9587_length_874_cov_37.354839	199	279	1	6	80	0.0750000
NODE_9587_length_874_cov_37.354839	252	332	0	21	80	0.2625000
NODE_9587_length_874_cov_37.354839	252	332	1	59	80	0.7375000
NODE_9588_length_874_cov_35.040000	231	311	1	4	80	0.0500000
NODE_9588_length_874_cov_35.040000	231	311	2	26	80	0.3250000
NODE_9588_length_874_cov_35.040000	231	311	3	50	80	0.6250000
NODE_9588_length_874_cov_35.040000	284	364	2	14	80	0.1750000
NODE_9588_length_874_cov_35.040000	284	364	3	66	80	0.8250000
NODE_9589_length_874_cov_23.415484	327	407	1	60	80	0.7500000
NODE_9589_length_874_cov_23.415484	327	407	3	20	80	0.2500000
NODE_9589_length_874_cov_23.415484	380	460	0	13	80	0.1625000
NODE_9589_length_874_cov_23.415484	380	460	1	67	80	0.8375000
NODE_9589_length_874_cov_23.415484	456	536	0	42	80	0.5250000
NODE_9589_length_874_cov_23.415484	456	536	1	38	80	0.4750000
NODE_9589_length_874_cov_23.415484	509	589	1	80	80	1.0000000
NODE_9590_length_874_cov_21.885161	279	359	2	13	80	0.1625000
NODE_9590_length_874_cov_21.885161	279	359	3	63	80	0.7875000
NODE_9590_length_874_cov_21.885161	279	359	4	4	80	0.0500000
NODE_9590_length_874_cov_21.885161	332	412	2	64	80	0.8000000
NODE_9590_length_874_cov_21.885161	332	412	3	16	80	0.2000000
NODE_9591_length_874_cov_11.172903	67	147	2	80	80	1.0000000
NODE_9591_length_874_cov_11.172903	120	200	0	16	80	0.2000000
NODE_9591_length_874_cov_11.172903	120	200	2	64	80	0.8000000
NODE_9592_length_874_cov_9.645161	424	504	2	30	80	0.3750000
NODE_9592_length_874_cov_9.645161	424	504	3	7	80	0.0875000
NODE_9592_length_874_cov_9.645161	424	504	4	43	80	0.5375000
NODE_9592_length_874_cov_9.645161	477	557	2	26	80	0.3250000
NODE_9592_length_874_cov_9.645161	477	557	3	22	80	0.2750000
NODE_9592_length_874_cov_9.645161	477	557	4	32	80	0.4000000
NODE_9593_length_874_cov_8.637419	359	439	1	22	80	0.2750000
NODE_9593_length_874_cov_8.637419	359	439	2	38	80	0.4750000
NODE_9593_length_874_cov_8.637419	359	439	3	20	80	0.2500000
NODE_9593_length_874_cov_8.637419	412	499	1	35	87	0.4022988
NODE_9593_length_874_cov_8.637419	412	499	2	47	87	0.5402299
NODE_9593_length_874_cov_8.637419	412	499	3	5	87	0.0574713
NODE_9596_length_874_cov_4.785806	829	874	0	9	45	0.2000000
NODE_9596_length_874_cov_4.785806	829	874	2	4	45	0.0888889
NODE_9596_length_874_cov_4.785806	829	874	3	32	45	0.7111111
NODE_9618_length_873_cov_100.625323	50	130	36	5	80	0.0625000
NODE_9618_length_873_cov_100.625323	50	130	37	5	80	0.0625000
NODE_9618_length_873_cov_100.625323	50	130	38	3	80	0.0375000
NODE_9618_length_873_cov_100.625323	50	130	39	8	80	0.1000000
NODE_9618_length_873_cov_100.625323	50	130	40	11	80	0.1375000
NODE_9618_length_873_cov_100.625323	50	130	41	24	80	0.3000000
NODE_9618_length_873_cov_100.625323	50	130	42	24	80	0.3000000
NODE_9619_length_873_cov_45.633075	226	306	4	59	80	0.7375000
NODE_9619_length_873_cov_45.633075	226	306	5	7	80	0.0875000
NODE_9619_length_873_cov_45.633075	226	306	7	14	80	0.1750000
NODE_9619_length_873_cov_45.633075	279	359	1	8	80	0.1000000
NODE_9619_length_873_cov_45.633075	279	359	3	29	80	0.3625000
NODE_9619_length_873_cov_45.633075	279	359	4	43	80	0.5375000
NODE_9619_length_873_cov_45.633075	693	773	1	80	80	1.0000000
NODE_9619_length_873_cov_45.633075	746	826	0	51	80	0.6375000
NODE_9619_length_873_cov_45.633075	746	826	1	29	80	0.3625000
NODE_9620_length_873_cov_39.224806	190	270	0	63	80	0.7875000
NODE_9620_length_873_cov_39.224806	190	270	2	9	80	0.1125000
NODE_9620_length_873_cov_39.224806	190	270	4	8	80	0.1000000
NODE_9620_length_873_cov_39.224806	243	307	0	64	64	1.0000000
NODE_9620_length_873_cov_39.224806	390	470	2	15	80	0.1875000
NODE_9620_length_873_cov_39.224806	390	470	4	65	80	0.8125000
NODE_9620_length_873_cov_39.224806	443	523	0	10	80	0.1250000
NODE_9620_length_873_cov_39.224806	443	523	2	27	80	0.3375000
NODE_9620_length_873_cov_39.224806	443	523	4	43	80	0.5375000
NODE_9620_length_873_cov_39.224806	504	523	0	10	19	0.5263158
NODE_9620_length_873_cov_39.224806	504	523	2	9	19	0.4736842
NODE_9620_length_873_cov_39.224806	519	599	0	7	80	0.0875000
NODE_9620_length_873_cov_39.224806	519	599	2	73	80	0.9125000
NODE_9620_length_873_cov_39.224806	572	652	2	80	80	1.0000000
NODE_9621_length_873_cov_27.992248	372	452	4	13	80	0.1625000
NODE_9621_length_873_cov_27.992248	372	452	5	41	80	0.5125000
NODE_9621_length_873_cov_27.992248	372	452	6	15	80	0.1875000
NODE_9621_length_873_cov_27.992248	372	452	7	11	80	0.1375000
NODE_9621_length_873_cov_27.992248	425	505	2	13	80	0.1625000
NODE_9621_length_873_cov_27.992248	425	505	3	26	80	0.3250000
NODE_9621_length_873_cov_27.992248	425	505	4	27	80	0.3375000
NODE_9621_length_873_cov_27.992248	425	505	5	4	80	0.0500000
NODE_9621_length_873_cov_27.992248	425	505	6	10	80	0.1250000
NODE_9622_length_873_cov_23.270026	390	470	1	24	80	0.3000000
NODE_9622_length_873_cov_23.270026	390	470	3	56	80	0.7000000
NODE_9622_length_873_cov_23.270026	443	528	1	82	85	0.9647059
NODE_9622_length_873_cov_23.270026	443	528	3	3	85	0.0352941
NODE_9623_length_873_cov_23.197674	293	373	0	80	80	1.0000000
NODE_9623_length_873_cov_23.197674	346	426	0	80	80	1.0000000
NODE_9624_length_873_cov_20.432817	347	427	2	10	80	0.1250000
NODE_9624_length_873_cov_20.432817	347	427	4	70	80	0.8750000
NODE_9624_length_873_cov_20.432817	400	480	2	37	80	0.4625000
NODE_9624_length_873_cov_20.432817	400	480	4	43	80	0.5375000
NODE_9624_length_873_cov_20.432817	476	556	1	50	80	0.6250000
NODE_9624_length_873_cov_20.432817	476	556	2	9	80	0.1125000
NODE_9624_length_873_cov_20.432817	476	556	3	21	80	0.2625000
NODE_9624_length_873_cov_20.432817	529	609	1	47	80	0.5875000
NODE_9624_length_873_cov_20.432817	529	609	2	33	80	0.4125000
NODE_9625_length_873_cov_19.913437	445	525	1	13	80	0.1625000
NODE_9625_length_873_cov_19.913437	445	525	2	67	80	0.8375000
NODE_9625_length_873_cov_19.913437	498	578	0	14	80	0.1750000
NODE_9625_length_873_cov_19.913437	498	578	1	52	80	0.6500000
NODE_9625_length_873_cov_19.913437	498	578	2	14	80	0.1750000
NODE_9626_length_873_cov_16.718346	276	356	2	32	80	0.4000000
NODE_9626_length_873_cov_16.718346	276	356	3	48	80	0.6000000
NODE_9626_length_873_cov_16.718346	329	409	1	16	80	0.2000000
NODE_9626_length_873_cov_16.718346	329	409	2	43	80	0.5375000
NODE_9626_length_873_cov_16.718346	329	409	3	21	80	0.2625000
NODE_9627_length_873_cov_16.422481	423	503	0	28	80	0.3500000
NODE_9627_length_873_cov_16.422481	423	503	2	52	80	0.6500000
NODE_9627_length_873_cov_16.422481	476	556	2	80	80	1.0000000
NODE_9628_length_873_cov_11.198966	410	490	1	80	80	1.0000000
NODE_9628_length_873_cov_11.198966	463	543	0	27	80	0.3375000
NODE_9628_length_873_cov_11.198966	463	543	1	53	80	0.6625000
NODE_9629_length_873_cov_9.799742	334	414	2	25	80	0.3125000
NODE_9629_length_873_cov_9.799742	334	414	3	16	80	0.2000000
NODE_9629_length_873_cov_9.799742	334	414	5	4	80	0.0500000
NODE_9629_length_873_cov_9.799742	334	414	6	35	80	0.4375000
NODE_9629_length_873_cov_9.799742	387	467	5	56	80	0.7000000
NODE_9629_length_873_cov_9.799742	387	467	6	24	80	0.3000000
NODE_9632_length_873_cov_3.828165	490	570	0	80	80	1.0000000
NODE_9632_length_873_cov_3.828165	543	583	0	40	40	1.0000000
NODE_9632_length_873_cov_3.828165	690	735	0	45	45	1.0000000
NODE_9633_length_873_cov_3.443152	716	746	0	16	30	0.5333334
NODE_9633_length_873_cov_3.443152	716	746	2	14	30	0.4666667
NODE_9647_length_873_cov_1.239018	593	658	2	27	65	0.4153846
NODE_9647_length_873_cov_1.239018	593	658	3	12	65	0.1846154
NODE_9647_length_873_cov_1.239018	593	658	5	26	65	0.4000000
NODE_9651_length_872_cov_47.732212	432	512	2	6	80	0.0750000
NODE_9651_length_872_cov_47.732212	432	512	3	25	80	0.3125000
NODE_9651_length_872_cov_47.732212	432	512	4	49	80	0.6125000
NODE_9651_length_872_cov_47.732212	484	564	4	65	80	0.8125000
NODE_9651_length_872_cov_47.732212	484	564	5	15	80	0.1875000
NODE_9651_length_872_cov_47.732212	560	640	4	6	80	0.0750000
NODE_9651_length_872_cov_47.732212	560	640	5	50	80	0.6250000
NODE_9651_length_872_cov_47.732212	560	640	6	24	80	0.3000000
NODE_9651_length_872_cov_47.732212	613	693	2	5	80	0.0625000
NODE_9651_length_872_cov_47.732212	613	693	3	24	80	0.3000000
NODE_9651_length_872_cov_47.732212	613	693	4	30	80	0.3750000
NODE_9651_length_872_cov_47.732212	613	693	5	21	80	0.2625000
NODE_9652_length_872_cov_16.204398	349	429	1	68	80	0.8500000
NODE_9652_length_872_cov_16.204398	349	429	2	12	80	0.1500000
NODE_9652_length_872_cov_16.204398	402	482	1	18	80	0.2250000
NODE_9652_length_872_cov_16.204398	402	482	2	62	80	0.7750000
NODE_9652_length_872_cov_16.204398	478	558	1	79	80	0.9875000
NODE_9652_length_872_cov_16.204398	478	558	2	1	80	0.0125000
NODE_9652_length_872_cov_16.204398	531	611	0	44	80	0.5500000
NODE_9652_length_872_cov_16.204398	531	611	1	36	80	0.4500000
NODE_9653_length_872_cov_12.835705	376	456	6	80	80	1.0000000
NODE_9653_length_872_cov_12.835705	429	509	1	5	80	0.0625000
NODE_9653_length_872_cov_12.835705	429	509	3	6	80	0.0750000
NODE_9653_length_872_cov_12.835705	429	509	5	13	80	0.1625000
NODE_9653_length_872_cov_12.835705	429	509	6	56	80	0.7000000
NODE_9654_length_872_cov_9.657180	356	431	1	41	75	0.5466667
NODE_9654_length_872_cov_9.657180	356	431	2	5	75	0.0666667
NODE_9654_length_872_cov_9.657180	356	431	3	29	75	0.3866667
NODE_9660_length_872_cov_3.531695	425	505	0	80	80	1.0000000
NODE_9660_length_872_cov_3.531695	478	559	0	81	81	1.0000000
NODE_9673_length_871_cov_56.841969	265	345	0	21	80	0.2625000
NODE_9673_length_871_cov_56.841969	265	345	2	59	80	0.7375000
NODE_9673_length_871_cov_56.841969	318	398	2	31	80	0.3875000
NODE_9673_length_871_cov_56.841969	318	398	4	15	80	0.1875000
NODE_9673_length_871_cov_56.841969	318	398	6	21	80	0.2625000
NODE_9673_length_871_cov_56.841969	318	398	7	13	80	0.1625000
NODE_9673_length_871_cov_56.841969	394	474	3	2	80	0.0250000
NODE_9673_length_871_cov_56.841969	394	474	5	49	80	0.6125000
NODE_9673_length_871_cov_56.841969	394	474	7	29	80	0.3625000
NODE_9673_length_871_cov_56.841969	447	527	0	21	80	0.2625000
NODE_9673_length_871_cov_56.841969	447	527	1	7	80	0.0875000
NODE_9673_length_871_cov_56.841969	447	527	3	27	80	0.3375000
NODE_9673_length_871_cov_56.841969	447	527	5	25	80	0.3125000
NODE_9674_length_871_cov_47.528497	461	541	4	61	80	0.7625000
NODE_9674_length_871_cov_47.528497	461	541	6	19	80	0.2375000
NODE_9674_length_871_cov_47.528497	514	594	0	16	80	0.2000000
NODE_9674_length_871_cov_47.528497	514	594	2	22	80	0.2750000
NODE_9674_length_871_cov_47.528497	514	594	3	9	80	0.1125000
NODE_9674_length_871_cov_47.528497	514	594	4	30	80	0.3750000
NODE_9674_length_871_cov_47.528497	514	594	6	3	80	0.0375000
NODE_9675_length_871_cov_31.145078	326	406	0	30	80	0.3750000
NODE_9675_length_871_cov_31.145078	326	406	2	34	80	0.4250000
NODE_9675_length_871_cov_31.145078	326	406	3	2	80	0.0250000
NODE_9675_length_871_cov_31.145078	326	406	4	14	80	0.1750000
NODE_9675_length_871_cov_31.145078	379	459	2	11	80	0.1375000
NODE_9675_length_871_cov_31.145078	379	459	3	2	80	0.0250000
NODE_9675_length_871_cov_31.145078	379	459	4	67	80	0.8375000
NODE_9676_length_871_cov_27.993523	379	459	0	21	80	0.2625000
NODE_9676_length_871_cov_27.993523	379	459	1	51	80	0.6375000
NODE_9676_length_871_cov_27.993523	379	459	2	8	80	0.1000000
NODE_9676_length_871_cov_27.993523	432	512	1	19	80	0.2375000
NODE_9676_length_871_cov_27.993523	432	512	2	61	80	0.7625000
NODE_9677_length_871_cov_25.954663	463	543	2	15	80	0.1875000
NODE_9677_length_871_cov_25.954663	463	543	3	65	80	0.8125000
NODE_9677_length_871_cov_25.954663	516	596	1	15	80	0.1875000
NODE_9677_length_871_cov_25.954663	516	596	3	65	80	0.8125000
NODE_9678_length_871_cov_24.069948	492	558	1	66	66	1.0000000
NODE_9678_length_871_cov_24.069948	558	634	0	25	76	0.3289474
NODE_9678_length_871_cov_24.069948	558	634	1	51	76	0.6710526
NODE_9679_length_871_cov_23.953368	445	522	11	7	77	0.0909091
NODE_9679_length_871_cov_23.953368	445	522	13	5	77	0.0649351
NODE_9679_length_871_cov_23.953368	445	522	14	4	77	0.0519481
NODE_9679_length_871_cov_23.953368	445	522	15	1	77	0.0129870
NODE_9679_length_871_cov_23.953368	445	522	16	8	77	0.1038961
NODE_9679_length_871_cov_23.953368	445	522	17	15	77	0.1948052
NODE_9679_length_871_cov_23.953368	445	522	18	4	77	0.0519481
NODE_9679_length_871_cov_23.953368	445	522	19	33	77	0.4285714
NODE_9680_length_871_cov_19.304404	335	415	4	1	80	0.0125000
NODE_9680_length_871_cov_19.304404	335	415	5	38	80	0.4750000
NODE_9680_length_871_cov_19.304404	335	415	6	41	80	0.5125000
NODE_9680_length_871_cov_19.304404	388	468	3	5	80	0.0625000
NODE_9680_length_871_cov_19.304404	388	468	4	46	80	0.5750000
NODE_9680_length_871_cov_19.304404	388	468	5	26	80	0.3250000
NODE_9680_length_871_cov_19.304404	388	468	6	3	80	0.0375000
NODE_9682_length_871_cov_18.108808	370	450	1	9	80	0.1125000
NODE_9682_length_871_cov_18.108808	370	450	2	71	80	0.8875000
NODE_9682_length_871_cov_18.108808	423	503	1	41	80	0.5125000
NODE_9682_length_871_cov_18.108808	423	503	2	39	80	0.4875000
NODE_9683_length_871_cov_17.034974	362	442	0	31	80	0.3875000
NODE_9683_length_871_cov_17.034974	362	442	1	49	80	0.6125000
NODE_9683_length_871_cov_17.034974	415	495	1	80	80	1.0000000
NODE_9684_length_871_cov_16.768135	374	454	0	80	80	1.0000000
NODE_9685_length_871_cov_14.196891	267	347	4	8	80	0.1000000
NODE_9685_length_871_cov_14.196891	267	347	5	54	80	0.6750000
NODE_9685_length_871_cov_14.196891	267	347	6	2	80	0.0250000
NODE_9685_length_871_cov_14.196891	267	347	7	16	80	0.2000000
NODE_9685_length_871_cov_14.196891	320	400	4	42	80	0.5250000
NODE_9685_length_871_cov_14.196891	320	400	5	20	80	0.2500000
NODE_9685_length_871_cov_14.196891	320	400	6	2	80	0.0250000
NODE_9685_length_871_cov_14.196891	320	400	7	16	80	0.2000000
NODE_9686_length_871_cov_13.443005	246	326	0	80	80	1.0000000
NODE_9686_length_871_cov_13.443005	299	322	0	23	23	1.0000000
NODE_9687_length_871_cov_11.839378	29	109	1	43	80	0.5375000
NODE_9687_length_871_cov_11.839378	29	109	3	37	80	0.4625000
NODE_9687_length_871_cov_11.839378	82	149	3	34	67	0.5074627
NODE_9687_length_871_cov_11.839378	82	149	4	33	67	0.4925373
NODE_9687_length_871_cov_11.839378	331	411	4	80	80	1.0000000
NODE_9687_length_871_cov_11.839378	384	464	2	3	80	0.0375000
NODE_9687_length_871_cov_11.839378	384	464	3	2	80	0.0250000
NODE_9687_length_871_cov_11.839378	384	464	4	75	80	0.9375000
NODE_9689_length_871_cov_5.730570	316	373	0	57	57	1.0000000
NODE_9694_length_871_cov_3.544041	428	508	0	80	80	1.0000000
NODE_9694_length_871_cov_3.544041	481	561	0	80	80	1.0000000
NODE_9716_length_870_cov_43.400778	542	622	0	40	80	0.5000000
NODE_9716_length_870_cov_43.400778	542	622	2	40	80	0.5000000
NODE_9716_length_870_cov_43.400778	595	675	2	80	80	1.0000000
NODE_9719_length_870_cov_28.249027	442	524	1	65	82	0.7926829
NODE_9719_length_870_cov_28.249027	442	524	2	17	82	0.2073171
NODE_9719_length_870_cov_28.249027	497	577	1	63	80	0.7875000
NODE_9719_length_870_cov_28.249027	497	577	2	17	80	0.2125000
NODE_9720_length_870_cov_26.992218	240	320	1	1	80	0.0125000
NODE_9720_length_870_cov_26.992218	240	320	2	31	80	0.3875000
NODE_9720_length_870_cov_26.992218	240	320	3	48	80	0.6000000
NODE_9720_length_870_cov_26.992218	293	373	2	51	80	0.6375000
NODE_9720_length_870_cov_26.992218	293	373	3	29	80	0.3625000
NODE_9720_length_870_cov_26.992218	369	449	1	41	80	0.5125000
NODE_9720_length_870_cov_26.992218	369	449	2	39	80	0.4875000
NODE_9720_length_870_cov_26.992218	422	502	1	80	80	1.0000000
NODE_9721_length_870_cov_25.806744	186	237	2	51	51	1.0000000
NODE_9721_length_870_cov_25.806744	391	471	2	18	80	0.2250000
NODE_9721_length_870_cov_25.806744	391	471	4	62	80	0.7750000
NODE_9721_length_870_cov_25.806744	444	524	1	29	80	0.3625000
NODE_9721_length_870_cov_25.806744	444	524	3	12	80	0.1500000
NODE_9721_length_870_cov_25.806744	444	524	4	39	80	0.4875000
NODE_9722_length_870_cov_18.862516	345	425	1	58	80	0.7250000
NODE_9722_length_870_cov_18.862516	345	425	2	22	80	0.2750000
NODE_9722_length_870_cov_18.862516	398	478	1	5	80	0.0625000
NODE_9722_length_870_cov_18.862516	398	478	2	75	80	0.9375000
NODE_9723_length_870_cov_15.686122	330	410	0	38	80	0.4750000
NODE_9723_length_870_cov_15.686122	330	410	2	42	80	0.5250000
NODE_9723_length_870_cov_15.686122	383	463	2	70	80	0.8750000
NODE_9723_length_870_cov_15.686122	383	463	4	10	80	0.1250000
NODE_9725_length_870_cov_13.334630	479	559	0	80	80	1.0000000
NODE_9725_length_870_cov_13.334630	532	612	0	80	80	1.0000000
NODE_9726_length_870_cov_9.712062	410	490	0	80	80	1.0000000
NODE_9726_length_870_cov_9.712062	463	542	0	79	79	1.0000000
NODE_9728_length_870_cov_7.556420	448	528	0	80	80	1.0000000
NODE_9728_length_870_cov_7.556420	501	581	0	80	80	1.0000000
NODE_9746_length_869_cov_42.784416	395	475	4	3	80	0.0375000
NODE_9746_length_869_cov_42.784416	395	475	5	20	80	0.2500000
NODE_9746_length_869_cov_42.784416	395	475	6	1	80	0.0125000
NODE_9746_length_869_cov_42.784416	395	475	8	4	80	0.0500000
NODE_9746_length_869_cov_42.784416	395	475	10	39	80	0.4875000
NODE_9746_length_869_cov_42.784416	395	475	11	13	80	0.1625000
NODE_9746_length_869_cov_42.784416	448	528	7	7	80	0.0875000
NODE_9746_length_869_cov_42.784416	448	528	8	18	80	0.2250000
NODE_9746_length_869_cov_42.784416	448	528	10	44	80	0.5500000
NODE_9746_length_869_cov_42.784416	448	528	11	11	80	0.1375000
NODE_9747_length_869_cov_29.525974	211	291	2	8	80	0.1000000
NODE_9747_length_869_cov_29.525974	211	291	3	44	80	0.5500000
NODE_9747_length_869_cov_29.525974	211	291	4	28	80	0.3500000
NODE_9747_length_869_cov_29.525974	264	344	1	46	80	0.5750000
NODE_9747_length_869_cov_29.525974	264	344	2	15	80	0.1875000
NODE_9747_length_869_cov_29.525974	264	344	3	19	80	0.2375000
NODE_9748_length_869_cov_16.258442	389	469	0	24	80	0.3000000
NODE_9748_length_869_cov_16.258442	389	469	1	56	80	0.7000000
NODE_9748_length_869_cov_16.258442	442	522	1	80	80	1.0000000
NODE_9749_length_869_cov_15.940260	321	401	0	80	80	1.0000000
NODE_9749_length_869_cov_15.940260	374	454	0	80	80	1.0000000
NODE_9750_length_869_cov_9.619481	402	442	140	1	40	0.0250000
NODE_9750_length_869_cov_9.619481	402	442	141	2	40	0.0500000
NODE_9750_length_869_cov_9.619481	402	442	142	1	40	0.0250000
NODE_9750_length_869_cov_9.619481	402	442	143	2	40	0.0500000
NODE_9750_length_869_cov_9.619481	402	442	144	3	40	0.0750000
NODE_9750_length_869_cov_9.619481	402	442	146	1	40	0.0250000
NODE_9750_length_869_cov_9.619481	402	442	147	5	40	0.1250000
NODE_9750_length_869_cov_9.619481	402	442	148	2	40	0.0500000
NODE_9750_length_869_cov_9.619481	402	442	150	1	40	0.0250000
NODE_9750_length_869_cov_9.619481	402	442	151	1	40	0.0250000
NODE_9750_length_869_cov_9.619481	402	442	156	2	40	0.0500000
NODE_9750_length_869_cov_9.619481	402	442	157	1	40	0.0250000
NODE_9750_length_869_cov_9.619481	402	442	161	2	40	0.0500000
NODE_9750_length_869_cov_9.619481	402	442	162	1	40	0.0250000
NODE_9750_length_869_cov_9.619481	402	442	163	6	40	0.1500000
NODE_9750_length_869_cov_9.619481	402	442	164	1	40	0.0250000
NODE_9750_length_869_cov_9.619481	402	442	165	2	40	0.0500000
NODE_9750_length_869_cov_9.619481	402	442	167	1	40	0.0250000
NODE_9750_length_869_cov_9.619481	402	442	168	2	40	0.0500000
NODE_9750_length_869_cov_9.619481	402	442	169	2	40	0.0500000
NODE_9750_length_869_cov_9.619481	402	442	170	1	40	0.0250000
NODE_9751_length_869_cov_7.123377	392	472	3	68	80	0.8500000
NODE_9751_length_869_cov_7.123377	392	472	4	12	80	0.1500000
NODE_9751_length_869_cov_7.123377	445	525	0	26	80	0.3250000
NODE_9751_length_869_cov_7.123377	445	525	1	15	80	0.1875000
NODE_9751_length_869_cov_7.123377	445	525	2	1	80	0.0125000
NODE_9751_length_869_cov_7.123377	445	525	3	38	80	0.4750000
NODE_9753_length_869_cov_3.658442	310	378	0	68	68	1.0000000
NODE_9777_length_868_cov_57.465540	355	435	45	1	80	0.0125000
NODE_9777_length_868_cov_57.465540	355	435	46	5	80	0.0625000
NODE_9777_length_868_cov_57.465540	355	435	47	3	80	0.0375000
NODE_9777_length_868_cov_57.465540	355	435	48	2	80	0.0250000
NODE_9777_length_868_cov_57.465540	355	435	49	4	80	0.0500000
NODE_9777_length_868_cov_57.465540	355	435	50	8	80	0.1000000
NODE_9777_length_868_cov_57.465540	355	435	51	19	80	0.2375000
NODE_9777_length_868_cov_57.465540	355	435	52	26	80	0.3250000
NODE_9777_length_868_cov_57.465540	355	435	53	6	80	0.0750000
NODE_9777_length_868_cov_57.465540	355	435	54	6	80	0.0750000
NODE_9778_length_868_cov_46.509753	0	65	2	4	65	0.0615385
NODE_9778_length_868_cov_46.509753	0	65	3	5	65	0.0769231
NODE_9778_length_868_cov_46.509753	0	65	4	9	65	0.1384615
NODE_9778_length_868_cov_46.509753	0	65	5	4	65	0.0615385
NODE_9778_length_868_cov_46.509753	0	65	6	8	65	0.1230769
NODE_9778_length_868_cov_46.509753	0	65	7	1	65	0.0153846
NODE_9778_length_868_cov_46.509753	0	65	8	2	65	0.0307692
NODE_9778_length_868_cov_46.509753	0	65	9	10	65	0.1538462
NODE_9778_length_868_cov_46.509753	0	65	11	22	65	0.3384615
NODE_9778_length_868_cov_46.509753	0	65	2	4	65	0.0615385
NODE_9778_length_868_cov_46.509753	0	65	3	5	65	0.0769231
NODE_9778_length_868_cov_46.509753	0	65	4	9	65	0.1384615
NODE_9778_length_868_cov_46.509753	0	65	5	4	65	0.0615385
NODE_9778_length_868_cov_46.509753	0	65	6	8	65	0.1230769
NODE_9778_length_868_cov_46.509753	0	65	7	1	65	0.0153846
NODE_9778_length_868_cov_46.509753	0	65	8	2	65	0.0307692
NODE_9778_length_868_cov_46.509753	0	65	9	10	65	0.1538462
NODE_9778_length_868_cov_46.509753	0	65	11	22	65	0.3384615
NODE_9778_length_868_cov_46.509753	0	65	2	4	65	0.0615385
NODE_9778_length_868_cov_46.509753	0	65	3	5	65	0.0769231
NODE_9778_length_868_cov_46.509753	0	65	4	9	65	0.1384615
NODE_9778_length_868_cov_46.509753	0	65	5	4	65	0.0615385
NODE_9778_length_868_cov_46.509753	0	65	6	8	65	0.1230769
NODE_9778_length_868_cov_46.509753	0	65	7	1	65	0.0153846
NODE_9778_length_868_cov_46.509753	0	65	8	2	65	0.0307692
NODE_9778_length_868_cov_46.509753	0	65	9	10	65	0.1538462
NODE_9778_length_868_cov_46.509753	0	65	11	22	65	0.3384615
NODE_9778_length_868_cov_46.509753	0	65	2	4	65	0.0615385
NODE_9778_length_868_cov_46.509753	0	65	3	5	65	0.0769231
NODE_9778_length_868_cov_46.509753	0	65	4	9	65	0.1384615
NODE_9778_length_868_cov_46.509753	0	65	5	4	65	0.0615385
NODE_9778_length_868_cov_46.509753	0	65	6	8	65	0.1230769
NODE_9778_length_868_cov_46.509753	0	65	7	1	65	0.0153846
NODE_9778_length_868_cov_46.509753	0	65	8	2	65	0.0307692
NODE_9778_length_868_cov_46.509753	0	65	9	10	65	0.1538462
NODE_9778_length_868_cov_46.509753	0	65	11	22	65	0.3384615
NODE_9778_length_868_cov_46.509753	61	141	11	4	80	0.0500000
NODE_9778_length_868_cov_46.509753	61	141	12	7	80	0.0875000
NODE_9778_length_868_cov_46.509753	61	141	13	39	80	0.4875000
NODE_9778_length_868_cov_46.509753	61	141	14	17	80	0.2125000
NODE_9778_length_868_cov_46.509753	61	141	15	13	80	0.1625000
NODE_9778_length_868_cov_46.509753	61	141	11	4	80	0.0500000
NODE_9778_length_868_cov_46.509753	61	141	12	7	80	0.0875000
NODE_9778_length_868_cov_46.509753	61	141	13	39	80	0.4875000
NODE_9778_length_868_cov_46.509753	61	141	14	17	80	0.2125000
NODE_9778_length_868_cov_46.509753	61	141	15	13	80	0.1625000
NODE_9778_length_868_cov_46.509753	114	194	4	12	80	0.1500000
NODE_9778_length_868_cov_46.509753	114	194	6	1	80	0.0125000
NODE_9778_length_868_cov_46.509753	114	194	7	1	80	0.0125000
NODE_9778_length_868_cov_46.509753	114	194	8	2	80	0.0250000
NODE_9778_length_868_cov_46.509753	114	194	9	6	80	0.0750000
NODE_9778_length_868_cov_46.509753	114	194	10	4	80	0.0500000
NODE_9778_length_868_cov_46.509753	114	194	11	9	80	0.1125000
NODE_9778_length_868_cov_46.509753	114	194	12	21	80	0.2625000
NODE_9778_length_868_cov_46.509753	114	194	13	10	80	0.1250000
NODE_9778_length_868_cov_46.509753	114	194	14	3	80	0.0375000
NODE_9778_length_868_cov_46.509753	114	194	15	11	80	0.1375000
NODE_9778_length_868_cov_46.509753	114	194	4	12	80	0.1500000
NODE_9778_length_868_cov_46.509753	114	194	6	1	80	0.0125000
NODE_9778_length_868_cov_46.509753	114	194	7	1	80	0.0125000
NODE_9778_length_868_cov_46.509753	114	194	8	2	80	0.0250000
NODE_9778_length_868_cov_46.509753	114	194	9	6	80	0.0750000
NODE_9778_length_868_cov_46.509753	114	194	10	4	80	0.0500000
NODE_9778_length_868_cov_46.509753	114	194	11	9	80	0.1125000
NODE_9778_length_868_cov_46.509753	114	194	12	21	80	0.2625000
NODE_9778_length_868_cov_46.509753	114	194	13	10	80	0.1250000
NODE_9778_length_868_cov_46.509753	114	194	14	3	80	0.0375000
NODE_9778_length_868_cov_46.509753	114	194	15	11	80	0.1375000
NODE_9779_length_868_cov_26.092328	318	398	0	66	80	0.8250000
NODE_9779_length_868_cov_26.092328	318	398	2	14	80	0.1750000
NODE_9779_length_868_cov_26.092328	371	451	0	80	80	1.0000000
NODE_9781_length_868_cov_22.555267	377	457	1	3	80	0.0375000
NODE_9781_length_868_cov_22.555267	377	457	2	56	80	0.7000000
NODE_9781_length_868_cov_22.555267	377	457	3	21	80	0.2625000
NODE_9781_length_868_cov_22.555267	430	510	2	60	80	0.7500000
NODE_9781_length_868_cov_22.555267	430	510	3	20	80	0.2500000
NODE_9782_length_868_cov_20.466840	259	339	0	80	80	1.0000000
NODE_9782_length_868_cov_20.466840	312	392	0	46	80	0.5750000
NODE_9782_length_868_cov_20.466840	312	392	2	34	80	0.4250000
NODE_9782_length_868_cov_20.466840	388	468	2	80	80	1.0000000
NODE_9782_length_868_cov_20.466840	441	521	0	23	80	0.2875000
NODE_9782_length_868_cov_20.466840	441	521	2	57	80	0.7125000
NODE_9783_length_868_cov_20.414824	311	391	3	56	80	0.7000000
NODE_9783_length_868_cov_20.414824	311	391	4	24	80	0.3000000
NODE_9783_length_868_cov_20.414824	364	444	2	7	80	0.0875000
NODE_9783_length_868_cov_20.414824	364	444	3	73	80	0.9125000
NODE_9784_length_868_cov_17.613784	340	420	0	56	80	0.7000000
NODE_9784_length_868_cov_17.613784	340	420	1	24	80	0.3000000
NODE_9784_length_868_cov_17.613784	393	473	0	31	80	0.3875000
NODE_9784_length_868_cov_17.613784	393	473	2	1	80	0.0125000
NODE_9784_length_868_cov_17.613784	393	473	3	48	80	0.6000000
NODE_9785_length_868_cov_15.768531	353	433	3	1	80	0.0125000
NODE_9785_length_868_cov_15.768531	353	433	4	35	80	0.4375000
NODE_9785_length_868_cov_15.768531	353	433	5	44	80	0.5500000
NODE_9785_length_868_cov_15.768531	406	486	0	46	80	0.5750000
NODE_9785_length_868_cov_15.768531	406	486	1	3	80	0.0375000
NODE_9785_length_868_cov_15.768531	406	486	4	31	80	0.3875000
NODE_9786_length_868_cov_13.997399	611	691	2	21	80	0.2625000
NODE_9786_length_868_cov_13.997399	611	691	3	13	80	0.1625000
NODE_9786_length_868_cov_13.997399	611	691	4	45	80	0.5625000
NODE_9786_length_868_cov_13.997399	611	691	5	1	80	0.0125000
NODE_9786_length_868_cov_13.997399	664	744	4	78	80	0.9750000
NODE_9786_length_868_cov_13.997399	664	744	5	2	80	0.0250000
NODE_9787_length_868_cov_13.224967	451	531	1	11	80	0.1375000
NODE_9787_length_868_cov_13.224967	451	531	2	69	80	0.8625000
NODE_9787_length_868_cov_13.224967	504	583	2	79	79	1.0000000
NODE_9788_length_868_cov_11.851756	363	422	0	59	59	1.0000000
NODE_9788_length_868_cov_11.851756	395	475	0	80	80	1.0000000
NODE_9789_length_868_cov_11.352406	361	441	0	80	80	1.0000000
NODE_9789_length_868_cov_11.352406	414	494	0	80	80	1.0000000
NODE_9790_length_868_cov_11.335501	289	369	1	80	80	1.0000000
NODE_9790_length_868_cov_11.335501	342	422	0	29	80	0.3625000
NODE_9790_length_868_cov_11.335501	342	422	1	51	80	0.6375000
NODE_9791_length_868_cov_8.455137	401	481	2	4	80	0.0500000
NODE_9791_length_868_cov_8.455137	401	481	3	41	80	0.5125000
NODE_9791_length_868_cov_8.455137	401	481	4	35	80	0.4375000
NODE_9791_length_868_cov_8.455137	454	534	2	27	80	0.3375000
NODE_9791_length_868_cov_8.455137	454	534	3	53	80	0.6625000
NODE_9816_length_867_cov_27.756510	333	376	0	43	43	1.0000000
NODE_9816_length_867_cov_27.756510	349	429	0	76	80	0.9500000
NODE_9816_length_867_cov_27.756510	349	429	1	4	80	0.0500000
NODE_9816_length_867_cov_27.756510	425	505	1	80	80	1.0000000
NODE_9816_length_867_cov_27.756510	478	542	1	63	64	0.9843750
NODE_9816_length_867_cov_27.756510	478	542	2	1	64	0.0156250
NODE_9817_length_867_cov_25.354167	280	345	0	65	65	1.0000000
NODE_9817_length_867_cov_25.354167	325	397	0	72	72	1.0000000
NODE_9818_length_867_cov_23.968750	369	449	2	80	80	1.0000000
NODE_9818_length_867_cov_23.968750	422	502	0	25	80	0.3125000
NODE_9818_length_867_cov_23.968750	422	502	2	55	80	0.6875000
NODE_9819_length_867_cov_21.220052	524	604	0	80	80	1.0000000
NODE_9819_length_867_cov_21.220052	577	657	0	80	80	1.0000000
NODE_9820_length_867_cov_15.042969	287	364	5	13	77	0.1688312
NODE_9820_length_867_cov_15.042969	287	364	6	28	77	0.3636364
NODE_9820_length_867_cov_15.042969	287	364	7	18	77	0.2337662
NODE_9820_length_867_cov_15.042969	287	364	8	5	77	0.0649351
NODE_9820_length_867_cov_15.042969	287	364	9	13	77	0.1688312
NODE_9821_length_867_cov_11.057292	305	373	0	52	68	0.7647059
NODE_9821_length_867_cov_11.057292	305	373	1	16	68	0.2352941
NODE_9821_length_867_cov_11.057292	346	426	0	11	80	0.1375000
NODE_9821_length_867_cov_11.057292	346	426	1	62	80	0.7750000
NODE_9821_length_867_cov_11.057292	346	426	2	3	80	0.0375000
NODE_9821_length_867_cov_11.057292	346	426	3	4	80	0.0500000
NODE_9821_length_867_cov_11.057292	475	555	3	14	80	0.1750000
NODE_9821_length_867_cov_11.057292	475	555	4	66	80	0.8250000
NODE_9822_length_867_cov_8.127604	347	427	0	80	80	1.0000000
NODE_9822_length_867_cov_8.127604	400	480	0	80	80	1.0000000
NODE_9823_length_867_cov_7.621094	292	372	2	6	80	0.0750000
NODE_9823_length_867_cov_7.621094	292	372	3	72	80	0.9000000
NODE_9823_length_867_cov_7.621094	292	372	4	2	80	0.0250000
NODE_9823_length_867_cov_7.621094	345	425	0	16	80	0.2000000
NODE_9823_length_867_cov_7.621094	345	425	2	32	80	0.4000000
NODE_9823_length_867_cov_7.621094	345	425	3	32	80	0.4000000
NODE_9826_length_867_cov_5.494792	445	525	0	80	80	1.0000000
NODE_9826_length_867_cov_5.494792	498	578	0	80	80	1.0000000
NODE_9857_length_866_cov_49.224250	269	349	0	11	80	0.1375000
NODE_9857_length_866_cov_49.224250	269	349	1	69	80	0.8625000
NODE_9857_length_866_cov_49.224250	322	402	1	58	80	0.7250000
NODE_9857_length_866_cov_49.224250	322	402	2	22	80	0.2750000
NODE_9858_length_866_cov_47.160365	428	508	2	13	80	0.1625000
NODE_9858_length_866_cov_47.160365	428	508	3	6	80	0.0750000
NODE_9858_length_866_cov_47.160365	428	508	4	6	80	0.0750000
NODE_9858_length_866_cov_47.160365	428	508	5	4	80	0.0500000
NODE_9858_length_866_cov_47.160365	428	508	6	6	80	0.0750000
NODE_9858_length_866_cov_47.160365	428	508	7	5	80	0.0625000
NODE_9858_length_866_cov_47.160365	428	508	9	19	80	0.2375000
NODE_9858_length_866_cov_47.160365	428	508	10	21	80	0.2625000
NODE_9858_length_866_cov_47.160365	481	561	7	5	80	0.0625000
NODE_9858_length_866_cov_47.160365	481	561	8	16	80	0.2000000
NODE_9858_length_866_cov_47.160365	481	561	9	6	80	0.0750000
NODE_9858_length_866_cov_47.160365	481	561	10	53	80	0.6625000
NODE_9858_length_866_cov_47.160365	557	637	1	24	80	0.3000000
NODE_9858_length_866_cov_47.160365	557	637	2	6	80	0.0750000
NODE_9858_length_866_cov_47.160365	557	637	3	4	80	0.0500000
NODE_9858_length_866_cov_47.160365	557	637	4	6	80	0.0750000
NODE_9858_length_866_cov_47.160365	557	637	5	6	80	0.0750000
NODE_9858_length_866_cov_47.160365	557	637	6	26	80	0.3250000
NODE_9858_length_866_cov_47.160365	557	637	7	8	80	0.1000000
NODE_9858_length_866_cov_47.160365	610	690	0	53	80	0.6625000
NODE_9858_length_866_cov_47.160365	610	690	1	24	80	0.3000000
NODE_9858_length_866_cov_47.160365	610	690	2	3	80	0.0375000
NODE_9859_length_866_cov_23.398957	281	361	0	21	80	0.2625000
NODE_9859_length_866_cov_23.398957	281	361	1	59	80	0.7375000
NODE_9859_length_866_cov_23.398957	334	414	0	47	80	0.5875000
NODE_9859_length_866_cov_23.398957	334	414	1	33	80	0.4125000
NODE_9860_length_866_cov_22.186441	455	535	0	80	80	1.0000000
NODE_9860_length_866_cov_22.186441	508	588	0	80	80	1.0000000
NODE_9861_length_866_cov_18.362451	451	531	0	80	80	1.0000000
NODE_9861_length_866_cov_18.362451	504	584	0	80	80	1.0000000
NODE_9862_length_866_cov_16.830508	372	452	3	38	80	0.4750000
NODE_9862_length_866_cov_16.830508	372	452	4	42	80	0.5250000
NODE_9862_length_866_cov_16.830508	425	505	1	47	80	0.5875000
NODE_9862_length_866_cov_16.830508	425	505	3	2	80	0.0250000
NODE_9862_length_866_cov_16.830508	425	505	4	31	80	0.3875000
NODE_9882_length_865_cov_63.137076	288	368	0	3	80	0.0375000
NODE_9882_length_865_cov_63.137076	288	368	1	77	80	0.9625000
NODE_9882_length_865_cov_63.137076	341	421	1	70	80	0.8750000
NODE_9882_length_865_cov_63.137076	341	421	2	10	80	0.1250000
NODE_9883_length_865_cov_19.882507	335	415	0	24	80	0.3000000
NODE_9883_length_865_cov_19.882507	335	415	1	4	80	0.0500000
NODE_9883_length_865_cov_19.882507	335	415	2	16	80	0.2000000
NODE_9883_length_865_cov_19.882507	335	415	3	12	80	0.1500000
NODE_9883_length_865_cov_19.882507	335	415	4	24	80	0.3000000
NODE_9883_length_865_cov_19.882507	388	468	0	66	80	0.8250000
NODE_9883_length_865_cov_19.882507	388	468	1	14	80	0.1750000
NODE_9884_length_865_cov_17.784595	306	386	3	80	80	1.0000000
NODE_9884_length_865_cov_17.784595	359	439	0	14	80	0.1750000
NODE_9884_length_865_cov_17.784595	359	439	1	11	80	0.1375000
NODE_9884_length_865_cov_17.784595	359	439	3	55	80	0.6875000
NODE_9885_length_865_cov_16.150131	451	531	0	80	80	1.0000000
NODE_9885_length_865_cov_16.150131	504	584	0	35	80	0.4375000
NODE_9885_length_865_cov_16.150131	504	584	2	45	80	0.5625000
NODE_9886_length_865_cov_14.751958	473	553	1	43	80	0.5375000
NODE_9886_length_865_cov_14.751958	473	553	2	37	80	0.4625000
NODE_9886_length_865_cov_14.751958	473	553	1	43	80	0.5375000
NODE_9886_length_865_cov_14.751958	473	553	2	37	80	0.4625000
NODE_9886_length_865_cov_14.751958	526	589	1	10	63	0.1587302
NODE_9886_length_865_cov_14.751958	526	589	2	53	63	0.8412699
NODE_9886_length_865_cov_14.751958	526	606	1	27	80	0.3375000
NODE_9886_length_865_cov_14.751958	526	606	2	53	80	0.6625000
NODE_9887_length_865_cov_10.937337	422	502	0	80	80	1.0000000
NODE_9887_length_865_cov_10.937337	475	555	0	80	80	1.0000000
NODE_9889_length_865_cov_9.167102	389	469	2	23	80	0.2875000
NODE_9889_length_865_cov_9.167102	389	469	3	42	80	0.5250000
NODE_9889_length_865_cov_9.167102	389	469	4	15	80	0.1875000
NODE_9889_length_865_cov_9.167102	442	522	2	55	80	0.6875000
NODE_9889_length_865_cov_9.167102	442	522	3	10	80	0.1250000
NODE_9889_length_865_cov_9.167102	442	522	4	15	80	0.1875000
NODE_9912_length_864_cov_13.398693	491	571	1	8	80	0.1000000
NODE_9912_length_864_cov_13.398693	491	571	2	38	80	0.4750000
NODE_9912_length_864_cov_13.398693	491	571	3	9	80	0.1125000
NODE_9912_length_864_cov_13.398693	491	571	5	25	80	0.3125000
NODE_9912_length_864_cov_13.398693	544	624	3	2	80	0.0250000
NODE_9912_length_864_cov_13.398693	544	624	4	12	80	0.1500000
NODE_9912_length_864_cov_13.398693	544	624	5	66	80	0.8250000
NODE_9913_length_864_cov_8.466667	308	388	2	80	80	1.0000000
NODE_9913_length_864_cov_8.466667	361	441	0	41	80	0.5125000
NODE_9913_length_864_cov_8.466667	361	441	2	39	80	0.4875000
NODE_9917_length_864_cov_3.947712	651	676	0	25	25	1.0000000
NODE_9917_length_864_cov_3.947712	725	805	5	24	80	0.3000000
NODE_9917_length_864_cov_3.947712	725	805	7	23	80	0.2875000
NODE_9917_length_864_cov_3.947712	725	805	9	33	80	0.4125000
NODE_9917_length_864_cov_3.947712	778	844	6	2	66	0.0303030
NODE_9917_length_864_cov_3.947712	778	844	7	46	66	0.6969697
NODE_9917_length_864_cov_3.947712	778	844	9	18	66	0.2727273
NODE_9931_length_863_cov_72.856021	241	321	3	75	80	0.9375000
NODE_9931_length_863_cov_72.856021	241	321	5	5	80	0.0625000
NODE_9931_length_863_cov_72.856021	294	374	3	22	80	0.2750000
NODE_9931_length_863_cov_72.856021	294	374	4	51	80	0.6375000
NODE_9931_length_863_cov_72.856021	294	374	5	5	80	0.0625000
NODE_9931_length_863_cov_72.856021	294	374	6	2	80	0.0250000
NODE_9931_length_863_cov_72.856021	370	450	4	2	80	0.0250000
NODE_9931_length_863_cov_72.856021	370	450	6	17	80	0.2125000
NODE_9931_length_863_cov_72.856021	370	450	7	3	80	0.0375000
NODE_9931_length_863_cov_72.856021	370	450	8	22	80	0.2750000
NODE_9931_length_863_cov_72.856021	370	450	11	8	80	0.1000000
NODE_9931_length_863_cov_72.856021	370	450	13	28	80	0.3500000
NODE_9931_length_863_cov_72.856021	423	503	11	37	80	0.4625000
NODE_9931_length_863_cov_72.856021	423	503	13	43	80	0.5375000
NODE_9932_length_863_cov_37.130890	363	443	0	28	80	0.3500000
NODE_9932_length_863_cov_37.130890	363	443	2	52	80	0.6500000
NODE_9932_length_863_cov_37.130890	416	496	2	53	80	0.6625000
NODE_9932_length_863_cov_37.130890	416	496	3	1	80	0.0125000
NODE_9932_length_863_cov_37.130890	416	496	4	15	80	0.1875000
NODE_9932_length_863_cov_37.130890	416	496	6	11	80	0.1375000
NODE_9932_length_863_cov_37.130890	492	572	6	77	80	0.9625000
NODE_9932_length_863_cov_37.130890	492	572	8	3	80	0.0375000
NODE_9932_length_863_cov_37.130890	545	617	4	39	72	0.5416667
NODE_9932_length_863_cov_37.130890	545	617	5	2	72	0.0277778
NODE_9932_length_863_cov_37.130890	545	617	6	30	72	0.4166667
NODE_9932_length_863_cov_37.130890	545	617	13	1	72	0.0138889
NODE_9933_length_863_cov_33.159686	287	367	1	80	80	1.0000000
NODE_9933_length_863_cov_33.159686	340	420	1	49	80	0.6125000
NODE_9933_length_863_cov_33.159686	340	420	2	31	80	0.3875000
NODE_9934_length_863_cov_24.714660	370	450	0	16	80	0.2000000
NODE_9934_length_863_cov_24.714660	370	450	1	64	80	0.8000000
NODE_9934_length_863_cov_24.714660	423	503	1	80	80	1.0000000
NODE_9935_length_863_cov_21.945026	341	421	0	80	80	1.0000000
NODE_9935_length_863_cov_21.945026	394	474	0	61	80	0.7625000
NODE_9935_length_863_cov_21.945026	394	474	1	19	80	0.2375000
NODE_9936_length_863_cov_19.794503	393	473	2	1	80	0.0125000
NODE_9936_length_863_cov_19.794503	393	473	3	67	80	0.8375000
NODE_9936_length_863_cov_19.794503	393	473	5	12	80	0.1500000
NODE_9936_length_863_cov_19.794503	446	526	2	54	80	0.6750000
NODE_9936_length_863_cov_19.794503	446	526	3	26	80	0.3250000
NODE_9937_length_863_cov_11.778796	303	383	0	4	80	0.0500000
NODE_9937_length_863_cov_11.778796	303	383	1	41	80	0.5125000
NODE_9937_length_863_cov_11.778796	303	383	2	35	80	0.4375000
NODE_9937_length_863_cov_11.778796	356	436	2	80	80	1.0000000
NODE_9938_length_863_cov_10.026178	283	363	0	33	80	0.4125000
NODE_9938_length_863_cov_10.026178	283	363	2	47	80	0.5875000
NODE_9938_length_863_cov_10.026178	336	416	0	25	80	0.3125000
NODE_9938_length_863_cov_10.026178	336	416	2	55	80	0.6875000
NODE_9957_length_862_cov_46.811271	272	352	4	9	80	0.1125000
NODE_9957_length_862_cov_46.811271	272	352	5	2	80	0.0250000
NODE_9957_length_862_cov_46.811271	272	352	6	17	80	0.2125000
NODE_9957_length_862_cov_46.811271	272	352	8	52	80	0.6500000
NODE_9957_length_862_cov_46.811271	325	405	4	9	80	0.1125000
NODE_9957_length_862_cov_46.811271	325	405	5	13	80	0.1625000
NODE_9957_length_862_cov_46.811271	325	405	6	28	80	0.3500000
NODE_9957_length_862_cov_46.811271	325	405	7	2	80	0.0250000
NODE_9957_length_862_cov_46.811271	325	405	9	7	80	0.0875000
NODE_9957_length_862_cov_46.811271	325	405	10	8	80	0.1000000
NODE_9957_length_862_cov_46.811271	325	405	11	13	80	0.1625000
NODE_9957_length_862_cov_46.811271	401	481	8	67	80	0.8375000
NODE_9957_length_862_cov_46.811271	401	481	9	2	80	0.0250000
NODE_9957_length_862_cov_46.811271	401	481	10	11	80	0.1375000
NODE_9957_length_862_cov_46.811271	454	534	3	7	80	0.0875000
NODE_9957_length_862_cov_46.811271	454	534	5	8	80	0.1000000
NODE_9957_length_862_cov_46.811271	454	534	6	26	80	0.3250000
NODE_9957_length_862_cov_46.811271	454	534	7	4	80	0.0500000
NODE_9957_length_862_cov_46.811271	454	534	8	35	80	0.4375000
NODE_9958_length_862_cov_34.638270	259	339	1	29	80	0.3625000
NODE_9958_length_862_cov_34.638270	259	339	2	49	80	0.6125000
NODE_9958_length_862_cov_34.638270	259	339	3	2	80	0.0250000
NODE_9958_length_862_cov_34.638270	312	392	2	44	80	0.5500000
NODE_9958_length_862_cov_34.638270	312	392	3	11	80	0.1375000
NODE_9958_length_862_cov_34.638270	312	392	4	25	80	0.3125000
NODE_9958_length_862_cov_34.638270	388	468	4	5	80	0.0625000
NODE_9958_length_862_cov_34.638270	388	468	5	11	80	0.1375000
NODE_9958_length_862_cov_34.638270	388	468	6	64	80	0.8000000
NODE_9958_length_862_cov_34.638270	441	521	0	7	80	0.0875000
NODE_9958_length_862_cov_34.638270	441	521	2	27	80	0.3375000
NODE_9958_length_862_cov_34.638270	441	521	3	4	80	0.0500000
NODE_9958_length_862_cov_34.638270	441	521	5	26	80	0.3250000
NODE_9958_length_862_cov_34.638270	441	521	6	16	80	0.2000000
NODE_9959_length_862_cov_32.068152	468	548	5	70	80	0.8750000
NODE_9959_length_862_cov_32.068152	468	548	6	10	80	0.1250000
NODE_9959_length_862_cov_32.068152	521	601	4	12	80	0.1500000
NODE_9959_length_862_cov_32.068152	521	601	5	34	80	0.4250000
NODE_9959_length_862_cov_32.068152	521	601	6	34	80	0.4250000
NODE_9960_length_862_cov_23.584535	526	606	2	10	80	0.1250000
NODE_9960_length_862_cov_23.584535	526	606	3	6	80	0.0750000
NODE_9960_length_862_cov_23.584535	526	606	5	14	80	0.1750000
NODE_9960_length_862_cov_23.584535	526	606	6	50	80	0.6250000
NODE_9960_length_862_cov_23.584535	579	659	2	2	80	0.0250000
NODE_9960_length_862_cov_23.584535	579	659	4	3	80	0.0375000
NODE_9960_length_862_cov_23.584535	579	659	5	20	80	0.2500000
NODE_9960_length_862_cov_23.584535	579	659	6	55	80	0.6875000
NODE_9961_length_862_cov_19.980341	347	427	0	39	80	0.4875000
NODE_9961_length_862_cov_19.980341	347	427	1	11	80	0.1375000
NODE_9961_length_862_cov_19.980341	347	427	2	30	80	0.3750000
NODE_9961_length_862_cov_19.980341	400	480	2	80	80	1.0000000
NODE_9962_length_862_cov_19.079948	379	459	1	10	80	0.1250000
NODE_9962_length_862_cov_19.079948	379	459	2	13	80	0.1625000
NODE_9962_length_862_cov_19.079948	379	459	4	57	80	0.7125000
NODE_9962_length_862_cov_19.079948	432	512	4	53	80	0.6625000
NODE_9962_length_862_cov_19.079948	432	512	5	27	80	0.3375000
NODE_9963_length_862_cov_18.425950	94	174	0	80	80	1.0000000
NODE_9963_length_862_cov_18.425950	147	201	0	54	54	1.0000000
NODE_9963_length_862_cov_18.425950	392	472	2	9	80	0.1125000
NODE_9963_length_862_cov_18.425950	392	472	4	10	80	0.1250000
NODE_9963_length_862_cov_18.425950	392	472	5	10	80	0.1250000
NODE_9963_length_862_cov_18.425950	392	472	6	8	80	0.1000000
NODE_9963_length_862_cov_18.425950	392	472	7	2	80	0.0250000
NODE_9963_length_862_cov_18.425950	392	472	8	41	80	0.5125000
NODE_9963_length_862_cov_18.425950	445	525	6	12	80	0.1500000
NODE_9963_length_862_cov_18.425950	445	525	7	11	80	0.1375000
NODE_9963_length_862_cov_18.425950	445	525	8	29	80	0.3625000
NODE_9963_length_862_cov_18.425950	445	525	9	28	80	0.3500000
NODE_9964_length_862_cov_11.740498	348	428	1	6	80	0.0750000
NODE_9964_length_862_cov_11.740498	348	428	2	55	80	0.6875000
NODE_9964_length_862_cov_11.740498	348	428	4	19	80	0.2375000
NODE_9964_length_862_cov_11.740498	401	481	2	8	80	0.1000000
NODE_9964_length_862_cov_11.740498	401	481	3	21	80	0.2625000
NODE_9964_length_862_cov_11.740498	401	481	4	51	80	0.6375000
NODE_9965_length_862_cov_11.685452	292	372	3	2	80	0.0250000
NODE_9965_length_862_cov_11.685452	292	372	4	78	80	0.9750000
NODE_9965_length_862_cov_11.685452	345	425	3	55	80	0.6875000
NODE_9965_length_862_cov_11.685452	345	425	4	25	80	0.3125000
NODE_9966_length_862_cov_8.259502	385	465	1	80	80	1.0000000
NODE_9966_length_862_cov_8.259502	438	518	0	40	80	0.5000000
NODE_9966_length_862_cov_8.259502	438	518	1	40	80	0.5000000
NODE_9970_length_862_cov_2.895151	388	468	0	80	80	1.0000000
NODE_9970_length_862_cov_2.895151	441	521	0	55	80	0.6875000
NODE_9970_length_862_cov_2.895151	441	521	1	25	80	0.3125000
NODE_9984_length_861_cov_52.679790	450	530	0	80	80	1.0000000
NODE_9984_length_861_cov_52.679790	503	583	0	80	80	1.0000000
NODE_9985_length_861_cov_34.868766	470	550	7	30	80	0.3750000
NODE_9985_length_861_cov_34.868766	470	550	8	20	80	0.2500000
NODE_9985_length_861_cov_34.868766	470	550	9	30	80	0.3750000
NODE_9985_length_861_cov_34.868766	523	603	3	12	80	0.1500000
NODE_9985_length_861_cov_34.868766	523	603	4	28	80	0.3500000
NODE_9985_length_861_cov_34.868766	523	603	5	2	80	0.0250000
NODE_9985_length_861_cov_34.868766	523	603	7	35	80	0.4375000
NODE_9985_length_861_cov_34.868766	523	603	8	3	80	0.0375000
NODE_9986_length_861_cov_25.622047	145	225	0	61	80	0.7625000
NODE_9986_length_861_cov_25.622047	145	225	1	19	80	0.2375000
NODE_9986_length_861_cov_25.622047	198	278	0	8	80	0.1000000
NODE_9986_length_861_cov_25.622047	198	278	1	72	80	0.9000000
NODE_9987_length_861_cov_22.052493	401	481	2	53	80	0.6625000
NODE_9987_length_861_cov_22.052493	401	481	3	27	80	0.3375000
NODE_9987_length_861_cov_22.052493	454	534	2	80	80	1.0000000
NODE_9988_length_861_cov_19.913386	400	480	1	36	80	0.4500000
NODE_9988_length_861_cov_19.913386	400	480	3	44	80	0.5500000
NODE_9988_length_861_cov_19.913386	453	533	3	80	80	1.0000000
NODE_9989_length_861_cov_15.237533	492	572	0	10	80	0.1250000
NODE_9989_length_861_cov_15.237533	492	572	1	70	80	0.8750000
NODE_9989_length_861_cov_15.237533	545	625	1	64	80	0.8000000
NODE_9989_length_861_cov_15.237533	545	625	2	16	80	0.2000000
NODE_9990_length_861_cov_12.460630	451	531	0	10	80	0.1250000
NODE_9990_length_861_cov_12.460630	451	531	2	70	80	0.8750000
NODE_9990_length_861_cov_12.460630	504	584	0	63	80	0.7875000
NODE_9990_length_861_cov_12.460630	504	584	2	17	80	0.2125000
NODE_9991_length_861_cov_9.463255	446	526	0	80	80	1.0000000
NODE_9991_length_861_cov_9.463255	499	579	0	80	80	1.0000000
NODE_9992_length_861_cov_9.435696	348	423	0	21	75	0.2800000
NODE_9992_length_861_cov_9.435696	348	423	2	54	75	0.7200000
NODE_9993_length_861_cov_7.009186	51	91	0	40	40	1.0000000
NODE_9993_length_861_cov_7.009186	185	265	1	24	80	0.3000000
NODE_9993_length_861_cov_7.009186	185	265	2	56	80	0.7000000
NODE_9993_length_861_cov_7.009186	238	318	1	5	80	0.0625000
NODE_9993_length_861_cov_7.009186	238	318	2	75	80	0.9375000
NODE_10019_length_860_cov_54.315375	245	325	1	80	80	1.0000000
NODE_10019_length_860_cov_54.315375	298	378	1	43	80	0.5375000
NODE_10019_length_860_cov_54.315375	298	378	2	5	80	0.0625000
NODE_10019_length_860_cov_54.315375	298	378	3	32	80	0.4000000
NODE_10019_length_860_cov_54.315375	374	454	2	70	80	0.8750000
NODE_10019_length_860_cov_54.315375	374	454	3	10	80	0.1250000
NODE_10019_length_860_cov_54.315375	427	507	0	6	80	0.0750000
NODE_10019_length_860_cov_54.315375	427	507	1	10	80	0.1250000
NODE_10019_length_860_cov_54.315375	427	507	2	64	80	0.8000000
NODE_10020_length_860_cov_29.618922	356	436	1	24	80	0.3000000
NODE_10020_length_860_cov_29.618922	356	436	2	56	80	0.7000000
NODE_10020_length_860_cov_29.618922	409	489	1	30	80	0.3750000
NODE_10020_length_860_cov_29.618922	409	489	2	50	80	0.6250000
NODE_10021_length_860_cov_15.152431	393	473	3	16	80	0.2000000
NODE_10021_length_860_cov_15.152431	393	473	4	47	80	0.5875000
NODE_10021_length_860_cov_15.152431	393	473	5	16	80	0.2000000
NODE_10021_length_860_cov_15.152431	393	473	6	1	80	0.0125000
NODE_10021_length_860_cov_15.152431	446	526	3	69	80	0.8625000
NODE_10021_length_860_cov_15.152431	446	526	5	11	80	0.1375000
NODE_10022_length_860_cov_11.320631	343	423	1	80	80	1.0000000
NODE_10022_length_860_cov_11.320631	396	476	0	29	80	0.3625000
NODE_10022_length_860_cov_11.320631	396	476	1	51	80	0.6375000
NODE_10049_length_859_cov_48.173684	432	512	4	37	80	0.4625000
NODE_10049_length_859_cov_48.173684	432	512	5	23	80	0.2875000
NODE_10049_length_859_cov_48.173684	432	512	6	20	80	0.2500000
NODE_10049_length_859_cov_48.173684	485	565	3	8	80	0.1000000
NODE_10049_length_859_cov_48.173684	485	565	4	5	80	0.0625000
NODE_10049_length_859_cov_48.173684	485	565	5	4	80	0.0500000
NODE_10049_length_859_cov_48.173684	485	565	6	63	80	0.7875000
NODE_10050_length_859_cov_24.957895	402	482	2	26	80	0.3250000
NODE_10050_length_859_cov_24.957895	402	482	4	54	80	0.6750000
NODE_10050_length_859_cov_24.957895	455	535	0	36	80	0.4500000
NODE_10050_length_859_cov_24.957895	455	535	2	18	80	0.2250000
NODE_10050_length_859_cov_24.957895	455	535	4	26	80	0.3250000
NODE_10051_length_859_cov_23.431579	251	331	0	28	80	0.3500000
NODE_10051_length_859_cov_23.431579	251	331	1	9	80	0.1125000
NODE_10051_length_859_cov_23.431579	251	331	2	36	80	0.4500000
NODE_10051_length_859_cov_23.431579	251	331	3	7	80	0.0875000
NODE_10051_length_859_cov_23.431579	304	384	2	20	80	0.2500000
NODE_10051_length_859_cov_23.431579	304	384	3	18	80	0.2250000
NODE_10051_length_859_cov_23.431579	304	384	4	33	80	0.4125000
NODE_10051_length_859_cov_23.431579	304	384	6	9	80	0.1125000
NODE_10052_length_859_cov_20.523684	341	421	1	2	80	0.0250000
NODE_10052_length_859_cov_20.523684	341	421	2	9	80	0.1125000
NODE_10052_length_859_cov_20.523684	341	421	3	64	80	0.8000000
NODE_10052_length_859_cov_20.523684	341	421	4	5	80	0.0625000
NODE_10052_length_859_cov_20.523684	394	474	0	48	80	0.6000000
NODE_10052_length_859_cov_20.523684	394	474	1	7	80	0.0875000
NODE_10052_length_859_cov_20.523684	394	474	2	9	80	0.1125000
NODE_10052_length_859_cov_20.523684	394	474	3	16	80	0.2000000
NODE_10053_length_859_cov_17.996053	316	396	1	22	80	0.2750000
NODE_10053_length_859_cov_17.996053	316	396	2	58	80	0.7250000
NODE_10053_length_859_cov_17.996053	369	449	2	80	80	1.0000000
NODE_10054_length_859_cov_16.757895	404	484	2	21	80	0.2625000
NODE_10054_length_859_cov_16.757895	404	484	4	37	80	0.4625000
NODE_10054_length_859_cov_16.757895	404	484	6	22	80	0.2750000
NODE_10054_length_859_cov_16.757895	457	537	4	5	80	0.0625000
NODE_10054_length_859_cov_16.757895	457	537	6	75	80	0.9375000
NODE_10055_length_859_cov_15.852632	346	426	3	12	80	0.1500000
NODE_10055_length_859_cov_15.852632	346	426	5	1	80	0.0125000
NODE_10055_length_859_cov_15.852632	346	426	6	67	80	0.8375000
NODE_10055_length_859_cov_15.852632	399	479	4	45	80	0.5625000
NODE_10055_length_859_cov_15.852632	399	479	6	35	80	0.4375000
NODE_10056_length_859_cov_11.584211	407	487	0	80	80	1.0000000
NODE_10056_length_859_cov_11.584211	460	540	0	80	80	1.0000000
NODE_10057_length_859_cov_10.296053	368	448	2	20	80	0.2500000
NODE_10057_length_859_cov_10.296053	368	448	3	60	80	0.7500000
NODE_10057_length_859_cov_10.296053	421	501	1	30	80	0.3750000
NODE_10057_length_859_cov_10.296053	421	501	2	23	80	0.2875000
NODE_10057_length_859_cov_10.296053	421	501	3	27	80	0.3375000
NODE_10066_length_859_cov_2.359211	498	578	0	29	80	0.3625000
NODE_10066_length_859_cov_2.359211	498	578	1	3	80	0.0375000
NODE_10066_length_859_cov_2.359211	498	578	2	48	80	0.6000000
NODE_10066_length_859_cov_2.359211	551	631	2	80	80	1.0000000
NODE_10079_length_858_cov_54.677207	277	357	4	80	80	1.0000000
NODE_10079_length_858_cov_54.677207	330	410	2	29	80	0.3625000
NODE_10079_length_858_cov_54.677207	330	410	4	51	80	0.6375000
NODE_10080_length_858_cov_40.584980	500	580	2	77	80	0.9625000
NODE_10080_length_858_cov_40.584980	500	580	3	3	80	0.0375000
NODE_10080_length_858_cov_40.584980	553	633	1	16	80	0.2000000
NODE_10080_length_858_cov_40.584980	553	633	2	59	80	0.7375000
NODE_10080_length_858_cov_40.584980	553	633	3	5	80	0.0625000
NODE_10081_length_858_cov_30.177866	363	443	6	7	80	0.0875000
NODE_10081_length_858_cov_30.177866	363	443	7	1	80	0.0125000
NODE_10081_length_858_cov_30.177866	363	443	9	18	80	0.2250000
NODE_10081_length_858_cov_30.177866	363	443	10	5	80	0.0625000
NODE_10081_length_858_cov_30.177866	363	443	11	15	80	0.1875000
NODE_10081_length_858_cov_30.177866	363	443	12	31	80	0.3875000
NODE_10081_length_858_cov_30.177866	363	443	13	3	80	0.0375000
NODE_10081_length_858_cov_30.177866	416	496	5	11	80	0.1375000
NODE_10081_length_858_cov_30.177866	416	496	6	33	80	0.4125000
NODE_10081_length_858_cov_30.177866	416	496	7	17	80	0.2125000
NODE_10081_length_858_cov_30.177866	416	496	10	5	80	0.0625000
NODE_10081_length_858_cov_30.177866	416	496	11	1	80	0.0125000
NODE_10081_length_858_cov_30.177866	416	496	12	13	80	0.1625000
NODE_10081_length_858_cov_30.177866	492	572	2	5	80	0.0625000
NODE_10081_length_858_cov_30.177866	492	572	4	18	80	0.2250000
NODE_10081_length_858_cov_30.177866	492	572	5	13	80	0.1625000
NODE_10081_length_858_cov_30.177866	492	572	6	14	80	0.1750000
NODE_10081_length_858_cov_30.177866	492	572	7	13	80	0.1625000
NODE_10081_length_858_cov_30.177866	492	572	8	17	80	0.2125000
NODE_10081_length_858_cov_30.177866	545	625	1	39	80	0.4875000
NODE_10081_length_858_cov_30.177866	545	625	2	19	80	0.2375000
NODE_10081_length_858_cov_30.177866	545	625	4	18	80	0.2250000
NODE_10081_length_858_cov_30.177866	545	625	5	4	80	0.0500000
NODE_10082_length_858_cov_18.534914	371	451	0	80	80	1.0000000
NODE_10082_length_858_cov_18.534914	424	504	0	80	80	1.0000000
NODE_10083_length_858_cov_15.378129	232	312	0	80	80	1.0000000
NODE_10083_length_858_cov_15.378129	285	365	0	80	80	1.0000000
NODE_10084_length_858_cov_12.310935	335	415	1	80	80	1.0000000
NODE_10084_length_858_cov_12.310935	388	468	1	65	80	0.8125000
NODE_10084_length_858_cov_12.310935	388	468	2	15	80	0.1875000
NODE_10085_length_858_cov_7.835310	396	479	0	83	83	1.0000000
NODE_10085_length_858_cov_7.835310	452	532	0	80	80	1.0000000
NODE_10088_length_858_cov_4.953887	474	554	0	26	80	0.3250000
NODE_10088_length_858_cov_4.953887	474	554	1	28	80	0.3500000
NODE_10088_length_858_cov_4.953887	474	554	2	26	80	0.3250000
NODE_10088_length_858_cov_4.953887	527	607	1	1	80	0.0125000
NODE_10088_length_858_cov_4.953887	527	607	2	79	80	0.9875000
NODE_10091_length_858_cov_3.475626	428	502	1	22	74	0.2972973
NODE_10091_length_858_cov_3.475626	428	502	2	12	74	0.1621622
NODE_10091_length_858_cov_3.475626	428	502	3	40	74	0.5405405
NODE_10091_length_858_cov_3.475626	498	578	1	18	80	0.2250000
NODE_10091_length_858_cov_3.475626	498	578	2	15	80	0.1875000
NODE_10091_length_858_cov_3.475626	498	578	3	47	80	0.5875000
NODE_10091_length_858_cov_3.475626	551	631	2	25	80	0.3125000
NODE_10091_length_858_cov_3.475626	551	631	3	30	80	0.3750000
NODE_10091_length_858_cov_3.475626	551	631	4	2	80	0.0250000
NODE_10091_length_858_cov_3.475626	551	631	5	23	80	0.2875000
NODE_10108_length_857_cov_33.449868	384	455	1	4	71	0.0563380
NODE_10108_length_857_cov_33.449868	384	455	2	62	71	0.8732395
NODE_10108_length_857_cov_33.449868	384	455	3	5	71	0.0704225
NODE_10108_length_857_cov_33.449868	437	518	1	11	81	0.1358025
NODE_10108_length_857_cov_33.449868	437	518	2	52	81	0.6419753
NODE_10108_length_857_cov_33.449868	437	518	3	18	81	0.2222222
NODE_10109_length_857_cov_32.527704	391	471	7	2	80	0.0250000
NODE_10109_length_857_cov_32.527704	391	471	8	22	80	0.2750000
NODE_10109_length_857_cov_32.527704	391	471	9	56	80	0.7000000
NODE_10109_length_857_cov_32.527704	444	524	6	22	80	0.2750000
NODE_10109_length_857_cov_32.527704	444	524	7	33	80	0.4125000
NODE_10109_length_857_cov_32.527704	444	524	9	25	80	0.3125000
NODE_10110_length_857_cov_27.853562	310	390	0	80	80	1.0000000
NODE_10110_length_857_cov_27.853562	363	443	0	80	80	1.0000000
NODE_10111_length_857_cov_24.654354	282	362	0	80	80	1.0000000
NODE_10111_length_857_cov_24.654354	335	415	0	80	80	1.0000000
NODE_10112_length_857_cov_22.604222	374	456	2	54	82	0.6585366
NODE_10112_length_857_cov_22.604222	374	456	4	17	82	0.2073171
NODE_10112_length_857_cov_22.604222	374	456	6	11	82	0.1341463
NODE_10112_length_857_cov_22.604222	427	509	2	1	82	0.0121951
NODE_10112_length_857_cov_22.604222	427	509	4	38	82	0.4634146
NODE_10112_length_857_cov_22.604222	427	509	6	43	82	0.5243902
NODE_10113_length_857_cov_17.399736	320	400	4	18	80	0.2250000
NODE_10113_length_857_cov_17.399736	320	400	6	62	80	0.7750000
NODE_10113_length_857_cov_17.399736	373	453	2	26	80	0.3250000
NODE_10113_length_857_cov_17.399736	373	453	6	54	80	0.6750000
NODE_10114_length_857_cov_17.069921	388	468	0	80	80	1.0000000
NODE_10114_length_857_cov_17.069921	441	521	0	80	80	1.0000000
NODE_10115_length_857_cov_11.816623	433	513	0	68	80	0.8500000
NODE_10115_length_857_cov_11.816623	433	513	1	12	80	0.1500000
NODE_10115_length_857_cov_11.816623	486	566	0	80	80	1.0000000
NODE_10116_length_857_cov_6.733509	513	593	0	38	80	0.4750000
NODE_10116_length_857_cov_6.733509	513	593	2	42	80	0.5250000
NODE_10117_length_857_cov_6.251979	298	378	2	19	80	0.2375000
NODE_10117_length_857_cov_6.251979	298	378	3	61	80	0.7625000
NODE_10117_length_857_cov_6.251979	351	431	1	2	80	0.0250000
NODE_10117_length_857_cov_6.251979	351	431	2	31	80	0.3875000
NODE_10117_length_857_cov_6.251979	351	431	3	47	80	0.5875000
NODE_10118_length_857_cov_5.827177	323	403	1	27	80	0.3375000
NODE_10118_length_857_cov_5.827177	323	403	2	53	80	0.6625000
NODE_10118_length_857_cov_5.827177	376	456	1	33	80	0.4125000
NODE_10118_length_857_cov_5.827177	376	456	2	47	80	0.5875000
NODE_10120_length_857_cov_4.530343	362	442	1	80	80	1.0000000
NODE_10120_length_857_cov_4.530343	415	495	0	27	80	0.3375000
NODE_10120_length_857_cov_4.530343	415	495	1	53	80	0.6625000
NODE_10128_length_857_cov_1.464380	179	249	1	70	70	1.0000000
NODE_10128_length_857_cov_1.464380	222	288	1	32	66	0.4848485
NODE_10128_length_857_cov_1.464380	222	288	2	9	66	0.1363636
NODE_10128_length_857_cov_1.464380	222	288	3	25	66	0.3787879
NODE_10138_length_856_cov_39.147952	157	237	1	5	80	0.0625000
NODE_10138_length_856_cov_39.147952	157	237	2	58	80	0.7250000
NODE_10138_length_856_cov_39.147952	157	237	3	17	80	0.2125000
NODE_10138_length_856_cov_39.147952	210	290	2	10	80	0.1250000
NODE_10138_length_856_cov_39.147952	210	290	3	57	80	0.7125000
NODE_10138_length_856_cov_39.147952	210	290	4	13	80	0.1625000
NODE_10138_length_856_cov_39.147952	286	366	2	54	80	0.6750000
NODE_10138_length_856_cov_39.147952	286	366	3	26	80	0.3250000
NODE_10138_length_856_cov_39.147952	339	419	0	1	80	0.0125000
NODE_10138_length_856_cov_39.147952	339	419	1	46	80	0.5750000
NODE_10138_length_856_cov_39.147952	339	419	2	33	80	0.4125000
NODE_10139_length_856_cov_21.937913	353	433	2	1	80	0.0125000
NODE_10139_length_856_cov_21.937913	353	433	3	79	80	0.9875000
NODE_10139_length_856_cov_21.937913	406	486	1	10	80	0.1250000
NODE_10139_length_856_cov_21.937913	406	486	2	44	80	0.5500000
NODE_10139_length_856_cov_21.937913	406	486	3	26	80	0.3250000
NODE_10140_length_856_cov_20.227213	375	459	1	7	84	0.0833333
NODE_10140_length_856_cov_20.227213	375	459	2	77	84	0.9166667
NODE_10140_length_856_cov_20.227213	432	512	2	80	80	1.0000000
NODE_10141_length_856_cov_18.445178	340	420	1	1	80	0.0125000
NODE_10141_length_856_cov_18.445178	340	420	2	32	80	0.4000000
NODE_10141_length_856_cov_18.445178	340	420	3	47	80	0.5875000
NODE_10141_length_856_cov_18.445178	393	473	1	1	80	0.0125000
NODE_10141_length_856_cov_18.445178	393	473	3	79	80	0.9875000
NODE_10142_length_856_cov_16.564069	462	543	4	81	81	1.0000000
NODE_10142_length_856_cov_16.564069	516	596	1	16	80	0.2000000
NODE_10142_length_856_cov_16.564069	516	596	2	24	80	0.3000000
NODE_10142_length_856_cov_16.564069	516	596	4	40	80	0.5000000
NODE_10142_length_856_cov_16.564069	516	593	1	13	77	0.1688312
NODE_10142_length_856_cov_16.564069	516	593	2	24	77	0.3116883
NODE_10142_length_856_cov_16.564069	516	593	4	40	77	0.5194805
NODE_10143_length_856_cov_15.803170	403	483	0	41	80	0.5125000
NODE_10143_length_856_cov_15.803170	403	483	2	39	80	0.4875000
NODE_10143_length_856_cov_15.803170	456	536	2	80	80	1.0000000
NODE_10144_length_856_cov_12.904888	345	425	0	10	80	0.1250000
NODE_10144_length_856_cov_12.904888	345	425	1	70	80	0.8750000
NODE_10144_length_856_cov_12.904888	398	478	1	29	80	0.3625000
NODE_10144_length_856_cov_12.904888	398	478	2	51	80	0.6375000
NODE_10145_length_856_cov_9.881110	338	418	0	80	80	1.0000000
NODE_10145_length_856_cov_9.881110	391	471	0	34	80	0.4250000
NODE_10145_length_856_cov_9.881110	391	471	2	46	80	0.5750000
NODE_10146_length_856_cov_5.875826	405	485	0	1	80	0.0125000
NODE_10146_length_856_cov_5.875826	405	485	1	79	80	0.9875000
NODE_10146_length_856_cov_5.875826	458	538	0	1	80	0.0125000
NODE_10146_length_856_cov_5.875826	458	538	1	79	80	0.9875000
NODE_10149_length_856_cov_4.821664	466	546	0	80	80	1.0000000
NODE_10149_length_856_cov_4.821664	519	599	0	80	80	1.0000000
NODE_10151_length_856_cov_4.195509	248	328	0	80	80	1.0000000
NODE_10151_length_856_cov_4.195509	301	381	0	80	80	1.0000000
NODE_10152_length_856_cov_3.899604	262	339	1	76	77	0.9870130
NODE_10152_length_856_cov_3.899604	262	339	2	1	77	0.0129870
NODE_10152_length_856_cov_3.899604	312	392	0	8	80	0.1000000
NODE_10152_length_856_cov_3.899604	312	392	1	72	80	0.9000000
NODE_10176_length_855_cov_28.312169	541	621	2	48	80	0.6000000
NODE_10176_length_855_cov_28.312169	541	621	3	32	80	0.4000000
NODE_10176_length_855_cov_28.312169	594	674	2	22	80	0.2750000
NODE_10176_length_855_cov_28.312169	594	674	3	48	80	0.6000000
NODE_10176_length_855_cov_28.312169	594	674	4	10	80	0.1250000
NODE_10177_length_855_cov_19.392857	692	772	1	40	80	0.5000000
NODE_10177_length_855_cov_19.392857	692	772	2	40	80	0.5000000
NODE_10177_length_855_cov_19.392857	745	825	0	15	80	0.1875000
NODE_10177_length_855_cov_19.392857	745	825	1	65	80	0.8125000
NODE_10178_length_855_cov_13.402116	343	423	0	26	80	0.3250000
NODE_10178_length_855_cov_13.402116	343	423	2	54	80	0.6750000
NODE_10178_length_855_cov_13.402116	396	476	0	12	80	0.1500000
NODE_10178_length_855_cov_13.402116	396	476	2	68	80	0.8500000
NODE_10179_length_855_cov_13.116402	295	375	1	12	80	0.1500000
NODE_10179_length_855_cov_13.116402	295	375	3	27	80	0.3375000
NODE_10179_length_855_cov_13.116402	295	375	4	12	80	0.1500000
NODE_10179_length_855_cov_13.116402	295	375	5	29	80	0.3625000
NODE_10179_length_855_cov_13.116402	348	428	2	9	80	0.1125000
NODE_10179_length_855_cov_13.116402	348	428	4	13	80	0.1625000
NODE_10179_length_855_cov_13.116402	348	428	5	58	80	0.7250000
NODE_10180_length_855_cov_11.179894	360	436	4	16	76	0.2105263
NODE_10180_length_855_cov_11.179894	360	436	5	42	76	0.5526316
NODE_10180_length_855_cov_11.179894	360	436	6	18	76	0.2368421
NODE_10180_length_855_cov_11.179894	409	489	2	14	80	0.1750000
NODE_10180_length_855_cov_11.179894	409	489	3	2	80	0.0250000
NODE_10180_length_855_cov_11.179894	409	489	4	6	80	0.0750000
NODE_10180_length_855_cov_11.179894	409	489	5	17	80	0.2125000
NODE_10180_length_855_cov_11.179894	409	489	6	41	80	0.5125000
NODE_10183_length_855_cov_8.593915	339	419	2	80	80	1.0000000
NODE_10183_length_855_cov_8.593915	392	472	0	4	80	0.0500000
NODE_10183_length_855_cov_8.593915	392	472	1	30	80	0.3750000
NODE_10183_length_855_cov_8.593915	392	472	2	46	80	0.5750000
NODE_10206_length_854_cov_64.200000	586	666	3	18	80	0.2250000
NODE_10206_length_854_cov_64.200000	586	666	4	5	80	0.0625000
NODE_10206_length_854_cov_64.200000	586	666	5	3	80	0.0375000
NODE_10206_length_854_cov_64.200000	586	666	6	29	80	0.3625000
NODE_10206_length_854_cov_64.200000	586	666	7	11	80	0.1375000
NODE_10206_length_854_cov_64.200000	586	666	8	14	80	0.1750000
NODE_10206_length_854_cov_64.200000	639	719	6	15	80	0.1875000
NODE_10206_length_854_cov_64.200000	639	719	7	22	80	0.2750000
NODE_10206_length_854_cov_64.200000	639	719	8	43	80	0.5375000
NODE_10207_length_854_cov_46.037086	348	428	1	2	80	0.0250000
NODE_10207_length_854_cov_46.037086	348	428	3	1	80	0.0125000
NODE_10207_length_854_cov_46.037086	348	428	4	9	80	0.1125000
NODE_10207_length_854_cov_46.037086	348	428	5	68	80	0.8500000
NODE_10207_length_854_cov_46.037086	401	481	4	7	80	0.0875000
NODE_10207_length_854_cov_46.037086	401	481	5	22	80	0.2750000
NODE_10207_length_854_cov_46.037086	401	481	6	51	80	0.6375000
NODE_10207_length_854_cov_46.037086	458	481	6	23	23	1.0000000
NODE_10208_length_854_cov_45.633113	393	473	0	2	80	0.0250000
NODE_10208_length_854_cov_45.633113	393	473	2	78	80	0.9750000
NODE_10208_length_854_cov_45.633113	446	526	2	37	80	0.4625000
NODE_10208_length_854_cov_45.633113	446	526	3	43	80	0.5375000
NODE_10209_length_854_cov_40.407947	489	569	4	15	80	0.1875000
NODE_10209_length_854_cov_40.407947	489	569	5	11	80	0.1375000
NODE_10209_length_854_cov_40.407947	489	569	6	44	80	0.5500000
NODE_10209_length_854_cov_40.407947	489	569	7	10	80	0.1250000
NODE_10209_length_854_cov_40.407947	542	622	4	18	80	0.2250000
NODE_10209_length_854_cov_40.407947	542	622	6	52	80	0.6500000
NODE_10209_length_854_cov_40.407947	542	622	7	10	80	0.1250000
NODE_10210_length_854_cov_29.773510	450	530	0	2	80	0.0250000
NODE_10210_length_854_cov_29.773510	450	530	2	8	80	0.1000000
NODE_10210_length_854_cov_29.773510	450	530	4	70	80	0.8750000
NODE_10210_length_854_cov_29.773510	503	583	2	19	80	0.2375000
NODE_10210_length_854_cov_29.773510	503	583	4	61	80	0.7625000
NODE_10211_length_854_cov_22.968212	318	398	0	13	80	0.1625000
NODE_10211_length_854_cov_22.968212	318	398	1	67	80	0.8375000
NODE_10211_length_854_cov_22.968212	371	451	1	27	80	0.3375000
NODE_10211_length_854_cov_22.968212	371	451	2	53	80	0.6625000
NODE_10212_length_854_cov_18.038411	387	467	2	64	80	0.8000000
NODE_10212_length_854_cov_18.038411	387	467	3	16	80	0.2000000
NODE_10212_length_854_cov_18.038411	440	520	2	80	80	1.0000000
NODE_10213_length_854_cov_13.774834	330	410	0	9	80	0.1125000
NODE_10213_length_854_cov_13.774834	330	410	1	71	80	0.8875000
NODE_10213_length_854_cov_13.774834	383	463	0	62	80	0.7750000
NODE_10213_length_854_cov_13.774834	383	463	1	18	80	0.2250000
NODE_10214_length_854_cov_11.998675	366	446	1	16	80	0.2000000
NODE_10214_length_854_cov_11.998675	366	446	2	64	80	0.8000000
NODE_10214_length_854_cov_11.998675	419	499	1	28	80	0.3500000
NODE_10214_length_854_cov_11.998675	419	499	2	52	80	0.6500000
NODE_10215_length_854_cov_7.600000	298	378	1	9	80	0.1125000
NODE_10215_length_854_cov_7.600000	298	378	3	8	80	0.1000000
NODE_10215_length_854_cov_7.600000	298	378	4	10	80	0.1250000
NODE_10215_length_854_cov_7.600000	298	378	5	53	80	0.6625000
NODE_10215_length_854_cov_7.600000	351	431	2	9	80	0.1125000
NODE_10215_length_854_cov_7.600000	351	431	4	54	80	0.6750000
NODE_10215_length_854_cov_7.600000	351	431	5	17	80	0.2125000
NODE_10218_length_854_cov_4.939073	603	633	0	5	30	0.1666667
NODE_10218_length_854_cov_4.939073	603	633	1	5	30	0.1666667
NODE_10218_length_854_cov_4.939073	603	633	3	20	30	0.6666667
NODE_10226_length_854_cov_2.354967	613	633	0	20	20	1.0000000
NODE_10239_length_853_cov_61.988064	380	460	7	4	80	0.0500000
NODE_10239_length_853_cov_61.988064	380	460	8	11	80	0.1375000
NODE_10239_length_853_cov_61.988064	380	460	11	1	80	0.0125000
NODE_10239_length_853_cov_61.988064	380	460	12	2	80	0.0250000
NODE_10239_length_853_cov_61.988064	380	460	13	3	80	0.0375000
NODE_10239_length_853_cov_61.988064	380	460	14	6	80	0.0750000
NODE_10239_length_853_cov_61.988064	380	460	15	3	80	0.0375000
NODE_10239_length_853_cov_61.988064	380	460	16	12	80	0.1500000
NODE_10239_length_853_cov_61.988064	380	460	17	11	80	0.1375000
NODE_10239_length_853_cov_61.988064	380	460	18	4	80	0.0500000
NODE_10239_length_853_cov_61.988064	380	460	19	16	80	0.2000000
NODE_10239_length_853_cov_61.988064	380	460	21	4	80	0.0500000
NODE_10239_length_853_cov_61.988064	380	460	22	2	80	0.0250000
NODE_10239_length_853_cov_61.988064	380	460	25	1	80	0.0125000
NODE_10239_length_853_cov_61.988064	433	513	17	1	80	0.0125000
NODE_10239_length_853_cov_61.988064	433	513	18	6	80	0.0750000
NODE_10239_length_853_cov_61.988064	433	513	19	22	80	0.2750000
NODE_10239_length_853_cov_61.988064	433	513	21	4	80	0.0500000
NODE_10239_length_853_cov_61.988064	433	513	22	4	80	0.0500000
NODE_10239_length_853_cov_61.988064	433	513	23	9	80	0.1125000
NODE_10239_length_853_cov_61.988064	433	513	24	17	80	0.2125000
NODE_10239_length_853_cov_61.988064	433	513	25	17	80	0.2125000
NODE_10240_length_853_cov_33.683024	384	464	0	80	80	1.0000000
NODE_10240_length_853_cov_33.683024	437	517	0	80	80	1.0000000
NODE_10241_length_853_cov_31.965517	224	305	0	81	81	1.0000000
NODE_10241_length_853_cov_31.965517	278	358	0	80	80	1.0000000
NODE_10241_length_853_cov_31.965517	354	434	0	80	80	1.0000000
NODE_10241_length_853_cov_31.965517	407	466	0	59	59	1.0000000
NODE_10242_length_853_cov_16.551724	247	327	0	80	80	1.0000000
NODE_10242_length_853_cov_16.551724	300	380	0	80	80	1.0000000
NODE_10242_length_853_cov_16.551724	376	456	0	80	80	1.0000000
NODE_10242_length_853_cov_16.551724	429	509	0	80	80	1.0000000
NODE_10243_length_853_cov_15.395225	395	475	1	7	80	0.0875000
NODE_10243_length_853_cov_15.395225	395	475	2	73	80	0.9125000
NODE_10243_length_853_cov_15.395225	448	528	1	53	80	0.6625000
NODE_10243_length_853_cov_15.395225	448	528	2	27	80	0.3375000
NODE_10244_length_853_cov_15.086207	355	434	0	79	79	1.0000000
NODE_10244_length_853_cov_15.086207	408	488	0	80	80	1.0000000
NODE_10245_length_853_cov_14.929708	160	240	0	80	80	1.0000000
NODE_10245_length_853_cov_14.929708	213	293	0	80	80	1.0000000
NODE_10246_length_853_cov_11.299735	395	475	2	80	80	1.0000000
NODE_10246_length_853_cov_11.299735	448	528	0	37	80	0.4625000
NODE_10246_length_853_cov_11.299735	448	528	1	13	80	0.1625000
NODE_10246_length_853_cov_11.299735	448	528	2	30	80	0.3750000
NODE_10247_length_853_cov_9.571618	479	559	0	80	80	1.0000000
NODE_10247_length_853_cov_9.571618	532	612	0	80	80	1.0000000
NODE_10248_length_853_cov_7.828912	265	345	1	58	80	0.7250000
NODE_10248_length_853_cov_7.828912	265	345	2	22	80	0.2750000
NODE_10248_length_853_cov_7.828912	318	398	0	27	80	0.3375000
NODE_10248_length_853_cov_7.828912	318	398	1	53	80	0.6625000
NODE_10249_length_853_cov_7.623342	255	335	0	80	80	1.0000000
NODE_10249_length_853_cov_7.623342	308	388	0	80	80	1.0000000
NODE_10253_length_853_cov_3.173740	212	292	0	10	80	0.1250000
NODE_10253_length_853_cov_3.173740	212	292	1	70	80	0.8750000
NODE_10253_length_853_cov_3.173740	265	343	1	78	78	1.0000000
NODE_10258_length_853_cov_1.823607	710	773	0	63	63	1.0000000
NODE_10258_length_853_cov_1.823607	711	773	0	62	62	1.0000000
NODE_10258_length_853_cov_1.823607	711	773	0	62	62	1.0000000
NODE_10258_length_853_cov_1.823607	746	826	0	80	80	1.0000000
NODE_10267_length_852_cov_30.022576	279	359	4	32	80	0.4000000
NODE_10267_length_852_cov_30.022576	279	359	5	48	80	0.6000000
NODE_10267_length_852_cov_30.022576	332	412	3	13	80	0.1625000
NODE_10267_length_852_cov_30.022576	332	412	4	7	80	0.0875000
NODE_10267_length_852_cov_30.022576	332	412	5	47	80	0.5875000
NODE_10267_length_852_cov_30.022576	332	412	6	13	80	0.1625000
NODE_10268_length_852_cov_19.373174	353	433	1	80	80	1.0000000
NODE_10268_length_852_cov_19.373174	406	486	0	38	80	0.4750000
NODE_10268_length_852_cov_19.373174	406	486	1	42	80	0.5250000
NODE_10269_length_852_cov_18.853918	297	377	4	80	80	1.0000000
NODE_10269_length_852_cov_18.853918	350	430	0	26	80	0.3250000
NODE_10269_length_852_cov_18.853918	350	430	1	1	80	0.0125000
NODE_10269_length_852_cov_18.853918	350	430	2	4	80	0.0500000
NODE_10269_length_852_cov_18.853918	350	430	3	6	80	0.0750000
NODE_10269_length_852_cov_18.853918	350	430	4	43	80	0.5375000
NODE_10269_length_852_cov_18.853918	426	506	0	80	80	1.0000000
NODE_10269_length_852_cov_18.853918	489	559	0	70	70	1.0000000
NODE_10270_length_852_cov_17.391766	472	552	3	80	80	1.0000000
NODE_10270_length_852_cov_17.391766	525	605	2	24	80	0.3000000
NODE_10270_length_852_cov_17.391766	525	605	3	56	80	0.7000000
NODE_10271_length_852_cov_8.818061	513	593	0	80	80	1.0000000
NODE_10271_length_852_cov_8.818061	566	646	0	80	80	1.0000000
NODE_10274_length_852_cov_4.403718	493	573	0	80	80	1.0000000
NODE_10274_length_852_cov_4.403718	546	626	0	80	80	1.0000000
NODE_10285_length_851_cov_33.953457	329	409	0	6	80	0.0750000
NODE_10285_length_851_cov_33.953457	329	409	2	74	80	0.9250000
NODE_10285_length_851_cov_33.953457	382	462	0	59	80	0.7375000
NODE_10285_length_851_cov_33.953457	382	462	2	21	80	0.2625000
NODE_10286_length_851_cov_30.488032	395	475	3	26	80	0.3250000
NODE_10286_length_851_cov_30.488032	395	475	4	18	80	0.2250000
NODE_10286_length_851_cov_30.488032	395	475	6	7	80	0.0875000
NODE_10286_length_851_cov_30.488032	395	475	7	29	80	0.3625000
NODE_10286_length_851_cov_30.488032	448	528	5	28	80	0.3500000
NODE_10286_length_851_cov_30.488032	448	528	6	32	80	0.4000000
NODE_10286_length_851_cov_30.488032	448	528	7	20	80	0.2500000
NODE_10287_length_851_cov_27.481383	353	433	6	7	80	0.0875000
NODE_10287_length_851_cov_27.481383	353	433	7	73	80	0.9125000
NODE_10287_length_851_cov_27.481383	406	486	3	2	80	0.0250000
NODE_10287_length_851_cov_27.481383	406	486	4	8	80	0.1000000
NODE_10287_length_851_cov_27.481383	406	486	5	10	80	0.1250000
NODE_10287_length_851_cov_27.481383	406	486	6	13	80	0.1625000
NODE_10287_length_851_cov_27.481383	406	486	7	47	80	0.5875000
NODE_10288_length_851_cov_23.656915	345	425	0	46	80	0.5750000
NODE_10288_length_851_cov_23.656915	345	425	2	34	80	0.4250000
NODE_10288_length_851_cov_23.656915	398	478	0	2	80	0.0250000
NODE_10288_length_851_cov_23.656915	398	478	2	78	80	0.9750000
NODE_10289_length_851_cov_19.769947	298	378	1	80	80	1.0000000
NODE_10289_length_851_cov_19.769947	351	431	1	60	80	0.7500000
NODE_10289_length_851_cov_19.769947	351	431	2	20	80	0.2500000
NODE_10290_length_851_cov_17.386968	459	539	1	80	80	1.0000000
NODE_10290_length_851_cov_17.386968	512	592	1	80	80	1.0000000
NODE_10291_length_851_cov_13.519947	323	403	0	74	80	0.9250000
NODE_10291_length_851_cov_13.519947	323	403	1	6	80	0.0750000
NODE_10291_length_851_cov_13.519947	376	456	0	21	80	0.2625000
NODE_10291_length_851_cov_13.519947	376	456	1	59	80	0.7375000
NODE_10292_length_851_cov_11.771277	403	483	2	5	80	0.0625000
NODE_10292_length_851_cov_11.771277	403	483	4	75	80	0.9375000
NODE_10292_length_851_cov_11.771277	456	536	0	49	80	0.6125000
NODE_10292_length_851_cov_11.771277	456	536	2	9	80	0.1125000
NODE_10292_length_851_cov_11.771277	456	536	4	22	80	0.2750000
NODE_10293_length_851_cov_11.698138	227	307	0	11	80	0.1375000
NODE_10293_length_851_cov_11.698138	227	307	1	50	80	0.6250000
NODE_10293_length_851_cov_11.698138	227	307	2	19	80	0.2375000
NODE_10293_length_851_cov_11.698138	280	360	1	8	80	0.1000000
NODE_10293_length_851_cov_11.698138	280	360	2	35	80	0.4375000
NODE_10293_length_851_cov_11.698138	280	360	4	26	80	0.3250000
NODE_10293_length_851_cov_11.698138	280	360	5	11	80	0.1375000
NODE_10293_length_851_cov_11.698138	356	436	4	28	80	0.3500000
NODE_10293_length_851_cov_11.698138	356	436	5	10	80	0.1250000
NODE_10293_length_851_cov_11.698138	356	436	6	20	80	0.2500000
NODE_10293_length_851_cov_11.698138	356	436	7	22	80	0.2750000
NODE_10293_length_851_cov_11.698138	409	489	3	51	80	0.6375000
NODE_10293_length_851_cov_11.698138	409	489	4	29	80	0.3625000
NODE_10294_length_851_cov_11.672872	372	452	0	80	80	1.0000000
NODE_10294_length_851_cov_11.672872	425	505	0	80	80	1.0000000
NODE_10295_length_851_cov_10.938830	418	499	1	3	81	0.0370370
NODE_10295_length_851_cov_10.938830	418	499	2	61	81	0.7530864
NODE_10295_length_851_cov_10.938830	418	499	3	17	81	0.2098765
NODE_10296_length_851_cov_10.074468	454	534	1	10	80	0.1250000
NODE_10296_length_851_cov_10.074468	454	534	2	70	80	0.8750000
NODE_10296_length_851_cov_10.074468	507	587	1	1	80	0.0125000
NODE_10296_length_851_cov_10.074468	507	587	2	79	80	0.9875000
NODE_10297_length_851_cov_7.599734	330	410	1	20	80	0.2500000
NODE_10297_length_851_cov_7.599734	330	410	2	60	80	0.7500000
NODE_10297_length_851_cov_7.599734	383	463	0	9	80	0.1125000
NODE_10297_length_851_cov_7.599734	383	463	1	64	80	0.8000000
NODE_10297_length_851_cov_7.599734	383	463	2	7	80	0.0875000
NODE_10298_length_851_cov_5.639628	379	459	0	80	80	1.0000000
NODE_10298_length_851_cov_5.639628	432	512	0	80	80	1.0000000
NODE_10300_length_851_cov_3.880319	729	765	0	36	36	1.0000000
NODE_10300_length_851_cov_3.880319	743	824	0	81	81	1.0000000
NODE_10301_length_851_cov_3.823138	380	460	0	80	80	1.0000000
NODE_10301_length_851_cov_3.823138	433	513	0	80	80	1.0000000
NODE_10318_length_851_cov_1.130319	33	103	1	41	70	0.5857143
NODE_10318_length_851_cov_1.130319	33	103	2	29	70	0.4142857
NODE_10326_length_850_cov_36.527297	360	440	2	18	80	0.2250000
NODE_10326_length_850_cov_36.527297	360	440	3	5	80	0.0625000
NODE_10326_length_850_cov_36.527297	360	440	5	17	80	0.2125000
NODE_10326_length_850_cov_36.527297	360	440	6	13	80	0.1625000
NODE_10326_length_850_cov_36.527297	360	440	7	27	80	0.3375000
NODE_10326_length_850_cov_36.527297	413	493	1	45	80	0.5625000
NODE_10326_length_850_cov_36.527297	413	493	2	26	80	0.3250000
NODE_10326_length_850_cov_36.527297	413	493	3	5	80	0.0625000
NODE_10326_length_850_cov_36.527297	413	493	5	4	80	0.0500000
NODE_10327_length_850_cov_31.006658	330	410	2	20	80	0.2500000
NODE_10327_length_850_cov_31.006658	330	410	3	60	80	0.7500000
NODE_10327_length_850_cov_31.006658	383	463	1	12	80	0.1500000
NODE_10327_length_850_cov_31.006658	383	463	2	45	80	0.5625000
NODE_10327_length_850_cov_31.006658	383	463	3	23	80	0.2875000
NODE_10328_length_850_cov_30.460719	251	331	1	52	80	0.6500000
NODE_10328_length_850_cov_30.460719	251	331	2	28	80	0.3500000
NODE_10328_length_850_cov_30.460719	304	384	2	80	80	1.0000000
NODE_10329_length_850_cov_25.263648	355	435	1	9	80	0.1125000
NODE_10329_length_850_cov_25.263648	355	435	2	65	80	0.8125000
NODE_10329_length_850_cov_25.263648	355	435	4	6	80	0.0750000
NODE_10329_length_850_cov_25.263648	408	488	2	21	80	0.2625000
NODE_10329_length_850_cov_25.263648	408	488	3	46	80	0.5750000
NODE_10329_length_850_cov_25.263648	408	488	4	13	80	0.1625000
NODE_10330_length_850_cov_21.368842	290	370	4	7	80	0.0875000
NODE_10330_length_850_cov_21.368842	290	370	5	52	80	0.6500000
NODE_10330_length_850_cov_21.368842	290	370	6	21	80	0.2625000
NODE_10330_length_850_cov_21.368842	343	423	3	32	80	0.4000000
NODE_10330_length_850_cov_21.368842	343	423	4	16	80	0.2000000
NODE_10330_length_850_cov_21.368842	343	423	5	32	80	0.4000000
NODE_10331_length_850_cov_20.500666	318	398	0	80	80	1.0000000
NODE_10331_length_850_cov_20.500666	371	451	0	30	80	0.3750000
NODE_10331_length_850_cov_20.500666	371	451	2	50	80	0.6250000
NODE_10332_length_850_cov_17.268975	398	478	0	80	80	1.0000000
NODE_10332_length_850_cov_17.268975	451	531	0	80	80	1.0000000
NODE_10333_length_850_cov_14.728362	379	459	0	80	80	1.0000000
NODE_10333_length_850_cov_14.728362	432	512	0	80	80	1.0000000
NODE_10334_length_850_cov_14.230360	313	393	2	80	80	1.0000000
NODE_10334_length_850_cov_14.230360	366	446	1	23	80	0.2875000
NODE_10334_length_850_cov_14.230360	366	446	2	57	80	0.7125000
NODE_10335_length_850_cov_12.387483	337	417	0	80	80	1.0000000
NODE_10335_length_850_cov_12.387483	390	470	0	80	80	1.0000000
NODE_10335_length_850_cov_12.387483	466	545	0	79	79	1.0000000
NODE_10335_length_850_cov_12.387483	518	598	0	80	80	1.0000000
NODE_10336_length_850_cov_11.402130	329	409	0	14	80	0.1750000
NODE_10336_length_850_cov_11.402130	329	409	2	66	80	0.8250000
NODE_10336_length_850_cov_11.402130	382	462	2	80	80	1.0000000
NODE_10337_length_850_cov_10.326232	330	410	0	8	80	0.1000000
NODE_10337_length_850_cov_10.326232	330	410	1	72	80	0.9000000
NODE_10337_length_850_cov_10.326232	383	463	0	8	80	0.1000000
NODE_10337_length_850_cov_10.326232	383	463	1	72	80	0.9000000
NODE_10338_length_850_cov_9.675100	464	544	5	44	80	0.5500000
NODE_10338_length_850_cov_9.675100	464	544	6	9	80	0.1125000
NODE_10338_length_850_cov_9.675100	464	544	7	27	80	0.3375000
NODE_10338_length_850_cov_9.675100	517	597	2	11	80	0.1375000
NODE_10338_length_850_cov_9.675100	517	597	3	4	80	0.0500000
NODE_10338_length_850_cov_9.675100	517	597	5	53	80	0.6625000
NODE_10338_length_850_cov_9.675100	517	597	6	9	80	0.1125000
NODE_10338_length_850_cov_9.675100	517	597	7	3	80	0.0375000
NODE_10367_length_849_cov_43.137333	336	416	3	14	80	0.1750000
NODE_10367_length_849_cov_43.137333	336	416	4	66	80	0.8250000
NODE_10367_length_849_cov_43.137333	389	469	3	41	80	0.5125000
NODE_10367_length_849_cov_43.137333	389	469	4	13	80	0.1625000
NODE_10367_length_849_cov_43.137333	389	469	5	26	80	0.3250000
NODE_10368_length_849_cov_36.562667	326	406	0	65	80	0.8125000
NODE_10368_length_849_cov_36.562667	326	406	2	15	80	0.1875000
NODE_10368_length_849_cov_36.562667	379	459	0	12	80	0.1500000
NODE_10368_length_849_cov_36.562667	379	459	2	68	80	0.8500000
NODE_10369_length_849_cov_35.449333	408	488	1	28	80	0.3500000
NODE_10369_length_849_cov_35.449333	408	488	2	52	80	0.6500000
NODE_10369_length_849_cov_35.449333	461	541	1	61	80	0.7625000
NODE_10369_length_849_cov_35.449333	461	541	2	19	80	0.2375000
NODE_10370_length_849_cov_29.989333	332	412	0	21	80	0.2625000
NODE_10370_length_849_cov_29.989333	332	412	1	58	80	0.7250000
NODE_10370_length_849_cov_29.989333	332	412	3	1	80	0.0125000
NODE_10370_length_849_cov_29.989333	385	465	1	26	80	0.3250000
NODE_10370_length_849_cov_29.989333	385	465	3	53	80	0.6625000
NODE_10370_length_849_cov_29.989333	385	465	4	1	80	0.0125000
NODE_10371_length_849_cov_17.974667	343	423	1	13	80	0.1625000
NODE_10371_length_849_cov_17.974667	343	423	2	28	80	0.3500000
NODE_10371_length_849_cov_17.974667	343	423	3	39	80	0.4875000
NODE_10371_length_849_cov_17.974667	396	476	1	66	80	0.8250000
NODE_10371_length_849_cov_17.974667	396	476	3	14	80	0.1750000
NODE_10372_length_849_cov_17.018667	360	440	0	80	80	1.0000000
NODE_10372_length_849_cov_17.018667	416	493	0	77	77	1.0000000
NODE_10373_length_849_cov_15.581333	287	367	0	19	80	0.2375000
NODE_10373_length_849_cov_15.581333	287	367	1	51	80	0.6375000
NODE_10373_length_849_cov_15.581333	287	367	2	10	80	0.1250000
NODE_10373_length_849_cov_15.581333	340	420	1	17	80	0.2125000
NODE_10373_length_849_cov_15.581333	340	420	2	45	80	0.5625000
NODE_10373_length_849_cov_15.581333	340	420	4	18	80	0.2250000
NODE_10373_length_849_cov_15.581333	416	496	4	58	80	0.7250000
NODE_10373_length_849_cov_15.581333	416	496	5	22	80	0.2750000
NODE_10373_length_849_cov_15.581333	469	549	1	43	80	0.5375000
NODE_10373_length_849_cov_15.581333	469	549	2	6	80	0.0750000
NODE_10373_length_849_cov_15.581333	469	549	4	31	80	0.3875000
NODE_10374_length_849_cov_9.460000	370	450	0	80	80	1.0000000
NODE_10374_length_849_cov_9.460000	423	503	0	80	80	1.0000000
NODE_10375_length_849_cov_4.893333	427	507	0	80	80	1.0000000
NODE_10375_length_849_cov_4.893333	480	560	0	80	80	1.0000000
NODE_10376_length_849_cov_4.860000	380	460	0	80	80	1.0000000
NODE_10376_length_849_cov_4.860000	433	513	0	80	80	1.0000000
NODE_10379_length_849_cov_2.761333	254	334	0	70	80	0.8750000
NODE_10379_length_849_cov_2.761333	254	334	1	10	80	0.1250000
NODE_10396_length_848_cov_27.287049	253	333	2	39	80	0.4875000
NODE_10396_length_848_cov_27.287049	253	333	3	36	80	0.4500000
NODE_10396_length_848_cov_27.287049	253	333	4	5	80	0.0625000
NODE_10396_length_848_cov_27.287049	306	386	3	25	80	0.3125000
NODE_10396_length_848_cov_27.287049	306	386	4	55	80	0.6875000
NODE_10396_length_848_cov_27.287049	382	458	1	16	76	0.2105263
NODE_10396_length_848_cov_27.287049	382	458	2	56	76	0.7368421
NODE_10396_length_848_cov_27.287049	382	458	3	3	76	0.0394737
NODE_10396_length_848_cov_27.287049	382	458	4	1	76	0.0131579
NODE_10396_length_848_cov_27.287049	435	513	0	34	78	0.4358974
NODE_10396_length_848_cov_27.287049	435	513	1	37	78	0.4743590
NODE_10396_length_848_cov_27.287049	435	513	2	7	78	0.0897436
NODE_10397_length_848_cov_23.511348	248	328	0	80	80	1.0000000
NODE_10397_length_848_cov_23.511348	301	381	0	32	80	0.4000000
NODE_10397_length_848_cov_23.511348	301	381	1	24	80	0.3000000
NODE_10397_length_848_cov_23.511348	301	381	2	24	80	0.3000000
NODE_10397_length_848_cov_23.511348	377	457	2	28	80	0.3500000
NODE_10397_length_848_cov_23.511348	377	457	3	10	80	0.1250000
NODE_10397_length_848_cov_23.511348	377	457	5	15	80	0.1875000
NODE_10397_length_848_cov_23.511348	377	457	6	27	80	0.3375000
NODE_10397_length_848_cov_23.511348	430	508	4	1	78	0.0128205
NODE_10397_length_848_cov_23.511348	430	508	5	24	78	0.3076923
NODE_10397_length_848_cov_23.511348	430	508	6	53	78	0.6794872
NODE_10398_length_848_cov_21.939920	295	375	3	80	80	1.0000000
NODE_10398_length_848_cov_21.939920	348	428	1	2	80	0.0250000
NODE_10398_length_848_cov_21.939920	348	428	3	78	80	0.9750000
NODE_10399_length_848_cov_21.937250	434	514	0	80	80	1.0000000
NODE_10399_length_848_cov_21.937250	487	567	0	80	80	1.0000000
NODE_10400_length_848_cov_19.500668	367	392	4	1	25	0.0400000
NODE_10400_length_848_cov_19.500668	367	392	5	3	25	0.1200000
NODE_10400_length_848_cov_19.500668	367	392	7	21	25	0.8400000
NODE_10400_length_848_cov_19.500668	388	468	0	38	80	0.4750000
NODE_10400_length_848_cov_19.500668	388	468	1	5	80	0.0625000
NODE_10400_length_848_cov_19.500668	388	468	2	5	80	0.0625000
NODE_10400_length_848_cov_19.500668	388	468	3	10	80	0.1250000
NODE_10400_length_848_cov_19.500668	388	468	4	19	80	0.2375000
NODE_10400_length_848_cov_19.500668	388	468	5	3	80	0.0375000
NODE_10400_length_848_cov_19.500668	441	521	0	80	80	1.0000000
NODE_10400_length_848_cov_19.500668	443	512	0	69	69	1.0000000
NODE_10400_length_848_cov_19.500668	443	472	0	29	29	1.0000000
NODE_10401_length_848_cov_16.566088	323	403	0	12	80	0.1500000
NODE_10401_length_848_cov_16.566088	323	403	1	16	80	0.2000000
NODE_10401_length_848_cov_16.566088	323	403	2	13	80	0.1625000
NODE_10401_length_848_cov_16.566088	323	403	3	19	80	0.2375000
NODE_10401_length_848_cov_16.566088	323	403	4	20	80	0.2500000
NODE_10401_length_848_cov_16.566088	376	456	3	7	80	0.0875000
NODE_10401_length_848_cov_16.566088	376	456	4	45	80	0.5625000
NODE_10401_length_848_cov_16.566088	376	456	5	28	80	0.3500000
NODE_10402_length_848_cov_16.109479	256	336	4	13	80	0.1625000
NODE_10402_length_848_cov_16.109479	256	336	5	34	80	0.4250000
NODE_10402_length_848_cov_16.109479	256	336	6	33	80	0.4125000
NODE_10402_length_848_cov_16.109479	309	389	3	3	80	0.0375000
NODE_10402_length_848_cov_16.109479	309	389	4	63	80	0.7875000
NODE_10402_length_848_cov_16.109479	309	389	5	2	80	0.0250000
NODE_10402_length_848_cov_16.109479	309	389	6	12	80	0.1500000
NODE_10402_length_848_cov_16.109479	385	465	2	15	80	0.1875000
NODE_10402_length_848_cov_16.109479	385	465	4	40	80	0.5000000
NODE_10402_length_848_cov_16.109479	385	465	5	25	80	0.3125000
NODE_10402_length_848_cov_16.109479	438	518	1	14	80	0.1750000
NODE_10402_length_848_cov_16.109479	438	518	2	54	80	0.6750000
NODE_10402_length_848_cov_16.109479	438	518	4	12	80	0.1500000
NODE_10403_length_848_cov_15.919893	492	568	0	50	76	0.6578947
NODE_10403_length_848_cov_15.919893	492	568	2	26	76	0.3421053
NODE_10403_length_848_cov_15.919893	541	621	0	80	80	1.0000000
NODE_10404_length_848_cov_13.979973	269	349	0	17	80	0.2125000
NODE_10404_length_848_cov_13.979973	269	349	2	63	80	0.7875000
NODE_10404_length_848_cov_13.979973	322	402	2	66	80	0.8250000
NODE_10404_length_848_cov_13.979973	322	402	3	14	80	0.1750000
NODE_10405_length_848_cov_13.073431	343	423	0	42	80	0.5250000
NODE_10405_length_848_cov_13.073431	343	423	1	38	80	0.4750000
NODE_10405_length_848_cov_13.073431	396	476	0	80	80	1.0000000
NODE_10406_length_848_cov_8.523364	232	312	0	70	80	0.8750000
NODE_10406_length_848_cov_8.523364	232	312	1	10	80	0.1250000
NODE_10406_length_848_cov_8.523364	285	365	0	17	80	0.2125000
NODE_10406_length_848_cov_8.523364	285	365	1	63	80	0.7875000
NODE_10406_length_848_cov_8.523364	361	441	1	80	80	1.0000000
NODE_10406_length_848_cov_8.523364	414	494	1	73	80	0.9125000
NODE_10406_length_848_cov_8.523364	414	494	2	7	80	0.0875000
NODE_10408_length_848_cov_5.903872	251	331	0	61	80	0.7625000
NODE_10408_length_848_cov_5.903872	251	331	2	13	80	0.1625000
NODE_10408_length_848_cov_5.903872	251	331	4	6	80	0.0750000
NODE_10408_length_848_cov_5.903872	304	383	0	79	79	1.0000000
NODE_10409_length_848_cov_5.236315	378	458	0	23	80	0.2875000
NODE_10409_length_848_cov_5.236315	378	458	2	57	80	0.7125000
NODE_10409_length_848_cov_5.236315	431	507	2	76	76	1.0000000
NODE_10424_length_847_cov_56.417112	576	656	6	6	80	0.0750000
NODE_10424_length_847_cov_56.417112	576	656	7	14	80	0.1750000
NODE_10424_length_847_cov_56.417112	576	656	8	60	80	0.7500000
NODE_10424_length_847_cov_56.417112	629	709	2	9	80	0.1125000
NODE_10424_length_847_cov_56.417112	629	709	3	9	80	0.1125000
NODE_10424_length_847_cov_56.417112	629	709	4	5	80	0.0625000
NODE_10424_length_847_cov_56.417112	629	709	5	25	80	0.3125000
NODE_10424_length_847_cov_56.417112	629	709	6	11	80	0.1375000
NODE_10424_length_847_cov_56.417112	629	709	7	14	80	0.1750000
NODE_10424_length_847_cov_56.417112	629	709	8	7	80	0.0875000
NODE_10425_length_847_cov_27.292781	390	470	5	22	80	0.2750000
NODE_10425_length_847_cov_27.292781	390	470	6	58	80	0.7250000
NODE_10425_length_847_cov_27.292781	443	523	3	15	80	0.1875000
NODE_10425_length_847_cov_27.292781	443	523	4	7	80	0.0875000
NODE_10425_length_847_cov_27.292781	443	523	5	53	80	0.6625000
NODE_10425_length_847_cov_27.292781	443	523	6	5	80	0.0625000
NODE_10426_length_847_cov_24.954545	342	422	1	12	80	0.1500000
NODE_10426_length_847_cov_24.954545	342	422	2	50	80	0.6250000
NODE_10426_length_847_cov_24.954545	342	422	3	18	80	0.2250000
NODE_10426_length_847_cov_24.954545	395	475	2	9	80	0.1125000
NODE_10426_length_847_cov_24.954545	395	475	3	26	80	0.3250000
NODE_10426_length_847_cov_24.954545	395	475	4	45	80	0.5625000
NODE_10427_length_847_cov_20.310160	341	421	3	80	80	1.0000000
NODE_10427_length_847_cov_20.310160	394	474	0	27	80	0.3375000
NODE_10427_length_847_cov_20.310160	394	474	1	4	80	0.0500000
NODE_10427_length_847_cov_20.310160	394	474	2	19	80	0.2375000
NODE_10427_length_847_cov_20.310160	394	474	3	30	80	0.3750000
NODE_10428_length_847_cov_19.002674	368	448	3	25	80	0.3125000
NODE_10428_length_847_cov_19.002674	368	448	4	17	80	0.2125000
NODE_10428_length_847_cov_19.002674	368	448	5	38	80	0.4750000
NODE_10428_length_847_cov_19.002674	421	501	3	7	80	0.0875000
NODE_10428_length_847_cov_19.002674	421	501	4	37	80	0.4625000
NODE_10428_length_847_cov_19.002674	421	501	5	36	80	0.4500000
NODE_10429_length_847_cov_16.879679	218	298	5	12	80	0.1500000
NODE_10429_length_847_cov_16.879679	218	298	6	19	80	0.2375000
NODE_10429_length_847_cov_16.879679	218	298	7	49	80	0.6125000
NODE_10429_length_847_cov_16.879679	271	351	3	31	80	0.3875000
NODE_10429_length_847_cov_16.879679	271	351	5	14	80	0.1750000
NODE_10429_length_847_cov_16.879679	271	351	7	35	80	0.4375000
NODE_10431_length_847_cov_11.784759	298	378	1	80	80	1.0000000
NODE_10431_length_847_cov_11.784759	351	431	0	17	80	0.2125000
NODE_10431_length_847_cov_11.784759	351	431	1	63	80	0.7875000
NODE_10431_length_847_cov_11.784759	427	507	0	80	80	1.0000000
NODE_10431_length_847_cov_11.784759	480	560	0	80	80	1.0000000
NODE_10432_length_847_cov_11.604278	407	487	0	24	80	0.3000000
NODE_10432_length_847_cov_11.604278	407	487	1	22	80	0.2750000
NODE_10432_length_847_cov_11.604278	407	487	2	34	80	0.4250000
NODE_10432_length_847_cov_11.604278	460	540	2	80	80	1.0000000
NODE_10433_length_847_cov_10.221925	395	475	2	65	80	0.8125000
NODE_10433_length_847_cov_10.221925	395	475	3	15	80	0.1875000
NODE_10433_length_847_cov_10.221925	448	528	2	60	80	0.7500000
NODE_10433_length_847_cov_10.221925	448	528	3	20	80	0.2500000
NODE_10434_length_847_cov_4.602941	97	154	9	6	57	0.1052632
NODE_10434_length_847_cov_4.602941	97	154	12	6	57	0.1052632
NODE_10434_length_847_cov_4.602941	97	154	13	5	57	0.0877193
NODE_10434_length_847_cov_4.602941	97	154	14	33	57	0.5789474
NODE_10434_length_847_cov_4.602941	97	154	15	7	57	0.1228070
NODE_10434_length_847_cov_4.602941	127	207	3	46	80	0.5750000
NODE_10434_length_847_cov_4.602941	127	207	5	4	80	0.0500000
NODE_10434_length_847_cov_4.602941	127	207	7	2	80	0.0250000
NODE_10434_length_847_cov_4.602941	127	207	9	7	80	0.0875000
NODE_10434_length_847_cov_4.602941	127	207	12	6	80	0.0750000
NODE_10434_length_847_cov_4.602941	127	207	13	5	80	0.0625000
NODE_10434_length_847_cov_4.602941	127	207	14	10	80	0.1250000
NODE_10456_length_846_cov_39.476573	336	416	0	22	80	0.2750000
NODE_10456_length_846_cov_39.476573	336	416	1	58	80	0.7250000
NODE_10456_length_846_cov_39.476573	389	469	1	80	80	1.0000000
NODE_10456_length_846_cov_39.476573	465	545	1	79	80	0.9875000
NODE_10456_length_846_cov_39.476573	465	545	2	1	80	0.0125000
NODE_10456_length_846_cov_39.476573	518	598	1	80	80	1.0000000
NODE_10457_length_846_cov_37.297189	312	392	2	64	80	0.8000000
NODE_10457_length_846_cov_37.297189	312	392	3	16	80	0.2000000
NODE_10457_length_846_cov_37.297189	365	445	1	42	80	0.5250000
NODE_10457_length_846_cov_37.297189	365	445	2	38	80	0.4750000
NODE_10458_length_846_cov_32.852744	279	359	0	80	80	1.0000000
NODE_10458_length_846_cov_32.852744	332	412	0	80	80	1.0000000
NODE_10459_length_846_cov_31.717537	290	370	6	4	80	0.0500000
NODE_10459_length_846_cov_31.717537	290	370	7	7	80	0.0875000
NODE_10459_length_846_cov_31.717537	290	370	8	8	80	0.1000000
NODE_10459_length_846_cov_31.717537	290	370	9	6	80	0.0750000
NODE_10459_length_846_cov_31.717537	290	370	11	5	80	0.0625000
NODE_10459_length_846_cov_31.717537	290	370	13	3	80	0.0375000
NODE_10459_length_846_cov_31.717537	290	370	15	3	80	0.0375000
NODE_10459_length_846_cov_31.717537	290	370	16	35	80	0.4375000
NODE_10459_length_846_cov_31.717537	290	370	18	9	80	0.1125000
NODE_10459_length_846_cov_31.717537	343	423	11	7	80	0.0875000
NODE_10459_length_846_cov_31.717537	343	423	13	3	80	0.0375000
NODE_10459_length_846_cov_31.717537	343	423	14	4	80	0.0500000
NODE_10459_length_846_cov_31.717537	343	423	16	33	80	0.4125000
NODE_10459_length_846_cov_31.717537	343	423	18	33	80	0.4125000
NODE_10460_length_846_cov_24.380187	350	430	2	4	80	0.0500000
NODE_10460_length_846_cov_24.380187	350	430	3	16	80	0.2000000
NODE_10460_length_846_cov_24.380187	350	430	4	60	80	0.7500000
NODE_10460_length_846_cov_24.380187	403	483	0	12	80	0.1500000
NODE_10460_length_846_cov_24.380187	403	483	1	26	80	0.3250000
NODE_10460_length_846_cov_24.380187	403	483	3	31	80	0.3875000
NODE_10460_length_846_cov_24.380187	403	483	4	11	80	0.1375000
NODE_10461_length_846_cov_16.155288	364	444	0	11	80	0.1375000
NODE_10461_length_846_cov_16.155288	364	444	1	1	80	0.0125000
NODE_10461_length_846_cov_16.155288	364	444	3	68	80	0.8500000
NODE_10461_length_846_cov_16.155288	417	497	3	56	80	0.7000000
NODE_10461_length_846_cov_16.155288	417	497	4	24	80	0.3000000
NODE_10462_length_846_cov_15.917001	398	478	2	80	80	1.0000000
NODE_10462_length_846_cov_15.917001	451	531	0	9	80	0.1125000
NODE_10462_length_846_cov_15.917001	451	531	1	8	80	0.1000000
NODE_10462_length_846_cov_15.917001	451	531	2	63	80	0.7875000
NODE_10463_length_846_cov_15.275770	355	435	0	80	80	1.0000000
NODE_10463_length_846_cov_15.275770	408	488	0	80	80	1.0000000
NODE_10464_length_846_cov_13.618474	216	296	1	5	80	0.0625000
NODE_10464_length_846_cov_13.618474	216	296	2	15	80	0.1875000
NODE_10464_length_846_cov_13.618474	216	296	3	60	80	0.7500000
NODE_10464_length_846_cov_13.618474	269	349	2	10	80	0.1250000
NODE_10464_length_846_cov_13.618474	269	349	3	64	80	0.8000000
NODE_10464_length_846_cov_13.618474	269	349	4	6	80	0.0750000
NODE_10464_length_846_cov_13.618474	345	425	3	39	80	0.4875000
NODE_10464_length_846_cov_13.618474	345	425	4	26	80	0.3250000
NODE_10464_length_846_cov_13.618474	345	425	5	15	80	0.1875000
NODE_10464_length_846_cov_13.618474	398	478	1	12	80	0.1500000
NODE_10464_length_846_cov_13.618474	398	478	3	68	80	0.8500000
NODE_10465_length_846_cov_12.878179	425	505	0	80	80	1.0000000
NODE_10465_length_846_cov_12.878179	478	558	0	80	80	1.0000000
NODE_10467_length_846_cov_7.232932	407	487	1	80	80	1.0000000
NODE_10467_length_846_cov_7.232932	460	540	1	59	80	0.7375000
NODE_10467_length_846_cov_7.232932	460	540	2	21	80	0.2625000
NODE_10468_length_846_cov_6.776439	320	400	1	2	80	0.0250000
NODE_10468_length_846_cov_6.776439	320	400	3	41	80	0.5125000
NODE_10468_length_846_cov_6.776439	320	400	4	37	80	0.4625000
NODE_10468_length_846_cov_6.776439	373	453	1	50	80	0.6250000
NODE_10468_length_846_cov_6.776439	373	453	3	25	80	0.3125000
NODE_10468_length_846_cov_6.776439	373	453	4	5	80	0.0625000
NODE_10472_length_846_cov_3.025435	190	270	0	58	80	0.7250000
NODE_10472_length_846_cov_3.025435	190	270	2	22	80	0.2750000
NODE_10472_length_846_cov_3.025435	243	323	0	5	80	0.0625000
NODE_10472_length_846_cov_3.025435	243	323	2	75	80	0.9375000
NODE_10488_length_845_cov_34.458445	213	293	3	3	80	0.0375000
NODE_10488_length_845_cov_34.458445	213	293	4	40	80	0.5000000
NODE_10488_length_845_cov_34.458445	213	293	5	23	80	0.2875000
NODE_10488_length_845_cov_34.458445	213	293	6	14	80	0.1750000
NODE_10488_length_845_cov_34.458445	266	346	1	7	80	0.0875000
NODE_10488_length_845_cov_34.458445	266	346	3	12	80	0.1500000
NODE_10488_length_845_cov_34.458445	266	346	4	45	80	0.5625000
NODE_10488_length_845_cov_34.458445	266	346	5	16	80	0.2000000
NODE_10489_length_845_cov_33.025469	309	389	1	46	80	0.5750000
NODE_10489_length_845_cov_33.025469	309	389	2	34	80	0.4250000
NODE_10489_length_845_cov_33.025469	362	442	1	18	80	0.2250000
NODE_10489_length_845_cov_33.025469	362	442	2	62	80	0.7750000
NODE_10490_length_845_cov_30.331099	288	368	2	56	80	0.7000000
NODE_10490_length_845_cov_30.331099	288	368	3	4	80	0.0500000
NODE_10490_length_845_cov_30.331099	288	368	4	20	80	0.2500000
NODE_10490_length_845_cov_30.331099	341	421	2	3	80	0.0375000
NODE_10490_length_845_cov_30.331099	341	421	3	21	80	0.2625000
NODE_10490_length_845_cov_30.331099	341	421	4	56	80	0.7000000
NODE_10491_length_845_cov_22.042895	455	535	4	19	80	0.2375000
NODE_10491_length_845_cov_22.042895	455	535	5	61	80	0.7625000
NODE_10491_length_845_cov_22.042895	508	588	2	2	80	0.0250000
NODE_10491_length_845_cov_22.042895	508	588	3	4	80	0.0500000
NODE_10491_length_845_cov_22.042895	508	588	4	60	80	0.7500000
NODE_10491_length_845_cov_22.042895	508	588	5	14	80	0.1750000
NODE_10492_length_845_cov_20.662198	325	406	2	81	81	1.0000000
NODE_10492_length_845_cov_20.662198	379	459	0	25	80	0.3125000
NODE_10492_length_845_cov_20.662198	379	459	2	55	80	0.6875000
NODE_10493_length_845_cov_17.214477	352	432	0	17	80	0.2125000
NODE_10493_length_845_cov_17.214477	352	432	1	63	80	0.7875000
NODE_10493_length_845_cov_17.214477	405	485	1	80	80	1.0000000
NODE_10494_length_845_cov_15.805630	409	489	0	80	80	1.0000000
NODE_10494_length_845_cov_15.805630	462	542	0	80	80	1.0000000
NODE_10495_length_845_cov_13.443700	329	409	0	78	80	0.9750000
NODE_10495_length_845_cov_13.443700	329	409	1	2	80	0.0250000
NODE_10495_length_845_cov_13.443700	382	462	0	80	80	1.0000000
NODE_10496_length_845_cov_12.301609	334	414	2	53	80	0.6625000
NODE_10496_length_845_cov_12.301609	334	414	4	27	80	0.3375000
NODE_10496_length_845_cov_12.301609	387	467	0	49	80	0.6125000
NODE_10496_length_845_cov_12.301609	387	467	2	31	80	0.3875000
NODE_10497_length_845_cov_11.836461	389	469	0	80	80	1.0000000
NODE_10497_length_845_cov_11.836461	442	522	0	80	80	1.0000000
NODE_10499_length_845_cov_8.140751	439	519	0	80	80	1.0000000
NODE_10499_length_845_cov_8.140751	492	572	0	80	80	1.0000000
NODE_10516_length_845_cov_1.680965	447	491	0	44	44	1.0000000
NODE_10528_length_844_cov_43.778523	313	393	0	4	80	0.0500000
NODE_10528_length_844_cov_43.778523	313	393	1	13	80	0.1625000
NODE_10528_length_844_cov_43.778523	313	393	2	51	80	0.6375000
NODE_10528_length_844_cov_43.778523	313	393	4	1	80	0.0125000
NODE_10528_length_844_cov_43.778523	313	393	5	11	80	0.1375000
NODE_10528_length_844_cov_43.778523	366	446	0	2	80	0.0250000
NODE_10528_length_844_cov_43.778523	366	446	1	13	80	0.1625000
NODE_10528_length_844_cov_43.778523	366	446	4	1	80	0.0125000
NODE_10528_length_844_cov_43.778523	366	446	5	51	80	0.6375000
NODE_10528_length_844_cov_43.778523	366	446	6	13	80	0.1625000
NODE_10528_length_844_cov_43.778523	442	522	3	19	80	0.2375000
NODE_10528_length_844_cov_43.778523	442	522	4	19	80	0.2375000
NODE_10528_length_844_cov_43.778523	442	522	6	36	80	0.4500000
NODE_10528_length_844_cov_43.778523	442	522	7	6	80	0.0750000
NODE_10528_length_844_cov_43.778523	495	575	3	61	80	0.7625000
NODE_10528_length_844_cov_43.778523	495	575	4	19	80	0.2375000
NODE_10529_length_844_cov_36.762416	381	461	0	26	80	0.3250000
NODE_10529_length_844_cov_36.762416	381	461	1	45	80	0.5625000
NODE_10529_length_844_cov_36.762416	381	461	2	9	80	0.1125000
NODE_10529_length_844_cov_36.762416	434	514	0	18	80	0.2250000
NODE_10529_length_844_cov_36.762416	434	514	2	62	80	0.7750000
NODE_10529_length_844_cov_36.762416	510	590	2	19	80	0.2375000
NODE_10529_length_844_cov_36.762416	510	590	4	61	80	0.7625000
NODE_10529_length_844_cov_36.762416	563	644	0	2	81	0.0246914
NODE_10529_length_844_cov_36.762416	563	644	2	54	81	0.6666667
NODE_10529_length_844_cov_36.762416	563	644	4	25	81	0.3086420
NODE_10530_length_844_cov_35.765101	424	504	4	7	80	0.0875000
NODE_10530_length_844_cov_35.765101	424	504	5	36	80	0.4500000
NODE_10530_length_844_cov_35.765101	424	504	6	37	80	0.4625000
NODE_10530_length_844_cov_35.765101	477	557	5	39	80	0.4875000
NODE_10530_length_844_cov_35.765101	477	557	6	41	80	0.5125000
NODE_10531_length_844_cov_18.445638	353	420	1	21	67	0.3134328
NODE_10531_length_844_cov_18.445638	353	420	2	46	67	0.6865672
NODE_10531_length_844_cov_18.445638	393	473	0	15	80	0.1875000
NODE_10531_length_844_cov_18.445638	393	473	1	59	80	0.7375000
NODE_10531_length_844_cov_18.445638	393	473	2	6	80	0.0750000
NODE_10532_length_844_cov_12.616107	363	443	1	68	80	0.8500000
NODE_10532_length_844_cov_12.616107	363	443	2	12	80	0.1500000
NODE_10532_length_844_cov_12.616107	416	496	1	52	80	0.6500000
NODE_10532_length_844_cov_12.616107	416	496	2	28	80	0.3500000
NODE_10533_length_844_cov_12.092617	171	251	0	42	80	0.5250000
NODE_10533_length_844_cov_12.092617	171	251	1	38	80	0.4750000
NODE_10533_length_844_cov_12.092617	224	304	1	54	80	0.6750000
NODE_10533_length_844_cov_12.092617	224	304	2	26	80	0.3250000
NODE_10534_length_844_cov_11.883221	341	421	0	54	80	0.6750000
NODE_10534_length_844_cov_11.883221	341	421	2	26	80	0.3250000
NODE_10534_length_844_cov_11.883221	394	474	0	1	80	0.0125000
NODE_10534_length_844_cov_11.883221	394	474	2	59	80	0.7375000
NODE_10534_length_844_cov_11.883221	394	474	3	20	80	0.2500000
NODE_10535_length_844_cov_10.571812	390	448	0	11	58	0.1896552
NODE_10535_length_844_cov_10.571812	390	448	1	47	58	0.8103448
NODE_10537_length_844_cov_9.357047	370	450	2	50	80	0.6250000
NODE_10537_length_844_cov_9.357047	370	450	4	30	80	0.3750000
NODE_10537_length_844_cov_9.357047	423	503	2	80	80	1.0000000
NODE_10538_length_844_cov_8.975839	355	435	0	9	80	0.1125000
NODE_10538_length_844_cov_8.975839	355	435	2	71	80	0.8875000
NODE_10538_length_844_cov_8.975839	408	488	0	8	80	0.1000000
NODE_10538_length_844_cov_8.975839	408	488	2	72	80	0.9000000
NODE_10539_length_844_cov_7.347651	357	438	1	45	81	0.5555556
NODE_10539_length_844_cov_7.347651	357	438	3	36	81	0.4444444
NODE_10539_length_844_cov_7.347651	410	491	2	28	81	0.3456790
NODE_10539_length_844_cov_7.347651	410	491	3	53	81	0.6543210
NODE_10540_length_844_cov_6.975839	444	524	0	80	80	1.0000000
NODE_10540_length_844_cov_6.975839	497	577	0	80	80	1.0000000
NODE_10567_length_843_cov_48.258065	203	262	303	2	59	0.0338983
NODE_10567_length_843_cov_48.258065	203	262	304	1	59	0.0169492
NODE_10567_length_843_cov_48.258065	203	262	305	1	59	0.0169492
NODE_10567_length_843_cov_48.258065	203	262	313	1	59	0.0169492
NODE_10567_length_843_cov_48.258065	203	262	314	1	59	0.0169492
NODE_10567_length_843_cov_48.258065	203	262	319	1	59	0.0169492
NODE_10567_length_843_cov_48.258065	203	262	325	1	59	0.0169492
NODE_10567_length_843_cov_48.258065	203	262	327	1	59	0.0169492
NODE_10567_length_843_cov_48.258065	203	262	330	1	59	0.0169492
NODE_10567_length_843_cov_48.258065	203	262	335	2	59	0.0338983
NODE_10567_length_843_cov_48.258065	203	262	336	1	59	0.0169492
NODE_10567_length_843_cov_48.258065	203	262	338	1	59	0.0169492
NODE_10567_length_843_cov_48.258065	203	262	341	1	59	0.0169492
NODE_10567_length_843_cov_48.258065	203	262	345	2	59	0.0338983
NODE_10567_length_843_cov_48.258065	203	262	349	1	59	0.0169492
NODE_10567_length_843_cov_48.258065	203	262	351	1	59	0.0169492
NODE_10567_length_843_cov_48.258065	203	262	353	1	59	0.0169492
NODE_10567_length_843_cov_48.258065	203	262	354	1	59	0.0169492
NODE_10567_length_843_cov_48.258065	203	262	359	1	59	0.0169492
NODE_10567_length_843_cov_48.258065	203	262	360	1	59	0.0169492
NODE_10567_length_843_cov_48.258065	203	262	361	1	59	0.0169492
NODE_10567_length_843_cov_48.258065	203	262	362	5	59	0.0847458
NODE_10567_length_843_cov_48.258065	203	262	363	6	59	0.1016949
NODE_10567_length_843_cov_48.258065	203	262	364	5	59	0.0847458
NODE_10567_length_843_cov_48.258065	203	262	365	2	59	0.0338983
NODE_10567_length_843_cov_48.258065	203	262	366	2	59	0.0338983
NODE_10567_length_843_cov_48.258065	203	262	367	2	59	0.0338983
NODE_10567_length_843_cov_48.258065	203	262	369	1	59	0.0169492
NODE_10567_length_843_cov_48.258065	203	262	373	1	59	0.0169492
NODE_10567_length_843_cov_48.258065	203	262	375	1	59	0.0169492
NODE_10567_length_843_cov_48.258065	203	262	376	3	59	0.0508475
NODE_10567_length_843_cov_48.258065	203	262	379	1	59	0.0169492
NODE_10567_length_843_cov_48.258065	203	262	384	1	59	0.0169492
NODE_10567_length_843_cov_48.258065	203	262	386	2	59	0.0338983
NODE_10567_length_843_cov_48.258065	203	262	388	2	59	0.0338983
NODE_10567_length_843_cov_48.258065	203	262	392	1	59	0.0169492
NODE_10568_length_843_cov_31.279570	351	431	3	80	80	1.0000000
NODE_10568_length_843_cov_31.279570	404	484	1	5	80	0.0625000
NODE_10568_length_843_cov_31.279570	404	484	2	22	80	0.2750000
NODE_10568_length_843_cov_31.279570	404	484	3	34	80	0.4250000
NODE_10568_length_843_cov_31.279570	404	484	4	19	80	0.2375000
NODE_10569_length_843_cov_27.060484	423	503	3	45	80	0.5625000
NODE_10569_length_843_cov_27.060484	423	503	4	35	80	0.4375000
NODE_10569_length_843_cov_27.060484	476	556	1	7	80	0.0875000
NODE_10569_length_843_cov_27.060484	476	556	2	21	80	0.2625000
NODE_10569_length_843_cov_27.060484	476	556	3	32	80	0.4000000
NODE_10569_length_843_cov_27.060484	476	556	4	20	80	0.2500000
NODE_10570_length_843_cov_22.725806	334	414	0	80	80	1.0000000
NODE_10570_length_843_cov_22.725806	339	396	0	57	57	1.0000000
NODE_10570_length_843_cov_22.725806	356	427	0	71	71	1.0000000
NODE_10570_length_843_cov_22.725806	387	455	0	68	68	1.0000000
NODE_10570_length_843_cov_22.725806	401	476	0	75	75	1.0000000
NODE_10570_length_843_cov_22.725806	418	486	0	68	68	1.0000000
NODE_10570_length_843_cov_22.725806	449	529	0	80	80	1.0000000
NODE_10571_length_843_cov_22.387097	412	492	2	16	80	0.2000000
NODE_10571_length_843_cov_22.387097	412	492	3	30	80	0.3750000
NODE_10571_length_843_cov_22.387097	412	492	4	34	80	0.4250000
NODE_10571_length_843_cov_22.387097	465	545	3	57	80	0.7125000
NODE_10571_length_843_cov_22.387097	465	545	4	23	80	0.2875000
NODE_10572_length_843_cov_16.326613	551	631	3	58	80	0.7250000
NODE_10572_length_843_cov_16.326613	551	631	4	22	80	0.2750000
NODE_10572_length_843_cov_16.326613	604	684	2	7	80	0.0875000
NODE_10572_length_843_cov_16.326613	604	684	3	72	80	0.9000000
NODE_10572_length_843_cov_16.326613	604	684	4	1	80	0.0125000
NODE_10573_length_843_cov_13.478495	381	461	1	10	80	0.1250000
NODE_10573_length_843_cov_13.478495	381	461	2	42	80	0.5250000
NODE_10573_length_843_cov_13.478495	381	461	3	28	80	0.3500000
NODE_10573_length_843_cov_13.478495	434	514	1	2	80	0.0250000
NODE_10573_length_843_cov_13.478495	434	514	2	27	80	0.3375000
NODE_10573_length_843_cov_13.478495	434	514	3	46	80	0.5750000
NODE_10573_length_843_cov_13.478495	434	514	4	5	80	0.0625000
NODE_10574_length_843_cov_13.150538	448	528	0	14	80	0.1750000
NODE_10574_length_843_cov_13.150538	448	528	1	66	80	0.8250000
NODE_10574_length_843_cov_13.150538	501	581	1	71	80	0.8875000
NODE_10574_length_843_cov_13.150538	501	581	2	9	80	0.1125000
NODE_10575_length_843_cov_12.510753	360	440	0	80	80	1.0000000
NODE_10575_length_843_cov_12.510753	413	493	0	80	80	1.0000000
NODE_10576_length_843_cov_11.090054	457	537	2	6	80	0.0750000
NODE_10576_length_843_cov_11.090054	457	537	3	4	80	0.0500000
NODE_10576_length_843_cov_11.090054	457	537	4	70	80	0.8750000
NODE_10576_length_843_cov_11.090054	510	590	2	20	80	0.2500000
NODE_10576_length_843_cov_11.090054	510	590	3	20	80	0.2500000
NODE_10576_length_843_cov_11.090054	510	590	4	40	80	0.5000000
NODE_10577_length_843_cov_7.672043	472	552	0	63	80	0.7875000
NODE_10577_length_843_cov_7.672043	472	552	1	17	80	0.2125000
NODE_10577_length_843_cov_7.672043	525	605	0	10	80	0.1250000
NODE_10577_length_843_cov_7.672043	525	605	1	67	80	0.8375000
NODE_10577_length_843_cov_7.672043	525	605	2	3	80	0.0375000
NODE_10601_length_842_cov_39.518170	390	470	0	48	80	0.6000000
NODE_10601_length_842_cov_39.518170	390	470	1	7	80	0.0875000
NODE_10601_length_842_cov_39.518170	390	470	2	25	80	0.3125000
NODE_10601_length_842_cov_39.518170	443	523	1	2	80	0.0250000
NODE_10601_length_842_cov_39.518170	443	523	2	78	80	0.9750000
NODE_10602_length_842_cov_21.567968	331	411	0	80	80	1.0000000
NODE_10602_length_842_cov_21.567968	384	464	0	80	80	1.0000000
NODE_10603_length_842_cov_19.761777	228	308	2	26	80	0.3250000
NODE_10603_length_842_cov_19.761777	228	308	3	25	80	0.3125000
NODE_10603_length_842_cov_19.761777	228	308	4	3	80	0.0375000
NODE_10603_length_842_cov_19.761777	228	308	5	16	80	0.2000000
NODE_10603_length_842_cov_19.761777	228	308	6	10	80	0.1250000
NODE_10603_length_842_cov_19.761777	281	361	4	1	80	0.0125000
NODE_10603_length_842_cov_19.761777	281	361	5	16	80	0.2000000
NODE_10603_length_842_cov_19.761777	281	361	6	32	80	0.4000000
NODE_10603_length_842_cov_19.761777	281	361	7	31	80	0.3875000
NODE_10605_length_842_cov_8.703903	641	722	0	81	81	1.0000000
NODE_10608_length_842_cov_5.305518	287	367	0	80	80	1.0000000
NODE_10608_length_842_cov_5.305518	340	420	0	80	80	1.0000000
NODE_10617_length_842_cov_1.751009	35	66	0	31	31	1.0000000
NODE_10622_length_841_cov_23.815364	292	372	2	67	80	0.8375000
NODE_10622_length_841_cov_23.815364	292	372	4	13	80	0.1625000
NODE_10622_length_841_cov_23.815364	345	425	2	16	80	0.2000000
NODE_10622_length_841_cov_23.815364	345	425	3	39	80	0.4875000
NODE_10622_length_841_cov_23.815364	345	425	4	25	80	0.3125000
NODE_10623_length_841_cov_18.871968	338	418	0	56	80	0.7000000
NODE_10623_length_841_cov_18.871968	338	418	2	24	80	0.3000000
NODE_10623_length_841_cov_18.871968	391	471	0	80	80	1.0000000
NODE_10624_length_841_cov_14.663073	345	425	2	80	80	1.0000000
NODE_10624_length_841_cov_14.663073	398	478	1	1	80	0.0125000
NODE_10624_length_841_cov_14.663073	398	478	2	79	80	0.9875000
NODE_10625_length_841_cov_14.149596	341	421	2	69	80	0.8625000
NODE_10625_length_841_cov_14.149596	341	421	5	11	80	0.1375000
NODE_10625_length_841_cov_14.149596	394	474	2	16	80	0.2000000
NODE_10625_length_841_cov_14.149596	394	474	3	32	80	0.4000000
NODE_10625_length_841_cov_14.149596	394	474	4	11	80	0.1375000
NODE_10625_length_841_cov_14.149596	394	474	5	21	80	0.2625000
NODE_10626_length_841_cov_12.452830	240	320	0	80	80	1.0000000
NODE_10626_length_841_cov_12.452830	293	373	0	80	80	1.0000000
NODE_10628_length_841_cov_9.925876	394	474	1	80	80	1.0000000
NODE_10628_length_841_cov_9.925876	447	527	0	4	80	0.0500000
NODE_10628_length_841_cov_9.925876	447	527	1	76	80	0.9500000
NODE_10629_length_841_cov_7.407008	317	397	0	3	80	0.0375000
NODE_10629_length_841_cov_7.407008	317	397	1	56	80	0.7000000
NODE_10629_length_841_cov_7.407008	317	397	2	21	80	0.2625000
NODE_10629_length_841_cov_7.407008	370	450	1	6	80	0.0750000
NODE_10629_length_841_cov_7.407008	370	450	2	74	80	0.9250000
NODE_10632_length_841_cov_3.865229	305	356	2	51	51	1.0000000
NODE_10651_length_840_cov_63.726046	461	541	2	80	80	1.0000000
NODE_10651_length_840_cov_63.726046	514	594	0	26	80	0.3250000
NODE_10651_length_840_cov_63.726046	514	594	2	54	80	0.6750000
NODE_10652_length_840_cov_35.874494	486	566	5	45	80	0.5625000
NODE_10652_length_840_cov_35.874494	486	566	7	35	80	0.4375000
NODE_10652_length_840_cov_35.874494	539	619	6	8	80	0.1000000
NODE_10652_length_840_cov_35.874494	539	619	7	72	80	0.9000000
NODE_10653_length_840_cov_24.499325	224	304	1	61	80	0.7625000
NODE_10653_length_840_cov_24.499325	224	304	2	19	80	0.2375000
NODE_10653_length_840_cov_24.499325	277	357	1	14	80	0.1750000
NODE_10653_length_840_cov_24.499325	277	357	2	15	80	0.1875000
NODE_10653_length_840_cov_24.499325	277	357	3	51	80	0.6375000
NODE_10653_length_840_cov_24.499325	353	433	0	20	80	0.2500000
NODE_10653_length_840_cov_24.499325	353	433	1	16	80	0.2000000
NODE_10653_length_840_cov_24.499325	353	433	3	44	80	0.5500000
NODE_10653_length_840_cov_24.499325	406	486	0	73	80	0.9125000
NODE_10653_length_840_cov_24.499325	406	486	1	7	80	0.0875000
NODE_10654_length_840_cov_23.272605	309	389	2	37	80	0.4625000
NODE_10654_length_840_cov_23.272605	309	389	3	43	80	0.5375000
NODE_10654_length_840_cov_23.272605	362	442	2	36	80	0.4500000
NODE_10654_length_840_cov_23.272605	362	442	3	39	80	0.4875000
NODE_10654_length_840_cov_23.272605	362	442	4	5	80	0.0625000
NODE_10655_length_840_cov_22.221323	293	373	2	11	80	0.1375000
NODE_10655_length_840_cov_22.221323	293	373	4	2	80	0.0250000
NODE_10655_length_840_cov_22.221323	293	373	6	8	80	0.1000000
NODE_10655_length_840_cov_22.221323	293	373	8	9	80	0.1125000
NODE_10655_length_840_cov_22.221323	293	373	9	50	80	0.6250000
NODE_10655_length_840_cov_22.221323	346	426	3	1	80	0.0125000
NODE_10655_length_840_cov_22.221323	346	426	5	5	80	0.0625000
NODE_10655_length_840_cov_22.221323	346	426	7	38	80	0.4750000
NODE_10655_length_840_cov_22.221323	346	426	9	36	80	0.4500000
NODE_10656_length_840_cov_17.026991	348	432	0	20	84	0.2380952
NODE_10656_length_840_cov_17.026991	348	432	1	61	84	0.7261904
NODE_10656_length_840_cov_17.026991	348	432	2	3	84	0.0357143
NODE_10656_length_840_cov_17.026991	405	485	1	24	80	0.3000000
NODE_10656_length_840_cov_17.026991	405	485	2	56	80	0.7000000
NODE_10657_length_840_cov_16.635628	347	427	2	43	80	0.5375000
NODE_10657_length_840_cov_16.635628	347	427	3	7	80	0.0875000
NODE_10657_length_840_cov_16.635628	347	427	4	30	80	0.3750000
NODE_10657_length_840_cov_16.635628	400	480	0	4	80	0.0500000
NODE_10657_length_840_cov_16.635628	400	480	1	4	80	0.0500000
NODE_10657_length_840_cov_16.635628	400	480	3	52	80	0.6500000
NODE_10657_length_840_cov_16.635628	400	480	4	20	80	0.2500000
NODE_10658_length_840_cov_12.133603	336	416	2	80	80	1.0000000
NODE_10658_length_840_cov_12.133603	389	469	0	24	80	0.3000000
NODE_10658_length_840_cov_12.133603	389	469	2	56	80	0.7000000
NODE_10659_length_840_cov_12.041835	332	412	0	19	80	0.2375000
NODE_10659_length_840_cov_12.041835	332	412	2	11	80	0.1375000
NODE_10659_length_840_cov_12.041835	332	412	4	50	80	0.6250000
NODE_10659_length_840_cov_12.041835	385	465	4	80	80	1.0000000
NODE_10660_length_840_cov_10.719298	275	354	0	45	79	0.5696203
NODE_10660_length_840_cov_10.719298	275	354	2	34	79	0.4303797
NODE_10660_length_840_cov_10.719298	327	407	2	80	80	1.0000000
NODE_10663_length_840_cov_5.207827	427	507	0	77	80	0.9625000
NODE_10663_length_840_cov_5.207827	427	507	1	1	80	0.0125000
NODE_10663_length_840_cov_5.207827	427	507	2	2	80	0.0250000
NODE_10663_length_840_cov_5.207827	480	560	0	24	80	0.3000000
NODE_10663_length_840_cov_5.207827	480	560	1	1	80	0.0125000
NODE_10663_length_840_cov_5.207827	480	560	2	55	80	0.6875000
NODE_10683_length_839_cov_274.987838	450	530	31	3	80	0.0375000
NODE_10683_length_839_cov_274.987838	450	530	32	1	80	0.0125000
NODE_10683_length_839_cov_274.987838	450	530	50	1	80	0.0125000
NODE_10683_length_839_cov_274.987838	450	530	55	1	80	0.0125000
NODE_10683_length_839_cov_274.987838	450	530	56	1	80	0.0125000
NODE_10683_length_839_cov_274.987838	450	530	59	1	80	0.0125000
NODE_10683_length_839_cov_274.987838	450	530	60	1	80	0.0125000
NODE_10683_length_839_cov_274.987838	450	530	61	2	80	0.0250000
NODE_10683_length_839_cov_274.987838	450	530	62	1	80	0.0125000
NODE_10683_length_839_cov_274.987838	450	530	64	1	80	0.0125000
NODE_10683_length_839_cov_274.987838	450	530	65	1	80	0.0125000
NODE_10683_length_839_cov_274.987838	450	530	66	1	80	0.0125000
NODE_10683_length_839_cov_274.987838	450	530	68	1	80	0.0125000
NODE_10683_length_839_cov_274.987838	450	530	73	3	80	0.0375000
NODE_10683_length_839_cov_274.987838	450	530	74	1	80	0.0125000
NODE_10683_length_839_cov_274.987838	450	530	75	1	80	0.0125000
NODE_10683_length_839_cov_274.987838	450	530	76	1	80	0.0125000
NODE_10683_length_839_cov_274.987838	450	530	78	1	80	0.0125000
NODE_10683_length_839_cov_274.987838	450	530	79	3	80	0.0375000
NODE_10683_length_839_cov_274.987838	450	530	80	1	80	0.0125000
NODE_10683_length_839_cov_274.987838	450	530	84	2	80	0.0250000
NODE_10683_length_839_cov_274.987838	450	530	85	1	80	0.0125000
NODE_10683_length_839_cov_274.987838	450	530	87	2	80	0.0250000
NODE_10683_length_839_cov_274.987838	450	530	90	2	80	0.0250000
NODE_10683_length_839_cov_274.987838	450	530	91	1	80	0.0125000
NODE_10683_length_839_cov_274.987838	450	530	93	3	80	0.0375000
NODE_10683_length_839_cov_274.987838	450	530	95	1	80	0.0125000
NODE_10683_length_839_cov_274.987838	450	530	96	2	80	0.0250000
NODE_10683_length_839_cov_274.987838	450	530	97	2	80	0.0250000
NODE_10683_length_839_cov_274.987838	450	530	99	2	80	0.0250000
NODE_10683_length_839_cov_274.987838	450	530	100	2	80	0.0250000
NODE_10683_length_839_cov_274.987838	450	530	101	1	80	0.0125000
NODE_10683_length_839_cov_274.987838	450	530	103	1	80	0.0125000
NODE_10683_length_839_cov_274.987838	450	530	104	1	80	0.0125000
NODE_10683_length_839_cov_274.987838	450	530	108	1	80	0.0125000
NODE_10683_length_839_cov_274.987838	450	530	109	1	80	0.0125000
NODE_10683_length_839_cov_274.987838	450	530	113	1	80	0.0125000
NODE_10683_length_839_cov_274.987838	450	530	115	1	80	0.0125000
NODE_10683_length_839_cov_274.987838	450	530	116	2	80	0.0250000
NODE_10683_length_839_cov_274.987838	450	530	117	3	80	0.0375000
NODE_10683_length_839_cov_274.987838	450	530	118	3	80	0.0375000
NODE_10683_length_839_cov_274.987838	450	530	119	2	80	0.0250000
NODE_10683_length_839_cov_274.987838	450	530	122	2	80	0.0250000
NODE_10683_length_839_cov_274.987838	450	530	123	1	80	0.0125000
NODE_10683_length_839_cov_274.987838	450	530	125	1	80	0.0125000
NODE_10683_length_839_cov_274.987838	450	530	127	3	80	0.0375000
NODE_10683_length_839_cov_274.987838	450	530	129	5	80	0.0625000
NODE_10683_length_839_cov_274.987838	450	530	131	1	80	0.0125000
NODE_10683_length_839_cov_274.987838	450	530	132	2	80	0.0250000
NODE_10683_length_839_cov_274.987838	450	530	139	1	80	0.0125000
NODE_10683_length_839_cov_274.987838	503	583	115	1	80	0.0125000
NODE_10683_length_839_cov_274.987838	503	583	116	2	80	0.0250000
NODE_10683_length_839_cov_274.987838	503	583	117	3	80	0.0375000
NODE_10683_length_839_cov_274.987838	503	583	118	3	80	0.0375000
NODE_10683_length_839_cov_274.987838	503	583	119	2	80	0.0250000
NODE_10683_length_839_cov_274.987838	503	583	122	2	80	0.0250000
NODE_10683_length_839_cov_274.987838	503	583	123	1	80	0.0125000
NODE_10683_length_839_cov_274.987838	503	583	125	1	80	0.0125000
NODE_10683_length_839_cov_274.987838	503	583	127	3	80	0.0375000
NODE_10683_length_839_cov_274.987838	503	583	129	5	80	0.0625000
NODE_10683_length_839_cov_274.987838	503	583	131	1	80	0.0125000
NODE_10683_length_839_cov_274.987838	503	583	132	2	80	0.0250000
NODE_10683_length_839_cov_274.987838	503	583	139	2	80	0.0250000
NODE_10683_length_839_cov_274.987838	503	583	141	1	80	0.0125000
NODE_10683_length_839_cov_274.987838	503	583	144	1	80	0.0125000
NODE_10683_length_839_cov_274.987838	503	583	148	1	80	0.0125000
NODE_10683_length_839_cov_274.987838	503	583	151	2	80	0.0250000
NODE_10683_length_839_cov_274.987838	503	583	159	1	80	0.0125000
NODE_10683_length_839_cov_274.987838	503	583	165	1	80	0.0125000
NODE_10683_length_839_cov_274.987838	503	583	172	1	80	0.0125000
NODE_10683_length_839_cov_274.987838	503	583	177	1	80	0.0125000
NODE_10683_length_839_cov_274.987838	503	583	178	1	80	0.0125000
NODE_10683_length_839_cov_274.987838	503	583	179	2	80	0.0250000
NODE_10683_length_839_cov_274.987838	503	583	180	2	80	0.0250000
NODE_10683_length_839_cov_274.987838	503	583	181	1	80	0.0125000
NODE_10683_length_839_cov_274.987838	503	583	184	1	80	0.0125000
NODE_10683_length_839_cov_274.987838	503	583	190	1	80	0.0125000
NODE_10683_length_839_cov_274.987838	503	583	191	2	80	0.0250000
NODE_10683_length_839_cov_274.987838	503	583	192	2	80	0.0250000
NODE_10683_length_839_cov_274.987838	503	583	194	1	80	0.0125000
NODE_10683_length_839_cov_274.987838	503	583	197	2	80	0.0250000
NODE_10683_length_839_cov_274.987838	503	583	198	1	80	0.0125000
NODE_10683_length_839_cov_274.987838	503	583	199	3	80	0.0375000
NODE_10683_length_839_cov_274.987838	503	583	200	4	80	0.0500000
NODE_10683_length_839_cov_274.987838	503	583	201	4	80	0.0500000
NODE_10683_length_839_cov_274.987838	503	583	202	6	80	0.0750000
NODE_10683_length_839_cov_274.987838	503	583	203	6	80	0.0750000
NODE_10683_length_839_cov_274.987838	503	583	204	3	80	0.0375000
NODE_10683_length_839_cov_274.987838	503	583	205	1	80	0.0125000
NODE_10684_length_839_cov_24.500000	303	383	1	55	80	0.6875000
NODE_10684_length_839_cov_24.500000	303	383	2	25	80	0.3125000
NODE_10684_length_839_cov_24.500000	356	436	1	3	80	0.0375000
NODE_10684_length_839_cov_24.500000	356	436	2	34	80	0.4250000
NODE_10684_length_839_cov_24.500000	356	436	3	19	80	0.2375000
NODE_10684_length_839_cov_24.500000	356	436	4	24	80	0.3000000
NODE_10685_length_839_cov_16.390541	477	557	1	80	80	1.0000000
NODE_10685_length_839_cov_16.390541	530	610	0	6	80	0.0750000
NODE_10685_length_839_cov_16.390541	530	610	1	74	80	0.9250000
NODE_10686_length_839_cov_10.006757	383	463	1	41	80	0.5125000
NODE_10686_length_839_cov_10.006757	383	463	2	39	80	0.4875000
NODE_10686_length_839_cov_10.006757	436	516	0	27	80	0.3375000
NODE_10686_length_839_cov_10.006757	436	516	1	53	80	0.6625000
NODE_10688_length_839_cov_7.612162	308	388	0	80	80	1.0000000
NODE_10688_length_839_cov_7.612162	361	441	0	80	80	1.0000000
NODE_10689_length_839_cov_6.693243	343	423	0	12	80	0.1500000
NODE_10689_length_839_cov_6.693243	343	423	2	56	80	0.7000000
NODE_10689_length_839_cov_6.693243	343	423	4	12	80	0.1500000
NODE_10706_length_838_cov_39.263870	383	463	3	1	80	0.0125000
NODE_10706_length_838_cov_39.263870	383	463	4	43	80	0.5375000
NODE_10706_length_838_cov_39.263870	383	463	5	18	80	0.2250000
NODE_10706_length_838_cov_39.263870	383	463	6	18	80	0.2250000
NODE_10706_length_838_cov_39.263870	436	516	4	22	80	0.2750000
NODE_10706_length_838_cov_39.263870	436	516	5	42	80	0.5250000
NODE_10706_length_838_cov_39.263870	436	516	6	16	80	0.2000000
NODE_10707_length_838_cov_27.843031	473	553	0	32	80	0.4000000
NODE_10707_length_838_cov_27.843031	473	553	1	48	80	0.6000000
NODE_10707_length_838_cov_27.843031	526	606	1	80	80	1.0000000
NODE_10708_length_838_cov_27.238160	432	512	1	80	80	1.0000000
NODE_10708_length_838_cov_27.238160	485	565	1	45	80	0.5625000
NODE_10708_length_838_cov_27.238160	485	565	2	35	80	0.4375000
NODE_10709_length_838_cov_22.691475	380	460	2	80	80	1.0000000
NODE_10709_length_838_cov_22.691475	433	513	0	41	80	0.5125000
NODE_10709_length_838_cov_22.691475	433	513	2	39	80	0.4875000
NODE_10710_length_838_cov_16.169147	312	392	0	50	80	0.6250000
NODE_10710_length_838_cov_16.169147	312	392	1	1	80	0.0125000
NODE_10710_length_838_cov_16.169147	312	392	2	29	80	0.3625000
NODE_10710_length_838_cov_16.169147	365	445	0	8	80	0.1000000
NODE_10710_length_838_cov_16.169147	365	445	1	1	80	0.0125000
NODE_10710_length_838_cov_16.169147	365	445	2	71	80	0.8875000
NODE_10711_length_838_cov_15.753721	328	408	2	21	80	0.2625000
NODE_10711_length_838_cov_15.753721	328	408	4	59	80	0.7375000
NODE_10711_length_838_cov_15.753721	381	461	2	74	80	0.9250000
NODE_10711_length_838_cov_15.753721	381	461	4	6	80	0.0750000
NODE_10712_length_838_cov_15.514208	294	374	2	22	80	0.2750000
NODE_10712_length_838_cov_15.514208	294	374	3	58	80	0.7250000
NODE_10712_length_838_cov_15.514208	347	427	0	7	80	0.0875000
NODE_10712_length_838_cov_15.514208	347	427	1	16	80	0.2000000
NODE_10712_length_838_cov_15.514208	347	427	2	52	80	0.6500000
NODE_10712_length_838_cov_15.514208	347	427	3	5	80	0.0625000
NODE_10713_length_838_cov_7.733424	350	430	0	80	80	1.0000000
NODE_10713_length_838_cov_7.733424	403	483	0	80	80	1.0000000
NODE_10716_length_838_cov_4.511502	131	213	0	54	82	0.6585366
NODE_10716_length_838_cov_4.511502	131	213	2	28	82	0.3414634
NODE_10716_length_838_cov_4.511502	184	252	0	1	68	0.0147059
NODE_10716_length_838_cov_4.511502	184	252	2	67	68	0.9852941
NODE_10722_length_838_cov_2.247632	359	405	0	46	46	1.0000000
NODE_10727_length_838_cov_1.843031	732	752	0	20	20	1.0000000
NODE_10740_length_837_cov_32.691057	401	481	4	80	80	1.0000000
NODE_10740_length_837_cov_32.691057	454	534	0	33	80	0.4125000
NODE_10740_length_837_cov_32.691057	454	534	2	14	80	0.1750000
NODE_10740_length_837_cov_32.691057	454	534	4	33	80	0.4125000
NODE_10741_length_837_cov_30.995935	399	479	0	80	80	1.0000000
NODE_10741_length_837_cov_30.995935	452	532	0	80	80	1.0000000
NODE_10742_length_837_cov_30.883469	278	358	0	25	80	0.3125000
NODE_10742_length_837_cov_30.883469	278	358	1	17	80	0.2125000
NODE_10742_length_837_cov_30.883469	278	358	2	38	80	0.4750000
NODE_10742_length_837_cov_30.883469	331	411	2	69	80	0.8625000
NODE_10742_length_837_cov_30.883469	331	411	3	11	80	0.1375000
NODE_10742_length_837_cov_30.883469	407	487	2	23	80	0.2875000
NODE_10742_length_837_cov_30.883469	407	487	3	47	80	0.5875000
NODE_10742_length_837_cov_30.883469	407	487	4	10	80	0.1250000
NODE_10742_length_837_cov_30.883469	460	540	2	16	80	0.2000000
NODE_10742_length_837_cov_30.883469	460	540	3	1	80	0.0125000
NODE_10742_length_837_cov_30.883469	460	540	4	63	80	0.7875000
NODE_10743_length_837_cov_14.573171	205	280	0	75	75	1.0000000
NODE_10743_length_837_cov_14.573171	258	337	0	79	79	1.0000000
NODE_10743_length_837_cov_14.573171	333	413	0	80	80	1.0000000
NODE_10743_length_837_cov_14.573171	386	466	0	80	80	1.0000000
NODE_10744_length_837_cov_12.582656	226	306	0	36	80	0.4500000
NODE_10744_length_837_cov_12.582656	226	306	2	7	80	0.0875000
NODE_10744_length_837_cov_12.582656	226	306	3	37	80	0.4625000
NODE_10744_length_837_cov_12.582656	279	359	3	35	80	0.4375000
NODE_10744_length_837_cov_12.582656	279	359	4	34	80	0.4250000
NODE_10744_length_837_cov_12.582656	279	359	6	11	80	0.1375000
NODE_10745_length_837_cov_6.998645	389	474	0	85	85	1.0000000
NODE_10745_length_837_cov_6.998645	447	527	0	80	80	1.0000000
NODE_10750_length_837_cov_3.119241	373	453	0	80	80	1.0000000
NODE_10750_length_837_cov_3.119241	426	506	0	80	80	1.0000000
NODE_10769_length_836_cov_40.141113	224	304	1	32	80	0.4000000
NODE_10769_length_836_cov_40.141113	224	304	2	27	80	0.3375000
NODE_10769_length_836_cov_40.141113	224	304	4	21	80	0.2625000
NODE_10769_length_836_cov_40.141113	277	357	2	6	80	0.0750000
NODE_10769_length_836_cov_40.141113	277	357	4	30	80	0.3750000
NODE_10769_length_836_cov_40.141113	277	357	5	1	80	0.0125000
NODE_10769_length_836_cov_40.141113	277	357	6	28	80	0.3500000
NODE_10769_length_836_cov_40.141113	277	357	7	6	80	0.0750000
NODE_10769_length_836_cov_40.141113	277	357	8	9	80	0.1125000
NODE_10769_length_836_cov_40.141113	353	433	4	11	80	0.1375000
NODE_10769_length_836_cov_40.141113	353	433	6	16	80	0.2000000
NODE_10769_length_836_cov_40.141113	353	433	7	53	80	0.6625000
NODE_10769_length_836_cov_40.141113	406	486	2	23	80	0.2875000
NODE_10769_length_836_cov_40.141113	406	486	3	1	80	0.0125000
NODE_10769_length_836_cov_40.141113	406	486	4	22	80	0.2750000
NODE_10769_length_836_cov_40.141113	406	486	5	10	80	0.1250000
NODE_10769_length_836_cov_40.141113	406	486	6	24	80	0.3000000
NODE_10770_length_836_cov_27.610583	344	424	3	8	80	0.1000000
NODE_10770_length_836_cov_27.610583	344	424	4	7	80	0.0875000
NODE_10770_length_836_cov_27.610583	344	424	5	11	80	0.1375000
NODE_10770_length_836_cov_27.610583	344	424	6	54	80	0.6750000
NODE_10770_length_836_cov_27.610583	397	477	1	25	80	0.3125000
NODE_10770_length_836_cov_27.610583	397	477	2	4	80	0.0500000
NODE_10770_length_836_cov_27.610583	397	477	3	24	80	0.3000000
NODE_10770_length_836_cov_27.610583	397	477	4	15	80	0.1875000
NODE_10770_length_836_cov_27.610583	397	477	5	11	80	0.1375000
NODE_10770_length_836_cov_27.610583	397	477	6	1	80	0.0125000
NODE_10771_length_836_cov_15.719132	295	375	2	27	80	0.3375000
NODE_10771_length_836_cov_15.719132	295	375	3	20	80	0.2500000
NODE_10771_length_836_cov_15.719132	295	375	4	33	80	0.4125000
NODE_10771_length_836_cov_15.719132	348	428	2	49	80	0.6125000
NODE_10771_length_836_cov_15.719132	348	428	3	16	80	0.2000000
NODE_10771_length_836_cov_15.719132	348	428	4	15	80	0.1875000
NODE_10772_length_836_cov_9.309362	295	375	0	80	80	1.0000000
NODE_10772_length_836_cov_9.309362	348	428	0	80	80	1.0000000
NODE_10773_length_836_cov_6.283582	336	416	0	80	80	1.0000000
NODE_10773_length_836_cov_6.283582	389	469	0	80	80	1.0000000
NODE_10774_length_836_cov_4.979647	371	451	0	80	80	1.0000000
NODE_10774_length_836_cov_4.979647	424	504	0	80	80	1.0000000
NODE_10787_length_835_cov_61.033967	253	333	8	1	80	0.0125000
NODE_10787_length_835_cov_61.033967	253	333	9	9	80	0.1125000
NODE_10787_length_835_cov_61.033967	253	333	10	13	80	0.1625000
NODE_10787_length_835_cov_61.033967	253	333	11	51	80	0.6375000
NODE_10787_length_835_cov_61.033967	253	333	12	6	80	0.0750000
NODE_10787_length_835_cov_61.033967	306	386	6	4	80	0.0500000
NODE_10787_length_835_cov_61.033967	306	386	7	31	80	0.3875000
NODE_10787_length_835_cov_61.033967	306	386	11	45	80	0.5625000
NODE_10788_length_835_cov_32.380435	390	470	2	22	80	0.2750000
NODE_10788_length_835_cov_32.380435	390	470	3	58	80	0.7250000
NODE_10788_length_835_cov_32.380435	443	523	0	4	80	0.0500000
NODE_10788_length_835_cov_32.380435	443	523	1	2	80	0.0250000
NODE_10788_length_835_cov_32.380435	443	523	2	69	80	0.8625000
NODE_10788_length_835_cov_32.380435	443	523	3	5	80	0.0625000
NODE_10789_length_835_cov_20.779891	415	495	3	31	80	0.3875000
NODE_10789_length_835_cov_20.779891	415	495	5	8	80	0.1000000
NODE_10789_length_835_cov_20.779891	415	495	6	37	80	0.4625000
NODE_10789_length_835_cov_20.779891	415	495	7	4	80	0.0500000
NODE_10789_length_835_cov_20.779891	468	548	5	5	80	0.0625000
NODE_10789_length_835_cov_20.779891	468	548	6	61	80	0.7625000
NODE_10789_length_835_cov_20.779891	468	548	7	14	80	0.1750000
NODE_10808_length_835_cov_1.694293	18	80	0	62	62	1.0000000
NODE_10820_length_834_cov_13.689796	213	293	0	80	80	1.0000000
NODE_10820_length_834_cov_13.689796	266	346	0	80	80	1.0000000
NODE_10822_length_834_cov_12.609524	406	486	0	80	80	1.0000000
NODE_10822_length_834_cov_12.609524	459	539	0	80	80	1.0000000
NODE_10823_length_834_cov_11.492517	248	328	0	80	80	1.0000000
NODE_10823_length_834_cov_11.492517	301	381	0	80	80	1.0000000
NODE_10824_length_834_cov_9.957823	212	292	0	80	80	1.0000000
NODE_10824_length_834_cov_9.957823	265	345	0	80	80	1.0000000
NODE_10825_length_834_cov_6.448980	482	546	0	64	64	1.0000000
NODE_10833_length_834_cov_2.658503	589	641	0	52	52	1.0000000
NODE_10846_length_833_cov_57.702997	338	418	0	28	80	0.3500000
NODE_10846_length_833_cov_57.702997	338	418	1	52	80	0.6500000
NODE_10846_length_833_cov_57.702997	391	471	1	80	80	1.0000000
NODE_10847_length_833_cov_38.153951	364	444	6	10	80	0.1250000
NODE_10847_length_833_cov_38.153951	364	444	7	23	80	0.2875000
NODE_10847_length_833_cov_38.153951	364	444	9	20	80	0.2500000
NODE_10847_length_833_cov_38.153951	364	444	10	8	80	0.1000000
NODE_10847_length_833_cov_38.153951	364	444	11	19	80	0.2375000
NODE_10847_length_833_cov_38.153951	417	497	7	20	80	0.2500000
NODE_10847_length_833_cov_38.153951	417	497	8	21	80	0.2625000
NODE_10847_length_833_cov_38.153951	417	497	9	16	80	0.2000000
NODE_10847_length_833_cov_38.153951	417	497	10	4	80	0.0500000
NODE_10847_length_833_cov_38.153951	417	497	11	19	80	0.2375000
NODE_10848_length_833_cov_34.302452	368	448	4	4	80	0.0500000
NODE_10848_length_833_cov_34.302452	368	448	5	76	80	0.9500000
NODE_10848_length_833_cov_34.302452	421	501	2	6	80	0.0750000
NODE_10848_length_833_cov_34.302452	421	501	3	31	80	0.3875000
NODE_10848_length_833_cov_34.302452	421	501	4	6	80	0.0750000
NODE_10848_length_833_cov_34.302452	421	501	5	37	80	0.4625000
NODE_10849_length_833_cov_20.452316	311	392	0	81	81	1.0000000
NODE_10849_length_833_cov_20.452316	365	445	0	80	80	1.0000000
NODE_10850_length_833_cov_16.643052	238	318	0	80	80	1.0000000
NODE_10851_length_833_cov_16.536785	84	164	0	6	80	0.0750000
NODE_10851_length_833_cov_16.536785	84	164	1	13	80	0.1625000
NODE_10851_length_833_cov_16.536785	84	164	2	7	80	0.0875000
NODE_10851_length_833_cov_16.536785	84	164	3	44	80	0.5500000
NODE_10851_length_833_cov_16.536785	84	164	4	10	80	0.1250000
NODE_10851_length_833_cov_16.536785	137	217	3	17	80	0.2125000
NODE_10851_length_833_cov_16.536785	137	217	4	63	80	0.7875000
NODE_10865_length_833_cov_3.089918	467	547	1	22	80	0.2750000
NODE_10865_length_833_cov_3.089918	467	547	2	1	80	0.0125000
NODE_10865_length_833_cov_3.089918	467	547	3	17	80	0.2125000
NODE_10865_length_833_cov_3.089918	467	547	4	40	80	0.5000000
NODE_10865_length_833_cov_3.089918	520	600	0	43	80	0.5375000
NODE_10865_length_833_cov_3.089918	520	600	1	32	80	0.4000000
NODE_10865_length_833_cov_3.089918	520	600	2	1	80	0.0125000
NODE_10865_length_833_cov_3.089918	520	600	3	4	80	0.0500000
NODE_10891_length_832_cov_35.728513	460	540	1	28	80	0.3500000
NODE_10891_length_832_cov_35.728513	460	540	2	52	80	0.6500000
NODE_10891_length_832_cov_35.728513	513	593	2	80	80	1.0000000
NODE_10892_length_832_cov_25.450205	292	372	1	9	80	0.1125000
NODE_10892_length_832_cov_25.450205	292	372	4	17	80	0.2125000
NODE_10892_length_832_cov_25.450205	292	372	6	41	80	0.5125000
NODE_10892_length_832_cov_25.450205	292	372	8	13	80	0.1625000
NODE_10892_length_832_cov_25.450205	345	425	6	14	80	0.1750000
NODE_10892_length_832_cov_25.450205	345	425	8	47	80	0.5875000
NODE_10892_length_832_cov_25.450205	345	425	9	19	80	0.2375000
NODE_10893_length_832_cov_18.858117	428	508	0	80	80	1.0000000
NODE_10893_length_832_cov_18.858117	481	561	0	80	80	1.0000000
NODE_10894_length_832_cov_17.799454	314	394	1	19	80	0.2375000
NODE_10894_length_832_cov_17.799454	314	394	3	28	80	0.3500000
NODE_10894_length_832_cov_17.799454	314	394	4	33	80	0.4125000
NODE_10894_length_832_cov_17.799454	367	447	4	80	80	1.0000000
NODE_10895_length_832_cov_14.811733	353	433	6	3	80	0.0375000
NODE_10895_length_832_cov_14.811733	353	433	8	3	80	0.0375000
NODE_10895_length_832_cov_14.811733	353	433	9	23	80	0.2875000
NODE_10895_length_832_cov_14.811733	353	433	11	5	80	0.0625000
NODE_10895_length_832_cov_14.811733	353	433	12	6	80	0.0750000
NODE_10895_length_832_cov_14.811733	353	433	13	5	80	0.0625000
NODE_10895_length_832_cov_14.811733	353	433	14	11	80	0.1375000
NODE_10895_length_832_cov_14.811733	353	433	15	7	80	0.0875000
NODE_10895_length_832_cov_14.811733	353	433	16	11	80	0.1375000
NODE_10895_length_832_cov_14.811733	353	433	17	6	80	0.0750000
NODE_10896_length_832_cov_14.770805	259	339	1	53	80	0.6625000
NODE_10896_length_832_cov_14.770805	259	339	2	27	80	0.3375000
NODE_10896_length_832_cov_14.770805	312	392	1	31	80	0.3875000
NODE_10896_length_832_cov_14.770805	312	392	2	49	80	0.6125000
NODE_10897_length_832_cov_8.305593	266	346	0	80	80	1.0000000
NODE_10897_length_832_cov_8.305593	319	399	0	80	80	1.0000000
NODE_10918_length_831_cov_18.403005	371	451	3	29	80	0.3625000
NODE_10918_length_831_cov_18.403005	371	451	4	51	80	0.6375000
NODE_10918_length_831_cov_18.403005	424	504	3	74	80	0.9250000
NODE_10918_length_831_cov_18.403005	424	504	4	6	80	0.0750000
NODE_10919_length_831_cov_16.017760	357	437	0	31	80	0.3875000
NODE_10919_length_831_cov_16.017760	357	437	1	49	80	0.6125000
NODE_10919_length_831_cov_16.017760	410	490	0	4	80	0.0500000
NODE_10919_length_831_cov_16.017760	410	490	1	76	80	0.9500000
NODE_10920_length_831_cov_13.740437	405	485	0	80	80	1.0000000
NODE_10920_length_831_cov_13.740437	458	538	0	80	80	1.0000000
NODE_10921_length_831_cov_9.595628	281	361	0	80	80	1.0000000
NODE_10921_length_831_cov_9.595628	334	414	0	80	80	1.0000000
NODE_10922_length_831_cov_8.199454	433	482	2	7	49	0.1428571
NODE_10922_length_831_cov_8.199454	433	482	4	23	49	0.4693878
NODE_10922_length_831_cov_8.199454	433	482	5	19	49	0.3877551
NODE_10923_length_831_cov_7.607923	216	296	0	80	80	1.0000000
NODE_10923_length_831_cov_7.607923	269	349	0	80	80	1.0000000
NODE_10924_length_831_cov_6.454918	334	409	2	27	75	0.3600000
NODE_10924_length_831_cov_6.454918	334	409	3	1	75	0.0133333
NODE_10924_length_831_cov_6.454918	334	409	4	29	75	0.3866667
NODE_10924_length_831_cov_6.454918	334	409	5	18	75	0.2400000
NODE_10924_length_831_cov_6.454918	382	462	4	24	80	0.3000000
NODE_10924_length_831_cov_6.454918	382	462	5	56	80	0.7000000
NODE_10960_length_830_cov_40.856361	238	318	0	2	80	0.0250000
NODE_10960_length_830_cov_40.856361	238	318	1	78	80	0.9750000
NODE_10960_length_830_cov_40.856361	291	371	1	80	80	1.0000000
NODE_10961_length_830_cov_32.170999	302	378	4	1	76	0.0131579
NODE_10961_length_830_cov_32.170999	302	378	5	28	76	0.3684210
NODE_10961_length_830_cov_32.170999	302	378	6	32	76	0.4210526
NODE_10961_length_830_cov_32.170999	302	378	7	15	76	0.1973684
NODE_10961_length_830_cov_32.170999	303	383	5	29	80	0.3625000
NODE_10961_length_830_cov_32.170999	303	383	6	36	80	0.4500000
NODE_10961_length_830_cov_32.170999	303	383	7	15	80	0.1875000
NODE_10961_length_830_cov_32.170999	356	436	5	33	80	0.4125000
NODE_10961_length_830_cov_32.170999	356	436	6	16	80	0.2000000
NODE_10961_length_830_cov_32.170999	356	436	7	31	80	0.3875000
NODE_10962_length_830_cov_28.041040	393	473	0	38	80	0.4750000
NODE_10962_length_830_cov_28.041040	393	473	2	42	80	0.5250000
NODE_10962_length_830_cov_28.041040	446	526	0	80	80	1.0000000
NODE_10963_length_830_cov_20.280438	360	440	1	54	80	0.6750000
NODE_10963_length_830_cov_20.280438	360	440	2	26	80	0.3250000
NODE_10963_length_830_cov_20.280438	413	492	0	45	79	0.5696203
NODE_10963_length_830_cov_20.280438	413	492	1	34	79	0.4303797
NODE_10964_length_830_cov_19.495212	274	354	0	80	80	1.0000000
NODE_10964_length_830_cov_19.495212	327	407	0	57	80	0.7125000
NODE_10964_length_830_cov_19.495212	327	407	2	23	80	0.2875000
NODE_10965_length_830_cov_18.522572	368	448	1	13	80	0.1625000
NODE_10965_length_830_cov_18.522572	368	448	2	18	80	0.2250000
NODE_10965_length_830_cov_18.522572	368	448	3	5	80	0.0625000
NODE_10965_length_830_cov_18.522572	368	448	4	44	80	0.5500000
NODE_10965_length_830_cov_18.522572	421	501	1	53	80	0.6625000
NODE_10965_length_830_cov_18.522572	421	501	2	18	80	0.2250000
NODE_10965_length_830_cov_18.522572	421	501	4	9	80	0.1125000
NODE_10966_length_830_cov_13.830369	278	358	0	80	80	1.0000000
NODE_10966_length_830_cov_13.830369	331	411	0	80	80	1.0000000
NODE_10967_length_830_cov_12.459644	201	281	0	80	80	1.0000000
NODE_10967_length_830_cov_12.459644	254	334	0	80	80	1.0000000
NODE_10968_length_830_cov_8.344733	450	530	1	15	80	0.1875000
NODE_10968_length_830_cov_8.344733	450	530	2	65	80	0.8125000
NODE_10968_length_830_cov_8.344733	503	583	1	26	80	0.3250000
NODE_10968_length_830_cov_8.344733	503	583	2	54	80	0.6750000
NODE_10969_length_830_cov_8.227086	634	714	0	80	80	1.0000000
NODE_10969_length_830_cov_8.227086	687	767	0	80	80	1.0000000
NODE_10995_length_829_cov_74.910959	271	351	0	4	80	0.0500000
NODE_10995_length_829_cov_74.910959	271	351	2	5	80	0.0625000
NODE_10995_length_829_cov_74.910959	271	351	4	71	80	0.8875000
NODE_10995_length_829_cov_74.910959	324	404	1	6	80	0.0750000
NODE_10995_length_829_cov_74.910959	324	404	2	12	80	0.1500000
NODE_10995_length_829_cov_74.910959	324	404	3	14	80	0.1750000
NODE_10995_length_829_cov_74.910959	324	404	4	48	80	0.6000000
NODE_10996_length_829_cov_34.068493	302	382	0	64	80	0.8000000
NODE_10996_length_829_cov_34.068493	302	382	2	16	80	0.2000000
NODE_10996_length_829_cov_34.068493	355	435	0	11	80	0.1375000
NODE_10996_length_829_cov_34.068493	355	435	2	69	80	0.8625000
NODE_10997_length_829_cov_24.027397	441	521	3	80	80	1.0000000
NODE_10997_length_829_cov_24.027397	494	574	0	18	80	0.2250000
NODE_10997_length_829_cov_24.027397	494	574	1	5	80	0.0625000
NODE_10997_length_829_cov_24.027397	494	574	2	16	80	0.2000000
NODE_10997_length_829_cov_24.027397	494	574	3	41	80	0.5125000
NODE_10998_length_829_cov_21.735616	420	500	4	80	80	1.0000000
NODE_10998_length_829_cov_21.735616	473	553	1	4	80	0.0500000
NODE_10998_length_829_cov_21.735616	473	553	2	6	80	0.0750000
NODE_10998_length_829_cov_21.735616	473	553	4	70	80	0.8750000
NODE_10999_length_829_cov_18.446575	407	487	4	35	80	0.4375000
NODE_10999_length_829_cov_18.446575	407	487	5	45	80	0.5625000
NODE_10999_length_829_cov_18.446575	460	540	4	15	80	0.1875000
NODE_10999_length_829_cov_18.446575	460	540	5	65	80	0.8125000
NODE_11000_length_829_cov_10.971233	368	448	2	80	80	1.0000000
NODE_11000_length_829_cov_10.971233	421	501	0	2	80	0.0250000
NODE_11000_length_829_cov_10.971233	421	501	2	78	80	0.9750000
NODE_11001_length_829_cov_10.035616	387	467	0	45	80	0.5625000
NODE_11001_length_829_cov_10.035616	387	467	1	35	80	0.4375000
NODE_11001_length_829_cov_10.035616	440	520	0	9	80	0.1125000
NODE_11001_length_829_cov_10.035616	440	520	1	71	80	0.8875000
NODE_11002_length_829_cov_9.906849	326	406	0	80	80	1.0000000
NODE_11002_length_829_cov_9.906849	379	459	0	80	80	1.0000000
NODE_11003_length_829_cov_8.809589	450	530	3	5	80	0.0625000
NODE_11003_length_829_cov_8.809589	450	530	4	19	80	0.2375000
NODE_11003_length_829_cov_8.809589	450	530	5	56	80	0.7000000
NODE_11003_length_829_cov_8.809589	503	583	2	36	80	0.4500000
NODE_11003_length_829_cov_8.809589	503	583	3	9	80	0.1125000
NODE_11003_length_829_cov_8.809589	503	583	4	12	80	0.1500000
NODE_11003_length_829_cov_8.809589	503	583	5	23	80	0.2875000
NODE_11006_length_829_cov_4.310959	473	553	0	80	80	1.0000000
NODE_11006_length_829_cov_4.310959	526	606	0	80	80	1.0000000
NODE_11008_length_829_cov_3.079452	507	587	0	8	80	0.1000000
NODE_11008_length_829_cov_3.079452	507	587	1	54	80	0.6750000
NODE_11008_length_829_cov_3.079452	507	587	2	18	80	0.2250000
NODE_11008_length_829_cov_3.079452	507	587	0	8	80	0.1000000
NODE_11008_length_829_cov_3.079452	507	587	1	54	80	0.6750000
NODE_11008_length_829_cov_3.079452	507	587	2	18	80	0.2250000
NODE_11008_length_829_cov_3.079452	560	640	1	9	80	0.1125000
NODE_11008_length_829_cov_3.079452	560	640	2	67	80	0.8375000
NODE_11008_length_829_cov_3.079452	560	640	4	4	80	0.0500000
NODE_11025_length_828_cov_41.116598	436	516	0	46	80	0.5750000
NODE_11025_length_828_cov_41.116598	436	516	1	34	80	0.4250000
NODE_11025_length_828_cov_41.116598	489	569	1	30	80	0.3750000
NODE_11025_length_828_cov_41.116598	489	569	2	50	80	0.6250000
NODE_11026_length_828_cov_36.459534	372	452	0	80	80	1.0000000
NODE_11026_length_828_cov_36.459534	425	505	0	80	80	1.0000000
NODE_11027_length_828_cov_33.515775	443	523	1	19	80	0.2375000
NODE_11027_length_828_cov_33.515775	443	523	2	38	80	0.4750000
NODE_11027_length_828_cov_33.515775	443	523	3	23	80	0.2875000
NODE_11027_length_828_cov_33.515775	496	576	0	4	80	0.0500000
NODE_11027_length_828_cov_33.515775	496	576	1	68	80	0.8500000
NODE_11027_length_828_cov_33.515775	496	576	2	8	80	0.1000000
NODE_11028_length_828_cov_21.123457	380	460	0	80	80	1.0000000
NODE_11028_length_828_cov_21.123457	433	513	0	80	80	1.0000000
NODE_11029_length_828_cov_17.406036	304	392	1	88	88	1.0000000
NODE_11029_length_828_cov_17.406036	369	445	0	12	76	0.1578947
NODE_11029_length_828_cov_17.406036	369	445	1	64	76	0.8421053
NODE_11030_length_828_cov_14.606310	287	367	2	25	80	0.3125000
NODE_11030_length_828_cov_14.606310	287	367	3	55	80	0.6875000
NODE_11030_length_828_cov_14.606310	340	420	2	63	80	0.7875000
NODE_11030_length_828_cov_14.606310	340	420	3	17	80	0.2125000
NODE_11031_length_828_cov_14.493827	326	406	0	80	80	1.0000000
NODE_11031_length_828_cov_14.493827	379	459	0	80	80	1.0000000
NODE_11031_length_828_cov_14.493827	455	535	0	80	80	1.0000000
NODE_11031_length_828_cov_14.493827	508	588	0	71	80	0.8875000
NODE_11031_length_828_cov_14.493827	508	588	1	9	80	0.1125000
NODE_11032_length_828_cov_10.550069	280	360	1	20	80	0.2500000
NODE_11032_length_828_cov_10.550069	280	360	2	60	80	0.7500000
NODE_11032_length_828_cov_10.550069	333	413	0	23	80	0.2875000
NODE_11032_length_828_cov_10.550069	333	413	1	50	80	0.6250000
NODE_11032_length_828_cov_10.550069	333	413	2	7	80	0.0875000
NODE_11033_length_828_cov_9.292181	594	674	0	80	80	1.0000000
NODE_11033_length_828_cov_9.292181	647	727	0	80	80	1.0000000
NODE_11034_length_828_cov_8.747599	298	378	4	80	80	1.0000000
NODE_11034_length_828_cov_8.747599	351	431	0	15	80	0.1875000
NODE_11034_length_828_cov_8.747599	351	431	2	23	80	0.2875000
NODE_11034_length_828_cov_8.747599	351	431	4	42	80	0.5250000
NODE_11035_length_828_cov_8.098765	199	279	1	10	80	0.1250000
NODE_11035_length_828_cov_8.098765	199	279	3	70	80	0.8750000
NODE_11035_length_828_cov_8.098765	252	332	3	80	80	1.0000000
NODE_11037_length_828_cov_7.473251	300	380	0	80	80	1.0000000
NODE_11037_length_828_cov_7.473251	353	433	0	80	80	1.0000000
NODE_11039_length_828_cov_5.481481	543	623	0	64	80	0.8000000
NODE_11039_length_828_cov_5.481481	543	623	2	16	80	0.2000000
NODE_11039_length_828_cov_5.481481	596	676	0	11	80	0.1375000
NODE_11039_length_828_cov_5.481481	596	676	2	69	80	0.8625000
NODE_11041_length_828_cov_5.069959	259	339	1	35	80	0.4375000
NODE_11041_length_828_cov_5.069959	259	339	2	20	80	0.2500000
NODE_11041_length_828_cov_5.069959	259	339	4	25	80	0.3125000
NODE_11066_length_827_cov_34.567308	269	349	1	29	80	0.3625000
NODE_11066_length_827_cov_34.567308	269	349	2	2	80	0.0250000
NODE_11066_length_827_cov_34.567308	269	349	4	49	80	0.6125000
NODE_11066_length_827_cov_34.567308	322	402	3	20	80	0.2500000
NODE_11066_length_827_cov_34.567308	322	402	4	60	80	0.7500000
NODE_11066_length_827_cov_34.567308	398	478	0	28	80	0.3500000
NODE_11066_length_827_cov_34.567308	398	478	2	3	80	0.0375000
NODE_11066_length_827_cov_34.567308	398	478	3	49	80	0.6125000
NODE_11066_length_827_cov_34.567308	451	531	0	80	80	1.0000000
NODE_11067_length_827_cov_31.538462	320	400	2	26	80	0.3250000
NODE_11067_length_827_cov_31.538462	320	400	3	54	80	0.6750000
NODE_11067_length_827_cov_31.538462	373	453	1	37	80	0.4625000
NODE_11067_length_827_cov_31.538462	373	453	3	43	80	0.5375000
NODE_11068_length_827_cov_19.548077	464	544	3	11	80	0.1375000
NODE_11068_length_827_cov_19.548077	464	544	4	69	80	0.8625000
NODE_11068_length_827_cov_19.548077	517	597	1	1	80	0.0125000
NODE_11068_length_827_cov_19.548077	517	597	2	31	80	0.3875000
NODE_11068_length_827_cov_19.548077	517	597	4	48	80	0.6000000
NODE_11069_length_827_cov_17.490385	320	400	0	80	80	1.0000000
NODE_11069_length_827_cov_17.490385	373	453	0	80	80	1.0000000
NODE_11070_length_827_cov_15.247253	205	285	2	27	80	0.3375000
NODE_11070_length_827_cov_15.247253	205	285	3	44	80	0.5500000
NODE_11070_length_827_cov_15.247253	205	285	4	9	80	0.1125000
NODE_11070_length_827_cov_15.247253	258	338	2	64	80	0.8000000
NODE_11070_length_827_cov_15.247253	258	338	3	16	80	0.2000000
NODE_11071_length_827_cov_14.151099	372	452	3	3	80	0.0375000
NODE_11071_length_827_cov_14.151099	372	452	4	9	80	0.1125000
NODE_11071_length_827_cov_14.151099	372	452	5	18	80	0.2250000
NODE_11071_length_827_cov_14.151099	372	452	6	50	80	0.6250000
NODE_11071_length_827_cov_14.151099	425	505	1	22	80	0.2750000
NODE_11071_length_827_cov_14.151099	425	505	2	7	80	0.0875000
NODE_11071_length_827_cov_14.151099	425	505	3	27	80	0.3375000
NODE_11071_length_827_cov_14.151099	425	505	4	9	80	0.1125000
NODE_11071_length_827_cov_14.151099	425	505	5	12	80	0.1500000
NODE_11071_length_827_cov_14.151099	425	505	6	3	80	0.0375000
NODE_11072_length_827_cov_12.157967	262	342	0	31	80	0.3875000
NODE_11072_length_827_cov_12.157967	262	342	1	20	80	0.2500000
NODE_11072_length_827_cov_12.157967	262	342	2	29	80	0.3625000
NODE_11072_length_827_cov_12.157967	315	395	2	80	80	1.0000000
NODE_11073_length_827_cov_11.777473	316	396	0	80	80	1.0000000
NODE_11073_length_827_cov_11.777473	369	449	0	80	80	1.0000000
NODE_11074_length_827_cov_11.651099	393	473	2	80	80	1.0000000
NODE_11074_length_827_cov_11.651099	446	526	2	62	80	0.7750000
NODE_11074_length_827_cov_11.651099	446	526	3	18	80	0.2250000
NODE_11075_length_827_cov_10.711538	286	366	0	80	80	1.0000000
NODE_11075_length_827_cov_10.711538	339	419	0	80	80	1.0000000
NODE_11076_length_827_cov_10.262363	273	353	0	33	80	0.4125000
NODE_11076_length_827_cov_10.262363	273	353	1	44	80	0.5500000
NODE_11076_length_827_cov_10.262363	273	353	2	3	80	0.0375000
NODE_11076_length_827_cov_10.262363	326	406	1	24	80	0.3000000
NODE_11076_length_827_cov_10.262363	326	406	2	56	80	0.7000000
NODE_11077_length_827_cov_10.221154	256	336	2	9	80	0.1125000
NODE_11077_length_827_cov_10.221154	256	336	3	19	80	0.2375000
NODE_11077_length_827_cov_10.221154	256	336	4	36	80	0.4500000
NODE_11077_length_827_cov_10.221154	256	336	5	16	80	0.2000000
NODE_11078_length_827_cov_9.576923	359	439	1	46	80	0.5750000
NODE_11078_length_827_cov_9.576923	359	439	2	34	80	0.4250000
NODE_11078_length_827_cov_9.576923	412	492	1	45	80	0.5625000
NODE_11078_length_827_cov_9.576923	412	492	2	35	80	0.4375000
NODE_11079_length_827_cov_8.780220	361	441	0	10	80	0.1250000
NODE_11079_length_827_cov_8.780220	361	441	2	27	80	0.3375000
NODE_11079_length_827_cov_8.780220	361	441	3	5	80	0.0625000
NODE_11079_length_827_cov_8.780220	361	441	5	13	80	0.1625000
NODE_11079_length_827_cov_8.780220	361	441	6	25	80	0.3125000
NODE_11079_length_827_cov_8.780220	414	494	2	12	80	0.1500000
NODE_11079_length_827_cov_8.780220	414	494	4	7	80	0.0875000
NODE_11079_length_827_cov_8.780220	414	494	5	2	80	0.0250000
NODE_11079_length_827_cov_8.780220	414	494	6	59	80	0.7375000
NODE_11093_length_827_cov_1.412088	736	784	0	7	48	0.1458333
NODE_11093_length_827_cov_1.412088	736	784	1	5	48	0.1041667
NODE_11093_length_827_cov_1.412088	736	784	3	36	48	0.7500000
NODE_11106_length_826_cov_34.026135	211	291	6	54	80	0.6750000
NODE_11106_length_826_cov_34.026135	211	291	8	26	80	0.3250000
NODE_11106_length_826_cov_34.026135	264	344	2	3	80	0.0375000
NODE_11106_length_826_cov_34.026135	264	344	4	8	80	0.1000000
NODE_11106_length_826_cov_34.026135	264	344	5	2	80	0.0250000
NODE_11106_length_826_cov_34.026135	264	344	6	53	80	0.6625000
NODE_11106_length_826_cov_34.026135	264	344	8	14	80	0.1750000
NODE_11107_length_826_cov_24.093535	282	362	1	80	80	1.0000000
NODE_11107_length_826_cov_24.093535	335	415	1	80	80	1.0000000
NODE_11108_length_826_cov_20.943604	207	287	1	63	80	0.7875000
NODE_11108_length_826_cov_20.943604	207	287	2	17	80	0.2125000
NODE_11108_length_826_cov_20.943604	260	340	0	38	80	0.4750000
NODE_11108_length_826_cov_20.943604	260	340	1	42	80	0.5250000
NODE_11109_length_826_cov_20.437414	413	493	0	80	80	1.0000000
NODE_11109_length_826_cov_20.437414	466	546	0	80	80	1.0000000
NODE_11110_length_826_cov_20.200825	432	512	3	69	80	0.8625000
NODE_11110_length_826_cov_20.200825	432	512	4	11	80	0.1375000
NODE_11110_length_826_cov_20.200825	485	565	2	45	80	0.5625000
NODE_11110_length_826_cov_20.200825	485	565	3	35	80	0.4375000
NODE_11111_length_826_cov_18.489684	345	425	1	80	80	1.0000000
NODE_11111_length_826_cov_18.489684	398	478	1	80	80	1.0000000
NODE_11112_length_826_cov_17.998624	336	416	3	34	80	0.4250000
NODE_11112_length_826_cov_17.998624	336	416	4	9	80	0.1125000
NODE_11112_length_826_cov_17.998624	336	416	5	16	80	0.2000000
NODE_11112_length_826_cov_17.998624	336	416	6	21	80	0.2625000
NODE_11112_length_826_cov_17.998624	389	469	3	40	80	0.5000000
NODE_11112_length_826_cov_17.998624	389	469	4	22	80	0.2750000
NODE_11112_length_826_cov_17.998624	389	469	6	18	80	0.2250000
NODE_11113_length_826_cov_17.038514	358	438	0	9	80	0.1125000
NODE_11113_length_826_cov_17.038514	358	438	1	71	80	0.8875000
NODE_11113_length_826_cov_17.038514	411	491	0	62	80	0.7750000
NODE_11113_length_826_cov_17.038514	411	491	1	18	80	0.2250000
NODE_11114_length_826_cov_16.777166	514	603	0	89	89	1.0000000
NODE_11115_length_826_cov_16.177442	361	441	2	67	80	0.8375000
NODE_11115_length_826_cov_16.177442	361	441	3	13	80	0.1625000
NODE_11115_length_826_cov_16.177442	414	494	2	45	80	0.5625000
NODE_11115_length_826_cov_16.177442	414	494	3	35	80	0.4375000
NODE_11116_length_826_cov_15.134801	346	426	0	80	80	1.0000000
NODE_11116_length_826_cov_15.134801	399	479	0	80	80	1.0000000
NODE_11117_length_826_cov_9.943604	320	400	0	15	80	0.1875000
NODE_11117_length_826_cov_9.943604	320	400	1	1	80	0.0125000
NODE_11117_length_826_cov_9.943604	320	400	3	38	80	0.4750000
NODE_11117_length_826_cov_9.943604	320	400	4	26	80	0.3250000
NODE_11117_length_826_cov_9.943604	373	453	3	1	80	0.0125000
NODE_11117_length_826_cov_9.943604	373	453	4	31	80	0.3875000
NODE_11117_length_826_cov_9.943604	373	453	6	48	80	0.6000000
NODE_11120_length_826_cov_4.852820	501	579	2	78	78	1.0000000
NODE_11120_length_826_cov_4.852820	552	632	0	34	80	0.4250000
NODE_11120_length_826_cov_4.852820	552	632	1	14	80	0.1750000
NODE_11120_length_826_cov_4.852820	552	632	2	32	80	0.4000000
NODE_11161_length_825_cov_61.804408	382	462	0	33	80	0.4125000
NODE_11161_length_825_cov_61.804408	382	462	3	1	80	0.0125000
NODE_11161_length_825_cov_61.804408	382	462	4	46	80	0.5750000
NODE_11161_length_825_cov_61.804408	435	514	0	28	79	0.3544304
NODE_11161_length_825_cov_61.804408	435	514	4	51	79	0.6455696
NODE_11162_length_825_cov_43.825069	488	568	0	23	80	0.2875000
NODE_11162_length_825_cov_43.825069	488	568	1	57	80	0.7125000
NODE_11162_length_825_cov_43.825069	541	621	1	50	80	0.6250000
NODE_11162_length_825_cov_43.825069	541	621	2	9	80	0.1125000
NODE_11162_length_825_cov_43.825069	541	621	4	21	80	0.2625000
NODE_11162_length_825_cov_43.825069	617	697	3	2	80	0.0250000
NODE_11162_length_825_cov_43.825069	617	697	4	44	80	0.5500000
NODE_11162_length_825_cov_43.825069	617	697	5	34	80	0.4250000
NODE_11162_length_825_cov_43.825069	670	750	2	9	80	0.1125000
NODE_11162_length_825_cov_43.825069	670	750	3	6	80	0.0750000
NODE_11162_length_825_cov_43.825069	670	750	5	65	80	0.8125000
NODE_11163_length_825_cov_43.389807	496	576	2	6	80	0.0750000
NODE_11163_length_825_cov_43.389807	496	576	3	47	80	0.5875000
NODE_11163_length_825_cov_43.389807	496	576	4	15	80	0.1875000
NODE_11163_length_825_cov_43.389807	496	576	6	12	80	0.1500000
NODE_11163_length_825_cov_43.389807	549	629	3	1	80	0.0125000
NODE_11163_length_825_cov_43.389807	549	629	4	14	80	0.1750000
NODE_11163_length_825_cov_43.389807	549	629	5	34	80	0.4250000
NODE_11163_length_825_cov_43.389807	549	629	6	31	80	0.3875000
NODE_11164_length_825_cov_39.603306	386	466	0	80	80	1.0000000
NODE_11164_length_825_cov_39.603306	439	519	0	80	80	1.0000000
NODE_11165_length_825_cov_32.205234	354	434	1	21	80	0.2625000
NODE_11165_length_825_cov_32.205234	354	434	2	18	80	0.2250000
NODE_11165_length_825_cov_32.205234	354	434	3	41	80	0.5125000
NODE_11165_length_825_cov_32.205234	407	487	2	22	80	0.2750000
NODE_11165_length_825_cov_32.205234	407	487	3	58	80	0.7250000
NODE_11166_length_825_cov_29.411846	503	583	0	7	80	0.0875000
NODE_11166_length_825_cov_29.411846	503	583	1	1	80	0.0125000
NODE_11166_length_825_cov_29.411846	503	583	3	72	80	0.9000000
NODE_11166_length_825_cov_29.411846	556	636	0	52	80	0.6500000
NODE_11166_length_825_cov_29.411846	556	636	1	9	80	0.1125000
NODE_11166_length_825_cov_29.411846	556	636	3	19	80	0.2375000
NODE_11167_length_825_cov_22.428375	312	392	8	27	80	0.3375000
NODE_11167_length_825_cov_22.428375	312	392	9	21	80	0.2625000
NODE_11167_length_825_cov_22.428375	312	392	10	31	80	0.3875000
NODE_11167_length_825_cov_22.428375	312	392	11	1	80	0.0125000
NODE_11167_length_825_cov_22.428375	365	445	8	5	80	0.0625000
NODE_11167_length_825_cov_22.428375	365	445	9	4	80	0.0500000
NODE_11167_length_825_cov_22.428375	365	445	10	35	80	0.4375000
NODE_11167_length_825_cov_22.428375	365	445	11	10	80	0.1250000
NODE_11167_length_825_cov_22.428375	365	445	12	2	80	0.0250000
NODE_11167_length_825_cov_22.428375	365	445	13	24	80	0.3000000
NODE_11167_length_825_cov_22.428375	441	521	3	1	80	0.0125000
NODE_11167_length_825_cov_22.428375	441	521	4	2	80	0.0250000
NODE_11167_length_825_cov_22.428375	441	521	6	6	80	0.0750000
NODE_11167_length_825_cov_22.428375	441	521	8	61	80	0.7625000
NODE_11167_length_825_cov_22.428375	441	521	10	1	80	0.0125000
NODE_11167_length_825_cov_22.428375	441	521	11	9	80	0.1125000
NODE_11167_length_825_cov_22.428375	494	574	1	16	80	0.2000000
NODE_11167_length_825_cov_22.428375	494	574	2	34	80	0.4250000
NODE_11167_length_825_cov_22.428375	494	574	3	4	80	0.0500000
NODE_11167_length_825_cov_22.428375	494	574	4	2	80	0.0250000
NODE_11167_length_825_cov_22.428375	494	574	6	6	80	0.0750000
NODE_11167_length_825_cov_22.428375	494	574	8	18	80	0.2250000
NODE_11168_length_825_cov_19.964187	249	329	2	80	80	1.0000000
NODE_11168_length_825_cov_19.964187	302	382	0	15	80	0.1875000
NODE_11168_length_825_cov_19.964187	302	382	1	27	80	0.3375000
NODE_11168_length_825_cov_19.964187	302	382	2	38	80	0.4750000
NODE_11169_length_825_cov_13.790634	273	353	2	26	80	0.3250000
NODE_11169_length_825_cov_13.790634	273	353	3	34	80	0.4250000
NODE_11169_length_825_cov_13.790634	273	353	4	20	80	0.2500000
NODE_11169_length_825_cov_13.790634	326	406	3	20	80	0.2500000
NODE_11169_length_825_cov_13.790634	326	406	4	51	80	0.6375000
NODE_11169_length_825_cov_13.790634	326	406	5	9	80	0.1125000
NODE_11170_length_825_cov_11.834711	331	411	0	80	80	1.0000000
NODE_11170_length_825_cov_11.834711	384	464	0	80	80	1.0000000
NODE_11171_length_825_cov_11.477961	392	472	4	80	80	1.0000000
NODE_11172_length_825_cov_8.947658	259	339	0	1	80	0.0125000
NODE_11172_length_825_cov_8.947658	259	339	1	70	80	0.8750000
NODE_11172_length_825_cov_8.947658	259	339	2	9	80	0.1125000
NODE_11172_length_825_cov_8.947658	312	392	0	54	80	0.6750000
NODE_11172_length_825_cov_8.947658	312	392	1	26	80	0.3250000
NODE_11173_length_825_cov_7.811295	379	459	0	31	80	0.3875000
NODE_11173_length_825_cov_7.811295	379	459	2	7	80	0.0875000
NODE_11173_length_825_cov_7.811295	379	459	3	42	80	0.5250000
NODE_11173_length_825_cov_7.811295	432	512	3	47	80	0.5875000
NODE_11173_length_825_cov_7.811295	432	512	4	33	80	0.4125000
NODE_11174_length_825_cov_7.104683	464	544	1	80	80	1.0000000
NODE_11174_length_825_cov_7.104683	517	597	1	56	80	0.7000000
NODE_11174_length_825_cov_7.104683	517	597	2	24	80	0.3000000
NODE_11176_length_825_cov_6.252066	542	622	0	80	80	1.0000000
NODE_11176_length_825_cov_6.252066	595	675	0	80	80	1.0000000
NODE_11178_length_825_cov_5.230028	264	344	0	80	80	1.0000000
NODE_11178_length_825_cov_5.230028	317	372	0	55	55	1.0000000
NODE_11178_length_825_cov_5.230028	383	463	0	80	80	1.0000000
NODE_11178_length_825_cov_5.230028	436	516	0	80	80	1.0000000
NODE_11205_length_825_cov_0.765840	0	50	0	50	50	1.0000000
NODE_11207_length_824_cov_27.074483	337	412	4	12	75	0.1600000
NODE_11207_length_824_cov_27.074483	337	412	5	15	75	0.2000000
NODE_11207_length_824_cov_27.074483	337	412	6	23	75	0.3066667
NODE_11207_length_824_cov_27.074483	337	412	7	18	75	0.2400000
NODE_11207_length_824_cov_27.074483	337	412	8	7	75	0.0933333
NODE_11207_length_824_cov_27.074483	390	470	6	24	80	0.3000000
NODE_11207_length_824_cov_27.074483	390	470	7	49	80	0.6125000
NODE_11207_length_824_cov_27.074483	390	470	8	7	80	0.0875000
NODE_11208_length_824_cov_23.936552	365	445	1	80	80	1.0000000
NODE_11208_length_824_cov_23.936552	418	493	0	9	75	0.1200000
NODE_11208_length_824_cov_23.936552	418	493	1	66	75	0.8800000
NODE_11209_length_824_cov_22.129655	377	457	0	80	80	1.0000000
NODE_11209_length_824_cov_22.129655	430	510	0	80	80	1.0000000
NODE_11210_length_824_cov_17.914483	387	467	0	18	80	0.2250000
NODE_11210_length_824_cov_17.914483	387	467	2	62	80	0.7750000
NODE_11210_length_824_cov_17.914483	440	520	0	18	80	0.2250000
NODE_11210_length_824_cov_17.914483	440	520	2	62	80	0.7750000
NODE_11211_length_824_cov_16.662069	362	442	2	31	80	0.3875000
NODE_11211_length_824_cov_16.662069	362	442	3	49	80	0.6125000
NODE_11211_length_824_cov_16.662069	415	495	1	3	80	0.0375000
NODE_11211_length_824_cov_16.662069	415	495	2	55	80	0.6875000
NODE_11211_length_824_cov_16.662069	415	495	3	22	80	0.2750000
NODE_11212_length_824_cov_16.306207	352	432	0	80	80	1.0000000
NODE_11212_length_824_cov_16.306207	405	485	0	80	80	1.0000000
NODE_11213_length_824_cov_15.891034	342	422	0	80	80	1.0000000
NODE_11213_length_824_cov_15.891034	395	475	0	80	80	1.0000000
NODE_11214_length_824_cov_12.485517	280	360	0	27	80	0.3375000
NODE_11214_length_824_cov_12.485517	280	360	2	53	80	0.6625000
NODE_11214_length_824_cov_12.485517	333	413	2	80	80	1.0000000
NODE_11216_length_824_cov_5.924138	269	349	0	18	80	0.2250000
NODE_11216_length_824_cov_5.924138	269	349	1	6	80	0.0750000
NODE_11216_length_824_cov_5.924138	269	349	2	56	80	0.7000000
NODE_11216_length_824_cov_5.924138	322	402	2	80	80	1.0000000
NODE_11222_length_824_cov_3.849655	191	271	0	80	80	1.0000000
NODE_11251_length_823_cov_75.169890	207	287	3	3	80	0.0375000
NODE_11251_length_823_cov_75.169890	207	287	4	13	80	0.1625000
NODE_11251_length_823_cov_75.169890	207	287	5	18	80	0.2250000
NODE_11251_length_823_cov_75.169890	207	287	6	46	80	0.5750000
NODE_11251_length_823_cov_75.169890	260	340	4	19	80	0.2375000
NODE_11251_length_823_cov_75.169890	260	340	5	20	80	0.2500000
NODE_11251_length_823_cov_75.169890	260	340	6	39	80	0.4875000
NODE_11251_length_823_cov_75.169890	260	340	7	2	80	0.0250000
NODE_11251_length_823_cov_75.169890	336	416	4	28	80	0.3500000
NODE_11251_length_823_cov_75.169890	336	416	5	48	80	0.6000000
NODE_11251_length_823_cov_75.169890	336	416	6	4	80	0.0500000
NODE_11251_length_823_cov_75.169890	389	469	2	21	80	0.2625000
NODE_11251_length_823_cov_75.169890	389	469	3	1	80	0.0125000
NODE_11251_length_823_cov_75.169890	389	469	4	20	80	0.2500000
NODE_11251_length_823_cov_75.169890	389	469	5	38	80	0.4750000
NODE_11253_length_823_cov_37.738950	332	412	2	4	80	0.0500000
NODE_11253_length_823_cov_37.738950	332	412	3	76	80	0.9500000
NODE_11253_length_823_cov_37.738950	385	466	3	80	81	0.9876543
NODE_11253_length_823_cov_37.738950	385	466	4	1	81	0.0123457
NODE_11254_length_823_cov_29.349448	400	480	3	1	80	0.0125000
NODE_11254_length_823_cov_29.349448	400	480	4	1	80	0.0125000
NODE_11254_length_823_cov_29.349448	400	480	5	6	80	0.0750000
NODE_11254_length_823_cov_29.349448	400	480	6	5	80	0.0625000
NODE_11254_length_823_cov_29.349448	400	480	8	15	80	0.1875000
NODE_11254_length_823_cov_29.349448	400	480	10	13	80	0.1625000
NODE_11254_length_823_cov_29.349448	400	480	12	35	80	0.4375000
NODE_11254_length_823_cov_29.349448	400	480	13	4	80	0.0500000
NODE_11254_length_823_cov_29.349448	453	533	8	25	80	0.3125000
NODE_11254_length_823_cov_29.349448	453	533	9	10	80	0.1250000
NODE_11254_length_823_cov_29.349448	453	533	10	31	80	0.3875000
NODE_11254_length_823_cov_29.349448	453	533	12	10	80	0.1250000
NODE_11254_length_823_cov_29.349448	453	533	13	4	80	0.0500000
NODE_11255_length_823_cov_25.730663	338	418	0	14	80	0.1750000
NODE_11255_length_823_cov_25.730663	338	418	2	31	80	0.3875000
NODE_11255_length_823_cov_25.730663	338	418	3	35	80	0.4375000
NODE_11255_length_823_cov_25.730663	391	471	1	38	80	0.4750000
NODE_11255_length_823_cov_25.730663	391	471	3	42	80	0.5250000
NODE_11256_length_823_cov_24.599448	349	429	0	8	80	0.1000000
NODE_11256_length_823_cov_24.599448	349	429	2	72	80	0.9000000
NODE_11256_length_823_cov_24.599448	402	482	0	4	80	0.0500000
NODE_11256_length_823_cov_24.599448	402	482	2	76	80	0.9500000
NODE_11257_length_823_cov_22.149171	356	436	3	52	80	0.6500000
NODE_11257_length_823_cov_22.149171	356	436	4	4	80	0.0500000
NODE_11257_length_823_cov_22.149171	356	436	5	5	80	0.0625000
NODE_11257_length_823_cov_22.149171	356	436	6	19	80	0.2375000
NODE_11257_length_823_cov_22.149171	409	489	4	26	80	0.3250000
NODE_11257_length_823_cov_22.149171	409	489	5	32	80	0.4000000
NODE_11257_length_823_cov_22.149171	409	489	6	22	80	0.2750000
NODE_11257_length_823_cov_22.149171	485	565	3	4	80	0.0500000
NODE_11257_length_823_cov_22.149171	485	565	4	39	80	0.4875000
NODE_11257_length_823_cov_22.149171	485	565	5	37	80	0.4625000
NODE_11257_length_823_cov_22.149171	538	618	1	36	80	0.4500000
NODE_11257_length_823_cov_22.149171	538	618	2	17	80	0.2125000
NODE_11257_length_823_cov_22.149171	538	618	3	4	80	0.0500000
NODE_11257_length_823_cov_22.149171	538	618	4	23	80	0.2875000
NODE_11258_length_823_cov_20.892265	329	409	0	35	80	0.4375000
NODE_11258_length_823_cov_20.892265	329	409	2	45	80	0.5625000
NODE_11258_length_823_cov_20.892265	382	462	2	80	80	1.0000000
NODE_11259_length_823_cov_19.281768	305	385	1	8	80	0.1000000
NODE_11259_length_823_cov_19.281768	305	385	2	70	80	0.8750000
NODE_11259_length_823_cov_19.281768	305	385	3	2	80	0.0250000
NODE_11259_length_823_cov_19.281768	358	438	2	25	80	0.3125000
NODE_11259_length_823_cov_19.281768	358	438	3	40	80	0.5000000
NODE_11259_length_823_cov_19.281768	358	438	4	15	80	0.1875000
NODE_11260_length_823_cov_15.738950	409	489	1	5	80	0.0625000
NODE_11260_length_823_cov_15.738950	409	489	3	22	80	0.2750000
NODE_11260_length_823_cov_15.738950	409	489	4	53	80	0.6625000
NODE_11260_length_823_cov_15.738950	462	542	1	11	80	0.1375000
NODE_11260_length_823_cov_15.738950	462	542	3	6	80	0.0750000
NODE_11260_length_823_cov_15.738950	462	542	4	63	80	0.7875000
NODE_11261_length_823_cov_10.729282	362	437	0	75	75	1.0000000
NODE_11261_length_823_cov_10.729282	410	484	0	74	74	1.0000000
NODE_11262_length_823_cov_9.110497	394	474	0	80	80	1.0000000
NODE_11262_length_823_cov_9.110497	447	527	0	80	80	1.0000000
NODE_11265_length_823_cov_5.511050	168	248	1	80	80	1.0000000
NODE_11265_length_823_cov_5.511050	434	485	0	41	51	0.8039216
NODE_11265_length_823_cov_5.511050	434	485	1	8	51	0.1568628
NODE_11265_length_823_cov_5.511050	434	485	2	2	51	0.0392157
NODE_11292_length_823_cov_0.968232	86	154	0	63	68	0.9264706
NODE_11292_length_823_cov_0.968232	86	154	1	5	68	0.0735294
NODE_11298_length_822_cov_25.423237	377	459	0	62	82	0.7560976
NODE_11298_length_822_cov_25.423237	377	459	1	20	82	0.2439024
NODE_11298_length_822_cov_25.423237	432	512	0	7	80	0.0875000
NODE_11298_length_822_cov_25.423237	432	512	1	73	80	0.9125000
NODE_11299_length_822_cov_16.381743	394	474	1	80	80	1.0000000
NODE_11299_length_822_cov_16.381743	447	527	0	49	80	0.6125000
NODE_11299_length_822_cov_16.381743	447	527	1	31	80	0.3875000
NODE_11300_length_822_cov_12.426003	223	296	2	31	73	0.4246575
NODE_11300_length_822_cov_12.426003	223	296	3	42	73	0.5753425
NODE_11300_length_822_cov_12.426003	278	349	2	53	71	0.7464789
NODE_11300_length_822_cov_12.426003	278	349	3	18	71	0.2535211
NODE_11301_length_822_cov_10.608575	464	544	1	3	80	0.0375000
NODE_11301_length_822_cov_10.608575	464	544	2	55	80	0.6875000
NODE_11301_length_822_cov_10.608575	464	544	3	13	80	0.1625000
NODE_11301_length_822_cov_10.608575	464	544	4	9	80	0.1125000
NODE_11301_length_822_cov_10.608575	517	597	2	18	80	0.2250000
NODE_11301_length_822_cov_10.608575	517	597	4	62	80	0.7750000
NODE_11302_length_822_cov_9.496542	363	443	2	80	80	1.0000000
NODE_11302_length_822_cov_9.496542	416	496	2	55	80	0.6875000
NODE_11302_length_822_cov_9.496542	416	496	4	25	80	0.3125000
NODE_11333_length_821_cov_39.818560	341	420	2	1	79	0.0126582
NODE_11333_length_821_cov_39.818560	341	420	3	33	79	0.4177215
NODE_11333_length_821_cov_39.818560	341	420	4	6	79	0.0759494
NODE_11333_length_821_cov_39.818560	341	420	5	39	79	0.4936709
NODE_11333_length_821_cov_39.818560	393	473	2	34	80	0.4250000
NODE_11333_length_821_cov_39.818560	393	473	3	21	80	0.2625000
NODE_11333_length_821_cov_39.818560	393	473	4	20	80	0.2500000
NODE_11333_length_821_cov_39.818560	393	473	5	5	80	0.0625000
NODE_11334_length_821_cov_27.721607	299	379	1	27	80	0.3375000
NODE_11334_length_821_cov_27.721607	299	379	2	53	80	0.6625000
NODE_11334_length_821_cov_27.721607	352	432	1	26	80	0.3250000
NODE_11334_length_821_cov_27.721607	352	432	2	54	80	0.6750000
NODE_11335_length_821_cov_26.252078	386	466	2	3	80	0.0375000
NODE_11335_length_821_cov_26.252078	386	466	3	9	80	0.1125000
NODE_11335_length_821_cov_26.252078	386	466	4	1	80	0.0125000
NODE_11335_length_821_cov_26.252078	386	466	5	24	80	0.3000000
NODE_11335_length_821_cov_26.252078	386	466	6	43	80	0.5375000
NODE_11335_length_821_cov_26.252078	439	519	3	20	80	0.2500000
NODE_11335_length_821_cov_26.252078	439	519	5	35	80	0.4375000
NODE_11335_length_821_cov_26.252078	439	519	6	25	80	0.3125000
NODE_11336_length_821_cov_19.603878	353	433	1	2	80	0.0250000
NODE_11336_length_821_cov_19.603878	353	433	3	18	80	0.2250000
NODE_11336_length_821_cov_19.603878	353	433	5	60	80	0.7500000
NODE_11336_length_821_cov_19.603878	406	486	0	20	80	0.2500000
NODE_11336_length_821_cov_19.603878	406	486	1	35	80	0.4375000
NODE_11336_length_821_cov_19.603878	406	486	3	9	80	0.1125000
NODE_11336_length_821_cov_19.603878	406	486	5	16	80	0.2000000
NODE_11337_length_821_cov_15.945983	310	390	0	80	80	1.0000000
NODE_11337_length_821_cov_15.945983	363	443	0	80	80	1.0000000
NODE_11339_length_821_cov_8.711911	288	368	0	80	80	1.0000000
NODE_11339_length_821_cov_8.711911	341	421	0	80	80	1.0000000
NODE_11349_length_821_cov_3.026316	310	390	2	80	80	1.0000000
NODE_11349_length_821_cov_3.026316	363	443	0	22	80	0.2750000
NODE_11349_length_821_cov_3.026316	363	443	1	13	80	0.1625000
NODE_11349_length_821_cov_3.026316	363	443	2	45	80	0.5625000
NODE_11361_length_820_cov_67.292649	328	408	2	7	80	0.0875000
NODE_11361_length_820_cov_67.292649	328	408	3	28	80	0.3500000
NODE_11361_length_820_cov_67.292649	328	408	5	45	80	0.5625000
NODE_11361_length_820_cov_67.292649	381	461	4	24	80	0.3000000
NODE_11361_length_820_cov_67.292649	381	461	5	46	80	0.5750000
NODE_11361_length_820_cov_67.292649	381	461	6	10	80	0.1250000
NODE_11362_length_820_cov_26.915395	308	388	2	18	80	0.2250000
NODE_11362_length_820_cov_26.915395	308	388	4	3	80	0.0375000
NODE_11362_length_820_cov_26.915395	308	388	5	2	80	0.0250000
NODE_11362_length_820_cov_26.915395	308	388	6	6	80	0.0750000
NODE_11362_length_820_cov_26.915395	308	388	7	2	80	0.0250000
NODE_11362_length_820_cov_26.915395	308	388	9	4	80	0.0500000
NODE_11362_length_820_cov_26.915395	308	388	11	43	80	0.5375000
NODE_11362_length_820_cov_26.915395	308	388	13	2	80	0.0250000
NODE_11363_length_820_cov_25.253814	301	381	1	22	80	0.2750000
NODE_11363_length_820_cov_25.253814	301	381	2	21	80	0.2625000
NODE_11363_length_820_cov_25.253814	301	381	3	37	80	0.4625000
NODE_11363_length_820_cov_25.253814	354	434	3	80	80	1.0000000
NODE_11363_length_820_cov_25.253814	430	510	1	37	80	0.4625000
NODE_11363_length_820_cov_25.253814	430	510	2	24	80	0.3000000
NODE_11363_length_820_cov_25.253814	430	510	3	19	80	0.2375000
NODE_11363_length_820_cov_25.253814	483	563	1	80	80	1.0000000
NODE_11364_length_820_cov_16.015257	325	405	0	38	80	0.4750000
NODE_11364_length_820_cov_16.015257	325	405	2	42	80	0.5250000
NODE_11364_length_820_cov_16.015257	378	458	0	10	80	0.1250000
NODE_11364_length_820_cov_16.015257	378	458	2	70	80	0.8750000
NODE_11365_length_820_cov_14.703190	371	451	1	80	80	1.0000000
NODE_11365_length_820_cov_14.703190	424	504	0	53	80	0.6625000
NODE_11365_length_820_cov_14.703190	424	504	1	27	80	0.3375000
NODE_11366_length_820_cov_14.527046	249	329	0	80	80	1.0000000
NODE_11366_length_820_cov_14.527046	302	382	0	80	80	1.0000000
NODE_11367_length_820_cov_14.284327	286	366	1	80	80	1.0000000
NODE_11367_length_820_cov_14.284327	339	419	1	80	80	1.0000000
NODE_11367_length_820_cov_14.284327	619	699	0	80	80	1.0000000
NODE_11368_length_820_cov_13.036061	364	444	2	80	80	1.0000000
NODE_11368_length_820_cov_13.036061	417	497	0	27	80	0.3375000
NODE_11368_length_820_cov_13.036061	417	497	1	26	80	0.3250000
NODE_11368_length_820_cov_13.036061	417	497	2	27	80	0.3375000
NODE_11369_length_820_cov_12.830791	313	393	0	80	80	1.0000000
NODE_11369_length_820_cov_12.830791	366	446	0	45	80	0.5625000
NODE_11369_length_820_cov_12.830791	366	446	2	35	80	0.4375000
NODE_11370_length_820_cov_12.768377	366	443	1	9	77	0.1168831
NODE_11370_length_820_cov_12.768377	366	443	2	55	77	0.7142857
NODE_11370_length_820_cov_12.768377	366	443	3	13	77	0.1688312
NODE_11370_length_820_cov_12.768377	496	525	3	8	29	0.2758621
NODE_11370_length_820_cov_12.768377	496	525	4	21	29	0.7241379
NODE_11371_length_820_cov_12.223301	452	519	0	67	67	1.0000000
NODE_11371_length_820_cov_12.223301	492	572	0	80	80	1.0000000
NODE_11396_length_819_cov_43.027778	403	483	0	26	80	0.3250000
NODE_11396_length_819_cov_43.027778	403	483	2	54	80	0.6750000
NODE_11396_length_819_cov_43.027778	456	536	0	9	80	0.1125000
NODE_11396_length_819_cov_43.027778	456	536	2	71	80	0.8875000
NODE_11396_length_819_cov_43.027778	532	612	0	80	80	1.0000000
NODE_11396_length_819_cov_43.027778	585	665	0	80	80	1.0000000
NODE_11397_length_819_cov_42.758333	391	471	0	11	80	0.1375000
NODE_11397_length_819_cov_42.758333	391	471	1	57	80	0.7125000
NODE_11397_length_819_cov_42.758333	391	471	2	12	80	0.1500000
NODE_11397_length_819_cov_42.758333	444	524	1	15	80	0.1875000
NODE_11397_length_819_cov_42.758333	444	524	2	65	80	0.8125000
NODE_11398_length_819_cov_41.341667	86	166	3	15	80	0.1875000
NODE_11398_length_819_cov_41.341667	86	166	4	57	80	0.7125000
NODE_11398_length_819_cov_41.341667	86	166	5	8	80	0.1000000
NODE_11398_length_819_cov_41.341667	139	219	3	3	80	0.0375000
NODE_11398_length_819_cov_41.341667	139	219	4	67	80	0.8375000
NODE_11398_length_819_cov_41.341667	139	219	5	10	80	0.1250000
NODE_11398_length_819_cov_41.341667	215	295	2	18	80	0.2250000
NODE_11398_length_819_cov_41.341667	215	295	3	56	80	0.7000000
NODE_11398_length_819_cov_41.341667	215	295	4	6	80	0.0750000
NODE_11398_length_819_cov_41.341667	268	348	2	47	80	0.5875000
NODE_11398_length_819_cov_41.341667	268	348	3	33	80	0.4125000
NODE_11399_length_819_cov_23.656944	335	415	3	28	80	0.3500000
NODE_11399_length_819_cov_23.656944	335	415	4	46	80	0.5750000
NODE_11399_length_819_cov_23.656944	335	415	5	6	80	0.0750000
NODE_11399_length_819_cov_23.656944	388	468	4	21	80	0.2625000
NODE_11399_length_819_cov_23.656944	388	468	5	20	80	0.2500000
NODE_11399_length_819_cov_23.656944	388	468	6	39	80	0.4875000
NODE_11400_length_819_cov_20.633333	475	555	1	4	80	0.0500000
NODE_11400_length_819_cov_20.633333	475	555	2	76	80	0.9500000
NODE_11400_length_819_cov_20.633333	528	608	0	3	80	0.0375000
NODE_11400_length_819_cov_20.633333	528	608	1	14	80	0.1750000
NODE_11400_length_819_cov_20.633333	528	608	2	63	80	0.7875000
NODE_11401_length_819_cov_18.941667	307	387	0	80	80	1.0000000
NODE_11401_length_819_cov_18.941667	360	440	0	80	80	1.0000000
NODE_11401_length_819_cov_18.941667	436	516	0	80	80	1.0000000
NODE_11401_length_819_cov_18.941667	489	569	0	80	80	1.0000000
NODE_11402_length_819_cov_12.225000	431	511	0	80	80	1.0000000
NODE_11402_length_819_cov_12.225000	484	564	0	80	80	1.0000000
NODE_11403_length_819_cov_11.562500	273	353	0	80	80	1.0000000
NODE_11403_length_819_cov_11.562500	326	406	0	80	80	1.0000000
NODE_11404_length_819_cov_8.905556	477	557	0	80	80	1.0000000
NODE_11404_length_819_cov_8.905556	530	610	0	80	80	1.0000000
NODE_11405_length_819_cov_5.675000	232	312	8	80	80	1.0000000
NODE_11405_length_819_cov_5.675000	285	365	2	14	80	0.1750000
NODE_11405_length_819_cov_5.675000	285	365	3	1	80	0.0125000
NODE_11405_length_819_cov_5.675000	285	365	4	21	80	0.2625000
NODE_11405_length_819_cov_5.675000	285	365	8	44	80	0.5500000
NODE_11431_length_818_cov_21.979138	342	422	0	75	80	0.9375000
NODE_11431_length_818_cov_21.979138	342	422	1	5	80	0.0625000
NODE_11431_length_818_cov_21.979138	395	475	0	26	80	0.3250000
NODE_11431_length_818_cov_21.979138	395	475	1	54	80	0.6750000
NODE_11432_length_818_cov_15.326843	334	414	0	80	80	1.0000000
NODE_11432_length_818_cov_15.326843	387	467	0	80	80	1.0000000
NODE_11433_length_818_cov_14.880389	392	472	0	80	80	1.0000000
NODE_11433_length_818_cov_14.880389	445	525	0	80	80	1.0000000
NODE_11434_length_818_cov_12.369958	390	470	2	80	80	1.0000000
NODE_11434_length_818_cov_12.369958	443	523	2	63	80	0.7875000
NODE_11434_length_818_cov_12.369958	443	523	3	17	80	0.2125000
NODE_11436_length_818_cov_8.421419	370	450	0	80	80	1.0000000
NODE_11436_length_818_cov_8.421419	423	503	0	80	80	1.0000000
NODE_11437_length_818_cov_6.439499	706	741	2	33	35	0.9428571
NODE_11437_length_818_cov_6.439499	706	741	3	2	35	0.0571429
NODE_11439_length_818_cov_4.098748	320	390	0	70	70	1.0000000
NODE_11439_length_818_cov_4.098748	416	472	0	56	56	1.0000000
NODE_11457_length_817_cov_7.238162	494	574	0	80	80	1.0000000
NODE_11457_length_817_cov_7.238162	547	627	0	80	80	1.0000000
NODE_11458_length_817_cov_5.789694	400	480	0	80	80	1.0000000
NODE_11458_length_817_cov_5.789694	476	555	0	79	79	1.0000000
NODE_11458_length_817_cov_5.789694	528	608	0	80	80	1.0000000
NODE_11462_length_817_cov_4.357939	433	513	0	80	80	1.0000000
NODE_11462_length_817_cov_4.357939	486	566	0	80	80	1.0000000
NODE_11486_length_817_cov_0.692201	626	696	3	2	70	0.0285714
NODE_11486_length_817_cov_0.692201	626	696	6	38	70	0.5428572
NODE_11486_length_817_cov_0.692201	626	696	8	28	70	0.4000000
NODE_11486_length_817_cov_0.692201	626	696	10	2	70	0.0285714
NODE_11488_length_816_cov_69.800558	395	475	1	80	80	1.0000000
NODE_11488_length_816_cov_69.800558	448	520	1	72	72	1.0000000
NODE_11489_length_816_cov_19.044630	77	154	2	66	77	0.8571429
NODE_11489_length_816_cov_19.044630	77	154	4	11	77	0.1428571
NODE_11489_length_816_cov_19.044630	130	212	2	13	82	0.1585366
NODE_11489_length_816_cov_19.044630	130	212	3	43	82	0.5243902
NODE_11489_length_816_cov_19.044630	130	212	4	26	82	0.3170732
NODE_11490_length_816_cov_16.418410	381	461	0	80	80	1.0000000
NODE_11490_length_816_cov_16.418410	434	514	0	80	80	1.0000000
NODE_11491_length_816_cov_15.945607	319	399	0	58	80	0.7250000
NODE_11491_length_816_cov_15.945607	319	399	5	22	80	0.2750000
NODE_11491_length_816_cov_15.945607	372	452	0	5	80	0.0625000
NODE_11491_length_816_cov_15.945607	372	452	5	75	80	0.9375000
NODE_11492_length_816_cov_12.797768	358	438	1	10	80	0.1250000
NODE_11492_length_816_cov_12.797768	358	438	2	24	80	0.3000000
NODE_11492_length_816_cov_12.797768	358	438	3	37	80	0.4625000
NODE_11492_length_816_cov_12.797768	358	438	4	9	80	0.1125000
NODE_11492_length_816_cov_12.797768	411	491	1	21	80	0.2625000
NODE_11492_length_816_cov_12.797768	411	491	2	59	80	0.7375000
NODE_11493_length_816_cov_12.086471	242	322	0	80	80	1.0000000
NODE_11493_length_816_cov_12.086471	295	375	0	80	80	1.0000000
NODE_11495_length_816_cov_3.873082	412	492	0	80	80	1.0000000
NODE_11495_length_816_cov_3.873082	465	545	0	80	80	1.0000000
NODE_11516_length_815_cov_48.090782	334	414	1	80	80	1.0000000
NODE_11516_length_815_cov_48.090782	387	467	0	2	80	0.0250000
NODE_11516_length_815_cov_48.090782	387	467	1	78	80	0.9750000
NODE_11517_length_815_cov_27.748603	290	370	3	23	80	0.2875000
NODE_11517_length_815_cov_27.748603	290	370	4	40	80	0.5000000
NODE_11517_length_815_cov_27.748603	290	370	6	15	80	0.1875000
NODE_11517_length_815_cov_27.748603	290	370	7	2	80	0.0250000
NODE_11517_length_815_cov_27.748603	343	423	4	10	80	0.1250000
NODE_11517_length_815_cov_27.748603	343	423	6	40	80	0.5000000
NODE_11517_length_815_cov_27.748603	343	423	7	6	80	0.0750000
NODE_11517_length_815_cov_27.748603	343	423	8	24	80	0.3000000
NODE_11518_length_815_cov_23.748603	429	509	5	80	80	1.0000000
NODE_11518_length_815_cov_23.748603	482	562	2	37	80	0.4625000
NODE_11518_length_815_cov_23.748603	482	562	3	7	80	0.0875000
NODE_11518_length_815_cov_23.748603	482	562	4	9	80	0.1125000
NODE_11518_length_815_cov_23.748603	482	562	5	27	80	0.3375000
NODE_11519_length_815_cov_14.870112	318	398	0	80	80	1.0000000
NODE_11519_length_815_cov_14.870112	371	451	0	80	80	1.0000000
NODE_11520_length_815_cov_13.317039	338	418	2	80	80	1.0000000
NODE_11520_length_815_cov_13.317039	391	471	1	31	80	0.3875000
NODE_11520_length_815_cov_13.317039	391	471	2	49	80	0.6125000
NODE_11521_length_815_cov_12.270950	315	395	0	80	80	1.0000000
NODE_11521_length_815_cov_12.270950	368	448	0	80	80	1.0000000
NODE_11522_length_815_cov_9.304469	150	230	0	80	80	1.0000000
NODE_11522_length_815_cov_9.304469	203	283	0	80	80	1.0000000
NODE_11524_length_815_cov_8.117318	437	517	0	21	80	0.2625000
NODE_11524_length_815_cov_8.117318	437	517	2	59	80	0.7375000
NODE_11524_length_815_cov_8.117318	490	570	2	80	80	1.0000000
NODE_11530_length_815_cov_3.963687	275	355	0	80	80	1.0000000
NODE_11530_length_815_cov_3.963687	328	408	0	80	80	1.0000000
NODE_11532_length_815_cov_2.976257	441	508	1	55	67	0.8208955
NODE_11532_length_815_cov_2.976257	441	508	2	12	67	0.1791045
NODE_11554_length_814_cov_55.545455	304	384	4	1	80	0.0125000
NODE_11554_length_814_cov_55.545455	304	384	6	70	80	0.8750000
NODE_11554_length_814_cov_55.545455	304	384	7	9	80	0.1125000
NODE_11554_length_814_cov_55.545455	357	437	2	4	80	0.0500000
NODE_11554_length_814_cov_55.545455	357	437	3	7	80	0.0875000
NODE_11554_length_814_cov_55.545455	357	437	4	43	80	0.5375000
NODE_11554_length_814_cov_55.545455	357	437	6	17	80	0.2125000
NODE_11554_length_814_cov_55.545455	357	437	7	9	80	0.1125000
NODE_11554_length_814_cov_55.545455	517	559	0	42	42	1.0000000
NODE_11554_length_814_cov_55.545455	724	804	11	1	80	0.0125000
NODE_11554_length_814_cov_55.545455	724	804	12	3	80	0.0375000
NODE_11554_length_814_cov_55.545455	724	804	14	1	80	0.0125000
NODE_11554_length_814_cov_55.545455	724	804	16	2	80	0.0250000
NODE_11554_length_814_cov_55.545455	724	804	18	2	80	0.0250000
NODE_11554_length_814_cov_55.545455	724	804	19	2	80	0.0250000
NODE_11554_length_814_cov_55.545455	724	804	21	3	80	0.0375000
NODE_11554_length_814_cov_55.545455	724	804	23	1	80	0.0125000
NODE_11554_length_814_cov_55.545455	724	804	24	2	80	0.0250000
NODE_11554_length_814_cov_55.545455	724	804	25	1	80	0.0125000
NODE_11554_length_814_cov_55.545455	724	804	26	6	80	0.0750000
NODE_11554_length_814_cov_55.545455	724	804	28	3	80	0.0375000
NODE_11554_length_814_cov_55.545455	724	804	30	1	80	0.0125000
NODE_11554_length_814_cov_55.545455	724	804	32	6	80	0.0750000
NODE_11554_length_814_cov_55.545455	724	804	33	4	80	0.0500000
NODE_11554_length_814_cov_55.545455	724	804	34	5	80	0.0625000
NODE_11554_length_814_cov_55.545455	724	804	35	5	80	0.0625000
NODE_11554_length_814_cov_55.545455	724	804	36	1	80	0.0125000
NODE_11554_length_814_cov_55.545455	724	804	37	4	80	0.0500000
NODE_11554_length_814_cov_55.545455	724	804	38	14	80	0.1750000
NODE_11554_length_814_cov_55.545455	724	804	39	6	80	0.0750000
NODE_11554_length_814_cov_55.545455	724	804	40	7	80	0.0875000
NODE_11555_length_814_cov_32.216783	317	397	0	26	80	0.3250000
NODE_11555_length_814_cov_32.216783	317	397	1	13	80	0.1625000
NODE_11555_length_814_cov_32.216783	317	397	2	35	80	0.4375000
NODE_11555_length_814_cov_32.216783	317	397	4	6	80	0.0750000
NODE_11555_length_814_cov_32.216783	370	450	2	21	80	0.2625000
NODE_11555_length_814_cov_32.216783	370	450	4	22	80	0.2750000
NODE_11555_length_814_cov_32.216783	370	450	5	37	80	0.4625000
NODE_11556_length_814_cov_19.507692	174	254	5	2	80	0.0250000
NODE_11556_length_814_cov_19.507692	174	254	6	57	80	0.7125000
NODE_11556_length_814_cov_19.507692	174	254	7	21	80	0.2625000
NODE_11556_length_814_cov_19.507692	227	307	2	4	80	0.0500000
NODE_11556_length_814_cov_19.507692	227	307	3	11	80	0.1375000
NODE_11556_length_814_cov_19.507692	227	307	5	37	80	0.4625000
NODE_11556_length_814_cov_19.507692	227	307	6	7	80	0.0875000
NODE_11556_length_814_cov_19.507692	227	307	7	21	80	0.2625000
NODE_11556_length_814_cov_19.507692	303	383	1	6	80	0.0750000
NODE_11556_length_814_cov_19.507692	303	383	2	74	80	0.9250000
NODE_11556_length_814_cov_19.507692	356	436	1	59	80	0.7375000
NODE_11556_length_814_cov_19.507692	356	436	2	21	80	0.2625000
NODE_11557_length_814_cov_18.579021	433	513	4	36	80	0.4500000
NODE_11557_length_814_cov_18.579021	433	513	6	44	80	0.5500000
NODE_11557_length_814_cov_18.579021	486	566	3	11	80	0.1375000
NODE_11557_length_814_cov_18.579021	486	566	4	8	80	0.1000000
NODE_11557_length_814_cov_18.579021	486	566	5	29	80	0.3625000
NODE_11557_length_814_cov_18.579021	486	566	6	32	80	0.4000000
NODE_11558_length_814_cov_17.183217	339	419	1	9	80	0.1125000
NODE_11558_length_814_cov_17.183217	339	419	3	23	80	0.2875000
NODE_11558_length_814_cov_17.183217	339	419	4	8	80	0.1000000
NODE_11558_length_814_cov_17.183217	339	419	5	40	80	0.5000000
NODE_11558_length_814_cov_17.183217	392	472	3	25	80	0.3125000
NODE_11558_length_814_cov_17.183217	392	472	4	23	80	0.2875000
NODE_11558_length_814_cov_17.183217	392	472	5	32	80	0.4000000
NODE_11559_length_814_cov_15.306294	238	318	1	67	80	0.8375000
NODE_11559_length_814_cov_15.306294	238	318	2	13	80	0.1625000
NODE_11559_length_814_cov_15.306294	291	371	1	29	80	0.3625000
NODE_11559_length_814_cov_15.306294	291	371	2	51	80	0.6375000
NODE_11560_length_814_cov_11.511888	397	477	0	80	80	1.0000000
NODE_11560_length_814_cov_11.511888	459	530	0	71	71	1.0000000
NODE_11561_length_814_cov_10.395804	305	385	0	80	80	1.0000000
NODE_11561_length_814_cov_10.395804	358	438	0	80	80	1.0000000
NODE_11562_length_814_cov_9.692308	347	427	2	57	80	0.7125000
NODE_11562_length_814_cov_9.692308	347	427	3	23	80	0.2875000
NODE_11562_length_814_cov_9.692308	400	480	1	4	80	0.0500000
NODE_11562_length_814_cov_9.692308	400	480	2	76	80	0.9500000
NODE_11564_length_814_cov_9.274126	245	325	0	80	80	1.0000000
NODE_11564_length_814_cov_9.274126	298	378	0	80	80	1.0000000
NODE_11565_length_814_cov_8.973427	271	351	1	19	80	0.2375000
NODE_11565_length_814_cov_8.973427	271	351	2	61	80	0.7625000
NODE_11565_length_814_cov_8.973427	324	404	2	80	80	1.0000000
NODE_11573_length_814_cov_2.145455	273	327	0	54	54	1.0000000
NODE_11573_length_814_cov_2.145455	307	371	0	64	64	1.0000000
NODE_11587_length_813_cov_39.228291	225	305	10	7	80	0.0875000
NODE_11587_length_813_cov_39.228291	225	305	13	5	80	0.0625000
NODE_11587_length_813_cov_39.228291	225	305	15	13	80	0.1625000
NODE_11587_length_813_cov_39.228291	225	305	16	6	80	0.0750000
NODE_11587_length_813_cov_39.228291	225	305	17	5	80	0.0625000
NODE_11587_length_813_cov_39.228291	225	305	18	10	80	0.1250000
NODE_11587_length_813_cov_39.228291	225	305	19	12	80	0.1500000
NODE_11587_length_813_cov_39.228291	225	305	20	22	80	0.2750000
NODE_11587_length_813_cov_39.228291	278	358	6	13	80	0.1625000
NODE_11587_length_813_cov_39.228291	278	358	7	13	80	0.1625000
NODE_11587_length_813_cov_39.228291	278	358	8	6	80	0.0750000
NODE_11587_length_813_cov_39.228291	278	358	9	8	80	0.1000000
NODE_11587_length_813_cov_39.228291	278	358	12	9	80	0.1125000
NODE_11587_length_813_cov_39.228291	278	358	14	2	80	0.0250000
NODE_11587_length_813_cov_39.228291	278	358	16	8	80	0.1000000
NODE_11587_length_813_cov_39.228291	278	358	17	3	80	0.0375000
NODE_11587_length_813_cov_39.228291	278	358	18	10	80	0.1250000
NODE_11587_length_813_cov_39.228291	278	358	19	2	80	0.0250000
NODE_11587_length_813_cov_39.228291	278	358	20	6	80	0.0750000
NODE_11588_length_813_cov_36.570028	406	486	2	7	80	0.0875000
NODE_11588_length_813_cov_36.570028	406	486	4	4	80	0.0500000
NODE_11588_length_813_cov_36.570028	406	486	5	28	80	0.3500000
NODE_11588_length_813_cov_36.570028	406	486	6	41	80	0.5125000
NODE_11588_length_813_cov_36.570028	459	539	0	17	80	0.2125000
NODE_11588_length_813_cov_36.570028	459	539	1	10	80	0.1250000
NODE_11588_length_813_cov_36.570028	459	539	2	33	80	0.4125000
NODE_11588_length_813_cov_36.570028	459	539	4	4	80	0.0500000
NODE_11588_length_813_cov_36.570028	459	539	5	16	80	0.2000000
NODE_11589_length_813_cov_26.718487	209	289	0	80	80	1.0000000
NODE_11589_length_813_cov_26.718487	262	342	0	80	80	1.0000000
NODE_11590_length_813_cov_17.537815	335	415	1	80	80	1.0000000
NODE_11590_length_813_cov_17.537815	388	468	1	77	80	0.9625000
NODE_11590_length_813_cov_17.537815	388	468	3	3	80	0.0375000
NODE_11591_length_813_cov_14.243697	279	359	0	80	80	1.0000000
NODE_11591_length_813_cov_14.243697	332	412	0	80	80	1.0000000
NODE_11592_length_813_cov_13.984594	307	387	0	80	80	1.0000000
NODE_11592_length_813_cov_13.984594	360	440	0	80	80	1.0000000
NODE_11593_length_813_cov_13.242297	336	416	2	31	80	0.3875000
NODE_11593_length_813_cov_13.242297	336	416	3	32	80	0.4000000
NODE_11593_length_813_cov_13.242297	336	416	5	17	80	0.2125000
NODE_11593_length_813_cov_13.242297	389	469	3	18	80	0.2250000
NODE_11593_length_813_cov_13.242297	389	469	4	35	80	0.4375000
NODE_11593_length_813_cov_13.242297	389	469	5	27	80	0.3375000
NODE_11594_length_813_cov_11.985994	374	454	0	80	80	1.0000000
NODE_11594_length_813_cov_11.985994	427	507	0	80	80	1.0000000
NODE_11595_length_813_cov_11.668067	279	359	3	38	80	0.4750000
NODE_11595_length_813_cov_11.668067	279	359	4	42	80	0.5250000
NODE_11595_length_813_cov_11.668067	332	412	1	19	80	0.2375000
NODE_11595_length_813_cov_11.668067	332	412	2	26	80	0.3250000
NODE_11595_length_813_cov_11.668067	332	412	3	35	80	0.4375000
NODE_11596_length_813_cov_8.149860	538	618	0	80	80	1.0000000
NODE_11596_length_813_cov_8.149860	591	671	0	80	80	1.0000000
NODE_11597_length_813_cov_7.098039	234	314	0	80	80	1.0000000
NODE_11597_length_813_cov_7.098039	287	367	0	28	80	0.3500000
NODE_11597_length_813_cov_7.098039	287	367	2	52	80	0.6500000
NODE_11613_length_812_cov_45.183731	435	515	8	29	80	0.3625000
NODE_11613_length_812_cov_45.183731	435	515	9	25	80	0.3125000
NODE_11613_length_812_cov_45.183731	435	515	10	6	80	0.0750000
NODE_11613_length_812_cov_45.183731	435	515	11	20	80	0.2500000
NODE_11613_length_812_cov_45.183731	488	568	3	35	80	0.4375000
NODE_11613_length_812_cov_45.183731	488	568	5	16	80	0.2000000
NODE_11613_length_812_cov_45.183731	488	568	8	23	80	0.2875000
NODE_11613_length_812_cov_45.183731	488	568	9	6	80	0.0750000
NODE_11614_length_812_cov_23.862553	386	466	1	4	80	0.0500000
NODE_11614_length_812_cov_23.862553	386	466	2	2	80	0.0250000
NODE_11614_length_812_cov_23.862553	386	466	3	30	80	0.3750000
NODE_11614_length_812_cov_23.862553	386	466	5	15	80	0.1875000
NODE_11614_length_812_cov_23.862553	386	466	6	29	80	0.3625000
NODE_11614_length_812_cov_23.862553	439	519	3	8	80	0.1000000
NODE_11614_length_812_cov_23.862553	439	519	5	20	80	0.2500000
NODE_11614_length_812_cov_23.862553	439	519	6	52	80	0.6500000
NODE_11615_length_812_cov_23.516129	295	375	3	70	80	0.8750000
NODE_11615_length_812_cov_23.516129	295	375	4	10	80	0.1250000
NODE_11615_length_812_cov_23.516129	348	428	0	13	80	0.1625000
NODE_11615_length_812_cov_23.516129	348	428	2	29	80	0.3625000
NODE_11615_length_812_cov_23.516129	348	428	3	38	80	0.4750000
NODE_11616_length_812_cov_15.577840	509	589	0	80	80	1.0000000
NODE_11616_length_812_cov_15.577840	562	644	0	82	82	1.0000000
NODE_11617_length_812_cov_13.277700	257	331	0	12	74	0.1621622
NODE_11617_length_812_cov_13.277700	257	331	1	62	74	0.8378378
NODE_11617_length_812_cov_13.277700	304	384	1	46	80	0.5750000
NODE_11617_length_812_cov_13.277700	304	384	2	34	80	0.4250000
NODE_11619_length_812_cov_6.697055	309	389	0	80	80	1.0000000
NODE_11619_length_812_cov_6.697055	362	442	0	80	80	1.0000000
NODE_11642_length_811_cov_65.762640	418	492	2	8	74	0.1081081
NODE_11642_length_811_cov_65.762640	418	492	3	66	74	0.8918919
NODE_11642_length_811_cov_65.762640	471	545	0	40	74	0.5405405
NODE_11642_length_811_cov_65.762640	471	545	1	10	74	0.1351351
NODE_11642_length_811_cov_65.762640	471	545	2	11	74	0.1486486
NODE_11642_length_811_cov_65.762640	471	545	3	13	74	0.1756757
NODE_11643_length_811_cov_62.933989	457	537	2	21	80	0.2625000
NODE_11643_length_811_cov_62.933989	457	537	3	32	80	0.4000000
NODE_11643_length_811_cov_62.933989	457	537	4	1	80	0.0125000
NODE_11643_length_811_cov_62.933989	457	537	5	17	80	0.2125000
NODE_11643_length_811_cov_62.933989	457	537	6	9	80	0.1125000
NODE_11643_length_811_cov_62.933989	510	590	4	1	80	0.0125000
NODE_11643_length_811_cov_62.933989	510	590	5	17	80	0.2125000
NODE_11643_length_811_cov_62.933989	510	590	6	32	80	0.4000000
NODE_11643_length_811_cov_62.933989	510	590	7	30	80	0.3750000
NODE_11644_length_811_cov_26.401685	397	477	4	9	80	0.1125000
NODE_11644_length_811_cov_26.401685	397	477	5	6	80	0.0750000
NODE_11644_length_811_cov_26.401685	397	477	6	13	80	0.1625000
NODE_11644_length_811_cov_26.401685	397	477	7	45	80	0.5625000
NODE_11644_length_811_cov_26.401685	397	477	8	7	80	0.0875000
NODE_11644_length_811_cov_26.401685	450	530	3	20	80	0.2500000
NODE_11644_length_811_cov_26.401685	450	530	4	42	80	0.5250000
NODE_11644_length_811_cov_26.401685	450	530	5	6	80	0.0750000
NODE_11644_length_811_cov_26.401685	450	530	6	12	80	0.1500000
NODE_11645_length_811_cov_23.009831	189	269	4	47	80	0.5875000
NODE_11645_length_811_cov_23.009831	189	269	5	1	80	0.0125000
NODE_11645_length_811_cov_23.009831	189	269	6	32	80	0.4000000
NODE_11645_length_811_cov_23.009831	242	322	2	5	80	0.0625000
NODE_11645_length_811_cov_23.009831	242	322	3	1	80	0.0125000
NODE_11645_length_811_cov_23.009831	242	322	4	14	80	0.1750000
NODE_11645_length_811_cov_23.009831	242	322	6	60	80	0.7500000
NODE_11646_length_811_cov_20.523876	375	455	0	80	80	1.0000000
NODE_11646_length_811_cov_20.523876	428	508	0	80	80	1.0000000
NODE_11647_length_811_cov_17.386236	421	501	1	40	80	0.5000000
NODE_11647_length_811_cov_17.386236	421	501	2	40	80	0.5000000
NODE_11647_length_811_cov_17.386236	474	554	1	80	80	1.0000000
NODE_11648_length_811_cov_15.279494	368	448	0	80	80	1.0000000
NODE_11648_length_811_cov_15.279494	421	502	0	81	81	1.0000000
NODE_11649_length_811_cov_14.543539	222	302	1	80	80	1.0000000
NODE_11649_length_811_cov_14.543539	275	355	0	15	80	0.1875000
NODE_11649_length_811_cov_14.543539	275	355	1	65	80	0.8125000
NODE_11650_length_811_cov_12.196629	402	482	4	80	80	1.0000000
NODE_11650_length_811_cov_12.196629	455	535	2	28	80	0.3500000
NODE_11650_length_811_cov_12.196629	455	535	4	52	80	0.6500000
NODE_11651_length_811_cov_12.117978	289	369	0	80	80	1.0000000
NODE_11651_length_811_cov_12.117978	342	422	0	80	80	1.0000000
NODE_11652_length_811_cov_11.886236	330	410	0	6	80	0.0750000
NODE_11652_length_811_cov_11.886236	330	410	1	17	80	0.2125000
NODE_11652_length_811_cov_11.886236	330	410	2	57	80	0.7125000
NODE_11652_length_811_cov_11.886236	383	463	0	59	80	0.7375000
NODE_11652_length_811_cov_11.886236	383	463	1	17	80	0.2125000
NODE_11652_length_811_cov_11.886236	383	463	2	4	80	0.0500000
NODE_11653_length_811_cov_10.602528	342	422	1	15	80	0.1875000
NODE_11653_length_811_cov_10.602528	342	422	2	65	80	0.8125000
NODE_11653_length_811_cov_10.602528	395	461	1	6	66	0.0909091
NODE_11653_length_811_cov_10.602528	395	461	2	60	66	0.9090909
NODE_11653_length_811_cov_10.602528	452	519	0	58	67	0.8656716
NODE_11653_length_811_cov_10.602528	452	519	1	6	67	0.0895522
NODE_11653_length_811_cov_10.602528	452	519	2	3	67	0.0447761
NODE_11653_length_811_cov_10.602528	492	572	0	76	80	0.9500000
NODE_11653_length_811_cov_10.602528	492	572	2	4	80	0.0500000
NODE_11654_length_811_cov_7.539326	324	404	0	80	80	1.0000000
NODE_11654_length_811_cov_7.539326	377	457	0	80	80	1.0000000
NODE_11655_length_811_cov_6.398876	419	499	1	52	80	0.6500000
NODE_11655_length_811_cov_6.398876	419	499	3	28	80	0.3500000
NODE_11655_length_811_cov_6.398876	472	552	3	38	80	0.4750000
NODE_11655_length_811_cov_6.398876	472	552	4	26	80	0.3250000
NODE_11655_length_811_cov_6.398876	472	552	5	16	80	0.2000000
NODE_11657_length_811_cov_5.939607	496	527	0	31	31	1.0000000
NODE_11657_length_811_cov_5.939607	528	603	0	15	75	0.2000000
NODE_11657_length_811_cov_5.939607	528	603	2	60	75	0.8000000
NODE_11669_length_811_cov_1.501404	645	676	1	31	31	1.0000000
NODE_11684_length_810_cov_42.358650	484	564	3	79	80	0.9875000
NODE_11684_length_810_cov_42.358650	484	564	4	1	80	0.0125000
NODE_11684_length_810_cov_42.358650	537	617	2	33	80	0.4125000
NODE_11684_length_810_cov_42.358650	537	617	3	47	80	0.5875000
NODE_11685_length_810_cov_38.604782	370	450	0	80	80	1.0000000
NODE_11685_length_810_cov_38.604782	423	499	0	76	76	1.0000000
NODE_11686_length_810_cov_20.354430	338	418	2	80	80	1.0000000
NODE_11686_length_810_cov_20.354430	391	471	2	80	80	1.0000000
NODE_11688_length_810_cov_12.367089	144	224	1	53	80	0.6625000
NODE_11688_length_810_cov_12.367089	144	224	2	27	80	0.3375000
NODE_11688_length_810_cov_12.367089	197	277	0	46	80	0.5750000
NODE_11688_length_810_cov_12.367089	197	277	1	34	80	0.4250000
NODE_11689_length_810_cov_8.886076	333	399	0	66	66	1.0000000
NODE_11690_length_810_cov_8.291139	446	526	0	80	80	1.0000000
NODE_11690_length_810_cov_8.291139	499	579	0	80	80	1.0000000
NODE_11692_length_810_cov_7.213783	335	406	0	71	71	1.0000000
NODE_11692_length_810_cov_7.213783	335	416	0	81	81	1.0000000
NODE_11692_length_810_cov_7.213783	379	459	0	80	80	1.0000000
NODE_11714_length_809_cov_40.536620	428	500	0	72	72	1.0000000
NODE_11714_length_809_cov_40.536620	473	553	0	80	80	1.0000000
NODE_11715_length_809_cov_15.871831	385	465	0	80	80	1.0000000
NODE_11715_length_809_cov_15.871831	402	465	0	63	63	1.0000000
NODE_11715_length_809_cov_15.871831	438	518	0	80	80	1.0000000
NODE_11715_length_809_cov_15.871831	438	518	0	80	80	1.0000000
NODE_11716_length_809_cov_15.019718	286	366	2	32	80	0.4000000
NODE_11716_length_809_cov_15.019718	286	366	3	48	80	0.6000000
NODE_11716_length_809_cov_15.019718	339	419	2	14	80	0.1750000
NODE_11716_length_809_cov_15.019718	339	419	3	59	80	0.7375000
NODE_11716_length_809_cov_15.019718	339	419	4	7	80	0.0875000
NODE_11718_length_809_cov_4.483099	244	324	0	80	80	1.0000000
NODE_11718_length_809_cov_4.483099	278	324	0	46	46	1.0000000
NODE_11718_length_809_cov_4.483099	298	377	0	42	79	0.5316456
NODE_11718_length_809_cov_4.483099	298	377	1	37	79	0.4683544
NODE_11718_length_809_cov_4.483099	308	377	0	32	69	0.4637681
NODE_11718_length_809_cov_4.483099	308	377	1	37	69	0.5362319
NODE_11738_length_808_cov_45.023977	325	405	5	9	80	0.1125000
NODE_11738_length_808_cov_45.023977	325	405	6	29	80	0.3625000
NODE_11738_length_808_cov_45.023977	325	405	7	42	80	0.5250000
NODE_11738_length_808_cov_45.023977	378	458	5	14	80	0.1750000
NODE_11738_length_808_cov_45.023977	378	458	6	48	80	0.6000000
NODE_11738_length_808_cov_45.023977	378	458	7	18	80	0.2250000
NODE_11739_length_808_cov_24.087447	287	367	3	4	80	0.0500000
NODE_11739_length_808_cov_24.087447	287	367	4	6	80	0.0750000
NODE_11739_length_808_cov_24.087447	287	367	5	13	80	0.1625000
NODE_11739_length_808_cov_24.087447	287	367	6	57	80	0.7125000
NODE_11739_length_808_cov_24.087447	340	420	6	75	80	0.9375000
NODE_11739_length_808_cov_24.087447	340	420	8	5	80	0.0625000
NODE_11740_length_808_cov_21.867419	324	404	0	6	80	0.0750000
NODE_11740_length_808_cov_21.867419	324	404	1	74	80	0.9250000
NODE_11740_length_808_cov_21.867419	377	457	1	80	80	1.0000000
NODE_11741_length_808_cov_16.289140	333	413	2	12	80	0.1500000
NODE_11741_length_808_cov_16.289140	333	413	4	17	80	0.2125000
NODE_11741_length_808_cov_16.289140	333	413	5	51	80	0.6375000
NODE_11741_length_808_cov_16.289140	386	466	4	2	80	0.0250000
NODE_11741_length_808_cov_16.289140	386	466	5	48	80	0.6000000
NODE_11741_length_808_cov_16.289140	386	466	6	30	80	0.3750000
NODE_11742_length_808_cov_14.489422	307	387	0	72	80	0.9000000
NODE_11742_length_808_cov_14.489422	307	387	1	8	80	0.1000000
NODE_11742_length_808_cov_14.489422	360	440	0	19	80	0.2375000
NODE_11742_length_808_cov_14.489422	360	440	1	61	80	0.7625000
NODE_11744_length_808_cov_10.507757	317	397	0	20	80	0.2500000
NODE_11744_length_808_cov_10.507757	317	397	3	60	80	0.7500000
NODE_11744_length_808_cov_10.507757	370	450	3	42	80	0.5250000
NODE_11744_length_808_cov_10.507757	370	450	5	38	80	0.4750000
NODE_11745_length_808_cov_10.066291	483	563	0	15	80	0.1875000
NODE_11745_length_808_cov_10.066291	483	563	2	5	80	0.0625000
NODE_11745_length_808_cov_10.066291	483	563	4	60	80	0.7500000
NODE_11745_length_808_cov_10.066291	536	616	0	66	80	0.8250000
NODE_11745_length_808_cov_10.066291	536	616	4	14	80	0.1750000
NODE_11746_length_808_cov_7.581100	358	438	0	12	80	0.1500000
NODE_11746_length_808_cov_7.581100	358	438	1	26	80	0.3250000
NODE_11746_length_808_cov_7.581100	358	438	2	42	80	0.5250000
NODE_11746_length_808_cov_7.581100	411	491	2	80	80	1.0000000
NODE_11756_length_808_cov_3.283498	471	551	0	18	80	0.2250000
NODE_11756_length_808_cov_3.283498	471	551	1	13	80	0.1625000
NODE_11756_length_808_cov_3.283498	471	551	2	49	80	0.6125000
NODE_11756_length_808_cov_3.283498	524	604	2	80	80	1.0000000
NODE_11783_length_807_cov_67.341808	2	25	38	1	23	0.0434783
NODE_11783_length_807_cov_67.341808	2	25	40	2	23	0.0869565
NODE_11783_length_807_cov_67.341808	2	25	42	1	23	0.0434783
NODE_11783_length_807_cov_67.341808	2	25	43	1	23	0.0434783
NODE_11783_length_807_cov_67.341808	2	25	45	1	23	0.0434783
NODE_11783_length_807_cov_67.341808	2	25	49	2	23	0.0869565
NODE_11783_length_807_cov_67.341808	2	25	51	1	23	0.0434783
NODE_11783_length_807_cov_67.341808	2	25	53	1	23	0.0434783
NODE_11783_length_807_cov_67.341808	2	25	57	1	23	0.0434783
NODE_11783_length_807_cov_67.341808	2	25	58	2	23	0.0869565
NODE_11783_length_807_cov_67.341808	2	25	60	1	23	0.0434783
NODE_11783_length_807_cov_67.341808	2	25	65	2	23	0.0869565
NODE_11783_length_807_cov_67.341808	2	25	67	1	23	0.0434783
NODE_11783_length_807_cov_67.341808	2	25	73	1	23	0.0434783
NODE_11783_length_807_cov_67.341808	2	25	75	1	23	0.0434783
NODE_11783_length_807_cov_67.341808	2	25	82	1	23	0.0434783
NODE_11783_length_807_cov_67.341808	2	25	83	1	23	0.0434783
NODE_11783_length_807_cov_67.341808	2	25	84	1	23	0.0434783
NODE_11783_length_807_cov_67.341808	2	25	85	1	23	0.0434783
NODE_11783_length_807_cov_67.341808	339	370	304	1	31	0.0322581
NODE_11783_length_807_cov_67.341808	339	370	306	1	31	0.0322581
NODE_11783_length_807_cov_67.341808	339	370	308	1	31	0.0322581
NODE_11783_length_807_cov_67.341808	339	370	310	1	31	0.0322581
NODE_11783_length_807_cov_67.341808	339	370	311	1	31	0.0322581
NODE_11783_length_807_cov_67.341808	339	370	313	1	31	0.0322581
NODE_11783_length_807_cov_67.341808	339	370	316	1	31	0.0322581
NODE_11783_length_807_cov_67.341808	339	370	318	1	31	0.0322581
NODE_11783_length_807_cov_67.341808	339	370	319	1	31	0.0322581
NODE_11783_length_807_cov_67.341808	339	370	320	1	31	0.0322581
NODE_11783_length_807_cov_67.341808	339	370	321	1	31	0.0322581
NODE_11783_length_807_cov_67.341808	339	370	323	1	31	0.0322581
NODE_11783_length_807_cov_67.341808	339	370	324	2	31	0.0645161
NODE_11783_length_807_cov_67.341808	339	370	325	1	31	0.0322581
NODE_11783_length_807_cov_67.341808	339	370	326	2	31	0.0645161
NODE_11783_length_807_cov_67.341808	339	370	327	3	31	0.0967742
NODE_11783_length_807_cov_67.341808	339	370	328	4	31	0.1290323
NODE_11783_length_807_cov_67.341808	339	370	329	2	31	0.0645161
NODE_11783_length_807_cov_67.341808	339	370	330	2	31	0.0645161
NODE_11783_length_807_cov_67.341808	339	370	331	2	31	0.0645161
NODE_11783_length_807_cov_67.341808	339	370	333	1	31	0.0322581
NODE_11783_length_807_cov_67.341808	343	423	310	1	80	0.0125000
NODE_11783_length_807_cov_67.341808	343	423	311	3	80	0.0375000
NODE_11783_length_807_cov_67.341808	343	423	313	2	80	0.0250000
NODE_11783_length_807_cov_67.341808	343	423	314	1	80	0.0125000
NODE_11783_length_807_cov_67.341808	343	423	315	1	80	0.0125000
NODE_11783_length_807_cov_67.341808	343	423	316	3	80	0.0375000
NODE_11783_length_807_cov_67.341808	343	423	318	2	80	0.0250000
NODE_11783_length_807_cov_67.341808	343	423	319	3	80	0.0375000
NODE_11783_length_807_cov_67.341808	343	423	320	3	80	0.0375000
NODE_11783_length_807_cov_67.341808	343	423	321	1	80	0.0125000
NODE_11783_length_807_cov_67.341808	343	423	322	4	80	0.0500000
NODE_11783_length_807_cov_67.341808	343	423	323	1	80	0.0125000
NODE_11783_length_807_cov_67.341808	343	423	324	6	80	0.0750000
NODE_11783_length_807_cov_67.341808	343	423	325	5	80	0.0625000
NODE_11783_length_807_cov_67.341808	343	423	326	4	80	0.0500000
NODE_11783_length_807_cov_67.341808	343	423	327	10	80	0.1250000
NODE_11783_length_807_cov_67.341808	343	423	328	8	80	0.1000000
NODE_11783_length_807_cov_67.341808	343	423	329	4	80	0.0500000
NODE_11783_length_807_cov_67.341808	343	423	330	4	80	0.0500000
NODE_11783_length_807_cov_67.341808	343	423	331	4	80	0.0500000
NODE_11783_length_807_cov_67.341808	343	423	332	2	80	0.0250000
NODE_11783_length_807_cov_67.341808	343	423	333	3	80	0.0375000
NODE_11783_length_807_cov_67.341808	343	423	334	1	80	0.0125000
NODE_11783_length_807_cov_67.341808	343	423	335	3	80	0.0375000
NODE_11783_length_807_cov_67.341808	343	423	336	1	80	0.0125000
NODE_11784_length_807_cov_54.980226	683	749	84	3	66	0.0454545
NODE_11784_length_807_cov_54.980226	683	749	90	2	66	0.0303030
NODE_11784_length_807_cov_54.980226	683	749	93	5	66	0.0757576
NODE_11784_length_807_cov_54.980226	683	749	94	7	66	0.1060606
NODE_11784_length_807_cov_54.980226	683	749	96	1	66	0.0151515
NODE_11784_length_807_cov_54.980226	683	749	100	1	66	0.0151515
NODE_11784_length_807_cov_54.980226	683	749	101	6	66	0.0909091
NODE_11784_length_807_cov_54.980226	683	749	104	5	66	0.0757576
NODE_11784_length_807_cov_54.980226	683	749	108	5	66	0.0757576
NODE_11784_length_807_cov_54.980226	683	749	109	2	66	0.0303030
NODE_11784_length_807_cov_54.980226	683	749	110	1	66	0.0151515
NODE_11784_length_807_cov_54.980226	683	749	111	1	66	0.0151515
NODE_11784_length_807_cov_54.980226	683	749	113	4	66	0.0606061
NODE_11784_length_807_cov_54.980226	683	749	114	1	66	0.0151515
NODE_11784_length_807_cov_54.980226	683	749	115	7	66	0.1060606
NODE_11784_length_807_cov_54.980226	683	749	116	3	66	0.0454545
NODE_11784_length_807_cov_54.980226	683	749	117	1	66	0.0151515
NODE_11784_length_807_cov_54.980226	683	749	118	1	66	0.0151515
NODE_11784_length_807_cov_54.980226	683	749	119	1	66	0.0151515
NODE_11784_length_807_cov_54.980226	683	749	120	3	66	0.0454545
NODE_11784_length_807_cov_54.980226	683	749	121	3	66	0.0454545
NODE_11784_length_807_cov_54.980226	683	749	122	2	66	0.0303030
NODE_11784_length_807_cov_54.980226	683	749	124	1	66	0.0151515
NODE_11784_length_807_cov_54.980226	727	802	33	1	75	0.0133333
NODE_11784_length_807_cov_54.980226	727	802	38	2	75	0.0266667
NODE_11784_length_807_cov_54.980226	727	802	39	1	75	0.0133333
NODE_11784_length_807_cov_54.980226	727	802	43	2	75	0.0266667
NODE_11784_length_807_cov_54.980226	727	802	44	2	75	0.0266667
NODE_11784_length_807_cov_54.980226	727	802	46	1	75	0.0133333
NODE_11784_length_807_cov_54.980226	727	802	49	1	75	0.0133333
NODE_11784_length_807_cov_54.980226	727	802	53	6	75	0.0800000
NODE_11784_length_807_cov_54.980226	727	802	54	1	75	0.0133333
NODE_11784_length_807_cov_54.980226	727	802	55	5	75	0.0666667
NODE_11784_length_807_cov_54.980226	727	802	56	2	75	0.0266667
NODE_11784_length_807_cov_54.980226	727	802	58	1	75	0.0133333
NODE_11784_length_807_cov_54.980226	727	802	63	1	75	0.0133333
NODE_11784_length_807_cov_54.980226	727	802	67	1	75	0.0133333
NODE_11784_length_807_cov_54.980226	727	802	68	3	75	0.0400000
NODE_11784_length_807_cov_54.980226	727	802	71	4	75	0.0533333
NODE_11784_length_807_cov_54.980226	727	802	74	1	75	0.0133333
NODE_11784_length_807_cov_54.980226	727	802	75	5	75	0.0666667
NODE_11784_length_807_cov_54.980226	727	802	76	1	75	0.0133333
NODE_11784_length_807_cov_54.980226	727	802	77	3	75	0.0400000
NODE_11784_length_807_cov_54.980226	727	802	78	3	75	0.0400000
NODE_11784_length_807_cov_54.980226	727	802	80	4	75	0.0533333
NODE_11784_length_807_cov_54.980226	727	802	81	1	75	0.0133333
NODE_11784_length_807_cov_54.980226	727	802	84	4	75	0.0533333
NODE_11784_length_807_cov_54.980226	727	802	90	2	75	0.0266667
NODE_11784_length_807_cov_54.980226	727	802	93	5	75	0.0666667
NODE_11784_length_807_cov_54.980226	727	802	94	7	75	0.0933333
NODE_11784_length_807_cov_54.980226	727	802	96	1	75	0.0133333
NODE_11784_length_807_cov_54.980226	727	802	100	1	75	0.0133333
NODE_11784_length_807_cov_54.980226	727	802	101	3	75	0.0400000
NODE_11785_length_807_cov_37.306497	435	515	4	40	80	0.5000000
NODE_11785_length_807_cov_37.306497	435	515	5	3	80	0.0375000
NODE_11785_length_807_cov_37.306497	435	515	6	37	80	0.4625000
NODE_11785_length_807_cov_37.306497	488	568	3	10	80	0.1250000
NODE_11785_length_807_cov_37.306497	488	568	4	49	80	0.6125000
NODE_11785_length_807_cov_37.306497	488	568	5	17	80	0.2125000
NODE_11785_length_807_cov_37.306497	488	568	6	4	80	0.0500000
NODE_11786_length_807_cov_31.177966	287	367	1	17	80	0.2125000
NODE_11786_length_807_cov_31.177966	287	367	2	2	80	0.0250000
NODE_11786_length_807_cov_31.177966	287	367	4	61	80	0.7625000
NODE_11786_length_807_cov_31.177966	340	420	4	54	80	0.6750000
NODE_11786_length_807_cov_31.177966	340	420	5	26	80	0.3250000
NODE_11787_length_807_cov_30.638418	250	329	2	79	79	1.0000000
NODE_11787_length_807_cov_30.638418	302	382	0	28	80	0.3500000
NODE_11787_length_807_cov_30.638418	302	382	2	52	80	0.6500000
NODE_11787_length_807_cov_30.638418	378	458	0	80	80	1.0000000
NODE_11787_length_807_cov_30.638418	431	511	0	80	80	1.0000000
NODE_11788_length_807_cov_29.725989	362	442	0	80	80	1.0000000
NODE_11788_length_807_cov_29.725989	415	495	0	80	80	1.0000000
NODE_11789_length_807_cov_23.200565	441	521	3	28	80	0.3500000
NODE_11789_length_807_cov_23.200565	441	521	4	7	80	0.0875000
NODE_11789_length_807_cov_23.200565	441	521	5	45	80	0.5625000
NODE_11789_length_807_cov_23.200565	494	574	4	4	80	0.0500000
NODE_11789_length_807_cov_23.200565	494	574	5	76	80	0.9500000
NODE_11790_length_807_cov_21.888418	319	386	1	20	67	0.2985075
NODE_11790_length_807_cov_21.888418	319	386	2	21	67	0.3134328
NODE_11790_length_807_cov_21.888418	319	386	3	26	67	0.3880597
NODE_11790_length_807_cov_21.888418	390	440	0	50	50	1.0000000
NODE_11791_length_807_cov_17.480226	339	419	0	80	80	1.0000000
NODE_11791_length_807_cov_17.480226	392	472	0	80	80	1.0000000
NODE_11792_length_807_cov_14.895480	350	430	2	7	80	0.0875000
NODE_11792_length_807_cov_14.895480	350	430	3	73	80	0.9125000
NODE_11792_length_807_cov_14.895480	403	483	2	18	80	0.2250000
NODE_11792_length_807_cov_14.895480	403	483	3	62	80	0.7750000
NODE_11794_length_807_cov_12.255650	440	520	0	10	80	0.1250000
NODE_11794_length_807_cov_12.255650	440	520	2	31	80	0.3875000
NODE_11794_length_807_cov_12.255650	440	520	3	39	80	0.4875000
NODE_11794_length_807_cov_12.255650	493	573	2	10	80	0.1250000
NODE_11794_length_807_cov_12.255650	493	573	3	70	80	0.8750000
NODE_11795_length_807_cov_11.129944	359	439	1	80	80	1.0000000
NODE_11795_length_807_cov_11.129944	412	492	1	80	80	1.0000000
NODE_11801_length_807_cov_3.847458	322	385	0	33	63	0.5238096
NODE_11801_length_807_cov_3.847458	322	385	2	30	63	0.4761905
NODE_11822_length_806_cov_35.650636	397	477	2	76	80	0.9500000
NODE_11822_length_806_cov_35.650636	397	477	4	4	80	0.0500000
NODE_11822_length_806_cov_35.650636	450	530	2	28	80	0.3500000
NODE_11822_length_806_cov_35.650636	450	530	4	52	80	0.6500000
NODE_11822_length_806_cov_35.650636	526	606	2	4	80	0.0500000
NODE_11822_length_806_cov_35.650636	526	606	3	4	80	0.0500000
NODE_11822_length_806_cov_35.650636	526	606	4	24	80	0.3000000
NODE_11822_length_806_cov_35.650636	526	606	5	18	80	0.2250000
NODE_11822_length_806_cov_35.650636	526	606	6	4	80	0.0500000
NODE_11822_length_806_cov_35.650636	526	606	7	14	80	0.1750000
NODE_11822_length_806_cov_35.650636	526	606	8	12	80	0.1500000
NODE_11822_length_806_cov_35.650636	579	667	6	61	88	0.6931818
NODE_11822_length_806_cov_35.650636	579	667	7	14	88	0.1590909
NODE_11822_length_806_cov_35.650636	579	667	8	13	88	0.1477273
NODE_11823_length_806_cov_29.615276	377	457	2	15	80	0.1875000
NODE_11823_length_806_cov_29.615276	377	457	3	34	80	0.4250000
NODE_11823_length_806_cov_29.615276	377	457	4	31	80	0.3875000
NODE_11823_length_806_cov_29.615276	430	510	1	8	80	0.1000000
NODE_11823_length_806_cov_29.615276	430	510	2	60	80	0.7500000
NODE_11823_length_806_cov_29.615276	430	510	3	12	80	0.1500000
NODE_11824_length_806_cov_23.680339	394	474	1	37	80	0.4625000
NODE_11824_length_806_cov_23.680339	394	474	2	43	80	0.5375000
NODE_11824_length_806_cov_23.680339	447	527	1	9	80	0.1125000
NODE_11824_length_806_cov_23.680339	447	527	2	71	80	0.8875000
NODE_11825_length_806_cov_19.107496	239	293	1	5	54	0.0925926
NODE_11825_length_806_cov_19.107496	239	293	2	49	54	0.9074074
NODE_11825_length_806_cov_19.107496	248	293	2	45	45	1.0000000
NODE_11825_length_806_cov_19.107496	266	345	2	29	79	0.3670886
NODE_11825_length_806_cov_19.107496	266	345	3	26	79	0.3291139
NODE_11825_length_806_cov_19.107496	266	345	5	24	79	0.3037975
NODE_11825_length_806_cov_19.107496	266	345	2	29	79	0.3670886
NODE_11825_length_806_cov_19.107496	266	345	3	26	79	0.3291139
NODE_11825_length_806_cov_19.107496	266	345	5	24	79	0.3037975
NODE_11825_length_806_cov_19.107496	421	501	4	17	80	0.2125000
NODE_11825_length_806_cov_19.107496	421	501	5	13	80	0.1625000
NODE_11825_length_806_cov_19.107496	421	501	7	19	80	0.2375000
NODE_11825_length_806_cov_19.107496	421	501	8	4	80	0.0500000
NODE_11825_length_806_cov_19.107496	421	501	10	27	80	0.3375000
NODE_11826_length_806_cov_17.551627	308	388	0	11	80	0.1375000
NODE_11826_length_806_cov_17.551627	308	388	2	69	80	0.8625000
NODE_11826_length_806_cov_17.551627	361	441	0	41	80	0.5125000
NODE_11826_length_806_cov_17.551627	361	441	2	39	80	0.4875000
NODE_11827_length_806_cov_15.608204	408	488	0	26	80	0.3250000
NODE_11827_length_806_cov_15.608204	408	488	2	54	80	0.6750000
NODE_11827_length_806_cov_15.608204	461	543	2	82	82	1.0000000
NODE_11864_length_805_cov_94.121813	398	478	2	19	80	0.2375000
NODE_11864_length_805_cov_94.121813	398	478	5	1	80	0.0125000
NODE_11864_length_805_cov_94.121813	398	478	6	14	80	0.1750000
NODE_11864_length_805_cov_94.121813	398	478	7	16	80	0.2000000
NODE_11864_length_805_cov_94.121813	398	478	9	30	80	0.3750000
NODE_11864_length_805_cov_94.121813	451	531	8	36	80	0.4500000
NODE_11864_length_805_cov_94.121813	451	531	9	44	80	0.5500000
NODE_11865_length_805_cov_54.001416	284	364	0	80	80	1.0000000
NODE_11865_length_805_cov_54.001416	337	417	0	80	80	1.0000000
NODE_11865_length_805_cov_54.001416	413	493	0	80	80	1.0000000
NODE_11865_length_805_cov_54.001416	466	546	0	37	80	0.4625000
NODE_11865_length_805_cov_54.001416	466	546	2	43	80	0.5375000
NODE_11866_length_805_cov_42.325779	377	457	22	7	80	0.0875000
NODE_11866_length_805_cov_42.325779	377	457	24	6	80	0.0750000
NODE_11866_length_805_cov_42.325779	377	457	25	1	80	0.0125000
NODE_11866_length_805_cov_42.325779	377	457	26	22	80	0.2750000
NODE_11866_length_805_cov_42.325779	377	457	27	7	80	0.0875000
NODE_11866_length_805_cov_42.325779	377	457	28	15	80	0.1875000
NODE_11866_length_805_cov_42.325779	377	457	29	6	80	0.0750000
NODE_11866_length_805_cov_42.325779	377	457	30	16	80	0.2000000
NODE_11866_length_805_cov_42.325779	430	510	14	2	80	0.0250000
NODE_11866_length_805_cov_42.325779	430	510	15	10	80	0.1250000
NODE_11866_length_805_cov_42.325779	430	510	18	1	80	0.0125000
NODE_11866_length_805_cov_42.325779	430	510	20	2	80	0.0250000
NODE_11866_length_805_cov_42.325779	430	510	21	2	80	0.0250000
NODE_11866_length_805_cov_42.325779	430	510	22	24	80	0.3000000
NODE_11866_length_805_cov_42.325779	430	510	23	7	80	0.0875000
NODE_11866_length_805_cov_42.325779	430	510	24	18	80	0.2250000
NODE_11866_length_805_cov_42.325779	430	510	25	1	80	0.0125000
NODE_11866_length_805_cov_42.325779	430	510	26	7	80	0.0875000
NODE_11866_length_805_cov_42.325779	430	510	27	5	80	0.0625000
NODE_11866_length_805_cov_42.325779	430	510	28	1	80	0.0125000
NODE_11867_length_805_cov_36.742210	345	425	2	6	80	0.0750000
NODE_11867_length_805_cov_36.742210	345	425	4	47	80	0.5875000
NODE_11867_length_805_cov_36.742210	345	425	5	27	80	0.3375000
NODE_11867_length_805_cov_36.742210	398	478	4	19	80	0.2375000
NODE_11867_length_805_cov_36.742210	398	478	5	49	80	0.6125000
NODE_11867_length_805_cov_36.742210	398	478	6	12	80	0.1500000
NODE_11868_length_805_cov_25.879603	361	441	4	5	80	0.0625000
NODE_11868_length_805_cov_25.879603	361	441	6	63	80	0.7875000
NODE_11868_length_805_cov_25.879603	361	441	7	12	80	0.1500000
NODE_11868_length_805_cov_25.879603	414	494	4	35	80	0.4375000
NODE_11868_length_805_cov_25.879603	414	494	5	22	80	0.2750000
NODE_11868_length_805_cov_25.879603	414	494	6	12	80	0.1500000
NODE_11868_length_805_cov_25.879603	414	494	7	11	80	0.1375000
NODE_11869_length_805_cov_25.048159	306	386	1	17	80	0.2125000
NODE_11869_length_805_cov_25.048159	306	386	2	28	80	0.3500000
NODE_11869_length_805_cov_25.048159	306	386	3	35	80	0.4375000
NODE_11869_length_805_cov_25.048159	359	439	2	57	80	0.7125000
NODE_11869_length_805_cov_25.048159	359	439	3	23	80	0.2875000
NODE_11870_length_805_cov_15.453258	311	391	0	14	80	0.1750000
NODE_11870_length_805_cov_15.453258	311	391	2	66	80	0.8250000
NODE_11870_length_805_cov_15.453258	364	444	0	67	80	0.8375000
NODE_11870_length_805_cov_15.453258	364	444	2	13	80	0.1625000
NODE_11871_length_805_cov_14.930595	264	344	2	80	80	1.0000000
NODE_11871_length_805_cov_14.930595	317	397	0	10	80	0.1250000
NODE_11871_length_805_cov_14.930595	317	397	2	70	80	0.8750000
NODE_11872_length_805_cov_10.888102	259	339	1	80	80	1.0000000
NODE_11872_length_805_cov_10.888102	312	392	1	80	80	1.0000000
NODE_11873_length_805_cov_10.716714	348	428	0	8	80	0.1000000
NODE_11873_length_805_cov_10.716714	348	428	1	38	80	0.4750000
NODE_11873_length_805_cov_10.716714	348	428	2	34	80	0.4250000
NODE_11873_length_805_cov_10.716714	401	481	0	61	80	0.7625000
NODE_11873_length_805_cov_10.716714	401	481	1	19	80	0.2375000
NODE_11876_length_805_cov_7.212465	374	454	2	55	80	0.6875000
NODE_11876_length_805_cov_7.212465	374	454	3	5	80	0.0625000
NODE_11876_length_805_cov_7.212465	374	454	4	20	80	0.2500000
NODE_11876_length_805_cov_7.212465	427	507	2	18	80	0.2250000
NODE_11876_length_805_cov_7.212465	427	507	4	62	80	0.7750000
NODE_11877_length_805_cov_5.637394	323	403	0	46	80	0.5750000
NODE_11877_length_805_cov_5.637394	323	403	1	34	80	0.4250000
NODE_11877_length_805_cov_5.637394	376	456	0	57	80	0.7125000
NODE_11877_length_805_cov_5.637394	376	456	1	23	80	0.2875000
NODE_11878_length_805_cov_4.001416	304	384	0	80	80	1.0000000
NODE_11878_length_805_cov_4.001416	357	437	0	80	80	1.0000000
NODE_11903_length_804_cov_26.204255	319	399	1	80	80	1.0000000
NODE_11903_length_804_cov_26.204255	372	452	1	38	80	0.4750000
NODE_11903_length_804_cov_26.204255	372	452	3	26	80	0.3250000
NODE_11903_length_804_cov_26.204255	372	452	4	16	80	0.2000000
NODE_11904_length_804_cov_25.978723	242	322	0	80	80	1.0000000
NODE_11904_length_804_cov_25.978723	295	375	0	44	80	0.5500000
NODE_11904_length_804_cov_25.978723	295	375	1	36	80	0.4500000
NODE_11904_length_804_cov_25.978723	371	451	1	20	80	0.2500000
NODE_11904_length_804_cov_25.978723	371	451	2	60	80	0.7500000
NODE_11904_length_804_cov_25.978723	424	504	1	15	80	0.1875000
NODE_11904_length_804_cov_25.978723	424	504	2	65	80	0.8125000
NODE_11905_length_804_cov_25.628369	444	524	1	17	80	0.2125000
NODE_11905_length_804_cov_25.628369	444	524	2	19	80	0.2375000
NODE_11905_length_804_cov_25.628369	444	524	3	43	80	0.5375000
NODE_11905_length_804_cov_25.628369	444	524	4	1	80	0.0125000
NODE_11905_length_804_cov_25.628369	497	577	1	70	80	0.8750000
NODE_11905_length_804_cov_25.628369	497	577	2	10	80	0.1250000
NODE_11906_length_804_cov_22.438298	269	349	0	80	80	1.0000000
NODE_11906_length_804_cov_22.438298	322	402	0	80	80	1.0000000
NODE_11907_length_804_cov_17.425532	273	353	1	19	80	0.2375000
NODE_11907_length_804_cov_17.425532	273	353	2	17	80	0.2125000
NODE_11907_length_804_cov_17.425532	273	353	4	9	80	0.1125000
NODE_11907_length_804_cov_17.425532	273	353	5	35	80	0.4375000
NODE_11907_length_804_cov_17.425532	326	406	5	29	80	0.3625000
NODE_11907_length_804_cov_17.425532	326	406	6	40	80	0.5000000
NODE_11907_length_804_cov_17.425532	326	406	7	11	80	0.1375000
NODE_11908_length_804_cov_16.849645	229	309	3	23	80	0.2875000
NODE_11908_length_804_cov_16.849645	229	309	5	11	80	0.1375000
NODE_11908_length_804_cov_16.849645	229	309	6	9	80	0.1125000
NODE_11908_length_804_cov_16.849645	229	309	7	37	80	0.4625000
NODE_11908_length_804_cov_16.849645	282	362	6	53	80	0.6625000
NODE_11908_length_804_cov_16.849645	282	362	7	27	80	0.3375000
NODE_11909_length_804_cov_16.024113	499	579	0	80	80	1.0000000
NODE_11909_length_804_cov_16.024113	552	632	0	80	80	1.0000000
NODE_11910_length_804_cov_14.567376	375	455	0	80	80	1.0000000
NODE_11910_length_804_cov_14.567376	428	508	0	80	80	1.0000000
NODE_11911_length_804_cov_14.011348	262	342	0	80	80	1.0000000
NODE_11911_length_804_cov_14.011348	315	395	0	80	80	1.0000000
NODE_11912_length_804_cov_13.800000	289	318	0	29	29	1.0000000
NODE_11913_length_804_cov_12.585816	396	476	0	45	80	0.5625000
NODE_11913_length_804_cov_12.585816	396	476	1	35	80	0.4375000
NODE_11913_length_804_cov_12.585816	449	529	0	80	80	1.0000000
NODE_11914_length_804_cov_12.375887	190	270	0	24	80	0.3000000
NODE_11914_length_804_cov_12.375887	190	270	2	56	80	0.7000000
NODE_11914_length_804_cov_12.375887	243	323	2	80	80	1.0000000
NODE_11915_length_804_cov_10.947518	363	443	3	22	80	0.2750000
NODE_11915_length_804_cov_10.947518	363	443	4	40	80	0.5000000
NODE_11915_length_804_cov_10.947518	363	443	6	18	80	0.2250000
NODE_11915_length_804_cov_10.947518	416	496	4	58	80	0.7250000
NODE_11915_length_804_cov_10.947518	416	496	6	22	80	0.2750000
NODE_11916_length_804_cov_8.164539	427	507	0	18	80	0.2250000
NODE_11916_length_804_cov_8.164539	427	507	2	62	80	0.7750000
NODE_11916_length_804_cov_8.164539	480	560	2	80	80	1.0000000
NODE_11917_length_804_cov_7.462411	345	425	0	80	80	1.0000000
NODE_11917_length_804_cov_7.462411	398	478	0	80	80	1.0000000
NODE_11919_length_804_cov_3.663830	736	799	0	63	63	1.0000000
NODE_11933_length_804_cov_1.303546	480	560	1	78	80	0.9750000
NODE_11933_length_804_cov_1.303546	480	560	2	2	80	0.0250000
NODE_11933_length_804_cov_1.303546	533	613	1	78	80	0.9750000
NODE_11933_length_804_cov_1.303546	533	613	2	2	80	0.0250000
NODE_11942_length_803_cov_40.930398	374	454	0	29	80	0.3625000
NODE_11942_length_803_cov_40.930398	374	454	1	10	80	0.1250000
NODE_11942_length_803_cov_40.930398	374	454	2	4	80	0.0500000
NODE_11942_length_803_cov_40.930398	374	454	4	9	80	0.1125000
NODE_11942_length_803_cov_40.930398	374	454	6	28	80	0.3500000
NODE_11942_length_803_cov_40.930398	427	507	6	54	80	0.6750000
NODE_11942_length_803_cov_40.930398	427	507	7	26	80	0.3250000
NODE_11944_length_803_cov_28.346591	242	322	2	35	80	0.4375000
NODE_11944_length_803_cov_28.346591	242	322	3	31	80	0.3875000
NODE_11944_length_803_cov_28.346591	242	322	4	14	80	0.1750000
NODE_11944_length_803_cov_28.346591	295	375	2	12	80	0.1500000
NODE_11944_length_803_cov_28.346591	295	375	3	32	80	0.4000000
NODE_11944_length_803_cov_28.346591	295	375	4	36	80	0.4500000
NODE_11945_length_803_cov_23.420455	288	368	0	11	80	0.1375000
NODE_11945_length_803_cov_23.420455	288	368	2	69	80	0.8625000
NODE_11945_length_803_cov_23.420455	341	421	0	64	80	0.8000000
NODE_11945_length_803_cov_23.420455	341	421	2	16	80	0.2000000
NODE_11946_length_803_cov_20.977273	316	396	2	9	80	0.1125000
NODE_11946_length_803_cov_20.977273	316	396	3	68	80	0.8500000
NODE_11946_length_803_cov_20.977273	316	396	4	3	80	0.0375000
NODE_11946_length_803_cov_20.977273	369	449	3	74	80	0.9250000
NODE_11946_length_803_cov_20.977273	369	449	4	6	80	0.0750000
NODE_11947_length_803_cov_18.458807	307	387	2	46	80	0.5750000
NODE_11947_length_803_cov_18.458807	307	387	3	34	80	0.4250000
NODE_11947_length_803_cov_18.458807	360	440	1	24	80	0.3000000
NODE_11947_length_803_cov_18.458807	360	440	2	56	80	0.7000000
NODE_11948_length_803_cov_14.411932	386	466	0	80	80	1.0000000
NODE_11948_length_803_cov_14.411932	439	519	0	80	80	1.0000000
NODE_11949_length_803_cov_10.157670	319	399	0	27	80	0.3375000
NODE_11949_length_803_cov_10.157670	319	399	1	53	80	0.6625000
NODE_11949_length_803_cov_10.157670	372	452	0	16	80	0.2000000
NODE_11949_length_803_cov_10.157670	372	452	1	64	80	0.8000000
NODE_11950_length_803_cov_8.977273	362	442	0	20	80	0.2500000
NODE_11950_length_803_cov_8.977273	362	442	1	60	80	0.7500000
NODE_11950_length_803_cov_8.977273	415	485	0	63	70	0.9000000
NODE_11950_length_803_cov_8.977273	415	485	1	7	70	0.1000000
NODE_11951_length_803_cov_7.735795	195	275	0	80	80	1.0000000
NODE_11951_length_803_cov_7.735795	248	328	0	80	80	1.0000000
NODE_11955_length_803_cov_4.613636	266	346	0	35	80	0.4375000
NODE_11955_length_803_cov_4.613636	266	346	2	45	80	0.5625000
NODE_11955_length_803_cov_4.613636	319	399	2	80	80	1.0000000
NODE_11957_length_803_cov_4.220170	72	152	2	40	80	0.5000000
NODE_11957_length_803_cov_4.220170	72	152	3	40	80	0.5000000
NODE_11957_length_803_cov_4.220170	130	207	1	28	77	0.3636364
NODE_11957_length_803_cov_4.220170	130	207	3	49	77	0.6363636
NODE_11985_length_802_cov_42.294452	289	369	2	44	80	0.5500000
NODE_11985_length_802_cov_42.294452	289	369	4	4	80	0.0500000
NODE_11985_length_802_cov_42.294452	289	369	6	32	80	0.4000000
NODE_11985_length_802_cov_42.294452	342	422	6	60	80	0.7500000
NODE_11985_length_802_cov_42.294452	342	422	7	12	80	0.1500000
NODE_11985_length_802_cov_42.294452	342	422	8	8	80	0.1000000
NODE_11986_length_802_cov_31.896159	246	326	2	30	80	0.3750000
NODE_11986_length_802_cov_31.896159	246	326	3	21	80	0.2625000
NODE_11986_length_802_cov_31.896159	246	326	4	29	80	0.3625000
NODE_11986_length_802_cov_31.896159	299	379	0	28	80	0.3500000
NODE_11986_length_802_cov_31.896159	299	379	2	13	80	0.1625000
NODE_11986_length_802_cov_31.896159	299	379	3	33	80	0.4125000
NODE_11986_length_802_cov_31.896159	299	379	4	6	80	0.0750000
NODE_11987_length_802_cov_30.786629	419	499	1	72	80	0.9000000
NODE_11987_length_802_cov_30.786629	419	499	2	8	80	0.1000000
NODE_11987_length_802_cov_30.786629	472	552	0	17	80	0.2125000
NODE_11987_length_802_cov_30.786629	472	552	1	63	80	0.7875000
NODE_11988_length_802_cov_19.540541	368	448	0	80	80	1.0000000
NODE_11988_length_802_cov_19.540541	421	501	0	80	80	1.0000000
NODE_11989_length_802_cov_17.689900	268	348	0	10	80	0.1250000
NODE_11989_length_802_cov_17.689900	268	348	2	70	80	0.8750000
NODE_11989_length_802_cov_17.689900	321	401	2	80	80	1.0000000
NODE_11990_length_802_cov_16.432432	364	444	1	21	80	0.2625000
NODE_11990_length_802_cov_16.432432	364	444	3	42	80	0.5250000
NODE_11990_length_802_cov_16.432432	364	444	5	17	80	0.2125000
NODE_11990_length_802_cov_16.432432	417	497	1	74	80	0.9250000
NODE_11990_length_802_cov_16.432432	417	497	3	6	80	0.0750000
NODE_11991_length_802_cov_15.409673	317	397	2	23	80	0.2875000
NODE_11991_length_802_cov_15.409673	317	397	3	32	80	0.4000000
NODE_11991_length_802_cov_15.409673	317	397	4	25	80	0.3125000
NODE_11991_length_802_cov_15.409673	370	450	1	25	80	0.3125000
NODE_11991_length_802_cov_15.409673	370	450	2	26	80	0.3250000
NODE_11991_length_802_cov_15.409673	370	450	3	29	80	0.3625000
NODE_11992_length_802_cov_12.507824	340	420	2	80	80	1.0000000
NODE_11992_length_802_cov_12.507824	393	473	1	46	80	0.5750000
NODE_11992_length_802_cov_12.507824	393	473	2	34	80	0.4250000
NODE_11993_length_802_cov_9.310100	374	454	0	48	80	0.6000000
NODE_11993_length_802_cov_9.310100	374	454	1	32	80	0.4000000
NODE_11993_length_802_cov_9.310100	427	507	1	32	80	0.4000000
NODE_11993_length_802_cov_9.310100	427	507	2	48	80	0.6000000
NODE_11994_length_802_cov_8.421053	272	351	0	79	79	1.0000000
NODE_11994_length_802_cov_8.421053	324	404	0	80	80	1.0000000
NODE_11997_length_802_cov_5.576102	294	374	0	80	80	1.0000000
NODE_11997_length_802_cov_5.576102	347	427	0	80	80	1.0000000
NODE_12025_length_801_cov_35.199430	334	414	1	32	80	0.4000000
NODE_12025_length_801_cov_35.199430	334	414	2	2	80	0.0250000
NODE_12025_length_801_cov_35.199430	334	414	3	13	80	0.1625000
NODE_12025_length_801_cov_35.199430	334	414	4	33	80	0.4125000
NODE_12025_length_801_cov_35.199430	387	467	4	80	80	1.0000000
NODE_12026_length_801_cov_20.096866	347	427	1	38	80	0.4750000
NODE_12026_length_801_cov_20.096866	347	427	3	7	80	0.0875000
NODE_12026_length_801_cov_20.096866	347	427	4	4	80	0.0500000
NODE_12026_length_801_cov_20.096866	347	427	5	31	80	0.3875000
NODE_12026_length_801_cov_20.096866	400	480	1	80	80	1.0000000
NODE_12027_length_801_cov_18.643875	355	435	1	38	80	0.4750000
NODE_12027_length_801_cov_18.643875	355	435	2	7	80	0.0875000
NODE_12027_length_801_cov_18.643875	355	435	3	5	80	0.0625000
NODE_12027_length_801_cov_18.643875	355	435	4	30	80	0.3750000
NODE_12027_length_801_cov_18.643875	408	488	3	47	80	0.5875000
NODE_12027_length_801_cov_18.643875	408	488	4	33	80	0.4125000
NODE_12028_length_801_cov_16.099715	427	507	0	9	80	0.1125000
NODE_12028_length_801_cov_16.099715	427	507	2	71	80	0.8875000
NODE_12028_length_801_cov_16.099715	480	560	0	37	80	0.4625000
NODE_12028_length_801_cov_16.099715	480	560	2	43	80	0.5375000
NODE_12029_length_801_cov_12.307692	332	412	0	80	80	1.0000000
NODE_12029_length_801_cov_12.307692	385	465	0	80	80	1.0000000
NODE_12030_length_801_cov_11.464387	293	373	0	80	80	1.0000000
NODE_12030_length_801_cov_11.464387	346	426	0	80	80	1.0000000
NODE_12031_length_801_cov_8.562678	309	389	0	80	80	1.0000000
NODE_12031_length_801_cov_8.562678	362	442	0	80	80	1.0000000
NODE_12032_length_801_cov_3.927350	339	419	0	21	80	0.2625000
NODE_12032_length_801_cov_3.927350	339	419	1	20	80	0.2500000
NODE_12032_length_801_cov_3.927350	339	419	2	39	80	0.4875000
NODE_12032_length_801_cov_3.927350	392	472	2	80	80	1.0000000
NODE_12053_length_800_cov_72.029957	245	325	5	18	80	0.2250000
NODE_12053_length_800_cov_72.029957	245	325	6	25	80	0.3125000
NODE_12053_length_800_cov_72.029957	245	325	7	37	80	0.4625000
NODE_12053_length_800_cov_72.029957	298	378	5	31	80	0.3875000
NODE_12053_length_800_cov_72.029957	298	378	6	49	80	0.6125000
NODE_12054_length_800_cov_22.631954	297	377	10	1	80	0.0125000
NODE_12054_length_800_cov_22.631954	297	377	12	18	80	0.2250000
NODE_12054_length_800_cov_22.631954	297	377	13	34	80	0.4250000
NODE_12054_length_800_cov_22.631954	297	377	14	19	80	0.2375000
NODE_12054_length_800_cov_22.631954	297	377	15	8	80	0.1000000
NODE_12054_length_800_cov_22.631954	350	430	9	4	80	0.0500000
NODE_12054_length_800_cov_22.631954	350	430	10	9	80	0.1125000
NODE_12054_length_800_cov_22.631954	350	430	11	4	80	0.0500000
NODE_12054_length_800_cov_22.631954	350	430	12	19	80	0.2375000
NODE_12054_length_800_cov_22.631954	350	430	13	4	80	0.0500000
NODE_12054_length_800_cov_22.631954	350	430	14	22	80	0.2750000
NODE_12054_length_800_cov_22.631954	350	430	15	18	80	0.2250000
NODE_12055_length_800_cov_9.457917	409	489	4	31	80	0.3875000
NODE_12055_length_800_cov_9.457917	409	489	5	24	80	0.3000000
NODE_12055_length_800_cov_9.457917	409	489	6	25	80	0.3125000
NODE_12055_length_800_cov_9.457917	462	542	2	29	80	0.3625000
NODE_12055_length_800_cov_9.457917	462	542	3	4	80	0.0500000
NODE_12055_length_800_cov_9.457917	462	542	4	12	80	0.1500000
NODE_12055_length_800_cov_9.457917	462	542	5	18	80	0.2250000
NODE_12055_length_800_cov_9.457917	462	542	6	17	80	0.2125000
NODE_12084_length_799_cov_101.640000	101	132	84	1	31	0.0322581
NODE_12084_length_799_cov_101.640000	101	132	87	1	31	0.0322581
NODE_12084_length_799_cov_101.640000	101	132	88	1	31	0.0322581
NODE_12084_length_799_cov_101.640000	101	132	102	1	31	0.0322581
NODE_12084_length_799_cov_101.640000	101	132	108	1	31	0.0322581
NODE_12084_length_799_cov_101.640000	101	132	110	2	31	0.0645161
NODE_12084_length_799_cov_101.640000	101	132	114	1	31	0.0322581
NODE_12084_length_799_cov_101.640000	101	132	117	1	31	0.0322581
NODE_12084_length_799_cov_101.640000	101	132	122	1	31	0.0322581
NODE_12084_length_799_cov_101.640000	101	132	125	1	31	0.0322581
NODE_12084_length_799_cov_101.640000	101	132	130	1	31	0.0322581
NODE_12084_length_799_cov_101.640000	101	132	134	1	31	0.0322581
NODE_12084_length_799_cov_101.640000	101	132	140	1	31	0.0322581
NODE_12084_length_799_cov_101.640000	101	132	143	1	31	0.0322581
NODE_12084_length_799_cov_101.640000	101	132	146	1	31	0.0322581
NODE_12084_length_799_cov_101.640000	101	132	150	1	31	0.0322581
NODE_12084_length_799_cov_101.640000	101	132	154	1	31	0.0322581
NODE_12084_length_799_cov_101.640000	101	132	157	1	31	0.0322581
NODE_12084_length_799_cov_101.640000	101	132	160	1	31	0.0322581
NODE_12084_length_799_cov_101.640000	101	132	167	1	31	0.0322581
NODE_12084_length_799_cov_101.640000	101	132	173	1	31	0.0322581
NODE_12084_length_799_cov_101.640000	101	132	185	1	31	0.0322581
NODE_12084_length_799_cov_101.640000	101	132	193	1	31	0.0322581
NODE_12084_length_799_cov_101.640000	101	132	196	1	31	0.0322581
NODE_12084_length_799_cov_101.640000	101	132	198	1	31	0.0322581
NODE_12084_length_799_cov_101.640000	101	132	199	1	31	0.0322581
NODE_12084_length_799_cov_101.640000	101	132	207	1	31	0.0322581
NODE_12084_length_799_cov_101.640000	101	132	209	1	31	0.0322581
NODE_12084_length_799_cov_101.640000	101	132	213	1	31	0.0322581
NODE_12084_length_799_cov_101.640000	101	132	215	1	31	0.0322581
NODE_12085_length_799_cov_33.630000	367	447	3	52	80	0.6500000
NODE_12085_length_799_cov_33.630000	367	447	4	22	80	0.2750000
NODE_12085_length_799_cov_33.630000	367	447	5	6	80	0.0750000
NODE_12085_length_799_cov_33.630000	420	500	1	14	80	0.1750000
NODE_12085_length_799_cov_33.630000	420	500	3	50	80	0.6250000
NODE_12085_length_799_cov_33.630000	420	500	4	16	80	0.2000000
NODE_12086_length_799_cov_15.717143	408	488	0	80	80	1.0000000
NODE_12086_length_799_cov_15.717143	461	541	0	80	80	1.0000000
NODE_12087_length_799_cov_15.175714	293	373	0	66	80	0.8250000
NODE_12087_length_799_cov_15.175714	293	373	1	14	80	0.1750000
NODE_12087_length_799_cov_15.175714	346	426	0	13	80	0.1625000
NODE_12087_length_799_cov_15.175714	346	426	1	67	80	0.8375000
NODE_12088_length_799_cov_8.444286	408	488	1	46	80	0.5750000
NODE_12088_length_799_cov_8.444286	408	488	2	11	80	0.1375000
NODE_12088_length_799_cov_8.444286	408	488	3	23	80	0.2875000
NODE_12088_length_799_cov_8.444286	461	541	2	14	80	0.1750000
NODE_12088_length_799_cov_8.444286	461	541	3	66	80	0.8250000
NODE_12120_length_798_cov_42.629471	148	228	0	80	80	1.0000000
NODE_12120_length_798_cov_42.629471	201	281	0	80	80	1.0000000
NODE_12121_length_798_cov_23.658083	368	448	2	17	80	0.2125000
NODE_12121_length_798_cov_23.658083	368	448	3	28	80	0.3500000
NODE_12121_length_798_cov_23.658083	368	448	4	35	80	0.4375000
NODE_12121_length_798_cov_23.658083	421	501	2	47	80	0.5875000
NODE_12121_length_798_cov_23.658083	421	501	3	33	80	0.4125000
NODE_12122_length_798_cov_15.037196	341	421	2	80	80	1.0000000
NODE_12122_length_798_cov_15.037196	394	474	0	11	80	0.1375000
NODE_12122_length_798_cov_15.037196	394	474	1	41	80	0.5125000
NODE_12122_length_798_cov_15.037196	394	474	2	28	80	0.3500000
NODE_12123_length_798_cov_6.816881	404	483	0	79	79	1.0000000
NODE_12123_length_798_cov_6.816881	457	536	0	79	79	1.0000000
NODE_12129_length_798_cov_2.796853	246	326	0	80	80	1.0000000
NODE_12129_length_798_cov_2.796853	299	379	0	80	80	1.0000000
NODE_12151_length_797_cov_24.340974	207	287	0	80	80	1.0000000
NODE_12151_length_797_cov_24.340974	260	340	0	80	80	1.0000000
NODE_12152_length_797_cov_21.071633	372	452	2	6	80	0.0750000
NODE_12152_length_797_cov_21.071633	372	452	3	8	80	0.1000000
NODE_12152_length_797_cov_21.071633	372	452	4	29	80	0.3625000
NODE_12152_length_797_cov_21.071633	372	452	6	18	80	0.2250000
NODE_12152_length_797_cov_21.071633	372	452	7	17	80	0.2125000
NODE_12152_length_797_cov_21.071633	372	452	8	2	80	0.0250000
NODE_12152_length_797_cov_21.071633	425	505	6	8	80	0.1000000
NODE_12152_length_797_cov_21.071633	425	505	7	17	80	0.2125000
NODE_12152_length_797_cov_21.071633	425	505	8	10	80	0.1250000
NODE_12152_length_797_cov_21.071633	425	505	9	45	80	0.5625000
NODE_12153_length_797_cov_18.286533	346	426	2	63	80	0.7875000
NODE_12153_length_797_cov_18.286533	346	426	3	17	80	0.2125000
NODE_12153_length_797_cov_18.286533	399	479	2	41	80	0.5125000
NODE_12153_length_797_cov_18.286533	399	479	3	30	80	0.3750000
NODE_12153_length_797_cov_18.286533	399	479	4	9	80	0.1125000
NODE_12154_length_797_cov_16.628940	322	402	4	16	80	0.2000000
NODE_12154_length_797_cov_16.628940	322	402	5	40	80	0.5000000
NODE_12154_length_797_cov_16.628940	322	402	6	24	80	0.3000000
NODE_12154_length_797_cov_16.628940	375	455	2	4	80	0.0500000
NODE_12154_length_797_cov_16.628940	375	455	3	6	80	0.0750000
NODE_12154_length_797_cov_16.628940	375	455	4	45	80	0.5625000
NODE_12154_length_797_cov_16.628940	375	455	5	25	80	0.3125000
NODE_12155_length_797_cov_15.266476	299	379	2	80	80	1.0000000
NODE_12155_length_797_cov_15.266476	352	432	0	34	80	0.4250000
NODE_12155_length_797_cov_15.266476	352	432	2	46	80	0.5750000
NODE_12156_length_797_cov_15.035817	263	343	4	17	80	0.2125000
NODE_12156_length_797_cov_15.035817	263	343	5	47	80	0.5875000
NODE_12156_length_797_cov_15.035817	263	343	6	16	80	0.2000000
NODE_12156_length_797_cov_15.035817	316	396	4	40	80	0.5000000
NODE_12156_length_797_cov_15.035817	316	396	5	40	80	0.5000000
NODE_12157_length_797_cov_12.934097	403	484	1	33	81	0.4074074
NODE_12157_length_797_cov_12.934097	403	484	2	20	81	0.2469136
NODE_12157_length_797_cov_12.934097	403	484	3	28	81	0.3456790
NODE_12157_length_797_cov_12.934097	457	537	3	69	80	0.8625000
NODE_12157_length_797_cov_12.934097	457	537	4	11	80	0.1375000
NODE_12158_length_797_cov_11.140401	201	281	1	8	80	0.1000000
NODE_12158_length_797_cov_11.140401	201	281	2	51	80	0.6375000
NODE_12158_length_797_cov_11.140401	201	281	3	21	80	0.2625000
NODE_12158_length_797_cov_11.140401	254	334	0	34	80	0.4250000
NODE_12158_length_797_cov_11.140401	254	334	1	27	80	0.3375000
NODE_12158_length_797_cov_11.140401	254	334	2	19	80	0.2375000
NODE_12159_length_797_cov_8.681948	284	364	0	45	80	0.5625000
NODE_12159_length_797_cov_8.681948	284	364	2	35	80	0.4375000
NODE_12159_length_797_cov_8.681948	337	417	0	80	80	1.0000000
NODE_12160_length_797_cov_7.616046	314	397	0	83	83	1.0000000
NODE_12160_length_797_cov_7.616046	370	450	0	80	80	1.0000000
NODE_12161_length_797_cov_7.487106	275	347	3	5	72	0.0694444
NODE_12161_length_797_cov_7.487106	275	347	4	20	72	0.2777778
NODE_12161_length_797_cov_7.487106	275	347	5	47	72	0.6527778
NODE_12161_length_797_cov_7.487106	320	400	1	11	80	0.1375000
NODE_12161_length_797_cov_7.487106	320	400	2	17	80	0.2125000
NODE_12161_length_797_cov_7.487106	320	400	3	30	80	0.3750000
NODE_12161_length_797_cov_7.487106	320	400	5	22	80	0.2750000
NODE_12163_length_797_cov_6.068768	357	437	0	80	80	1.0000000
NODE_12163_length_797_cov_6.068768	410	490	0	80	80	1.0000000
NODE_12186_length_796_cov_20.862267	262	342	2	9	80	0.1125000
NODE_12186_length_796_cov_20.862267	262	342	4	19	80	0.2375000
NODE_12186_length_796_cov_20.862267	262	342	6	2	80	0.0250000
NODE_12186_length_796_cov_20.862267	262	342	8	50	80	0.6250000
NODE_12186_length_796_cov_20.862267	315	395	4	35	80	0.4375000
NODE_12186_length_796_cov_20.862267	315	395	6	16	80	0.2000000
NODE_12186_length_796_cov_20.862267	315	395	8	29	80	0.3625000
NODE_12187_length_796_cov_18.291248	283	363	0	44	80	0.5500000
NODE_12187_length_796_cov_18.291248	283	363	4	36	80	0.4500000
NODE_12187_length_796_cov_18.291248	336	416	2	24	80	0.3000000
NODE_12187_length_796_cov_18.291248	336	416	3	24	80	0.3000000
NODE_12187_length_796_cov_18.291248	336	416	4	32	80	0.4000000
NODE_12189_length_796_cov_7.880918	388	460	0	72	72	1.0000000
NODE_12189_length_796_cov_7.880918	442	513	0	71	71	1.0000000
NODE_12216_length_795_cov_31.729885	298	378	3	19	80	0.2375000
NODE_12216_length_795_cov_31.729885	298	378	4	61	80	0.7625000
NODE_12216_length_795_cov_31.729885	351	431	1	7	80	0.0875000
NODE_12216_length_795_cov_31.729885	351	431	3	65	80	0.8125000
NODE_12216_length_795_cov_31.729885	351	431	4	8	80	0.1000000
NODE_12217_length_795_cov_26.760057	367	447	0	31	80	0.3875000
NODE_12217_length_795_cov_26.760057	367	447	1	49	80	0.6125000
NODE_12217_length_795_cov_26.760057	420	500	1	42	80	0.5250000
NODE_12217_length_795_cov_26.760057	420	500	2	38	80	0.4750000
NODE_12218_length_795_cov_24.522989	352	432	3	38	80	0.4750000
NODE_12218_length_795_cov_24.522989	352	432	4	42	80	0.5250000
NODE_12218_length_795_cov_24.522989	405	485	0	6	80	0.0750000
NODE_12218_length_795_cov_24.522989	405	485	2	46	80	0.5750000
NODE_12218_length_795_cov_24.522989	405	485	3	28	80	0.3500000
NODE_12219_length_795_cov_22.747126	363	443	1	12	80	0.1500000
NODE_12219_length_795_cov_22.747126	363	443	3	68	80	0.8500000
NODE_12219_length_795_cov_22.747126	416	496	1	11	80	0.1375000
NODE_12219_length_795_cov_22.747126	416	496	3	69	80	0.8625000
NODE_12220_length_795_cov_9.439655	425	505	2	9	80	0.1125000
NODE_12220_length_795_cov_9.439655	425	505	3	71	80	0.8875000
NODE_12220_length_795_cov_9.439655	478	558	1	10	80	0.1250000
NODE_12220_length_795_cov_9.439655	478	558	3	70	80	0.8750000
NODE_12232_length_795_cov_3.359195	349	429	1	80	80	1.0000000
NODE_12232_length_795_cov_3.359195	402	482	0	17	80	0.2125000
NODE_12232_length_795_cov_3.359195	402	482	1	63	80	0.7875000
NODE_12256_length_794_cov_24.680576	326	406	4	25	80	0.3125000
NODE_12256_length_794_cov_24.680576	326	406	5	55	80	0.6875000
NODE_12256_length_794_cov_24.680576	379	459	2	30	80	0.3750000
NODE_12256_length_794_cov_24.680576	379	459	3	5	80	0.0625000
NODE_12256_length_794_cov_24.680576	379	459	4	43	80	0.5375000
NODE_12256_length_794_cov_24.680576	379	459	5	2	80	0.0250000
NODE_12257_length_794_cov_20.057554	153	233	2	33	80	0.4125000
NODE_12257_length_794_cov_20.057554	153	233	3	47	80	0.5875000
NODE_12257_length_794_cov_20.057554	206	286	3	80	80	1.0000000
NODE_12257_length_794_cov_20.057554	282	362	1	26	80	0.3250000
NODE_12257_length_794_cov_20.057554	282	362	2	41	80	0.5125000
NODE_12257_length_794_cov_20.057554	282	362	3	10	80	0.1250000
NODE_12257_length_794_cov_20.057554	282	362	4	3	80	0.0375000
NODE_12257_length_794_cov_20.057554	335	415	1	79	80	0.9875000
NODE_12257_length_794_cov_20.057554	335	415	2	1	80	0.0125000
NODE_12258_length_794_cov_16.602878	361	441	4	39	80	0.4875000
NODE_12258_length_794_cov_16.602878	361	441	5	24	80	0.3000000
NODE_12258_length_794_cov_16.602878	361	441	6	17	80	0.2125000
NODE_12258_length_794_cov_16.602878	414	494	2	10	80	0.1250000
NODE_12258_length_794_cov_16.602878	414	494	3	15	80	0.1875000
NODE_12258_length_794_cov_16.602878	414	494	4	24	80	0.3000000
NODE_12258_length_794_cov_16.602878	414	494	5	18	80	0.2250000
NODE_12258_length_794_cov_16.602878	414	494	6	13	80	0.1625000
NODE_12259_length_794_cov_16.362590	337	417	0	80	80	1.0000000
NODE_12259_length_794_cov_16.362590	390	470	0	80	80	1.0000000
NODE_12260_length_794_cov_14.444604	101	160	0	59	59	1.0000000
NODE_12260_length_794_cov_14.444604	409	489	0	80	80	1.0000000
NODE_12260_length_794_cov_14.444604	462	542	0	80	80	1.0000000
NODE_12261_length_794_cov_12.866187	442	522	1	54	80	0.6750000
NODE_12261_length_794_cov_12.866187	442	522	2	26	80	0.3250000
NODE_12261_length_794_cov_12.866187	495	575	1	32	80	0.4000000
NODE_12261_length_794_cov_12.866187	495	575	2	48	80	0.6000000
NODE_12262_length_794_cov_12.287770	235	315	0	10	80	0.1250000
NODE_12262_length_794_cov_12.287770	235	315	2	70	80	0.8750000
NODE_12262_length_794_cov_12.287770	288	368	0	31	80	0.3875000
NODE_12262_length_794_cov_12.287770	288	368	2	49	80	0.6125000
NODE_12263_length_794_cov_11.210072	315	395	0	80	80	1.0000000
NODE_12263_length_794_cov_11.210072	368	448	0	80	80	1.0000000
NODE_12264_length_794_cov_10.638849	325	406	0	81	81	1.0000000
NODE_12264_length_794_cov_10.638849	379	459	0	80	80	1.0000000
NODE_12266_length_794_cov_6.274820	412	492	1	53	80	0.6625000
NODE_12266_length_794_cov_6.274820	412	492	2	27	80	0.3375000
NODE_12266_length_794_cov_6.274820	465	545	1	37	80	0.4625000
NODE_12266_length_794_cov_6.274820	465	545	2	43	80	0.5375000
NODE_12271_length_794_cov_3.197122	273	338	2	18	65	0.2769231
NODE_12271_length_794_cov_3.197122	273	338	4	10	65	0.1538462
NODE_12271_length_794_cov_3.197122	273	338	5	37	65	0.5692308
NODE_12282_length_794_cov_1.848921	246	326	0	80	80	1.0000000
NODE_12282_length_794_cov_1.848921	299	379	0	80	80	1.0000000
NODE_12295_length_793_cov_29.878963	326	406	0	78	80	0.9750000
NODE_12295_length_793_cov_29.878963	326	406	1	2	80	0.0250000
NODE_12295_length_793_cov_29.878963	379	459	0	55	80	0.6875000
NODE_12295_length_793_cov_29.878963	379	459	2	25	80	0.3125000
NODE_12296_length_793_cov_25.981268	310	390	0	80	80	1.0000000
NODE_12296_length_793_cov_25.981268	363	445	0	82	82	1.0000000
NODE_12297_length_793_cov_24.840058	331	411	2	1	80	0.0125000
NODE_12297_length_793_cov_24.840058	331	411	3	63	80	0.7875000
NODE_12297_length_793_cov_24.840058	331	411	4	16	80	0.2000000
NODE_12297_length_793_cov_24.840058	384	464	0	20	80	0.2500000
NODE_12297_length_793_cov_24.840058	384	464	2	34	80	0.4250000
NODE_12297_length_793_cov_24.840058	384	464	3	10	80	0.1250000
NODE_12297_length_793_cov_24.840058	384	464	4	16	80	0.2000000
NODE_12298_length_793_cov_21.707493	398	478	4	23	80	0.2875000
NODE_12298_length_793_cov_21.707493	398	478	6	57	80	0.7125000
NODE_12298_length_793_cov_21.707493	451	531	2	48	80	0.6000000
NODE_12298_length_793_cov_21.707493	451	531	4	3	80	0.0375000
NODE_12298_length_793_cov_21.707493	451	531	6	29	80	0.3625000
NODE_12299_length_793_cov_8.358790	257	337	0	80	80	1.0000000
NODE_12299_length_793_cov_8.358790	310	390	0	80	80	1.0000000
NODE_12300_length_793_cov_8.236311	477	557	0	80	80	1.0000000
NODE_12300_length_793_cov_8.236311	530	610	0	80	80	1.0000000
NODE_12302_length_793_cov_6.763689	461	541	0	53	80	0.6625000
NODE_12302_length_793_cov_6.763689	461	541	1	27	80	0.3375000
NODE_12302_length_793_cov_6.763689	514	594	0	53	80	0.6625000
NODE_12302_length_793_cov_6.763689	514	594	2	27	80	0.3375000
NODE_12307_length_793_cov_4.465418	501	549	0	28	48	0.5833333
NODE_12307_length_793_cov_4.465418	501	549	2	20	48	0.4166667
NODE_12311_length_793_cov_4.138329	174	254	0	80	80	1.0000000
NODE_12311_length_793_cov_4.138329	227	307	0	80	80	1.0000000
NODE_12338_length_792_cov_40.025974	198	278	6	33	80	0.4125000
NODE_12338_length_792_cov_40.025974	198	278	7	12	80	0.1500000
NODE_12338_length_792_cov_40.025974	198	278	8	1	80	0.0125000
NODE_12338_length_792_cov_40.025974	198	278	9	9	80	0.1125000
NODE_12338_length_792_cov_40.025974	198	278	10	8	80	0.1000000
NODE_12338_length_792_cov_40.025974	198	278	11	17	80	0.2125000
NODE_12338_length_792_cov_40.025974	251	331	9	13	80	0.1625000
NODE_12338_length_792_cov_40.025974	251	331	10	8	80	0.1000000
NODE_12338_length_792_cov_40.025974	251	331	11	13	80	0.1625000
NODE_12338_length_792_cov_40.025974	251	331	13	12	80	0.1500000
NODE_12338_length_792_cov_40.025974	251	331	14	15	80	0.1875000
NODE_12338_length_792_cov_40.025974	251	331	15	6	80	0.0750000
NODE_12338_length_792_cov_40.025974	251	331	16	9	80	0.1125000
NODE_12338_length_792_cov_40.025974	251	331	17	4	80	0.0500000
NODE_12338_length_792_cov_40.025974	327	408	17	30	81	0.3703704
NODE_12338_length_792_cov_40.025974	327	408	18	20	81	0.2469136
NODE_12338_length_792_cov_40.025974	327	408	19	28	81	0.3456790
NODE_12338_length_792_cov_40.025974	327	408	20	3	81	0.0370370
NODE_12338_length_792_cov_40.025974	381	461	16	12	80	0.1500000
NODE_12338_length_792_cov_40.025974	381	461	17	28	80	0.3500000
NODE_12338_length_792_cov_40.025974	381	461	18	19	80	0.2375000
NODE_12338_length_792_cov_40.025974	381	461	19	21	80	0.2625000
NODE_12339_length_792_cov_31.176046	331	411	0	80	80	1.0000000
NODE_12339_length_792_cov_31.176046	384	463	0	79	79	1.0000000
NODE_12339_length_792_cov_31.176046	459	539	0	48	80	0.6000000
NODE_12339_length_792_cov_31.176046	459	539	2	32	80	0.4000000
NODE_12339_length_792_cov_31.176046	512	546	2	34	34	1.0000000
NODE_12340_length_792_cov_21.347763	303	383	0	25	80	0.3125000
NODE_12340_length_792_cov_21.347763	303	383	2	55	80	0.6875000
NODE_12340_length_792_cov_21.347763	356	436	0	78	80	0.9750000
NODE_12340_length_792_cov_21.347763	356	436	2	2	80	0.0250000
NODE_12341_length_792_cov_20.142857	361	441	1	55	80	0.6875000
NODE_12341_length_792_cov_20.142857	361	441	2	25	80	0.3125000
NODE_12341_length_792_cov_20.142857	414	494	1	2	80	0.0250000
NODE_12341_length_792_cov_20.142857	414	494	2	78	80	0.9750000
NODE_12342_length_792_cov_18.733045	320	400	2	60	80	0.7500000
NODE_12342_length_792_cov_18.733045	320	400	3	7	80	0.0875000
NODE_12342_length_792_cov_18.733045	320	400	4	13	80	0.1625000
NODE_12342_length_792_cov_18.733045	373	453	2	25	80	0.3125000
NODE_12342_length_792_cov_18.733045	373	453	3	14	80	0.1750000
NODE_12342_length_792_cov_18.733045	373	453	4	22	80	0.2750000
NODE_12342_length_792_cov_18.733045	373	453	8	1	80	0.0125000
NODE_12342_length_792_cov_18.733045	373	453	9	1	80	0.0125000
NODE_12342_length_792_cov_18.733045	373	453	10	17	80	0.2125000
NODE_12343_length_792_cov_12.024531	369	449	5	80	80	1.0000000
NODE_12343_length_792_cov_12.024531	422	502	0	4	80	0.0500000
NODE_12343_length_792_cov_12.024531	422	502	2	15	80	0.1875000
NODE_12343_length_792_cov_12.024531	422	502	4	4	80	0.0500000
NODE_12343_length_792_cov_12.024531	422	502	5	57	80	0.7125000
NODE_12372_length_791_cov_53.573699	287	359	0	32	72	0.4444444
NODE_12372_length_791_cov_53.573699	287	359	1	22	72	0.3055556
NODE_12372_length_791_cov_53.573699	287	359	3	18	72	0.2500000
NODE_12372_length_791_cov_53.573699	332	412	1	9	80	0.1125000
NODE_12372_length_791_cov_53.573699	332	412	3	71	80	0.8875000
NODE_12373_length_791_cov_40.416185	238	318	2	80	80	1.0000000
NODE_12373_length_791_cov_40.416185	291	371	0	8	80	0.1000000
NODE_12373_length_791_cov_40.416185	291	371	2	72	80	0.9000000
NODE_12374_length_791_cov_38.791908	309	389	5	8	80	0.1000000
NODE_12374_length_791_cov_38.791908	309	389	6	37	80	0.4625000
NODE_12374_length_791_cov_38.791908	309	389	7	35	80	0.4375000
NODE_12374_length_791_cov_38.791908	362	442	4	16	80	0.2000000
NODE_12374_length_791_cov_38.791908	362	442	5	38	80	0.4750000
NODE_12374_length_791_cov_38.791908	362	442	6	25	80	0.3125000
NODE_12374_length_791_cov_38.791908	362	442	7	1	80	0.0125000
NODE_12375_length_791_cov_23.468208	328	408	1	14	80	0.1750000
NODE_12375_length_791_cov_23.468208	328	408	2	3	80	0.0375000
NODE_12375_length_791_cov_23.468208	328	408	3	63	80	0.7875000
NODE_12375_length_791_cov_23.468208	381	461	0	35	80	0.4375000
NODE_12375_length_791_cov_23.468208	381	461	2	21	80	0.2625000
NODE_12375_length_791_cov_23.468208	381	461	3	24	80	0.3000000
NODE_12376_length_791_cov_20.897399	299	379	3	49	80	0.6125000
NODE_12376_length_791_cov_20.897399	299	379	4	29	80	0.3625000
NODE_12376_length_791_cov_20.897399	299	379	5	2	80	0.0250000
NODE_12376_length_791_cov_20.897399	352	432	4	44	80	0.5500000
NODE_12376_length_791_cov_20.897399	352	432	5	36	80	0.4500000
NODE_12377_length_791_cov_13.504335	339	419	2	13	80	0.1625000
NODE_12377_length_791_cov_13.504335	339	419	3	15	80	0.1875000
NODE_12377_length_791_cov_13.504335	339	419	4	23	80	0.2875000
NODE_12377_length_791_cov_13.504335	339	419	5	29	80	0.3625000
NODE_12377_length_791_cov_13.504335	392	472	0	51	80	0.6375000
NODE_12377_length_791_cov_13.504335	392	472	1	2	80	0.0250000
NODE_12377_length_791_cov_13.504335	392	472	2	13	80	0.1625000
NODE_12377_length_791_cov_13.504335	392	472	3	14	80	0.1750000
NODE_12379_length_791_cov_12.547688	338	418	1	66	80	0.8250000
NODE_12379_length_791_cov_12.547688	338	418	2	14	80	0.1750000
NODE_12379_length_791_cov_12.547688	391	471	1	73	80	0.9125000
NODE_12379_length_791_cov_12.547688	391	471	3	7	80	0.0875000
NODE_12380_length_791_cov_11.791908	440	520	1	14	80	0.1750000
NODE_12380_length_791_cov_11.791908	440	520	2	66	80	0.8250000
NODE_12380_length_791_cov_11.791908	493	573	0	1	80	0.0125000
NODE_12380_length_791_cov_11.791908	493	573	1	66	80	0.8250000
NODE_12380_length_791_cov_11.791908	493	573	2	13	80	0.1625000
NODE_12381_length_791_cov_11.011561	337	417	0	80	80	1.0000000
NODE_12381_length_791_cov_11.011561	390	470	0	80	80	1.0000000
NODE_12382_length_791_cov_8.757225	325	405	0	80	80	1.0000000
NODE_12382_length_791_cov_8.757225	378	458	0	80	80	1.0000000
NODE_12384_length_791_cov_8.125723	416	496	0	80	80	1.0000000
NODE_12384_length_791_cov_8.125723	469	549	0	80	80	1.0000000
NODE_12409_length_790_cov_48.021708	526	606	2	10	80	0.1250000
NODE_12409_length_790_cov_48.021708	526	606	4	70	80	0.8750000
NODE_12409_length_790_cov_48.021708	579	659	0	27	80	0.3375000
NODE_12409_length_790_cov_48.021708	579	659	1	25	80	0.3125000
NODE_12409_length_790_cov_48.021708	579	659	2	11	80	0.1375000
NODE_12409_length_790_cov_48.021708	579	659	4	17	80	0.2125000
NODE_12410_length_790_cov_44.151954	343	423	4	48	80	0.6000000
NODE_12410_length_790_cov_44.151954	343	423	5	32	80	0.4000000
NODE_12410_length_790_cov_44.151954	396	438	4	42	42	1.0000000
NODE_12410_length_790_cov_44.151954	696	776	5	9	80	0.1125000
NODE_12410_length_790_cov_44.151954	696	776	6	10	80	0.1250000
NODE_12410_length_790_cov_44.151954	696	776	7	2	80	0.0250000
NODE_12410_length_790_cov_44.151954	696	776	8	11	80	0.1375000
NODE_12410_length_790_cov_44.151954	696	776	9	1	80	0.0125000
NODE_12410_length_790_cov_44.151954	696	776	10	3	80	0.0375000
NODE_12410_length_790_cov_44.151954	696	776	11	16	80	0.2000000
NODE_12410_length_790_cov_44.151954	696	776	13	22	80	0.2750000
NODE_12410_length_790_cov_44.151954	696	776	14	6	80	0.0750000
NODE_12411_length_790_cov_27.144718	291	371	1	51	80	0.6375000
NODE_12411_length_790_cov_27.144718	291	371	2	29	80	0.3625000
NODE_12411_length_790_cov_27.144718	344	424	2	80	80	1.0000000
NODE_12412_length_790_cov_16.973951	232	312	0	32	80	0.4000000
NODE_12412_length_790_cov_16.973951	232	312	1	48	80	0.6000000
NODE_12412_length_790_cov_16.973951	285	365	1	80	80	1.0000000
NODE_12413_length_790_cov_13.374819	204	284	1	40	80	0.5000000
NODE_12413_length_790_cov_13.374819	204	284	2	13	80	0.1625000
NODE_12413_length_790_cov_13.374819	204	284	4	16	80	0.2000000
NODE_12413_length_790_cov_13.374819	204	284	5	11	80	0.1375000
NODE_12413_length_790_cov_13.374819	257	337	4	32	80	0.4000000
NODE_12413_length_790_cov_13.374819	257	337	5	48	80	0.6000000
NODE_12415_length_790_cov_10.613603	302	382	3	11	80	0.1375000
NODE_12415_length_790_cov_10.613603	302	382	4	39	80	0.4875000
NODE_12415_length_790_cov_10.613603	302	382	5	30	80	0.3750000
NODE_12415_length_790_cov_10.613603	355	435	3	36	80	0.4500000
NODE_12415_length_790_cov_10.613603	355	435	4	31	80	0.3875000
NODE_12415_length_790_cov_10.613603	355	435	5	13	80	0.1625000
NODE_12418_length_790_cov_5.493488	271	351	0	80	80	1.0000000
NODE_12418_length_790_cov_5.493488	324	404	0	80	80	1.0000000
NODE_12434_length_790_cov_1.463097	313	376	2	20	63	0.3174603
NODE_12434_length_790_cov_1.463097	313	376	3	43	63	0.6825397
NODE_12452_length_789_cov_39.123188	226	306	1	12	80	0.1500000
NODE_12452_length_789_cov_39.123188	226	306	2	2	80	0.0250000
NODE_12452_length_789_cov_39.123188	226	306	3	8	80	0.1000000
NODE_12452_length_789_cov_39.123188	226	306	5	10	80	0.1250000
NODE_12452_length_789_cov_39.123188	226	306	6	25	80	0.3125000
NODE_12452_length_789_cov_39.123188	226	306	7	23	80	0.2875000
NODE_12452_length_789_cov_39.123188	279	359	4	11	80	0.1375000
NODE_12452_length_789_cov_39.123188	279	359	6	36	80	0.4500000
NODE_12452_length_789_cov_39.123188	279	359	7	33	80	0.4125000
NODE_12453_length_789_cov_37.205797	423	503	3	24	80	0.3000000
NODE_12453_length_789_cov_37.205797	423	503	4	12	80	0.1500000
NODE_12453_length_789_cov_37.205797	423	503	5	1	80	0.0125000
NODE_12453_length_789_cov_37.205797	423	503	7	4	80	0.0500000
NODE_12453_length_789_cov_37.205797	423	503	8	2	80	0.0250000
NODE_12453_length_789_cov_37.205797	423	503	9	15	80	0.1875000
NODE_12453_length_789_cov_37.205797	423	503	11	5	80	0.0625000
NODE_12453_length_789_cov_37.205797	423	503	12	2	80	0.0250000
NODE_12453_length_789_cov_37.205797	423	503	13	15	80	0.1875000
NODE_12453_length_789_cov_37.205797	476	556	9	5	80	0.0625000
NODE_12453_length_789_cov_37.205797	476	556	11	5	80	0.0625000
NODE_12453_length_789_cov_37.205797	476	556	12	2	80	0.0250000
NODE_12453_length_789_cov_37.205797	476	556	13	19	80	0.2375000
NODE_12453_length_789_cov_37.205797	476	556	14	22	80	0.2750000
NODE_12453_length_789_cov_37.205797	476	556	15	26	80	0.3250000
NODE_12453_length_789_cov_37.205797	476	556	16	1	80	0.0125000
NODE_12454_length_789_cov_31.311594	223	303	3	5	80	0.0625000
NODE_12454_length_789_cov_31.311594	223	303	4	6	80	0.0750000
NODE_12454_length_789_cov_31.311594	223	303	6	69	80	0.8625000
NODE_12454_length_789_cov_31.311594	276	356	2	3	80	0.0375000
NODE_12454_length_789_cov_31.311594	276	356	4	2	80	0.0250000
NODE_12454_length_789_cov_31.311594	276	356	5	18	80	0.2250000
NODE_12454_length_789_cov_31.311594	276	356	6	57	80	0.7125000
NODE_12455_length_789_cov_30.536232	306	386	2	28	80	0.3500000
NODE_12455_length_789_cov_30.536232	306	386	3	50	80	0.6250000
NODE_12455_length_789_cov_30.536232	306	386	4	2	80	0.0250000
NODE_12455_length_789_cov_30.536232	359	439	2	21	80	0.2625000
NODE_12455_length_789_cov_30.536232	359	439	3	57	80	0.7125000
NODE_12455_length_789_cov_30.536232	359	439	4	2	80	0.0250000
NODE_12456_length_789_cov_24.886957	343	423	0	80	80	1.0000000
NODE_12456_length_789_cov_24.886957	396	476	0	80	80	1.0000000
NODE_12457_length_789_cov_23.539130	357	437	1	80	80	1.0000000
NODE_12457_length_789_cov_23.539130	410	490	0	19	80	0.2375000
NODE_12457_length_789_cov_23.539130	410	490	1	61	80	0.7625000
NODE_12458_length_789_cov_16.169565	392	472	0	42	80	0.5250000
NODE_12458_length_789_cov_16.169565	392	472	1	1	80	0.0125000
NODE_12458_length_789_cov_16.169565	392	472	2	37	80	0.4625000
NODE_12458_length_789_cov_16.169565	445	525	0	4	80	0.0500000
NODE_12458_length_789_cov_16.169565	445	525	2	76	80	0.9500000
NODE_12459_length_789_cov_15.175362	242	322	2	57	80	0.7125000
NODE_12459_length_789_cov_15.175362	242	322	3	23	80	0.2875000
NODE_12459_length_789_cov_15.175362	295	375	1	49	80	0.6125000
NODE_12459_length_789_cov_15.175362	295	375	2	31	80	0.3875000
NODE_12459_length_789_cov_15.175362	371	451	0	36	80	0.4500000
NODE_12459_length_789_cov_15.175362	371	451	1	44	80	0.5500000
NODE_12459_length_789_cov_15.175362	424	504	0	80	80	1.0000000
NODE_12460_length_789_cov_7.276812	306	386	0	80	80	1.0000000
NODE_12460_length_789_cov_7.276812	359	439	0	80	80	1.0000000
NODE_12482_length_788_cov_43.091437	335	415	1	4	80	0.0500000
NODE_12482_length_788_cov_43.091437	335	415	2	4	80	0.0500000
NODE_12482_length_788_cov_43.091437	335	415	4	18	80	0.2250000
NODE_12482_length_788_cov_43.091437	335	415	5	14	80	0.1750000
NODE_12482_length_788_cov_43.091437	335	415	6	40	80	0.5000000
NODE_12482_length_788_cov_43.091437	388	460	5	14	72	0.1944444
NODE_12482_length_788_cov_43.091437	388	460	6	20	72	0.2777778
NODE_12482_length_788_cov_43.091437	388	460	7	38	72	0.5277778
NODE_12483_length_788_cov_38.914369	345	425	2	1	80	0.0125000
NODE_12483_length_788_cov_38.914369	345	425	4	43	80	0.5375000
NODE_12483_length_788_cov_38.914369	345	425	5	3	80	0.0375000
NODE_12483_length_788_cov_38.914369	345	425	6	33	80	0.4125000
NODE_12483_length_788_cov_38.914369	398	478	4	54	80	0.6750000
NODE_12483_length_788_cov_38.914369	398	478	5	3	80	0.0375000
NODE_12483_length_788_cov_38.914369	398	478	6	23	80	0.2875000
NODE_12484_length_788_cov_36.148041	320	400	2	11	80	0.1375000
NODE_12484_length_788_cov_36.148041	320	400	3	24	80	0.3000000
NODE_12484_length_788_cov_36.148041	320	400	5	45	80	0.5625000
NODE_12484_length_788_cov_36.148041	373	453	3	3	80	0.0375000
NODE_12484_length_788_cov_36.148041	373	453	5	77	80	0.9625000
NODE_12485_length_788_cov_35.460087	346	426	5	9	80	0.1125000
NODE_12485_length_788_cov_35.460087	346	426	6	71	80	0.8875000
NODE_12485_length_788_cov_35.460087	399	479	2	48	80	0.6000000
NODE_12485_length_788_cov_35.460087	399	479	4	5	80	0.0625000
NODE_12485_length_788_cov_35.460087	399	479	5	6	80	0.0750000
NODE_12485_length_788_cov_35.460087	399	479	6	21	80	0.2625000
NODE_12486_length_788_cov_30.785196	278	358	2	13	80	0.1625000
NODE_12486_length_788_cov_30.785196	278	358	4	10	80	0.1250000
NODE_12486_length_788_cov_30.785196	278	358	6	13	80	0.1625000
NODE_12486_length_788_cov_30.785196	278	358	7	14	80	0.1750000
NODE_12486_length_788_cov_30.785196	278	358	8	30	80	0.3750000
NODE_12486_length_788_cov_30.785196	331	411	5	2	80	0.0250000
NODE_12486_length_788_cov_30.785196	331	411	6	7	80	0.0875000
NODE_12486_length_788_cov_30.785196	331	411	7	1	80	0.0125000
NODE_12486_length_788_cov_30.785196	331	411	8	57	80	0.7125000
NODE_12486_length_788_cov_30.785196	331	411	9	13	80	0.1625000
NODE_12488_length_788_cov_20.867925	300	380	3	59	80	0.7375000
NODE_12488_length_788_cov_20.867925	300	380	4	2	80	0.0250000
NODE_12488_length_788_cov_20.867925	300	380	6	5	80	0.0625000
NODE_12488_length_788_cov_20.867925	300	380	7	14	80	0.1750000
NODE_12488_length_788_cov_20.867925	353	430	1	16	77	0.2077922
NODE_12488_length_788_cov_20.867925	353	430	2	2	77	0.0259740
NODE_12488_length_788_cov_20.867925	353	430	3	39	77	0.5064935
NODE_12488_length_788_cov_20.867925	353	430	4	20	77	0.2597403
NODE_12489_length_788_cov_20.821480	322	402	2	37	80	0.4625000
NODE_12489_length_788_cov_20.821480	322	402	3	43	80	0.5375000
NODE_12489_length_788_cov_20.821480	375	455	1	20	80	0.2500000
NODE_12489_length_788_cov_20.821480	375	455	2	60	80	0.7500000
NODE_12490_length_788_cov_15.570392	342	422	1	16	80	0.2000000
NODE_12490_length_788_cov_15.570392	342	422	2	2	80	0.0250000
NODE_12490_length_788_cov_15.570392	342	422	3	10	80	0.1250000
NODE_12490_length_788_cov_15.570392	342	422	4	52	80	0.6500000
NODE_12490_length_788_cov_15.570392	395	475	3	48	80	0.6000000
NODE_12490_length_788_cov_15.570392	395	475	4	32	80	0.4000000
NODE_12491_length_788_cov_12.235123	241	321	0	66	80	0.8250000
NODE_12491_length_788_cov_12.235123	241	321	2	14	80	0.1750000
NODE_12491_length_788_cov_12.235123	294	374	0	13	80	0.1625000
NODE_12491_length_788_cov_12.235123	294	374	2	67	80	0.8375000
NODE_12492_length_788_cov_10.509434	405	480	0	3	75	0.0400000
NODE_12492_length_788_cov_10.509434	405	480	2	72	75	0.9600000
NODE_12493_length_788_cov_9.737300	310	390	0	80	80	1.0000000
NODE_12493_length_788_cov_9.737300	363	443	0	80	80	1.0000000
NODE_12494_length_788_cov_8.872279	280	360	0	80	80	1.0000000
NODE_12494_length_788_cov_8.872279	333	413	0	80	80	1.0000000
NODE_12516_length_787_cov_34.683140	274	335	2	61	61	1.0000000
NODE_12516_length_787_cov_34.683140	319	380	0	9	61	0.1475410
NODE_12516_length_787_cov_34.683140	319	380	2	52	61	0.8524590
NODE_12517_length_787_cov_28.039244	252	329	0	5	77	0.0649351
NODE_12517_length_787_cov_28.039244	252	329	1	29	77	0.3766234
NODE_12517_length_787_cov_28.039244	252	329	2	8	77	0.1038961
NODE_12517_length_787_cov_28.039244	252	329	4	35	77	0.4545455
NODE_12517_length_787_cov_28.039244	302	370	4	68	68	1.0000000
NODE_12518_length_787_cov_25.422965	351	431	0	80	80	1.0000000
NODE_12518_length_787_cov_25.422965	404	484	0	80	80	1.0000000
NODE_12519_length_787_cov_24.857558	319	399	7	20	80	0.2500000
NODE_12519_length_787_cov_24.857558	319	399	8	60	80	0.7500000
NODE_12519_length_787_cov_24.857558	372	452	2	10	80	0.1250000
NODE_12519_length_787_cov_24.857558	372	452	4	24	80	0.3000000
NODE_12519_length_787_cov_24.857558	372	452	8	46	80	0.5750000
NODE_12520_length_787_cov_21.357558	291	371	4	35	80	0.4375000
NODE_12520_length_787_cov_21.357558	291	371	5	45	80	0.5625000
NODE_12520_length_787_cov_21.357558	344	424	4	3	80	0.0375000
NODE_12520_length_787_cov_21.357558	344	424	5	56	80	0.7000000
NODE_12520_length_787_cov_21.357558	344	424	6	20	80	0.2500000
NODE_12520_length_787_cov_21.357558	344	424	7	1	80	0.0125000
NODE_12521_length_787_cov_17.360465	396	476	2	14	80	0.1750000
NODE_12521_length_787_cov_17.360465	396	476	4	66	80	0.8250000
NODE_12521_length_787_cov_17.360465	449	529	2	67	80	0.8375000
NODE_12521_length_787_cov_17.360465	449	529	4	13	80	0.1625000
NODE_12522_length_787_cov_14.677326	178	258	0	80	80	1.0000000
NODE_12522_length_787_cov_14.677326	231	311	0	80	80	1.0000000
NODE_12523_length_787_cov_12.959302	331	411	3	80	80	1.0000000
NODE_12523_length_787_cov_12.959302	384	464	0	12	80	0.1500000
NODE_12523_length_787_cov_12.959302	384	464	3	68	80	0.8500000
NODE_12524_length_787_cov_12.748547	426	506	0	80	80	1.0000000
NODE_12524_length_787_cov_12.748547	479	559	0	80	80	1.0000000
NODE_12525_length_787_cov_12.369186	338	418	0	80	80	1.0000000
NODE_12525_length_787_cov_12.369186	391	471	0	80	80	1.0000000
NODE_12526_length_787_cov_9.213663	376	456	1	52	80	0.6500000
NODE_12526_length_787_cov_9.213663	376	456	2	28	80	0.3500000
NODE_12527_length_787_cov_8.857558	344	424	1	80	80	1.0000000
NODE_12527_length_787_cov_8.857558	397	477	1	34	80	0.4250000
NODE_12527_length_787_cov_8.857558	397	477	2	3	80	0.0375000
NODE_12527_length_787_cov_8.857558	397	477	3	16	80	0.2000000
NODE_12527_length_787_cov_8.857558	397	477	4	27	80	0.3375000
NODE_12529_length_787_cov_8.186047	508	552	0	44	44	1.0000000
NODE_12541_length_787_cov_2.188953	505	552	0	47	47	1.0000000
NODE_12562_length_786_cov_36.441048	431	511	3	80	80	1.0000000
NODE_12562_length_786_cov_36.441048	484	564	1	21	80	0.2625000
NODE_12562_length_786_cov_36.441048	484	564	2	30	80	0.3750000
NODE_12562_length_786_cov_36.441048	484	564	3	29	80	0.3625000
NODE_12563_length_786_cov_23.771470	235	315	0	59	80	0.7375000
NODE_12563_length_786_cov_23.771470	235	315	1	9	80	0.1125000
NODE_12563_length_786_cov_23.771470	235	315	2	12	80	0.1500000
NODE_12563_length_786_cov_23.771470	288	368	0	18	80	0.2250000
NODE_12563_length_786_cov_23.771470	288	368	1	12	80	0.1500000
NODE_12563_length_786_cov_23.771470	288	368	2	50	80	0.6250000
NODE_12564_length_786_cov_23.333333	361	436	2	39	75	0.5200000
NODE_12564_length_786_cov_23.333333	361	436	3	2	75	0.0266667
NODE_12564_length_786_cov_23.333333	361	436	5	3	75	0.0400000
NODE_12564_length_786_cov_23.333333	361	436	6	6	75	0.0800000
NODE_12564_length_786_cov_23.333333	361	436	7	3	75	0.0400000
NODE_12564_length_786_cov_23.333333	361	436	8	3	75	0.0400000
NODE_12564_length_786_cov_23.333333	361	436	10	1	75	0.0133333
NODE_12564_length_786_cov_23.333333	361	436	11	2	75	0.0266667
NODE_12564_length_786_cov_23.333333	361	436	12	10	75	0.1333333
NODE_12564_length_786_cov_23.333333	361	436	13	6	75	0.0800000
NODE_12564_length_786_cov_23.333333	362	436	2	38	74	0.5135135
NODE_12564_length_786_cov_23.333333	362	436	3	2	74	0.0270270
NODE_12564_length_786_cov_23.333333	362	436	5	3	74	0.0405405
NODE_12564_length_786_cov_23.333333	362	436	6	6	74	0.0810811
NODE_12564_length_786_cov_23.333333	362	436	7	3	74	0.0405405
NODE_12564_length_786_cov_23.333333	362	436	8	3	74	0.0405405
NODE_12564_length_786_cov_23.333333	362	436	10	1	74	0.0135135
NODE_12564_length_786_cov_23.333333	362	436	11	2	74	0.0270270
NODE_12564_length_786_cov_23.333333	362	436	12	10	74	0.1351351
NODE_12564_length_786_cov_23.333333	362	436	13	6	74	0.0810811
NODE_12564_length_786_cov_23.333333	375	436	2	25	61	0.4098361
NODE_12564_length_786_cov_23.333333	375	436	3	2	61	0.0327869
NODE_12564_length_786_cov_23.333333	375	436	5	3	61	0.0491803
NODE_12564_length_786_cov_23.333333	375	436	6	6	61	0.0983607
NODE_12564_length_786_cov_23.333333	375	436	7	3	61	0.0491803
NODE_12564_length_786_cov_23.333333	375	436	8	3	61	0.0491803
NODE_12564_length_786_cov_23.333333	375	436	10	1	61	0.0163934
NODE_12564_length_786_cov_23.333333	375	436	11	2	61	0.0327869
NODE_12564_length_786_cov_23.333333	375	436	12	10	61	0.1639344
NODE_12564_length_786_cov_23.333333	375	436	13	6	61	0.0983607
NODE_12564_length_786_cov_23.333333	414	489	8	3	75	0.0400000
NODE_12564_length_786_cov_23.333333	414	489	10	1	75	0.0133333
NODE_12564_length_786_cov_23.333333	414	489	11	40	75	0.5333334
NODE_12564_length_786_cov_23.333333	414	489	12	25	75	0.3333333
NODE_12564_length_786_cov_23.333333	414	489	13	6	75	0.0800000
NODE_12564_length_786_cov_23.333333	414	489	8	3	75	0.0400000
NODE_12564_length_786_cov_23.333333	414	489	10	1	75	0.0133333
NODE_12564_length_786_cov_23.333333	414	489	11	40	75	0.5333334
NODE_12564_length_786_cov_23.333333	414	489	12	25	75	0.3333333
NODE_12564_length_786_cov_23.333333	414	489	13	6	75	0.0800000
NODE_12564_length_786_cov_23.333333	414	489	8	3	75	0.0400000
NODE_12564_length_786_cov_23.333333	414	489	10	1	75	0.0133333
NODE_12564_length_786_cov_23.333333	414	489	11	40	75	0.5333334
NODE_12564_length_786_cov_23.333333	414	489	12	25	75	0.3333333
NODE_12564_length_786_cov_23.333333	414	489	13	6	75	0.0800000
NODE_12564_length_786_cov_23.333333	490	564	11	4	74	0.0540541
NODE_12564_length_786_cov_23.333333	490	564	12	10	74	0.1351351
NODE_12564_length_786_cov_23.333333	490	564	13	8	74	0.1081081
NODE_12564_length_786_cov_23.333333	490	564	15	32	74	0.4324324
NODE_12564_length_786_cov_23.333333	490	564	16	18	74	0.2432432
NODE_12564_length_786_cov_23.333333	490	564	17	2	74	0.0270270
NODE_12565_length_786_cov_19.279476	310	375	0	65	65	1.0000000
NODE_12565_length_786_cov_19.279476	371	441	0	70	70	1.0000000
NODE_12565_length_786_cov_19.279476	371	451	0	80	80	1.0000000
NODE_12565_length_786_cov_19.279476	424	491	0	67	67	1.0000000
NODE_12566_length_786_cov_18.652111	251	331	0	18	80	0.2250000
NODE_12566_length_786_cov_18.652111	251	331	2	11	80	0.1375000
NODE_12566_length_786_cov_18.652111	251	331	4	51	80	0.6375000
NODE_12566_length_786_cov_18.652111	304	384	4	80	80	1.0000000
NODE_12567_length_786_cov_16.704512	319	399	0	80	80	1.0000000
NODE_12567_length_786_cov_16.704512	372	452	0	80	80	1.0000000
NODE_12568_length_786_cov_16.254731	378	458	2	57	80	0.7125000
NODE_12568_length_786_cov_16.254731	378	458	4	23	80	0.2875000
NODE_12568_length_786_cov_16.254731	431	511	2	51	80	0.6375000
NODE_12568_length_786_cov_16.254731	431	511	4	29	80	0.3625000
NODE_12571_length_786_cov_10.053857	381	461	2	38	80	0.4750000
NODE_12571_length_786_cov_10.053857	381	461	4	2	80	0.0250000
NODE_12571_length_786_cov_10.053857	381	461	6	31	80	0.3875000
NODE_12571_length_786_cov_10.053857	381	461	7	9	80	0.1125000
NODE_12571_length_786_cov_10.053857	434	514	5	2	80	0.0250000
NODE_12571_length_786_cov_10.053857	434	514	6	64	80	0.8000000
NODE_12571_length_786_cov_10.053857	434	514	7	14	80	0.1750000
NODE_12572_length_786_cov_7.455604	400	473	0	73	73	1.0000000
NODE_12572_length_786_cov_7.455604	453	533	0	80	80	1.0000000
NODE_12573_length_786_cov_7.119360	276	356	0	66	80	0.8250000
NODE_12573_length_786_cov_7.119360	276	356	1	1	80	0.0125000
NODE_12573_length_786_cov_7.119360	276	356	2	13	80	0.1625000
NODE_12573_length_786_cov_7.119360	329	409	0	13	80	0.1625000
NODE_12573_length_786_cov_7.119360	329	409	1	1	80	0.0125000
NODE_12573_length_786_cov_7.119360	329	409	2	66	80	0.8250000
NODE_12575_length_786_cov_6.771470	382	462	4	44	80	0.5500000
NODE_12575_length_786_cov_6.771470	382	462	5	36	80	0.4500000
NODE_12575_length_786_cov_6.771470	435	515	1	30	80	0.3750000
NODE_12575_length_786_cov_6.771470	435	515	5	50	80	0.6250000
NODE_12603_length_785_cov_83.972303	315	395	9	13	80	0.1625000
NODE_12603_length_785_cov_83.972303	315	395	10	17	80	0.2125000
NODE_12603_length_785_cov_83.972303	315	395	11	24	80	0.3000000
NODE_12603_length_785_cov_83.972303	315	395	12	26	80	0.3250000
NODE_12603_length_785_cov_83.972303	368	448	5	1	80	0.0125000
NODE_12603_length_785_cov_83.972303	368	448	6	12	80	0.1500000
NODE_12603_length_785_cov_83.972303	368	448	7	7	80	0.0875000
NODE_12603_length_785_cov_83.972303	368	448	8	22	80	0.2750000
NODE_12603_length_785_cov_83.972303	368	448	9	21	80	0.2625000
NODE_12603_length_785_cov_83.972303	368	448	10	12	80	0.1500000
NODE_12603_length_785_cov_83.972303	368	448	11	5	80	0.0625000
NODE_12604_length_785_cov_33.911079	477	557	4	8	80	0.1000000
NODE_12604_length_785_cov_33.911079	477	557	5	72	80	0.9000000
NODE_12604_length_785_cov_33.911079	530	610	1	9	80	0.1125000
NODE_12604_length_785_cov_33.911079	530	610	2	7	80	0.0875000
NODE_12604_length_785_cov_33.911079	530	610	3	31	80	0.3875000
NODE_12604_length_785_cov_33.911079	530	610	4	14	80	0.1750000
NODE_12604_length_785_cov_33.911079	530	610	5	19	80	0.2375000
NODE_12605_length_785_cov_21.174927	265	299	4	34	34	1.0000000
NODE_12605_length_785_cov_21.174927	295	375	3	17	80	0.2125000
NODE_12605_length_785_cov_21.174927	295	375	4	63	80	0.7875000
NODE_12605_length_785_cov_21.174927	348	428	0	17	80	0.2125000
NODE_12605_length_785_cov_21.174927	348	428	1	11	80	0.1375000
NODE_12605_length_785_cov_21.174927	348	428	3	42	80	0.5250000
NODE_12605_length_785_cov_21.174927	348	428	4	10	80	0.1250000
NODE_12606_length_785_cov_18.612245	291	371	1	80	80	1.0000000
NODE_12606_length_785_cov_18.612245	344	424	0	27	80	0.3375000
NODE_12606_length_785_cov_18.612245	344	424	1	53	80	0.6625000
NODE_12606_length_785_cov_18.612245	684	705	0	21	21	1.0000000
NODE_12607_length_785_cov_9.893586	153	233	1	35	80	0.4375000
NODE_12607_length_785_cov_9.893586	153	233	2	45	80	0.5625000
NODE_12607_length_785_cov_9.893586	206	286	2	80	80	1.0000000
NODE_12645_length_784_cov_203.604380	5	85	11	4	80	0.0500000
NODE_12645_length_784_cov_203.604380	5	85	13	1	80	0.0125000
NODE_12645_length_784_cov_203.604380	5	85	14	1	80	0.0125000
NODE_12645_length_784_cov_203.604380	5	85	15	3	80	0.0375000
NODE_12645_length_784_cov_203.604380	5	85	16	1	80	0.0125000
NODE_12645_length_784_cov_203.604380	5	85	18	1	80	0.0125000
NODE_12645_length_784_cov_203.604380	5	85	21	1	80	0.0125000
NODE_12645_length_784_cov_203.604380	5	85	22	1	80	0.0125000
NODE_12645_length_784_cov_203.604380	5	85	24	3	80	0.0375000
NODE_12645_length_784_cov_203.604380	5	85	26	8	80	0.1000000
NODE_12645_length_784_cov_203.604380	5	85	27	1	80	0.0125000
NODE_12645_length_784_cov_203.604380	5	85	29	11	80	0.1375000
NODE_12645_length_784_cov_203.604380	5	85	30	8	80	0.1000000
NODE_12645_length_784_cov_203.604380	5	85	32	1	80	0.0125000
NODE_12645_length_784_cov_203.604380	5	85	34	1	80	0.0125000
NODE_12645_length_784_cov_203.604380	5	85	35	2	80	0.0250000
NODE_12645_length_784_cov_203.604380	5	85	36	1	80	0.0125000
NODE_12645_length_784_cov_203.604380	5	85	38	4	80	0.0500000
NODE_12645_length_784_cov_203.604380	5	85	39	5	80	0.0625000
NODE_12645_length_784_cov_203.604380	5	85	40	2	80	0.0250000
NODE_12645_length_784_cov_203.604380	5	85	41	8	80	0.1000000
NODE_12645_length_784_cov_203.604380	5	85	44	2	80	0.0250000
NODE_12645_length_784_cov_203.604380	5	85	45	2	80	0.0250000
NODE_12645_length_784_cov_203.604380	5	85	46	2	80	0.0250000
NODE_12645_length_784_cov_203.604380	5	85	48	1	80	0.0125000
NODE_12645_length_784_cov_203.604380	5	85	50	3	80	0.0375000
NODE_12645_length_784_cov_203.604380	5	85	52	1	80	0.0125000
NODE_12645_length_784_cov_203.604380	5	85	53	1	80	0.0125000
NODE_12645_length_784_cov_203.604380	58	138	39	5	80	0.0625000
NODE_12645_length_784_cov_203.604380	58	138	40	2	80	0.0250000
NODE_12645_length_784_cov_203.604380	58	138	41	8	80	0.1000000
NODE_12645_length_784_cov_203.604380	58	138	44	2	80	0.0250000
NODE_12645_length_784_cov_203.604380	58	138	45	2	80	0.0250000
NODE_12645_length_784_cov_203.604380	58	138	46	2	80	0.0250000
NODE_12645_length_784_cov_203.604380	58	138	48	1	80	0.0125000
NODE_12645_length_784_cov_203.604380	58	138	50	3	80	0.0375000
NODE_12645_length_784_cov_203.604380	58	138	52	1	80	0.0125000
NODE_12645_length_784_cov_203.604380	58	138	53	10	80	0.1250000
NODE_12645_length_784_cov_203.604380	58	138	54	5	80	0.0625000
NODE_12645_length_784_cov_203.604380	58	138	55	19	80	0.2375000
NODE_12645_length_784_cov_203.604380	58	138	58	2	80	0.0250000
NODE_12645_length_784_cov_203.604380	58	138	59	4	80	0.0500000
NODE_12645_length_784_cov_203.604380	58	138	60	4	80	0.0500000
NODE_12645_length_784_cov_203.604380	58	138	61	4	80	0.0500000
NODE_12645_length_784_cov_203.604380	58	138	62	4	80	0.0500000
NODE_12645_length_784_cov_203.604380	58	138	63	2	80	0.0250000
NODE_12646_length_784_cov_45.210219	49	129	0	10	80	0.1250000
NODE_12646_length_784_cov_45.210219	49	129	1	70	80	0.8750000
NODE_12646_length_784_cov_45.210219	102	182	0	30	80	0.3750000
NODE_12646_length_784_cov_45.210219	102	182	1	50	80	0.6250000
NODE_12646_length_784_cov_45.210219	218	298	4	48	80	0.6000000
NODE_12646_length_784_cov_45.210219	218	298	5	32	80	0.4000000
NODE_12646_length_784_cov_45.210219	271	351	3	4	80	0.0500000
NODE_12646_length_784_cov_45.210219	271	351	4	24	80	0.3000000
NODE_12646_length_784_cov_45.210219	271	351	5	52	80	0.6500000
NODE_12646_length_784_cov_45.210219	347	427	0	11	80	0.1375000
NODE_12646_length_784_cov_45.210219	347	427	1	52	80	0.6500000
NODE_12646_length_784_cov_45.210219	347	427	2	10	80	0.1250000
NODE_12646_length_784_cov_45.210219	347	427	3	7	80	0.0875000
NODE_12646_length_784_cov_45.210219	347	427	0	11	80	0.1375000
NODE_12646_length_784_cov_45.210219	347	427	1	52	80	0.6500000
NODE_12646_length_784_cov_45.210219	347	427	2	10	80	0.1250000
NODE_12646_length_784_cov_45.210219	347	427	3	7	80	0.0875000
NODE_12646_length_784_cov_45.210219	347	427	0	11	80	0.1375000
NODE_12646_length_784_cov_45.210219	347	427	1	52	80	0.6500000
NODE_12646_length_784_cov_45.210219	347	427	2	10	80	0.1250000
NODE_12646_length_784_cov_45.210219	347	427	3	7	80	0.0875000
NODE_12646_length_784_cov_45.210219	400	447	0	31	47	0.6595744
NODE_12646_length_784_cov_45.210219	400	447	1	16	47	0.3404255
NODE_12646_length_784_cov_45.210219	400	480	0	64	80	0.8000000
NODE_12646_length_784_cov_45.210219	400	480	1	16	80	0.2000000
NODE_12646_length_784_cov_45.210219	400	455	0	39	55	0.7090909
NODE_12646_length_784_cov_45.210219	400	455	1	16	55	0.2909091
NODE_12647_length_784_cov_33.543066	405	485	5	4	80	0.0500000
NODE_12647_length_784_cov_33.543066	405	485	6	50	80	0.6250000
NODE_12647_length_784_cov_33.543066	405	485	7	26	80	0.3250000
NODE_12647_length_784_cov_33.543066	458	538	1	36	80	0.4500000
NODE_12647_length_784_cov_33.543066	458	538	3	10	80	0.1250000
NODE_12647_length_784_cov_33.543066	458	538	5	11	80	0.1375000
NODE_12647_length_784_cov_33.543066	458	538	6	23	80	0.2875000
NODE_12648_length_784_cov_21.762044	318	398	0	80	80	1.0000000
NODE_12648_length_784_cov_21.762044	371	451	0	80	80	1.0000000
NODE_12649_length_784_cov_20.583942	286	366	1	21	80	0.2625000
NODE_12649_length_784_cov_20.583942	286	366	3	59	80	0.7375000
NODE_12649_length_784_cov_20.583942	339	419	1	74	80	0.9250000
NODE_12649_length_784_cov_20.583942	339	419	3	6	80	0.0750000
NODE_12649_length_784_cov_20.583942	415	495	0	54	80	0.6750000
NODE_12649_length_784_cov_20.583942	415	495	1	26	80	0.3250000
NODE_12649_length_784_cov_20.583942	468	548	0	22	80	0.2750000
NODE_12649_length_784_cov_20.583942	468	548	1	58	80	0.7250000
NODE_12650_length_784_cov_19.448175	217	297	0	2	80	0.0250000
NODE_12650_length_784_cov_19.448175	217	297	2	78	80	0.9750000
NODE_12650_length_784_cov_19.448175	270	350	0	50	80	0.6250000
NODE_12650_length_784_cov_19.448175	270	350	2	30	80	0.3750000
NODE_12652_length_784_cov_12.480292	297	377	0	80	80	1.0000000
NODE_12652_length_784_cov_12.480292	350	430	0	80	80	1.0000000
NODE_12653_length_784_cov_9.296350	250	330	1	63	80	0.7875000
NODE_12653_length_784_cov_9.296350	250	330	3	17	80	0.2125000
NODE_12653_length_784_cov_9.296350	303	383	0	12	80	0.1500000
NODE_12653_length_784_cov_9.296350	303	383	1	68	80	0.8500000
NODE_12653_length_784_cov_9.296350	379	459	0	67	80	0.8375000
NODE_12653_length_784_cov_9.296350	379	459	1	13	80	0.1625000
NODE_12653_length_784_cov_9.296350	432	512	0	14	80	0.1750000
NODE_12653_length_784_cov_9.296350	432	512	1	38	80	0.4750000
NODE_12653_length_784_cov_9.296350	432	512	2	28	80	0.3500000
NODE_12654_length_784_cov_6.316788	274	354	0	61	80	0.7625000
NODE_12654_length_784_cov_6.316788	274	354	2	19	80	0.2375000
NODE_12654_length_784_cov_6.316788	327	407	0	8	80	0.1000000
NODE_12654_length_784_cov_6.316788	327	407	2	72	80	0.9000000
NODE_12688_length_783_cov_41.849415	459	539	2	33	80	0.4125000
NODE_12688_length_783_cov_41.849415	459	539	4	47	80	0.5875000
NODE_12688_length_783_cov_41.849415	512	592	0	18	80	0.2250000
NODE_12688_length_783_cov_41.849415	512	592	1	17	80	0.2125000
NODE_12688_length_783_cov_41.849415	512	592	2	45	80	0.5625000
NODE_12689_length_783_cov_39.881579	230	310	1	80	80	1.0000000
NODE_12689_length_783_cov_39.881579	283	363	1	41	80	0.5125000
NODE_12689_length_783_cov_39.881579	283	363	2	39	80	0.4875000
NODE_12689_length_783_cov_39.881579	359	439	1	71	80	0.8875000
NODE_12689_length_783_cov_39.881579	359	439	2	9	80	0.1125000
NODE_12689_length_783_cov_39.881579	412	492	0	19	80	0.2375000
NODE_12689_length_783_cov_39.881579	412	492	1	61	80	0.7625000
NODE_12690_length_783_cov_35.967836	229	309	0	71	80	0.8875000
NODE_12690_length_783_cov_35.967836	229	309	1	9	80	0.1125000
NODE_12690_length_783_cov_35.967836	282	362	0	18	80	0.2250000
NODE_12690_length_783_cov_35.967836	282	362	1	62	80	0.7750000
NODE_12691_length_783_cov_28.203216	292	372	0	74	80	0.9250000
NODE_12691_length_783_cov_28.203216	292	372	1	6	80	0.0750000
NODE_12691_length_783_cov_28.203216	345	425	0	21	80	0.2625000
NODE_12691_length_783_cov_28.203216	345	425	1	59	80	0.7375000
NODE_12692_length_783_cov_16.695906	393	473	0	35	80	0.4375000
NODE_12692_length_783_cov_16.695906	393	473	1	45	80	0.5625000
NODE_12692_length_783_cov_16.695906	446	526	1	80	80	1.0000000
NODE_12693_length_783_cov_15.656433	418	498	6	29	80	0.3625000
NODE_12693_length_783_cov_15.656433	418	498	7	34	80	0.4250000
NODE_12693_length_783_cov_15.656433	418	498	8	17	80	0.2125000
NODE_12693_length_783_cov_15.656433	471	551	1	4	80	0.0500000
NODE_12693_length_783_cov_15.656433	471	551	2	1	80	0.0125000
NODE_12693_length_783_cov_15.656433	471	551	3	3	80	0.0375000
NODE_12693_length_783_cov_15.656433	471	551	4	4	80	0.0500000
NODE_12693_length_783_cov_15.656433	471	551	6	35	80	0.4375000
NODE_12693_length_783_cov_15.656433	471	551	7	19	80	0.2375000
NODE_12693_length_783_cov_15.656433	471	551	8	14	80	0.1750000
NODE_12694_length_783_cov_14.904971	321	401	4	5	80	0.0625000
NODE_12694_length_783_cov_14.904971	321	401	6	34	80	0.4250000
NODE_12694_length_783_cov_14.904971	321	401	7	41	80	0.5125000
NODE_12694_length_783_cov_14.904971	374	454	1	34	80	0.4250000
NODE_12694_length_783_cov_14.904971	374	454	2	1	80	0.0125000
NODE_12694_length_783_cov_14.904971	374	454	4	6	80	0.0750000
NODE_12694_length_783_cov_14.904971	374	454	6	39	80	0.4875000
NODE_12728_length_782_cov_22.461201	347	427	2	35	80	0.4375000
NODE_12728_length_782_cov_22.461201	347	427	4	45	80	0.5625000
NODE_12728_length_782_cov_22.461201	400	480	0	52	80	0.6500000
NODE_12728_length_782_cov_22.461201	400	480	2	28	80	0.3500000
NODE_12729_length_782_cov_19.163982	306	386	0	80	80	1.0000000
NODE_12729_length_782_cov_19.163982	382	462	0	80	80	1.0000000
NODE_12729_length_782_cov_19.163982	435	515	0	80	80	1.0000000
NODE_12730_length_782_cov_19.090776	295	375	1	1	80	0.0125000
NODE_12730_length_782_cov_19.090776	295	375	2	51	80	0.6375000
NODE_12730_length_782_cov_19.090776	295	375	3	28	80	0.3500000
NODE_12730_length_782_cov_19.090776	348	428	2	76	80	0.9500000
NODE_12730_length_782_cov_19.090776	348	428	3	4	80	0.0500000
NODE_12731_length_782_cov_13.509517	323	403	0	80	80	1.0000000
NODE_12731_length_782_cov_13.509517	376	456	0	80	80	1.0000000
NODE_12732_length_782_cov_11.364568	367	447	0	80	80	1.0000000
NODE_12732_length_782_cov_11.364568	420	500	0	80	80	1.0000000
NODE_12735_length_782_cov_7.976574	245	325	0	80	80	1.0000000
NODE_12735_length_782_cov_7.976574	298	378	0	80	80	1.0000000
NODE_12737_length_782_cov_5.500732	384	464	0	80	80	1.0000000
NODE_12737_length_782_cov_5.500732	437	517	0	80	80	1.0000000
NODE_12739_length_782_cov_4.434846	309	389	0	80	80	1.0000000
NODE_12739_length_782_cov_4.434846	362	442	0	37	80	0.4625000
NODE_12739_length_782_cov_4.434846	362	442	1	11	80	0.1375000
NODE_12739_length_782_cov_4.434846	362	442	3	32	80	0.4000000
NODE_12740_length_782_cov_3.352855	177	196	0	19	19	1.0000000
NODE_12741_length_782_cov_3.231332	160	240	0	80	80	1.0000000
NODE_12741_length_782_cov_3.231332	213	298	0	85	85	1.0000000
NODE_12765_length_781_cov_34.247801	174	254	0	7	80	0.0875000
NODE_12765_length_781_cov_34.247801	174	254	2	49	80	0.6125000
NODE_12765_length_781_cov_34.247801	174	254	6	24	80	0.3000000
NODE_12765_length_781_cov_34.247801	227	307	2	3	80	0.0375000
NODE_12765_length_781_cov_34.247801	227	307	4	3	80	0.0375000
NODE_12765_length_781_cov_34.247801	227	307	5	4	80	0.0500000
NODE_12765_length_781_cov_34.247801	227	307	6	70	80	0.8750000
NODE_12766_length_781_cov_27.530792	490	570	8	7	80	0.0875000
NODE_12766_length_781_cov_27.530792	490	570	9	1	80	0.0125000
NODE_12766_length_781_cov_27.530792	490	570	10	29	80	0.3625000
NODE_12766_length_781_cov_27.530792	490	570	11	43	80	0.5375000
NODE_12766_length_781_cov_27.530792	543	623	6	18	80	0.2250000
NODE_12766_length_781_cov_27.530792	543	623	8	15	80	0.1875000
NODE_12766_length_781_cov_27.530792	543	623	10	26	80	0.3250000
NODE_12766_length_781_cov_27.530792	543	623	11	21	80	0.2625000
NODE_12766_length_781_cov_27.530792	619	699	1	2	80	0.0250000
NODE_12766_length_781_cov_27.530792	619	699	3	29	80	0.3625000
NODE_12766_length_781_cov_27.530792	619	699	4	17	80	0.2125000
NODE_12766_length_781_cov_27.530792	619	699	5	27	80	0.3375000
NODE_12766_length_781_cov_27.530792	619	699	6	5	80	0.0625000
NODE_12766_length_781_cov_27.530792	672	752	0	42	80	0.5250000
NODE_12766_length_781_cov_27.530792	672	752	1	13	80	0.1625000
NODE_12766_length_781_cov_27.530792	672	752	3	25	80	0.3125000
NODE_12767_length_781_cov_22.768328	427	507	0	21	80	0.2625000
NODE_12767_length_781_cov_22.768328	427	507	1	8	80	0.1000000
NODE_12767_length_781_cov_22.768328	427	507	2	16	80	0.2000000
NODE_12767_length_781_cov_22.768328	427	507	4	21	80	0.2625000
NODE_12767_length_781_cov_22.768328	427	507	6	14	80	0.1750000
NODE_12767_length_781_cov_22.768328	480	560	4	29	80	0.3625000
NODE_12767_length_781_cov_22.768328	480	560	6	51	80	0.6375000
NODE_12768_length_781_cov_17.894428	411	491	1	34	80	0.4250000
NODE_12768_length_781_cov_17.894428	411	491	2	46	80	0.5750000
NODE_12768_length_781_cov_17.894428	464	544	1	15	80	0.1875000
NODE_12768_length_781_cov_17.894428	464	544	2	65	80	0.8125000
NODE_12769_length_781_cov_14.922287	486	565	1	27	79	0.3417721
NODE_12769_length_781_cov_14.922287	486	565	2	31	79	0.3924051
NODE_12769_length_781_cov_14.922287	486	565	3	21	79	0.2658228
NODE_12769_length_781_cov_14.922287	538	618	0	2	80	0.0250000
NODE_12769_length_781_cov_14.922287	538	618	2	72	80	0.9000000
NODE_12769_length_781_cov_14.922287	538	618	3	6	80	0.0750000
NODE_12770_length_781_cov_12.529326	318	398	0	80	80	1.0000000
NODE_12770_length_781_cov_12.529326	371	451	0	80	80	1.0000000
NODE_12771_length_781_cov_10.303519	444	524	7	8	80	0.1000000
NODE_12771_length_781_cov_10.303519	444	524	8	46	80	0.5750000
NODE_12771_length_781_cov_10.303519	444	524	10	26	80	0.3250000
NODE_12772_length_781_cov_9.851906	374	454	0	41	80	0.5125000
NODE_12772_length_781_cov_9.851906	374	454	2	39	80	0.4875000
NODE_12772_length_781_cov_9.851906	427	507	0	80	80	1.0000000
NODE_12775_length_781_cov_8.557185	113	194	1	38	81	0.4691358
NODE_12775_length_781_cov_8.557185	113	194	2	7	81	0.0864198
NODE_12775_length_781_cov_8.557185	113	194	3	36	81	0.4444444
NODE_12775_length_781_cov_8.557185	166	239	2	42	73	0.5753425
NODE_12775_length_781_cov_8.557185	166	239	3	31	73	0.4246575
NODE_12778_length_781_cov_4.734604	30	110	1	27	80	0.3375000
NODE_12778_length_781_cov_4.734604	30	110	2	53	80	0.6625000
NODE_12778_length_781_cov_4.734604	83	163	2	80	80	1.0000000
NODE_12780_length_781_cov_4.077713	269	349	0	40	80	0.5000000
NODE_12780_length_781_cov_4.077713	269	349	1	40	80	0.5000000
NODE_12780_length_781_cov_4.077713	322	402	0	80	80	1.0000000
NODE_12812_length_780_cov_37.693098	165	245	0	68	80	0.8500000
NODE_12812_length_780_cov_37.693098	165	245	1	12	80	0.1500000
NODE_12812_length_780_cov_37.693098	218	298	0	15	80	0.1875000
NODE_12812_length_780_cov_37.693098	218	298	1	27	80	0.3375000
NODE_12812_length_780_cov_37.693098	218	298	2	3	80	0.0375000
NODE_12812_length_780_cov_37.693098	218	298	3	35	80	0.4375000
NODE_12813_length_780_cov_22.132159	407	487	1	8	80	0.1000000
NODE_12813_length_780_cov_22.132159	407	487	2	72	80	0.9000000
NODE_12813_length_780_cov_22.132159	460	540	1	13	80	0.1625000
NODE_12813_length_780_cov_22.132159	460	540	2	67	80	0.8375000
NODE_12814_length_780_cov_21.831131	299	379	1	20	80	0.2500000
NODE_12814_length_780_cov_21.831131	299	379	2	25	80	0.3125000
NODE_12814_length_780_cov_21.831131	299	379	3	30	80	0.3750000
NODE_12814_length_780_cov_21.831131	299	379	5	5	80	0.0625000
NODE_12814_length_780_cov_21.831131	352	432	3	22	80	0.2750000
NODE_12814_length_780_cov_21.831131	352	432	5	58	80	0.7250000
NODE_12815_length_780_cov_16.722467	165	245	0	80	80	1.0000000
NODE_12815_length_780_cov_16.722467	218	298	0	80	80	1.0000000
NODE_12816_length_780_cov_13.189427	150	254	3	100	104	0.9615384
NODE_12816_length_780_cov_13.189427	150	254	6	4	104	0.0384615
NODE_12816_length_780_cov_13.189427	227	307	3	76	80	0.9500000
NODE_12816_length_780_cov_13.189427	227	307	6	4	80	0.0500000
NODE_12817_length_780_cov_12.910426	276	356	2	10	80	0.1250000
NODE_12817_length_780_cov_12.910426	276	356	3	70	80	0.8750000
NODE_12817_length_780_cov_12.910426	329	409	1	4	80	0.0500000
NODE_12817_length_780_cov_12.910426	329	409	3	76	80	0.9500000
NODE_12818_length_780_cov_8.455213	141	221	3	11	80	0.1375000
NODE_12818_length_780_cov_8.455213	141	221	4	8	80	0.1000000
NODE_12818_length_780_cov_8.455213	141	221	5	61	80	0.7625000
NODE_12818_length_780_cov_8.455213	194	274	3	7	80	0.0875000
NODE_12818_length_780_cov_8.455213	194	274	4	2	80	0.0250000
NODE_12818_length_780_cov_8.455213	194	274	5	71	80	0.8875000
NODE_12848_length_779_cov_51.022059	8	43	9	4	35	0.1142857
NODE_12848_length_779_cov_51.022059	8	43	10	28	35	0.8000000
NODE_12848_length_779_cov_51.022059	8	43	11	3	35	0.0857143
NODE_12848_length_779_cov_51.022059	53	96	12	4	43	0.0930233
NODE_12848_length_779_cov_51.022059	53	96	14	39	43	0.9069768
NODE_12848_length_779_cov_51.022059	97	177	6	12	80	0.1500000
NODE_12848_length_779_cov_51.022059	97	177	7	22	80	0.2750000
NODE_12848_length_779_cov_51.022059	97	177	8	29	80	0.3625000
NODE_12848_length_779_cov_51.022059	97	177	10	4	80	0.0500000
NODE_12848_length_779_cov_51.022059	97	177	12	2	80	0.0250000
NODE_12848_length_779_cov_51.022059	97	177	13	11	80	0.1375000
NODE_12848_length_779_cov_51.022059	150	230	4	24	80	0.3000000
NODE_12848_length_779_cov_51.022059	150	230	5	1	80	0.0125000
NODE_12848_length_779_cov_51.022059	150	230	6	16	80	0.2000000
NODE_12848_length_779_cov_51.022059	150	230	7	24	80	0.3000000
NODE_12848_length_779_cov_51.022059	150	230	8	15	80	0.1875000
NODE_12849_length_779_cov_23.682353	362	442	0	80	80	1.0000000
NODE_12849_length_779_cov_23.682353	415	495	0	80	80	1.0000000
NODE_12850_length_779_cov_15.994118	320	400	2	80	80	1.0000000
NODE_12850_length_779_cov_15.994118	373	453	0	40	80	0.5000000
NODE_12850_length_779_cov_15.994118	373	453	2	40	80	0.5000000
NODE_12851_length_779_cov_14.386765	258	320	5	1	62	0.0161290
NODE_12851_length_779_cov_14.386765	258	320	6	18	62	0.2903226
NODE_12851_length_779_cov_14.386765	258	320	8	33	62	0.5322581
NODE_12851_length_779_cov_14.386765	258	320	9	10	62	0.1612903
NODE_12851_length_779_cov_14.386765	293	368	4	7	75	0.0933333
NODE_12851_length_779_cov_14.386765	293	368	6	34	75	0.4533333
NODE_12851_length_779_cov_14.386765	293	368	8	34	75	0.4533333
NODE_12851_length_779_cov_14.386765	369	443	0	15	74	0.2027027
NODE_12851_length_779_cov_14.386765	369	443	1	23	74	0.3108108
NODE_12851_length_779_cov_14.386765	369	443	2	17	74	0.2297297
NODE_12851_length_779_cov_14.386765	369	443	4	19	74	0.2567568
NODE_12852_length_779_cov_11.861765	180	263	0	58	83	0.6987952
NODE_12852_length_779_cov_11.861765	180	263	1	25	83	0.3012048
NODE_12852_length_779_cov_11.861765	236	316	0	2	80	0.0250000
NODE_12852_length_779_cov_11.861765	236	316	1	55	80	0.6875000
NODE_12852_length_779_cov_11.861765	236	316	2	9	80	0.1125000
NODE_12852_length_779_cov_11.861765	236	316	3	14	80	0.1750000
NODE_12852_length_779_cov_11.861765	312	392	2	40	80	0.5000000
NODE_12852_length_779_cov_11.861765	312	392	3	40	80	0.5000000
NODE_12852_length_779_cov_11.861765	365	445	1	2	80	0.0250000
NODE_12852_length_779_cov_11.861765	365	445	2	78	80	0.9750000
NODE_12853_length_779_cov_11.735294	285	365	0	49	80	0.6125000
NODE_12853_length_779_cov_11.735294	285	365	1	31	80	0.3875000
NODE_12853_length_779_cov_11.735294	338	418	1	31	80	0.3875000
NODE_12853_length_779_cov_11.735294	338	418	2	49	80	0.6125000
NODE_12854_length_779_cov_7.211765	333	413	1	10	80	0.1250000
NODE_12854_length_779_cov_7.211765	333	413	2	70	80	0.8750000
NODE_12854_length_779_cov_7.211765	386	466	0	42	80	0.5250000
NODE_12854_length_779_cov_7.211765	386	466	1	21	80	0.2625000
NODE_12854_length_779_cov_7.211765	386	466	2	17	80	0.2125000
NODE_12857_length_779_cov_5.611765	271	351	0	80	80	1.0000000
NODE_12857_length_779_cov_5.611765	324	404	0	80	80	1.0000000
NODE_12859_length_779_cov_4.695588	216	296	0	80	80	1.0000000
NODE_12859_length_779_cov_4.695588	269	349	0	80	80	1.0000000
NODE_12863_length_779_cov_2.329412	615	672	6	1	57	0.0175439
NODE_12863_length_779_cov_2.329412	615	672	8	47	57	0.8245614
NODE_12863_length_779_cov_2.329412	615	672	10	9	57	0.1578947
NODE_12883_length_778_cov_21.615611	325	405	0	80	80	1.0000000
NODE_12883_length_778_cov_21.615611	378	458	0	80	80	1.0000000
NODE_12884_length_778_cov_19.549337	348	428	3	52	80	0.6500000
NODE_12884_length_778_cov_19.549337	348	428	4	28	80	0.3500000
NODE_12884_length_778_cov_19.549337	401	481	3	80	80	1.0000000
NODE_12885_length_778_cov_15.403535	312	392	3	4	80	0.0500000
NODE_12885_length_778_cov_15.403535	312	392	4	63	80	0.7875000
NODE_12885_length_778_cov_15.403535	312	392	5	5	80	0.0625000
NODE_12885_length_778_cov_15.403535	312	392	6	8	80	0.1000000
NODE_12885_length_778_cov_15.403535	365	445	3	3	80	0.0375000
NODE_12885_length_778_cov_15.403535	365	445	4	41	80	0.5125000
NODE_12885_length_778_cov_15.403535	365	445	5	11	80	0.1375000
NODE_12885_length_778_cov_15.403535	365	445	6	25	80	0.3125000
NODE_12886_length_778_cov_14.614138	101	181	1	20	80	0.2500000
NODE_12886_length_778_cov_14.614138	101	181	2	27	80	0.3375000
NODE_12886_length_778_cov_14.614138	101	181	3	24	80	0.3000000
NODE_12886_length_778_cov_14.614138	101	181	4	9	80	0.1125000
NODE_12886_length_778_cov_14.614138	154	234	3	18	80	0.2250000
NODE_12886_length_778_cov_14.614138	154	234	4	62	80	0.7750000
NODE_12887_length_778_cov_13.368189	256	336	1	71	80	0.8875000
NODE_12887_length_778_cov_13.368189	256	336	2	9	80	0.1125000
NODE_12887_length_778_cov_13.368189	309	389	1	18	80	0.2250000
NODE_12887_length_778_cov_13.368189	309	389	2	15	80	0.1875000
NODE_12887_length_778_cov_13.368189	309	389	3	47	80	0.5875000
NODE_12891_length_778_cov_6.307806	349	429	0	80	80	1.0000000
NODE_12891_length_778_cov_6.307806	402	482	0	80	80	1.0000000
NODE_12893_length_778_cov_5.985272	385	465	0	28	80	0.3500000
NODE_12893_length_778_cov_5.985272	385	465	1	13	80	0.1625000
NODE_12893_length_778_cov_5.985272	385	465	2	39	80	0.4875000
NODE_12893_length_778_cov_5.985272	438	518	2	80	80	1.0000000
NODE_12928_length_777_cov_25.504425	323	403	0	80	80	1.0000000
NODE_12928_length_777_cov_25.504425	376	456	0	80	80	1.0000000
NODE_12929_length_777_cov_25.410029	346	426	2	6	80	0.0750000
NODE_12929_length_777_cov_25.410029	346	426	3	47	80	0.5875000
NODE_12929_length_777_cov_25.410029	346	426	5	19	80	0.2375000
NODE_12929_length_777_cov_25.410029	346	426	6	8	80	0.1000000
NODE_12929_length_777_cov_25.410029	399	479	4	12	80	0.1500000
NODE_12929_length_777_cov_25.410029	399	479	5	41	80	0.5125000
NODE_12929_length_777_cov_25.410029	399	479	6	27	80	0.3375000
NODE_12930_length_777_cov_25.333333	97	177	0	5	80	0.0625000
NODE_12930_length_777_cov_25.333333	97	177	2	75	80	0.9375000
NODE_12930_length_777_cov_25.333333	150	230	0	12	80	0.1500000
NODE_12930_length_777_cov_25.333333	150	230	1	46	80	0.5750000
NODE_12930_length_777_cov_25.333333	150	230	2	22	80	0.2750000
NODE_12931_length_777_cov_21.600295	408	485	0	42	77	0.5454546
NODE_12931_length_777_cov_21.600295	408	485	1	35	77	0.4545455
NODE_12931_length_777_cov_21.600295	458	538	0	32	80	0.4000000
NODE_12931_length_777_cov_21.600295	458	538	2	17	80	0.2125000
NODE_12931_length_777_cov_21.600295	458	538	3	1	80	0.0125000
NODE_12931_length_777_cov_21.600295	458	538	4	30	80	0.3750000
NODE_12932_length_777_cov_19.561947	343	423	4	45	80	0.5625000
NODE_12932_length_777_cov_19.561947	343	423	5	15	80	0.1875000
NODE_12932_length_777_cov_19.561947	343	423	6	20	80	0.2500000
NODE_12932_length_777_cov_19.561947	396	476	4	56	80	0.7000000
NODE_12932_length_777_cov_19.561947	396	476	5	24	80	0.3000000
NODE_12933_length_777_cov_16.961652	264	344	0	80	80	1.0000000
NODE_12933_length_777_cov_16.961652	317	397	0	80	80	1.0000000
NODE_12934_length_777_cov_16.081121	299	379	3	4	80	0.0500000
NODE_12934_length_777_cov_16.081121	299	379	4	76	80	0.9500000
NODE_12934_length_777_cov_16.081121	352	432	2	11	80	0.1375000
NODE_12934_length_777_cov_16.081121	352	432	4	69	80	0.8625000
NODE_12935_length_777_cov_13.827434	380	460	1	29	80	0.3625000
NODE_12935_length_777_cov_13.827434	380	460	3	6	80	0.0750000
NODE_12935_length_777_cov_13.827434	380	460	4	45	80	0.5625000
NODE_12935_length_777_cov_13.827434	433	513	1	36	80	0.4500000
NODE_12935_length_777_cov_13.827434	433	513	2	1	80	0.0125000
NODE_12935_length_777_cov_13.827434	433	513	3	43	80	0.5375000
NODE_12936_length_777_cov_12.497050	413	493	0	80	80	1.0000000
NODE_12936_length_777_cov_12.497050	466	546	0	80	80	1.0000000
NODE_12937_length_777_cov_10.787611	213	286	3	48	73	0.6575342
NODE_12937_length_777_cov_10.787611	213	286	4	25	73	0.3424658
NODE_12938_length_777_cov_8.530973	362	422	3	60	60	1.0000000
NODE_12939_length_777_cov_7.634218	79	159	2	80	80	1.0000000
NODE_12939_length_777_cov_7.634218	132	212	0	4	80	0.0500000
NODE_12939_length_777_cov_7.634218	132	212	1	22	80	0.2750000
NODE_12939_length_777_cov_7.634218	132	212	2	54	80	0.6750000
NODE_12940_length_777_cov_6.963127	256	336	0	80	80	1.0000000
NODE_12940_length_777_cov_6.963127	309	389	0	80	80	1.0000000
NODE_12941_length_777_cov_6.417404	565	638	0	73	73	1.0000000
NODE_12942_length_777_cov_5.868732	443	523	0	80	80	1.0000000
NODE_12942_length_777_cov_5.868732	496	576	0	80	80	1.0000000
NODE_12971_length_776_cov_81.002954	237	317	0	62	80	0.7750000
NODE_12971_length_776_cov_81.002954	237	317	1	2	80	0.0250000
NODE_12971_length_776_cov_81.002954	237	317	2	3	80	0.0375000
NODE_12971_length_776_cov_81.002954	237	317	4	1	80	0.0125000
NODE_12971_length_776_cov_81.002954	237	317	5	1	80	0.0125000
NODE_12971_length_776_cov_81.002954	237	317	6	3	80	0.0375000
NODE_12971_length_776_cov_81.002954	237	317	7	2	80	0.0250000
NODE_12971_length_776_cov_81.002954	237	317	8	1	80	0.0125000
NODE_12971_length_776_cov_81.002954	237	317	13	4	80	0.0500000
NODE_12971_length_776_cov_81.002954	237	317	14	1	80	0.0125000
NODE_12971_length_776_cov_81.002954	290	370	0	80	80	1.0000000
NODE_12972_length_776_cov_40.502216	345	425	4	8	80	0.1000000
NODE_12972_length_776_cov_40.502216	345	425	5	72	80	0.9000000
NODE_12972_length_776_cov_40.502216	398	478	2	7	80	0.0875000
NODE_12972_length_776_cov_40.502216	398	478	3	12	80	0.1500000
NODE_12972_length_776_cov_40.502216	398	478	4	38	80	0.4750000
NODE_12972_length_776_cov_40.502216	398	478	5	23	80	0.2875000
NODE_12973_length_776_cov_34.921713	204	284	2	24	80	0.3000000
NODE_12973_length_776_cov_34.921713	204	284	4	24	80	0.3000000
NODE_12973_length_776_cov_34.921713	204	284	5	11	80	0.1375000
NODE_12973_length_776_cov_34.921713	204	284	6	21	80	0.2625000
NODE_12973_length_776_cov_34.921713	257	337	2	54	80	0.6750000
NODE_12973_length_776_cov_34.921713	257	337	3	23	80	0.2875000
NODE_12973_length_776_cov_34.921713	257	337	4	3	80	0.0375000
NODE_12974_length_776_cov_29.998523	177	257	1	26	80	0.3250000
NODE_12974_length_776_cov_29.998523	177	257	2	32	80	0.4000000
NODE_12974_length_776_cov_29.998523	177	257	3	7	80	0.0875000
NODE_12974_length_776_cov_29.998523	177	257	4	15	80	0.1875000
NODE_12974_length_776_cov_29.998523	230	310	2	12	80	0.1500000
NODE_12974_length_776_cov_29.998523	230	310	4	68	80	0.8500000
NODE_12975_length_776_cov_25.683900	417	497	2	35	80	0.4375000
NODE_12975_length_776_cov_25.683900	417	497	3	45	80	0.5625000
NODE_12975_length_776_cov_25.683900	470	550	1	2	80	0.0250000
NODE_12975_length_776_cov_25.683900	470	550	2	14	80	0.1750000
NODE_12975_length_776_cov_25.683900	470	550	3	64	80	0.8000000
NODE_12976_length_776_cov_22.276219	367	447	0	6	80	0.0750000
NODE_12976_length_776_cov_22.276219	367	447	2	42	80	0.5250000
NODE_12976_length_776_cov_22.276219	367	447	3	32	80	0.4000000
NODE_12976_length_776_cov_22.276219	420	500	1	50	80	0.6250000
NODE_12976_length_776_cov_22.276219	420	500	3	30	80	0.3750000
NODE_12977_length_776_cov_19.574594	242	322	2	33	80	0.4125000
NODE_12977_length_776_cov_19.574594	242	322	3	47	80	0.5875000
NODE_12977_length_776_cov_19.574594	295	375	1	5	80	0.0625000
NODE_12977_length_776_cov_19.574594	295	375	2	49	80	0.6125000
NODE_12977_length_776_cov_19.574594	295	375	3	26	80	0.3250000
NODE_12978_length_776_cov_18.262925	384	464	2	1	80	0.0125000
NODE_12978_length_776_cov_18.262925	384	464	4	27	80	0.3375000
NODE_12978_length_776_cov_18.262925	384	464	5	52	80	0.6500000
NODE_12978_length_776_cov_18.262925	437	517	1	37	80	0.4625000
NODE_12978_length_776_cov_18.262925	437	517	2	17	80	0.2125000
NODE_12978_length_776_cov_18.262925	437	517	4	18	80	0.2250000
NODE_12978_length_776_cov_18.262925	437	517	5	8	80	0.1000000
NODE_12979_length_776_cov_16.023634	334	414	2	48	80	0.6000000
NODE_12979_length_776_cov_16.023634	334	414	3	32	80	0.4000000
NODE_12979_length_776_cov_16.023634	387	467	1	7	80	0.0875000
NODE_12979_length_776_cov_16.023634	387	467	2	9	80	0.1125000
NODE_12979_length_776_cov_16.023634	387	467	3	64	80	0.8000000
NODE_12980_length_776_cov_15.841950	282	362	0	80	80	1.0000000
NODE_12980_length_776_cov_15.841950	335	415	0	80	80	1.0000000
NODE_12981_length_776_cov_14.131462	240	320	0	8	80	0.1000000
NODE_12981_length_776_cov_14.131462	240	320	1	72	80	0.9000000
NODE_12981_length_776_cov_14.131462	293	373	0	8	80	0.1000000
NODE_12981_length_776_cov_14.131462	293	373	1	72	80	0.9000000
NODE_12981_length_776_cov_14.131462	369	449	1	38	80	0.4750000
NODE_12981_length_776_cov_14.131462	369	449	2	42	80	0.5250000
NODE_12981_length_776_cov_14.131462	422	502	1	51	80	0.6375000
NODE_12981_length_776_cov_14.131462	422	502	2	29	80	0.3625000
NODE_12983_length_776_cov_13.890694	302	382	3	2	80	0.0250000
NODE_12983_length_776_cov_13.890694	302	382	4	28	80	0.3500000
NODE_12983_length_776_cov_13.890694	302	382	5	50	80	0.6250000
NODE_12983_length_776_cov_13.890694	355	435	0	21	80	0.2625000
NODE_12983_length_776_cov_13.890694	355	435	1	19	80	0.2375000
NODE_12983_length_776_cov_13.890694	355	435	3	15	80	0.1875000
NODE_12983_length_776_cov_13.890694	355	435	4	25	80	0.3125000
NODE_12984_length_776_cov_12.097489	488	568	1	21	80	0.2625000
NODE_12984_length_776_cov_12.097489	488	568	2	59	80	0.7375000
NODE_12984_length_776_cov_12.097489	541	621	0	33	80	0.4125000
NODE_12984_length_776_cov_12.097489	541	621	1	41	80	0.5125000
NODE_12984_length_776_cov_12.097489	541	621	2	6	80	0.0750000
NODE_12985_length_776_cov_11.923191	422	498	0	23	76	0.3026316
NODE_12985_length_776_cov_11.923191	422	498	2	53	76	0.6973684
NODE_12985_length_776_cov_11.923191	475	551	2	76	76	1.0000000
NODE_12986_length_776_cov_11.163959	312	392	5	48	80	0.6000000
NODE_12986_length_776_cov_11.163959	312	392	6	32	80	0.4000000
NODE_12986_length_776_cov_11.163959	365	445	4	53	80	0.6625000
NODE_12986_length_776_cov_11.163959	365	445	5	25	80	0.3125000
NODE_12986_length_776_cov_11.163959	365	445	6	2	80	0.0250000
NODE_12987_length_776_cov_9.754801	370	450	0	80	80	1.0000000
NODE_12987_length_776_cov_9.754801	423	503	0	80	80	1.0000000
NODE_12989_length_776_cov_8.271787	332	412	5	70	80	0.8750000
NODE_12989_length_776_cov_8.271787	332	412	6	10	80	0.1250000
NODE_12989_length_776_cov_8.271787	385	465	1	4	80	0.0500000
NODE_12989_length_776_cov_8.271787	385	465	2	18	80	0.2250000
NODE_12989_length_776_cov_8.271787	385	465	3	1	80	0.0125000
NODE_12989_length_776_cov_8.271787	385	465	4	29	80	0.3625000
NODE_12989_length_776_cov_8.271787	385	465	5	28	80	0.3500000
NODE_12990_length_776_cov_4.874446	330	410	0	80	80	1.0000000
NODE_12990_length_776_cov_4.874446	383	463	0	80	80	1.0000000
NODE_13022_length_775_cov_33.612426	372	452	2	1	80	0.0125000
NODE_13022_length_775_cov_33.612426	372	452	4	36	80	0.4500000
NODE_13022_length_775_cov_33.612426	372	452	5	2	80	0.0250000
NODE_13022_length_775_cov_33.612426	372	452	6	41	80	0.5125000
NODE_13022_length_775_cov_33.612426	425	505	2	5	80	0.0625000
NODE_13022_length_775_cov_33.612426	425	505	4	31	80	0.3875000
NODE_13022_length_775_cov_33.612426	425	505	6	44	80	0.5500000
NODE_13023_length_775_cov_25.500000	361	434	2	73	73	1.0000000
NODE_13023_length_775_cov_25.500000	413	487	0	25	74	0.3378378
NODE_13023_length_775_cov_25.500000	413	487	2	49	74	0.6621622
NODE_13024_length_775_cov_24.128698	220	300	1	5	80	0.0625000
NODE_13024_length_775_cov_24.128698	220	300	2	46	80	0.5750000
NODE_13024_length_775_cov_24.128698	220	300	3	29	80	0.3625000
NODE_13024_length_775_cov_24.128698	273	353	1	13	80	0.1625000
NODE_13024_length_775_cov_24.128698	273	353	2	24	80	0.3000000
NODE_13024_length_775_cov_24.128698	273	353	3	43	80	0.5375000
NODE_13026_length_775_cov_16.165680	358	438	2	80	80	1.0000000
NODE_13026_length_775_cov_16.165680	411	491	0	25	80	0.3125000
NODE_13026_length_775_cov_16.165680	411	491	2	55	80	0.6875000
NODE_13027_length_775_cov_8.522189	440	520	10	14	80	0.1750000
NODE_13027_length_775_cov_8.522189	440	520	11	2	80	0.0250000
NODE_13027_length_775_cov_8.522189	440	520	15	43	80	0.5375000
NODE_13027_length_775_cov_8.522189	440	520	16	17	80	0.2125000
NODE_13027_length_775_cov_8.522189	440	520	17	4	80	0.0500000
NODE_13027_length_775_cov_8.522189	493	573	2	4	80	0.0500000
NODE_13027_length_775_cov_8.522189	493	573	6	6	80	0.0750000
NODE_13027_length_775_cov_8.522189	493	573	7	1	80	0.0125000
NODE_13027_length_775_cov_8.522189	493	573	8	4	80	0.0500000
NODE_13027_length_775_cov_8.522189	493	573	9	24	80	0.3000000
NODE_13027_length_775_cov_8.522189	493	573	10	28	80	0.3500000
NODE_13027_length_775_cov_8.522189	493	573	11	2	80	0.0250000
NODE_13027_length_775_cov_8.522189	493	573	15	4	80	0.0500000
NODE_13027_length_775_cov_8.522189	493	573	16	7	80	0.0875000
NODE_13028_length_775_cov_8.258876	247	327	2	33	80	0.4125000
NODE_13028_length_775_cov_8.258876	247	327	3	41	80	0.5125000
NODE_13028_length_775_cov_8.258876	247	327	4	6	80	0.0750000
NODE_13028_length_775_cov_8.258876	300	380	2	50	80	0.6250000
NODE_13028_length_775_cov_8.258876	300	380	3	30	80	0.3750000
NODE_13031_length_775_cov_3.786982	299	379	0	80	80	1.0000000
NODE_13031_length_775_cov_3.786982	352	432	0	80	80	1.0000000
NODE_13059_length_774_cov_27.386667	433	514	1	52	81	0.6419753
NODE_13059_length_774_cov_27.386667	433	514	2	28	81	0.3456790
NODE_13059_length_774_cov_27.386667	433	514	3	1	81	0.0123457
NODE_13059_length_774_cov_27.386667	487	567	2	71	80	0.8875000
NODE_13059_length_774_cov_27.386667	487	567	3	9	80	0.1125000
NODE_13060_length_774_cov_19.721481	239	319	2	13	80	0.1625000
NODE_13060_length_774_cov_19.721481	239	319	3	28	80	0.3500000
NODE_13060_length_774_cov_19.721481	239	319	4	39	80	0.4875000
NODE_13060_length_774_cov_19.721481	292	372	2	17	80	0.2125000
NODE_13060_length_774_cov_19.721481	292	372	3	48	80	0.6000000
NODE_13060_length_774_cov_19.721481	292	372	4	15	80	0.1875000
NODE_13063_length_774_cov_4.594074	216	294	1	59	78	0.7564102
NODE_13063_length_774_cov_4.594074	216	294	2	19	78	0.2435897
NODE_13063_length_774_cov_4.594074	269	347	0	16	78	0.2051282
NODE_13063_length_774_cov_4.594074	269	347	1	62	78	0.7948718
NODE_13063_length_774_cov_4.594074	405	485	4	80	80	1.0000000
NODE_13103_length_773_cov_60.566766	249	328	1	9	79	0.1139240
NODE_13103_length_773_cov_60.566766	249	328	3	60	79	0.7594936
NODE_13103_length_773_cov_60.566766	249	328	4	10	79	0.1265823
NODE_13103_length_773_cov_60.566766	304	381	3	77	77	1.0000000
NODE_13104_length_773_cov_27.299703	230	310	2	7	80	0.0875000
NODE_13104_length_773_cov_27.299703	230	310	3	62	80	0.7750000
NODE_13104_length_773_cov_27.299703	230	310	4	11	80	0.1375000
NODE_13104_length_773_cov_27.299703	283	363	3	48	80	0.6000000
NODE_13104_length_773_cov_27.299703	283	363	4	32	80	0.4000000
NODE_13105_length_773_cov_24.250742	392	470	1	12	78	0.1538462
NODE_13105_length_773_cov_24.250742	392	470	2	66	78	0.8461539
NODE_13105_length_773_cov_24.250742	443	523	2	80	80	1.0000000
NODE_13106_length_773_cov_20.683976	367	447	0	45	80	0.5625000
NODE_13106_length_773_cov_20.683976	367	447	1	35	80	0.4375000
NODE_13106_length_773_cov_20.683976	420	500	1	39	80	0.4875000
NODE_13106_length_773_cov_20.683976	420	500	2	41	80	0.5125000
NODE_13107_length_773_cov_18.498516	248	328	1	76	80	0.9500000
NODE_13107_length_773_cov_18.498516	248	328	2	4	80	0.0500000
NODE_13107_length_773_cov_18.498516	301	381	1	76	80	0.9500000
NODE_13107_length_773_cov_18.498516	301	381	2	4	80	0.0500000
NODE_13108_length_773_cov_14.063798	405	485	0	80	80	1.0000000
NODE_13108_length_773_cov_14.063798	458	538	0	80	80	1.0000000
NODE_13109_length_773_cov_12.482196	421	501	0	5	80	0.0625000
NODE_13109_length_773_cov_12.482196	421	501	1	75	80	0.9375000
NODE_13109_length_773_cov_12.482196	474	554	1	36	80	0.4500000
NODE_13109_length_773_cov_12.482196	474	554	2	4	80	0.0500000
NODE_13109_length_773_cov_12.482196	474	554	4	40	80	0.5000000
NODE_13114_length_773_cov_9.136499	214	294	3	37	80	0.4625000
NODE_13114_length_773_cov_9.136499	214	294	4	43	80	0.5375000
NODE_13114_length_773_cov_9.136499	267	347	1	6	80	0.0750000
NODE_13114_length_773_cov_9.136499	267	347	2	31	80	0.3875000
NODE_13114_length_773_cov_9.136499	267	347	3	41	80	0.5125000
NODE_13114_length_773_cov_9.136499	267	347	4	2	80	0.0250000
NODE_13115_length_773_cov_8.609792	461	541	2	52	80	0.6500000
NODE_13115_length_773_cov_8.609792	461	541	4	28	80	0.3500000
NODE_13115_length_773_cov_8.609792	514	594	0	36	80	0.4500000
NODE_13115_length_773_cov_8.609792	514	594	1	3	80	0.0375000
NODE_13115_length_773_cov_8.609792	514	594	2	41	80	0.5125000
NODE_13116_length_773_cov_7.224036	200	280	3	40	80	0.5000000
NODE_13116_length_773_cov_7.224036	200	280	5	40	80	0.5000000
NODE_13116_length_773_cov_7.224036	253	333	0	6	80	0.0750000
NODE_13116_length_773_cov_7.224036	253	333	1	22	80	0.2750000
NODE_13116_length_773_cov_7.224036	253	333	3	52	80	0.6500000
NODE_13117_length_773_cov_6.910979	522	615	2	58	93	0.6236559
NODE_13117_length_773_cov_6.910979	522	615	4	35	93	0.3763441
NODE_13117_length_773_cov_6.910979	588	668	2	80	80	1.0000000
NODE_13147_length_772_cov_28.044577	231	311	0	22	80	0.2750000
NODE_13147_length_772_cov_28.044577	231	311	1	58	80	0.7250000
NODE_13147_length_772_cov_28.044577	284	364	0	51	80	0.6375000
NODE_13147_length_772_cov_28.044577	284	364	1	29	80	0.3625000
NODE_13149_length_772_cov_9.523031	288	368	1	42	80	0.5250000
NODE_13149_length_772_cov_9.523031	288	368	2	38	80	0.4750000
NODE_13149_length_772_cov_9.523031	341	421	1	64	80	0.8000000
NODE_13149_length_772_cov_9.523031	341	421	2	16	80	0.2000000
NODE_13150_length_772_cov_8.778603	133	213	0	80	80	1.0000000
NODE_13150_length_772_cov_8.778603	186	266	0	80	80	1.0000000
NODE_13151_length_772_cov_7.921248	351	431	2	80	80	1.0000000
NODE_13151_length_772_cov_7.921248	404	480	0	40	76	0.5263158
NODE_13151_length_772_cov_7.921248	404	480	2	36	76	0.4736842
NODE_13152_length_772_cov_7.059435	276	356	1	59	80	0.7375000
NODE_13152_length_772_cov_7.059435	276	356	2	21	80	0.2625000
NODE_13152_length_772_cov_7.059435	329	409	1	80	80	1.0000000
NODE_13153_length_772_cov_5.536404	269	299	2	12	30	0.4000000
NODE_13153_length_772_cov_5.536404	269	299	4	18	30	0.6000000
NODE_13153_length_772_cov_5.536404	272	341	2	9	69	0.1304348
NODE_13153_length_772_cov_5.536404	272	341	4	60	69	0.8695652
NODE_13156_length_772_cov_4.838039	430	510	0	11	80	0.1375000
NODE_13156_length_772_cov_4.838039	430	510	2	69	80	0.8625000
NODE_13156_length_772_cov_4.838039	483	563	0	64	80	0.8000000
NODE_13156_length_772_cov_4.838039	483	563	2	16	80	0.2000000
NODE_13162_length_772_cov_3.041605	339	419	0	80	80	1.0000000
NODE_13162_length_772_cov_3.041605	392	472	0	80	80	1.0000000
NODE_13195_length_771_cov_36.729167	223	304	0	81	81	1.0000000
NODE_13195_length_771_cov_36.729167	277	357	0	80	80	1.0000000
NODE_13195_length_771_cov_36.729167	353	434	0	81	81	1.0000000
NODE_13195_length_771_cov_36.729167	407	487	0	80	80	1.0000000
NODE_13196_length_771_cov_28.903274	337	417	2	6	80	0.0750000
NODE_13196_length_771_cov_28.903274	337	417	3	20	80	0.2500000
NODE_13196_length_771_cov_28.903274	337	417	4	19	80	0.2375000
NODE_13196_length_771_cov_28.903274	337	417	5	35	80	0.4375000
NODE_13196_length_771_cov_28.903274	390	470	4	55	80	0.6875000
NODE_13196_length_771_cov_28.903274	390	470	5	25	80	0.3125000
NODE_13197_length_771_cov_28.165179	453	533	1	67	80	0.8375000
NODE_13197_length_771_cov_28.165179	453	533	2	13	80	0.1625000
NODE_13197_length_771_cov_28.165179	506	586	1	20	80	0.2500000
NODE_13197_length_771_cov_28.165179	506	586	2	60	80	0.7500000
NODE_13198_length_771_cov_14.336310	259	339	2	80	80	1.0000000
NODE_13198_length_771_cov_14.336310	312	392	0	33	80	0.4125000
NODE_13198_length_771_cov_14.336310	312	392	1	5	80	0.0625000
NODE_13198_length_771_cov_14.336310	312	392	2	42	80	0.5250000
NODE_13199_length_771_cov_13.592262	428	508	5	15	80	0.1875000
NODE_13199_length_771_cov_13.592262	428	508	6	65	80	0.8125000
NODE_13199_length_771_cov_13.592262	481	561	6	80	80	1.0000000
NODE_13200_length_771_cov_12.226190	407	487	0	1	80	0.0125000
NODE_13200_length_771_cov_12.226190	407	487	1	32	80	0.4000000
NODE_13200_length_771_cov_12.226190	407	487	3	47	80	0.5875000
NODE_13200_length_771_cov_12.226190	460	540	1	13	80	0.1625000
NODE_13200_length_771_cov_12.226190	460	540	3	67	80	0.8375000
NODE_13201_length_771_cov_11.188988	348	428	0	80	80	1.0000000
NODE_13201_length_771_cov_11.188988	401	481	0	80	80	1.0000000
NODE_13202_length_771_cov_10.525298	171	251	4	80	80	1.0000000
NODE_13202_length_771_cov_10.525298	224	304	1	4	80	0.0500000
NODE_13202_length_771_cov_10.525298	224	304	2	39	80	0.4875000
NODE_13202_length_771_cov_10.525298	224	304	4	37	80	0.4625000
NODE_13207_length_771_cov_3.357143	238	318	0	80	80	1.0000000
NODE_13207_length_771_cov_3.357143	291	371	0	80	80	1.0000000
NODE_13209_length_771_cov_3.129464	476	518	0	42	42	1.0000000
NODE_13238_length_770_cov_45.312966	212	292	1	24	80	0.3000000
NODE_13238_length_770_cov_45.312966	212	292	2	2	80	0.0250000
NODE_13238_length_770_cov_45.312966	212	292	3	6	80	0.0750000
NODE_13238_length_770_cov_45.312966	212	292	4	6	80	0.0750000
NODE_13238_length_770_cov_45.312966	212	292	5	31	80	0.3875000
NODE_13238_length_770_cov_45.312966	212	292	6	11	80	0.1375000
NODE_13238_length_770_cov_45.312966	265	345	5	16	80	0.2000000
NODE_13238_length_770_cov_45.312966	265	345	6	15	80	0.1875000
NODE_13238_length_770_cov_45.312966	265	345	7	47	80	0.5875000
NODE_13238_length_770_cov_45.312966	265	345	8	2	80	0.0250000
NODE_13239_length_770_cov_23.153502	348	428	0	80	80	1.0000000
NODE_13239_length_770_cov_23.153502	401	481	0	80	80	1.0000000
NODE_13240_length_770_cov_22.463487	340	420	2	14	80	0.1750000
NODE_13240_length_770_cov_22.463487	340	420	3	16	80	0.2000000
NODE_13240_length_770_cov_22.463487	340	420	4	50	80	0.6250000
NODE_13240_length_770_cov_22.463487	393	473	2	8	80	0.1000000
NODE_13240_length_770_cov_22.463487	393	473	3	26	80	0.3250000
NODE_13240_length_770_cov_22.463487	393	473	4	45	80	0.5625000
NODE_13240_length_770_cov_22.463487	393	473	5	1	80	0.0125000
NODE_13241_length_770_cov_18.594635	335	416	2	81	81	1.0000000
NODE_13241_length_770_cov_18.594635	389	469	2	80	80	1.0000000
NODE_13242_length_770_cov_18.092399	292	372	0	16	80	0.2000000
NODE_13242_length_770_cov_18.092399	292	372	1	4	80	0.0500000
NODE_13242_length_770_cov_18.092399	292	372	3	25	80	0.3125000
NODE_13242_length_770_cov_18.092399	292	372	4	25	80	0.3125000
NODE_13242_length_770_cov_18.092399	292	372	6	10	80	0.1250000
NODE_13242_length_770_cov_18.092399	345	425	4	17	80	0.2125000
NODE_13242_length_770_cov_18.092399	345	425	5	31	80	0.3875000
NODE_13242_length_770_cov_18.092399	345	425	6	32	80	0.4000000
NODE_13243_length_770_cov_7.064083	294	374	0	80	80	1.0000000
NODE_13243_length_770_cov_7.064083	347	426	0	79	79	1.0000000
NODE_13246_length_770_cov_5.184799	341	421	0	16	80	0.2000000
NODE_13246_length_770_cov_5.184799	341	421	1	64	80	0.8000000
NODE_13246_length_770_cov_5.184799	394	474	0	8	80	0.1000000
NODE_13246_length_770_cov_5.184799	394	474	1	72	80	0.9000000
NODE_13250_length_770_cov_4.120715	325	405	0	80	80	1.0000000
NODE_13250_length_770_cov_4.120715	378	458	0	80	80	1.0000000
NODE_13272_length_769_cov_11.008955	355	435	6	21	80	0.2625000
NODE_13272_length_769_cov_11.008955	355	435	7	6	80	0.0750000
NODE_13272_length_769_cov_11.008955	355	435	8	21	80	0.2625000
NODE_13272_length_769_cov_11.008955	355	435	9	1	80	0.0125000
NODE_13272_length_769_cov_11.008955	355	435	10	31	80	0.3875000
NODE_13272_length_769_cov_11.008955	408	488	7	25	80	0.3125000
NODE_13272_length_769_cov_11.008955	408	488	9	19	80	0.2375000
NODE_13272_length_769_cov_11.008955	408	488	10	27	80	0.3375000
NODE_13272_length_769_cov_11.008955	408	488	12	9	80	0.1125000
NODE_13274_length_769_cov_9.077612	263	343	0	44	80	0.5500000
NODE_13274_length_769_cov_9.077612	263	343	1	29	80	0.3625000
NODE_13274_length_769_cov_9.077612	263	343	2	7	80	0.0875000
NODE_13274_length_769_cov_9.077612	316	396	1	20	80	0.2500000
NODE_13274_length_769_cov_9.077612	316	396	2	60	80	0.7500000
NODE_13275_length_769_cov_7.034328	289	367	1	69	78	0.8846154
NODE_13275_length_769_cov_7.034328	289	367	2	9	78	0.1153846
NODE_13275_length_769_cov_7.034328	340	420	1	18	80	0.2250000
NODE_13275_length_769_cov_7.034328	340	420	2	62	80	0.7750000
NODE_13307_length_769_cov_1.262687	620	668	0	48	48	1.0000000
NODE_13316_length_768_cov_19.195815	266	346	0	80	80	1.0000000
NODE_13316_length_768_cov_19.195815	319	399	0	80	80	1.0000000
NODE_13316_length_768_cov_19.195815	395	475	0	80	80	1.0000000
NODE_13316_length_768_cov_19.195815	448	528	0	80	80	1.0000000
NODE_13317_length_768_cov_16.420030	246	326	2	10	80	0.1250000
NODE_13317_length_768_cov_16.420030	246	326	3	70	80	0.8750000
NODE_13317_length_768_cov_16.420030	299	379	1	10	80	0.1250000
NODE_13317_length_768_cov_16.420030	299	379	3	70	80	0.8750000
NODE_13318_length_768_cov_14.508221	309	389	0	25	80	0.3125000
NODE_13318_length_768_cov_14.508221	309	389	2	7	80	0.0875000
NODE_13318_length_768_cov_14.508221	309	389	4	48	80	0.6000000
NODE_13318_length_768_cov_14.508221	362	442	0	78	80	0.9750000
NODE_13318_length_768_cov_14.508221	362	442	2	2	80	0.0250000
NODE_13319_length_768_cov_11.635277	309	389	1	14	80	0.1750000
NODE_13319_length_768_cov_11.635277	309	389	2	66	80	0.8250000
NODE_13319_length_768_cov_11.635277	362	442	2	80	80	1.0000000
NODE_13321_length_768_cov_9.064275	392	472	0	80	80	1.0000000
NODE_13321_length_768_cov_9.064275	445	525	0	65	80	0.8125000
NODE_13321_length_768_cov_9.064275	445	525	1	15	80	0.1875000
NODE_13324_length_768_cov_3.605381	512	592	0	80	80	1.0000000
NODE_13324_length_768_cov_3.605381	565	645	0	80	80	1.0000000
NODE_13354_length_767_cov_38.161677	28	108	0	80	80	1.0000000
NODE_13354_length_767_cov_38.161677	254	334	1	8	80	0.1000000
NODE_13354_length_767_cov_38.161677	254	334	2	45	80	0.5625000
NODE_13354_length_767_cov_38.161677	254	334	3	12	80	0.1500000
NODE_13354_length_767_cov_38.161677	254	334	4	15	80	0.1875000
NODE_13354_length_767_cov_38.161677	307	387	0	10	80	0.1250000
NODE_13354_length_767_cov_38.161677	307	387	1	51	80	0.6375000
NODE_13354_length_767_cov_38.161677	307	387	2	19	80	0.2375000
NODE_13355_length_767_cov_24.107784	279	359	1	13	80	0.1625000
NODE_13355_length_767_cov_24.107784	279	359	3	67	80	0.8375000
NODE_13355_length_767_cov_24.107784	332	412	1	8	80	0.1000000
NODE_13355_length_767_cov_24.107784	332	412	3	72	80	0.9000000
NODE_13356_length_767_cov_22.823353	286	366	6	7	80	0.0875000
NODE_13356_length_767_cov_22.823353	286	366	7	55	80	0.6875000
NODE_13356_length_767_cov_22.823353	286	366	8	18	80	0.2250000
NODE_13356_length_767_cov_22.823353	339	419	3	7	80	0.0875000
NODE_13356_length_767_cov_22.823353	339	419	4	37	80	0.4625000
NODE_13356_length_767_cov_22.823353	339	419	6	16	80	0.2000000
NODE_13356_length_767_cov_22.823353	339	419	7	3	80	0.0375000
NODE_13356_length_767_cov_22.823353	339	419	8	17	80	0.2125000
NODE_13357_length_767_cov_20.898204	312	392	0	80	80	1.0000000
NODE_13357_length_767_cov_20.898204	365	445	0	80	80	1.0000000
NODE_13358_length_767_cov_20.058383	357	439	2	19	82	0.2317073
NODE_13358_length_767_cov_20.058383	357	439	3	1	82	0.0121951
NODE_13358_length_767_cov_20.058383	357	439	4	62	82	0.7560976
NODE_13358_length_767_cov_20.058383	410	490	3	1	80	0.0125000
NODE_13358_length_767_cov_20.058383	410	490	4	79	80	0.9875000
NODE_13359_length_767_cov_20.020958	191	271	2	9	80	0.1125000
NODE_13359_length_767_cov_20.020958	191	271	3	53	80	0.6625000
NODE_13359_length_767_cov_20.020958	191	271	4	18	80	0.2250000
NODE_13359_length_767_cov_20.020958	244	324	2	25	80	0.3125000
NODE_13359_length_767_cov_20.020958	244	324	3	55	80	0.6875000
NODE_13360_length_767_cov_18.687126	270	350	0	37	80	0.4625000
NODE_13360_length_767_cov_18.687126	270	350	1	14	80	0.1750000
NODE_13360_length_767_cov_18.687126	270	350	2	29	80	0.3625000
NODE_13360_length_767_cov_18.687126	323	403	2	80	80	1.0000000
NODE_13362_length_767_cov_13.323353	45	125	0	80	80	1.0000000
NODE_13362_length_767_cov_13.323353	98	178	0	80	80	1.0000000
NODE_13366_length_767_cov_8.787425	377	447	2	7	70	0.1000000
NODE_13366_length_767_cov_8.787425	377	447	3	63	70	0.9000000
NODE_13366_length_767_cov_8.787425	420	500	1	1	80	0.0125000
NODE_13366_length_767_cov_8.787425	420	500	3	79	80	0.9875000
NODE_13367_length_767_cov_7.206587	306	386	0	80	80	1.0000000
NODE_13367_length_767_cov_7.206587	359	440	0	81	81	1.0000000
NODE_13403_length_766_cov_59.388306	322	402	1	3	80	0.0375000
NODE_13403_length_766_cov_59.388306	322	402	2	77	80	0.9625000
NODE_13403_length_766_cov_59.388306	375	455	0	42	80	0.5250000
NODE_13403_length_766_cov_59.388306	375	455	1	14	80	0.1750000
NODE_13403_length_766_cov_59.388306	375	455	2	24	80	0.3000000
NODE_13403_length_766_cov_59.388306	451	531	0	80	80	1.0000000
NODE_13403_length_766_cov_59.388306	504	584	0	80	80	1.0000000
NODE_13404_length_766_cov_23.361319	308	388	1	27	80	0.3375000
NODE_13404_length_766_cov_23.361319	308	388	4	53	80	0.6625000
NODE_13404_length_766_cov_23.361319	361	441	3	26	80	0.3250000
NODE_13404_length_766_cov_23.361319	361	441	4	54	80	0.6750000
NODE_13405_length_766_cov_22.751124	229	309	0	8	80	0.1000000
NODE_13405_length_766_cov_22.751124	229	309	1	72	80	0.9000000
NODE_13405_length_766_cov_22.751124	282	362	0	8	80	0.1000000
NODE_13405_length_766_cov_22.751124	282	362	1	72	80	0.9000000
NODE_13406_length_766_cov_20.011994	285	363	0	78	78	1.0000000
NODE_13406_length_766_cov_20.011994	336	416	0	80	80	1.0000000
NODE_13407_length_766_cov_18.685157	288	368	1	4	80	0.0500000
NODE_13407_length_766_cov_18.685157	288	368	2	76	80	0.9500000
NODE_13407_length_766_cov_18.685157	341	421	0	53	80	0.6625000
NODE_13407_length_766_cov_18.685157	341	421	1	4	80	0.0500000
NODE_13407_length_766_cov_18.685157	341	421	2	23	80	0.2875000
NODE_13408_length_766_cov_13.131934	271	351	0	31	80	0.3875000
NODE_13408_length_766_cov_13.131934	271	351	1	22	80	0.2750000
NODE_13408_length_766_cov_13.131934	271	351	2	27	80	0.3375000
NODE_13408_length_766_cov_13.131934	324	404	2	80	80	1.0000000
NODE_13410_length_766_cov_9.479760	274	354	0	23	80	0.2875000
NODE_13410_length_766_cov_9.479760	274	354	2	57	80	0.7125000
NODE_13410_length_766_cov_9.479760	327	407	0	76	80	0.9500000
NODE_13410_length_766_cov_9.479760	327	407	2	4	80	0.0500000
NODE_13415_length_766_cov_4.500750	333	413	4	4	80	0.0500000
NODE_13415_length_766_cov_4.500750	333	413	5	29	80	0.3625000
NODE_13415_length_766_cov_4.500750	333	413	6	47	80	0.5875000
NODE_13415_length_766_cov_4.500750	369	404	6	35	35	1.0000000
NODE_13415_length_766_cov_4.500750	371	413	4	4	42	0.0952381
NODE_13415_length_766_cov_4.500750	371	413	6	38	42	0.9047619
NODE_13415_length_766_cov_4.500750	397	466	2	21	69	0.3043478
NODE_13415_length_766_cov_4.500750	397	466	3	14	69	0.2028985
NODE_13415_length_766_cov_4.500750	397	466	4	22	69	0.3188406
NODE_13415_length_766_cov_4.500750	397	466	6	12	69	0.1739130
NODE_13447_length_765_cov_92.851351	16	96	1	16	80	0.2000000
NODE_13447_length_765_cov_92.851351	16	96	2	7	80	0.0875000
NODE_13447_length_765_cov_92.851351	16	96	3	9	80	0.1125000
NODE_13447_length_765_cov_92.851351	16	96	4	1	80	0.0125000
NODE_13447_length_765_cov_92.851351	16	96	6	2	80	0.0250000
NODE_13447_length_765_cov_92.851351	16	96	8	5	80	0.0625000
NODE_13447_length_765_cov_92.851351	16	96	10	11	80	0.1375000
NODE_13447_length_765_cov_92.851351	16	96	11	6	80	0.0750000
NODE_13447_length_765_cov_92.851351	16	96	12	3	80	0.0375000
NODE_13447_length_765_cov_92.851351	16	96	16	4	80	0.0500000
NODE_13447_length_765_cov_92.851351	16	96	18	1	80	0.0125000
NODE_13447_length_765_cov_92.851351	16	96	20	15	80	0.1875000
NODE_13448_length_765_cov_36.345345	504	584	0	18	80	0.2250000
NODE_13448_length_765_cov_36.345345	504	584	4	16	80	0.2000000
NODE_13448_length_765_cov_36.345345	504	584	5	17	80	0.2125000
NODE_13448_length_765_cov_36.345345	504	584	6	8	80	0.1000000
NODE_13448_length_765_cov_36.345345	504	584	8	21	80	0.2625000
NODE_13448_length_765_cov_36.345345	557	637	5	13	80	0.1625000
NODE_13448_length_765_cov_36.345345	557	637	6	35	80	0.4375000
NODE_13448_length_765_cov_36.345345	557	637	8	32	80	0.4000000
NODE_13449_length_765_cov_27.334835	370	450	2	28	80	0.3500000
NODE_13449_length_765_cov_27.334835	370	450	4	4	80	0.0500000
NODE_13449_length_765_cov_27.334835	370	450	6	48	80	0.6000000
NODE_13449_length_765_cov_27.334835	423	503	2	31	80	0.3875000
NODE_13449_length_765_cov_27.334835	423	503	3	1	80	0.0125000
NODE_13449_length_765_cov_27.334835	423	503	4	48	80	0.6000000
NODE_13450_length_765_cov_23.355856	251	331	6	12	80	0.1500000
NODE_13450_length_765_cov_23.355856	251	331	7	47	80	0.5875000
NODE_13450_length_765_cov_23.355856	251	331	8	18	80	0.2250000
NODE_13450_length_765_cov_23.355856	251	331	10	3	80	0.0375000
NODE_13450_length_765_cov_23.355856	304	384	7	6	80	0.0750000
NODE_13450_length_765_cov_23.355856	304	384	8	18	80	0.2250000
NODE_13450_length_765_cov_23.355856	304	384	9	23	80	0.2875000
NODE_13450_length_765_cov_23.355856	304	384	10	21	80	0.2625000
NODE_13450_length_765_cov_23.355856	304	384	11	12	80	0.1500000
NODE_13450_length_765_cov_23.355856	380	460	7	33	80	0.4125000
NODE_13450_length_765_cov_23.355856	380	460	8	14	80	0.1750000
NODE_13450_length_765_cov_23.355856	380	460	9	30	80	0.3750000
NODE_13450_length_765_cov_23.355856	380	460	10	3	80	0.0375000
NODE_13450_length_765_cov_23.355856	433	506	3	7	73	0.0958904
NODE_13450_length_765_cov_23.355856	433	506	5	13	73	0.1780822
NODE_13450_length_765_cov_23.355856	433	506	6	26	73	0.3561644
NODE_13450_length_765_cov_23.355856	433	506	7	27	73	0.3698630
NODE_13451_length_765_cov_23.322823	256	336	0	80	80	1.0000000
NODE_13451_length_765_cov_23.322823	309	389	0	29	80	0.3625000
NODE_13451_length_765_cov_23.322823	309	389	2	51	80	0.6375000
NODE_13452_length_765_cov_21.741742	379	452	0	7	73	0.0958904
NODE_13452_length_765_cov_21.741742	379	452	1	7	73	0.0958904
NODE_13452_length_765_cov_21.741742	379	452	2	59	73	0.8082192
NODE_13452_length_765_cov_21.741742	425	505	0	60	80	0.7500000
NODE_13452_length_765_cov_21.741742	425	505	1	7	80	0.0875000
NODE_13452_length_765_cov_21.741742	425	505	2	13	80	0.1625000
NODE_13453_length_765_cov_14.253754	450	530	0	62	80	0.7750000
NODE_13453_length_765_cov_14.253754	450	530	2	18	80	0.2250000
NODE_13453_length_765_cov_14.253754	503	583	0	9	80	0.1125000
NODE_13453_length_765_cov_14.253754	503	583	2	71	80	0.8875000
NODE_13454_length_765_cov_13.627628	313	393	0	79	80	0.9875000
NODE_13454_length_765_cov_13.627628	313	393	1	1	80	0.0125000
NODE_13454_length_765_cov_13.627628	366	446	0	80	80	1.0000000
NODE_13455_length_765_cov_5.561562	319	349	0	30	30	1.0000000
NODE_13458_length_765_cov_4.367868	433	513	0	19	80	0.2375000
NODE_13458_length_765_cov_4.367868	433	513	1	61	80	0.7625000
NODE_13458_length_765_cov_4.367868	486	566	0	72	80	0.9000000
NODE_13458_length_765_cov_4.367868	486	566	1	8	80	0.1000000
NODE_13483_length_764_cov_30.096241	436	516	1	78	80	0.9750000
NODE_13483_length_764_cov_30.096241	436	516	2	2	80	0.0250000
NODE_13483_length_764_cov_30.096241	489	569	0	29	80	0.3625000
NODE_13483_length_764_cov_30.096241	489	569	1	51	80	0.6375000
NODE_13484_length_764_cov_29.218045	304	384	1	71	80	0.8875000
NODE_13484_length_764_cov_29.218045	304	384	2	9	80	0.1125000
NODE_13484_length_764_cov_29.218045	357	437	1	18	80	0.2250000
NODE_13484_length_764_cov_29.218045	357	437	2	49	80	0.6125000
NODE_13484_length_764_cov_29.218045	357	437	3	13	80	0.1625000
NODE_13485_length_764_cov_25.951880	421	501	0	80	80	1.0000000
NODE_13485_length_764_cov_25.951880	474	554	0	80	80	1.0000000
NODE_13486_length_764_cov_23.590977	204	284	1	44	80	0.5500000
NODE_13486_length_764_cov_23.590977	204	284	2	24	80	0.3000000
NODE_13486_length_764_cov_23.590977	204	284	4	5	80	0.0625000
NODE_13486_length_764_cov_23.590977	204	284	5	7	80	0.0875000
NODE_13486_length_764_cov_23.590977	257	337	2	15	80	0.1875000
NODE_13486_length_764_cov_23.590977	257	337	4	5	80	0.0625000
NODE_13486_length_764_cov_23.590977	257	337	5	25	80	0.3125000
NODE_13486_length_764_cov_23.590977	257	337	9	3	80	0.0375000
NODE_13486_length_764_cov_23.590977	257	337	10	32	80	0.4000000
NODE_13488_length_764_cov_6.804511	281	361	0	80	80	1.0000000
NODE_13488_length_764_cov_6.804511	334	414	0	80	80	1.0000000
NODE_13489_length_764_cov_6.700752	392	458	1	48	66	0.7272727
NODE_13489_length_764_cov_6.700752	392	458	2	18	66	0.2727273
NODE_13508_length_764_cov_1.171429	475	537	0	62	62	1.0000000
NODE_13520_length_763_cov_28.807229	311	391	1	27	80	0.3375000
NODE_13520_length_763_cov_28.807229	311	391	3	53	80	0.6625000
NODE_13520_length_763_cov_28.807229	364	444	3	43	80	0.5375000
NODE_13520_length_763_cov_28.807229	364	444	4	1	80	0.0125000
NODE_13520_length_763_cov_28.807229	364	444	5	26	80	0.3250000
NODE_13520_length_763_cov_28.807229	364	444	6	10	80	0.1250000
NODE_13521_length_763_cov_25.299699	598	673	3	2	75	0.0266667
NODE_13521_length_763_cov_25.299699	598	673	4	23	75	0.3066667
NODE_13521_length_763_cov_25.299699	598	673	5	16	75	0.2133333
NODE_13521_length_763_cov_25.299699	598	673	7	34	75	0.4533333
NODE_13521_length_763_cov_25.299699	598	678	3	2	80	0.0250000
NODE_13521_length_763_cov_25.299699	598	678	4	23	80	0.2875000
NODE_13521_length_763_cov_25.299699	598	678	5	16	80	0.2000000
NODE_13521_length_763_cov_25.299699	598	678	7	39	80	0.4875000
NODE_13521_length_763_cov_25.299699	605	675	4	18	70	0.2571429
NODE_13521_length_763_cov_25.299699	605	675	5	16	70	0.2285714
NODE_13521_length_763_cov_25.299699	605	675	7	36	70	0.5142857
NODE_13521_length_763_cov_25.299699	607	678	4	16	71	0.2253521
NODE_13521_length_763_cov_25.299699	607	678	5	16	71	0.2253521
NODE_13521_length_763_cov_25.299699	607	678	7	39	71	0.5492958
NODE_13521_length_763_cov_25.299699	651	731	3	9	80	0.1125000
NODE_13521_length_763_cov_25.299699	651	731	4	11	80	0.1375000
NODE_13521_length_763_cov_25.299699	651	731	6	30	80	0.3750000
NODE_13521_length_763_cov_25.299699	651	731	7	30	80	0.3750000
NODE_13521_length_763_cov_25.299699	651	731	3	9	80	0.1125000
NODE_13521_length_763_cov_25.299699	651	731	4	11	80	0.1375000
NODE_13521_length_763_cov_25.299699	651	731	6	30	80	0.3750000
NODE_13521_length_763_cov_25.299699	651	731	7	30	80	0.3750000
NODE_13521_length_763_cov_25.299699	651	731	3	9	80	0.1125000
NODE_13521_length_763_cov_25.299699	651	731	4	11	80	0.1375000
NODE_13521_length_763_cov_25.299699	651	731	6	30	80	0.3750000
NODE_13521_length_763_cov_25.299699	651	731	7	30	80	0.3750000
NODE_13521_length_763_cov_25.299699	651	731	3	9	80	0.1125000
NODE_13521_length_763_cov_25.299699	651	731	4	11	80	0.1375000
NODE_13521_length_763_cov_25.299699	651	731	6	30	80	0.3750000
NODE_13521_length_763_cov_25.299699	651	731	7	30	80	0.3750000
NODE_13522_length_763_cov_12.887048	336	416	0	80	80	1.0000000
NODE_13522_length_763_cov_12.887048	389	469	0	80	80	1.0000000
NODE_13523_length_763_cov_11.599398	547	627	1	80	80	1.0000000
NODE_13523_length_763_cov_11.599398	600	680	0	30	80	0.3750000
NODE_13523_length_763_cov_11.599398	600	680	1	50	80	0.6250000
NODE_13524_length_763_cov_9.378012	297	377	0	80	80	1.0000000
NODE_13524_length_763_cov_9.378012	350	430	0	80	80	1.0000000
NODE_13526_length_763_cov_7.246988	368	448	0	37	80	0.4625000
NODE_13526_length_763_cov_7.246988	368	448	1	43	80	0.5375000
NODE_13526_length_763_cov_7.246988	421	501	1	53	80	0.6625000
NODE_13526_length_763_cov_7.246988	421	501	2	27	80	0.3375000
NODE_13527_length_763_cov_6.414157	371	451	0	22	80	0.2750000
NODE_13527_length_763_cov_6.414157	371	451	1	47	80	0.5875000
NODE_13527_length_763_cov_6.414157	371	451	2	11	80	0.1375000
NODE_13527_length_763_cov_6.414157	424	504	1	16	80	0.2000000
NODE_13527_length_763_cov_6.414157	424	504	2	64	80	0.8000000
NODE_13558_length_762_cov_21.236802	368	448	0	17	80	0.2125000
NODE_13558_length_762_cov_21.236802	368	448	1	8	80	0.1000000
NODE_13558_length_762_cov_21.236802	368	448	3	5	80	0.0625000
NODE_13558_length_762_cov_21.236802	368	448	4	50	80	0.6250000
NODE_13558_length_762_cov_21.236802	421	501	4	80	80	1.0000000
NODE_13559_length_762_cov_19.984917	327	407	0	80	80	1.0000000
NODE_13559_length_762_cov_19.984917	380	460	0	80	80	1.0000000
NODE_13560_length_762_cov_15.975867	318	398	0	78	80	0.9750000
NODE_13560_length_762_cov_15.975867	318	398	2	2	80	0.0250000
NODE_13560_length_762_cov_15.975867	371	439	0	68	68	1.0000000
NODE_13561_length_762_cov_12.728507	381	461	2	1	80	0.0125000
NODE_13561_length_762_cov_12.728507	381	461	3	79	80	0.9875000
NODE_13561_length_762_cov_12.728507	434	514	1	13	80	0.1625000
NODE_13561_length_762_cov_12.728507	434	514	2	26	80	0.3250000
NODE_13561_length_762_cov_12.728507	434	514	3	41	80	0.5125000
NODE_13562_length_762_cov_10.078431	277	357	0	80	80	1.0000000
NODE_13562_length_762_cov_10.078431	330	410	0	80	80	1.0000000
NODE_13563_length_762_cov_9.705882	339	419	2	80	80	1.0000000
NODE_13563_length_762_cov_9.705882	392	472	2	80	80	1.0000000
NODE_13564_length_762_cov_7.276018	316	395	3	29	79	0.3670886
NODE_13564_length_762_cov_7.276018	316	395	4	11	79	0.1392405
NODE_13564_length_762_cov_7.276018	316	395	6	12	79	0.1518987
NODE_13564_length_762_cov_7.276018	316	395	8	11	79	0.1392405
NODE_13564_length_762_cov_7.276018	316	395	9	4	79	0.0506329
NODE_13564_length_762_cov_7.276018	316	395	10	12	79	0.1518987
NODE_13564_length_762_cov_7.276018	368	448	7	25	80	0.3125000
NODE_13564_length_762_cov_7.276018	368	448	8	11	80	0.1375000
NODE_13564_length_762_cov_7.276018	368	448	9	32	80	0.4000000
NODE_13564_length_762_cov_7.276018	368	448	10	12	80	0.1500000
NODE_13565_length_762_cov_6.168929	222	302	1	10	80	0.1250000
NODE_13565_length_762_cov_6.168929	222	302	2	70	80	0.8750000
NODE_13565_length_762_cov_6.168929	275	355	0	5	80	0.0625000
NODE_13565_length_762_cov_6.168929	275	355	1	58	80	0.7250000
NODE_13565_length_762_cov_6.168929	275	355	2	17	80	0.2125000
NODE_13613_length_761_cov_44.243202	531	582	18	3	51	0.0588235
NODE_13613_length_761_cov_44.243202	531	582	19	6	51	0.1176471
NODE_13613_length_761_cov_44.243202	531	582	20	26	51	0.5098040
NODE_13613_length_761_cov_44.243202	531	582	21	8	51	0.1568628
NODE_13613_length_761_cov_44.243202	531	582	22	5	51	0.0980392
NODE_13613_length_761_cov_44.243202	531	582	23	3	51	0.0588235
NODE_13614_length_761_cov_38.809668	342	422	2	35	80	0.4375000
NODE_13614_length_761_cov_38.809668	342	422	3	8	80	0.1000000
NODE_13614_length_761_cov_38.809668	342	422	4	37	80	0.4625000
NODE_13614_length_761_cov_38.809668	395	475	0	37	80	0.4625000
NODE_13614_length_761_cov_38.809668	395	475	2	43	80	0.5375000
NODE_13615_length_761_cov_38.694864	314	394	1	6	80	0.0750000
NODE_13615_length_761_cov_38.694864	314	394	2	30	80	0.3750000
NODE_13615_length_761_cov_38.694864	314	394	3	44	80	0.5500000
NODE_13615_length_761_cov_38.694864	367	447	3	40	80	0.5000000
NODE_13615_length_761_cov_38.694864	367	447	4	17	80	0.2125000
NODE_13615_length_761_cov_38.694864	367	447	5	5	80	0.0625000
NODE_13615_length_761_cov_38.694864	367	447	6	15	80	0.1875000
NODE_13615_length_761_cov_38.694864	367	447	7	3	80	0.0375000
NODE_13616_length_761_cov_32.382175	432	512	0	4	80	0.0500000
NODE_13616_length_761_cov_32.382175	432	512	1	6	80	0.0750000
NODE_13616_length_761_cov_32.382175	432	512	2	33	80	0.4125000
NODE_13616_length_761_cov_32.382175	432	512	3	36	80	0.4500000
NODE_13616_length_761_cov_32.382175	432	512	4	1	80	0.0125000
NODE_13616_length_761_cov_32.382175	485	565	3	26	80	0.3250000
NODE_13616_length_761_cov_32.382175	485	565	4	10	80	0.1250000
NODE_13616_length_761_cov_32.382175	485	565	5	44	80	0.5500000
NODE_13617_length_761_cov_31.444109	323	403	1	27	80	0.3375000
NODE_13617_length_761_cov_31.444109	323	403	2	53	80	0.6625000
NODE_13617_length_761_cov_31.444109	376	467	1	3	91	0.0329670
NODE_13617_length_761_cov_31.444109	376	467	2	88	91	0.9670330
NODE_13618_length_761_cov_14.004532	366	446	6	32	80	0.4000000
NODE_13618_length_761_cov_14.004532	366	446	7	13	80	0.1625000
NODE_13618_length_761_cov_14.004532	366	446	8	34	80	0.4250000
NODE_13618_length_761_cov_14.004532	366	446	9	1	80	0.0125000
NODE_13618_length_761_cov_14.004532	419	499	2	14	80	0.1750000
NODE_13618_length_761_cov_14.004532	419	499	4	12	80	0.1500000
NODE_13618_length_761_cov_14.004532	419	499	5	1	80	0.0125000
NODE_13618_length_761_cov_14.004532	419	499	6	14	80	0.1750000
NODE_13618_length_761_cov_14.004532	419	499	7	39	80	0.4875000
NODE_13619_length_761_cov_13.287009	336	415	1	45	79	0.5696203
NODE_13619_length_761_cov_13.287009	336	415	3	34	79	0.4303797
NODE_13619_length_761_cov_13.287009	388	468	2	52	80	0.6500000
NODE_13619_length_761_cov_13.287009	388	468	3	28	80	0.3500000
NODE_13621_length_761_cov_9.654079	274	354	0	80	80	1.0000000
NODE_13621_length_761_cov_9.654079	327	407	0	80	80	1.0000000
NODE_13622_length_761_cov_7.306647	308	388	0	80	80	1.0000000
NODE_13622_length_761_cov_7.306647	361	441	0	80	80	1.0000000
NODE_13625_length_761_cov_4.314199	354	434	0	27	80	0.3375000
NODE_13625_length_761_cov_4.314199	354	434	1	13	80	0.1625000
NODE_13625_length_761_cov_4.314199	354	434	2	40	80	0.5000000
NODE_13625_length_761_cov_4.314199	407	487	2	80	80	1.0000000
NODE_13658_length_760_cov_48.290469	215	295	1	80	80	1.0000000
NODE_13658_length_760_cov_48.290469	268	348	1	64	80	0.8000000
NODE_13658_length_760_cov_48.290469	268	348	2	16	80	0.2000000
NODE_13658_length_760_cov_48.290469	344	424	1	68	80	0.8500000
NODE_13658_length_760_cov_48.290469	344	424	2	12	80	0.1500000
NODE_13658_length_760_cov_48.290469	397	477	1	80	80	1.0000000
NODE_13659_length_760_cov_28.314675	384	464	3	13	80	0.1625000
NODE_13659_length_760_cov_28.314675	384	464	4	22	80	0.2750000
NODE_13659_length_760_cov_28.314675	384	464	5	45	80	0.5625000
NODE_13659_length_760_cov_28.314675	437	517	3	16	80	0.2000000
NODE_13659_length_760_cov_28.314675	437	517	4	37	80	0.4625000
NODE_13659_length_760_cov_28.314675	437	517	5	27	80	0.3375000
NODE_13660_length_760_cov_27.981846	432	512	1	29	80	0.3625000
NODE_13660_length_760_cov_27.981846	432	512	2	51	80	0.6375000
NODE_13660_length_760_cov_27.981846	485	565	0	32	80	0.4000000
NODE_13660_length_760_cov_27.981846	485	565	1	48	80	0.6000000
NODE_13661_length_760_cov_17.500756	372	452	1	16	80	0.2000000
NODE_13661_length_760_cov_17.500756	372	452	3	54	80	0.6750000
NODE_13661_length_760_cov_17.500756	372	452	4	10	80	0.1250000
NODE_13661_length_760_cov_17.500756	425	505	3	17	80	0.2125000
NODE_13661_length_760_cov_17.500756	425	505	4	48	80	0.6000000
NODE_13661_length_760_cov_17.500756	425	505	5	15	80	0.1875000
NODE_13662_length_760_cov_17.420575	183	263	2	15	80	0.1875000
NODE_13662_length_760_cov_17.420575	183	263	3	43	80	0.5375000
NODE_13662_length_760_cov_17.420575	183	263	4	22	80	0.2750000
NODE_13662_length_760_cov_17.420575	236	316	3	5	80	0.0625000
NODE_13662_length_760_cov_17.420575	236	316	4	58	80	0.7250000
NODE_13662_length_760_cov_17.420575	236	316	5	17	80	0.2125000
NODE_13663_length_760_cov_13.444781	357	437	0	10	80	0.1250000
NODE_13663_length_760_cov_13.444781	357	437	1	6	80	0.0750000
NODE_13663_length_760_cov_13.444781	357	437	2	64	80	0.8000000
NODE_13663_length_760_cov_13.444781	410	490	2	80	80	1.0000000
NODE_13664_length_760_cov_13.196672	282	362	1	36	80	0.4500000
NODE_13664_length_760_cov_13.196672	282	362	3	44	80	0.5500000
NODE_13664_length_760_cov_13.196672	335	415	2	34	80	0.4250000
NODE_13664_length_760_cov_13.196672	335	415	3	46	80	0.5750000
NODE_13665_length_760_cov_12.692890	295	375	0	41	80	0.5125000
NODE_13665_length_760_cov_12.692890	295	375	1	12	80	0.1500000
NODE_13665_length_760_cov_12.692890	295	375	2	27	80	0.3375000
NODE_13665_length_760_cov_12.692890	348	428	2	80	80	1.0000000
NODE_13671_length_760_cov_4.282905	388	468	3	30	80	0.3750000
NODE_13671_length_760_cov_4.282905	388	468	4	39	80	0.4875000
NODE_13671_length_760_cov_4.282905	388	468	5	11	80	0.1375000
NODE_13671_length_760_cov_4.282905	441	521	4	55	80	0.6875000
NODE_13671_length_760_cov_4.282905	441	521	5	25	80	0.3125000
NODE_13671_length_760_cov_4.282905	517	597	1	12	80	0.1500000
NODE_13671_length_760_cov_4.282905	517	597	2	47	80	0.5875000
NODE_13671_length_760_cov_4.282905	517	597	3	3	80	0.0375000
NODE_13671_length_760_cov_4.282905	517	597	4	18	80	0.2250000
NODE_13683_length_760_cov_1.990923	490	570	0	2	80	0.0250000
NODE_13683_length_760_cov_1.990923	490	570	1	72	80	0.9000000
NODE_13683_length_760_cov_1.990923	490	570	2	6	80	0.0750000
NODE_13683_length_760_cov_1.990923	543	623	1	21	80	0.2625000
NODE_13683_length_760_cov_1.990923	543	623	2	27	80	0.3375000
NODE_13683_length_760_cov_1.990923	543	623	3	32	80	0.4000000
NODE_13709_length_759_cov_24.757576	376	456	0	80	80	1.0000000
NODE_13709_length_759_cov_24.757576	429	509	0	80	80	1.0000000
NODE_13710_length_759_cov_14.356061	210	290	0	80	80	1.0000000
NODE_13710_length_759_cov_14.356061	263	343	0	80	80	1.0000000
NODE_13711_length_759_cov_10.956061	328	408	0	80	80	1.0000000
NODE_13711_length_759_cov_10.956061	381	461	0	80	80	1.0000000
NODE_13712_length_759_cov_10.639394	330	410	2	14	80	0.1750000
NODE_13712_length_759_cov_10.639394	330	410	3	22	80	0.2750000
NODE_13712_length_759_cov_10.639394	330	410	4	44	80	0.5500000
NODE_13712_length_759_cov_10.639394	383	463	4	80	80	1.0000000
NODE_13713_length_759_cov_9.192424	209	290	6	15	81	0.1851852
NODE_13713_length_759_cov_9.192424	209	290	10	1	81	0.0123457
NODE_13713_length_759_cov_9.192424	209	290	12	6	81	0.0740741
NODE_13713_length_759_cov_9.192424	209	290	13	4	81	0.0493827
NODE_13713_length_759_cov_9.192424	209	290	15	13	81	0.1604938
NODE_13713_length_759_cov_9.192424	209	290	16	12	81	0.1481481
NODE_13713_length_759_cov_9.192424	209	290	18	9	81	0.1111111
NODE_13713_length_759_cov_9.192424	209	290	20	15	81	0.1851852
NODE_13713_length_759_cov_9.192424	209	290	22	4	81	0.0493827
NODE_13713_length_759_cov_9.192424	209	290	24	2	81	0.0246914
NODE_13713_length_759_cov_9.192424	262	310	6	30	48	0.6250000
NODE_13713_length_759_cov_9.192424	262	310	7	1	48	0.0208333
NODE_13713_length_759_cov_9.192424	262	310	10	1	48	0.0208333
NODE_13713_length_759_cov_9.192424	262	310	12	6	48	0.1250000
NODE_13713_length_759_cov_9.192424	262	310	13	8	48	0.1666667
NODE_13713_length_759_cov_9.192424	262	310	15	2	48	0.0416667
NODE_13714_length_759_cov_8.771212	292	372	4	41	80	0.5125000
NODE_13714_length_759_cov_8.771212	292	372	6	19	80	0.2375000
NODE_13714_length_759_cov_8.771212	292	372	7	9	80	0.1125000
NODE_13714_length_759_cov_8.771212	292	372	9	11	80	0.1375000
NODE_13714_length_759_cov_8.771212	345	425	3	7	80	0.0875000
NODE_13714_length_759_cov_8.771212	345	425	5	26	80	0.3250000
NODE_13714_length_759_cov_8.771212	345	425	6	7	80	0.0875000
NODE_13714_length_759_cov_8.771212	345	425	7	23	80	0.2875000
NODE_13714_length_759_cov_8.771212	345	425	9	17	80	0.2125000
NODE_13715_length_759_cov_8.650000	324	404	0	80	80	1.0000000
NODE_13715_length_759_cov_8.650000	377	457	0	80	80	1.0000000
NODE_13716_length_759_cov_8.268182	604	684	0	80	80	1.0000000
NODE_13716_length_759_cov_8.268182	657	737	0	80	80	1.0000000
NODE_13717_length_759_cov_6.833333	381	461	0	80	80	1.0000000
NODE_13717_length_759_cov_6.833333	434	515	0	81	81	1.0000000
NODE_13718_length_759_cov_6.407576	319	399	0	80	80	1.0000000
NODE_13718_length_759_cov_6.407576	372	452	0	80	80	1.0000000
NODE_13725_length_759_cov_3.400000	355	435	0	80	80	1.0000000
NODE_13725_length_759_cov_3.400000	408	488	0	80	80	1.0000000
NODE_13726_length_759_cov_3.346970	240	322	0	10	82	0.1219512
NODE_13726_length_759_cov_3.346970	240	322	1	72	82	0.8780488
NODE_13760_length_758_cov_38.414264	215	295	0	34	80	0.4250000
NODE_13760_length_758_cov_38.414264	215	295	1	46	80	0.5750000
NODE_13760_length_758_cov_38.414264	268	348	1	32	80	0.4000000
NODE_13760_length_758_cov_38.414264	268	348	2	48	80	0.6000000
NODE_13760_length_758_cov_38.414264	344	424	1	25	80	0.3125000
NODE_13760_length_758_cov_38.414264	344	424	2	55	80	0.6875000
NODE_13760_length_758_cov_38.414264	397	477	0	27	80	0.3375000
NODE_13760_length_758_cov_38.414264	397	477	1	51	80	0.6375000
NODE_13760_length_758_cov_38.414264	397	477	2	2	80	0.0250000
NODE_13761_length_758_cov_36.722307	331	411	1	33	80	0.4125000
NODE_13761_length_758_cov_36.722307	331	411	2	17	80	0.2125000
NODE_13761_length_758_cov_36.722307	331	411	3	22	80	0.2750000
NODE_13761_length_758_cov_36.722307	331	411	4	8	80	0.1000000
NODE_13761_length_758_cov_36.722307	384	464	3	52	80	0.6500000
NODE_13761_length_758_cov_36.722307	384	464	4	28	80	0.3500000
NODE_13762_length_758_cov_29.910470	235	315	3	6	80	0.0750000
NODE_13762_length_758_cov_29.910470	235	315	4	38	80	0.4750000
NODE_13762_length_758_cov_29.910470	235	315	5	36	80	0.4500000
NODE_13762_length_758_cov_29.910470	288	368	2	8	80	0.1000000
NODE_13762_length_758_cov_29.910470	288	368	3	29	80	0.3625000
NODE_13762_length_758_cov_29.910470	288	368	4	43	80	0.5375000
NODE_13763_length_758_cov_16.226100	386	466	0	80	80	1.0000000
NODE_13763_length_758_cov_16.226100	439	519	0	80	80	1.0000000
NODE_13764_length_758_cov_16.097117	311	391	2	80	80	1.0000000
NODE_13764_length_758_cov_16.097117	364	444	0	8	80	0.1000000
NODE_13764_length_758_cov_16.097117	364	444	1	4	80	0.0500000
NODE_13764_length_758_cov_16.097117	364	444	2	68	80	0.8500000
NODE_13765_length_758_cov_15.525038	260	340	0	80	80	1.0000000
NODE_13765_length_758_cov_15.525038	313	393	0	80	80	1.0000000
NODE_13768_length_758_cov_9.153263	224	299	1	75	75	1.0000000
NODE_13771_length_758_cov_4.241275	508	588	1	10	80	0.1250000
NODE_13771_length_758_cov_4.241275	508	588	2	70	80	0.8750000
NODE_13772_length_758_cov_3.902883	346	426	0	80	80	1.0000000
NODE_13772_length_758_cov_3.902883	399	479	0	80	80	1.0000000
NODE_13794_length_757_cov_49.057751	155	235	5	74	80	0.9250000
NODE_13794_length_757_cov_49.057751	155	235	7	6	80	0.0750000
NODE_13794_length_757_cov_49.057751	208	288	2	28	80	0.3500000
NODE_13794_length_757_cov_49.057751	208	288	4	9	80	0.1125000
NODE_13794_length_757_cov_49.057751	208	288	5	43	80	0.5375000
NODE_13795_length_757_cov_29.954407	181	262	2	45	81	0.5555556
NODE_13795_length_757_cov_29.954407	181	262	3	36	81	0.4444444
NODE_13795_length_757_cov_29.954407	235	315	1	8	80	0.1000000
NODE_13795_length_757_cov_29.954407	235	315	2	72	80	0.9000000
NODE_13795_length_757_cov_29.954407	311	391	1	78	80	0.9750000
NODE_13795_length_757_cov_29.954407	311	391	2	2	80	0.0250000
NODE_13795_length_757_cov_29.954407	364	444	0	25	80	0.3125000
NODE_13795_length_757_cov_29.954407	364	444	1	55	80	0.6875000
NODE_13796_length_757_cov_25.565350	352	432	0	80	80	1.0000000
NODE_13796_length_757_cov_25.565350	405	483	0	78	78	1.0000000
NODE_13797_length_757_cov_18.338906	264	344	0	80	80	1.0000000
NODE_13797_length_757_cov_18.338906	317	397	0	80	80	1.0000000
NODE_13798_length_757_cov_15.879939	58	138	0	80	80	1.0000000
NODE_13798_length_757_cov_15.879939	111	191	0	80	80	1.0000000
NODE_13800_length_757_cov_15.291793	314	394	6	7	80	0.0875000
NODE_13800_length_757_cov_15.291793	314	394	7	8	80	0.1000000
NODE_13800_length_757_cov_15.291793	314	394	8	2	80	0.0250000
NODE_13800_length_757_cov_15.291793	314	394	9	3	80	0.0375000
NODE_13800_length_757_cov_15.291793	314	394	10	46	80	0.5750000
NODE_13800_length_757_cov_15.291793	314	394	11	14	80	0.1750000
NODE_13800_length_757_cov_15.291793	367	447	6	29	80	0.3625000
NODE_13800_length_757_cov_15.291793	367	447	7	3	80	0.0375000
NODE_13800_length_757_cov_15.291793	367	447	8	15	80	0.1875000
NODE_13800_length_757_cov_15.291793	367	447	9	9	80	0.1125000
NODE_13800_length_757_cov_15.291793	367	447	10	10	80	0.1250000
NODE_13800_length_757_cov_15.291793	367	447	11	14	80	0.1750000
NODE_13807_length_757_cov_3.182371	423	503	0	80	80	1.0000000
NODE_13807_length_757_cov_3.182371	476	556	0	80	80	1.0000000
NODE_13832_length_756_cov_26.441400	287	367	2	80	80	1.0000000
NODE_13832_length_756_cov_26.441400	340	420	0	9	80	0.1125000
NODE_13832_length_756_cov_26.441400	340	420	1	25	80	0.3125000
NODE_13832_length_756_cov_26.441400	340	420	2	46	80	0.5750000
NODE_13834_length_756_cov_13.097412	154	234	1	27	80	0.3375000
NODE_13834_length_756_cov_13.097412	154	234	2	53	80	0.6625000
NODE_13834_length_756_cov_13.097412	207	287	1	10	80	0.1250000
NODE_13834_length_756_cov_13.097412	207	287	2	70	80	0.8750000
NODE_13835_length_756_cov_12.732116	377	457	4	6	80	0.0750000
NODE_13835_length_756_cov_12.732116	377	457	6	21	80	0.2625000
NODE_13835_length_756_cov_12.732116	377	457	7	5	80	0.0625000
NODE_13835_length_756_cov_12.732116	377	457	8	2	80	0.0250000
NODE_13835_length_756_cov_12.732116	377	457	9	10	80	0.1250000
NODE_13835_length_756_cov_12.732116	377	457	10	18	80	0.2250000
NODE_13835_length_756_cov_12.732116	377	457	11	18	80	0.2250000
NODE_13836_length_756_cov_9.254186	241	321	0	9	80	0.1125000
NODE_13836_length_756_cov_9.254186	241	321	1	71	80	0.8875000
NODE_13836_length_756_cov_9.254186	294	374	0	62	80	0.7750000
NODE_13836_length_756_cov_9.254186	294	374	1	18	80	0.2250000
NODE_13837_length_756_cov_8.304414	363	409	0	11	46	0.2391304
NODE_13837_length_756_cov_8.304414	363	409	1	35	46	0.7608696
NODE_13838_length_756_cov_8.105023	271	351	5	47	80	0.5875000
NODE_13838_length_756_cov_8.105023	271	351	6	33	80	0.4125000
NODE_13838_length_756_cov_8.105023	324	404	0	2	80	0.0250000
NODE_13838_length_756_cov_8.105023	324	404	1	14	80	0.1750000
NODE_13838_length_756_cov_8.105023	324	404	2	7	80	0.0875000
NODE_13838_length_756_cov_8.105023	324	404	5	57	80	0.7125000
NODE_13840_length_756_cov_6.622527	431	511	2	80	80	1.0000000
NODE_13840_length_756_cov_6.622527	484	565	0	53	81	0.6543210
NODE_13840_length_756_cov_6.622527	484	565	2	28	81	0.3456790
NODE_13888_length_755_cov_64.705793	303	383	6	1	80	0.0125000
NODE_13888_length_755_cov_64.705793	303	383	7	32	80	0.4000000
NODE_13888_length_755_cov_64.705793	303	383	8	4	80	0.0500000
NODE_13888_length_755_cov_64.705793	303	383	10	7	80	0.0875000
NODE_13888_length_755_cov_64.705793	303	383	11	10	80	0.1250000
NODE_13888_length_755_cov_64.705793	303	383	12	26	80	0.3250000
NODE_13888_length_755_cov_64.705793	356	436	7	18	80	0.2250000
NODE_13888_length_755_cov_64.705793	356	436	9	25	80	0.3125000
NODE_13888_length_755_cov_64.705793	356	436	10	1	80	0.0125000
NODE_13888_length_755_cov_64.705793	356	436	11	20	80	0.2500000
NODE_13888_length_755_cov_64.705793	356	436	12	16	80	0.2000000
NODE_13889_length_755_cov_58.214939	425	505	0	36	80	0.4500000
NODE_13889_length_755_cov_58.214939	425	505	1	6	80	0.0750000
NODE_13889_length_755_cov_58.214939	425	505	2	38	80	0.4750000
NODE_13889_length_755_cov_58.214939	425	505	0	36	80	0.4500000
NODE_13889_length_755_cov_58.214939	425	505	1	6	80	0.0750000
NODE_13889_length_755_cov_58.214939	425	505	2	38	80	0.4750000
NODE_13889_length_755_cov_58.214939	478	556	0	78	78	1.0000000
NODE_13889_length_755_cov_58.214939	478	556	0	78	78	1.0000000
NODE_13890_length_755_cov_25.945122	237	317	0	80	80	1.0000000
NODE_13890_length_755_cov_25.945122	290	370	0	80	80	1.0000000
NODE_13891_length_755_cov_24.263720	334	414	4	65	80	0.8125000
NODE_13891_length_755_cov_24.263720	334	414	5	12	80	0.1500000
NODE_13891_length_755_cov_24.263720	334	414	6	3	80	0.0375000
NODE_13891_length_755_cov_24.263720	387	467	3	9	80	0.1125000
NODE_13891_length_755_cov_24.263720	387	467	4	19	80	0.2375000
NODE_13891_length_755_cov_24.263720	387	467	5	49	80	0.6125000
NODE_13891_length_755_cov_24.263720	387	467	6	3	80	0.0375000
NODE_13892_length_755_cov_15.559451	306	386	0	11	80	0.1375000
NODE_13892_length_755_cov_15.559451	306	386	1	1	80	0.0125000
NODE_13892_length_755_cov_15.559451	306	386	2	15	80	0.1875000
NODE_13892_length_755_cov_15.559451	306	386	4	53	80	0.6625000
NODE_13892_length_755_cov_15.559451	359	439	4	39	80	0.4875000
NODE_13892_length_755_cov_15.559451	359	439	6	41	80	0.5125000
NODE_13894_length_755_cov_10.196646	332	412	0	80	80	1.0000000
NODE_13894_length_755_cov_10.196646	385	465	0	80	80	1.0000000
NODE_13895_length_755_cov_9.772866	210	290	3	23	80	0.2875000
NODE_13895_length_755_cov_9.772866	210	290	4	57	80	0.7125000
NODE_13895_length_755_cov_9.772866	263	343	0	40	80	0.5000000
NODE_13895_length_755_cov_9.772866	263	343	1	6	80	0.0750000
NODE_13895_length_755_cov_9.772866	263	343	3	30	80	0.3750000
NODE_13895_length_755_cov_9.772866	263	343	4	4	80	0.0500000
NODE_13936_length_754_cov_87.432061	208	288	1	12	80	0.1500000
NODE_13936_length_754_cov_87.432061	208	288	2	68	80	0.8500000
NODE_13936_length_754_cov_87.432061	261	341	1	40	80	0.5000000
NODE_13936_length_754_cov_87.432061	261	341	2	40	80	0.5000000
NODE_13937_length_754_cov_16.549618	156	236	1	9	80	0.1125000
NODE_13937_length_754_cov_16.549618	156	236	2	46	80	0.5750000
NODE_13937_length_754_cov_16.549618	156	236	4	25	80	0.3125000
NODE_13937_length_754_cov_16.549618	209	289	2	2	80	0.0250000
NODE_13937_length_754_cov_16.549618	209	289	4	78	80	0.9750000
NODE_13939_length_754_cov_9.068702	316	396	0	80	80	1.0000000
NODE_13939_length_754_cov_9.068702	369	449	0	80	80	1.0000000
NODE_13940_length_754_cov_5.925191	287	367	0	80	80	1.0000000
NODE_13940_length_754_cov_5.925191	340	420	0	80	80	1.0000000
NODE_13974_length_753_cov_10.434251	386	466	1	20	80	0.2500000
NODE_13974_length_753_cov_10.434251	386	466	2	60	80	0.7500000
NODE_13974_length_753_cov_10.434251	439	519	1	55	80	0.6875000
NODE_13974_length_753_cov_10.434251	439	519	2	25	80	0.3125000
NODE_13976_length_753_cov_7.056575	344	424	1	73	80	0.9125000
NODE_13976_length_753_cov_7.056575	344	424	2	7	80	0.0875000
NODE_13976_length_753_cov_7.056575	397	477	1	80	80	1.0000000
NODE_13977_length_753_cov_4.597859	321	401	0	80	80	1.0000000
NODE_13977_length_753_cov_4.597859	374	454	0	80	80	1.0000000
NODE_14003_length_752_cov_66.281776	617	697	39	6	80	0.0750000
NODE_14003_length_752_cov_66.281776	617	697	40	1	80	0.0125000
NODE_14003_length_752_cov_66.281776	617	697	42	1	80	0.0125000
NODE_14003_length_752_cov_66.281776	617	697	44	1	80	0.0125000
NODE_14003_length_752_cov_66.281776	617	697	47	3	80	0.0375000
NODE_14003_length_752_cov_66.281776	617	697	49	2	80	0.0250000
NODE_14003_length_752_cov_66.281776	617	697	52	7	80	0.0875000
NODE_14003_length_752_cov_66.281776	617	697	53	1	80	0.0125000
NODE_14003_length_752_cov_66.281776	617	697	54	5	80	0.0625000
NODE_14003_length_752_cov_66.281776	617	697	55	4	80	0.0500000
NODE_14003_length_752_cov_66.281776	617	697	56	1	80	0.0125000
NODE_14003_length_752_cov_66.281776	617	697	57	4	80	0.0500000
NODE_14003_length_752_cov_66.281776	617	697	58	6	80	0.0750000
NODE_14003_length_752_cov_66.281776	617	697	59	4	80	0.0500000
NODE_14003_length_752_cov_66.281776	617	697	60	3	80	0.0375000
NODE_14003_length_752_cov_66.281776	617	697	61	5	80	0.0625000
NODE_14003_length_752_cov_66.281776	617	697	62	22	80	0.2750000
NODE_14003_length_752_cov_66.281776	617	697	63	3	80	0.0375000
NODE_14003_length_752_cov_66.281776	617	697	64	1	80	0.0125000
NODE_14003_length_752_cov_66.281776	670	751	6	6	81	0.0740741
NODE_14003_length_752_cov_66.281776	670	751	7	1	81	0.0123457
NODE_14003_length_752_cov_66.281776	670	751	8	1	81	0.0123457
NODE_14003_length_752_cov_66.281776	670	751	9	2	81	0.0246914
NODE_14003_length_752_cov_66.281776	670	751	10	7	81	0.0864198
NODE_14003_length_752_cov_66.281776	670	751	11	4	81	0.0493827
NODE_14003_length_752_cov_66.281776	670	751	12	2	81	0.0246914
NODE_14003_length_752_cov_66.281776	670	751	13	3	81	0.0370370
NODE_14003_length_752_cov_66.281776	670	751	15	2	81	0.0246914
NODE_14003_length_752_cov_66.281776	670	751	17	3	81	0.0370370
NODE_14003_length_752_cov_66.281776	670	751	19	1	81	0.0123457
NODE_14003_length_752_cov_66.281776	670	751	21	4	81	0.0493827
NODE_14003_length_752_cov_66.281776	670	751	25	1	81	0.0123457
NODE_14003_length_752_cov_66.281776	670	751	28	1	81	0.0123457
NODE_14003_length_752_cov_66.281776	670	751	29	3	81	0.0370370
NODE_14003_length_752_cov_66.281776	670	751	30	1	81	0.0123457
NODE_14003_length_752_cov_66.281776	670	751	32	6	81	0.0740741
NODE_14003_length_752_cov_66.281776	670	751	34	2	81	0.0246914
NODE_14003_length_752_cov_66.281776	670	751	36	3	81	0.0370370
NODE_14003_length_752_cov_66.281776	670	751	38	1	81	0.0123457
NODE_14003_length_752_cov_66.281776	670	751	39	6	81	0.0740741
NODE_14003_length_752_cov_66.281776	670	751	40	1	81	0.0123457
NODE_14003_length_752_cov_66.281776	670	751	42	1	81	0.0123457
NODE_14003_length_752_cov_66.281776	670	751	44	1	81	0.0123457
NODE_14003_length_752_cov_66.281776	670	751	47	3	81	0.0370370
NODE_14003_length_752_cov_66.281776	670	751	49	2	81	0.0246914
NODE_14003_length_752_cov_66.281776	670	751	52	7	81	0.0864198
NODE_14003_length_752_cov_66.281776	670	751	53	1	81	0.0123457
NODE_14003_length_752_cov_66.281776	670	751	54	5	81	0.0617284
NODE_14004_length_752_cov_60.274119	193	273	0	27	80	0.3375000
NODE_14004_length_752_cov_60.274119	193	273	2	53	80	0.6625000
NODE_14004_length_752_cov_60.274119	246	326	2	80	80	1.0000000
NODE_14005_length_752_cov_19.811639	299	379	0	80	80	1.0000000
NODE_14005_length_752_cov_19.811639	352	432	0	80	80	1.0000000
NODE_14006_length_752_cov_17.661562	118	198	0	42	80	0.5250000
NODE_14006_length_752_cov_17.661562	118	198	2	38	80	0.4750000
NODE_14006_length_752_cov_17.661562	171	251	0	3	80	0.0375000
NODE_14006_length_752_cov_17.661562	171	251	2	77	80	0.9625000
NODE_14007_length_752_cov_13.275651	241	321	6	3	80	0.0375000
NODE_14007_length_752_cov_13.275651	241	321	7	17	80	0.2125000
NODE_14007_length_752_cov_13.275651	241	321	8	30	80	0.3750000
NODE_14007_length_752_cov_13.275651	241	321	9	6	80	0.0750000
NODE_14007_length_752_cov_13.275651	241	321	10	6	80	0.0750000
NODE_14007_length_752_cov_13.275651	241	321	11	14	80	0.1750000
NODE_14007_length_752_cov_13.275651	241	321	12	4	80	0.0500000
NODE_14007_length_752_cov_13.275651	294	374	3	13	80	0.1625000
NODE_14007_length_752_cov_13.275651	294	374	5	7	80	0.0875000
NODE_14007_length_752_cov_13.275651	294	374	6	25	80	0.3125000
NODE_14007_length_752_cov_13.275651	294	374	7	25	80	0.3125000
NODE_14007_length_752_cov_13.275651	294	374	8	10	80	0.1250000
NODE_14008_length_752_cov_10.928025	313	393	6	6	80	0.0750000
NODE_14008_length_752_cov_10.928025	313	393	7	1	80	0.0125000
NODE_14008_length_752_cov_10.928025	313	393	8	8	80	0.1000000
NODE_14008_length_752_cov_10.928025	313	393	10	1	80	0.0125000
NODE_14008_length_752_cov_10.928025	313	393	12	1	80	0.0125000
NODE_14008_length_752_cov_10.928025	313	393	13	7	80	0.0875000
NODE_14008_length_752_cov_10.928025	313	393	14	12	80	0.1500000
NODE_14008_length_752_cov_10.928025	313	393	16	18	80	0.2250000
NODE_14008_length_752_cov_10.928025	313	393	17	2	80	0.0250000
NODE_14008_length_752_cov_10.928025	313	393	18	24	80	0.3000000
NODE_14011_length_752_cov_9.558959	249	329	0	48	80	0.6000000
NODE_14011_length_752_cov_9.558959	249	329	1	32	80	0.4000000
NODE_14011_length_752_cov_9.558959	302	382	0	39	80	0.4875000
NODE_14011_length_752_cov_9.558959	302	382	1	41	80	0.5125000
NODE_14014_length_752_cov_8.281776	237	317	0	33	80	0.4125000
NODE_14014_length_752_cov_8.281776	237	317	1	47	80	0.5875000
NODE_14014_length_752_cov_8.281776	290	370	1	48	80	0.6000000
NODE_14014_length_752_cov_8.281776	290	370	2	32	80	0.4000000
NODE_14015_length_752_cov_8.082695	352	432	0	80	80	1.0000000
NODE_14015_length_752_cov_8.082695	405	485	0	80	80	1.0000000
NODE_14044_length_751_cov_20.730061	238	318	0	80	80	1.0000000
NODE_14044_length_751_cov_20.730061	291	371	0	80	80	1.0000000
NODE_14045_length_751_cov_18.478528	328	409	1	6	81	0.0740741
NODE_14045_length_751_cov_18.478528	328	409	3	68	81	0.8395061
NODE_14045_length_751_cov_18.478528	328	409	4	7	81	0.0864198
NODE_14045_length_751_cov_18.478528	382	462	2	20	80	0.2500000
NODE_14045_length_751_cov_18.478528	382	462	3	25	80	0.3125000
NODE_14045_length_751_cov_18.478528	382	462	4	14	80	0.1750000
NODE_14045_length_751_cov_18.478528	382	462	5	21	80	0.2625000
NODE_14046_length_751_cov_13.016871	172	252	0	80	80	1.0000000
NODE_14046_length_751_cov_13.016871	225	305	0	80	80	1.0000000
NODE_14047_length_751_cov_12.363497	397	477	3	3	80	0.0375000
NODE_14047_length_751_cov_12.363497	397	477	4	41	80	0.5125000
NODE_14047_length_751_cov_12.363497	397	477	5	23	80	0.2875000
NODE_14047_length_751_cov_12.363497	397	477	6	13	80	0.1625000
NODE_14047_length_751_cov_12.363497	450	530	5	14	80	0.1750000
NODE_14047_length_751_cov_12.363497	450	530	6	42	80	0.5250000
NODE_14047_length_751_cov_12.363497	450	530	7	24	80	0.3000000
NODE_14085_length_750_cov_46.371736	396	476	3	3	80	0.0375000
NODE_14085_length_750_cov_46.371736	396	476	4	74	80	0.9250000
NODE_14085_length_750_cov_46.371736	396	476	5	3	80	0.0375000
NODE_14085_length_750_cov_46.371736	449	529	2	53	80	0.6625000
NODE_14085_length_750_cov_46.371736	449	529	4	27	80	0.3375000
NODE_14086_length_750_cov_24.428571	524	604	15	6	80	0.0750000
NODE_14086_length_750_cov_24.428571	524	604	16	2	80	0.0250000
NODE_14086_length_750_cov_24.428571	524	604	17	4	80	0.0500000
NODE_14086_length_750_cov_24.428571	524	604	18	2	80	0.0250000
NODE_14086_length_750_cov_24.428571	524	604	19	6	80	0.0750000
NODE_14086_length_750_cov_24.428571	524	604	20	2	80	0.0250000
NODE_14086_length_750_cov_24.428571	524	604	21	2	80	0.0250000
NODE_14086_length_750_cov_24.428571	524	604	22	3	80	0.0375000
NODE_14086_length_750_cov_24.428571	524	604	23	4	80	0.0500000
NODE_14086_length_750_cov_24.428571	524	604	24	3	80	0.0375000
NODE_14086_length_750_cov_24.428571	524	604	25	2	80	0.0250000
NODE_14086_length_750_cov_24.428571	524	604	26	1	80	0.0125000
NODE_14086_length_750_cov_24.428571	524	604	27	2	80	0.0250000
NODE_14086_length_750_cov_24.428571	524	604	28	8	80	0.1000000
NODE_14086_length_750_cov_24.428571	524	604	29	3	80	0.0375000
NODE_14086_length_750_cov_24.428571	524	604	30	1	80	0.0125000
NODE_14086_length_750_cov_24.428571	524	604	31	3	80	0.0375000
NODE_14086_length_750_cov_24.428571	524	604	32	14	80	0.1750000
NODE_14086_length_750_cov_24.428571	524	604	33	4	80	0.0500000
NODE_14086_length_750_cov_24.428571	524	604	34	8	80	0.1000000
NODE_14086_length_750_cov_24.428571	683	746	0	26	63	0.4126984
NODE_14086_length_750_cov_24.428571	683	746	1	32	63	0.5079365
NODE_14086_length_750_cov_24.428571	683	746	2	2	63	0.0317460
NODE_14086_length_750_cov_24.428571	683	746	3	3	63	0.0476190
NODE_14087_length_750_cov_24.311828	325	405	2	6	80	0.0750000
NODE_14087_length_750_cov_24.311828	325	405	3	8	80	0.1000000
NODE_14087_length_750_cov_24.311828	325	405	4	18	80	0.2250000
NODE_14087_length_750_cov_24.311828	325	405	5	48	80	0.6000000
NODE_14087_length_750_cov_24.311828	378	458	4	18	80	0.2250000
NODE_14087_length_750_cov_24.311828	378	458	5	33	80	0.4125000
NODE_14087_length_750_cov_24.311828	378	458	6	29	80	0.3625000
NODE_14089_length_750_cov_8.529954	336	416	3	12	80	0.1500000
NODE_14089_length_750_cov_8.529954	336	416	4	19	80	0.2375000
NODE_14089_length_750_cov_8.529954	336	416	5	49	80	0.6125000
NODE_14089_length_750_cov_8.529954	395	469	1	48	74	0.6486486
NODE_14089_length_750_cov_8.529954	395	469	3	13	74	0.1756757
NODE_14089_length_750_cov_8.529954	395	469	4	13	74	0.1756757
NODE_14137_length_749_cov_18.986154	221	301	3	14	80	0.1750000
NODE_14137_length_749_cov_18.986154	221	301	5	20	80	0.2500000
NODE_14137_length_749_cov_18.986154	221	301	9	25	80	0.3125000
NODE_14137_length_749_cov_18.986154	221	301	10	13	80	0.1625000
NODE_14137_length_749_cov_18.986154	221	301	11	8	80	0.1000000
NODE_14137_length_749_cov_18.986154	274	354	7	15	80	0.1875000
NODE_14137_length_749_cov_18.986154	274	354	8	7	80	0.0875000
NODE_14137_length_749_cov_18.986154	274	354	9	14	80	0.1750000
NODE_14137_length_749_cov_18.986154	274	354	10	13	80	0.1625000
NODE_14137_length_749_cov_18.986154	274	354	11	31	80	0.3875000
NODE_14138_length_749_cov_18.836923	273	355	0	62	82	0.7560976
NODE_14138_length_749_cov_18.836923	273	355	2	20	82	0.2439024
NODE_14138_length_749_cov_18.836923	328	408	0	7	80	0.0875000
NODE_14138_length_749_cov_18.836923	328	408	2	73	80	0.9125000
NODE_14138_length_749_cov_18.836923	404	484	2	44	80	0.5500000
NODE_14138_length_749_cov_18.836923	404	484	4	36	80	0.4500000
NODE_14138_length_749_cov_18.836923	457	535	2	78	78	1.0000000
NODE_14139_length_749_cov_16.160000	232	253	0	21	21	1.0000000
NODE_14139_length_749_cov_16.160000	232	306	0	74	74	1.0000000
NODE_14140_length_749_cov_16.115385	307	387	2	80	80	1.0000000
NODE_14140_length_749_cov_16.115385	360	440	0	34	80	0.4250000
NODE_14140_length_749_cov_16.115385	360	440	2	46	80	0.5750000
NODE_14141_length_749_cov_11.210769	340	420	0	34	80	0.4250000
NODE_14141_length_749_cov_11.210769	340	420	1	25	80	0.3125000
NODE_14141_length_749_cov_11.210769	340	420	2	9	80	0.1125000
NODE_14141_length_749_cov_11.210769	340	420	3	12	80	0.1500000
NODE_14141_length_749_cov_11.210769	393	473	1	6	80	0.0750000
NODE_14141_length_749_cov_11.210769	393	473	2	9	80	0.1125000
NODE_14141_length_749_cov_11.210769	393	473	3	18	80	0.2250000
NODE_14141_length_749_cov_11.210769	393	473	4	47	80	0.5875000
NODE_14142_length_749_cov_8.424615	372	452	0	80	80	1.0000000
NODE_14142_length_749_cov_8.424615	425	505	0	80	80	1.0000000
NODE_14145_length_749_cov_4.521538	550	630	0	80	80	1.0000000
NODE_14145_length_749_cov_4.521538	603	683	0	80	80	1.0000000
NODE_14185_length_748_cov_55.348228	393	473	0	38	80	0.4750000
NODE_14185_length_748_cov_55.348228	393	473	1	42	80	0.5250000
NODE_14185_length_748_cov_55.348228	446	526	1	73	80	0.9125000
NODE_14185_length_748_cov_55.348228	446	526	2	7	80	0.0875000
NODE_14186_length_748_cov_51.838213	369	449	0	22	80	0.2750000
NODE_14186_length_748_cov_51.838213	369	449	2	7	80	0.0875000
NODE_14186_length_748_cov_51.838213	369	449	3	8	80	0.1000000
NODE_14186_length_748_cov_51.838213	369	449	4	18	80	0.2250000
NODE_14186_length_748_cov_51.838213	369	449	5	25	80	0.3125000
NODE_14186_length_748_cov_51.838213	422	502	4	2	80	0.0250000
NODE_14186_length_748_cov_51.838213	422	502	5	27	80	0.3375000
NODE_14186_length_748_cov_51.838213	422	502	7	51	80	0.6375000
NODE_14187_length_748_cov_46.952234	293	373	3	29	80	0.3625000
NODE_14187_length_748_cov_46.952234	293	373	5	6	80	0.0750000
NODE_14187_length_748_cov_46.952234	293	373	6	11	80	0.1375000
NODE_14187_length_748_cov_46.952234	293	373	8	34	80	0.4250000
NODE_14187_length_748_cov_46.952234	346	426	5	6	80	0.0750000
NODE_14187_length_748_cov_46.952234	346	426	7	12	80	0.1500000
NODE_14187_length_748_cov_46.952234	346	426	8	62	80	0.7750000
NODE_14188_length_748_cov_45.001541	272	352	1	5	80	0.0625000
NODE_14188_length_748_cov_45.001541	272	352	3	8	80	0.1000000
NODE_14188_length_748_cov_45.001541	272	352	4	18	80	0.2250000
NODE_14188_length_748_cov_45.001541	272	352	5	49	80	0.6125000
NODE_14188_length_748_cov_45.001541	325	405	4	5	80	0.0625000
NODE_14188_length_748_cov_45.001541	325	405	5	75	80	0.9375000
NODE_14189_length_748_cov_34.355932	488	568	5	3	80	0.0375000
NODE_14189_length_748_cov_34.355932	488	568	6	67	80	0.8375000
NODE_14189_length_748_cov_34.355932	488	568	7	10	80	0.1250000
NODE_14189_length_748_cov_34.355932	541	621	4	8	80	0.1000000
NODE_14189_length_748_cov_34.355932	541	621	5	9	80	0.1125000
NODE_14189_length_748_cov_34.355932	541	621	6	58	80	0.7250000
NODE_14189_length_748_cov_34.355932	541	621	7	5	80	0.0625000
NODE_14190_length_748_cov_25.972265	297	377	0	80	80	1.0000000
NODE_14190_length_748_cov_25.972265	350	430	0	80	80	1.0000000
NODE_14191_length_748_cov_21.050847	362	442	0	80	80	1.0000000
NODE_14191_length_748_cov_21.050847	415	495	0	80	80	1.0000000
NODE_14192_length_748_cov_20.682589	353	433	0	80	80	1.0000000
NODE_14192_length_748_cov_20.682589	406	486	0	80	80	1.0000000
NODE_14193_length_748_cov_19.081664	261	341	0	80	80	1.0000000
NODE_14193_length_748_cov_19.081664	314	394	0	40	80	0.5000000
NODE_14193_length_748_cov_19.081664	314	394	2	40	80	0.5000000
NODE_14193_length_748_cov_19.081664	390	470	0	22	80	0.2750000
NODE_14193_length_748_cov_19.081664	390	470	2	58	80	0.7250000
NODE_14193_length_748_cov_19.081664	443	522	0	74	79	0.9367089
NODE_14193_length_748_cov_19.081664	443	522	2	5	79	0.0632911
NODE_14194_length_748_cov_16.579353	81	161	2	8	80	0.1000000
NODE_14194_length_748_cov_16.579353	81	161	3	26	80	0.3250000
NODE_14194_length_748_cov_16.579353	81	161	4	27	80	0.3375000
NODE_14194_length_748_cov_16.579353	81	161	5	19	80	0.2375000
NODE_14194_length_748_cov_16.579353	134	214	4	9	80	0.1125000
NODE_14194_length_748_cov_16.579353	134	214	5	26	80	0.3250000
NODE_14194_length_748_cov_16.579353	134	214	6	4	80	0.0500000
NODE_14194_length_748_cov_16.579353	134	214	7	1	80	0.0125000
NODE_14194_length_748_cov_16.579353	134	214	8	40	80	0.5000000
NODE_14194_length_748_cov_16.579353	210	290	8	12	80	0.1500000
NODE_14194_length_748_cov_16.579353	210	290	9	28	80	0.3500000
NODE_14194_length_748_cov_16.579353	210	290	10	2	80	0.0250000
NODE_14194_length_748_cov_16.579353	210	290	11	3	80	0.0375000
NODE_14194_length_748_cov_16.579353	210	290	12	26	80	0.3250000
NODE_14194_length_748_cov_16.579353	210	290	13	9	80	0.1125000
NODE_14194_length_748_cov_16.579353	263	343	6	19	80	0.2375000
NODE_14194_length_748_cov_16.579353	263	343	7	1	80	0.0125000
NODE_14194_length_748_cov_16.579353	263	343	8	31	80	0.3875000
NODE_14194_length_748_cov_16.579353	263	343	9	25	80	0.3125000
NODE_14194_length_748_cov_16.579353	263	343	11	2	80	0.0250000
NODE_14194_length_748_cov_16.579353	263	343	12	2	80	0.0250000
NODE_14196_length_748_cov_11.983051	375	455	0	80	80	1.0000000
NODE_14196_length_748_cov_11.983051	428	508	0	80	80	1.0000000
NODE_14197_length_748_cov_11.474576	257	337	5	4	80	0.0500000
NODE_14197_length_748_cov_11.474576	257	337	6	76	80	0.9500000
NODE_14197_length_748_cov_11.474576	310	390	3	17	80	0.2125000
NODE_14197_length_748_cov_11.474576	310	390	4	35	80	0.4375000
NODE_14197_length_748_cov_11.474576	310	390	6	28	80	0.3500000
NODE_14200_length_748_cov_7.979969	223	303	1	61	80	0.7625000
NODE_14200_length_748_cov_7.979969	223	303	2	19	80	0.2375000
NODE_14200_length_748_cov_7.979969	276	356	1	44	80	0.5500000
NODE_14200_length_748_cov_7.979969	276	356	2	36	80	0.4500000
NODE_14240_length_747_cov_24.279321	205	285	1	7	80	0.0875000
NODE_14240_length_747_cov_24.279321	205	285	2	73	80	0.9125000
NODE_14240_length_747_cov_24.279321	258	338	1	7	80	0.0875000
NODE_14240_length_747_cov_24.279321	258	338	2	63	80	0.7875000
NODE_14240_length_747_cov_24.279321	258	338	3	10	80	0.1250000
NODE_14241_length_747_cov_15.438272	352	432	0	31	80	0.3875000
NODE_14241_length_747_cov_15.438272	352	432	2	49	80	0.6125000
NODE_14241_length_747_cov_15.438272	405	485	0	80	80	1.0000000
NODE_14244_length_747_cov_7.979938	237	317	0	80	80	1.0000000
NODE_14244_length_747_cov_7.979938	290	370	0	80	80	1.0000000
NODE_14248_length_747_cov_4.918210	157	237	0	80	80	1.0000000
NODE_14248_length_747_cov_4.918210	210	290	0	80	80	1.0000000
NODE_14277_length_746_cov_44.041731	153	233	3	37	80	0.4625000
NODE_14277_length_746_cov_44.041731	153	233	4	43	80	0.5375000
NODE_14277_length_746_cov_44.041731	206	286	3	77	80	0.9625000
NODE_14277_length_746_cov_44.041731	206	286	4	3	80	0.0375000
NODE_14278_length_746_cov_24.435858	334	414	0	80	80	1.0000000
NODE_14278_length_746_cov_24.435858	387	467	0	80	80	1.0000000
NODE_14279_length_746_cov_20.225657	114	194	0	13	80	0.1625000
NODE_14279_length_746_cov_20.225657	114	194	1	12	80	0.1500000
NODE_14279_length_746_cov_20.225657	114	194	2	55	80	0.6875000
NODE_14279_length_746_cov_20.225657	167	247	2	80	80	1.0000000
NODE_14280_length_746_cov_17.919629	330	410	0	80	80	1.0000000
NODE_14280_length_746_cov_17.919629	383	463	0	80	80	1.0000000
NODE_14281_length_746_cov_17.523957	292	372	2	62	80	0.7750000
NODE_14281_length_746_cov_17.523957	292	372	3	18	80	0.2250000
NODE_14281_length_746_cov_17.523957	345	425	1	28	80	0.3500000
NODE_14281_length_746_cov_17.523957	345	425	2	36	80	0.4500000
NODE_14281_length_746_cov_17.523957	345	425	3	16	80	0.2000000
NODE_14282_length_746_cov_17.214838	306	386	0	80	80	1.0000000
NODE_14282_length_746_cov_17.214838	359	439	0	80	80	1.0000000
NODE_14283_length_746_cov_16.765070	344	424	0	80	80	1.0000000
NODE_14283_length_746_cov_16.765070	397	477	0	80	80	1.0000000
NODE_14284_length_746_cov_13.153014	126	206	0	29	80	0.3625000
NODE_14284_length_746_cov_13.153014	126	206	1	7	80	0.0875000
NODE_14284_length_746_cov_13.153014	126	206	2	44	80	0.5500000
NODE_14284_length_746_cov_13.153014	179	259	2	80	80	1.0000000
NODE_14284_length_746_cov_13.153014	244	263	2	19	19	1.0000000
NODE_14285_length_746_cov_12.316847	364	442	0	78	78	1.0000000
NODE_14286_length_746_cov_11.301391	349	429	0	80	80	1.0000000
NODE_14286_length_746_cov_11.301391	402	482	0	80	80	1.0000000
NODE_14302_length_746_cov_2.639876	331	411	0	80	80	1.0000000
NODE_14307_length_746_cov_1.879444	435	502	1	30	67	0.4477612
NODE_14307_length_746_cov_1.879444	435	502	2	37	67	0.5522388
NODE_14310_length_746_cov_1.727975	65	121	0	56	56	1.0000000
NODE_14310_length_746_cov_1.727975	494	540	2	46	46	1.0000000
NODE_14329_length_745_cov_40.360681	257	337	1	1	80	0.0125000
NODE_14329_length_745_cov_40.360681	257	337	2	79	80	0.9875000
NODE_14329_length_745_cov_40.360681	310	390	1	40	80	0.5000000
NODE_14329_length_745_cov_40.360681	310	390	2	40	80	0.5000000
NODE_14330_length_745_cov_30.817337	339	419	2	34	80	0.4250000
NODE_14330_length_745_cov_30.817337	339	419	4	46	80	0.5750000
NODE_14330_length_745_cov_30.817337	392	459	0	16	67	0.2388060
NODE_14330_length_745_cov_30.817337	392	459	2	47	67	0.7014925
NODE_14330_length_745_cov_30.817337	392	459	4	4	67	0.0597015
NODE_14335_length_745_cov_8.620743	225	275	0	50	50	1.0000000
NODE_14335_length_745_cov_8.620743	248	328	0	80	80	1.0000000
NODE_14343_length_745_cov_3.922601	249	280	33	20	31	0.6451613
NODE_14343_length_745_cov_3.922601	249	280	34	11	31	0.3548387
NODE_14343_length_745_cov_3.922601	253	333	27	6	80	0.0750000
NODE_14343_length_745_cov_3.922601	253	333	28	2	80	0.0250000
NODE_14343_length_745_cov_3.922601	253	333	29	4	80	0.0500000
NODE_14343_length_745_cov_3.922601	253	333	30	2	80	0.0250000
NODE_14343_length_745_cov_3.922601	253	333	31	4	80	0.0500000
NODE_14343_length_745_cov_3.922601	253	333	32	9	80	0.1125000
NODE_14343_length_745_cov_3.922601	253	333	33	32	80	0.4000000
NODE_14343_length_745_cov_3.922601	253	333	34	17	80	0.2125000
NODE_14343_length_745_cov_3.922601	253	333	35	4	80	0.0500000
NODE_14381_length_744_cov_44.953488	553	633	7	1	80	0.0125000
NODE_14381_length_744_cov_44.953488	553	633	8	2	80	0.0250000
NODE_14381_length_744_cov_44.953488	553	633	9	21	80	0.2625000
NODE_14381_length_744_cov_44.953488	553	633	10	2	80	0.0250000
NODE_14381_length_744_cov_44.953488	553	633	11	30	80	0.3750000
NODE_14381_length_744_cov_44.953488	553	633	12	1	80	0.0125000
NODE_14381_length_744_cov_44.953488	553	633	13	1	80	0.0125000
NODE_14381_length_744_cov_44.953488	553	633	14	5	80	0.0625000
NODE_14381_length_744_cov_44.953488	553	633	15	2	80	0.0250000
NODE_14381_length_744_cov_44.953488	553	633	17	15	80	0.1875000
NODE_14381_length_744_cov_44.953488	553	633	7	1	80	0.0125000
NODE_14381_length_744_cov_44.953488	553	633	8	2	80	0.0250000
NODE_14381_length_744_cov_44.953488	553	633	9	21	80	0.2625000
NODE_14381_length_744_cov_44.953488	553	633	10	2	80	0.0250000
NODE_14381_length_744_cov_44.953488	553	633	11	30	80	0.3750000
NODE_14381_length_744_cov_44.953488	553	633	12	1	80	0.0125000
NODE_14381_length_744_cov_44.953488	553	633	13	1	80	0.0125000
NODE_14381_length_744_cov_44.953488	553	633	14	5	80	0.0625000
NODE_14381_length_744_cov_44.953488	553	633	15	2	80	0.0250000
NODE_14381_length_744_cov_44.953488	553	633	17	15	80	0.1875000
NODE_14381_length_744_cov_44.953488	553	633	7	1	80	0.0125000
NODE_14381_length_744_cov_44.953488	553	633	8	2	80	0.0250000
NODE_14381_length_744_cov_44.953488	553	633	9	21	80	0.2625000
NODE_14381_length_744_cov_44.953488	553	633	10	2	80	0.0250000
NODE_14381_length_744_cov_44.953488	553	633	11	30	80	0.3750000
NODE_14381_length_744_cov_44.953488	553	633	12	1	80	0.0125000
NODE_14381_length_744_cov_44.953488	553	633	13	1	80	0.0125000
NODE_14381_length_744_cov_44.953488	553	633	14	5	80	0.0625000
NODE_14381_length_744_cov_44.953488	553	633	15	2	80	0.0250000
NODE_14381_length_744_cov_44.953488	553	633	17	15	80	0.1875000
NODE_14381_length_744_cov_44.953488	553	633	7	1	80	0.0125000
NODE_14381_length_744_cov_44.953488	553	633	8	2	80	0.0250000
NODE_14381_length_744_cov_44.953488	553	633	9	21	80	0.2625000
NODE_14381_length_744_cov_44.953488	553	633	10	2	80	0.0250000
NODE_14381_length_744_cov_44.953488	553	633	11	30	80	0.3750000
NODE_14381_length_744_cov_44.953488	553	633	12	1	80	0.0125000
NODE_14381_length_744_cov_44.953488	553	633	13	1	80	0.0125000
NODE_14381_length_744_cov_44.953488	553	633	14	5	80	0.0625000
NODE_14381_length_744_cov_44.953488	553	633	15	2	80	0.0250000
NODE_14381_length_744_cov_44.953488	553	633	17	15	80	0.1875000
NODE_14382_length_744_cov_35.333333	163	243	0	14	80	0.1750000
NODE_14382_length_744_cov_35.333333	163	243	1	5	80	0.0625000
NODE_14382_length_744_cov_35.333333	163	243	2	25	80	0.3125000
NODE_14382_length_744_cov_35.333333	163	243	3	17	80	0.2125000
NODE_14382_length_744_cov_35.333333	163	243	4	4	80	0.0500000
NODE_14382_length_744_cov_35.333333	163	243	5	5	80	0.0625000
NODE_14382_length_744_cov_35.333333	163	243	6	10	80	0.1250000
NODE_14382_length_744_cov_35.333333	216	296	3	8	80	0.1000000
NODE_14382_length_744_cov_35.333333	216	296	4	4	80	0.0500000
NODE_14382_length_744_cov_35.333333	216	296	5	5	80	0.0625000
NODE_14382_length_744_cov_35.333333	216	296	6	28	80	0.3500000
NODE_14382_length_744_cov_35.333333	216	296	7	35	80	0.4375000
NODE_14382_length_744_cov_35.333333	292	372	5	20	80	0.2500000
NODE_14382_length_744_cov_35.333333	292	372	6	25	80	0.3125000
NODE_14382_length_744_cov_35.333333	292	372	7	35	80	0.4375000
NODE_14382_length_744_cov_35.333333	345	425	2	26	80	0.3250000
NODE_14382_length_744_cov_35.333333	345	425	3	21	80	0.2625000
NODE_14382_length_744_cov_35.333333	345	425	4	4	80	0.0500000
NODE_14382_length_744_cov_35.333333	345	425	5	17	80	0.2125000
NODE_14382_length_744_cov_35.333333	345	425	6	12	80	0.1500000
NODE_14383_length_744_cov_34.503876	294	374	3	80	80	1.0000000
NODE_14383_length_744_cov_34.503876	347	427	0	4	80	0.0500000
NODE_14383_length_744_cov_34.503876	347	427	2	17	80	0.2125000
NODE_14383_length_744_cov_34.503876	347	427	3	59	80	0.7375000
NODE_14384_length_744_cov_32.282171	333	403	0	23	70	0.3285714
NODE_14384_length_744_cov_32.282171	333	403	1	21	70	0.3000000
NODE_14384_length_744_cov_32.282171	333	403	2	20	70	0.2857143
NODE_14384_length_744_cov_32.282171	333	403	3	5	70	0.0714286
NODE_14384_length_744_cov_32.282171	333	403	5	1	70	0.0142857
NODE_14384_length_744_cov_32.282171	440	520	0	80	80	1.0000000
NODE_14384_length_744_cov_32.282171	493	573	0	80	80	1.0000000
NODE_14390_length_744_cov_4.537984	260	340	0	80	80	1.0000000
NODE_14390_length_744_cov_4.537984	313	393	0	80	80	1.0000000
NODE_14396_length_744_cov_2.784496	335	387	0	3	52	0.0576923
NODE_14396_length_744_cov_2.784496	335	387	1	40	52	0.7692308
NODE_14396_length_744_cov_2.784496	335	387	2	1	52	0.0192308
NODE_14396_length_744_cov_2.784496	335	387	3	1	52	0.0192308
NODE_14396_length_744_cov_2.784496	335	387	4	7	52	0.1346154
NODE_14396_length_744_cov_2.784496	360	437	1	18	77	0.2337662
NODE_14396_length_744_cov_2.784496	360	437	2	1	77	0.0129870
NODE_14396_length_744_cov_2.784496	360	437	3	1	77	0.0129870
NODE_14396_length_744_cov_2.784496	360	437	4	12	77	0.1558442
NODE_14396_length_744_cov_2.784496	360	437	6	1	77	0.0129870
NODE_14396_length_744_cov_2.784496	360	437	7	44	77	0.5714286
NODE_14427_length_743_cov_26.369565	354	434	0	47	80	0.5875000
NODE_14427_length_743_cov_26.369565	354	434	1	1	80	0.0125000
NODE_14427_length_743_cov_26.369565	354	434	2	32	80	0.4000000
NODE_14427_length_743_cov_26.369565	407	487	2	43	80	0.5375000
NODE_14427_length_743_cov_26.369565	407	487	3	3	80	0.0375000
NODE_14427_length_743_cov_26.369565	407	487	4	34	80	0.4250000
NODE_14428_length_743_cov_21.759317	138	218	0	80	80	1.0000000
NODE_14428_length_743_cov_21.759317	191	271	0	80	80	1.0000000
NODE_14429_length_743_cov_18.173913	213	293	2	50	80	0.6250000
NODE_14429_length_743_cov_18.173913	213	293	3	30	80	0.3750000
NODE_14429_length_743_cov_18.173913	266	346	1	10	80	0.1250000
NODE_14429_length_743_cov_18.173913	266	346	2	70	80	0.8750000
NODE_14431_length_743_cov_17.066770	400	480	1	70	80	0.8750000
NODE_14431_length_743_cov_17.066770	400	480	2	10	80	0.1250000
NODE_14431_length_743_cov_17.066770	453	532	1	24	79	0.3037975
NODE_14431_length_743_cov_17.066770	453	532	2	55	79	0.6962025
NODE_14432_length_743_cov_16.354037	350	430	2	32	80	0.4000000
NODE_14432_length_743_cov_16.354037	350	430	3	29	80	0.3625000
NODE_14432_length_743_cov_16.354037	350	430	4	19	80	0.2375000
NODE_14432_length_743_cov_16.354037	403	483	2	8	80	0.1000000
NODE_14432_length_743_cov_16.354037	403	483	4	72	80	0.9000000
NODE_14433_length_743_cov_15.667702	220	300	0	80	80	1.0000000
NODE_14433_length_743_cov_15.667702	273	353	0	80	80	1.0000000
NODE_14433_length_743_cov_15.667702	349	429	0	15	80	0.1875000
NODE_14433_length_743_cov_15.667702	349	429	2	65	80	0.8125000
NODE_14433_length_743_cov_15.667702	402	482	2	44	80	0.5500000
NODE_14433_length_743_cov_15.667702	402	482	4	36	80	0.4500000
NODE_14434_length_743_cov_14.975155	289	362	2	73	73	1.0000000
NODE_14435_length_743_cov_14.100932	232	312	0	60	80	0.7500000
NODE_14435_length_743_cov_14.100932	232	312	1	20	80	0.2500000
NODE_14435_length_743_cov_14.100932	285	365	0	7	80	0.0875000
NODE_14435_length_743_cov_14.100932	285	365	1	29	80	0.3625000
NODE_14435_length_743_cov_14.100932	285	365	2	3	80	0.0375000
NODE_14435_length_743_cov_14.100932	285	365	3	41	80	0.5125000
NODE_14435_length_743_cov_14.100932	361	441	3	80	80	1.0000000
NODE_14435_length_743_cov_14.100932	414	494	0	21	80	0.2625000
NODE_14435_length_743_cov_14.100932	414	494	1	3	80	0.0375000
NODE_14435_length_743_cov_14.100932	414	494	2	29	80	0.3625000
NODE_14435_length_743_cov_14.100932	414	494	3	27	80	0.3375000
NODE_14436_length_743_cov_12.968944	268	348	0	10	80	0.1250000
NODE_14436_length_743_cov_12.968944	268	348	1	14	80	0.1750000
NODE_14436_length_743_cov_12.968944	268	348	2	23	80	0.2875000
NODE_14436_length_743_cov_12.968944	268	348	3	1	80	0.0125000
NODE_14436_length_743_cov_12.968944	268	348	4	32	80	0.4000000
NODE_14436_length_743_cov_12.968944	321	401	4	65	80	0.8125000
NODE_14436_length_743_cov_12.968944	321	401	5	15	80	0.1875000
NODE_14437_length_743_cov_12.847826	485	565	2	9	80	0.1125000
NODE_14437_length_743_cov_12.847826	485	565	4	49	80	0.6125000
NODE_14437_length_743_cov_12.847826	485	565	5	22	80	0.2750000
NODE_14437_length_743_cov_12.847826	538	618	1	10	80	0.1250000
NODE_14437_length_743_cov_12.847826	538	618	2	20	80	0.2500000
NODE_14437_length_743_cov_12.847826	538	618	3	32	80	0.4000000
NODE_14437_length_743_cov_12.847826	538	618	4	18	80	0.2250000
NODE_14438_length_743_cov_11.871118	403	483	1	67	80	0.8375000
NODE_14438_length_743_cov_11.871118	403	483	2	13	80	0.1625000
NODE_14438_length_743_cov_11.871118	456	536	1	72	80	0.9000000
NODE_14438_length_743_cov_11.871118	456	536	2	8	80	0.1000000
NODE_14439_length_743_cov_11.760870	337	417	3	79	80	0.9875000
NODE_14439_length_743_cov_11.760870	337	417	4	1	80	0.0125000
NODE_14439_length_743_cov_11.760870	390	470	0	20	80	0.2500000
NODE_14439_length_743_cov_11.760870	390	470	2	25	80	0.3125000
NODE_14439_length_743_cov_11.760870	390	470	3	35	80	0.4375000
NODE_14440_length_743_cov_9.006211	351	431	2	56	80	0.7000000
NODE_14440_length_743_cov_9.006211	351	431	3	9	80	0.1125000
NODE_14440_length_743_cov_9.006211	351	431	4	15	80	0.1875000
NODE_14440_length_743_cov_9.006211	404	484	1	17	80	0.2125000
NODE_14440_length_743_cov_9.006211	404	484	2	63	80	0.7875000
NODE_14441_length_743_cov_8.063665	290	370	1	32	80	0.4000000
NODE_14441_length_743_cov_8.063665	290	370	2	48	80	0.6000000
NODE_14441_length_743_cov_8.063665	343	423	1	30	80	0.3750000
NODE_14441_length_743_cov_8.063665	343	423	2	50	80	0.6250000
NODE_14456_length_743_cov_2.029503	260	284	0	7	24	0.2916667
NODE_14456_length_743_cov_2.029503	260	284	1	17	24	0.7083333
NODE_14456_length_743_cov_2.029503	301	363	0	62	62	1.0000000
NODE_14473_length_743_cov_0.989130	592	670	0	4	78	0.0512821
NODE_14473_length_743_cov_0.989130	592	670	1	4	78	0.0512821
NODE_14473_length_743_cov_0.989130	592	670	2	5	78	0.0641026
NODE_14473_length_743_cov_0.989130	592	670	4	2	78	0.0256410
NODE_14473_length_743_cov_0.989130	592	670	6	3	78	0.0384615
NODE_14473_length_743_cov_0.989130	592	670	11	6	78	0.0769231
NODE_14473_length_743_cov_0.989130	592	670	13	17	78	0.2179487
NODE_14473_length_743_cov_0.989130	592	670	15	34	78	0.4358974
NODE_14473_length_743_cov_0.989130	592	670	16	3	78	0.0384615
NODE_14477_length_742_cov_23.664075	271	351	2	42	80	0.5250000
NODE_14477_length_742_cov_23.664075	271	351	3	38	80	0.4750000
NODE_14477_length_742_cov_23.664075	324	404	2	16	80	0.2000000
NODE_14477_length_742_cov_23.664075	324	404	3	64	80	0.8000000
NODE_14478_length_742_cov_19.488336	288	368	0	80	80	1.0000000
NODE_14478_length_742_cov_19.488336	341	421	0	80	80	1.0000000
NODE_14479_length_742_cov_18.528771	319	399	0	17	80	0.2125000
NODE_14479_length_742_cov_18.528771	319	399	1	63	80	0.7875000
NODE_14479_length_742_cov_18.528771	372	452	1	80	80	1.0000000
NODE_14480_length_742_cov_17.401244	126	206	1	33	80	0.4125000
NODE_14480_length_742_cov_17.401244	126	206	2	27	80	0.3375000
NODE_14480_length_742_cov_17.401244	126	206	4	20	80	0.2500000
NODE_14480_length_742_cov_17.401244	179	259	2	7	80	0.0875000
NODE_14480_length_742_cov_17.401244	179	259	3	10	80	0.1250000
NODE_14480_length_742_cov_17.401244	179	259	4	63	80	0.7875000
NODE_14482_length_742_cov_7.679627	274	354	0	7	80	0.0875000
NODE_14482_length_742_cov_7.679627	274	354	1	73	80	0.9125000
NODE_14482_length_742_cov_7.679627	327	407	0	3	80	0.0375000
NODE_14482_length_742_cov_7.679627	327	407	1	77	80	0.9625000
NODE_14521_length_741_cov_12.168224	316	392	0	10	76	0.1315790
NODE_14521_length_741_cov_12.168224	316	392	1	17	76	0.2236842
NODE_14521_length_741_cov_12.168224	316	392	2	49	76	0.6447368
NODE_14521_length_741_cov_12.168224	598	663	1	8	65	0.1230769
NODE_14521_length_741_cov_12.168224	598	663	2	57	65	0.8769231
NODE_14522_length_741_cov_8.542056	198	278	0	80	80	1.0000000
NODE_14522_length_741_cov_8.542056	251	331	0	80	80	1.0000000
NODE_14525_length_741_cov_5.989097	457	538	10	6	81	0.0740741
NODE_14525_length_741_cov_5.989097	457	538	11	5	81	0.0617284
NODE_14525_length_741_cov_5.989097	457	538	13	6	81	0.0740741
NODE_14525_length_741_cov_5.989097	457	538	15	1	81	0.0123457
NODE_14525_length_741_cov_5.989097	457	538	17	49	81	0.6049383
NODE_14525_length_741_cov_5.989097	457	538	18	14	81	0.1728395
NODE_14536_length_741_cov_2.556075	212	289	0	75	77	0.9740260
NODE_14536_length_741_cov_2.556075	212	289	3	1	77	0.0129870
NODE_14536_length_741_cov_2.556075	212	289	4	1	77	0.0129870
NODE_14571_length_740_cov_54.372855	192	272	5	9	80	0.1125000
NODE_14571_length_740_cov_54.372855	192	272	7	31	80	0.3875000
NODE_14571_length_740_cov_54.372855	192	272	8	34	80	0.4250000
NODE_14571_length_740_cov_54.372855	192	272	9	6	80	0.0750000
NODE_14571_length_740_cov_54.372855	245	325	6	35	80	0.4375000
NODE_14571_length_740_cov_54.372855	245	325	7	1	80	0.0125000
NODE_14571_length_740_cov_54.372855	245	325	8	44	80	0.5500000
NODE_14571_length_740_cov_54.372855	321	401	2	15	80	0.1875000
NODE_14571_length_740_cov_54.372855	321	401	3	13	80	0.1625000
NODE_14571_length_740_cov_54.372855	321	401	4	36	80	0.4500000
NODE_14571_length_740_cov_54.372855	321	401	5	9	80	0.1125000
NODE_14571_length_740_cov_54.372855	321	401	6	7	80	0.0875000
NODE_14571_length_740_cov_54.372855	374	454	2	55	80	0.6875000
NODE_14571_length_740_cov_54.372855	374	454	3	17	80	0.2125000
NODE_14571_length_740_cov_54.372855	374	454	4	8	80	0.1000000
NODE_14572_length_740_cov_51.758190	194	274	3	10	80	0.1250000
NODE_14572_length_740_cov_51.758190	194	274	4	49	80	0.6125000
NODE_14572_length_740_cov_51.758190	194	274	5	21	80	0.2625000
NODE_14572_length_740_cov_51.758190	247	327	2	30	80	0.3750000
NODE_14572_length_740_cov_51.758190	247	327	3	15	80	0.1875000
NODE_14572_length_740_cov_51.758190	247	327	4	35	80	0.4375000
NODE_14573_length_740_cov_34.185647	359	439	2	29	80	0.3625000
NODE_14573_length_740_cov_34.185647	359	439	4	51	80	0.6375000
NODE_14573_length_740_cov_34.185647	412	492	0	49	80	0.6125000
NODE_14573_length_740_cov_34.185647	412	492	2	31	80	0.3875000
NODE_14574_length_740_cov_24.794072	286	366	2	4	80	0.0500000
NODE_14574_length_740_cov_24.794072	286	366	3	76	80	0.9500000
NODE_14574_length_740_cov_24.794072	339	419	1	22	80	0.2750000
NODE_14574_length_740_cov_24.794072	339	419	3	58	80	0.7250000
NODE_14575_length_740_cov_20.361934	316	396	0	22	80	0.2750000
NODE_14575_length_740_cov_20.361934	316	396	3	17	80	0.2125000
NODE_14575_length_740_cov_20.361934	316	396	4	41	80	0.5125000
NODE_14575_length_740_cov_20.361934	369	449	2	26	80	0.3250000
NODE_14575_length_740_cov_20.361934	369	449	4	54	80	0.6750000
NODE_14576_length_740_cov_18.982839	266	348	1	26	82	0.3170732
NODE_14576_length_740_cov_18.982839	266	348	2	56	82	0.6829268
NODE_14576_length_740_cov_18.982839	321	401	1	34	80	0.4250000
NODE_14576_length_740_cov_18.982839	321	401	2	46	80	0.5750000
NODE_14577_length_740_cov_16.755070	354	434	3	4	80	0.0500000
NODE_14577_length_740_cov_16.755070	354	434	4	56	80	0.7000000
NODE_14577_length_740_cov_16.755070	354	434	5	19	80	0.2375000
NODE_14577_length_740_cov_16.755070	354	434	6	1	80	0.0125000
NODE_14577_length_740_cov_16.755070	407	487	4	22	80	0.2750000
NODE_14577_length_740_cov_16.755070	407	487	5	28	80	0.3500000
NODE_14577_length_740_cov_16.755070	407	487	6	30	80	0.3750000
NODE_14579_length_740_cov_7.585023	206	286	0	5	80	0.0625000
NODE_14579_length_740_cov_7.585023	206	286	1	75	80	0.9375000
NODE_14579_length_740_cov_7.585023	259	339	1	80	80	1.0000000
NODE_14580_length_740_cov_7.174727	165	245	0	28	80	0.3500000
NODE_14580_length_740_cov_7.174727	165	245	1	52	80	0.6500000
NODE_14580_length_740_cov_7.174727	218	298	0	80	80	1.0000000
NODE_14614_length_739_cov_52.970312	346	426	3	31	80	0.3875000
NODE_14614_length_739_cov_52.970312	346	426	4	2	80	0.0250000
NODE_14614_length_739_cov_52.970312	346	426	5	47	80	0.5875000
NODE_14614_length_739_cov_52.970312	399	479	3	38	80	0.4750000
NODE_14614_length_739_cov_52.970312	399	479	4	11	80	0.1375000
NODE_14614_length_739_cov_52.970312	399	479	5	31	80	0.3875000
NODE_14615_length_739_cov_31.175000	204	284	0	80	80	1.0000000
NODE_14615_length_739_cov_31.175000	257	337	0	80	80	1.0000000
NODE_14616_length_739_cov_25.482813	487	567	1	70	80	0.8750000
NODE_14616_length_739_cov_25.482813	487	567	2	10	80	0.1250000
NODE_14616_length_739_cov_25.482813	540	620	0	11	80	0.1375000
NODE_14616_length_739_cov_25.482813	540	620	1	69	80	0.8625000
NODE_14617_length_739_cov_24.871875	191	271	2	80	80	1.0000000
NODE_14617_length_739_cov_24.871875	244	324	0	7	80	0.0875000
NODE_14617_length_739_cov_24.871875	244	324	1	38	80	0.4750000
NODE_14617_length_739_cov_24.871875	244	324	2	35	80	0.4375000
NODE_14618_length_739_cov_18.360937	146	226	3	31	80	0.3875000
NODE_14618_length_739_cov_18.360937	146	226	5	15	80	0.1875000
NODE_14618_length_739_cov_18.360937	146	226	7	28	80	0.3500000
NODE_14618_length_739_cov_18.360937	146	226	8	6	80	0.0750000
NODE_14618_length_739_cov_18.360937	199	279	7	22	80	0.2750000
NODE_14618_length_739_cov_18.360937	199	279	8	31	80	0.3875000
NODE_14618_length_739_cov_18.360937	199	279	9	8	80	0.1000000
NODE_14618_length_739_cov_18.360937	199	279	10	19	80	0.2375000
NODE_14619_length_739_cov_13.195312	273	353	0	33	80	0.4125000
NODE_14619_length_739_cov_13.195312	273	353	1	14	80	0.1750000
NODE_14619_length_739_cov_13.195312	273	353	2	33	80	0.4125000
NODE_14619_length_739_cov_13.195312	326	406	2	80	80	1.0000000
NODE_14620_length_739_cov_10.314063	231	311	0	26	80	0.3250000
NODE_14620_length_739_cov_10.314063	231	311	2	54	80	0.6750000
NODE_14620_length_739_cov_10.314063	284	364	0	34	80	0.4250000
NODE_14620_length_739_cov_10.314063	284	364	2	46	80	0.5750000
NODE_14622_length_739_cov_8.523438	468	548	0	80	80	1.0000000
NODE_14622_length_739_cov_8.523438	521	600	0	79	79	1.0000000
NODE_14623_length_739_cov_7.398438	342	422	0	16	80	0.2000000
NODE_14623_length_739_cov_7.398438	342	422	1	22	80	0.2750000
NODE_14623_length_739_cov_7.398438	342	422	2	42	80	0.5250000
NODE_14623_length_739_cov_7.398438	395	475	2	80	80	1.0000000
NODE_14625_length_739_cov_5.826562	252	332	1	69	80	0.8625000
NODE_14625_length_739_cov_5.826562	252	332	2	11	80	0.1375000
NODE_14625_length_739_cov_5.826562	305	385	1	80	80	1.0000000
NODE_14634_length_739_cov_3.232813	355	435	1	80	80	1.0000000
NODE_14634_length_739_cov_3.232813	408	488	1	27	80	0.3375000
NODE_14634_length_739_cov_3.232813	408	488	2	53	80	0.6625000
NODE_14679_length_738_cov_35.278560	274	318	90	1	44	0.0227273
NODE_14679_length_738_cov_35.278560	274	318	92	1	44	0.0227273
NODE_14679_length_738_cov_35.278560	274	318	94	1	44	0.0227273
NODE_14679_length_738_cov_35.278560	274	318	95	1	44	0.0227273
NODE_14679_length_738_cov_35.278560	274	318	96	2	44	0.0454545
NODE_14679_length_738_cov_35.278560	274	318	101	1	44	0.0227273
NODE_14679_length_738_cov_35.278560	274	318	106	1	44	0.0227273
NODE_14679_length_738_cov_35.278560	274	318	108	2	44	0.0454545
NODE_14679_length_738_cov_35.278560	274	318	113	1	44	0.0227273
NODE_14679_length_738_cov_35.278560	274	318	114	2	44	0.0454545
NODE_14679_length_738_cov_35.278560	274	318	115	3	44	0.0681818
NODE_14679_length_738_cov_35.278560	274	318	116	3	44	0.0681818
NODE_14679_length_738_cov_35.278560	274	318	117	3	44	0.0681818
NODE_14679_length_738_cov_35.278560	274	318	118	1	44	0.0227273
NODE_14679_length_738_cov_35.278560	274	318	119	1	44	0.0227273
NODE_14679_length_738_cov_35.278560	274	318	120	3	44	0.0681818
NODE_14679_length_738_cov_35.278560	274	318	121	1	44	0.0227273
NODE_14679_length_738_cov_35.278560	274	318	122	1	44	0.0227273
NODE_14679_length_738_cov_35.278560	274	318	124	6	44	0.1363636
NODE_14679_length_738_cov_35.278560	274	318	125	5	44	0.1136364
NODE_14679_length_738_cov_35.278560	274	318	126	3	44	0.0681818
NODE_14679_length_738_cov_35.278560	274	318	127	1	44	0.0227273
NODE_14680_length_738_cov_21.672926	208	288	2	43	80	0.5375000
NODE_14680_length_738_cov_21.672926	208	288	3	6	80	0.0750000
NODE_14680_length_738_cov_21.672926	208	288	4	31	80	0.3875000
NODE_14680_length_738_cov_21.672926	261	341	4	80	80	1.0000000
NODE_14681_length_738_cov_15.665102	302	382	1	42	80	0.5250000
NODE_14681_length_738_cov_15.665102	302	382	3	38	80	0.4750000
NODE_14681_length_738_cov_15.665102	355	435	2	35	80	0.4375000
NODE_14681_length_738_cov_15.665102	355	435	3	45	80	0.5625000
NODE_14682_length_738_cov_15.661972	338	418	1	68	80	0.8500000
NODE_14682_length_738_cov_15.661972	338	418	2	6	80	0.0750000
NODE_14682_length_738_cov_15.661972	338	418	3	6	80	0.0750000
NODE_14682_length_738_cov_15.661972	391	471	1	80	80	1.0000000
NODE_14683_length_738_cov_12.594679	49	129	0	62	80	0.7750000
NODE_14683_length_738_cov_12.594679	49	129	1	18	80	0.2250000
NODE_14683_length_738_cov_12.594679	102	182	0	9	80	0.1125000
NODE_14683_length_738_cov_12.594679	102	182	1	71	80	0.8875000
NODE_14683_length_738_cov_12.594679	178	258	1	5	80	0.0625000
NODE_14683_length_738_cov_12.594679	178	258	2	60	80	0.7500000
NODE_14683_length_738_cov_12.594679	178	258	3	15	80	0.1875000
NODE_14683_length_738_cov_12.594679	231	311	2	62	80	0.7750000
NODE_14683_length_738_cov_12.594679	231	311	3	18	80	0.2250000
NODE_14691_length_738_cov_4.056338	254	326	2	43	72	0.5972222
NODE_14691_length_738_cov_4.056338	254	326	3	29	72	0.4027778
NODE_14691_length_738_cov_4.056338	437	528	4	14	91	0.1538462
NODE_14691_length_738_cov_4.056338	437	528	5	10	91	0.1098901
NODE_14691_length_738_cov_4.056338	437	528	6	44	91	0.4835165
NODE_14691_length_738_cov_4.056338	437	528	7	23	91	0.2527473
NODE_14724_length_737_cov_22.363636	303	383	2	55	80	0.6875000
NODE_14724_length_737_cov_22.363636	303	383	4	25	80	0.3125000
NODE_14724_length_737_cov_22.363636	356	436	2	2	80	0.0250000
NODE_14724_length_737_cov_22.363636	356	436	3	31	80	0.3875000
NODE_14724_length_737_cov_22.363636	356	436	4	47	80	0.5875000
NODE_14725_length_737_cov_21.318182	208	288	3	29	80	0.3625000
NODE_14725_length_737_cov_21.318182	208	288	4	17	80	0.2125000
NODE_14725_length_737_cov_21.318182	208	288	6	34	80	0.4250000
NODE_14725_length_737_cov_21.318182	261	341	3	8	80	0.1000000
NODE_14725_length_737_cov_21.318182	261	341	4	8	80	0.1000000
NODE_14725_length_737_cov_21.318182	261	341	6	64	80	0.8000000
NODE_14726_length_737_cov_17.161442	346	426	2	80	80	1.0000000
NODE_14726_length_737_cov_17.161442	399	479	1	22	80	0.2750000
NODE_14726_length_737_cov_17.161442	399	479	2	58	80	0.7250000
NODE_14727_length_737_cov_11.835423	211	291	2	7	80	0.0875000
NODE_14727_length_737_cov_11.835423	211	291	3	73	80	0.9125000
NODE_14727_length_737_cov_11.835423	264	344	1	34	80	0.4250000
NODE_14727_length_737_cov_11.835423	264	344	2	7	80	0.0875000
NODE_14727_length_737_cov_11.835423	264	344	3	39	80	0.4875000
NODE_14729_length_737_cov_6.782132	488	548	3	60	60	1.0000000
NODE_14732_length_737_cov_6.089342	241	321	4	80	80	1.0000000
NODE_14732_length_737_cov_6.089342	294	374	0	3	80	0.0375000
NODE_14732_length_737_cov_6.089342	294	374	1	14	80	0.1750000
NODE_14732_length_737_cov_6.089342	294	374	2	12	80	0.1500000
NODE_14732_length_737_cov_6.089342	294	374	3	3	80	0.0375000
NODE_14732_length_737_cov_6.089342	294	374	4	48	80	0.6000000
NODE_14747_length_737_cov_2.548589	386	416	0	30	30	1.0000000
NODE_14781_length_736_cov_46.601256	226	306	1	8	80	0.1000000
NODE_14781_length_736_cov_46.601256	226	306	2	72	80	0.9000000
NODE_14781_length_736_cov_46.601256	279	359	2	80	80	1.0000000
NODE_14782_length_736_cov_32.442700	215	295	0	80	80	1.0000000
NODE_14782_length_736_cov_32.442700	268	350	0	82	82	1.0000000
NODE_14783_length_736_cov_26.364207	220	300	0	80	80	1.0000000
NODE_14783_length_736_cov_26.364207	273	353	0	80	80	1.0000000
NODE_14785_length_736_cov_10.317111	313	393	2	80	80	1.0000000
NODE_14785_length_736_cov_10.317111	366	446	0	21	80	0.2625000
NODE_14785_length_736_cov_10.317111	366	446	2	59	80	0.7375000
NODE_14786_length_736_cov_9.188383	292	372	0	80	80	1.0000000
NODE_14786_length_736_cov_9.188383	345	425	0	80	80	1.0000000
NODE_14787_length_736_cov_8.149137	315	391	1	27	76	0.3552631
NODE_14787_length_736_cov_8.149137	315	391	4	49	76	0.6447368
NODE_14787_length_736_cov_8.149137	365	445	1	80	80	1.0000000
NODE_14788_length_736_cov_8.103611	295	375	0	12	80	0.1500000
NODE_14788_length_736_cov_8.103611	295	375	1	18	80	0.2250000
NODE_14788_length_736_cov_8.103611	295	375	2	50	80	0.6250000
NODE_14788_length_736_cov_8.103611	348	428	2	80	80	1.0000000
NODE_14789_length_736_cov_7.513344	239	319	3	3	80	0.0375000
NODE_14789_length_736_cov_7.513344	239	319	4	61	80	0.7625000
NODE_14789_length_736_cov_7.513344	239	319	5	16	80	0.2000000
NODE_14789_length_736_cov_7.513344	292	372	2	51	80	0.6375000
NODE_14789_length_736_cov_7.513344	292	372	4	13	80	0.1625000
NODE_14789_length_736_cov_7.513344	292	372	5	16	80	0.2000000
NODE_14792_length_736_cov_5.967033	253	333	3	14	80	0.1750000
NODE_14792_length_736_cov_5.967033	253	333	4	28	80	0.3500000
NODE_14792_length_736_cov_5.967033	253	333	5	38	80	0.4750000
NODE_14792_length_736_cov_5.967033	306	386	2	28	80	0.3500000
NODE_14792_length_736_cov_5.967033	306	386	3	17	80	0.2125000
NODE_14792_length_736_cov_5.967033	306	386	4	28	80	0.3500000
NODE_14792_length_736_cov_5.967033	306	386	5	7	80	0.0875000
NODE_14795_length_736_cov_4.908948	258	338	0	57	80	0.7125000
NODE_14795_length_736_cov_4.908948	258	338	1	1	80	0.0125000
NODE_14795_length_736_cov_4.908948	258	338	2	22	80	0.2750000
NODE_14795_length_736_cov_4.908948	311	391	0	4	80	0.0500000
NODE_14795_length_736_cov_4.908948	311	391	1	1	80	0.0125000
NODE_14795_length_736_cov_4.908948	311	391	2	75	80	0.9375000
NODE_14825_length_735_cov_21.099057	265	345	2	26	80	0.3250000
NODE_14825_length_735_cov_21.099057	265	345	4	54	80	0.6750000
NODE_14825_length_735_cov_21.099057	318	398	2	70	80	0.8750000
NODE_14825_length_735_cov_21.099057	318	398	4	10	80	0.1250000
NODE_14826_length_735_cov_16.696541	190	270	3	52	80	0.6500000
NODE_14826_length_735_cov_16.696541	190	270	4	16	80	0.2000000
NODE_14826_length_735_cov_16.696541	190	270	5	12	80	0.1500000
NODE_14826_length_735_cov_16.696541	243	323	2	25	80	0.3125000
NODE_14826_length_735_cov_16.696541	243	323	3	49	80	0.6125000
NODE_14826_length_735_cov_16.696541	243	323	4	6	80	0.0750000
NODE_14826_length_735_cov_16.696541	479	538	0	3	59	0.0508475
NODE_14826_length_735_cov_16.696541	479	538	2	14	59	0.2372881
NODE_14826_length_735_cov_16.696541	479	538	3	42	59	0.7118644
NODE_14827_length_735_cov_13.143082	231	311	0	8	80	0.1000000
NODE_14827_length_735_cov_13.143082	231	311	2	72	80	0.9000000
NODE_14827_length_735_cov_13.143082	284	364	0	22	80	0.2750000
NODE_14827_length_735_cov_13.143082	284	364	2	58	80	0.7250000
NODE_14828_length_735_cov_12.415094	434	514	0	80	80	1.0000000
NODE_14828_length_735_cov_12.415094	487	567	0	80	80	1.0000000
NODE_14836_length_735_cov_5.603774	326	394	0	68	68	1.0000000
NODE_14836_length_735_cov_5.603774	367	409	0	42	42	1.0000000
NODE_14880_length_734_cov_26.787402	209	289	0	80	80	1.0000000
NODE_14880_length_734_cov_26.787402	262	342	0	80	80	1.0000000
NODE_14881_length_734_cov_23.214173	200	280	3	80	80	1.0000000
NODE_14881_length_734_cov_23.214173	253	333	1	28	80	0.3500000
NODE_14881_length_734_cov_23.214173	253	333	2	24	80	0.3000000
NODE_14881_length_734_cov_23.214173	253	333	3	28	80	0.3500000
NODE_14883_length_734_cov_21.645669	245	325	2	31	80	0.3875000
NODE_14883_length_734_cov_21.645669	245	325	3	49	80	0.6125000
NODE_14883_length_734_cov_21.645669	298	378	3	80	80	1.0000000
NODE_14884_length_734_cov_14.393701	249	329	0	80	80	1.0000000
NODE_14884_length_734_cov_14.393701	302	382	0	52	80	0.6500000
NODE_14884_length_734_cov_14.393701	302	382	2	28	80	0.3500000
NODE_14885_length_734_cov_11.324409	133	196	0	63	63	1.0000000
NODE_14885_length_734_cov_11.324409	169	229	0	60	60	1.0000000
NODE_14886_length_734_cov_10.872441	302	331	2	10	29	0.3448276
NODE_14886_length_734_cov_10.872441	302	331	3	19	29	0.6551724
NODE_14890_length_734_cov_6.352756	371	451	2	80	80	1.0000000
NODE_14890_length_734_cov_6.352756	424	504	0	30	80	0.3750000
NODE_14890_length_734_cov_6.352756	424	504	2	50	80	0.6250000
NODE_14896_length_734_cov_2.705512	231	302	0	71	71	1.0000000
NODE_14934_length_733_cov_35.041009	268	348	3	7	80	0.0875000
NODE_14934_length_733_cov_35.041009	268	348	5	16	80	0.2000000
NODE_14934_length_733_cov_35.041009	268	348	6	57	80	0.7125000
NODE_14934_length_733_cov_35.041009	321	402	3	44	81	0.5432099
NODE_14934_length_733_cov_35.041009	321	402	4	10	81	0.1234568
NODE_14934_length_733_cov_35.041009	321	402	6	27	81	0.3333333
NODE_14935_length_733_cov_29.810726	28	108	0	80	80	1.0000000
NODE_14935_length_733_cov_29.810726	81	161	0	80	80	1.0000000
NODE_14935_length_733_cov_29.810726	157	237	0	80	80	1.0000000
NODE_14935_length_733_cov_29.810726	210	290	0	80	80	1.0000000
NODE_14936_length_733_cov_13.738170	333	413	0	28	80	0.3500000
NODE_14936_length_733_cov_13.738170	333	413	1	52	80	0.6500000
NODE_14936_length_733_cov_13.738170	386	466	0	80	80	1.0000000
NODE_14937_length_733_cov_11.471609	314	389	0	57	75	0.7600000
NODE_14937_length_733_cov_11.471609	314	389	2	18	75	0.2400000
NODE_14938_length_733_cov_11.321767	245	325	0	80	80	1.0000000
NODE_14938_length_733_cov_11.321767	298	378	0	80	80	1.0000000
NODE_14940_length_733_cov_8.481073	318	395	0	77	77	1.0000000
NODE_14940_length_733_cov_8.481073	371	451	0	80	80	1.0000000
NODE_14944_length_733_cov_5.485804	659	715	18	6	56	0.1071429
NODE_14944_length_733_cov_5.485804	659	715	19	1	56	0.0178571
NODE_14944_length_733_cov_5.485804	659	715	20	6	56	0.1071429
NODE_14944_length_733_cov_5.485804	659	715	21	1	56	0.0178571
NODE_14944_length_733_cov_5.485804	659	715	22	2	56	0.0357143
NODE_14944_length_733_cov_5.485804	659	715	26	2	56	0.0357143
NODE_14944_length_733_cov_5.485804	659	715	27	2	56	0.0357143
NODE_14944_length_733_cov_5.485804	659	715	28	3	56	0.0535714
NODE_14944_length_733_cov_5.485804	659	715	31	2	56	0.0357143
NODE_14944_length_733_cov_5.485804	659	715	32	4	56	0.0714286
NODE_14944_length_733_cov_5.485804	659	715	34	9	56	0.1607143
NODE_14944_length_733_cov_5.485804	659	715	35	2	56	0.0357143
NODE_14944_length_733_cov_5.485804	659	715	36	4	56	0.0714286
NODE_14944_length_733_cov_5.485804	659	715	37	2	56	0.0357143
NODE_14944_length_733_cov_5.485804	659	715	38	4	56	0.0714286
NODE_14944_length_733_cov_5.485804	659	715	39	6	56	0.1071429
NODE_14944_length_733_cov_5.485804	696	733	7	4	37	0.1081081
NODE_14944_length_733_cov_5.485804	696	733	10	3	37	0.0810811
NODE_14944_length_733_cov_5.485804	696	733	12	4	37	0.1081081
NODE_14944_length_733_cov_5.485804	696	733	13	2	37	0.0540541
NODE_14944_length_733_cov_5.485804	696	733	16	3	37	0.0810811
NODE_14944_length_733_cov_5.485804	696	733	17	1	37	0.0270270
NODE_14944_length_733_cov_5.485804	696	733	18	7	37	0.1891892
NODE_14944_length_733_cov_5.485804	696	733	19	1	37	0.0270270
NODE_14944_length_733_cov_5.485804	696	733	20	6	37	0.1621622
NODE_14944_length_733_cov_5.485804	696	733	21	1	37	0.0270270
NODE_14944_length_733_cov_5.485804	696	733	22	2	37	0.0540541
NODE_14944_length_733_cov_5.485804	696	733	26	2	37	0.0540541
NODE_14944_length_733_cov_5.485804	696	733	27	1	37	0.0270270
NODE_14957_length_733_cov_2.272871	312	392	0	80	80	1.0000000
NODE_14957_length_733_cov_2.272871	365	445	0	80	80	1.0000000
NODE_14975_length_732_cov_19.519747	229	309	0	4	80	0.0500000
NODE_14975_length_732_cov_19.519747	229	309	2	1	80	0.0125000
NODE_14975_length_732_cov_19.519747	229	309	4	75	80	0.9375000
NODE_14975_length_732_cov_19.519747	282	362	0	7	80	0.0875000
NODE_14975_length_732_cov_19.519747	282	362	2	5	80	0.0625000
NODE_14975_length_732_cov_19.519747	282	362	4	68	80	0.8500000
NODE_14976_length_732_cov_10.846761	247	327	0	80	80	1.0000000
NODE_14976_length_732_cov_10.846761	300	380	0	80	80	1.0000000
NODE_14977_length_732_cov_9.807267	276	356	1	40	80	0.5000000
NODE_14977_length_732_cov_9.807267	276	356	2	40	80	0.5000000
NODE_14977_length_732_cov_9.807267	329	409	2	80	80	1.0000000
NODE_14978_length_732_cov_8.053712	415	495	0	80	80	1.0000000
NODE_14978_length_732_cov_8.053712	468	548	0	80	80	1.0000000
NODE_14980_length_732_cov_5.194313	319	399	1	71	80	0.8875000
NODE_14980_length_732_cov_5.194313	319	399	2	9	80	0.1125000
NODE_14980_length_732_cov_5.194313	372	452	1	80	80	1.0000000
NODE_14981_length_732_cov_4.998420	293	373	0	80	80	1.0000000
NODE_14981_length_732_cov_4.998420	346	426	0	80	80	1.0000000
NODE_14983_length_732_cov_4.758294	483	524	0	41	41	1.0000000
NODE_15021_length_731_cov_36.123418	464	544	3	8	80	0.1000000
NODE_15021_length_731_cov_36.123418	464	544	4	54	80	0.6750000
NODE_15021_length_731_cov_36.123418	464	544	5	18	80	0.2250000
NODE_15021_length_731_cov_36.123418	517	597	1	5	80	0.0625000
NODE_15021_length_731_cov_36.123418	517	597	2	21	80	0.2625000
NODE_15021_length_731_cov_36.123418	517	597	3	35	80	0.4375000
NODE_15021_length_731_cov_36.123418	517	597	4	1	80	0.0125000
NODE_15021_length_731_cov_36.123418	517	597	5	18	80	0.2250000
NODE_15022_length_731_cov_27.721519	294	374	0	80	80	1.0000000
NODE_15022_length_731_cov_27.721519	347	427	0	80	80	1.0000000
NODE_15023_length_731_cov_19.655063	394	474	2	80	80	1.0000000
NODE_15023_length_731_cov_19.655063	447	527	0	29	80	0.3625000
NODE_15023_length_731_cov_19.655063	447	527	2	51	80	0.6375000
NODE_15024_length_731_cov_16.346519	429	509	0	31	80	0.3875000
NODE_15024_length_731_cov_16.346519	429	509	1	49	80	0.6125000
NODE_15024_length_731_cov_16.346519	482	562	1	80	80	1.0000000
NODE_15025_length_731_cov_13.892405	321	401	0	80	80	1.0000000
NODE_15025_length_731_cov_13.892405	374	454	0	80	80	1.0000000
NODE_15027_length_731_cov_8.800633	218	298	1	80	80	1.0000000
NODE_15027_length_731_cov_8.800633	271	352	1	42	81	0.5185185
NODE_15027_length_731_cov_8.800633	271	352	2	39	81	0.4814815
NODE_15028_length_731_cov_7.658228	335	406	4	32	71	0.4507042
NODE_15028_length_731_cov_7.658228	335	406	5	9	71	0.1267606
NODE_15028_length_731_cov_7.658228	335	406	6	6	71	0.0845070
NODE_15028_length_731_cov_7.658228	335	406	8	14	71	0.1971831
NODE_15028_length_731_cov_7.658228	335	406	9	10	71	0.1408451
NODE_15028_length_731_cov_7.658228	387	468	4	29	81	0.3580247
NODE_15028_length_731_cov_7.658228	387	468	6	1	81	0.0123457
NODE_15028_length_731_cov_7.658228	387	468	8	36	81	0.4444444
NODE_15028_length_731_cov_7.658228	387	468	9	15	81	0.1851852
NODE_15031_length_731_cov_5.471519	261	341	2	7	80	0.0875000
NODE_15031_length_731_cov_5.471519	261	341	3	19	80	0.2375000
NODE_15031_length_731_cov_5.471519	261	341	4	54	80	0.6750000
NODE_15031_length_731_cov_5.471519	314	394	1	46	80	0.5750000
NODE_15031_length_731_cov_5.471519	314	394	2	14	80	0.1750000
NODE_15031_length_731_cov_5.471519	314	394	3	5	80	0.0625000
NODE_15031_length_731_cov_5.471519	314	394	4	15	80	0.1875000
NODE_15034_length_731_cov_4.083861	361	441	2	37	80	0.4625000
NODE_15034_length_731_cov_4.083861	361	441	3	2	80	0.0250000
NODE_15034_length_731_cov_4.083861	361	441	4	29	80	0.3625000
NODE_15034_length_731_cov_4.083861	361	441	5	12	80	0.1500000
NODE_15034_length_731_cov_4.083861	458	482	2	24	24	1.0000000
NODE_15050_length_731_cov_2.226266	466	548	2	14	82	0.1707317
NODE_15050_length_731_cov_2.226266	466	548	3	68	82	0.8292683
NODE_15077_length_730_cov_51.556260	349	429	0	74	80	0.9250000
NODE_15077_length_730_cov_51.556260	349	429	1	6	80	0.0750000
NODE_15077_length_730_cov_51.556260	402	482	0	21	80	0.2625000
NODE_15077_length_730_cov_51.556260	402	482	1	59	80	0.7375000
NODE_15078_length_730_cov_39.862124	370	450	0	17	80	0.2125000
NODE_15078_length_730_cov_39.862124	370	450	1	29	80	0.3625000
NODE_15078_length_730_cov_39.862124	370	450	3	34	80	0.4250000
NODE_15078_length_730_cov_39.862124	423	503	0	43	80	0.5375000
NODE_15078_length_730_cov_39.862124	423	503	1	37	80	0.4625000
NODE_15079_length_730_cov_15.801902	261	341	1	80	80	1.0000000
NODE_15079_length_730_cov_15.801902	314	394	0	33	80	0.4125000
NODE_15079_length_730_cov_15.801902	314	394	1	47	80	0.5875000
NODE_15080_length_730_cov_11.746434	242	322	1	23	80	0.2875000
NODE_15080_length_730_cov_11.746434	242	322	2	57	80	0.7125000
NODE_15080_length_730_cov_11.746434	295	375	1	76	80	0.9500000
NODE_15080_length_730_cov_11.746434	295	375	2	4	80	0.0500000
NODE_15081_length_730_cov_9.209192	358	438	0	80	80	1.0000000
NODE_15081_length_730_cov_9.209192	411	483	0	72	72	1.0000000
NODE_15131_length_729_cov_44.188889	418	498	0	14	80	0.1750000
NODE_15131_length_729_cov_44.188889	418	498	1	38	80	0.4750000
NODE_15131_length_729_cov_44.188889	418	498	2	28	80	0.3500000
NODE_15131_length_729_cov_44.188889	471	551	2	80	80	1.0000000
NODE_15132_length_729_cov_40.390476	330	410	1	24	80	0.3000000
NODE_15132_length_729_cov_40.390476	330	410	2	56	80	0.7000000
NODE_15132_length_729_cov_40.390476	383	463	0	8	80	0.1000000
NODE_15132_length_729_cov_40.390476	383	463	1	69	80	0.8625000
NODE_15132_length_729_cov_40.390476	383	463	2	3	80	0.0375000
NODE_15133_length_729_cov_35.973016	231	311	6	80	80	1.0000000
NODE_15133_length_729_cov_35.973016	284	363	1	11	79	0.1392405
NODE_15133_length_729_cov_35.973016	284	363	2	10	79	0.1265823
NODE_15133_length_729_cov_35.973016	284	363	3	15	79	0.1898734
NODE_15133_length_729_cov_35.973016	284	363	5	8	79	0.1012658
NODE_15133_length_729_cov_35.973016	284	363	6	35	79	0.4430380
NODE_15134_length_729_cov_18.357143	170	250	5	73	80	0.9125000
NODE_15134_length_729_cov_18.357143	170	250	6	7	80	0.0875000
NODE_15134_length_729_cov_18.357143	223	303	0	14	80	0.1750000
NODE_15134_length_729_cov_18.357143	223	303	2	22	80	0.2750000
NODE_15134_length_729_cov_18.357143	223	303	3	4	80	0.0500000
NODE_15134_length_729_cov_18.357143	223	303	5	40	80	0.5000000
NODE_15135_length_729_cov_17.928571	194	274	0	26	80	0.3250000
NODE_15135_length_729_cov_17.928571	194	274	2	54	80	0.6750000
NODE_15135_length_729_cov_17.928571	247	327	0	28	80	0.3500000
NODE_15135_length_729_cov_17.928571	247	327	2	52	80	0.6500000
NODE_15136_length_729_cov_17.373016	369	449	3	80	80	1.0000000
NODE_15136_length_729_cov_17.373016	422	502	0	22	80	0.2750000
NODE_15136_length_729_cov_17.373016	422	502	1	26	80	0.3250000
NODE_15136_length_729_cov_17.373016	422	502	3	32	80	0.4000000
NODE_15137_length_729_cov_12.452381	347	427	0	80	80	1.0000000
NODE_15137_length_729_cov_12.452381	400	480	0	80	80	1.0000000
NODE_15138_length_729_cov_10.388889	296	376	0	80	80	1.0000000
NODE_15138_length_729_cov_10.388889	349	429	0	32	80	0.4000000
NODE_15138_length_729_cov_10.388889	349	429	1	48	80	0.6000000
NODE_15185_length_728_cov_23.503975	338	418	0	80	80	1.0000000
NODE_15185_length_728_cov_23.503975	391	471	0	80	80	1.0000000
NODE_15186_length_728_cov_22.496025	310	390	4	33	80	0.4125000
NODE_15186_length_728_cov_22.496025	310	390	5	31	80	0.3875000
NODE_15186_length_728_cov_22.496025	310	390	7	16	80	0.2000000
NODE_15186_length_728_cov_22.496025	363	443	3	16	80	0.2000000
NODE_15186_length_728_cov_22.496025	363	443	4	32	80	0.4000000
NODE_15186_length_728_cov_22.496025	363	443	5	32	80	0.4000000
NODE_15187_length_728_cov_16.596184	257	337	0	80	80	1.0000000
NODE_15187_length_728_cov_16.596184	310	387	0	77	77	1.0000000
NODE_15188_length_728_cov_16.114467	192	272	3	17	80	0.2125000
NODE_15188_length_728_cov_16.114467	192	272	4	4	80	0.0500000
NODE_15188_length_728_cov_16.114467	192	272	5	5	80	0.0625000
NODE_15188_length_728_cov_16.114467	192	272	6	5	80	0.0625000
NODE_15188_length_728_cov_16.114467	192	272	7	16	80	0.2000000
NODE_15188_length_728_cov_16.114467	192	272	8	19	80	0.2375000
NODE_15188_length_728_cov_16.114467	192	272	9	10	80	0.1250000
NODE_15188_length_728_cov_16.114467	192	272	10	4	80	0.0500000
NODE_15188_length_728_cov_16.114467	245	325	7	4	80	0.0500000
NODE_15188_length_728_cov_16.114467	245	325	8	16	80	0.2000000
NODE_15188_length_728_cov_16.114467	245	325	9	3	80	0.0375000
NODE_15188_length_728_cov_16.114467	245	325	10	9	80	0.1125000
NODE_15188_length_728_cov_16.114467	245	325	11	11	80	0.1375000
NODE_15188_length_728_cov_16.114467	245	325	12	12	80	0.1500000
NODE_15188_length_728_cov_16.114467	245	325	13	25	80	0.3125000
NODE_15189_length_728_cov_15.128776	298	377	3	26	79	0.3291139
NODE_15189_length_728_cov_15.128776	298	377	4	16	79	0.2025317
NODE_15189_length_728_cov_15.128776	298	377	5	9	79	0.1139240
NODE_15189_length_728_cov_15.128776	298	377	6	28	79	0.3544304
NODE_15189_length_728_cov_15.128776	350	430	2	16	80	0.2000000
NODE_15189_length_728_cov_15.128776	350	430	3	63	80	0.7875000
NODE_15189_length_728_cov_15.128776	350	430	4	1	80	0.0125000
NODE_15190_length_728_cov_10.613672	269	349	0	80	80	1.0000000
NODE_15190_length_728_cov_10.613672	322	402	0	80	80	1.0000000
NODE_15191_length_728_cov_7.613672	408	488	0	80	80	1.0000000
NODE_15191_length_728_cov_7.613672	461	541	0	80	80	1.0000000
NODE_15196_length_728_cov_3.405405	335	415	0	17	80	0.2125000
NODE_15196_length_728_cov_3.405405	335	415	2	63	80	0.7875000
NODE_15244_length_727_cov_34.883758	57	137	0	14	80	0.1750000
NODE_15244_length_727_cov_34.883758	57	137	1	19	80	0.2375000
NODE_15244_length_727_cov_34.883758	57	137	4	41	80	0.5125000
NODE_15244_length_727_cov_34.883758	57	137	5	6	80	0.0750000
NODE_15244_length_727_cov_34.883758	57	137	0	14	80	0.1750000
NODE_15244_length_727_cov_34.883758	57	137	1	19	80	0.2375000
NODE_15244_length_727_cov_34.883758	57	137	4	41	80	0.5125000
NODE_15244_length_727_cov_34.883758	57	137	5	6	80	0.0750000
NODE_15244_length_727_cov_34.883758	57	137	0	14	80	0.1750000
NODE_15244_length_727_cov_34.883758	57	137	1	19	80	0.2375000
NODE_15244_length_727_cov_34.883758	57	137	4	41	80	0.5125000
NODE_15244_length_727_cov_34.883758	57	137	5	6	80	0.0750000
NODE_15244_length_727_cov_34.883758	110	190	4	21	80	0.2625000
NODE_15244_length_727_cov_34.883758	110	190	5	16	80	0.2000000
NODE_15244_length_727_cov_34.883758	110	190	6	43	80	0.5375000
NODE_15244_length_727_cov_34.883758	110	190	4	21	80	0.2625000
NODE_15244_length_727_cov_34.883758	110	190	5	16	80	0.2000000
NODE_15244_length_727_cov_34.883758	110	190	6	43	80	0.5375000
NODE_15245_length_727_cov_32.025478	275	355	1	20	80	0.2500000
NODE_15245_length_727_cov_32.025478	275	355	2	25	80	0.3125000
NODE_15245_length_727_cov_32.025478	275	355	4	35	80	0.4375000
NODE_15245_length_727_cov_32.025478	328	408	1	13	80	0.1625000
NODE_15245_length_727_cov_32.025478	328	408	3	36	80	0.4500000
NODE_15245_length_727_cov_32.025478	328	408	4	31	80	0.3875000
NODE_15246_length_727_cov_28.523885	307	381	3	71	74	0.9594595
NODE_15246_length_727_cov_28.523885	307	381	6	3	74	0.0405405
NODE_15246_length_727_cov_28.523885	360	381	3	18	21	0.8571429
NODE_15246_length_727_cov_28.523885	360	381	6	3	21	0.1428571
NODE_15246_length_727_cov_28.523885	378	415	3	34	37	0.9189189
NODE_15246_length_727_cov_28.523885	378	415	6	3	37	0.0810811
NODE_15247_length_727_cov_25.826433	325	405	3	13	80	0.1625000
NODE_15247_length_727_cov_25.826433	325	405	4	1	80	0.0125000
NODE_15247_length_727_cov_25.826433	325	405	6	66	80	0.8250000
NODE_15247_length_727_cov_25.826433	378	458	4	14	80	0.1750000
NODE_15247_length_727_cov_25.826433	378	458	6	66	80	0.8250000
NODE_15248_length_727_cov_22.253185	150	230	1	59	80	0.7375000
NODE_15248_length_727_cov_22.253185	150	230	2	21	80	0.2625000
NODE_15248_length_727_cov_22.253185	203	283	1	47	80	0.5875000
NODE_15248_length_727_cov_22.253185	203	283	2	33	80	0.4125000
NODE_15249_length_727_cov_18.972930	263	343	13	17	80	0.2125000
NODE_15249_length_727_cov_18.972930	263	343	14	37	80	0.4625000
NODE_15249_length_727_cov_18.972930	263	343	15	10	80	0.1250000
NODE_15249_length_727_cov_18.972930	263	343	16	16	80	0.2000000
NODE_15249_length_727_cov_18.972930	316	396	12	4	80	0.0500000
NODE_15249_length_727_cov_18.972930	316	396	13	15	80	0.1875000
NODE_15249_length_727_cov_18.972930	316	396	14	47	80	0.5875000
NODE_15249_length_727_cov_18.972930	316	396	15	5	80	0.0625000
NODE_15249_length_727_cov_18.972930	316	396	16	9	80	0.1125000
NODE_15250_length_727_cov_15.531847	269	349	2	1	80	0.0125000
NODE_15250_length_727_cov_15.531847	269	349	3	79	80	0.9875000
NODE_15250_length_727_cov_15.531847	322	402	1	33	80	0.4125000
NODE_15250_length_727_cov_15.531847	322	402	2	21	80	0.2625000
NODE_15250_length_727_cov_15.531847	322	402	3	26	80	0.3250000
NODE_15252_length_727_cov_10.178344	280	360	0	21	80	0.2625000
NODE_15252_length_727_cov_10.178344	280	360	2	59	80	0.7375000
NODE_15252_length_727_cov_10.178344	333	413	2	80	80	1.0000000
NODE_15258_length_727_cov_4.955414	360	440	0	48	80	0.6000000
NODE_15258_length_727_cov_4.955414	360	440	2	32	80	0.4000000
NODE_15258_length_727_cov_4.955414	413	493	2	80	80	1.0000000
NODE_15287_length_726_cov_52.923445	415	495	3	35	80	0.4375000
NODE_15287_length_726_cov_52.923445	415	495	4	45	80	0.5625000
NODE_15287_length_726_cov_52.923445	468	548	2	23	80	0.2875000
NODE_15287_length_726_cov_52.923445	468	548	3	2	80	0.0250000
NODE_15287_length_726_cov_52.923445	468	548	4	55	80	0.6875000
NODE_15288_length_726_cov_35.896332	108	188	2	22	80	0.2750000
NODE_15288_length_726_cov_35.896332	108	188	3	58	80	0.7250000
NODE_15288_length_726_cov_35.896332	161	241	2	47	80	0.5875000
NODE_15288_length_726_cov_35.896332	161	241	3	33	80	0.4125000
NODE_15288_length_726_cov_35.896332	237	317	2	3	80	0.0375000
NODE_15288_length_726_cov_35.896332	237	317	3	72	80	0.9000000
NODE_15288_length_726_cov_35.896332	237	317	4	5	80	0.0625000
NODE_15288_length_726_cov_35.896332	290	370	2	51	80	0.6375000
NODE_15288_length_726_cov_35.896332	290	370	3	29	80	0.3625000
NODE_15291_length_726_cov_8.534290	355	435	1	80	80	1.0000000
NODE_15291_length_726_cov_8.534290	408	488	1	80	80	1.0000000
NODE_15330_length_725_cov_40.856230	203	283	2	62	80	0.7750000
NODE_15330_length_725_cov_40.856230	203	283	3	18	80	0.2250000
NODE_15330_length_725_cov_40.856230	256	336	2	9	80	0.1125000
NODE_15330_length_725_cov_40.856230	256	336	3	37	80	0.4625000
NODE_15330_length_725_cov_40.856230	256	336	4	13	80	0.1625000
NODE_15330_length_725_cov_40.856230	256	336	5	21	80	0.2625000
NODE_15330_length_725_cov_40.856230	332	412	3	54	80	0.6750000
NODE_15330_length_725_cov_40.856230	332	412	4	13	80	0.1625000
NODE_15330_length_725_cov_40.856230	332	412	6	13	80	0.1625000
NODE_15330_length_725_cov_40.856230	385	465	3	17	80	0.2125000
NODE_15330_length_725_cov_40.856230	385	465	4	26	80	0.3250000
NODE_15330_length_725_cov_40.856230	385	465	5	21	80	0.2625000
NODE_15330_length_725_cov_40.856230	385	465	6	16	80	0.2000000
NODE_15331_length_725_cov_25.036741	366	446	2	43	80	0.5375000
NODE_15331_length_725_cov_25.036741	366	446	3	37	80	0.4625000
NODE_15331_length_725_cov_25.036741	419	499	0	37	80	0.4625000
NODE_15331_length_725_cov_25.036741	419	499	2	43	80	0.5375000
NODE_15332_length_725_cov_23.009585	455	536	0	81	81	1.0000000
NODE_15333_length_725_cov_20.474441	112	192	0	80	80	1.0000000
NODE_15333_length_725_cov_20.474441	165	245	0	80	80	1.0000000
NODE_15334_length_725_cov_15.455272	106	186	2	80	80	1.0000000
NODE_15334_length_725_cov_15.455272	159	239	0	24	80	0.3000000
NODE_15334_length_725_cov_15.455272	159	239	2	56	80	0.7000000
NODE_15334_length_725_cov_15.455272	235	315	0	80	80	1.0000000
NODE_15334_length_725_cov_15.455272	288	368	0	29	80	0.3625000
NODE_15334_length_725_cov_15.455272	288	368	2	51	80	0.6375000
NODE_15335_length_725_cov_10.426518	289	369	0	80	80	1.0000000
NODE_15335_length_725_cov_10.426518	342	422	0	80	80	1.0000000
NODE_15337_length_725_cov_7.781150	189	269	0	80	80	1.0000000
NODE_15337_length_725_cov_7.781150	242	322	0	80	80	1.0000000
NODE_15388_length_724_cov_28.132800	354	434	0	34	80	0.4250000
NODE_15388_length_724_cov_28.132800	354	434	2	46	80	0.5750000
NODE_15388_length_724_cov_28.132800	407	473	2	66	66	1.0000000
NODE_15389_length_724_cov_24.710400	376	461	1	85	85	1.0000000
NODE_15389_length_724_cov_24.710400	434	514	1	80	80	1.0000000
NODE_15390_length_724_cov_13.960000	152	232	2	80	80	1.0000000
NODE_15390_length_724_cov_13.960000	205	248	2	43	43	1.0000000
NODE_15390_length_724_cov_13.960000	237	286	0	34	49	0.6938776
NODE_15390_length_724_cov_13.960000	237	286	1	1	49	0.0204082
NODE_15390_length_724_cov_13.960000	237	286	2	14	49	0.2857143
NODE_15390_length_724_cov_13.960000	259	302	0	43	43	1.0000000
NODE_15390_length_724_cov_13.960000	288	340	0	52	52	1.0000000
NODE_15390_length_724_cov_13.960000	313	393	0	80	80	1.0000000
NODE_15391_length_724_cov_13.065600	215	295	0	80	80	1.0000000
NODE_15391_length_724_cov_13.065600	268	347	0	79	79	1.0000000
NODE_15393_length_724_cov_10.358400	257	337	1	80	80	1.0000000
NODE_15393_length_724_cov_10.358400	310	385	0	27	75	0.3600000
NODE_15393_length_724_cov_10.358400	310	385	1	48	75	0.6400000
NODE_15396_length_724_cov_6.451200	151	231	0	28	80	0.3500000
NODE_15396_length_724_cov_6.451200	151	231	1	52	80	0.6500000
NODE_15396_length_724_cov_6.451200	202	282	1	80	80	1.0000000
NODE_15397_length_724_cov_5.921600	165	213	0	48	48	1.0000000
NODE_15399_length_724_cov_5.028800	416	469	0	53	53	1.0000000
NODE_15399_length_724_cov_5.028800	488	526	0	38	38	1.0000000
NODE_15403_length_724_cov_3.315200	166	246	0	80	80	1.0000000
NODE_15403_length_724_cov_3.315200	219	299	0	80	80	1.0000000
NODE_15442_length_723_cov_81.453526	205	285	2	43	80	0.5375000
NODE_15442_length_723_cov_81.453526	205	285	3	30	80	0.3750000
NODE_15442_length_723_cov_81.453526	205	285	4	7	80	0.0875000
NODE_15442_length_723_cov_81.453526	258	338	2	9	80	0.1125000
NODE_15442_length_723_cov_81.453526	258	338	3	11	80	0.1375000
NODE_15442_length_723_cov_81.453526	258	338	4	49	80	0.6125000
NODE_15442_length_723_cov_81.453526	258	338	5	11	80	0.1375000
NODE_15443_length_723_cov_33.075321	254	329	1	42	75	0.5600000
NODE_15443_length_723_cov_33.075321	254	329	3	33	75	0.4400000
NODE_15443_length_723_cov_33.075321	307	387	3	59	80	0.7375000
NODE_15443_length_723_cov_33.075321	307	387	4	21	80	0.2625000
NODE_15444_length_723_cov_25.410256	291	371	2	42	80	0.5250000
NODE_15444_length_723_cov_25.410256	291	371	3	38	80	0.4750000
NODE_15444_length_723_cov_25.410256	344	424	1	18	80	0.2250000
NODE_15444_length_723_cov_25.410256	344	424	2	26	80	0.3250000
NODE_15444_length_723_cov_25.410256	344	424	3	36	80	0.4500000
NODE_15445_length_723_cov_18.097756	233	313	1	11	80	0.1375000
NODE_15445_length_723_cov_18.097756	233	313	2	21	80	0.2625000
NODE_15445_length_723_cov_18.097756	233	313	3	45	80	0.5625000
NODE_15445_length_723_cov_18.097756	233	313	5	3	80	0.0375000
NODE_15445_length_723_cov_18.097756	286	351	3	29	65	0.4461538
NODE_15445_length_723_cov_18.097756	286	351	5	36	65	0.5538462
NODE_15446_length_723_cov_14.113782	311	391	0	38	80	0.4750000
NODE_15446_length_723_cov_14.113782	311	391	2	34	80	0.4250000
NODE_15446_length_723_cov_14.113782	311	391	4	8	80	0.1000000
NODE_15446_length_723_cov_14.113782	364	444	2	19	80	0.2375000
NODE_15446_length_723_cov_14.113782	364	444	4	61	80	0.7625000
NODE_15447_length_723_cov_11.634615	299	379	0	10	80	0.1250000
NODE_15447_length_723_cov_11.634615	299	379	1	70	80	0.8750000
NODE_15447_length_723_cov_11.634615	352	432	0	63	80	0.7875000
NODE_15447_length_723_cov_11.634615	352	432	1	17	80	0.2125000
NODE_15448_length_723_cov_8.342949	357	437	3	80	80	1.0000000
NODE_15448_length_723_cov_8.342949	410	490	1	50	80	0.6250000
NODE_15448_length_723_cov_8.342949	410	490	3	30	80	0.3750000
NODE_15455_length_723_cov_2.711538	379	422	0	43	43	1.0000000
NODE_15459_length_723_cov_2.573718	383	413	3	30	30	1.0000000
NODE_15495_length_722_cov_19.182986	180	260	0	45	80	0.5625000
NODE_15495_length_722_cov_19.182986	180	260	1	35	80	0.4375000
NODE_15495_length_722_cov_19.182986	233	313	1	56	80	0.7000000
NODE_15495_length_722_cov_19.182986	233	313	2	24	80	0.3000000
NODE_15496_length_722_cov_13.582665	192	272	0	80	80	1.0000000
NODE_15496_length_722_cov_13.582665	245	326	0	28	81	0.3456790
NODE_15496_length_722_cov_13.582665	245	326	2	53	81	0.6543210
NODE_15497_length_722_cov_9.202247	347	427	1	18	80	0.2250000
NODE_15497_length_722_cov_9.202247	347	427	3	60	80	0.7500000
NODE_15497_length_722_cov_9.202247	347	427	4	2	80	0.0250000
NODE_15497_length_722_cov_9.202247	400	480	3	53	80	0.6625000
NODE_15497_length_722_cov_9.202247	400	480	4	27	80	0.3375000
NODE_15500_length_722_cov_6.707865	343	423	0	80	80	1.0000000
NODE_15500_length_722_cov_6.707865	396	476	0	80	80	1.0000000
NODE_15504_length_722_cov_4.985554	332	393	0	61	61	1.0000000
NODE_15508_length_722_cov_3.977528	217	297	0	80	80	1.0000000
NODE_15508_length_722_cov_3.977528	270	350	0	80	80	1.0000000
NODE_15553_length_721_cov_105.927653	425	505	8	7	80	0.0875000
NODE_15553_length_721_cov_105.927653	425	505	10	11	80	0.1375000
NODE_15553_length_721_cov_105.927653	425	505	12	30	80	0.3750000
NODE_15553_length_721_cov_105.927653	425	505	13	20	80	0.2500000
NODE_15553_length_721_cov_105.927653	425	505	14	12	80	0.1500000
NODE_15553_length_721_cov_105.927653	478	558	3	17	80	0.2125000
NODE_15553_length_721_cov_105.927653	478	558	5	22	80	0.2750000
NODE_15553_length_721_cov_105.927653	478	558	6	1	80	0.0125000
NODE_15553_length_721_cov_105.927653	478	558	7	9	80	0.1125000
NODE_15553_length_721_cov_105.927653	478	558	8	11	80	0.1375000
NODE_15553_length_721_cov_105.927653	478	558	10	11	80	0.1375000
NODE_15553_length_721_cov_105.927653	478	558	12	8	80	0.1000000
NODE_15553_length_721_cov_105.927653	478	558	13	1	80	0.0125000
NODE_15554_length_721_cov_49.660772	304	384	4	5	80	0.0625000
NODE_15554_length_721_cov_49.660772	304	384	5	29	80	0.3625000
NODE_15554_length_721_cov_49.660772	304	384	6	46	80	0.5750000
NODE_15554_length_721_cov_49.660772	357	437	2	43	80	0.5375000
NODE_15554_length_721_cov_49.660772	357	437	3	2	80	0.0250000
NODE_15554_length_721_cov_49.660772	357	437	4	13	80	0.1625000
NODE_15554_length_721_cov_49.660772	357	437	5	22	80	0.2750000
NODE_15555_length_721_cov_46.991961	341	421	2	14	80	0.1750000
NODE_15555_length_721_cov_46.991961	341	421	3	27	80	0.3375000
NODE_15555_length_721_cov_46.991961	341	421	4	8	80	0.1000000
NODE_15555_length_721_cov_46.991961	341	421	6	21	80	0.2625000
NODE_15555_length_721_cov_46.991961	341	421	7	10	80	0.1250000
NODE_15555_length_721_cov_46.991961	394	474	6	17	80	0.2125000
NODE_15555_length_721_cov_46.991961	394	474	7	13	80	0.1625000
NODE_15555_length_721_cov_46.991961	394	474	8	40	80	0.5000000
NODE_15555_length_721_cov_46.991961	394	474	9	8	80	0.1000000
NODE_15555_length_721_cov_46.991961	394	474	10	2	80	0.0250000
NODE_15556_length_721_cov_38.864952	208	288	0	80	80	1.0000000
NODE_15556_length_721_cov_38.864952	269	341	0	72	72	1.0000000
NODE_15556_length_721_cov_38.864952	337	417	0	80	80	1.0000000
NODE_15556_length_721_cov_38.864952	390	467	0	77	77	1.0000000
NODE_15557_length_721_cov_29.016077	192	272	0	80	80	1.0000000
NODE_15557_length_721_cov_29.016077	251	325	0	74	74	1.0000000
NODE_15558_length_721_cov_26.196141	398	478	5	57	80	0.7125000
NODE_15558_length_721_cov_26.196141	398	478	7	23	80	0.2875000
NODE_15558_length_721_cov_26.196141	451	531	4	28	80	0.3500000
NODE_15558_length_721_cov_26.196141	451	531	5	13	80	0.1625000
NODE_15558_length_721_cov_26.196141	451	531	6	1	80	0.0125000
NODE_15558_length_721_cov_26.196141	451	531	7	38	80	0.4750000
NODE_15560_length_721_cov_20.054662	178	258	0	80	80	1.0000000
NODE_15560_length_721_cov_20.054662	231	311	0	80	80	1.0000000
NODE_15561_length_721_cov_13.670418	263	343	0	11	80	0.1375000
NODE_15561_length_721_cov_13.670418	263	343	1	69	80	0.8625000
NODE_15561_length_721_cov_13.670418	316	396	1	80	80	1.0000000
NODE_15562_length_721_cov_13.652733	268	350	0	82	82	1.0000000
NODE_15562_length_721_cov_13.652733	321	403	0	82	82	1.0000000
NODE_15563_length_721_cov_13.120579	312	392	1	14	80	0.1750000
NODE_15563_length_721_cov_13.120579	312	392	3	39	80	0.4875000
NODE_15563_length_721_cov_13.120579	312	392	5	21	80	0.2625000
NODE_15563_length_721_cov_13.120579	312	392	6	2	80	0.0250000
NODE_15563_length_721_cov_13.120579	312	392	7	4	80	0.0500000
NODE_15563_length_721_cov_13.120579	365	445	5	21	80	0.2625000
NODE_15563_length_721_cov_13.120579	365	445	6	52	80	0.6500000
NODE_15563_length_721_cov_13.120579	365	445	7	7	80	0.0875000
NODE_15572_length_721_cov_4.491961	210	280	1	37	70	0.5285714
NODE_15572_length_721_cov_4.491961	210	280	2	3	70	0.0428571
NODE_15572_length_721_cov_4.491961	210	280	4	30	70	0.4285714
NODE_15572_length_721_cov_4.491961	253	333	3	26	80	0.3250000
NODE_15572_length_721_cov_4.491961	253	333	4	33	80	0.4125000
NODE_15572_length_721_cov_4.491961	253	333	5	21	80	0.2625000
NODE_15572_length_721_cov_4.491961	470	521	0	51	51	1.0000000
NODE_15608_length_720_cov_17.449275	267	347	0	80	80	1.0000000
NODE_15608_length_720_cov_17.449275	320	400	0	80	80	1.0000000
NODE_15609_length_720_cov_14.814815	261	341	4	43	80	0.5375000
NODE_15609_length_720_cov_14.814815	261	341	5	37	80	0.4625000
NODE_15609_length_720_cov_14.814815	314	394	4	11	80	0.1375000
NODE_15609_length_720_cov_14.814815	314	394	5	69	80	0.8625000
NODE_15610_length_720_cov_14.107890	290	370	1	80	80	1.0000000
NODE_15610_length_720_cov_14.107890	343	423	0	52	80	0.6500000
NODE_15610_length_720_cov_14.107890	343	423	1	28	80	0.3500000
NODE_15612_length_720_cov_12.924316	314	394	0	80	80	1.0000000
NODE_15612_length_720_cov_12.924316	367	447	0	80	80	1.0000000
NODE_15614_length_720_cov_10.389694	435	515	0	54	80	0.6750000
NODE_15614_length_720_cov_10.389694	435	515	2	26	80	0.3250000
NODE_15614_length_720_cov_10.389694	488	568	0	1	80	0.0125000
NODE_15614_length_720_cov_10.389694	488	568	2	79	80	0.9875000
NODE_15620_length_720_cov_5.278583	309	389	5	6	80	0.0750000
NODE_15620_length_720_cov_5.278583	309	389	6	17	80	0.2125000
NODE_15620_length_720_cov_5.278583	309	389	7	57	80	0.7125000
NODE_15620_length_720_cov_5.278583	362	442	4	37	80	0.4625000
NODE_15620_length_720_cov_5.278583	362	442	6	13	80	0.1625000
NODE_15620_length_720_cov_5.278583	362	442	7	30	80	0.3750000
NODE_15624_length_720_cov_3.792271	157	235	0	25	78	0.3205128
NODE_15624_length_720_cov_3.792271	157	235	2	53	78	0.6794872
NODE_15624_length_720_cov_3.792271	215	265	2	50	50	1.0000000
NODE_15658_length_719_cov_30.256452	279	359	1	64	80	0.8000000
NODE_15658_length_719_cov_30.256452	279	359	2	16	80	0.2000000
NODE_15658_length_719_cov_30.256452	332	412	1	64	80	0.8000000
NODE_15658_length_719_cov_30.256452	332	412	2	16	80	0.2000000
NODE_15659_length_719_cov_29.093548	310	390	3	80	80	1.0000000
NODE_15659_length_719_cov_29.093548	363	443	2	13	80	0.1625000
NODE_15659_length_719_cov_29.093548	363	443	3	44	80	0.5500000
NODE_15659_length_719_cov_29.093548	363	443	4	23	80	0.2875000
NODE_15660_length_719_cov_10.988710	195	275	3	59	80	0.7375000
NODE_15660_length_719_cov_10.988710	195	275	4	9	80	0.1125000
NODE_15660_length_719_cov_10.988710	195	275	5	12	80	0.1500000
NODE_15660_length_719_cov_10.988710	248	328	3	6	80	0.0750000
NODE_15660_length_719_cov_10.988710	248	328	4	46	80	0.5750000
NODE_15660_length_719_cov_10.988710	248	328	5	12	80	0.1500000
NODE_15660_length_719_cov_10.988710	248	328	6	16	80	0.2000000
NODE_15661_length_719_cov_10.837097	259	339	1	80	80	1.0000000
NODE_15661_length_719_cov_10.837097	312	392	1	80	80	1.0000000
NODE_15662_length_719_cov_7.622581	288	368	0	80	80	1.0000000
NODE_15662_length_719_cov_7.622581	341	421	0	80	80	1.0000000
NODE_15663_length_719_cov_7.570968	351	431	5	39	80	0.4875000
NODE_15663_length_719_cov_7.570968	351	431	6	41	80	0.5125000
NODE_15663_length_719_cov_7.570968	404	484	3	36	80	0.4500000
NODE_15663_length_719_cov_7.570968	404	484	4	10	80	0.1250000
NODE_15663_length_719_cov_7.570968	404	484	5	9	80	0.1125000
NODE_15663_length_719_cov_7.570968	404	484	6	25	80	0.3125000
NODE_15672_length_719_cov_4.264516	251	281	0	30	30	1.0000000
NODE_15684_length_719_cov_1.629032	88	163	0	38	75	0.5066667
NODE_15684_length_719_cov_1.629032	88	163	2	18	75	0.2400000
NODE_15684_length_719_cov_1.629032	88	163	4	11	75	0.1466667
NODE_15684_length_719_cov_1.629032	88	163	6	8	75	0.1066667
NODE_15706_length_718_cov_35.382876	296	376	2	12	80	0.1500000
NODE_15706_length_718_cov_35.382876	296	376	4	51	80	0.6375000
NODE_15706_length_718_cov_35.382876	296	376	5	17	80	0.2125000
NODE_15706_length_718_cov_35.382876	296	376	2	12	80	0.1500000
NODE_15706_length_718_cov_35.382876	296	376	4	51	80	0.6375000
NODE_15706_length_718_cov_35.382876	296	376	5	17	80	0.2125000
NODE_15706_length_718_cov_35.382876	349	429	0	35	80	0.4375000
NODE_15706_length_718_cov_35.382876	349	429	2	30	80	0.3750000
NODE_15706_length_718_cov_35.382876	349	429	4	15	80	0.1875000
NODE_15706_length_718_cov_35.382876	349	429	0	35	80	0.4375000
NODE_15706_length_718_cov_35.382876	349	429	2	30	80	0.3750000
NODE_15706_length_718_cov_35.382876	349	429	4	15	80	0.1875000
NODE_15707_length_718_cov_24.211632	313	393	0	80	80	1.0000000
NODE_15707_length_718_cov_24.211632	366	446	0	80	80	1.0000000
NODE_15708_length_718_cov_18.300485	217	297	0	80	80	1.0000000
NODE_15708_length_718_cov_18.300485	270	350	0	80	80	1.0000000
NODE_15709_length_718_cov_14.757674	383	463	2	16	80	0.2000000
NODE_15709_length_718_cov_14.757674	383	463	4	64	80	0.8000000
NODE_15709_length_718_cov_14.757674	436	516	0	52	80	0.6500000
NODE_15709_length_718_cov_14.757674	436	516	2	17	80	0.2125000
NODE_15709_length_718_cov_14.757674	436	516	4	11	80	0.1375000
NODE_15710_length_718_cov_14.355412	254	334	0	80	80	1.0000000
NODE_15710_length_718_cov_14.355412	307	387	0	80	80	1.0000000
NODE_15715_length_718_cov_4.804523	263	343	0	26	80	0.3250000
NODE_15715_length_718_cov_4.804523	263	343	1	54	80	0.6750000
NODE_15715_length_718_cov_4.804523	316	396	1	80	80	1.0000000
NODE_15750_length_717_cov_28.377023	335	415	0	80	80	1.0000000
NODE_15750_length_717_cov_28.377023	388	468	0	80	80	1.0000000
NODE_15751_length_717_cov_23.275081	162	242	1	77	80	0.9625000
NODE_15751_length_717_cov_23.275081	162	242	2	3	80	0.0375000
NODE_15751_length_717_cov_23.275081	215	295	1	80	80	1.0000000
NODE_15752_length_717_cov_18.564725	319	399	2	70	80	0.8750000
NODE_15752_length_717_cov_18.564725	319	399	3	10	80	0.1250000
NODE_15752_length_717_cov_18.564725	372	452	2	68	80	0.8500000
NODE_15752_length_717_cov_18.564725	372	452	3	12	80	0.1500000
NODE_15753_length_717_cov_18.389968	358	438	1	80	80	1.0000000
NODE_15753_length_717_cov_18.389968	411	491	0	9	80	0.1125000
NODE_15753_length_717_cov_18.389968	411	491	1	71	80	0.8875000
NODE_15754_length_717_cov_17.932039	241	321	1	80	80	1.0000000
NODE_15754_length_717_cov_17.932039	294	374	0	41	80	0.5125000
NODE_15754_length_717_cov_17.932039	294	374	1	39	80	0.4875000
NODE_15755_length_717_cov_14.637540	298	378	0	80	80	1.0000000
NODE_15755_length_717_cov_14.637540	351	431	0	80	80	1.0000000
NODE_15756_length_717_cov_12.279935	113	196	0	83	83	1.0000000
NODE_15756_length_717_cov_12.279935	169	249	0	80	80	1.0000000
NODE_15757_length_717_cov_10.711974	353	431	1	78	78	1.0000000
NODE_15758_length_717_cov_9.399676	331	411	1	20	80	0.2500000
NODE_15758_length_717_cov_9.399676	331	411	2	60	80	0.7500000
NODE_15758_length_717_cov_9.399676	384	464	2	80	80	1.0000000
NODE_15762_length_717_cov_5.341424	475	555	1	80	80	1.0000000
NODE_15762_length_717_cov_5.341424	528	608	1	55	80	0.6875000
NODE_15762_length_717_cov_5.341424	528	608	2	25	80	0.3125000
NODE_15770_length_717_cov_3.187702	285	322	0	20	37	0.5405405
NODE_15770_length_717_cov_3.187702	285	322	2	17	37	0.4594595
NODE_15805_length_716_cov_16.800648	430	510	2	60	80	0.7500000
NODE_15805_length_716_cov_16.800648	430	510	4	20	80	0.2500000
NODE_15805_length_716_cov_16.800648	483	563	2	11	80	0.1375000
NODE_15805_length_716_cov_16.800648	483	563	4	69	80	0.8625000
NODE_15806_length_716_cov_12.565640	356	436	0	62	80	0.7750000
NODE_15806_length_716_cov_12.565640	356	436	2	18	80	0.2250000
NODE_15806_length_716_cov_12.565640	409	489	0	9	80	0.1125000
NODE_15806_length_716_cov_12.565640	409	489	2	37	80	0.4625000
NODE_15806_length_716_cov_12.565640	409	489	3	34	80	0.4250000
NODE_15807_length_716_cov_9.277147	385	465	0	80	80	1.0000000
NODE_15807_length_716_cov_9.277147	438	518	0	80	80	1.0000000
NODE_15808_length_716_cov_9.257699	302	382	0	80	80	1.0000000
NODE_15808_length_716_cov_9.257699	355	435	0	80	80	1.0000000
NODE_15809_length_716_cov_6.761750	263	343	0	80	80	1.0000000
NODE_15809_length_716_cov_6.761750	316	396	0	80	80	1.0000000
NODE_15812_length_716_cov_4.909238	236	316	0	80	80	1.0000000
NODE_15812_length_716_cov_4.909238	289	369	0	80	80	1.0000000
NODE_15824_length_716_cov_2.068071	453	481	1	28	28	1.0000000
NODE_15853_length_715_cov_38.795455	260	340	0	80	80	1.0000000
NODE_15853_length_715_cov_38.795455	313	393	0	80	80	1.0000000
NODE_15854_length_715_cov_30.344156	316	396	3	5	80	0.0625000
NODE_15854_length_715_cov_30.344156	316	396	4	11	80	0.1375000
NODE_15854_length_715_cov_30.344156	316	396	5	5	80	0.0625000
NODE_15854_length_715_cov_30.344156	316	396	6	59	80	0.7375000
NODE_15854_length_715_cov_30.344156	369	449	5	16	80	0.2000000
NODE_15854_length_715_cov_30.344156	369	449	6	64	80	0.8000000
NODE_15857_length_715_cov_11.209416	484	564	0	20	80	0.2500000
NODE_15857_length_715_cov_11.209416	484	564	2	60	80	0.7500000
NODE_15857_length_715_cov_11.209416	537	617	0	9	80	0.1125000
NODE_15857_length_715_cov_11.209416	537	617	2	71	80	0.8875000
NODE_15858_length_715_cov_10.894481	189	242	2	10	53	0.1886792
NODE_15858_length_715_cov_10.894481	189	242	4	43	53	0.8113208
NODE_15859_length_715_cov_10.628247	502	582	0	80	80	1.0000000
NODE_15859_length_715_cov_10.628247	555	635	0	80	80	1.0000000
NODE_15860_length_715_cov_8.647727	138	218	0	4	80	0.0500000
NODE_15860_length_715_cov_8.647727	138	218	1	76	80	0.9500000
NODE_15860_length_715_cov_8.647727	191	271	1	80	80	1.0000000
NODE_15861_length_715_cov_8.412338	364	444	0	80	80	1.0000000
NODE_15861_length_715_cov_8.412338	417	497	0	80	80	1.0000000
NODE_15864_length_715_cov_5.373377	318	398	0	80	80	1.0000000
NODE_15864_length_715_cov_5.373377	371	451	0	80	80	1.0000000
NODE_15898_length_715_cov_1.271104	331	397	0	4	66	0.0606061
NODE_15898_length_715_cov_1.271104	331	397	1	62	66	0.9393939
NODE_15910_length_714_cov_18.621138	297	377	0	80	80	1.0000000
NODE_15910_length_714_cov_18.621138	350	430	0	80	80	1.0000000
NODE_15911_length_714_cov_15.468293	268	348	2	80	80	1.0000000
NODE_15911_length_714_cov_15.468293	321	401	0	35	80	0.4375000
NODE_15911_length_714_cov_15.468293	321	401	1	5	80	0.0625000
NODE_15911_length_714_cov_15.468293	321	401	2	40	80	0.5000000
NODE_15913_length_714_cov_10.530081	218	298	0	4	80	0.0500000
NODE_15913_length_714_cov_10.530081	218	298	1	76	80	0.9500000
NODE_15913_length_714_cov_10.530081	271	351	1	43	80	0.5375000
NODE_15913_length_714_cov_10.530081	271	351	2	37	80	0.4625000
NODE_15913_length_714_cov_10.530081	354	434	1	54	80	0.6750000
NODE_15913_length_714_cov_10.530081	354	434	2	26	80	0.3250000
NODE_15913_length_714_cov_10.530081	407	487	1	42	80	0.5250000
NODE_15913_length_714_cov_10.530081	407	487	2	38	80	0.4750000
NODE_15914_length_714_cov_8.365854	285	365	0	25	80	0.3125000
NODE_15914_length_714_cov_8.365854	285	365	1	16	80	0.2000000
NODE_15914_length_714_cov_8.365854	285	365	3	39	80	0.4875000
NODE_15914_length_714_cov_8.365854	338	418	3	80	80	1.0000000
NODE_15919_length_714_cov_6.993496	263	343	1	19	80	0.2375000
NODE_15919_length_714_cov_6.993496	263	343	2	11	80	0.1375000
NODE_15919_length_714_cov_6.993496	263	343	3	50	80	0.6250000
NODE_15919_length_714_cov_6.993496	316	384	1	34	68	0.5000000
NODE_15919_length_714_cov_6.993496	316	384	2	13	68	0.1911765
NODE_15919_length_714_cov_6.993496	316	384	4	21	68	0.3088235
NODE_15921_length_714_cov_4.224390	218	288	0	70	70	1.0000000
NODE_15921_length_714_cov_4.224390	271	351	0	80	80	1.0000000
NODE_15969_length_713_cov_19.304560	271	351	3	41	80	0.5125000
NODE_15969_length_713_cov_19.304560	271	351	4	39	80	0.4875000
NODE_15969_length_713_cov_19.304560	324	404	2	28	80	0.3500000
NODE_15969_length_713_cov_19.304560	324	404	3	52	80	0.6500000
NODE_15970_length_713_cov_16.926710	262	342	7	4	80	0.0500000
NODE_15970_length_713_cov_16.926710	262	342	8	14	80	0.1750000
NODE_15970_length_713_cov_16.926710	262	342	9	26	80	0.3250000
NODE_15970_length_713_cov_16.926710	262	342	10	7	80	0.0875000
NODE_15970_length_713_cov_16.926710	262	342	11	29	80	0.3625000
NODE_15970_length_713_cov_16.926710	315	395	7	15	80	0.1875000
NODE_15970_length_713_cov_16.926710	315	395	8	19	80	0.2375000
NODE_15970_length_713_cov_16.926710	315	395	9	20	80	0.2500000
NODE_15970_length_713_cov_16.926710	315	395	10	18	80	0.2250000
NODE_15970_length_713_cov_16.926710	315	395	11	8	80	0.1000000
NODE_15973_length_713_cov_7.159609	351	431	0	80	80	1.0000000
NODE_15973_length_713_cov_7.159609	404	484	0	80	80	1.0000000
NODE_15974_length_713_cov_6.723127	379	427	0	48	48	1.0000000
NODE_15975_length_713_cov_4.954397	90	171	5	20	81	0.2469136
NODE_15975_length_713_cov_4.954397	90	171	6	26	81	0.3209876
NODE_15975_length_713_cov_4.954397	90	171	7	32	81	0.3950617
NODE_15975_length_713_cov_4.954397	90	171	8	3	81	0.0370370
NODE_15975_length_713_cov_4.954397	144	224	6	3	80	0.0375000
NODE_15975_length_713_cov_4.954397	144	224	7	66	80	0.8250000
NODE_15975_length_713_cov_4.954397	144	224	8	11	80	0.1375000
NODE_15980_length_713_cov_4.302932	402	482	2	41	80	0.5125000
NODE_15980_length_713_cov_4.302932	402	482	3	12	80	0.1500000
NODE_15980_length_713_cov_4.302932	402	482	4	27	80	0.3375000
NODE_15980_length_713_cov_4.302932	455	535	2	38	80	0.4750000
NODE_15980_length_713_cov_4.302932	455	535	4	42	80	0.5250000
NODE_16004_length_713_cov_1.939739	15	75	0	60	60	1.0000000
NODE_16010_length_713_cov_1.605863	81	161	0	42	80	0.5250000
NODE_16010_length_713_cov_1.605863	81	161	2	38	80	0.4750000
NODE_16010_length_713_cov_1.605863	134	214	0	80	80	1.0000000
NODE_16052_length_712_cov_32.931485	289	369	2	80	80	1.0000000
NODE_16052_length_712_cov_32.931485	342	422	0	25	80	0.3125000
NODE_16052_length_712_cov_32.931485	342	422	2	55	80	0.6875000
NODE_16053_length_712_cov_31.752039	185	251	1	66	66	1.0000000
NODE_16053_length_712_cov_31.752039	228	307	1	79	79	1.0000000
NODE_16054_length_712_cov_22.567700	228	308	0	30	80	0.3750000
NODE_16054_length_712_cov_22.567700	228	308	2	50	80	0.6250000
NODE_16054_length_712_cov_22.567700	281	361	2	80	80	1.0000000
NODE_16055_length_712_cov_19.306688	238	318	0	80	80	1.0000000
NODE_16055_length_712_cov_19.306688	291	371	0	80	80	1.0000000
NODE_16056_length_712_cov_14.929853	332	412	2	80	80	1.0000000
NODE_16056_length_712_cov_14.929853	385	465	0	52	80	0.6500000
NODE_16056_length_712_cov_14.929853	385	465	2	28	80	0.3500000
NODE_16057_length_712_cov_14.228385	250	330	0	80	80	1.0000000
NODE_16057_length_712_cov_14.228385	303	383	0	80	80	1.0000000
NODE_16059_length_712_cov_9.221860	326	406	0	80	80	1.0000000
NODE_16059_length_712_cov_9.221860	379	463	0	84	84	1.0000000
NODE_16060_length_712_cov_8.368679	331	411	0	43	80	0.5375000
NODE_16060_length_712_cov_8.368679	331	411	1	1	80	0.0125000
NODE_16060_length_712_cov_8.368679	331	411	2	36	80	0.4500000
NODE_16060_length_712_cov_8.368679	384	464	0	80	80	1.0000000
NODE_16079_length_712_cov_2.350734	466	510	0	43	44	0.9772727
NODE_16079_length_712_cov_2.350734	466	510	2	1	44	0.0227273
NODE_16118_length_711_cov_36.459150	146	223	0	77	77	1.0000000
NODE_16118_length_711_cov_36.459150	199	280	0	81	81	1.0000000
NODE_16119_length_711_cov_26.702614	460	540	1	51	80	0.6375000
NODE_16119_length_711_cov_26.702614	460	540	2	25	80	0.3125000
NODE_16119_length_711_cov_26.702614	460	540	3	4	80	0.0500000
NODE_16119_length_711_cov_26.702614	513	593	1	2	80	0.0250000
NODE_16119_length_711_cov_26.702614	513	593	2	21	80	0.2625000
NODE_16119_length_711_cov_26.702614	513	593	3	57	80	0.7125000
NODE_16120_length_711_cov_19.632353	329	409	1	60	80	0.7500000
NODE_16120_length_711_cov_19.632353	329	409	2	20	80	0.2500000
NODE_16120_length_711_cov_19.632353	382	462	1	80	80	1.0000000
NODE_16121_length_711_cov_19.267974	283	363	2	73	80	0.9125000
NODE_16121_length_711_cov_19.267974	283	363	3	7	80	0.0875000
NODE_16121_length_711_cov_19.267974	336	416	2	77	80	0.9625000
NODE_16121_length_711_cov_19.267974	336	416	3	3	80	0.0375000
NODE_16122_length_711_cov_12.813725	255	334	4	9	79	0.1139240
NODE_16122_length_711_cov_12.813725	255	334	6	70	79	0.8860760
NODE_16123_length_711_cov_12.147059	314	394	0	80	80	1.0000000
NODE_16123_length_711_cov_12.147059	367	447	0	80	80	1.0000000
NODE_16124_length_711_cov_10.009804	336	415	2	20	79	0.2531646
NODE_16124_length_711_cov_10.009804	336	415	3	4	79	0.0506329
NODE_16124_length_711_cov_10.009804	336	415	4	55	79	0.6962025
NODE_16127_length_711_cov_5.619281	276	356	0	80	80	1.0000000
NODE_16127_length_711_cov_5.619281	329	409	0	80	80	1.0000000
NODE_16130_length_711_cov_4.040850	165	245	0	80	80	1.0000000
NODE_16130_length_711_cov_4.040850	218	298	0	80	80	1.0000000
NODE_16167_length_710_cov_73.721768	626	706	0	80	80	1.0000000
NODE_16168_length_710_cov_21.772504	292	372	0	42	80	0.5250000
NODE_16168_length_710_cov_21.772504	292	372	2	38	80	0.4750000
NODE_16168_length_710_cov_21.772504	345	425	0	80	80	1.0000000
NODE_16169_length_710_cov_21.597381	18	54	0	36	36	1.0000000
NODE_16170_length_710_cov_13.155483	306	386	4	46	80	0.5750000
NODE_16170_length_710_cov_13.155483	306	386	5	34	80	0.4250000
NODE_16170_length_710_cov_13.155483	359	439	1	5	80	0.0625000
NODE_16170_length_710_cov_13.155483	359	439	2	3	80	0.0375000
NODE_16170_length_710_cov_13.155483	359	439	3	25	80	0.3125000
NODE_16170_length_710_cov_13.155483	359	439	4	25	80	0.3125000
NODE_16170_length_710_cov_13.155483	359	439	5	22	80	0.2750000
NODE_16173_length_710_cov_8.031097	316	396	0	80	80	1.0000000
NODE_16173_length_710_cov_8.031097	369	449	0	80	80	1.0000000
NODE_16175_length_710_cov_6.664484	264	344	0	10	80	0.1250000
NODE_16175_length_710_cov_6.664484	264	344	1	70	80	0.8750000
NODE_16178_length_710_cov_5.590835	352	421	1	42	69	0.6086956
NODE_16178_length_710_cov_5.590835	352	421	3	13	69	0.1884058
NODE_16178_length_710_cov_5.590835	352	421	4	14	69	0.2028985
NODE_16178_length_710_cov_5.590835	394	474	3	27	80	0.3375000
NODE_16178_length_710_cov_5.590835	394	474	4	53	80	0.6625000
NODE_16180_length_710_cov_5.356792	248	328	2	62	80	0.7750000
NODE_16180_length_710_cov_5.356792	248	328	3	16	80	0.2000000
NODE_16180_length_710_cov_5.356792	248	328	4	2	80	0.0250000
NODE_16180_length_710_cov_5.356792	301	381	2	9	80	0.1125000
NODE_16180_length_710_cov_5.356792	301	381	3	45	80	0.5625000
NODE_16180_length_710_cov_5.356792	301	381	4	7	80	0.0875000
NODE_16180_length_710_cov_5.356792	301	381	5	10	80	0.1250000
NODE_16180_length_710_cov_5.356792	301	381	6	9	80	0.1125000
NODE_16233_length_709_cov_12.227869	347	427	0	80	80	1.0000000
NODE_16233_length_709_cov_12.227869	400	480	0	80	80	1.0000000
NODE_16234_length_709_cov_10.531148	279	359	0	70	80	0.8750000
NODE_16234_length_709_cov_10.531148	279	359	1	10	80	0.1250000
NODE_16234_length_709_cov_10.531148	332	412	0	80	80	1.0000000
NODE_16238_length_709_cov_7.181967	225	305	0	80	80	1.0000000
NODE_16238_length_709_cov_7.181967	279	312	0	33	33	1.0000000
NODE_16241_length_709_cov_5.888525	239	319	0	41	80	0.5125000
NODE_16241_length_709_cov_5.888525	239	319	1	39	80	0.4875000
NODE_16241_length_709_cov_5.888525	292	372	0	80	80	1.0000000
NODE_16294_length_708_cov_42.435140	307	387	3	1	80	0.0125000
NODE_16294_length_708_cov_42.435140	307	387	4	9	80	0.1125000
NODE_16294_length_708_cov_42.435140	307	387	5	10	80	0.1250000
NODE_16294_length_708_cov_42.435140	307	387	6	9	80	0.1125000
NODE_16294_length_708_cov_42.435140	307	387	7	2	80	0.0250000
NODE_16294_length_708_cov_42.435140	307	387	8	18	80	0.2250000
NODE_16294_length_708_cov_42.435140	307	387	10	18	80	0.2250000
NODE_16294_length_708_cov_42.435140	307	387	12	4	80	0.0500000
NODE_16294_length_708_cov_42.435140	307	387	13	9	80	0.1125000
NODE_16294_length_708_cov_42.435140	360	440	10	18	80	0.2250000
NODE_16294_length_708_cov_42.435140	360	440	11	17	80	0.2125000
NODE_16294_length_708_cov_42.435140	360	440	12	36	80	0.4500000
NODE_16294_length_708_cov_42.435140	360	440	13	9	80	0.1125000
NODE_16296_length_708_cov_33.412151	235	315	2	40	80	0.5000000
NODE_16296_length_708_cov_33.412151	235	315	3	40	80	0.5000000
NODE_16296_length_708_cov_33.412151	288	368	3	68	80	0.8500000
NODE_16296_length_708_cov_33.412151	288	368	4	12	80	0.1500000
NODE_16297_length_708_cov_23.034483	316	396	0	80	80	1.0000000
NODE_16297_length_708_cov_23.034483	369	449	0	80	80	1.0000000
NODE_16298_length_708_cov_20.449918	254	334	4	11	80	0.1375000
NODE_16298_length_708_cov_20.449918	254	334	6	21	80	0.2625000
NODE_16298_length_708_cov_20.449918	254	334	7	48	80	0.6000000
NODE_16298_length_708_cov_20.449918	307	387	4	11	80	0.1375000
NODE_16298_length_708_cov_20.449918	307	387	5	10	80	0.1250000
NODE_16298_length_708_cov_20.449918	307	387	6	29	80	0.3625000
NODE_16298_length_708_cov_20.449918	307	387	7	30	80	0.3750000
NODE_16299_length_708_cov_19.998358	238	318	0	80	80	1.0000000
NODE_16299_length_708_cov_19.998358	291	371	0	80	80	1.0000000
NODE_16300_length_708_cov_19.021346	366	446	0	80	80	1.0000000
NODE_16300_length_708_cov_19.021346	419	499	0	80	80	1.0000000
NODE_16302_length_708_cov_12.228243	181	263	4	15	82	0.1829268
NODE_16302_length_708_cov_12.228243	181	263	5	61	82	0.7439024
NODE_16302_length_708_cov_12.228243	181	263	6	6	82	0.0731707
NODE_16302_length_708_cov_12.228243	188	268	4	19	80	0.2375000
NODE_16302_length_708_cov_12.228243	188	268	5	54	80	0.6750000
NODE_16302_length_708_cov_12.228243	188	268	6	7	80	0.0875000
NODE_16302_length_708_cov_12.228243	236	316	2	27	80	0.3375000
NODE_16302_length_708_cov_12.228243	236	316	3	3	80	0.0375000
NODE_16302_length_708_cov_12.228243	236	316	4	22	80	0.2750000
NODE_16302_length_708_cov_12.228243	236	316	5	21	80	0.2625000
NODE_16302_length_708_cov_12.228243	236	316	6	7	80	0.0875000
NODE_16302_length_708_cov_12.228243	312	392	1	42	80	0.5250000
NODE_16302_length_708_cov_12.228243	312	392	2	38	80	0.4750000
NODE_16302_length_708_cov_12.228243	312	392	1	42	80	0.5250000
NODE_16302_length_708_cov_12.228243	312	392	2	38	80	0.4750000
NODE_16302_length_708_cov_12.228243	365	445	0	52	80	0.6500000
NODE_16302_length_708_cov_12.228243	365	445	1	28	80	0.3500000
NODE_16303_length_708_cov_11.338259	255	335	2	80	80	1.0000000
NODE_16303_length_708_cov_11.338259	308	388	0	32	80	0.4000000
NODE_16303_length_708_cov_11.338259	308	388	2	48	80	0.6000000
NODE_16305_length_708_cov_9.676519	219	299	0	80	80	1.0000000
NODE_16305_length_708_cov_9.676519	272	352	0	80	80	1.0000000
NODE_16306_length_708_cov_8.638752	324	399	0	27	75	0.3600000
NODE_16306_length_708_cov_8.638752	324	399	2	48	75	0.6400000
NODE_16330_length_708_cov_2.699507	358	398	1	32	40	0.8000000
NODE_16330_length_708_cov_2.699507	358	398	2	8	40	0.2000000
NODE_16370_length_707_cov_30.067434	325	405	4	80	80	1.0000000
NODE_16370_length_707_cov_30.067434	378	458	2	9	80	0.1125000
NODE_16370_length_707_cov_30.067434	378	458	3	39	80	0.4875000
NODE_16370_length_707_cov_30.067434	378	458	4	32	80	0.4000000
NODE_16371_length_707_cov_26.555921	241	321	3	12	80	0.1500000
NODE_16371_length_707_cov_26.555921	241	321	5	59	80	0.7375000
NODE_16371_length_707_cov_26.555921	241	321	6	9	80	0.1125000
NODE_16371_length_707_cov_26.555921	294	374	3	45	80	0.5625000
NODE_16371_length_707_cov_26.555921	294	374	4	8	80	0.1000000
NODE_16371_length_707_cov_26.555921	294	374	5	18	80	0.2250000
NODE_16371_length_707_cov_26.555921	294	374	6	9	80	0.1125000
NODE_16372_length_707_cov_23.972039	322	402	6	5	80	0.0625000
NODE_16372_length_707_cov_23.972039	322	402	7	5	80	0.0625000
NODE_16372_length_707_cov_23.972039	322	402	8	34	80	0.4250000
NODE_16372_length_707_cov_23.972039	322	402	9	21	80	0.2625000
NODE_16372_length_707_cov_23.972039	322	402	10	15	80	0.1875000
NODE_16372_length_707_cov_23.972039	375	455	4	20	80	0.2500000
NODE_16372_length_707_cov_23.972039	375	455	5	19	80	0.2375000
NODE_16372_length_707_cov_23.972039	375	455	6	9	80	0.1125000
NODE_16372_length_707_cov_23.972039	375	455	8	30	80	0.3750000
NODE_16372_length_707_cov_23.972039	375	455	9	2	80	0.0250000
NODE_16373_length_707_cov_20.348684	157	237	0	36	80	0.4500000
NODE_16373_length_707_cov_20.348684	157	237	1	44	80	0.5500000
NODE_16373_length_707_cov_20.348684	210	281	0	71	71	1.0000000
NODE_16374_length_707_cov_18.970395	253	333	1	2	80	0.0250000
NODE_16374_length_707_cov_18.970395	253	333	2	78	80	0.9750000
NODE_16374_length_707_cov_18.970395	306	386	2	80	80	1.0000000
NODE_16375_length_707_cov_14.324013	302	382	0	80	80	1.0000000
NODE_16375_length_707_cov_14.324013	355	435	0	80	80	1.0000000
NODE_16378_length_707_cov_5.062500	313	393	0	80	80	1.0000000
NODE_16441_length_706_cov_34.116969	272	352	3	15	80	0.1875000
NODE_16441_length_706_cov_34.116969	272	352	4	1	80	0.0125000
NODE_16441_length_706_cov_34.116969	272	352	5	18	80	0.2250000
NODE_16441_length_706_cov_34.116969	272	352	6	37	80	0.4625000
NODE_16441_length_706_cov_34.116969	272	352	8	9	80	0.1125000
NODE_16441_length_706_cov_34.116969	325	405	6	22	80	0.2750000
NODE_16441_length_706_cov_34.116969	325	405	7	8	80	0.1000000
NODE_16441_length_706_cov_34.116969	325	405	8	50	80	0.6250000
NODE_16442_length_706_cov_27.220758	229	309	0	65	80	0.8125000
NODE_16442_length_706_cov_27.220758	229	309	1	15	80	0.1875000
NODE_16442_length_706_cov_27.220758	282	362	0	12	80	0.1500000
NODE_16442_length_706_cov_27.220758	282	362	1	35	80	0.4375000
NODE_16442_length_706_cov_27.220758	282	362	2	33	80	0.4125000
NODE_16443_length_706_cov_20.380560	264	344	0	58	80	0.7250000
NODE_16443_length_706_cov_20.380560	264	344	2	22	80	0.2750000
NODE_16443_length_706_cov_20.380560	317	397	0	5	80	0.0625000
NODE_16443_length_706_cov_20.380560	317	397	2	75	80	0.9375000
NODE_16444_length_706_cov_19.525535	289	369	0	21	80	0.2625000
NODE_16444_length_706_cov_19.525535	289	369	1	55	80	0.6875000
NODE_16444_length_706_cov_19.525535	289	369	3	4	80	0.0500000
NODE_16444_length_706_cov_19.525535	342	422	1	23	80	0.2875000
NODE_16444_length_706_cov_19.525535	342	422	3	52	80	0.6500000
NODE_16444_length_706_cov_19.525535	342	422	5	5	80	0.0625000
NODE_16454_length_706_cov_3.344316	465	545	0	80	80	1.0000000
NODE_16454_length_706_cov_3.344316	518	598	0	80	80	1.0000000
NODE_16494_length_705_cov_19.211221	118	198	2	53	80	0.6625000
NODE_16494_length_705_cov_19.211221	118	198	3	24	80	0.3000000
NODE_16494_length_705_cov_19.211221	118	198	4	3	80	0.0375000
NODE_16494_length_705_cov_19.211221	171	250	2	11	79	0.1392405
NODE_16494_length_705_cov_19.211221	171	250	3	24	79	0.3037975
NODE_16494_length_705_cov_19.211221	171	250	4	44	79	0.5569620
NODE_16495_length_705_cov_16.338284	291	339	0	48	48	1.0000000
NODE_16495_length_705_cov_16.338284	336	406	0	70	70	1.0000000
NODE_16496_length_705_cov_14.354785	209	289	0	44	80	0.5500000
NODE_16496_length_705_cov_14.354785	209	289	1	36	80	0.4500000
NODE_16496_length_705_cov_14.354785	262	342	1	80	80	1.0000000
NODE_16497_length_705_cov_12.231023	293	373	2	80	80	1.0000000
NODE_16497_length_705_cov_12.231023	346	426	0	16	80	0.2000000
NODE_16497_length_705_cov_12.231023	346	426	1	9	80	0.1125000
NODE_16497_length_705_cov_12.231023	346	426	2	55	80	0.6875000
NODE_16498_length_705_cov_11.836634	390	470	3	9	80	0.1125000
NODE_16498_length_705_cov_11.836634	390	470	4	27	80	0.3375000
NODE_16498_length_705_cov_11.836634	390	470	5	12	80	0.1500000
NODE_16498_length_705_cov_11.836634	390	470	6	32	80	0.4000000
NODE_16498_length_705_cov_11.836634	443	523	4	15	80	0.1875000
NODE_16498_length_705_cov_11.836634	443	523	5	25	80	0.3125000
NODE_16498_length_705_cov_11.836634	443	523	6	40	80	0.5000000
NODE_16499_length_705_cov_10.049505	382	479	0	97	97	1.0000000
NODE_16499_length_705_cov_10.049505	452	532	0	80	80	1.0000000
NODE_16507_length_705_cov_4.275578	358	438	0	80	80	1.0000000
NODE_16507_length_705_cov_4.275578	411	491	0	80	80	1.0000000
NODE_16509_length_705_cov_4.018152	306	364	3	58	58	1.0000000
NODE_16509_length_705_cov_4.018152	337	410	1	13	73	0.1780822
NODE_16509_length_705_cov_4.018152	337	410	3	30	73	0.4109589
NODE_16509_length_705_cov_4.018152	337	410	4	30	73	0.4109589
NODE_16511_length_705_cov_3.620462	253	315	5	6	62	0.0967742
NODE_16511_length_705_cov_3.620462	253	315	6	32	62	0.5161290
NODE_16511_length_705_cov_3.620462	253	315	9	4	62	0.0645161
NODE_16511_length_705_cov_3.620462	253	315	10	20	62	0.3225806
NODE_16511_length_705_cov_3.620462	308	368	6	10	60	0.1666667
NODE_16511_length_705_cov_3.620462	308	368	7	12	60	0.2000000
NODE_16511_length_705_cov_3.620462	308	368	8	29	60	0.4833333
NODE_16511_length_705_cov_3.620462	308	368	9	9	60	0.1500000
NODE_16527_length_705_cov_1.607261	462	531	3	3	69	0.0434783
NODE_16527_length_705_cov_1.607261	462	531	4	3	69	0.0434783
NODE_16527_length_705_cov_1.607261	462	531	5	21	69	0.3043478
NODE_16527_length_705_cov_1.607261	462	531	6	23	69	0.3333333
NODE_16527_length_705_cov_1.607261	462	531	7	2	69	0.0289855
NODE_16527_length_705_cov_1.607261	462	531	11	3	69	0.0434783
NODE_16527_length_705_cov_1.607261	462	531	14	14	69	0.2028985
NODE_16549_length_705_cov_0.529703	33	97	0	64	64	1.0000000
NODE_16549_length_705_cov_0.529703	86	150	0	64	64	1.0000000
NODE_16550_length_704_cov_18.256198	295	375	1	6	80	0.0750000
NODE_16550_length_704_cov_18.256198	295	375	2	12	80	0.1500000
NODE_16550_length_704_cov_18.256198	295	375	3	62	80	0.7750000
NODE_16550_length_704_cov_18.256198	348	428	0	11	80	0.1375000
NODE_16550_length_704_cov_18.256198	348	428	2	31	80	0.3875000
NODE_16550_length_704_cov_18.256198	348	428	3	38	80	0.4750000
NODE_16552_length_704_cov_16.662810	264	344	0	59	80	0.7375000
NODE_16552_length_704_cov_16.662810	264	344	1	21	80	0.2625000
NODE_16552_length_704_cov_16.662810	317	397	0	6	80	0.0750000
NODE_16552_length_704_cov_16.662810	317	397	1	46	80	0.5750000
NODE_16552_length_704_cov_16.662810	317	397	2	28	80	0.3500000
NODE_16553_length_704_cov_12.641322	294	374	3	51	80	0.6375000
NODE_16553_length_704_cov_12.641322	294	374	4	29	80	0.3625000
NODE_16553_length_704_cov_12.641322	347	427	1	48	80	0.6000000
NODE_16553_length_704_cov_12.641322	347	427	3	14	80	0.1750000
NODE_16553_length_704_cov_12.641322	347	427	4	18	80	0.2250000
NODE_16557_length_704_cov_5.603306	440	498	1	16	58	0.2758621
NODE_16557_length_704_cov_5.603306	440	498	2	42	58	0.7241379
NODE_16564_length_704_cov_3.535537	303	383	0	8	80	0.1000000
NODE_16564_length_704_cov_3.535537	303	383	1	54	80	0.6750000
NODE_16564_length_704_cov_3.535537	303	383	2	5	80	0.0625000
NODE_16564_length_704_cov_3.535537	303	383	3	13	80	0.1625000
NODE_16564_length_704_cov_3.535537	369	436	1	17	67	0.2537313
NODE_16564_length_704_cov_3.535537	369	436	2	45	67	0.6716418
NODE_16564_length_704_cov_3.535537	369	436	3	5	67	0.0746269
NODE_16578_length_704_cov_1.963636	345	425	6	63	80	0.7875000
NODE_16578_length_704_cov_1.963636	345	425	7	11	80	0.1375000
NODE_16578_length_704_cov_1.963636	345	425	8	6	80	0.0750000
NODE_16578_length_704_cov_1.963636	398	478	6	40	80	0.5000000
NODE_16578_length_704_cov_1.963636	398	478	7	20	80	0.2500000
NODE_16578_length_704_cov_1.963636	398	478	8	2	80	0.0250000
NODE_16578_length_704_cov_1.963636	398	478	9	18	80	0.2250000
NODE_16598_length_703_cov_44.102649	514	594	0	20	80	0.2500000
NODE_16598_length_703_cov_44.102649	514	594	1	60	80	0.7500000
NODE_16598_length_703_cov_44.102649	567	647	1	80	80	1.0000000
NODE_16599_length_703_cov_33.067881	521	594	77	1	73	0.0136986
NODE_16599_length_703_cov_33.067881	521	594	78	1	73	0.0136986
NODE_16599_length_703_cov_33.067881	521	594	79	2	73	0.0273973
NODE_16599_length_703_cov_33.067881	521	594	81	1	73	0.0136986
NODE_16599_length_703_cov_33.067881	521	594	83	1	73	0.0136986
NODE_16599_length_703_cov_33.067881	521	594	86	4	73	0.0547945
NODE_16599_length_703_cov_33.067881	521	594	87	3	73	0.0410959
NODE_16599_length_703_cov_33.067881	521	594	88	3	73	0.0410959
NODE_16599_length_703_cov_33.067881	521	594	90	9	73	0.1232877
NODE_16599_length_703_cov_33.067881	521	594	91	15	73	0.2054795
NODE_16599_length_703_cov_33.067881	521	594	92	10	73	0.1369863
NODE_16599_length_703_cov_33.067881	521	594	93	9	73	0.1232877
NODE_16599_length_703_cov_33.067881	521	594	94	2	73	0.0273973
NODE_16599_length_703_cov_33.067881	521	594	95	7	73	0.0958904
NODE_16599_length_703_cov_33.067881	521	594	96	3	73	0.0410959
NODE_16599_length_703_cov_33.067881	521	594	97	2	73	0.0273973
NODE_16599_length_703_cov_33.067881	561	602	66	3	41	0.0731707
NODE_16599_length_703_cov_33.067881	561	602	68	1	41	0.0243902
NODE_16599_length_703_cov_33.067881	561	602	69	1	41	0.0243902
NODE_16599_length_703_cov_33.067881	561	602	72	1	41	0.0243902
NODE_16599_length_703_cov_33.067881	561	602	73	1	41	0.0243902
NODE_16599_length_703_cov_33.067881	561	602	74	1	41	0.0243902
NODE_16599_length_703_cov_33.067881	561	602	77	1	41	0.0243902
NODE_16599_length_703_cov_33.067881	561	602	78	1	41	0.0243902
NODE_16599_length_703_cov_33.067881	561	602	79	2	41	0.0487805
NODE_16599_length_703_cov_33.067881	561	602	81	1	41	0.0243902
NODE_16599_length_703_cov_33.067881	561	602	83	1	41	0.0243902
NODE_16599_length_703_cov_33.067881	561	602	86	4	41	0.0975610
NODE_16599_length_703_cov_33.067881	561	602	87	3	41	0.0731707
NODE_16599_length_703_cov_33.067881	561	602	91	3	41	0.0731707
NODE_16599_length_703_cov_33.067881	561	602	92	5	41	0.1219512
NODE_16599_length_703_cov_33.067881	561	602	93	4	41	0.0975610
NODE_16599_length_703_cov_33.067881	561	602	94	1	41	0.0243902
NODE_16599_length_703_cov_33.067881	561	602	95	3	41	0.0731707
NODE_16599_length_703_cov_33.067881	561	602	96	3	41	0.0731707
NODE_16599_length_703_cov_33.067881	561	602	97	1	41	0.0243902
NODE_16600_length_703_cov_30.266556	312	392	2	80	80	1.0000000
NODE_16600_length_703_cov_30.266556	365	445	0	7	80	0.0875000
NODE_16600_length_703_cov_30.266556	365	445	2	73	80	0.9125000
NODE_16601_length_703_cov_17.006623	449	529	1	7	80	0.0875000
NODE_16601_length_703_cov_17.006623	449	529	2	53	80	0.6625000
NODE_16601_length_703_cov_17.006623	449	529	3	20	80	0.2500000
NODE_16601_length_703_cov_17.006623	502	582	0	10	80	0.1250000
NODE_16601_length_703_cov_17.006623	502	582	1	50	80	0.6250000
NODE_16601_length_703_cov_17.006623	502	582	2	20	80	0.2500000
NODE_16602_length_703_cov_14.801325	383	463	0	80	80	1.0000000
NODE_16602_length_703_cov_14.801325	436	516	0	80	80	1.0000000
NODE_16603_length_703_cov_11.766556	308	388	0	58	80	0.7250000
NODE_16603_length_703_cov_11.766556	308	388	1	22	80	0.2750000
NODE_16603_length_703_cov_11.766556	361	441	0	5	80	0.0625000
NODE_16603_length_703_cov_11.766556	361	441	1	75	80	0.9375000
NODE_16604_length_703_cov_10.405629	213	293	5	58	80	0.7250000
NODE_16604_length_703_cov_10.405629	213	293	6	6	80	0.0750000
NODE_16604_length_703_cov_10.405629	213	293	7	16	80	0.2000000
NODE_16604_length_703_cov_10.405629	266	301	5	35	35	1.0000000
NODE_16605_length_703_cov_6.966887	381	440	0	59	59	1.0000000
NODE_16616_length_703_cov_3.491722	256	309	0	37	53	0.6981132
NODE_16616_length_703_cov_3.491722	256	309	2	16	53	0.3018868
NODE_16616_length_703_cov_3.491722	257	337	0	65	80	0.8125000
NODE_16616_length_703_cov_3.491722	257	337	2	15	80	0.1875000
NODE_16616_length_703_cov_3.491722	305	362	0	57	57	1.0000000
NODE_16624_length_703_cov_2.687086	216	296	0	80	80	1.0000000
NODE_16624_length_703_cov_2.687086	269	349	0	80	80	1.0000000
NODE_16663_length_702_cov_49.784411	221	299	0	73	78	0.9358974
NODE_16663_length_702_cov_49.784411	221	299	1	5	78	0.0641026
NODE_16663_length_702_cov_49.784411	277	352	0	17	75	0.2266667
NODE_16663_length_702_cov_49.784411	277	352	1	16	75	0.2133333
NODE_16663_length_702_cov_49.784411	277	352	2	42	75	0.5600000
NODE_16664_length_702_cov_26.570481	201	281	5	2	80	0.0250000
NODE_16664_length_702_cov_26.570481	201	281	6	78	80	0.9750000
NODE_16664_length_702_cov_26.570481	254	334	0	5	80	0.0625000
NODE_16664_length_702_cov_26.570481	254	334	1	25	80	0.3125000
NODE_16664_length_702_cov_26.570481	254	334	4	9	80	0.1125000
NODE_16664_length_702_cov_26.570481	254	334	5	16	80	0.2000000
NODE_16664_length_702_cov_26.570481	254	334	6	25	80	0.3125000
NODE_16665_length_702_cov_23.971808	139	219	0	71	80	0.8875000
NODE_16665_length_702_cov_23.971808	139	219	1	9	80	0.1125000
NODE_16665_length_702_cov_23.971808	192	272	0	18	80	0.2250000
NODE_16665_length_702_cov_23.971808	192	272	1	29	80	0.3625000
NODE_16665_length_702_cov_23.971808	192	272	2	33	80	0.4125000
NODE_16665_length_702_cov_23.971808	268	348	2	80	80	1.0000000
NODE_16665_length_702_cov_23.971808	321	401	0	12	80	0.1500000
NODE_16665_length_702_cov_23.971808	321	401	1	29	80	0.3625000
NODE_16665_length_702_cov_23.971808	321	401	2	39	80	0.4875000
NODE_16666_length_702_cov_23.827529	448	528	2	80	80	1.0000000
NODE_16666_length_702_cov_23.827529	501	581	2	80	80	1.0000000
NODE_16667_length_702_cov_14.661692	424	504	2	5	80	0.0625000
NODE_16667_length_702_cov_14.661692	424	504	4	75	80	0.9375000
NODE_16667_length_702_cov_14.661692	477	557	2	27	80	0.3375000
NODE_16667_length_702_cov_14.661692	477	557	4	53	80	0.6625000
NODE_16668_length_702_cov_13.908789	259	304	0	36	45	0.8000000
NODE_16668_length_702_cov_13.908789	259	304	2	9	45	0.2000000
NODE_16668_length_702_cov_13.908789	277	357	0	80	80	1.0000000
NODE_16668_length_702_cov_13.908789	289	357	0	68	68	1.0000000
NODE_16669_length_702_cov_8.502488	337	417	0	80	80	1.0000000
NODE_16669_length_702_cov_8.502488	390	470	0	80	80	1.0000000
NODE_16671_length_702_cov_6.470978	209	289	0	80	80	1.0000000
NODE_16671_length_702_cov_6.470978	262	342	0	80	80	1.0000000
NODE_16729_length_701_cov_38.715947	178	258	0	80	80	1.0000000
NODE_16729_length_701_cov_38.715947	231	311	0	80	80	1.0000000
NODE_16729_length_701_cov_38.715947	307	387	0	80	80	1.0000000
NODE_16729_length_701_cov_38.715947	360	440	0	80	80	1.0000000
NODE_16730_length_701_cov_28.059801	432	513	3	42	81	0.5185185
NODE_16730_length_701_cov_28.059801	432	513	4	32	81	0.3950617
NODE_16730_length_701_cov_28.059801	432	513	5	7	81	0.0864198
NODE_16730_length_701_cov_28.059801	486	566	2	35	80	0.4375000
NODE_16730_length_701_cov_28.059801	486	566	3	30	80	0.3750000
NODE_16730_length_701_cov_28.059801	486	566	4	8	80	0.1000000
NODE_16730_length_701_cov_28.059801	486	566	5	7	80	0.0875000
NODE_16731_length_701_cov_18.387043	258	338	0	4	80	0.0500000
NODE_16731_length_701_cov_18.387043	258	338	2	76	80	0.9500000
NODE_16731_length_701_cov_18.387043	311	391	0	19	80	0.2375000
NODE_16731_length_701_cov_18.387043	311	391	2	61	80	0.7625000
NODE_16732_length_701_cov_17.122924	295	367	6	7	72	0.0972222
NODE_16732_length_701_cov_17.122924	295	367	7	11	72	0.1527778
NODE_16732_length_701_cov_17.122924	295	367	8	41	72	0.5694444
NODE_16732_length_701_cov_17.122924	295	367	9	13	72	0.1805556
NODE_16733_length_701_cov_16.114618	242	322	0	30	80	0.3750000
NODE_16733_length_701_cov_16.114618	242	322	1	50	80	0.6250000
NODE_16733_length_701_cov_16.114618	295	375	1	80	80	1.0000000
NODE_16734_length_701_cov_15.588040	399	479	0	80	80	1.0000000
NODE_16734_length_701_cov_15.588040	452	532	0	80	80	1.0000000
NODE_16736_length_701_cov_11.420266	229	309	0	80	80	1.0000000
NODE_16736_length_701_cov_11.420266	282	362	0	80	80	1.0000000
NODE_16737_length_701_cov_10.411960	202	283	0	32	81	0.3950617
NODE_16737_length_701_cov_10.411960	202	283	1	49	81	0.6049383
NODE_16737_length_701_cov_10.411960	256	336	1	80	80	1.0000000
NODE_16738_length_701_cov_9.107973	400	480	0	80	80	1.0000000
NODE_16738_length_701_cov_9.107973	453	533	0	80	80	1.0000000
NODE_16739_length_701_cov_8.877076	283	363	0	80	80	1.0000000
NODE_16739_length_701_cov_8.877076	336	416	0	80	80	1.0000000
NODE_16740_length_701_cov_8.543189	341	421	0	80	80	1.0000000
NODE_16740_length_701_cov_8.543189	394	474	0	80	80	1.0000000
NODE_16742_length_701_cov_6.317276	273	353	0	64	80	0.8000000
NODE_16742_length_701_cov_6.317276	273	353	2	16	80	0.2000000
NODE_16742_length_701_cov_6.317276	326	382	0	11	56	0.1964286
NODE_16742_length_701_cov_6.317276	326	382	2	45	56	0.8035714
NODE_16747_length_701_cov_5.081395	318	374	0	8	56	0.1428571
NODE_16747_length_701_cov_5.081395	318	374	1	48	56	0.8571429
NODE_16752_length_701_cov_3.320598	207	287	0	80	80	1.0000000
NODE_16752_length_701_cov_3.320598	260	340	0	80	80	1.0000000
NODE_16794_length_700_cov_22.241265	326	406	41	1	80	0.0125000
NODE_16794_length_700_cov_22.241265	326	406	42	4	80	0.0500000
NODE_16794_length_700_cov_22.241265	326	406	43	9	80	0.1125000
NODE_16794_length_700_cov_22.241265	326	406	45	2	80	0.0250000
NODE_16794_length_700_cov_22.241265	326	406	46	2	80	0.0250000
NODE_16794_length_700_cov_22.241265	326	406	47	3	80	0.0375000
NODE_16794_length_700_cov_22.241265	326	406	49	2	80	0.0250000
NODE_16794_length_700_cov_22.241265	326	406	50	13	80	0.1625000
NODE_16794_length_700_cov_22.241265	326	406	51	4	80	0.0500000
NODE_16794_length_700_cov_22.241265	326	406	52	2	80	0.0250000
NODE_16794_length_700_cov_22.241265	326	406	53	16	80	0.2000000
NODE_16794_length_700_cov_22.241265	326	406	54	18	80	0.2250000
NODE_16794_length_700_cov_22.241265	326	406	55	4	80	0.0500000
NODE_16796_length_700_cov_11.730449	294	374	0	23	80	0.2875000
NODE_16796_length_700_cov_11.730449	294	374	1	15	80	0.1875000
NODE_16796_length_700_cov_11.730449	294	374	3	3	80	0.0375000
NODE_16796_length_700_cov_11.730449	294	374	5	39	80	0.4875000
NODE_16796_length_700_cov_11.730449	347	427	3	1	80	0.0125000
NODE_16796_length_700_cov_11.730449	347	427	5	79	80	0.9875000
NODE_16800_length_700_cov_7.291181	317	397	0	80	80	1.0000000
NODE_16800_length_700_cov_7.291181	370	450	0	80	80	1.0000000
NODE_16801_length_700_cov_6.557404	353	404	3	47	51	0.9215686
NODE_16801_length_700_cov_6.557404	353	404	5	4	51	0.0784314
NODE_16802_length_700_cov_5.475874	301	381	0	80	80	1.0000000
NODE_16802_length_700_cov_5.475874	354	434	0	80	80	1.0000000
NODE_16803_length_700_cov_3.960067	158	234	0	41	76	0.5394737
NODE_16803_length_700_cov_3.960067	158	234	1	35	76	0.4605263
NODE_16803_length_700_cov_3.960067	209	291	1	82	82	1.0000000
NODE_16822_length_700_cov_1.517471	324	404	0	80	80	1.0000000
NODE_16822_length_700_cov_1.517471	377	457	0	80	80	1.0000000
NODE_16844_length_699_cov_18.446667	185	265	1	10	80	0.1250000
NODE_16844_length_699_cov_18.446667	185	265	2	49	80	0.6125000
NODE_16844_length_699_cov_18.446667	185	265	3	21	80	0.2625000
NODE_16844_length_699_cov_18.446667	238	318	2	80	80	1.0000000
NODE_16845_length_699_cov_18.383333	258	338	0	1	80	0.0125000
NODE_16845_length_699_cov_18.383333	258	338	1	6	80	0.0750000
NODE_16845_length_699_cov_18.383333	258	338	2	10	80	0.1250000
NODE_16845_length_699_cov_18.383333	258	338	3	63	80	0.7875000
NODE_16845_length_699_cov_18.383333	311	391	0	1	80	0.0125000
NODE_16845_length_699_cov_18.383333	311	391	1	59	80	0.7375000
NODE_16845_length_699_cov_18.383333	311	391	2	10	80	0.1250000
NODE_16845_length_699_cov_18.383333	311	391	3	10	80	0.1250000
NODE_16846_length_699_cov_18.103333	218	298	1	3	80	0.0375000
NODE_16846_length_699_cov_18.103333	218	298	2	13	80	0.1625000
NODE_16846_length_699_cov_18.103333	218	298	3	64	80	0.8000000
NODE_16846_length_699_cov_18.103333	271	351	1	56	80	0.7000000
NODE_16846_length_699_cov_18.103333	271	351	3	24	80	0.3000000
NODE_16847_length_699_cov_15.636667	279	359	0	80	80	1.0000000
NODE_16847_length_699_cov_15.636667	332	412	0	80	80	1.0000000
NODE_16848_length_699_cov_15.113333	313	393	5	47	80	0.5875000
NODE_16848_length_699_cov_15.113333	313	393	6	33	80	0.4125000
NODE_16848_length_699_cov_15.113333	366	446	3	33	80	0.4125000
NODE_16848_length_699_cov_15.113333	366	446	4	13	80	0.1625000
NODE_16848_length_699_cov_15.113333	366	446	5	21	80	0.2625000
NODE_16848_length_699_cov_15.113333	366	446	6	13	80	0.1625000
NODE_16849_length_699_cov_10.070000	233	313	0	80	80	1.0000000
NODE_16849_length_699_cov_10.070000	286	366	0	80	80	1.0000000
NODE_16849_length_699_cov_10.070000	362	442	0	80	80	1.0000000
NODE_16849_length_699_cov_10.070000	415	495	0	80	80	1.0000000
NODE_16850_length_699_cov_8.083333	347	427	0	80	80	1.0000000
NODE_16850_length_699_cov_8.083333	400	480	0	80	80	1.0000000
NODE_16851_length_699_cov_7.758333	307	387	3	57	80	0.7125000
NODE_16851_length_699_cov_7.758333	307	387	4	23	80	0.2875000
NODE_16851_length_699_cov_7.758333	360	440	0	3	80	0.0375000
NODE_16851_length_699_cov_7.758333	360	440	1	16	80	0.2000000
NODE_16851_length_699_cov_7.758333	360	440	2	17	80	0.2125000
NODE_16851_length_699_cov_7.758333	360	440	3	44	80	0.5500000
NODE_16852_length_699_cov_7.713333	252	332	0	80	80	1.0000000
NODE_16852_length_699_cov_7.713333	305	385	0	80	80	1.0000000
NODE_16853_length_699_cov_7.186667	271	332	1	9	61	0.1475410
NODE_16853_length_699_cov_7.186667	271	332	2	8	61	0.1311475
NODE_16853_length_699_cov_7.186667	271	332	4	44	61	0.7213115
NODE_16853_length_699_cov_7.186667	348	428	7	38	80	0.4750000
NODE_16853_length_699_cov_7.186667	348	428	8	26	80	0.3250000
NODE_16853_length_699_cov_7.186667	348	428	9	16	80	0.2000000
NODE_16857_length_699_cov_5.815000	243	316	3	2	73	0.0273973
NODE_16857_length_699_cov_5.815000	243	316	4	3	73	0.0410959
NODE_16857_length_699_cov_5.815000	243	316	5	25	73	0.3424658
NODE_16857_length_699_cov_5.815000	243	316	7	43	73	0.5890411
NODE_16857_length_699_cov_5.815000	293	374	0	23	81	0.2839506
NODE_16857_length_699_cov_5.815000	293	374	1	8	81	0.0987654
NODE_16857_length_699_cov_5.815000	293	374	3	29	81	0.3580247
NODE_16857_length_699_cov_5.815000	293	374	4	3	81	0.0370370
NODE_16857_length_699_cov_5.815000	293	374	5	18	81	0.2222222
NODE_16858_length_699_cov_5.520000	302	382	0	80	80	1.0000000
NODE_16858_length_699_cov_5.520000	355	435	0	80	80	1.0000000
NODE_16860_length_699_cov_4.051667	289	369	0	56	80	0.7000000
NODE_16860_length_699_cov_4.051667	289	369	1	21	80	0.2625000
NODE_16860_length_699_cov_4.051667	289	369	2	3	80	0.0375000
NODE_16860_length_699_cov_4.051667	342	422	0	80	80	1.0000000
NODE_16868_length_699_cov_2.498333	204	284	0	80	80	1.0000000
NODE_16868_length_699_cov_2.498333	257	337	0	80	80	1.0000000
NODE_16908_length_698_cov_47.350584	321	401	3	30	80	0.3750000
NODE_16908_length_698_cov_47.350584	321	401	4	50	80	0.6250000
NODE_16908_length_698_cov_47.350584	374	454	2	22	80	0.2750000
NODE_16908_length_698_cov_47.350584	374	454	3	42	80	0.5250000
NODE_16908_length_698_cov_47.350584	374	454	4	16	80	0.2000000
NODE_16909_length_698_cov_42.848080	255	335	0	80	80	1.0000000
NODE_16909_length_698_cov_42.848080	308	388	0	80	80	1.0000000
NODE_16910_length_698_cov_36.697830	366	446	1	16	80	0.2000000
NODE_16910_length_698_cov_36.697830	366	446	2	64	80	0.8000000
NODE_16910_length_698_cov_36.697830	419	484	2	65	65	1.0000000
NODE_16911_length_698_cov_23.874791	222	302	0	7	80	0.0875000
NODE_16911_length_698_cov_23.874791	222	302	1	73	80	0.9125000
NODE_16911_length_698_cov_23.874791	275	355	1	80	80	1.0000000
NODE_16912_length_698_cov_7.133556	360	440	5	15	80	0.1875000
NODE_16912_length_698_cov_7.133556	360	440	7	3	80	0.0375000
NODE_16912_length_698_cov_7.133556	360	440	8	62	80	0.7750000
NODE_16912_length_698_cov_7.133556	413	493	3	29	80	0.3625000
NODE_16912_length_698_cov_7.133556	413	493	5	30	80	0.3750000
NODE_16912_length_698_cov_7.133556	413	493	7	3	80	0.0375000
NODE_16912_length_698_cov_7.133556	413	493	8	18	80	0.2250000
NODE_16913_length_698_cov_6.520868	267	347	1	80	80	1.0000000
NODE_16913_length_698_cov_6.520868	320	400	0	12	80	0.1500000
NODE_16913_length_698_cov_6.520868	320	400	1	68	80	0.8500000
NODE_16917_length_698_cov_4.762938	329	359	0	30	30	1.0000000
NODE_16926_length_698_cov_2.577629	309	389	0	80	80	1.0000000
NODE_16926_length_698_cov_2.577629	362	442	0	80	80	1.0000000
NODE_16962_length_697_cov_16.013378	305	385	0	80	80	1.0000000
NODE_16962_length_697_cov_16.013378	358	438	0	80	80	1.0000000
NODE_16963_length_697_cov_14.411371	440	520	0	80	80	1.0000000
NODE_16963_length_697_cov_14.411371	493	573	0	80	80	1.0000000
NODE_16964_length_697_cov_14.282609	257	354	3	93	97	0.9587629
NODE_16964_length_697_cov_14.282609	257	354	4	4	97	0.0412371
NODE_16964_length_697_cov_14.282609	327	385	1	10	58	0.1724138
NODE_16964_length_697_cov_14.282609	327	385	2	14	58	0.2413793
NODE_16964_length_697_cov_14.282609	327	385	3	30	58	0.5172414
NODE_16964_length_697_cov_14.282609	327	385	4	4	58	0.0689655
NODE_16965_length_697_cov_9.969900	360	440	2	80	80	1.0000000
NODE_16965_length_697_cov_9.969900	413	493	0	21	80	0.2625000
NODE_16965_length_697_cov_9.969900	413	493	2	59	80	0.7375000
NODE_16968_length_697_cov_6.117057	236	316	0	80	80	1.0000000
NODE_16968_length_697_cov_6.117057	289	369	0	80	80	1.0000000
NODE_17025_length_696_cov_28.360134	319	399	0	80	80	1.0000000
NODE_17025_length_696_cov_28.360134	372	452	0	80	80	1.0000000
NODE_17026_length_696_cov_18.708543	367	447	2	80	80	1.0000000
NODE_17026_length_696_cov_18.708543	420	500	0	28	80	0.3500000
NODE_17026_length_696_cov_18.708543	420	500	1	23	80	0.2875000
NODE_17026_length_696_cov_18.708543	420	500	2	29	80	0.3625000
NODE_17027_length_696_cov_18.170854	390	470	0	80	80	1.0000000
NODE_17027_length_696_cov_18.170854	443	523	0	80	80	1.0000000
NODE_17028_length_696_cov_13.738693	266	346	0	10	80	0.1250000
NODE_17028_length_696_cov_13.738693	266	346	1	70	80	0.8750000
NODE_17028_length_696_cov_13.738693	319	399	1	54	80	0.6750000
NODE_17028_length_696_cov_13.738693	319	399	2	26	80	0.3250000
NODE_17030_length_696_cov_10.693467	239	266	1	1	27	0.0370370
NODE_17030_length_696_cov_10.693467	239	266	2	4	27	0.1481481
NODE_17030_length_696_cov_10.693467	239	266	3	17	27	0.6296296
NODE_17030_length_696_cov_10.693467	239	266	4	5	27	0.1851852
NODE_17031_length_696_cov_9.949749	248	328	1	79	80	0.9875000
NODE_17031_length_696_cov_9.949749	248	328	2	1	80	0.0125000
NODE_17031_length_696_cov_9.949749	301	381	1	55	80	0.6875000
NODE_17031_length_696_cov_9.949749	301	381	2	25	80	0.3125000
NODE_17032_length_696_cov_8.658291	247	327	0	50	80	0.6250000
NODE_17032_length_696_cov_8.658291	247	327	1	13	80	0.1625000
NODE_17032_length_696_cov_8.658291	247	327	3	17	80	0.2125000
NODE_17032_length_696_cov_8.658291	300	380	1	10	80	0.1250000
NODE_17032_length_696_cov_8.658291	300	380	3	70	80	0.8750000
NODE_17032_length_696_cov_8.658291	376	456	0	9	80	0.1125000
NODE_17032_length_696_cov_8.658291	376	456	1	38	80	0.4750000
NODE_17032_length_696_cov_8.658291	376	456	3	33	80	0.4125000
NODE_17032_length_696_cov_8.658291	429	509	0	62	80	0.7750000
NODE_17032_length_696_cov_8.658291	429	509	1	18	80	0.2250000
NODE_17068_length_696_cov_1.675042	498	543	0	45	45	1.0000000
NODE_17100_length_695_cov_24.112416	388	468	2	80	80	1.0000000
NODE_17100_length_695_cov_24.112416	441	521	0	13	80	0.1625000
NODE_17100_length_695_cov_24.112416	441	521	2	67	80	0.8375000
NODE_17101_length_695_cov_12.152685	349	429	0	9	80	0.1125000
NODE_17101_length_695_cov_12.152685	349	429	2	67	80	0.8375000
NODE_17101_length_695_cov_12.152685	349	429	4	4	80	0.0500000
NODE_17101_length_695_cov_12.152685	402	482	2	23	80	0.2875000
NODE_17101_length_695_cov_12.152685	402	482	4	57	80	0.7125000
NODE_17103_length_695_cov_8.466443	345	425	0	80	80	1.0000000
NODE_17103_length_695_cov_8.466443	398	478	0	80	80	1.0000000
NODE_17106_length_695_cov_5.661074	283	363	0	41	80	0.5125000
NODE_17106_length_695_cov_5.661074	283	363	2	39	80	0.4875000
NODE_17106_length_695_cov_5.661074	346	416	2	70	70	1.0000000
NODE_17124_length_695_cov_2.050336	36	112	0	76	76	1.0000000
NODE_17161_length_694_cov_46.675630	30	110	0	80	80	1.0000000
NODE_17161_length_694_cov_46.675630	83	163	0	80	80	1.0000000
NODE_17161_length_694_cov_46.675630	159	239	0	80	80	1.0000000
NODE_17161_length_694_cov_46.675630	212	292	0	80	80	1.0000000
NODE_17162_length_694_cov_12.850420	326	406	2	80	80	1.0000000
NODE_17162_length_694_cov_12.850420	379	459	0	9	80	0.1125000
NODE_17162_length_694_cov_12.850420	379	459	1	40	80	0.5000000
NODE_17162_length_694_cov_12.850420	379	459	2	31	80	0.3875000
NODE_17163_length_694_cov_7.236975	318	396	0	78	78	1.0000000
NODE_17163_length_694_cov_7.236975	371	450	0	79	79	1.0000000
NODE_17166_length_694_cov_5.554622	404	484	0	80	80	1.0000000
NODE_17166_length_694_cov_5.554622	457	537	0	80	80	1.0000000
NODE_17168_length_694_cov_5.373109	152	232	0	24	80	0.3000000
NODE_17168_length_694_cov_5.373109	152	232	1	36	80	0.4500000
NODE_17168_length_694_cov_5.373109	152	232	2	20	80	0.2500000
NODE_17168_length_694_cov_5.373109	205	285	1	7	80	0.0875000
NODE_17168_length_694_cov_5.373109	205	285	2	73	80	0.9125000
NODE_17227_length_693_cov_26.616162	435	515	0	80	80	1.0000000
NODE_17227_length_693_cov_26.616162	488	568	0	80	80	1.0000000
NODE_17228_length_693_cov_23.552189	193	273	0	80	80	1.0000000
NODE_17228_length_693_cov_23.552189	246	326	0	80	80	1.0000000
NODE_17229_length_693_cov_22.848485	231	311	2	46	80	0.5750000
NODE_17229_length_693_cov_22.848485	231	311	3	4	80	0.0500000
NODE_17229_length_693_cov_22.848485	231	311	4	30	80	0.3750000
NODE_17229_length_693_cov_22.848485	284	364	2	11	80	0.1375000
NODE_17229_length_693_cov_22.848485	284	364	3	8	80	0.1000000
NODE_17229_length_693_cov_22.848485	284	364	4	61	80	0.7625000
NODE_17230_length_693_cov_13.616162	219	299	0	19	80	0.2375000
NODE_17230_length_693_cov_13.616162	219	299	1	8	80	0.1000000
NODE_17230_length_693_cov_13.616162	219	299	3	53	80	0.6625000
NODE_17230_length_693_cov_13.616162	272	352	1	21	80	0.2625000
NODE_17230_length_693_cov_13.616162	272	352	3	59	80	0.7375000
NODE_17231_length_693_cov_12.382155	305	385	0	80	80	1.0000000
NODE_17231_length_693_cov_12.382155	358	424	0	66	66	1.0000000
NODE_17232_length_693_cov_10.053872	279	359	0	37	80	0.4625000
NODE_17232_length_693_cov_10.053872	279	359	1	5	80	0.0625000
NODE_17232_length_693_cov_10.053872	279	359	2	38	80	0.4750000
NODE_17232_length_693_cov_10.053872	332	412	2	80	80	1.0000000
NODE_17233_length_693_cov_9.659933	247	327	3	17	80	0.2125000
NODE_17233_length_693_cov_9.659933	247	327	4	9	80	0.1125000
NODE_17233_length_693_cov_9.659933	247	327	5	33	80	0.4125000
NODE_17233_length_693_cov_9.659933	247	327	6	21	80	0.2625000
NODE_17233_length_693_cov_9.659933	300	380	3	22	80	0.2750000
NODE_17233_length_693_cov_9.659933	300	380	4	15	80	0.1875000
NODE_17233_length_693_cov_9.659933	300	380	5	39	80	0.4875000
NODE_17233_length_693_cov_9.659933	300	380	6	4	80	0.0500000
NODE_17235_length_693_cov_8.077441	343	423	0	73	80	0.9125000
NODE_17235_length_693_cov_8.077441	343	423	1	7	80	0.0875000
NODE_17235_length_693_cov_8.077441	396	476	0	20	80	0.2500000
NODE_17235_length_693_cov_8.077441	396	476	1	60	80	0.7500000
NODE_17243_length_693_cov_3.680135	250	321	2	22	71	0.3098592
NODE_17243_length_693_cov_3.680135	250	321	3	21	71	0.2957746
NODE_17243_length_693_cov_3.680135	250	321	4	28	71	0.3943662
NODE_17280_length_692_cov_33.416526	462	542	3	70	80	0.8750000
NODE_17280_length_692_cov_33.416526	462	542	4	10	80	0.1250000
NODE_17280_length_692_cov_33.416526	515	595	2	11	80	0.1375000
NODE_17280_length_692_cov_33.416526	515	595	3	33	80	0.4125000
NODE_17280_length_692_cov_33.416526	515	595	4	36	80	0.4500000
NODE_17281_length_692_cov_17.559865	291	371	4	20	80	0.2500000
NODE_17281_length_692_cov_17.559865	291	371	6	47	80	0.5875000
NODE_17281_length_692_cov_17.559865	291	371	7	13	80	0.1625000
NODE_17282_length_692_cov_15.070826	304	375	0	71	71	1.0000000
NODE_17283_length_692_cov_13.279933	308	388	0	80	80	1.0000000
NODE_17283_length_692_cov_13.279933	361	441	0	80	80	1.0000000
NODE_17285_length_692_cov_10.750422	317	397	0	80	80	1.0000000
NODE_17287_length_692_cov_7.497470	175	255	1	2	80	0.0250000
NODE_17287_length_692_cov_7.497470	175	255	2	78	80	0.9750000
NODE_17287_length_692_cov_7.497470	228	312	1	2	84	0.0238095
NODE_17287_length_692_cov_7.497470	228	312	2	82	84	0.9761904
NODE_17289_length_692_cov_7.370995	235	315	4	80	80	1.0000000
NODE_17289_length_692_cov_7.370995	288	369	0	3	81	0.0370370
NODE_17289_length_692_cov_7.370995	288	369	2	7	81	0.0864198
NODE_17289_length_692_cov_7.370995	288	369	3	26	81	0.3209876
NODE_17289_length_692_cov_7.370995	288	369	4	45	81	0.5555556
NODE_17328_length_692_cov_1.514334	404	484	3	1	80	0.0125000
NODE_17328_length_692_cov_1.514334	404	484	4	22	80	0.2750000
NODE_17328_length_692_cov_1.514334	404	484	5	1	80	0.0125000
NODE_17328_length_692_cov_1.514334	404	484	6	4	80	0.0500000
NODE_17328_length_692_cov_1.514334	404	484	8	1	80	0.0125000
NODE_17328_length_692_cov_1.514334	404	484	10	18	80	0.2250000
NODE_17328_length_692_cov_1.514334	404	484	11	12	80	0.1500000
NODE_17328_length_692_cov_1.514334	404	484	13	21	80	0.2625000
NODE_17350_length_691_cov_115.233108	276	356	16	4	80	0.0500000
NODE_17350_length_691_cov_115.233108	276	356	17	27	80	0.3375000
NODE_17350_length_691_cov_115.233108	276	356	18	32	80	0.4000000
NODE_17350_length_691_cov_115.233108	276	356	19	2	80	0.0250000
NODE_17350_length_691_cov_115.233108	276	356	20	9	80	0.1125000
NODE_17350_length_691_cov_115.233108	276	356	21	1	80	0.0125000
NODE_17350_length_691_cov_115.233108	276	356	24	1	80	0.0125000
NODE_17350_length_691_cov_115.233108	276	356	25	1	80	0.0125000
NODE_17350_length_691_cov_115.233108	276	356	27	2	80	0.0250000
NODE_17350_length_691_cov_115.233108	276	356	28	1	80	0.0125000
NODE_17350_length_691_cov_115.233108	329	409	16	2	80	0.0250000
NODE_17350_length_691_cov_115.233108	329	409	17	4	80	0.0500000
NODE_17350_length_691_cov_115.233108	329	409	18	14	80	0.1750000
NODE_17350_length_691_cov_115.233108	329	409	20	1	80	0.0125000
NODE_17350_length_691_cov_115.233108	329	409	21	1	80	0.0125000
NODE_17350_length_691_cov_115.233108	329	409	24	1	80	0.0125000
NODE_17350_length_691_cov_115.233108	329	409	25	1	80	0.0125000
NODE_17350_length_691_cov_115.233108	329	409	27	2	80	0.0250000
NODE_17350_length_691_cov_115.233108	329	409	28	4	80	0.0500000
NODE_17350_length_691_cov_115.233108	329	409	29	23	80	0.2875000
NODE_17350_length_691_cov_115.233108	329	409	30	5	80	0.0625000
NODE_17350_length_691_cov_115.233108	329	409	32	1	80	0.0125000
NODE_17350_length_691_cov_115.233108	329	409	33	10	80	0.1250000
NODE_17350_length_691_cov_115.233108	329	409	34	1	80	0.0125000
NODE_17350_length_691_cov_115.233108	329	409	35	3	80	0.0375000
NODE_17350_length_691_cov_115.233108	329	409	36	6	80	0.0750000
NODE_17350_length_691_cov_115.233108	329	409	37	1	80	0.0125000
NODE_17350_length_691_cov_115.233108	405	485	31	1	80	0.0125000
NODE_17350_length_691_cov_115.233108	405	485	32	1	80	0.0125000
NODE_17350_length_691_cov_115.233108	405	485	33	5	80	0.0625000
NODE_17350_length_691_cov_115.233108	405	485	34	1	80	0.0125000
NODE_17350_length_691_cov_115.233108	405	485	36	3	80	0.0375000
NODE_17350_length_691_cov_115.233108	405	485	37	5	80	0.0625000
NODE_17350_length_691_cov_115.233108	405	485	38	7	80	0.0875000
NODE_17350_length_691_cov_115.233108	405	485	39	1	80	0.0125000
NODE_17350_length_691_cov_115.233108	405	485	41	1	80	0.0125000
NODE_17350_length_691_cov_115.233108	405	485	42	6	80	0.0750000
NODE_17350_length_691_cov_115.233108	405	485	43	1	80	0.0125000
NODE_17350_length_691_cov_115.233108	405	485	46	4	80	0.0500000
NODE_17350_length_691_cov_115.233108	405	485	47	1	80	0.0125000
NODE_17350_length_691_cov_115.233108	405	485	48	1	80	0.0125000
NODE_17350_length_691_cov_115.233108	405	485	49	1	80	0.0125000
NODE_17350_length_691_cov_115.233108	405	485	51	1	80	0.0125000
NODE_17350_length_691_cov_115.233108	405	485	52	2	80	0.0250000
NODE_17350_length_691_cov_115.233108	405	485	53	2	80	0.0250000
NODE_17350_length_691_cov_115.233108	405	485	54	2	80	0.0250000
NODE_17350_length_691_cov_115.233108	405	485	55	3	80	0.0375000
NODE_17350_length_691_cov_115.233108	405	485	56	1	80	0.0125000
NODE_17350_length_691_cov_115.233108	405	485	57	1	80	0.0125000
NODE_17350_length_691_cov_115.233108	405	485	59	1	80	0.0125000
NODE_17350_length_691_cov_115.233108	405	485	62	1	80	0.0125000
NODE_17350_length_691_cov_115.233108	405	485	63	2	80	0.0250000
NODE_17350_length_691_cov_115.233108	405	485	64	1	80	0.0125000
NODE_17350_length_691_cov_115.233108	405	485	65	1	80	0.0125000
NODE_17350_length_691_cov_115.233108	405	485	67	1	80	0.0125000
NODE_17350_length_691_cov_115.233108	405	485	68	2	80	0.0250000
NODE_17350_length_691_cov_115.233108	405	485	69	5	80	0.0625000
NODE_17350_length_691_cov_115.233108	405	485	71	1	80	0.0125000
NODE_17350_length_691_cov_115.233108	405	485	72	2	80	0.0250000
NODE_17350_length_691_cov_115.233108	405	485	73	1	80	0.0125000
NODE_17350_length_691_cov_115.233108	405	485	74	5	80	0.0625000
NODE_17350_length_691_cov_115.233108	405	485	75	4	80	0.0500000
NODE_17350_length_691_cov_115.233108	405	485	76	2	80	0.0250000
NODE_17350_length_691_cov_115.233108	458	538	63	2	80	0.0250000
NODE_17350_length_691_cov_115.233108	458	538	64	1	80	0.0125000
NODE_17350_length_691_cov_115.233108	458	538	65	1	80	0.0125000
NODE_17350_length_691_cov_115.233108	458	538	67	1	80	0.0125000
NODE_17350_length_691_cov_115.233108	458	538	68	2	80	0.0250000
NODE_17350_length_691_cov_115.233108	458	538	69	5	80	0.0625000
NODE_17350_length_691_cov_115.233108	458	538	71	1	80	0.0125000
NODE_17350_length_691_cov_115.233108	458	538	72	2	80	0.0250000
NODE_17350_length_691_cov_115.233108	458	538	73	1	80	0.0125000
NODE_17350_length_691_cov_115.233108	458	538	74	6	80	0.0750000
NODE_17350_length_691_cov_115.233108	458	538	75	7	80	0.0875000
NODE_17350_length_691_cov_115.233108	458	538	76	8	80	0.1000000
NODE_17350_length_691_cov_115.233108	458	538	77	3	80	0.0375000
NODE_17350_length_691_cov_115.233108	458	538	78	4	80	0.0500000
NODE_17350_length_691_cov_115.233108	458	538	79	5	80	0.0625000
NODE_17350_length_691_cov_115.233108	458	538	80	4	80	0.0500000
NODE_17350_length_691_cov_115.233108	458	538	81	5	80	0.0625000
NODE_17350_length_691_cov_115.233108	458	538	82	3	80	0.0375000
NODE_17350_length_691_cov_115.233108	458	538	83	4	80	0.0500000
NODE_17350_length_691_cov_115.233108	458	538	86	8	80	0.1000000
NODE_17350_length_691_cov_115.233108	458	538	87	1	80	0.0125000
NODE_17350_length_691_cov_115.233108	458	538	89	2	80	0.0250000
NODE_17350_length_691_cov_115.233108	458	538	90	1	80	0.0125000
NODE_17350_length_691_cov_115.233108	458	538	91	2	80	0.0250000
NODE_17350_length_691_cov_115.233108	458	538	92	1	80	0.0125000
NODE_17351_length_691_cov_26.076014	188	268	0	80	80	1.0000000
NODE_17351_length_691_cov_26.076014	241	321	0	80	80	1.0000000
NODE_17352_length_691_cov_21.991554	288	368	0	80	80	1.0000000
NODE_17352_length_691_cov_21.991554	341	419	0	78	78	1.0000000
NODE_17353_length_691_cov_14.908784	226	306	0	18	80	0.2250000
NODE_17353_length_691_cov_14.908784	226	306	1	10	80	0.1250000
NODE_17353_length_691_cov_14.908784	226	306	3	52	80	0.6500000
NODE_17353_length_691_cov_14.908784	279	359	0	71	80	0.8875000
NODE_17353_length_691_cov_14.908784	279	359	1	9	80	0.1125000
NODE_17358_length_691_cov_5.670608	325	402	0	10	77	0.1298701
NODE_17358_length_691_cov_5.670608	325	402	1	67	77	0.8701299
NODE_17358_length_691_cov_5.670608	375	455	1	75	80	0.9375000
NODE_17358_length_691_cov_5.670608	375	455	2	5	80	0.0625000
NODE_17361_length_691_cov_4.866554	103	183	0	3	80	0.0375000
NODE_17361_length_691_cov_4.866554	103	183	2	34	80	0.4250000
NODE_17361_length_691_cov_4.866554	103	183	3	43	80	0.5375000
NODE_17361_length_691_cov_4.866554	156	236	3	80	80	1.0000000
NODE_17367_length_691_cov_3.388514	304	384	0	80	80	1.0000000
NODE_17367_length_691_cov_3.388514	357	437	0	80	80	1.0000000
NODE_17415_length_690_cov_39.538071	563	612	0	49	49	1.0000000
NODE_17415_length_690_cov_39.538071	598	678	0	80	80	1.0000000
NODE_17415_length_690_cov_39.538071	651	690	0	39	39	1.0000000
NODE_17417_length_690_cov_30.336717	319	394	1	75	75	1.0000000
NODE_17417_length_690_cov_30.336717	372	453	0	6	81	0.0740741
NODE_17417_length_690_cov_30.336717	372	453	1	28	81	0.3456790
NODE_17417_length_690_cov_30.336717	372	453	2	32	81	0.3950617
NODE_17417_length_690_cov_30.336717	372	453	4	15	81	0.1851852
NODE_17417_length_690_cov_30.336717	449	529	4	80	80	1.0000000
NODE_17417_length_690_cov_30.336717	502	582	2	27	80	0.3375000
NODE_17417_length_690_cov_30.336717	502	582	4	53	80	0.6625000
NODE_17418_length_690_cov_26.888325	270	350	1	80	80	1.0000000
NODE_17418_length_690_cov_26.888325	323	403	0	27	80	0.3375000
NODE_17418_length_690_cov_26.888325	323	403	1	53	80	0.6625000
NODE_17419_length_690_cov_23.360406	131	211	0	80	80	1.0000000
NODE_17419_length_690_cov_23.360406	188	264	0	76	76	1.0000000
NODE_17420_length_690_cov_18.737733	316	396	0	52	80	0.6500000
NODE_17420_length_690_cov_18.737733	316	396	2	28	80	0.3500000
NODE_17420_length_690_cov_18.737733	369	449	2	80	80	1.0000000
NODE_17421_length_690_cov_16.593909	364	444	2	22	80	0.2750000
NODE_17421_length_690_cov_16.593909	364	444	3	58	80	0.7250000
NODE_17421_length_690_cov_16.593909	417	497	1	18	80	0.2250000
NODE_17421_length_690_cov_16.593909	417	497	2	30	80	0.3750000
NODE_17421_length_690_cov_16.593909	417	497	3	32	80	0.4000000
NODE_17422_length_690_cov_12.896785	320	400	0	80	80	1.0000000
NODE_17422_length_690_cov_12.896785	373	453	0	80	80	1.0000000
NODE_17423_length_690_cov_10.818951	349	429	7	39	80	0.4875000
NODE_17423_length_690_cov_10.818951	349	429	8	41	80	0.5125000
NODE_17424_length_690_cov_7.015228	273	353	0	80	80	1.0000000
NODE_17424_length_690_cov_7.015228	326	406	0	80	80	1.0000000
NODE_17429_length_690_cov_4.793570	316	365	32	6	49	0.1224490
NODE_17429_length_690_cov_4.793570	316	365	33	10	49	0.2040816
NODE_17429_length_690_cov_4.793570	316	365	34	1	49	0.0204082
NODE_17429_length_690_cov_4.793570	316	365	35	1	49	0.0204082
NODE_17429_length_690_cov_4.793570	316	365	37	16	49	0.3265306
NODE_17429_length_690_cov_4.793570	316	365	38	7	49	0.1428571
NODE_17429_length_690_cov_4.793570	316	365	39	7	49	0.1428571
NODE_17429_length_690_cov_4.793570	316	365	40	1	49	0.0204082
NODE_17430_length_690_cov_4.717428	316	396	0	80	80	1.0000000
NODE_17430_length_690_cov_4.717428	369	449	0	80	80	1.0000000
NODE_17484_length_689_cov_45.984746	244	322	1	7	78	0.0897436
NODE_17484_length_689_cov_45.984746	244	322	2	67	78	0.8589743
NODE_17484_length_689_cov_45.984746	244	322	3	4	78	0.0512821
NODE_17484_length_689_cov_45.984746	297	377	1	16	80	0.2000000
NODE_17484_length_689_cov_45.984746	297	377	2	60	80	0.7500000
NODE_17484_length_689_cov_45.984746	297	377	3	4	80	0.0500000
NODE_17485_length_689_cov_35.705085	436	516	0	80	80	1.0000000
NODE_17485_length_689_cov_35.705085	489	569	0	80	80	1.0000000
NODE_17486_length_689_cov_25.372881	211	291	2	72	80	0.9000000
NODE_17486_length_689_cov_25.372881	211	291	4	8	80	0.1000000
NODE_17486_length_689_cov_25.372881	264	344	0	7	80	0.0875000
NODE_17486_length_689_cov_25.372881	264	344	2	73	80	0.9125000
NODE_17487_length_689_cov_20.138983	319	399	0	80	80	1.0000000
NODE_17487_length_689_cov_20.138983	372	452	0	80	80	1.0000000
NODE_17488_length_689_cov_14.377966	351	431	0	80	80	1.0000000
NODE_17488_length_689_cov_14.377966	404	484	0	80	80	1.0000000
NODE_17489_length_689_cov_9.477966	201	281	3	44	80	0.5500000
NODE_17489_length_689_cov_9.477966	201	281	4	36	80	0.4500000
NODE_17489_length_689_cov_9.477966	254	334	3	16	80	0.2000000
NODE_17489_length_689_cov_9.477966	254	334	4	64	80	0.8000000
NODE_17491_length_689_cov_7.367797	122	207	8	1	85	0.0117647
NODE_17491_length_689_cov_7.367797	122	207	10	4	85	0.0470588
NODE_17491_length_689_cov_7.367797	122	207	11	8	85	0.0941176
NODE_17491_length_689_cov_7.367797	122	207	12	1	85	0.0117647
NODE_17491_length_689_cov_7.367797	122	207	13	14	85	0.1647059
NODE_17491_length_689_cov_7.367797	122	207	14	6	85	0.0705882
NODE_17491_length_689_cov_7.367797	122	207	15	51	85	0.6000000
NODE_17492_length_689_cov_6.649153	242	322	0	80	80	1.0000000
NODE_17492_length_689_cov_6.649153	295	375	0	80	80	1.0000000
NODE_17504_length_689_cov_2.788136	128	208	4	12	80	0.1500000
NODE_17504_length_689_cov_2.788136	128	208	5	34	80	0.4250000
NODE_17504_length_689_cov_2.788136	128	208	6	34	80	0.4250000
NODE_17504_length_689_cov_2.788136	181	261	2	2	80	0.0250000
NODE_17504_length_689_cov_2.788136	181	261	3	16	80	0.2000000
NODE_17504_length_689_cov_2.788136	181	261	4	19	80	0.2375000
NODE_17504_length_689_cov_2.788136	181	261	5	43	80	0.5375000
NODE_17548_length_688_cov_52.256367	198	278	8	2	80	0.0250000
NODE_17548_length_688_cov_52.256367	198	278	10	6	80	0.0750000
NODE_17548_length_688_cov_52.256367	198	278	11	72	80	0.9000000
NODE_17548_length_688_cov_52.256367	251	331	5	11	80	0.1375000
NODE_17548_length_688_cov_52.256367	251	331	7	40	80	0.5000000
NODE_17548_length_688_cov_52.256367	251	331	9	1	80	0.0125000
NODE_17548_length_688_cov_52.256367	251	331	11	28	80	0.3500000
NODE_17549_length_688_cov_37.563667	373	453	17	4	80	0.0500000
NODE_17549_length_688_cov_37.563667	373	453	18	5	80	0.0625000
NODE_17549_length_688_cov_37.563667	373	453	19	12	80	0.1500000
NODE_17549_length_688_cov_37.563667	373	453	21	6	80	0.0750000
NODE_17549_length_688_cov_37.563667	373	453	23	16	80	0.2000000
NODE_17549_length_688_cov_37.563667	373	453	24	2	80	0.0250000
NODE_17549_length_688_cov_37.563667	373	453	25	3	80	0.0375000
NODE_17549_length_688_cov_37.563667	373	453	26	3	80	0.0375000
NODE_17549_length_688_cov_37.563667	373	453	27	9	80	0.1125000
NODE_17549_length_688_cov_37.563667	373	453	28	17	80	0.2125000
NODE_17549_length_688_cov_37.563667	373	453	29	3	80	0.0375000
NODE_17549_length_688_cov_37.563667	426	506	9	15	80	0.1875000
NODE_17549_length_688_cov_37.563667	426	506	10	8	80	0.1000000
NODE_17549_length_688_cov_37.563667	426	506	11	7	80	0.0875000
NODE_17549_length_688_cov_37.563667	426	506	13	12	80	0.1500000
NODE_17549_length_688_cov_37.563667	426	506	14	6	80	0.0750000
NODE_17549_length_688_cov_37.563667	426	506	15	5	80	0.0625000
NODE_17549_length_688_cov_37.563667	426	506	17	4	80	0.0500000
NODE_17549_length_688_cov_37.563667	426	506	18	5	80	0.0625000
NODE_17549_length_688_cov_37.563667	426	506	19	12	80	0.1500000
NODE_17549_length_688_cov_37.563667	426	506	21	6	80	0.0750000
NODE_17549_length_688_cov_37.563667	514	594	4	37	80	0.4625000
NODE_17549_length_688_cov_37.563667	514	594	5	23	80	0.2875000
NODE_17549_length_688_cov_37.563667	514	594	7	1	80	0.0125000
NODE_17549_length_688_cov_37.563667	514	594	8	8	80	0.1000000
NODE_17549_length_688_cov_37.563667	514	594	9	10	80	0.1250000
NODE_17549_length_688_cov_37.563667	514	594	10	1	80	0.0125000
NODE_17549_length_688_cov_37.563667	514	594	4	37	80	0.4625000
NODE_17549_length_688_cov_37.563667	514	594	5	23	80	0.2875000
NODE_17549_length_688_cov_37.563667	514	594	7	1	80	0.0125000
NODE_17549_length_688_cov_37.563667	514	594	8	8	80	0.1000000
NODE_17549_length_688_cov_37.563667	514	594	9	10	80	0.1250000
NODE_17549_length_688_cov_37.563667	514	594	10	1	80	0.0125000
NODE_17549_length_688_cov_37.563667	514	584	4	27	70	0.3857143
NODE_17549_length_688_cov_37.563667	514	584	5	23	70	0.3285714
NODE_17549_length_688_cov_37.563667	514	584	7	1	70	0.0142857
NODE_17549_length_688_cov_37.563667	514	584	8	8	70	0.1142857
NODE_17549_length_688_cov_37.563667	514	584	9	10	70	0.1428571
NODE_17549_length_688_cov_37.563667	514	584	10	1	70	0.0142857
NODE_17549_length_688_cov_37.563667	567	647	3	49	80	0.6125000
NODE_17549_length_688_cov_37.563667	567	647	4	31	80	0.3875000
NODE_17549_length_688_cov_37.563667	567	646	3	48	79	0.6075949
NODE_17549_length_688_cov_37.563667	567	646	4	31	79	0.3924051
NODE_17550_length_688_cov_33.898132	373	453	1	15	80	0.1875000
NODE_17550_length_688_cov_33.898132	373	453	2	65	80	0.8125000
NODE_17550_length_688_cov_33.898132	426	506	1	22	80	0.2750000
NODE_17550_length_688_cov_33.898132	426	506	2	58	80	0.7250000
NODE_17551_length_688_cov_26.769100	457	537	9	7	80	0.0875000
NODE_17551_length_688_cov_26.769100	457	537	10	21	80	0.2625000
NODE_17551_length_688_cov_26.769100	457	537	11	2	80	0.0250000
NODE_17551_length_688_cov_26.769100	457	537	12	27	80	0.3375000
NODE_17551_length_688_cov_26.769100	457	537	13	19	80	0.2375000
NODE_17551_length_688_cov_26.769100	457	537	14	4	80	0.0500000
NODE_17551_length_688_cov_26.769100	510	590	5	25	80	0.3125000
NODE_17551_length_688_cov_26.769100	510	590	6	18	80	0.2250000
NODE_17551_length_688_cov_26.769100	510	590	7	1	80	0.0125000
NODE_17551_length_688_cov_26.769100	510	590	8	8	80	0.1000000
NODE_17551_length_688_cov_26.769100	510	590	9	8	80	0.1000000
NODE_17551_length_688_cov_26.769100	510	590	10	16	80	0.2000000
NODE_17551_length_688_cov_26.769100	510	590	12	4	80	0.0500000
NODE_17552_length_688_cov_22.517827	332	412	0	61	80	0.7625000
NODE_17552_length_688_cov_22.517827	332	412	1	5	80	0.0625000
NODE_17552_length_688_cov_22.517827	332	412	2	14	80	0.1750000
NODE_17552_length_688_cov_22.517827	385	465	0	8	80	0.1000000
NODE_17552_length_688_cov_22.517827	385	465	1	5	80	0.0625000
NODE_17552_length_688_cov_22.517827	385	465	2	67	80	0.8375000
NODE_17553_length_688_cov_16.796265	225	305	0	80	80	1.0000000
NODE_17553_length_688_cov_16.796265	278	358	0	80	80	1.0000000
NODE_17555_length_688_cov_13.758913	378	458	0	57	80	0.7125000
NODE_17555_length_688_cov_13.758913	378	458	1	23	80	0.2875000
NODE_17555_length_688_cov_13.758913	431	511	0	4	80	0.0500000
NODE_17555_length_688_cov_13.758913	431	511	1	76	80	0.9500000
NODE_17556_length_688_cov_12.511036	330	410	0	80	80	1.0000000
NODE_17556_length_688_cov_12.511036	383	463	0	80	80	1.0000000
NODE_17561_length_688_cov_5.446520	366	414	2	48	48	1.0000000
NODE_17567_length_688_cov_3.692699	265	345	0	74	80	0.9250000
NODE_17567_length_688_cov_3.692699	265	345	1	6	80	0.0750000
NODE_17567_length_688_cov_3.692699	322	380	0	17	58	0.2931035
NODE_17567_length_688_cov_3.692699	322	380	1	7	58	0.1206897
NODE_17567_length_688_cov_3.692699	322	380	2	34	58	0.5862069
NODE_17621_length_687_cov_50.214286	430	510	2	80	80	1.0000000
NODE_17621_length_687_cov_50.214286	483	563	0	1	80	0.0125000
NODE_17621_length_687_cov_50.214286	483	563	2	79	80	0.9875000
NODE_17622_length_687_cov_32.564626	204	284	0	49	80	0.6125000
NODE_17622_length_687_cov_32.564626	204	284	1	31	80	0.3875000
NODE_17622_length_687_cov_32.564626	257	337	0	80	80	1.0000000
NODE_17623_length_687_cov_22.365646	231	311	0	80	80	1.0000000
NODE_17623_length_687_cov_22.365646	284	364	0	80	80	1.0000000
NODE_17626_length_687_cov_11.943878	233	313	2	80	80	1.0000000
NODE_17626_length_687_cov_11.943878	286	366	0	33	80	0.4125000
NODE_17626_length_687_cov_11.943878	286	366	2	47	80	0.5875000
NODE_17627_length_687_cov_7.865646	311	391	0	80	80	1.0000000
NODE_17627_length_687_cov_7.865646	364	444	0	80	80	1.0000000
NODE_17628_length_687_cov_7.353741	286	366	0	80	80	1.0000000
NODE_17628_length_687_cov_7.353741	339	419	0	34	80	0.4250000
NODE_17628_length_687_cov_7.353741	339	419	1	46	80	0.5750000
NODE_17631_length_687_cov_5.903061	369	449	0	80	80	1.0000000
NODE_17631_length_687_cov_5.903061	422	502	0	80	80	1.0000000
NODE_17695_length_686_cov_34.642249	355	440	0	85	85	1.0000000
NODE_17695_length_686_cov_34.642249	413	493	0	80	80	1.0000000
NODE_17697_length_686_cov_26.357751	413	493	1	80	80	1.0000000
NODE_17697_length_686_cov_26.357751	466	546	0	44	80	0.5500000
NODE_17697_length_686_cov_26.357751	466	546	1	36	80	0.4500000
NODE_17698_length_686_cov_16.715503	400	480	0	80	80	1.0000000
NODE_17698_length_686_cov_16.715503	453	533	0	80	80	1.0000000
NODE_17757_length_685_cov_8.769625	178	258	0	80	80	1.0000000
NODE_17757_length_685_cov_8.769625	222	250	0	28	28	1.0000000
NODE_17757_length_685_cov_8.769625	231	311	0	40	80	0.5000000
NODE_17757_length_685_cov_8.769625	231	311	1	40	80	0.5000000
NODE_17764_length_685_cov_4.447099	249	329	0	80	80	1.0000000
NODE_17764_length_685_cov_4.447099	302	382	0	80	80	1.0000000
NODE_17768_length_685_cov_3.556314	338	418	0	80	80	1.0000000
NODE_17768_length_685_cov_3.556314	391	471	0	80	80	1.0000000
NODE_17821_length_684_cov_7.521368	189	269	3	38	80	0.4750000
NODE_17821_length_684_cov_7.521368	189	269	4	10	80	0.1250000
NODE_17821_length_684_cov_7.521368	189	269	5	32	80	0.4000000
NODE_17821_length_684_cov_7.521368	242	322	3	21	80	0.2625000
NODE_17821_length_684_cov_7.521368	242	322	4	42	80	0.5250000
NODE_17821_length_684_cov_7.521368	242	322	5	17	80	0.2125000
NODE_17832_length_684_cov_3.639316	306	386	0	80	80	1.0000000
NODE_17832_length_684_cov_3.639316	359	439	0	80	80	1.0000000
NODE_17866_length_683_cov_27.493151	346	426	0	80	80	1.0000000
NODE_17866_length_683_cov_27.493151	399	479	0	80	80	1.0000000
NODE_17867_length_683_cov_12.880137	242	321	1	56	79	0.7088608
NODE_17867_length_683_cov_12.880137	242	321	2	23	79	0.2911392
NODE_17868_length_683_cov_11.772260	218	274	0	56	56	1.0000000
NODE_17868_length_683_cov_11.772260	247	333	0	86	86	1.0000000
NODE_17869_length_683_cov_9.936644	435	515	0	80	80	1.0000000
NODE_17869_length_683_cov_9.936644	488	568	0	80	80	1.0000000
NODE_17871_length_683_cov_9.017123	296	364	0	53	68	0.7794118
NODE_17871_length_683_cov_9.017123	296	364	2	15	68	0.2205882
NODE_17871_length_683_cov_9.017123	337	417	0	80	80	1.0000000
NODE_17873_length_683_cov_6.797945	359	415	1	5	56	0.0892857
NODE_17873_length_683_cov_6.797945	359	415	2	34	56	0.6071429
NODE_17873_length_683_cov_6.797945	359	415	3	15	56	0.2678571
NODE_17873_length_683_cov_6.797945	359	415	4	2	56	0.0357143
NODE_17884_length_683_cov_3.176370	113	186	0	73	73	1.0000000
NODE_17947_length_682_cov_33.516295	423	503	0	80	80	1.0000000
NODE_17947_length_682_cov_33.516295	476	556	0	80	80	1.0000000
NODE_17948_length_682_cov_27.022298	479	559	0	63	80	0.7875000
NODE_17948_length_682_cov_27.022298	479	559	3	17	80	0.2125000
NODE_17948_length_682_cov_27.022298	532	612	0	10	80	0.1250000
NODE_17948_length_682_cov_27.022298	532	612	3	17	80	0.2125000
NODE_17948_length_682_cov_27.022298	532	612	5	53	80	0.6625000
NODE_17949_length_682_cov_19.612350	434	514	2	25	80	0.3125000
NODE_17949_length_682_cov_19.612350	434	514	4	55	80	0.6875000
NODE_17949_length_682_cov_19.612350	487	567	0	23	80	0.2875000
NODE_17949_length_682_cov_19.612350	487	567	2	55	80	0.6875000
NODE_17949_length_682_cov_19.612350	487	567	4	2	80	0.0250000
NODE_17950_length_682_cov_16.620926	261	341	0	80	80	1.0000000
NODE_17950_length_682_cov_16.620926	314	394	0	80	80	1.0000000
NODE_17951_length_682_cov_13.735849	251	331	1	68	80	0.8500000
NODE_17951_length_682_cov_13.735849	251	331	2	2	80	0.0250000
NODE_17951_length_682_cov_13.735849	251	331	3	10	80	0.1250000
NODE_17951_length_682_cov_13.735849	304	384	1	15	80	0.1875000
NODE_17951_length_682_cov_13.735849	304	384	2	50	80	0.6250000
NODE_17951_length_682_cov_13.735849	304	384	3	15	80	0.1875000
NODE_17952_length_682_cov_12.835334	228	308	0	10	80	0.1250000
NODE_17952_length_682_cov_12.835334	228	308	1	19	80	0.2375000
NODE_17952_length_682_cov_12.835334	228	308	2	51	80	0.6375000
NODE_17952_length_682_cov_12.835334	281	361	2	80	80	1.0000000
NODE_17956_length_682_cov_7.504288	224	304	0	80	80	1.0000000
NODE_17956_length_682_cov_7.504288	277	357	0	80	80	1.0000000
NODE_17960_length_682_cov_5.102916	314	351	0	37	37	1.0000000
NODE_17963_length_682_cov_4.579760	152	232	0	80	80	1.0000000
NODE_17963_length_682_cov_4.579760	205	285	0	80	80	1.0000000
NODE_17967_length_682_cov_4.006861	317	397	0	80	80	1.0000000
NODE_17967_length_682_cov_4.006861	370	450	0	80	80	1.0000000
NODE_17968_length_682_cov_3.859348	160	240	0	80	80	1.0000000
NODE_17968_length_682_cov_3.859348	213	293	0	80	80	1.0000000
NODE_18010_length_681_cov_51.810997	181	261	0	4	80	0.0500000
NODE_18010_length_681_cov_51.810997	181	261	1	76	80	0.9500000
NODE_18010_length_681_cov_51.810997	234	316	1	82	82	1.0000000
NODE_18011_length_681_cov_32.128866	347	427	2	80	80	1.0000000
NODE_18011_length_681_cov_32.128866	400	475	2	75	75	1.0000000
NODE_18012_length_681_cov_19.079038	282	362	0	26	80	0.3250000
NODE_18012_length_681_cov_19.079038	282	362	1	54	80	0.6750000
NODE_18012_length_681_cov_19.079038	335	415	1	80	80	1.0000000
NODE_18013_length_681_cov_17.053265	294	374	2	80	80	1.0000000
NODE_18013_length_681_cov_17.053265	347	427	2	43	80	0.5375000
NODE_18013_length_681_cov_17.053265	347	427	3	7	80	0.0875000
NODE_18013_length_681_cov_17.053265	347	427	4	12	80	0.1500000
NODE_18013_length_681_cov_17.053265	347	427	5	18	80	0.2250000
NODE_18014_length_681_cov_11.183849	306	386	0	80	80	1.0000000
NODE_18014_length_681_cov_11.183849	359	439	0	33	80	0.4125000
NODE_18014_length_681_cov_11.183849	359	439	1	17	80	0.2125000
NODE_18014_length_681_cov_11.183849	359	439	2	30	80	0.3750000
NODE_18015_length_681_cov_8.065292	236	316	0	80	80	1.0000000
NODE_18015_length_681_cov_8.065292	289	369	0	80	80	1.0000000
NODE_18017_length_681_cov_6.888316	344	424	0	80	80	1.0000000
NODE_18017_length_681_cov_6.888316	397	477	0	80	80	1.0000000
NODE_18080_length_680_cov_35.695353	348	428	6	27	80	0.3375000
NODE_18080_length_680_cov_35.695353	348	428	7	41	80	0.5125000
NODE_18080_length_680_cov_35.695353	348	428	8	12	80	0.1500000
NODE_18080_length_680_cov_35.695353	401	481	4	17	80	0.2125000
NODE_18080_length_680_cov_35.695353	401	481	5	11	80	0.1375000
NODE_18080_length_680_cov_35.695353	401	481	6	5	80	0.0625000
NODE_18080_length_680_cov_35.695353	401	481	7	35	80	0.4375000
NODE_18080_length_680_cov_35.695353	401	481	8	12	80	0.1500000
NODE_18081_length_680_cov_17.500861	296	376	1	4	80	0.0500000
NODE_18081_length_680_cov_17.500861	296	376	2	76	80	0.9500000
NODE_18081_length_680_cov_17.500861	349	429	2	75	80	0.9375000
NODE_18081_length_680_cov_17.500861	349	429	3	5	80	0.0625000
NODE_18082_length_680_cov_16.685026	260	340	0	53	80	0.6625000
NODE_18082_length_680_cov_16.685026	260	340	1	27	80	0.3375000
NODE_18082_length_680_cov_16.685026	313	393	1	80	80	1.0000000
NODE_18083_length_680_cov_15.345955	332	412	8	3	80	0.0375000
NODE_18083_length_680_cov_15.345955	332	412	10	5	80	0.0625000
NODE_18083_length_680_cov_15.345955	332	412	11	14	80	0.1750000
NODE_18083_length_680_cov_15.345955	332	412	12	30	80	0.3750000
NODE_18083_length_680_cov_15.345955	332	412	13	28	80	0.3500000
NODE_18083_length_680_cov_15.345955	385	465	4	16	80	0.2000000
NODE_18083_length_680_cov_15.345955	385	465	5	8	80	0.1000000
NODE_18083_length_680_cov_15.345955	385	465	6	2	80	0.0250000
NODE_18083_length_680_cov_15.345955	385	465	7	24	80	0.3000000
NODE_18083_length_680_cov_15.345955	385	465	8	6	80	0.0750000
NODE_18083_length_680_cov_15.345955	385	465	10	5	80	0.0625000
NODE_18083_length_680_cov_15.345955	385	465	11	14	80	0.1750000
NODE_18083_length_680_cov_15.345955	385	465	12	5	80	0.0625000
NODE_18089_length_680_cov_3.858864	458	538	0	80	80	1.0000000
NODE_18107_length_680_cov_1.879518	236	256	0	20	20	1.0000000
NODE_18146_length_679_cov_52.046552	367	447	1	8	80	0.1000000
NODE_18146_length_679_cov_52.046552	367	447	3	15	80	0.1875000
NODE_18146_length_679_cov_52.046552	367	447	4	57	80	0.7125000
NODE_18146_length_679_cov_52.046552	420	500	3	62	80	0.7750000
NODE_18146_length_679_cov_52.046552	420	500	4	18	80	0.2250000
NODE_18147_length_679_cov_40.353448	179	259	4	39	80	0.4875000
NODE_18147_length_679_cov_40.353448	179	259	5	10	80	0.1250000
NODE_18147_length_679_cov_40.353448	179	259	6	31	80	0.3875000
NODE_18147_length_679_cov_40.353448	232	312	5	16	80	0.2000000
NODE_18147_length_679_cov_40.353448	232	312	6	64	80	0.8000000
NODE_18148_length_679_cov_38.144828	364	428	2	26	64	0.4062500
NODE_18148_length_679_cov_38.144828	364	428	4	25	64	0.3906250
NODE_18148_length_679_cov_38.144828	364	428	5	13	64	0.2031250
NODE_18148_length_679_cov_38.144828	401	481	4	19	80	0.2375000
NODE_18148_length_679_cov_38.144828	401	481	5	15	80	0.1875000
NODE_18148_length_679_cov_38.144828	401	481	6	46	80	0.5750000
NODE_18149_length_679_cov_17.134483	277	357	0	27	80	0.3375000
NODE_18149_length_679_cov_17.134483	277	357	1	53	80	0.6625000
NODE_18149_length_679_cov_17.134483	330	410	1	80	80	1.0000000
NODE_18150_length_679_cov_15.046552	310	375	0	37	65	0.5692308
NODE_18150_length_679_cov_15.046552	310	375	2	28	65	0.4307692
NODE_18151_length_679_cov_12.586207	247	327	0	80	80	1.0000000
NODE_18151_length_679_cov_12.586207	303	381	0	78	78	1.0000000
NODE_18152_length_679_cov_12.282759	337	417	0	80	80	1.0000000
NODE_18152_length_679_cov_12.282759	390	470	0	80	80	1.0000000
NODE_18153_length_679_cov_11.532759	205	285	2	1	80	0.0125000
NODE_18153_length_679_cov_11.532759	205	285	3	14	80	0.1750000
NODE_18153_length_679_cov_11.532759	205	285	5	36	80	0.4500000
NODE_18153_length_679_cov_11.532759	205	285	6	23	80	0.2875000
NODE_18153_length_679_cov_11.532759	205	285	8	6	80	0.0750000
NODE_18153_length_679_cov_11.532759	258	338	6	21	80	0.2625000
NODE_18153_length_679_cov_11.532759	258	338	8	59	80	0.7375000
NODE_18155_length_679_cov_8.043103	269	341	0	72	72	1.0000000
NODE_18155_length_679_cov_8.043103	314	394	0	80	80	1.0000000
NODE_18156_length_679_cov_7.267241	191	271	0	41	80	0.5125000
NODE_18156_length_679_cov_7.267241	191	271	2	4	80	0.0500000
NODE_18156_length_679_cov_7.267241	191	271	3	16	80	0.2000000
NODE_18156_length_679_cov_7.267241	191	271	5	3	80	0.0375000
NODE_18156_length_679_cov_7.267241	191	271	6	16	80	0.2000000
NODE_18156_length_679_cov_7.267241	244	324	3	8	80	0.1000000
NODE_18156_length_679_cov_7.267241	244	324	4	16	80	0.2000000
NODE_18156_length_679_cov_7.267241	244	324	5	3	80	0.0375000
NODE_18156_length_679_cov_7.267241	244	324	6	53	80	0.6625000
NODE_18162_length_679_cov_5.391379	279	331	2	52	52	1.0000000
NODE_18164_length_679_cov_3.813793	10	69	0	1	59	0.0169492
NODE_18164_length_679_cov_3.813793	10	69	1	54	59	0.9152542
NODE_18164_length_679_cov_3.813793	10	69	2	4	59	0.0677966
NODE_18164_length_679_cov_3.813793	48	122	1	17	74	0.2297297
NODE_18164_length_679_cov_3.813793	48	122	2	7	74	0.0945946
NODE_18164_length_679_cov_3.813793	48	122	4	50	74	0.6756757
NODE_18217_length_678_cov_38.910190	252	332	0	78	80	0.9750000
NODE_18217_length_678_cov_38.910190	252	332	1	2	80	0.0250000
NODE_18217_length_678_cov_38.910190	305	385	0	80	80	1.0000000
NODE_18217_length_678_cov_38.910190	381	461	0	10	80	0.1250000
NODE_18217_length_678_cov_38.910190	381	461	2	15	80	0.1875000
NODE_18217_length_678_cov_38.910190	381	461	3	55	80	0.6875000
NODE_18217_length_678_cov_38.910190	434	514	1	1	80	0.0125000
NODE_18217_length_678_cov_38.910190	434	514	3	79	80	0.9875000
NODE_18218_length_678_cov_20.663212	243	323	0	4	80	0.0500000
NODE_18218_length_678_cov_20.663212	243	323	1	5	80	0.0625000
NODE_18218_length_678_cov_20.663212	243	323	2	71	80	0.8875000
NODE_18218_length_678_cov_20.663212	296	376	2	80	80	1.0000000
NODE_18219_length_678_cov_12.081174	243	323	0	80	80	1.0000000
NODE_18219_length_678_cov_12.081174	296	376	0	80	80	1.0000000
NODE_18224_length_678_cov_6.559585	195	264	2	21	69	0.3043478
NODE_18224_length_678_cov_6.559585	195	264	3	9	69	0.1304348
NODE_18224_length_678_cov_6.559585	195	264	4	10	69	0.1449275
NODE_18224_length_678_cov_6.559585	195	264	5	29	69	0.4202898
NODE_18224_length_678_cov_6.559585	237	317	2	23	80	0.2875000
NODE_18224_length_678_cov_6.559585	237	317	4	40	80	0.5000000
NODE_18224_length_678_cov_6.559585	237	317	5	17	80	0.2125000
NODE_18228_length_678_cov_4.462867	133	213	2	5	80	0.0625000
NODE_18228_length_678_cov_4.462867	133	213	4	75	80	0.9375000
NODE_18228_length_678_cov_4.462867	186	266	0	20	80	0.2500000
NODE_18228_length_678_cov_4.462867	186	266	1	3	80	0.0375000
NODE_18228_length_678_cov_4.462867	186	266	2	14	80	0.1750000
NODE_18228_length_678_cov_4.462867	186	266	4	43	80	0.5375000
NODE_18239_length_678_cov_2.716753	351	431	0	80	80	1.0000000
NODE_18239_length_678_cov_2.716753	404	484	0	80	80	1.0000000
NODE_18289_length_677_cov_22.235294	274	354	0	80	80	1.0000000
NODE_18289_length_677_cov_22.235294	327	407	0	80	80	1.0000000
NODE_18290_length_677_cov_16.410035	124	206	0	82	82	1.0000000
NODE_18290_length_677_cov_16.410035	177	261	0	84	84	1.0000000
NODE_18291_length_677_cov_11.031142	393	473	0	80	80	1.0000000
NODE_18291_length_677_cov_11.031142	446	526	0	80	80	1.0000000
NODE_18292_length_677_cov_10.129758	258	338	2	47	80	0.5875000
NODE_18292_length_677_cov_10.129758	258	338	3	23	80	0.2875000
NODE_18292_length_677_cov_10.129758	258	338	4	10	80	0.1250000
NODE_18292_length_677_cov_10.129758	311	391	2	4	80	0.0500000
NODE_18292_length_677_cov_10.129758	311	391	3	17	80	0.2125000
NODE_18292_length_677_cov_10.129758	311	391	4	59	80	0.7375000
NODE_18295_length_677_cov_6.660900	217	297	5	2	80	0.0250000
NODE_18295_length_677_cov_6.660900	217	297	6	12	80	0.1500000
NODE_18295_length_677_cov_6.660900	217	297	7	37	80	0.4625000
NODE_18295_length_677_cov_6.660900	217	297	8	8	80	0.1000000
NODE_18295_length_677_cov_6.660900	217	297	9	21	80	0.2625000
NODE_18297_length_677_cov_5.228374	366	446	0	80	80	1.0000000
NODE_18312_length_677_cov_2.306228	230	278	1	5	48	0.1041667
NODE_18312_length_677_cov_2.306228	230	278	3	43	48	0.8958333
NODE_18329_length_677_cov_1.709343	369	449	0	80	80	1.0000000
NODE_18329_length_677_cov_1.709343	422	502	0	73	80	0.9125000
NODE_18329_length_677_cov_1.709343	422	502	2	7	80	0.0875000
NODE_18368_length_676_cov_66.473137	286	366	4	17	80	0.2125000
NODE_18368_length_676_cov_66.473137	286	366	5	1	80	0.0125000
NODE_18368_length_676_cov_66.473137	286	366	6	13	80	0.1625000
NODE_18368_length_676_cov_66.473137	286	366	7	49	80	0.6125000
NODE_18368_length_676_cov_66.473137	339	419	6	12	80	0.1500000
NODE_18368_length_676_cov_66.473137	339	419	7	31	80	0.3875000
NODE_18368_length_676_cov_66.473137	339	419	9	1	80	0.0125000
NODE_18368_length_676_cov_66.473137	339	419	36	1	80	0.0125000
NODE_18368_length_676_cov_66.473137	339	419	37	1	80	0.0125000
NODE_18368_length_676_cov_66.473137	339	419	39	1	80	0.0125000
NODE_18368_length_676_cov_66.473137	339	419	43	1	80	0.0125000
NODE_18368_length_676_cov_66.473137	339	419	46	2	80	0.0250000
NODE_18368_length_676_cov_66.473137	339	419	49	1	80	0.0125000
NODE_18368_length_676_cov_66.473137	339	419	50	1	80	0.0125000
NODE_18368_length_676_cov_66.473137	339	419	53	1	80	0.0125000
NODE_18368_length_676_cov_66.473137	339	419	54	1	80	0.0125000
NODE_18368_length_676_cov_66.473137	339	419	55	1	80	0.0125000
NODE_18368_length_676_cov_66.473137	339	419	56	1	80	0.0125000
NODE_18368_length_676_cov_66.473137	339	419	57	2	80	0.0250000
NODE_18368_length_676_cov_66.473137	339	419	58	13	80	0.1625000
NODE_18368_length_676_cov_66.473137	339	419	59	9	80	0.1125000
NODE_18368_length_676_cov_66.473137	383	419	36	1	36	0.0277778
NODE_18368_length_676_cov_66.473137	383	419	37	1	36	0.0277778
NODE_18368_length_676_cov_66.473137	383	419	39	1	36	0.0277778
NODE_18368_length_676_cov_66.473137	383	419	43	1	36	0.0277778
NODE_18368_length_676_cov_66.473137	383	419	46	2	36	0.0555556
NODE_18368_length_676_cov_66.473137	383	419	49	1	36	0.0277778
NODE_18368_length_676_cov_66.473137	383	419	50	1	36	0.0277778
NODE_18368_length_676_cov_66.473137	383	419	53	1	36	0.0277778
NODE_18368_length_676_cov_66.473137	383	419	54	1	36	0.0277778
NODE_18368_length_676_cov_66.473137	383	419	55	1	36	0.0277778
NODE_18368_length_676_cov_66.473137	383	419	56	1	36	0.0277778
NODE_18368_length_676_cov_66.473137	383	419	57	2	36	0.0555556
NODE_18368_length_676_cov_66.473137	383	419	58	13	36	0.3611111
NODE_18368_length_676_cov_66.473137	383	419	59	9	36	0.2500000
NODE_18368_length_676_cov_66.473137	383	419	36	1	36	0.0277778
NODE_18368_length_676_cov_66.473137	383	419	37	1	36	0.0277778
NODE_18368_length_676_cov_66.473137	383	419	39	1	36	0.0277778
NODE_18368_length_676_cov_66.473137	383	419	43	1	36	0.0277778
NODE_18368_length_676_cov_66.473137	383	419	46	2	36	0.0555556
NODE_18368_length_676_cov_66.473137	383	419	49	1	36	0.0277778
NODE_18368_length_676_cov_66.473137	383	419	50	1	36	0.0277778
NODE_18368_length_676_cov_66.473137	383	419	53	1	36	0.0277778
NODE_18368_length_676_cov_66.473137	383	419	54	1	36	0.0277778
NODE_18368_length_676_cov_66.473137	383	419	55	1	36	0.0277778
NODE_18368_length_676_cov_66.473137	383	419	56	1	36	0.0277778
NODE_18368_length_676_cov_66.473137	383	419	57	2	36	0.0555556
NODE_18368_length_676_cov_66.473137	383	419	58	13	36	0.3611111
NODE_18368_length_676_cov_66.473137	383	419	59	9	36	0.2500000
NODE_18368_length_676_cov_66.473137	398	419	58	13	21	0.6190476
NODE_18368_length_676_cov_66.473137	398	419	59	8	21	0.3809524
NODE_18369_length_676_cov_14.429809	259	330	0	14	71	0.1971831
NODE_18369_length_676_cov_14.429809	259	330	1	57	71	0.8028169
NODE_18370_length_676_cov_13.882149	292	372	0	1	80	0.0125000
NODE_18370_length_676_cov_13.882149	292	372	1	79	80	0.9875000
NODE_18370_length_676_cov_13.882149	345	425	1	80	80	1.0000000
NODE_18374_length_676_cov_7.225303	363	443	0	80	80	1.0000000
NODE_18374_length_676_cov_7.225303	416	496	0	80	80	1.0000000
NODE_18375_length_676_cov_6.740035	373	433	2	11	60	0.1833333
NODE_18375_length_676_cov_6.740035	373	433	3	49	60	0.8166667
NODE_18375_length_676_cov_6.740035	406	486	2	5	80	0.0625000
NODE_18375_length_676_cov_6.740035	406	486	3	75	80	0.9375000
NODE_18378_length_676_cov_4.658579	167	240	1	47	73	0.6438356
NODE_18378_length_676_cov_4.658579	167	240	2	26	73	0.3561644
NODE_18397_length_676_cov_2.292894	146	226	0	42	80	0.5250000
NODE_18397_length_676_cov_2.292894	146	226	2	24	80	0.3000000
NODE_18397_length_676_cov_2.292894	146	226	3	14	80	0.1750000
NODE_18401_length_676_cov_2.157712	175	226	1	21	51	0.4117647
NODE_18401_length_676_cov_2.157712	175	226	2	30	51	0.5882353
NODE_18417_length_676_cov_1.547660	133	164	2	31	31	1.0000000
NODE_18447_length_675_cov_27.574653	190	270	2	80	80	1.0000000
NODE_18447_length_675_cov_27.574653	243	323	2	79	80	0.9875000
NODE_18447_length_675_cov_27.574653	243	323	4	1	80	0.0125000
NODE_18448_length_675_cov_11.895833	336	416	0	80	80	1.0000000
NODE_18448_length_675_cov_11.895833	389	469	0	80	80	1.0000000
NODE_18449_length_675_cov_8.157986	414	494	3	13	80	0.1625000
NODE_18449_length_675_cov_8.157986	414	494	4	67	80	0.8375000
NODE_18449_length_675_cov_8.157986	467	547	1	1	80	0.0125000
NODE_18449_length_675_cov_8.157986	467	547	2	52	80	0.6500000
NODE_18449_length_675_cov_8.157986	467	547	4	27	80	0.3375000
NODE_18450_length_675_cov_8.026042	320	400	1	42	80	0.5250000
NODE_18450_length_675_cov_8.026042	320	400	2	38	80	0.4750000
NODE_18450_length_675_cov_8.026042	373	453	0	42	80	0.5250000
NODE_18450_length_675_cov_8.026042	373	453	1	38	80	0.4750000
NODE_18451_length_675_cov_7.277778	317	397	0	80	80	1.0000000
NODE_18455_length_675_cov_5.666667	142	222	1	48	80	0.6000000
NODE_18455_length_675_cov_5.666667	142	222	2	32	80	0.4000000
NODE_18455_length_675_cov_5.666667	195	275	1	31	80	0.3875000
NODE_18455_length_675_cov_5.666667	195	275	2	6	80	0.0750000
NODE_18455_length_675_cov_5.666667	195	275	3	16	80	0.2000000
NODE_18455_length_675_cov_5.666667	195	275	5	27	80	0.3375000
NODE_18464_length_675_cov_2.751736	67	122	2	5	55	0.0909091
NODE_18464_length_675_cov_2.751736	67	122	3	50	55	0.9090909
NODE_18467_length_675_cov_2.623264	251	289	0	38	38	1.0000000
NODE_18467_length_675_cov_2.623264	279	343	0	64	64	1.0000000
NODE_18467_length_675_cov_2.623264	432	494	0	62	62	1.0000000
NODE_18515_length_674_cov_38.401739	225	305	3	8	80	0.1000000
NODE_18515_length_674_cov_38.401739	225	305	4	34	80	0.4250000
NODE_18515_length_674_cov_38.401739	225	305	6	38	80	0.4750000
NODE_18515_length_674_cov_38.401739	278	358	6	77	80	0.9625000
NODE_18515_length_674_cov_38.401739	278	358	7	3	80	0.0375000
NODE_18516_length_674_cov_30.215652	519	599	20	4	80	0.0500000
NODE_18516_length_674_cov_30.215652	519	599	21	6	80	0.0750000
NODE_18516_length_674_cov_30.215652	519	599	22	12	80	0.1500000
NODE_18516_length_674_cov_30.215652	519	599	23	15	80	0.1875000
NODE_18516_length_674_cov_30.215652	519	599	24	13	80	0.1625000
NODE_18516_length_674_cov_30.215652	519	599	26	30	80	0.3750000
NODE_18516_length_674_cov_30.215652	572	602	20	7	30	0.2333333
NODE_18516_length_674_cov_30.215652	572	602	22	12	30	0.4000000
NODE_18516_length_674_cov_30.215652	572	602	24	6	30	0.2000000
NODE_18516_length_674_cov_30.215652	572	602	26	5	30	0.1666667
NODE_18517_length_674_cov_19.636522	283	363	1	58	80	0.7250000
NODE_18517_length_674_cov_19.636522	283	363	2	22	80	0.2750000
NODE_18517_length_674_cov_19.636522	336	416	1	5	80	0.0625000
NODE_18517_length_674_cov_19.636522	336	416	2	75	80	0.9375000
NODE_18518_length_674_cov_19.436522	81	161	0	80	80	1.0000000
NODE_18518_length_674_cov_19.436522	134	214	0	44	80	0.5500000
NODE_18518_length_674_cov_19.436522	134	214	2	36	80	0.4500000
NODE_18519_length_674_cov_16.819130	185	265	0	80	80	1.0000000
NODE_18519_length_674_cov_16.819130	238	318	0	80	80	1.0000000
NODE_18520_length_674_cov_14.733913	169	249	0	34	80	0.4250000
NODE_18520_length_674_cov_14.733913	169	249	2	46	80	0.5750000
NODE_18520_length_674_cov_14.733913	222	302	2	80	80	1.0000000
NODE_18524_length_674_cov_7.086957	357	437	0	80	80	1.0000000
NODE_18524_length_674_cov_7.086957	410	490	0	80	80	1.0000000
NODE_18528_length_674_cov_4.808696	262	342	0	80	80	1.0000000
NODE_18528_length_674_cov_4.808696	315	395	0	80	80	1.0000000
NODE_18592_length_673_cov_47.109756	405	485	0	2	80	0.0250000
NODE_18592_length_673_cov_47.109756	405	485	1	78	80	0.9750000
NODE_18592_length_673_cov_47.109756	458	538	1	51	80	0.6375000
NODE_18592_length_673_cov_47.109756	458	538	2	29	80	0.3625000
NODE_18593_length_673_cov_20.548780	214	294	0	80	80	1.0000000
NODE_18593_length_673_cov_20.548780	267	347	0	80	80	1.0000000
NODE_18596_length_673_cov_8.306620	337	426	1	89	89	1.0000000
NODE_18607_length_673_cov_3.041812	196	276	0	80	80	1.0000000
NODE_18607_length_673_cov_3.041812	249	329	0	80	80	1.0000000
NODE_18660_length_672_cov_15.380454	282	362	1	56	80	0.7000000
NODE_18660_length_672_cov_15.380454	282	362	2	24	80	0.3000000
NODE_18660_length_672_cov_15.380454	335	415	1	80	80	1.0000000
NODE_18661_length_672_cov_9.902269	328	408	2	16	80	0.2000000
NODE_18661_length_672_cov_9.902269	328	408	3	23	80	0.2875000
NODE_18661_length_672_cov_9.902269	328	408	4	41	80	0.5125000
NODE_18661_length_672_cov_9.902269	381	461	1	5	80	0.0625000
NODE_18661_length_672_cov_9.902269	381	461	2	2	80	0.0250000
NODE_18661_length_672_cov_9.902269	381	461	3	26	80	0.3250000
NODE_18661_length_672_cov_9.902269	381	461	4	47	80	0.5875000
NODE_18662_length_672_cov_9.462478	309	389	3	10	80	0.1250000
NODE_18662_length_672_cov_9.462478	309	389	4	3	80	0.0375000
NODE_18662_length_672_cov_9.462478	309	389	5	67	80	0.8375000
NODE_18662_length_672_cov_9.462478	362	442	1	18	80	0.2250000
NODE_18662_length_672_cov_9.462478	362	442	2	30	80	0.3750000
NODE_18662_length_672_cov_9.462478	362	442	4	8	80	0.1000000
NODE_18662_length_672_cov_9.462478	362	442	5	24	80	0.3000000
NODE_18666_length_672_cov_6.516579	354	434	1	80	80	1.0000000
NODE_18666_length_672_cov_6.516579	407	487	1	80	80	1.0000000
NODE_18668_length_672_cov_6.108202	135	215	0	40	80	0.5000000
NODE_18668_length_672_cov_6.108202	135	215	1	1	80	0.0125000
NODE_18668_length_672_cov_6.108202	135	215	2	39	80	0.4875000
NODE_18668_length_672_cov_6.108202	188	268	2	80	80	1.0000000
NODE_18670_length_672_cov_4.949389	115	152	0	37	37	1.0000000
NODE_18670_length_672_cov_4.949389	125	205	0	80	80	1.0000000
NODE_18670_length_672_cov_4.949389	278	326	0	48	48	1.0000000
NODE_18672_length_672_cov_4.753927	378	450	1	59	72	0.8194444
NODE_18672_length_672_cov_4.753927	378	450	2	13	72	0.1805556
NODE_18704_length_672_cov_1.713787	340	401	0	16	61	0.2622951
NODE_18704_length_672_cov_1.713787	340	401	1	45	61	0.7377049
NODE_18742_length_671_cov_28.874126	306	387	0	81	81	1.0000000
NODE_18742_length_671_cov_28.874126	360	440	0	80	80	1.0000000
NODE_18744_length_671_cov_18.526224	294	333	0	37	39	0.9487180
NODE_18744_length_671_cov_18.526224	294	333	1	2	39	0.0512821
NODE_18744_length_671_cov_18.526224	331	404	1	73	73	1.0000000
NODE_18744_length_671_cov_18.526224	331	351	1	20	20	1.0000000
NODE_18745_length_671_cov_16.094406	417	497	0	4	80	0.0500000
NODE_18745_length_671_cov_16.094406	417	497	2	17	80	0.2125000
NODE_18745_length_671_cov_16.094406	417	497	3	59	80	0.7375000
NODE_18745_length_671_cov_16.094406	470	550	2	14	80	0.1750000
NODE_18745_length_671_cov_16.094406	470	550	3	41	80	0.5125000
NODE_18745_length_671_cov_16.094406	470	550	4	25	80	0.3125000
NODE_18746_length_671_cov_11.756993	337	417	0	80	80	1.0000000
NODE_18746_length_671_cov_11.756993	390	470	0	80	80	1.0000000
NODE_18747_length_671_cov_9.237762	305	382	0	77	77	1.0000000
NODE_18748_length_671_cov_8.491259	298	379	1	12	81	0.1481481
NODE_18748_length_671_cov_8.491259	298	379	2	69	81	0.8518519
NODE_18748_length_671_cov_8.491259	352	430	1	63	78	0.8076923
NODE_18748_length_671_cov_8.491259	352	430	2	15	78	0.1923077
NODE_18749_length_671_cov_8.241259	97	128	0	31	31	1.0000000
NODE_18752_length_671_cov_7.201049	368	448	0	29	80	0.3625000
NODE_18752_length_671_cov_7.201049	368	448	1	51	80	0.6375000
NODE_18752_length_671_cov_7.201049	421	501	0	71	80	0.8875000
NODE_18752_length_671_cov_7.201049	421	501	1	9	80	0.1125000
NODE_18753_length_671_cov_5.680070	370	450	0	80	80	1.0000000
NODE_18753_length_671_cov_5.680070	423	503	0	80	80	1.0000000
NODE_18754_length_671_cov_4.769231	362	414	2	7	52	0.1346154
NODE_18754_length_671_cov_4.769231	362	414	3	11	52	0.2115385
NODE_18754_length_671_cov_4.769231	362	414	4	30	52	0.5769231
NODE_18754_length_671_cov_4.769231	362	414	6	4	52	0.0769231
NODE_18760_length_671_cov_3.804196	360	440	2	11	80	0.1375000
NODE_18760_length_671_cov_3.804196	360	440	3	69	80	0.8625000
NODE_18812_length_670_cov_21.017513	443	523	1	3	80	0.0375000
NODE_18812_length_670_cov_21.017513	443	523	2	18	80	0.2250000
NODE_18812_length_670_cov_21.017513	443	523	3	27	80	0.3375000
NODE_18812_length_670_cov_21.017513	443	523	4	3	80	0.0375000
NODE_18812_length_670_cov_21.017513	443	523	5	1	80	0.0125000
NODE_18812_length_670_cov_21.017513	443	523	6	28	80	0.3500000
NODE_18812_length_670_cov_21.017513	496	576	5	23	80	0.2875000
NODE_18812_length_670_cov_21.017513	496	576	6	57	80	0.7125000
NODE_18813_length_670_cov_20.346760	372	452	0	80	80	1.0000000
NODE_18813_length_670_cov_20.346760	425	505	0	80	80	1.0000000
NODE_18814_length_670_cov_15.728546	157	237	0	80	80	1.0000000
NODE_18814_length_670_cov_15.728546	210	290	0	80	80	1.0000000
NODE_18814_length_670_cov_15.728546	286	366	0	80	80	1.0000000
NODE_18814_length_670_cov_15.728546	339	419	0	80	80	1.0000000
NODE_18818_length_670_cov_6.499124	390	470	1	15	80	0.1875000
NODE_18818_length_670_cov_6.499124	390	470	3	55	80	0.6875000
NODE_18818_length_670_cov_6.499124	390	470	4	10	80	0.1250000
NODE_18834_length_670_cov_3.099825	159	217	2	39	58	0.6724138
NODE_18834_length_670_cov_3.099825	159	217	3	19	58	0.3275862
NODE_18838_length_670_cov_2.700525	252	332	0	80	80	1.0000000
NODE_18838_length_670_cov_2.700525	305	385	0	80	80	1.0000000
NODE_18883_length_669_cov_13.307018	432	512	0	80	80	1.0000000
NODE_18883_length_669_cov_13.307018	485	565	0	80	80	1.0000000
NODE_18886_length_669_cov_6.921053	245	325	3	80	80	1.0000000
NODE_18886_length_669_cov_6.921053	298	370	3	72	72	1.0000000
NODE_18901_length_669_cov_3.633333	277	347	0	50	70	0.7142857
NODE_18901_length_669_cov_3.633333	277	347	2	20	70	0.2857143
NODE_18909_length_669_cov_2.361404	434	490	2	56	56	1.0000000
NODE_18958_length_668_cov_23.131810	275	355	0	30	80	0.3750000
NODE_18958_length_668_cov_23.131810	275	355	1	50	80	0.6250000
NODE_18958_length_668_cov_23.131810	328	408	0	36	80	0.4500000
NODE_18958_length_668_cov_23.131810	328	408	1	44	80	0.5500000
NODE_18959_length_668_cov_14.978910	324	404	1	66	80	0.8250000
NODE_18959_length_668_cov_14.978910	324	404	2	14	80	0.1750000
NODE_18959_length_668_cov_14.978910	377	457	1	66	80	0.8250000
NODE_18959_length_668_cov_14.978910	377	457	2	14	80	0.1750000
NODE_18962_length_668_cov_11.184534	187	267	0	41	80	0.5125000
NODE_18962_length_668_cov_11.184534	187	267	1	39	80	0.4875000
NODE_18962_length_668_cov_11.184534	240	320	0	80	80	1.0000000
NODE_18963_length_668_cov_10.548330	211	291	0	80	80	1.0000000
NODE_18963_length_668_cov_10.548330	264	344	0	80	80	1.0000000
NODE_18964_length_668_cov_10.370826	226	308	2	11	82	0.1341463
NODE_18964_length_668_cov_10.370826	226	308	4	71	82	0.8658537
NODE_18964_length_668_cov_10.370826	279	361	3	44	82	0.5365854
NODE_18964_length_668_cov_10.370826	279	361	4	38	82	0.4634146
NODE_18965_length_668_cov_10.223199	238	318	0	43	80	0.5375000
NODE_18965_length_668_cov_10.223199	238	318	1	37	80	0.4625000
NODE_18965_length_668_cov_10.223199	291	371	1	80	80	1.0000000
NODE_18967_length_668_cov_9.340949	310	390	0	80	80	1.0000000
NODE_18967_length_668_cov_9.340949	363	443	0	80	80	1.0000000
NODE_18975_length_668_cov_4.077329	304	384	3	42	80	0.5250000
NODE_18975_length_668_cov_4.077329	304	384	4	21	80	0.2625000
NODE_18975_length_668_cov_4.077329	304	384	5	17	80	0.2125000
NODE_18975_length_668_cov_4.077329	338	367	3	8	29	0.2758621
NODE_18975_length_668_cov_4.077329	338	367	4	4	29	0.1379310
NODE_18975_length_668_cov_4.077329	338	367	5	17	29	0.5862069
NODE_18975_length_668_cov_4.077329	358	427	2	9	69	0.1304348
NODE_18975_length_668_cov_4.077329	358	427	3	16	69	0.2318841
NODE_18975_length_668_cov_4.077329	358	427	4	39	69	0.5652174
NODE_18975_length_668_cov_4.077329	358	427	5	5	69	0.0724638
NODE_19032_length_667_cov_33.848592	168	248	0	80	80	1.0000000
NODE_19032_length_667_cov_33.848592	221	301	0	80	80	1.0000000
NODE_19033_length_667_cov_21.218310	270	350	0	80	80	1.0000000
NODE_19033_length_667_cov_21.218310	323	403	0	80	80	1.0000000
NODE_19034_length_667_cov_19.204225	258	338	2	22	80	0.2750000
NODE_19034_length_667_cov_19.204225	258	338	4	58	80	0.7250000
NODE_19034_length_667_cov_19.204225	311	391	2	53	80	0.6625000
NODE_19034_length_667_cov_19.204225	311	391	3	22	80	0.2750000
NODE_19034_length_667_cov_19.204225	311	391	4	5	80	0.0625000
NODE_19036_length_667_cov_8.264085	299	379	0	80	80	1.0000000
NODE_19036_length_667_cov_8.264085	352	432	0	80	80	1.0000000
NODE_19037_length_667_cov_8.248239	76	156	0	80	80	1.0000000
NODE_19037_length_667_cov_8.248239	129	209	0	80	80	1.0000000
NODE_19038_length_667_cov_8.207746	257	323	1	56	66	0.8484849
NODE_19038_length_667_cov_8.207746	257	323	2	10	66	0.1515152
NODE_19038_length_667_cov_8.207746	296	376	0	44	80	0.5500000
NODE_19038_length_667_cov_8.207746	296	376	1	36	80	0.4500000
NODE_19039_length_667_cov_7.232394	357	437	0	80	80	1.0000000
NODE_19039_length_667_cov_7.232394	410	490	0	80	80	1.0000000
NODE_19042_length_667_cov_4.941901	199	279	0	80	80	1.0000000
NODE_19042_length_667_cov_4.941901	252	332	0	80	80	1.0000000
NODE_19053_length_667_cov_3.404930	501	536	0	27	35	0.7714286
NODE_19053_length_667_cov_3.404930	501	536	1	8	35	0.2285714
NODE_19053_length_667_cov_3.404930	503	533	0	25	30	0.8333333
NODE_19053_length_667_cov_3.404930	503	533	1	5	30	0.1666667
NODE_19100_length_666_cov_24.811287	179	254	5	36	75	0.4800000
NODE_19100_length_666_cov_24.811287	179	254	6	19	75	0.2533333
NODE_19100_length_666_cov_24.811287	179	254	7	20	75	0.2666667
NODE_19100_length_666_cov_24.811287	182	254	5	33	72	0.4583333
NODE_19100_length_666_cov_24.811287	182	254	6	19	72	0.2638889
NODE_19100_length_666_cov_24.811287	182	254	7	20	72	0.2777778
NODE_19100_length_666_cov_24.811287	227	307	5	29	80	0.3625000
NODE_19100_length_666_cov_24.811287	227	307	6	4	80	0.0500000
NODE_19100_length_666_cov_24.811287	227	307	7	47	80	0.5875000
NODE_19100_length_666_cov_24.811287	227	307	5	29	80	0.3625000
NODE_19100_length_666_cov_24.811287	227	307	6	4	80	0.0500000
NODE_19100_length_666_cov_24.811287	227	307	7	47	80	0.5875000
NODE_19100_length_666_cov_24.811287	303	383	6	14	80	0.1750000
NODE_19100_length_666_cov_24.811287	303	383	7	34	80	0.4250000
NODE_19100_length_666_cov_24.811287	303	383	9	3	80	0.0375000
NODE_19100_length_666_cov_24.811287	303	383	10	18	80	0.2250000
NODE_19100_length_666_cov_24.811287	303	383	11	11	80	0.1375000
NODE_19100_length_666_cov_24.811287	356	436	5	6	80	0.0750000
NODE_19100_length_666_cov_24.811287	356	436	7	5	80	0.0625000
NODE_19100_length_666_cov_24.811287	356	436	9	45	80	0.5625000
NODE_19100_length_666_cov_24.811287	356	436	10	18	80	0.2250000
NODE_19100_length_666_cov_24.811287	356	436	11	6	80	0.0750000
NODE_19102_length_666_cov_20.114638	172	252	0	80	80	1.0000000
NODE_19102_length_666_cov_20.114638	225	305	0	80	80	1.0000000
NODE_19103_length_666_cov_16.813051	220	286	0	15	66	0.2272727
NODE_19103_length_666_cov_16.813051	220	286	2	51	66	0.7727273
NODE_19103_length_666_cov_16.813051	259	344	0	52	85	0.6117647
NODE_19103_length_666_cov_16.813051	259	344	2	33	85	0.3882353
NODE_19104_length_666_cov_15.384480	306	386	2	28	80	0.3500000
NODE_19104_length_666_cov_15.384480	306	386	3	52	80	0.6500000
NODE_19104_length_666_cov_15.384480	359	439	1	12	80	0.1500000
NODE_19104_length_666_cov_15.384480	359	439	2	16	80	0.2000000
NODE_19104_length_666_cov_15.384480	359	439	3	52	80	0.6500000
NODE_19105_length_666_cov_14.195767	485	565	0	80	80	1.0000000
NODE_19105_length_666_cov_14.195767	538	618	0	80	80	1.0000000
NODE_19108_length_666_cov_7.770723	226	306	0	80	80	1.0000000
NODE_19108_length_666_cov_7.770723	279	359	0	80	80	1.0000000
NODE_19163_length_665_cov_28.786219	391	471	0	53	80	0.6625000
NODE_19163_length_665_cov_28.786219	391	471	1	27	80	0.3375000
NODE_19163_length_665_cov_28.786219	444	524	1	62	80	0.7750000
NODE_19163_length_665_cov_28.786219	444	524	2	18	80	0.2250000
NODE_19164_length_665_cov_21.740283	311	391	0	80	80	1.0000000
NODE_19164_length_665_cov_21.740283	364	444	0	80	80	1.0000000
NODE_19165_length_665_cov_15.904594	390	470	0	20	80	0.2500000
NODE_19165_length_665_cov_15.904594	390	470	1	14	80	0.1750000
NODE_19165_length_665_cov_15.904594	390	470	2	46	80	0.5750000
NODE_19165_length_665_cov_15.904594	443	523	2	80	80	1.0000000
NODE_19224_length_664_cov_27.208850	259	339	0	80	80	1.0000000
NODE_19224_length_664_cov_27.208850	345	404	0	59	59	1.0000000
NODE_19225_length_664_cov_16.116814	241	321	0	33	80	0.4125000
NODE_19225_length_664_cov_16.116814	241	321	2	47	80	0.5875000
NODE_19225_length_664_cov_16.116814	294	374	0	80	80	1.0000000
NODE_19227_length_664_cov_14.185841	332	412	0	80	80	1.0000000
NODE_19227_length_664_cov_14.185841	385	465	0	39	80	0.4875000
NODE_19227_length_664_cov_14.185841	385	465	1	39	80	0.4875000
NODE_19227_length_664_cov_14.185841	385	465	2	2	80	0.0250000
NODE_19228_length_664_cov_12.256637	325	405	0	7	80	0.0875000
NODE_19228_length_664_cov_12.256637	325	405	1	73	80	0.9125000
NODE_19228_length_664_cov_12.256637	378	454	1	76	76	1.0000000
NODE_19229_length_664_cov_8.378761	252	332	4	2	80	0.0250000
NODE_19229_length_664_cov_8.378761	252	332	6	12	80	0.1500000
NODE_19229_length_664_cov_8.378761	252	332	8	34	80	0.4250000
NODE_19229_length_664_cov_8.378761	252	332	10	32	80	0.4000000
NODE_19229_length_664_cov_8.378761	305	385	6	12	80	0.1500000
NODE_19229_length_664_cov_8.378761	305	385	7	1	80	0.0125000
NODE_19229_length_664_cov_8.378761	305	385	8	7	80	0.0875000
NODE_19229_length_664_cov_8.378761	305	385	10	60	80	0.7500000
NODE_19229_length_664_cov_8.378761	381	461	0	43	80	0.5375000
NODE_19229_length_664_cov_8.378761	381	461	2	17	80	0.2125000
NODE_19229_length_664_cov_8.378761	381	461	4	8	80	0.1000000
NODE_19229_length_664_cov_8.378761	381	461	6	12	80	0.1500000
NODE_19229_length_664_cov_8.378761	434	514	0	63	80	0.7875000
NODE_19229_length_664_cov_8.378761	434	514	2	17	80	0.2125000
NODE_19254_length_664_cov_1.922124	393	434	0	41	41	1.0000000
NODE_19298_length_663_cov_26.601064	398	478	0	80	80	1.0000000
NODE_19298_length_663_cov_26.601064	451	531	0	80	80	1.0000000
NODE_19299_length_663_cov_16.948582	368	448	7	41	80	0.5125000
NODE_19299_length_663_cov_16.948582	368	448	8	36	80	0.4500000
NODE_19299_length_663_cov_16.948582	368	448	9	3	80	0.0375000
NODE_19299_length_663_cov_16.948582	421	501	3	9	80	0.1125000
NODE_19299_length_663_cov_16.948582	421	501	4	5	80	0.0625000
NODE_19299_length_663_cov_16.948582	421	501	6	32	80	0.4000000
NODE_19299_length_663_cov_16.948582	421	501	7	12	80	0.1500000
NODE_19299_length_663_cov_16.948582	421	501	8	22	80	0.2750000
NODE_19300_length_663_cov_16.225177	118	198	0	5	80	0.0625000
NODE_19300_length_663_cov_16.225177	118	198	2	75	80	0.9375000
NODE_19300_length_663_cov_16.225177	171	251	2	80	80	1.0000000
NODE_19302_length_663_cov_13.748227	277	357	0	80	80	1.0000000
NODE_19302_length_663_cov_13.748227	330	410	0	80	80	1.0000000
NODE_19303_length_663_cov_10.377660	300	380	6	7	80	0.0875000
NODE_19303_length_663_cov_10.377660	300	380	7	2	80	0.0250000
NODE_19303_length_663_cov_10.377660	300	380	8	10	80	0.1250000
NODE_19303_length_663_cov_10.377660	300	380	9	46	80	0.5750000
NODE_19303_length_663_cov_10.377660	300	380	10	15	80	0.1875000
NODE_19304_length_663_cov_9.549645	199	279	0	34	80	0.4250000
NODE_19304_length_663_cov_9.549645	199	279	1	4	80	0.0500000
NODE_19304_length_663_cov_9.549645	199	279	2	42	80	0.5250000
NODE_19304_length_663_cov_9.549645	252	332	0	80	80	1.0000000
NODE_19305_length_663_cov_7.397163	151	231	1	80	80	1.0000000
NODE_19305_length_663_cov_7.397163	204	284	1	64	80	0.8000000
NODE_19305_length_663_cov_7.397163	204	284	2	16	80	0.2000000
NODE_19307_length_663_cov_5.081560	317	397	0	44	80	0.5500000
NODE_19307_length_663_cov_5.081560	317	397	1	36	80	0.4500000
NODE_19368_length_662_cov_29.218472	233	313	0	26	80	0.3250000
NODE_19368_length_662_cov_29.218472	233	313	1	34	80	0.4250000
NODE_19368_length_662_cov_29.218472	233	313	2	6	80	0.0750000
NODE_19368_length_662_cov_29.218472	233	313	3	3	80	0.0375000
NODE_19368_length_662_cov_29.218472	233	313	5	11	80	0.1375000
NODE_19368_length_662_cov_29.218472	286	366	1	7	80	0.0875000
NODE_19368_length_662_cov_29.218472	286	366	2	6	80	0.0750000
NODE_19368_length_662_cov_29.218472	286	366	3	3	80	0.0375000
NODE_19368_length_662_cov_29.218472	286	366	5	64	80	0.8000000
NODE_19369_length_662_cov_18.717584	193	273	0	74	80	0.9250000
NODE_19369_length_662_cov_18.717584	193	273	2	6	80	0.0750000
NODE_19369_length_662_cov_18.717584	246	326	0	21	80	0.2625000
NODE_19369_length_662_cov_18.717584	246	326	2	59	80	0.7375000
NODE_19370_length_662_cov_16.358792	258	338	0	30	80	0.3750000
NODE_19370_length_662_cov_16.358792	258	338	1	50	80	0.6250000
NODE_19370_length_662_cov_16.358792	311	391	1	80	80	1.0000000
NODE_19371_length_662_cov_12.845471	259	339	0	41	80	0.5125000
NODE_19371_length_662_cov_12.845471	259	339	1	39	80	0.4875000
NODE_19371_length_662_cov_12.845471	312	392	0	33	80	0.4125000
NODE_19371_length_662_cov_12.845471	312	392	1	47	80	0.5875000
NODE_19372_length_662_cov_12.476021	299	379	0	80	80	1.0000000
NODE_19372_length_662_cov_12.476021	352	432	0	80	80	1.0000000
NODE_19373_length_662_cov_10.252220	239	319	0	10	80	0.1250000
NODE_19373_length_662_cov_10.252220	239	319	2	70	80	0.8750000
NODE_19373_length_662_cov_10.252220	292	372	0	63	80	0.7875000
NODE_19373_length_662_cov_10.252220	292	372	2	17	80	0.2125000
NODE_19376_length_662_cov_6.335702	267	347	1	16	80	0.2000000
NODE_19376_length_662_cov_6.335702	267	347	2	36	80	0.4500000
NODE_19376_length_662_cov_6.335702	267	347	3	28	80	0.3500000
NODE_19376_length_662_cov_6.335702	320	400	3	34	80	0.4250000
NODE_19376_length_662_cov_6.335702	320	400	4	46	80	0.5750000
NODE_19378_length_662_cov_5.738899	295	331	0	36	36	1.0000000
NODE_19378_length_662_cov_5.738899	301	322	0	21	21	1.0000000
NODE_19402_length_662_cov_1.905861	150	230	1	15	80	0.1875000
NODE_19402_length_662_cov_1.905861	150	230	2	65	80	0.8125000
NODE_19402_length_662_cov_1.905861	203	277	0	11	74	0.1486486
NODE_19402_length_662_cov_1.905861	203	277	1	51	74	0.6891892
NODE_19402_length_662_cov_1.905861	203	277	2	12	74	0.1621622
NODE_19441_length_661_cov_55.176157	236	316	12	10	80	0.1250000
NODE_19441_length_661_cov_55.176157	236	316	14	3	80	0.0375000
NODE_19441_length_661_cov_55.176157	236	316	15	15	80	0.1875000
NODE_19441_length_661_cov_55.176157	236	316	17	7	80	0.0875000
NODE_19441_length_661_cov_55.176157	236	316	18	4	80	0.0500000
NODE_19441_length_661_cov_55.176157	236	316	20	16	80	0.2000000
NODE_19441_length_661_cov_55.176157	236	316	21	24	80	0.3000000
NODE_19441_length_661_cov_55.176157	236	316	22	1	80	0.0125000
NODE_19441_length_661_cov_55.176157	289	369	9	12	80	0.1500000
NODE_19441_length_661_cov_55.176157	289	369	11	2	80	0.0250000
NODE_19441_length_661_cov_55.176157	289	369	13	1	80	0.0125000
NODE_19441_length_661_cov_55.176157	289	369	14	1	80	0.0125000
NODE_19441_length_661_cov_55.176157	289	369	15	4	80	0.0500000
NODE_19441_length_661_cov_55.176157	289	369	16	11	80	0.1375000
NODE_19441_length_661_cov_55.176157	289	369	17	12	80	0.1500000
NODE_19441_length_661_cov_55.176157	289	369	18	14	80	0.1750000
NODE_19441_length_661_cov_55.176157	289	369	20	5	80	0.0625000
NODE_19441_length_661_cov_55.176157	289	369	21	18	80	0.2250000
NODE_19442_length_661_cov_38.501779	231	311	2	65	80	0.8125000
NODE_19442_length_661_cov_38.501779	231	311	3	15	80	0.1875000
NODE_19442_length_661_cov_38.501779	284	364	1	14	80	0.1750000
NODE_19442_length_661_cov_38.501779	284	364	2	51	80	0.6375000
NODE_19442_length_661_cov_38.501779	284	364	3	15	80	0.1875000
NODE_19442_length_661_cov_38.501779	360	440	1	30	80	0.3750000
NODE_19442_length_661_cov_38.501779	360	440	2	33	80	0.4125000
NODE_19442_length_661_cov_38.501779	360	440	3	17	80	0.2125000
NODE_19442_length_661_cov_38.501779	413	493	2	12	80	0.1500000
NODE_19442_length_661_cov_38.501779	413	493	3	68	80	0.8500000
NODE_19443_length_661_cov_31.460854	128	208	1	40	80	0.5000000
NODE_19443_length_661_cov_31.460854	128	208	2	15	80	0.1875000
NODE_19443_length_661_cov_31.460854	128	208	3	25	80	0.3125000
NODE_19443_length_661_cov_31.460854	181	261	2	2	80	0.0250000
NODE_19443_length_661_cov_31.460854	181	261	3	59	80	0.7375000
NODE_19443_length_661_cov_31.460854	181	261	4	19	80	0.2375000
NODE_19444_length_661_cov_18.960854	216	296	1	80	80	1.0000000
NODE_19444_length_661_cov_18.960854	269	349	0	10	80	0.1250000
NODE_19444_length_661_cov_18.960854	269	349	1	70	80	0.8750000
NODE_19445_length_661_cov_16.035587	201	281	0	80	80	1.0000000
NODE_19445_length_661_cov_16.035587	254	334	0	80	80	1.0000000
NODE_19447_length_661_cov_13.005338	281	343	0	62	62	1.0000000
NODE_19447_length_661_cov_13.005338	353	433	0	80	80	1.0000000
NODE_19447_length_661_cov_13.005338	406	486	0	80	80	1.0000000
NODE_19452_length_661_cov_5.670819	374	454	3	17	80	0.2125000
NODE_19452_length_661_cov_5.670819	374	454	4	63	80	0.7875000
NODE_19452_length_661_cov_5.670819	427	507	1	7	80	0.0875000
NODE_19452_length_661_cov_5.670819	427	507	2	42	80	0.5250000
NODE_19452_length_661_cov_5.670819	427	507	3	13	80	0.1625000
NODE_19452_length_661_cov_5.670819	427	507	4	18	80	0.2250000
NODE_19457_length_661_cov_4.601423	319	395	0	70	76	0.9210526
NODE_19457_length_661_cov_4.601423	319	395	1	6	76	0.0789474
NODE_19459_length_661_cov_3.532028	282	362	1	44	80	0.5500000
NODE_19459_length_661_cov_3.532028	282	362	2	36	80	0.4500000
NODE_19459_length_661_cov_3.532028	335	415	0	39	80	0.4875000
NODE_19459_length_661_cov_3.532028	335	415	1	41	80	0.5125000
NODE_19515_length_660_cov_20.741533	343	423	0	80	80	1.0000000
NODE_19515_length_660_cov_20.741533	396	476	0	80	80	1.0000000
NODE_19516_length_660_cov_15.089127	148	228	1	13	80	0.1625000
NODE_19516_length_660_cov_15.089127	148	228	3	39	80	0.4875000
NODE_19516_length_660_cov_15.089127	148	228	4	28	80	0.3500000
NODE_19516_length_660_cov_15.089127	201	281	3	80	80	1.0000000
NODE_19518_length_660_cov_13.301248	276	356	2	17	80	0.2125000
NODE_19518_length_660_cov_13.301248	276	356	3	63	80	0.7875000
NODE_19518_length_660_cov_13.301248	329	409	1	14	80	0.1750000
NODE_19518_length_660_cov_13.301248	329	409	2	37	80	0.4625000
NODE_19518_length_660_cov_13.301248	329	409	3	29	80	0.3625000
NODE_19519_length_660_cov_12.393939	234	314	3	80	80	1.0000000
NODE_19519_length_660_cov_12.393939	287	367	1	13	80	0.1625000
NODE_19519_length_660_cov_12.393939	287	367	3	67	80	0.8375000
NODE_19521_length_660_cov_11.495544	399	479	1	80	80	1.0000000
NODE_19521_length_660_cov_11.495544	452	532	0	13	80	0.1625000
NODE_19521_length_660_cov_11.495544	452	532	1	67	80	0.8375000
NODE_19522_length_660_cov_10.522282	177	257	1	80	80	1.0000000
NODE_19522_length_660_cov_10.522282	230	311	0	15	81	0.1851852
NODE_19522_length_660_cov_10.522282	230	311	1	66	81	0.8148148
NODE_19524_length_660_cov_8.887701	254	325	8	31	71	0.4366197
NODE_19524_length_660_cov_8.887701	254	325	9	8	71	0.1126761
NODE_19524_length_660_cov_8.887701	254	325	10	32	71	0.4507042
NODE_19527_length_660_cov_7.278075	225	305	0	80	80	1.0000000
NODE_19527_length_660_cov_7.278075	278	358	0	80	80	1.0000000
NODE_19529_length_660_cov_6.577540	350	430	2	21	80	0.2625000
NODE_19529_length_660_cov_6.577540	350	430	3	44	80	0.5500000
NODE_19529_length_660_cov_6.577540	350	430	4	15	80	0.1875000
NODE_19529_length_660_cov_6.577540	403	483	2	25	80	0.3125000
NODE_19529_length_660_cov_6.577540	403	483	3	55	80	0.6875000
NODE_19549_length_660_cov_2.354724	421	470	0	36	49	0.7346939
NODE_19549_length_660_cov_2.354724	421	470	1	13	49	0.2653061
NODE_19594_length_659_cov_43.587500	2	82	0	37	80	0.4625000
NODE_19594_length_659_cov_43.587500	2	82	1	43	80	0.5375000
NODE_19594_length_659_cov_43.587500	55	135	1	35	80	0.4375000
NODE_19594_length_659_cov_43.587500	55	135	2	4	80	0.0500000
NODE_19594_length_659_cov_43.587500	55	135	3	7	80	0.0875000
NODE_19594_length_659_cov_43.587500	55	135	4	34	80	0.4250000
NODE_19594_length_659_cov_43.587500	131	211	3	22	80	0.2750000
NODE_19594_length_659_cov_43.587500	131	211	4	58	80	0.7250000
NODE_19594_length_659_cov_43.587500	184	264	0	13	80	0.1625000
NODE_19594_length_659_cov_43.587500	184	264	1	7	80	0.0875000
NODE_19594_length_659_cov_43.587500	184	264	2	4	80	0.0500000
NODE_19594_length_659_cov_43.587500	184	264	3	51	80	0.6375000
NODE_19594_length_659_cov_43.587500	184	264	4	5	80	0.0625000
NODE_19595_length_659_cov_23.330357	236	316	0	17	80	0.2125000
NODE_19595_length_659_cov_23.330357	236	316	2	63	80	0.7875000
NODE_19595_length_659_cov_23.330357	289	369	0	70	80	0.8750000
NODE_19595_length_659_cov_23.330357	289	369	2	10	80	0.1250000
NODE_19596_length_659_cov_12.775000	255	335	0	5	80	0.0625000
NODE_19596_length_659_cov_12.775000	255	335	1	3	80	0.0375000
NODE_19596_length_659_cov_12.775000	255	335	4	30	80	0.3750000
NODE_19596_length_659_cov_12.775000	255	335	6	30	80	0.3750000
NODE_19596_length_659_cov_12.775000	255	335	7	1	80	0.0125000
NODE_19596_length_659_cov_12.775000	255	335	8	11	80	0.1375000
NODE_19596_length_659_cov_12.775000	308	388	6	15	80	0.1875000
NODE_19596_length_659_cov_12.775000	308	388	7	1	80	0.0125000
NODE_19596_length_659_cov_12.775000	308	388	8	64	80	0.8000000
NODE_19598_length_659_cov_9.683929	220	298	0	36	78	0.4615385
NODE_19598_length_659_cov_9.683929	220	298	1	42	78	0.5384616
NODE_19598_length_659_cov_9.683929	271	351	1	80	80	1.0000000
NODE_19613_length_659_cov_3.658929	305	385	0	80	80	1.0000000
NODE_19613_length_659_cov_3.658929	358	438	0	80	80	1.0000000
NODE_19678_length_658_cov_38.479428	289	369	0	33	80	0.4125000
NODE_19678_length_658_cov_38.479428	289	369	1	13	80	0.1625000
NODE_19678_length_658_cov_38.479428	289	369	2	5	80	0.0625000
NODE_19678_length_658_cov_38.479428	289	369	3	13	80	0.1625000
NODE_19678_length_658_cov_38.479428	289	369	4	16	80	0.2000000
NODE_19678_length_658_cov_38.479428	342	422	3	11	80	0.1375000
NODE_19678_length_658_cov_38.479428	342	422	4	69	80	0.8625000
NODE_19679_length_658_cov_35.409660	242	322	3	14	80	0.1750000
NODE_19679_length_658_cov_35.409660	242	322	4	18	80	0.2250000
NODE_19679_length_658_cov_35.409660	242	322	5	48	80	0.6000000
NODE_19679_length_658_cov_35.409660	295	375	2	28	80	0.3500000
NODE_19679_length_658_cov_35.409660	295	375	3	25	80	0.3125000
NODE_19679_length_658_cov_35.409660	295	375	4	6	80	0.0750000
NODE_19679_length_658_cov_35.409660	295	375	5	21	80	0.2625000
NODE_19680_length_658_cov_20.322004	191	271	0	80	80	1.0000000
NODE_19680_length_658_cov_20.322004	244	321	0	77	77	1.0000000
NODE_19680_length_658_cov_20.322004	317	397	0	68	80	0.8500000
NODE_19680_length_658_cov_20.322004	317	397	1	12	80	0.1500000
NODE_19680_length_658_cov_20.322004	370	449	0	15	79	0.1898734
NODE_19680_length_658_cov_20.322004	370	449	1	56	79	0.7088608
NODE_19680_length_658_cov_20.322004	370	449	2	8	79	0.1012658
NODE_19681_length_658_cov_11.352415	324	404	6	15	80	0.1875000
NODE_19681_length_658_cov_11.352415	324	404	7	64	80	0.8000000
NODE_19681_length_658_cov_11.352415	324	404	9	1	80	0.0125000
NODE_19681_length_658_cov_11.352415	377	457	4	9	80	0.1125000
NODE_19681_length_658_cov_11.352415	377	457	6	14	80	0.1750000
NODE_19681_length_658_cov_11.352415	377	457	7	52	80	0.6500000
NODE_19681_length_658_cov_11.352415	377	457	9	5	80	0.0625000
NODE_19685_length_658_cov_8.241503	227	307	0	80	80	1.0000000
NODE_19685_length_658_cov_8.241503	280	360	0	73	80	0.9125000
NODE_19685_length_658_cov_8.241503	280	360	1	7	80	0.0875000
NODE_19689_length_658_cov_5.477639	450	530	4	19	80	0.2375000
NODE_19689_length_658_cov_5.477639	450	530	5	1	80	0.0125000
NODE_19689_length_658_cov_5.477639	450	530	6	17	80	0.2125000
NODE_19689_length_658_cov_5.477639	450	530	7	43	80	0.5375000
NODE_19705_length_658_cov_2.277281	286	366	1	59	80	0.7375000
NODE_19705_length_658_cov_2.277281	286	366	2	19	80	0.2375000
NODE_19705_length_658_cov_2.277281	286	366	4	2	80	0.0250000
NODE_19705_length_658_cov_2.277281	339	419	1	6	80	0.0750000
NODE_19705_length_658_cov_2.277281	339	419	2	19	80	0.2375000
NODE_19705_length_658_cov_2.277281	339	419	4	10	80	0.1250000
NODE_19705_length_658_cov_2.277281	339	419	5	3	80	0.0375000
NODE_19705_length_658_cov_2.277281	339	419	6	1	80	0.0125000
NODE_19705_length_658_cov_2.277281	339	419	7	1	80	0.0125000
NODE_19705_length_658_cov_2.277281	339	419	8	6	80	0.0750000
NODE_19705_length_658_cov_2.277281	339	419	9	9	80	0.1125000
NODE_19705_length_658_cov_2.277281	339	419	11	1	80	0.0125000
NODE_19705_length_658_cov_2.277281	339	419	12	4	80	0.0500000
NODE_19705_length_658_cov_2.277281	339	419	15	1	80	0.0125000
NODE_19705_length_658_cov_2.277281	339	419	17	1	80	0.0125000
NODE_19705_length_658_cov_2.277281	339	419	19	6	80	0.0750000
NODE_19705_length_658_cov_2.277281	339	419	22	3	80	0.0375000
NODE_19705_length_658_cov_2.277281	339	419	23	7	80	0.0875000
NODE_19705_length_658_cov_2.277281	339	419	24	2	80	0.0250000
NODE_19750_length_657_cov_71.087814	306	372	9	5	66	0.0757576
NODE_19750_length_657_cov_71.087814	306	372	11	9	66	0.1363636
NODE_19750_length_657_cov_71.087814	306	372	12	15	66	0.2272727
NODE_19750_length_657_cov_71.087814	306	372	13	12	66	0.1818182
NODE_19750_length_657_cov_71.087814	306	372	14	25	66	0.3787879
NODE_19750_length_657_cov_71.087814	382	462	4	3	80	0.0375000
NODE_19750_length_657_cov_71.087814	382	462	5	7	80	0.0875000
NODE_19750_length_657_cov_71.087814	382	462	7	5	80	0.0625000
NODE_19750_length_657_cov_71.087814	382	462	8	2	80	0.0250000
NODE_19750_length_657_cov_71.087814	382	462	11	9	80	0.1125000
NODE_19750_length_657_cov_71.087814	382	462	13	7	80	0.0875000
NODE_19750_length_657_cov_71.087814	382	462	14	31	80	0.3875000
NODE_19750_length_657_cov_71.087814	382	462	15	16	80	0.2000000
NODE_19750_length_657_cov_71.087814	382	462	4	3	80	0.0375000
NODE_19750_length_657_cov_71.087814	382	462	5	7	80	0.0875000
NODE_19750_length_657_cov_71.087814	382	462	7	5	80	0.0625000
NODE_19750_length_657_cov_71.087814	382	462	8	2	80	0.0250000
NODE_19750_length_657_cov_71.087814	382	462	11	9	80	0.1125000
NODE_19750_length_657_cov_71.087814	382	462	13	7	80	0.0875000
NODE_19750_length_657_cov_71.087814	382	462	14	31	80	0.3875000
NODE_19750_length_657_cov_71.087814	382	462	15	16	80	0.2000000
NODE_19750_length_657_cov_71.087814	435	515	2	30	80	0.3750000
NODE_19750_length_657_cov_71.087814	435	515	4	18	80	0.2250000
NODE_19750_length_657_cov_71.087814	435	515	5	15	80	0.1875000
NODE_19750_length_657_cov_71.087814	435	515	7	5	80	0.0625000
NODE_19750_length_657_cov_71.087814	435	515	8	2	80	0.0250000
NODE_19750_length_657_cov_71.087814	435	515	11	9	80	0.1125000
NODE_19750_length_657_cov_71.087814	435	515	13	1	80	0.0125000
NODE_19750_length_657_cov_71.087814	440	515	2	30	75	0.4000000
NODE_19750_length_657_cov_71.087814	440	515	4	18	75	0.2400000
NODE_19750_length_657_cov_71.087814	440	515	5	15	75	0.2000000
NODE_19750_length_657_cov_71.087814	440	515	7	5	75	0.0666667
NODE_19750_length_657_cov_71.087814	440	515	8	2	75	0.0266667
NODE_19750_length_657_cov_71.087814	440	515	11	5	75	0.0666667
NODE_19751_length_657_cov_67.408602	98	178	2	9	80	0.1125000
NODE_19751_length_657_cov_67.408602	98	178	3	15	80	0.1875000
NODE_19751_length_657_cov_67.408602	98	178	4	38	80	0.4750000
NODE_19751_length_657_cov_67.408602	98	178	5	18	80	0.2250000
NODE_19751_length_657_cov_67.408602	151	231	4	9	80	0.1125000
NODE_19751_length_657_cov_67.408602	151	231	5	43	80	0.5375000
NODE_19751_length_657_cov_67.408602	151	231	6	28	80	0.3500000
NODE_19752_length_657_cov_15.568100	265	345	1	71	80	0.8875000
NODE_19752_length_657_cov_15.568100	265	345	3	9	80	0.1125000
NODE_19752_length_657_cov_15.568100	341	421	2	55	80	0.6875000
NODE_19752_length_657_cov_15.568100	341	421	3	10	80	0.1250000
NODE_19752_length_657_cov_15.568100	341	421	4	15	80	0.1875000
NODE_19759_length_657_cov_5.161290	185	256	4	39	71	0.5492958
NODE_19759_length_657_cov_5.161290	185	256	6	21	71	0.2957746
NODE_19759_length_657_cov_5.161290	185	256	7	11	71	0.1549296
NODE_19759_length_657_cov_5.161290	229	309	3	5	80	0.0625000
NODE_19759_length_657_cov_5.161290	229	309	4	75	80	0.9375000
NODE_19824_length_656_cov_37.023339	470	550	8	5	80	0.0625000
NODE_19824_length_656_cov_37.023339	470	550	9	31	80	0.3875000
NODE_19824_length_656_cov_37.023339	470	550	10	6	80	0.0750000
NODE_19824_length_656_cov_37.023339	470	550	11	38	80	0.4750000
NODE_19824_length_656_cov_37.023339	523	603	5	15	80	0.1875000
NODE_19824_length_656_cov_37.023339	523	603	7	10	80	0.1250000
NODE_19824_length_656_cov_37.023339	523	603	9	54	80	0.6750000
NODE_19824_length_656_cov_37.023339	523	603	10	1	80	0.0125000
NODE_19825_length_656_cov_22.804309	173	253	0	15	80	0.1875000
NODE_19825_length_656_cov_22.804309	173	253	2	65	80	0.8125000
NODE_19825_length_656_cov_22.804309	226	306	2	80	80	1.0000000
NODE_19826_length_656_cov_19.280072	345	425	0	80	80	1.0000000
NODE_19826_length_656_cov_19.280072	398	478	0	80	80	1.0000000
NODE_19827_length_656_cov_18.267504	272	352	0	2	80	0.0250000
NODE_19827_length_656_cov_18.267504	272	352	1	4	80	0.0500000
NODE_19827_length_656_cov_18.267504	272	352	2	74	80	0.9250000
NODE_19827_length_656_cov_18.267504	325	405	2	80	80	1.0000000
NODE_19828_length_656_cov_15.928187	223	303	0	5	80	0.0625000
NODE_19828_length_656_cov_15.928187	223	303	1	75	80	0.9375000
NODE_19829_length_656_cov_15.091562	297	377	0	80	80	1.0000000
NODE_19829_length_656_cov_15.091562	350	430	0	80	80	1.0000000
NODE_19830_length_656_cov_12.773788	269	349	1	6	80	0.0750000
NODE_19830_length_656_cov_12.773788	269	349	2	74	80	0.9250000
NODE_19830_length_656_cov_12.773788	322	399	2	77	77	1.0000000
NODE_19831_length_656_cov_12.493716	212	292	0	12	80	0.1500000
NODE_19831_length_656_cov_12.493716	212	292	1	48	80	0.6000000
NODE_19831_length_656_cov_12.493716	212	292	2	20	80	0.2500000
NODE_19831_length_656_cov_12.493716	265	345	1	7	80	0.0875000
NODE_19831_length_656_cov_12.493716	265	345	2	73	80	0.9125000
NODE_19832_length_656_cov_10.946140	197	277	0	80	80	1.0000000
NODE_19832_length_656_cov_10.946140	250	330	0	80	80	1.0000000
NODE_19833_length_656_cov_9.412926	295	375	0	34	80	0.4250000
NODE_19833_length_656_cov_9.412926	295	375	2	46	80	0.5750000
NODE_19833_length_656_cov_9.412926	348	428	0	80	80	1.0000000
NODE_19904_length_655_cov_31.019784	212	292	7	26	80	0.3250000
NODE_19904_length_655_cov_31.019784	212	292	9	1	80	0.0125000
NODE_19904_length_655_cov_31.019784	212	292	10	11	80	0.1375000
NODE_19904_length_655_cov_31.019784	212	292	11	10	80	0.1250000
NODE_19904_length_655_cov_31.019784	212	292	12	26	80	0.3250000
NODE_19904_length_655_cov_31.019784	212	292	13	6	80	0.0750000
NODE_19904_length_655_cov_31.019784	265	345	9	24	80	0.3000000
NODE_19904_length_655_cov_31.019784	265	345	10	7	80	0.0875000
NODE_19904_length_655_cov_31.019784	265	345	11	1	80	0.0125000
NODE_19904_length_655_cov_31.019784	265	345	12	21	80	0.2625000
NODE_19904_length_655_cov_31.019784	265	345	13	27	80	0.3375000
NODE_19907_length_655_cov_8.672662	216	296	0	80	80	1.0000000
NODE_19907_length_655_cov_8.672662	269	349	0	80	80	1.0000000
NODE_19908_length_655_cov_8.250000	204	234	0	30	30	1.0000000
NODE_19909_length_655_cov_7.910072	366	446	0	80	80	1.0000000
NODE_19909_length_655_cov_7.910072	419	499	0	80	80	1.0000000
NODE_19916_length_655_cov_5.478417	178	255	0	64	77	0.8311688
NODE_19916_length_655_cov_5.478417	178	255	2	13	77	0.1688312
NODE_19916_length_655_cov_5.478417	178	221	0	30	43	0.6976744
NODE_19916_length_655_cov_5.478417	178	221	2	13	43	0.3023256
NODE_19919_length_655_cov_5.174460	347	428	1	18	81	0.2222222
NODE_19919_length_655_cov_5.174460	347	428	2	59	81	0.7283950
NODE_19919_length_655_cov_5.174460	347	428	3	4	81	0.0493827
NODE_19919_length_655_cov_5.174460	401	481	1	71	80	0.8875000
NODE_19919_length_655_cov_5.174460	401	481	2	9	80	0.1125000
NODE_19979_length_654_cov_17.086486	323	403	1	59	80	0.7375000
NODE_19979_length_654_cov_17.086486	323	403	2	3	80	0.0375000
NODE_19979_length_654_cov_17.086486	323	403	4	15	80	0.1875000
NODE_19979_length_654_cov_17.086486	323	403	6	3	80	0.0375000
NODE_19979_length_654_cov_17.086486	376	456	1	6	80	0.0750000
NODE_19979_length_654_cov_17.086486	376	456	2	3	80	0.0375000
NODE_19979_length_654_cov_17.086486	376	456	4	15	80	0.1875000
NODE_19979_length_654_cov_17.086486	376	456	5	26	80	0.3250000
NODE_19979_length_654_cov_17.086486	376	456	6	30	80	0.3750000
NODE_19980_length_654_cov_16.194595	318	398	0	80	80	1.0000000
NODE_19980_length_654_cov_16.194595	371	451	0	80	80	1.0000000
NODE_19983_length_654_cov_5.556757	341	412	0	71	71	1.0000000
NODE_19990_length_654_cov_3.236036	105	181	0	76	76	1.0000000
NODE_19990_length_654_cov_3.236036	158	236	0	78	78	1.0000000
NODE_19998_length_654_cov_2.549550	279	366	3	6	87	0.0689655
NODE_19998_length_654_cov_2.549550	279	366	4	76	87	0.8735632
NODE_19998_length_654_cov_2.549550	279	366	5	5	87	0.0574713
NODE_20013_length_654_cov_1.790991	480	560	0	80	80	1.0000000
NODE_20044_length_653_cov_70.296029	277	357	0	3	80	0.0375000
NODE_20044_length_653_cov_70.296029	277	357	2	2	80	0.0250000
NODE_20044_length_653_cov_70.296029	277	357	3	4	80	0.0500000
NODE_20044_length_653_cov_70.296029	277	357	4	62	80	0.7750000
NODE_20044_length_653_cov_70.296029	277	357	5	9	80	0.1125000
NODE_20044_length_653_cov_70.296029	330	410	3	16	80	0.2000000
NODE_20044_length_653_cov_70.296029	330	410	4	23	80	0.2875000
NODE_20044_length_653_cov_70.296029	330	410	5	41	80	0.5125000
NODE_20045_length_653_cov_28.072202	302	382	3	48	80	0.6000000
NODE_20045_length_653_cov_28.072202	302	382	4	32	80	0.4000000
NODE_20045_length_653_cov_28.072202	355	435	2	1	80	0.0125000
NODE_20045_length_653_cov_28.072202	355	435	3	65	80	0.8125000
NODE_20045_length_653_cov_28.072202	355	435	4	14	80	0.1750000
NODE_20046_length_653_cov_18.382671	214	294	0	80	80	1.0000000
NODE_20046_length_653_cov_18.382671	267	347	0	80	80	1.0000000
NODE_20047_length_653_cov_8.821300	292	372	0	80	80	1.0000000
NODE_20047_length_653_cov_8.821300	345	425	0	80	80	1.0000000
NODE_20048_length_653_cov_8.660650	200	280	0	59	80	0.7375000
NODE_20048_length_653_cov_8.660650	200	280	1	21	80	0.2625000
NODE_20048_length_653_cov_8.660650	253	333	0	6	80	0.0750000
NODE_20048_length_653_cov_8.660650	253	333	1	74	80	0.9250000
NODE_20052_length_653_cov_5.777978	308	383	3	11	75	0.1466667
NODE_20052_length_653_cov_5.777978	308	383	4	1	75	0.0133333
NODE_20052_length_653_cov_5.777978	308	383	5	63	75	0.8400000
NODE_20052_length_653_cov_5.777978	361	435	3	14	74	0.1891892
NODE_20052_length_653_cov_5.777978	361	435	4	32	74	0.4324324
NODE_20052_length_653_cov_5.777978	361	435	5	28	74	0.3783784
NODE_20054_length_653_cov_5.193141	304	356	4	34	52	0.6538461
NODE_20054_length_653_cov_5.193141	304	356	5	16	52	0.3076923
NODE_20054_length_653_cov_5.193141	304	356	6	2	52	0.0384615
NODE_20058_length_653_cov_4.823105	178	251	5	22	73	0.3013699
NODE_20058_length_653_cov_4.823105	178	251	6	48	73	0.6575342
NODE_20058_length_653_cov_4.823105	178	251	7	3	73	0.0410959
NODE_20058_length_653_cov_4.823105	178	256	4	3	78	0.0384615
NODE_20058_length_653_cov_4.823105	178	256	5	22	78	0.2820513
NODE_20058_length_653_cov_4.823105	178	256	6	50	78	0.6410257
NODE_20058_length_653_cov_4.823105	178	256	7	3	78	0.0384615
NODE_20058_length_653_cov_4.823105	229	309	2	7	80	0.0875000
NODE_20058_length_653_cov_4.823105	229	309	3	43	80	0.5375000
NODE_20058_length_653_cov_4.823105	229	309	4	6	80	0.0750000
NODE_20058_length_653_cov_4.823105	229	309	5	22	80	0.2750000
NODE_20058_length_653_cov_4.823105	229	309	6	2	80	0.0250000
NODE_20058_length_653_cov_4.823105	229	309	2	7	80	0.0875000
NODE_20058_length_653_cov_4.823105	229	309	3	43	80	0.5375000
NODE_20058_length_653_cov_4.823105	229	309	4	6	80	0.0750000
NODE_20058_length_653_cov_4.823105	229	309	5	22	80	0.2750000
NODE_20058_length_653_cov_4.823105	229	309	6	2	80	0.0250000
NODE_20058_length_653_cov_4.823105	239	309	2	7	70	0.1000000
NODE_20058_length_653_cov_4.823105	239	309	3	43	70	0.6142857
NODE_20058_length_653_cov_4.823105	239	309	4	6	70	0.0857143
NODE_20058_length_653_cov_4.823105	239	309	5	12	70	0.1714286
NODE_20058_length_653_cov_4.823105	239	309	6	2	70	0.0285714
NODE_20127_length_652_cov_215.211573	185	248	6	2	63	0.0317460
NODE_20127_length_652_cov_215.211573	185	248	7	2	63	0.0317460
NODE_20127_length_652_cov_215.211573	185	248	9	2	63	0.0317460
NODE_20127_length_652_cov_215.211573	185	248	11	1	63	0.0158730
NODE_20127_length_652_cov_215.211573	185	248	12	18	63	0.2857143
NODE_20127_length_652_cov_215.211573	185	248	14	3	63	0.0476190
NODE_20127_length_652_cov_215.211573	185	248	15	2	63	0.0317460
NODE_20127_length_652_cov_215.211573	185	248	17	2	63	0.0317460
NODE_20127_length_652_cov_215.211573	185	248	19	5	63	0.0793651
NODE_20127_length_652_cov_215.211573	185	248	21	4	63	0.0634921
NODE_20127_length_652_cov_215.211573	185	248	22	11	63	0.1746032
NODE_20127_length_652_cov_215.211573	185	248	23	10	63	0.1587302
NODE_20127_length_652_cov_215.211573	185	248	24	1	63	0.0158730
NODE_20127_length_652_cov_215.211573	221	301	19	1	80	0.0125000
NODE_20127_length_652_cov_215.211573	221	301	21	4	80	0.0500000
NODE_20127_length_652_cov_215.211573	221	301	22	11	80	0.1375000
NODE_20127_length_652_cov_215.211573	221	301	23	10	80	0.1250000
NODE_20127_length_652_cov_215.211573	221	301	24	4	80	0.0500000
NODE_20127_length_652_cov_215.211573	221	301	25	1	80	0.0125000
NODE_20127_length_652_cov_215.211573	221	301	26	3	80	0.0375000
NODE_20127_length_652_cov_215.211573	221	301	27	31	80	0.3875000
NODE_20127_length_652_cov_215.211573	221	301	28	4	80	0.0500000
NODE_20127_length_652_cov_215.211573	221	301	29	8	80	0.1000000
NODE_20127_length_652_cov_215.211573	221	301	30	3	80	0.0375000
NODE_20128_length_652_cov_21.267631	299	379	0	17	80	0.2125000
NODE_20128_length_652_cov_21.267631	299	379	2	63	80	0.7875000
NODE_20128_length_652_cov_21.267631	352	432	2	80	80	1.0000000
NODE_20138_length_652_cov_4.622061	266	315	0	49	49	1.0000000
NODE_20138_length_652_cov_4.622061	288	368	0	80	80	1.0000000
NODE_20210_length_651_cov_49.981884	425	505	10	2	80	0.0250000
NODE_20210_length_651_cov_49.981884	425	505	12	7	80	0.0875000
NODE_20210_length_651_cov_49.981884	425	505	13	1	80	0.0125000
NODE_20210_length_651_cov_49.981884	425	505	14	12	80	0.1500000
NODE_20210_length_651_cov_49.981884	425	505	15	12	80	0.1500000
NODE_20210_length_651_cov_49.981884	425	505	16	4	80	0.0500000
NODE_20210_length_651_cov_49.981884	425	505	17	2	80	0.0250000
NODE_20210_length_651_cov_49.981884	425	505	18	7	80	0.0875000
NODE_20210_length_651_cov_49.981884	425	505	20	15	80	0.1875000
NODE_20210_length_651_cov_49.981884	425	505	21	10	80	0.1250000
NODE_20210_length_651_cov_49.981884	425	505	22	8	80	0.1000000
NODE_20210_length_651_cov_49.981884	425	505	10	2	80	0.0250000
NODE_20210_length_651_cov_49.981884	425	505	12	7	80	0.0875000
NODE_20210_length_651_cov_49.981884	425	505	13	1	80	0.0125000
NODE_20210_length_651_cov_49.981884	425	505	14	12	80	0.1500000
NODE_20210_length_651_cov_49.981884	425	505	15	12	80	0.1500000
NODE_20210_length_651_cov_49.981884	425	505	16	4	80	0.0500000
NODE_20210_length_651_cov_49.981884	425	505	17	2	80	0.0250000
NODE_20210_length_651_cov_49.981884	425	505	18	7	80	0.0875000
NODE_20210_length_651_cov_49.981884	425	505	20	15	80	0.1875000
NODE_20210_length_651_cov_49.981884	425	505	21	10	80	0.1250000
NODE_20210_length_651_cov_49.981884	425	505	22	8	80	0.1000000
NODE_20210_length_651_cov_49.981884	425	505	10	2	80	0.0250000
NODE_20210_length_651_cov_49.981884	425	505	12	7	80	0.0875000
NODE_20210_length_651_cov_49.981884	425	505	13	1	80	0.0125000
NODE_20210_length_651_cov_49.981884	425	505	14	12	80	0.1500000
NODE_20210_length_651_cov_49.981884	425	505	15	12	80	0.1500000
NODE_20210_length_651_cov_49.981884	425	505	16	4	80	0.0500000
NODE_20210_length_651_cov_49.981884	425	505	17	2	80	0.0250000
NODE_20210_length_651_cov_49.981884	425	505	18	7	80	0.0875000
NODE_20210_length_651_cov_49.981884	425	505	20	15	80	0.1875000
NODE_20210_length_651_cov_49.981884	425	505	21	10	80	0.1250000
NODE_20210_length_651_cov_49.981884	425	505	22	8	80	0.1000000
NODE_20210_length_651_cov_49.981884	425	505	10	2	80	0.0250000
NODE_20210_length_651_cov_49.981884	425	505	12	7	80	0.0875000
NODE_20210_length_651_cov_49.981884	425	505	13	1	80	0.0125000
NODE_20210_length_651_cov_49.981884	425	505	14	12	80	0.1500000
NODE_20210_length_651_cov_49.981884	425	505	15	12	80	0.1500000
NODE_20210_length_651_cov_49.981884	425	505	16	4	80	0.0500000
NODE_20210_length_651_cov_49.981884	425	505	17	2	80	0.0250000
NODE_20210_length_651_cov_49.981884	425	505	18	7	80	0.0875000
NODE_20210_length_651_cov_49.981884	425	505	20	15	80	0.1875000
NODE_20210_length_651_cov_49.981884	425	505	21	10	80	0.1250000
NODE_20210_length_651_cov_49.981884	425	505	22	8	80	0.1000000
NODE_20210_length_651_cov_49.981884	478	540	8	6	62	0.0967742
NODE_20210_length_651_cov_49.981884	478	540	9	11	62	0.1774193
NODE_20210_length_651_cov_49.981884	478	540	10	12	62	0.1935484
NODE_20210_length_651_cov_49.981884	478	540	11	8	62	0.1290323
NODE_20210_length_651_cov_49.981884	478	540	12	7	62	0.1129032
NODE_20210_length_651_cov_49.981884	478	540	13	1	62	0.0161290
NODE_20210_length_651_cov_49.981884	478	540	14	12	62	0.1935484
NODE_20210_length_651_cov_49.981884	478	540	15	5	62	0.0806452
NODE_20210_length_651_cov_49.981884	478	540	8	6	62	0.0967742
NODE_20210_length_651_cov_49.981884	478	540	9	11	62	0.1774193
NODE_20210_length_651_cov_49.981884	478	540	10	12	62	0.1935484
NODE_20210_length_651_cov_49.981884	478	540	11	8	62	0.1290323
NODE_20210_length_651_cov_49.981884	478	540	12	7	62	0.1129032
NODE_20210_length_651_cov_49.981884	478	540	13	1	62	0.0161290
NODE_20210_length_651_cov_49.981884	478	540	14	12	62	0.1935484
NODE_20210_length_651_cov_49.981884	478	540	15	5	62	0.0806452
NODE_20210_length_651_cov_49.981884	478	540	8	6	62	0.0967742
NODE_20210_length_651_cov_49.981884	478	540	9	11	62	0.1774193
NODE_20210_length_651_cov_49.981884	478	540	10	12	62	0.1935484
NODE_20210_length_651_cov_49.981884	478	540	11	8	62	0.1290323
NODE_20210_length_651_cov_49.981884	478	540	12	7	62	0.1129032
NODE_20210_length_651_cov_49.981884	478	540	13	1	62	0.0161290
NODE_20210_length_651_cov_49.981884	478	540	14	12	62	0.1935484
NODE_20210_length_651_cov_49.981884	478	540	15	5	62	0.0806452
NODE_20210_length_651_cov_49.981884	478	542	8	8	64	0.1250000
NODE_20210_length_651_cov_49.981884	478	542	9	11	64	0.1718750
NODE_20210_length_651_cov_49.981884	478	542	10	12	64	0.1875000
NODE_20210_length_651_cov_49.981884	478	542	11	8	64	0.1250000
NODE_20210_length_651_cov_49.981884	478	542	12	7	64	0.1093750
NODE_20210_length_651_cov_49.981884	478	542	13	1	64	0.0156250
NODE_20210_length_651_cov_49.981884	478	542	14	12	64	0.1875000
NODE_20210_length_651_cov_49.981884	478	542	15	5	64	0.0781250
NODE_20211_length_651_cov_36.121377	422	502	1	54	80	0.6750000
NODE_20211_length_651_cov_36.121377	422	502	2	26	80	0.3250000
NODE_20211_length_651_cov_36.121377	475	555	0	42	80	0.5250000
NODE_20211_length_651_cov_36.121377	475	555	1	38	80	0.4750000
NODE_20212_length_651_cov_20.045290	252	332	0	80	80	1.0000000
NODE_20212_length_651_cov_20.045290	305	385	0	80	80	1.0000000
NODE_20213_length_651_cov_12.704710	264	344	2	7	80	0.0875000
NODE_20213_length_651_cov_12.704710	264	344	3	73	80	0.9125000
NODE_20213_length_651_cov_12.704710	317	397	1	36	80	0.4500000
NODE_20213_length_651_cov_12.704710	317	397	2	2	80	0.0250000
NODE_20213_length_651_cov_12.704710	317	397	3	42	80	0.5250000
NODE_20214_length_651_cov_11.632246	205	285	0	10	80	0.1250000
NODE_20214_length_651_cov_11.632246	205	285	1	70	80	0.8750000
NODE_20214_length_651_cov_11.632246	258	338	1	80	80	1.0000000
NODE_20215_length_651_cov_10.074275	369	449	0	48	80	0.6000000
NODE_20215_length_651_cov_10.074275	369	449	1	32	80	0.4000000
NODE_20215_length_651_cov_10.074275	422	502	1	69	80	0.8625000
NODE_20215_length_651_cov_10.074275	422	502	2	11	80	0.1375000
NODE_20216_length_651_cov_9.699275	199	279	0	2	80	0.0250000
NODE_20216_length_651_cov_9.699275	199	279	2	20	80	0.2500000
NODE_20216_length_651_cov_9.699275	199	279	3	58	80	0.7250000
NODE_20216_length_651_cov_9.699275	252	332	1	13	80	0.1625000
NODE_20216_length_651_cov_9.699275	252	332	3	67	80	0.8375000
NODE_20219_length_651_cov_8.309783	217	296	0	79	79	1.0000000
NODE_20219_length_651_cov_8.309783	269	349	0	80	80	1.0000000
NODE_20220_length_651_cov_5.621377	148	228	3	68	80	0.8500000
NODE_20220_length_651_cov_5.621377	148	228	4	12	80	0.1500000
NODE_20220_length_651_cov_5.621377	201	281	3	33	80	0.4125000
NODE_20220_length_651_cov_5.621377	201	281	4	47	80	0.5875000
NODE_20221_length_651_cov_5.610507	342	422	2	27	80	0.3375000
NODE_20221_length_651_cov_5.610507	342	422	3	53	80	0.6625000
NODE_20221_length_651_cov_5.610507	395	475	1	19	80	0.2375000
NODE_20221_length_651_cov_5.610507	395	475	3	61	80	0.7625000
NODE_20225_length_651_cov_4.246377	299	359	0	21	60	0.3500000
NODE_20225_length_651_cov_4.246377	299	359	2	39	60	0.6500000
NODE_20238_length_651_cov_2.744565	340	421	0	81	81	1.0000000
NODE_20252_length_651_cov_2.016304	280	311	2	31	31	1.0000000
NODE_20292_length_650_cov_22.644283	233	313	2	80	80	1.0000000
NODE_20292_length_650_cov_22.644283	286	366	0	26	80	0.3250000
NODE_20292_length_650_cov_22.644283	286	366	2	54	80	0.6750000
NODE_20293_length_650_cov_22.156080	269	349	0	80	80	1.0000000
NODE_20293_length_650_cov_22.156080	322	402	0	80	80	1.0000000
NODE_20294_length_650_cov_20.012704	186	266	0	22	80	0.2750000
NODE_20294_length_650_cov_20.012704	186	266	1	40	80	0.5000000
NODE_20294_length_650_cov_20.012704	186	266	2	18	80	0.2250000
NODE_20294_length_650_cov_20.012704	239	319	1	9	80	0.1125000
NODE_20294_length_650_cov_20.012704	239	319	2	20	80	0.2500000
NODE_20294_length_650_cov_20.012704	239	319	3	5	80	0.0625000
NODE_20294_length_650_cov_20.012704	239	319	4	46	80	0.5750000
NODE_20295_length_650_cov_17.626134	52	132	0	80	80	1.0000000
NODE_20295_length_650_cov_17.626134	105	185	0	80	80	1.0000000
NODE_20297_length_650_cov_10.687840	289	369	0	80	80	1.0000000
NODE_20297_length_650_cov_10.687840	342	422	0	80	80	1.0000000
NODE_20301_length_650_cov_6.519056	312	365	0	15	53	0.2830189
NODE_20301_length_650_cov_6.519056	312	365	2	9	53	0.1698113
NODE_20301_length_650_cov_6.519056	312	365	4	29	53	0.5471698
NODE_20301_length_650_cov_6.519056	338	417	4	79	79	1.0000000
NODE_20302_length_650_cov_6.159710	243	323	0	57	80	0.7125000
NODE_20302_length_650_cov_6.159710	243	323	2	23	80	0.2875000
NODE_20302_length_650_cov_6.159710	296	376	0	4	80	0.0500000
NODE_20302_length_650_cov_6.159710	296	376	2	76	80	0.9500000
NODE_20318_length_650_cov_2.488203	213	266	0	53	53	1.0000000
NODE_20370_length_649_cov_20.780000	111	140	2	29	29	1.0000000
NODE_20370_length_649_cov_20.780000	111	191	0	51	80	0.6375000
NODE_20370_length_649_cov_20.780000	111	191	2	29	80	0.3625000
NODE_20370_length_649_cov_20.780000	138	161	0	21	23	0.9130435
NODE_20370_length_649_cov_20.780000	138	161	2	2	23	0.0869565
NODE_20370_length_649_cov_20.780000	138	214	0	74	76	0.9736842
NODE_20370_length_649_cov_20.780000	138	214	2	2	76	0.0263158
NODE_20370_length_649_cov_20.780000	164	244	0	80	80	1.0000000
NODE_20371_length_649_cov_17.938182	162	242	0	34	80	0.4250000
NODE_20371_length_649_cov_17.938182	162	242	2	46	80	0.5750000
NODE_20371_length_649_cov_17.938182	215	295	0	80	80	1.0000000
NODE_20372_length_649_cov_16.761818	395	475	0	80	80	1.0000000
NODE_20372_length_649_cov_16.761818	448	528	0	80	80	1.0000000
NODE_20373_length_649_cov_15.632727	226	306	0	80	80	1.0000000
NODE_20373_length_649_cov_15.632727	279	359	0	80	80	1.0000000
NODE_20374_length_649_cov_15.516364	329	409	3	9	80	0.1125000
NODE_20374_length_649_cov_15.516364	329	409	4	27	80	0.3375000
NODE_20374_length_649_cov_15.516364	329	409	6	44	80	0.5500000
NODE_20374_length_649_cov_15.516364	382	462	4	10	80	0.1250000
NODE_20374_length_649_cov_15.516364	382	462	5	23	80	0.2875000
NODE_20374_length_649_cov_15.516364	382	462	6	47	80	0.5875000
NODE_20375_length_649_cov_10.374545	453	533	0	80	80	1.0000000
NODE_20375_length_649_cov_10.374545	506	586	0	80	80	1.0000000
NODE_20382_length_649_cov_4.403636	213	293	1	40	80	0.5000000
NODE_20382_length_649_cov_4.403636	213	293	2	40	80	0.5000000
NODE_20382_length_649_cov_4.403636	266	346	1	80	80	1.0000000
NODE_20454_length_648_cov_34.287796	343	423	0	80	80	1.0000000
NODE_20454_length_648_cov_34.287796	396	476	0	80	80	1.0000000
NODE_20454_length_648_cov_34.287796	472	552	0	80	80	1.0000000
NODE_20454_length_648_cov_34.287796	525	605	0	80	80	1.0000000
NODE_20455_length_648_cov_19.433515	259	339	1	13	80	0.1625000
NODE_20455_length_648_cov_19.433515	259	339	2	67	80	0.8375000
NODE_20455_length_648_cov_19.433515	312	392	1	37	80	0.4625000
NODE_20455_length_648_cov_19.433515	312	392	2	43	80	0.5375000
NODE_20457_length_648_cov_8.391621	206	286	0	80	80	1.0000000
NODE_20457_length_648_cov_8.391621	259	339	0	80	80	1.0000000
NODE_20459_length_648_cov_6.573770	293	373	0	80	80	1.0000000
NODE_20459_length_648_cov_6.573770	346	426	0	80	80	1.0000000
NODE_20460_length_648_cov_6.431694	285	328	0	43	43	1.0000000
NODE_20463_length_648_cov_6.085610	257	337	0	80	80	1.0000000
NODE_20463_length_648_cov_6.085610	310	390	0	80	80	1.0000000
NODE_20483_length_648_cov_2.333333	19	86	0	65	67	0.9701493
NODE_20483_length_648_cov_2.333333	19	86	1	2	67	0.0298507
NODE_20531_length_647_cov_18.489051	295	375	4	35	80	0.4375000
NODE_20531_length_647_cov_18.489051	295	375	5	20	80	0.2500000
NODE_20531_length_647_cov_18.489051	295	375	6	25	80	0.3125000
NODE_20531_length_647_cov_18.489051	348	428	4	46	80	0.5750000
NODE_20531_length_647_cov_18.489051	348	428	5	27	80	0.3375000
NODE_20531_length_647_cov_18.489051	348	428	6	7	80	0.0875000
NODE_20532_length_647_cov_14.677007	286	366	0	80	80	1.0000000
NODE_20532_length_647_cov_14.677007	339	419	0	80	80	1.0000000
NODE_20533_length_647_cov_10.895985	231	311	0	42	80	0.5250000
NODE_20533_length_647_cov_10.895985	231	311	1	38	80	0.4750000
NODE_20533_length_647_cov_10.895985	284	364	0	80	80	1.0000000
NODE_20534_length_647_cov_9.116788	372	452	2	80	80	1.0000000
NODE_20534_length_647_cov_9.116788	425	505	0	48	80	0.6000000
NODE_20534_length_647_cov_9.116788	425	505	2	32	80	0.4000000
NODE_20536_length_647_cov_6.410584	150	221	0	71	71	1.0000000
NODE_20536_length_647_cov_6.410584	194	274	0	80	80	1.0000000
NODE_20539_length_647_cov_5.567518	239	319	6	3	80	0.0375000
NODE_20539_length_647_cov_5.567518	239	319	7	76	80	0.9500000
NODE_20539_length_647_cov_5.567518	239	319	8	1	80	0.0125000
NODE_20539_length_647_cov_5.567518	292	355	6	10	63	0.1587302
NODE_20539_length_647_cov_5.567518	292	355	7	29	63	0.4603175
NODE_20539_length_647_cov_5.567518	292	355	8	9	63	0.1428571
NODE_20539_length_647_cov_5.567518	292	355	9	9	63	0.1428571
NODE_20539_length_647_cov_5.567518	292	355	11	4	63	0.0634921
NODE_20539_length_647_cov_5.567518	292	355	12	2	63	0.0317460
NODE_20539_length_647_cov_5.567518	348	416	9	1	68	0.0147059
NODE_20539_length_647_cov_5.567518	348	416	11	4	68	0.0588235
NODE_20539_length_647_cov_5.567518	348	416	12	7	68	0.1029412
NODE_20539_length_647_cov_5.567518	348	416	13	9	68	0.1323529
NODE_20539_length_647_cov_5.567518	348	416	14	16	68	0.2352941
NODE_20539_length_647_cov_5.567518	348	416	15	10	68	0.1470588
NODE_20539_length_647_cov_5.567518	348	416	16	6	68	0.0882353
NODE_20539_length_647_cov_5.567518	348	416	17	9	68	0.1323529
NODE_20539_length_647_cov_5.567518	348	416	18	6	68	0.0882353
NODE_20539_length_647_cov_5.567518	401	469	14	6	68	0.0882353
NODE_20539_length_647_cov_5.567518	401	469	15	3	68	0.0441176
NODE_20539_length_647_cov_5.567518	401	469	16	13	68	0.1911765
NODE_20539_length_647_cov_5.567518	401	469	17	46	68	0.6764706
NODE_20544_length_647_cov_3.775547	356	399	2	43	43	1.0000000
NODE_20550_length_647_cov_2.678832	239	319	0	80	80	1.0000000
NODE_20550_length_647_cov_2.678832	292	372	0	80	80	1.0000000
NODE_20561_length_647_cov_1.937956	254	304	0	50	50	1.0000000
NODE_20607_length_646_cov_56.226691	267	347	1	3	80	0.0375000
NODE_20607_length_646_cov_56.226691	267	347	2	77	80	0.9625000
NODE_20607_length_646_cov_56.226691	320	400	1	18	80	0.2250000
NODE_20607_length_646_cov_56.226691	320	400	2	62	80	0.7750000
NODE_20608_length_646_cov_23.747715	76	153	5	30	77	0.3896104
NODE_20608_length_646_cov_23.747715	76	153	6	4	77	0.0519481
NODE_20608_length_646_cov_23.747715	76	153	7	10	77	0.1298701
NODE_20608_length_646_cov_23.747715	76	153	9	17	77	0.2207792
NODE_20608_length_646_cov_23.747715	76	153	10	8	77	0.1038961
NODE_20608_length_646_cov_23.747715	76	153	11	8	77	0.1038961
NODE_20608_length_646_cov_23.747715	129	209	8	29	80	0.3625000
NODE_20608_length_646_cov_23.747715	129	209	9	34	80	0.4250000
NODE_20608_length_646_cov_23.747715	129	209	10	9	80	0.1125000
NODE_20608_length_646_cov_23.747715	129	209	11	8	80	0.1000000
NODE_20609_length_646_cov_22.740402	326	406	0	59	80	0.7375000
NODE_20609_length_646_cov_22.740402	326	406	4	21	80	0.2625000
NODE_20609_length_646_cov_22.740402	379	459	0	6	80	0.0750000
NODE_20609_length_646_cov_22.740402	379	459	2	9	80	0.1125000
NODE_20609_length_646_cov_22.740402	379	459	4	65	80	0.8125000
NODE_20610_length_646_cov_15.160878	363	443	1	66	80	0.8250000
NODE_20610_length_646_cov_15.160878	363	443	2	14	80	0.1750000
NODE_20610_length_646_cov_15.160878	416	496	1	13	80	0.1625000
NODE_20610_length_646_cov_15.160878	416	496	2	16	80	0.2000000
NODE_20610_length_646_cov_15.160878	416	496	3	51	80	0.6375000
NODE_20611_length_646_cov_9.429616	309	389	6	18	80	0.2250000
NODE_20611_length_646_cov_9.429616	309	389	7	3	80	0.0375000
NODE_20611_length_646_cov_9.429616	309	389	8	59	80	0.7375000
NODE_20611_length_646_cov_9.429616	362	442	4	2	80	0.0250000
NODE_20611_length_646_cov_9.429616	362	442	5	21	80	0.2625000
NODE_20611_length_646_cov_9.429616	362	442	6	48	80	0.6000000
NODE_20611_length_646_cov_9.429616	362	442	7	3	80	0.0375000
NODE_20611_length_646_cov_9.429616	362	442	8	6	80	0.0750000
NODE_20612_length_646_cov_9.246801	149	221	2	4	72	0.0555556
NODE_20612_length_646_cov_9.246801	149	221	3	22	72	0.3055556
NODE_20612_length_646_cov_9.246801	149	221	5	5	72	0.0694444
NODE_20612_length_646_cov_9.246801	149	221	6	2	72	0.0277778
NODE_20612_length_646_cov_9.246801	149	221	7	39	72	0.5416667
NODE_20613_length_646_cov_7.539305	227	307	0	80	80	1.0000000
NODE_20613_length_646_cov_7.539305	280	360	0	80	80	1.0000000
NODE_20614_length_646_cov_6.756856	236	316	1	13	80	0.1625000
NODE_20614_length_646_cov_6.756856	236	316	2	46	80	0.5750000
NODE_20614_length_646_cov_6.756856	236	316	3	21	80	0.2625000
NODE_20614_length_646_cov_6.756856	289	369	2	74	80	0.9250000
NODE_20614_length_646_cov_6.756856	289	369	3	6	80	0.0750000
NODE_20615_length_646_cov_6.480804	373	437	1	64	64	1.0000000
NODE_20615_length_646_cov_6.480804	410	490	0	17	80	0.2125000
NODE_20615_length_646_cov_6.480804	410	490	1	63	80	0.7875000
NODE_20616_length_646_cov_6.396709	194	274	0	80	80	1.0000000
NODE_20616_length_646_cov_6.396709	254	327	0	73	73	1.0000000
NODE_20619_length_646_cov_4.652651	265	345	1	63	80	0.7875000
NODE_20619_length_646_cov_4.652651	265	345	2	13	80	0.1625000
NODE_20619_length_646_cov_4.652651	265	345	3	4	80	0.0500000
NODE_20623_length_646_cov_4.122486	401	452	0	51	51	1.0000000
NODE_20688_length_645_cov_95.882784	179	259	8	24	80	0.3000000
NODE_20688_length_645_cov_95.882784	179	259	9	16	80	0.2000000
NODE_20688_length_645_cov_95.882784	179	259	10	32	80	0.4000000
NODE_20688_length_645_cov_95.882784	179	259	11	8	80	0.1000000
NODE_20688_length_645_cov_95.882784	232	312	4	15	80	0.1875000
NODE_20688_length_645_cov_95.882784	232	312	5	12	80	0.1500000
NODE_20688_length_645_cov_95.882784	232	312	6	9	80	0.1125000
NODE_20688_length_645_cov_95.882784	232	312	7	5	80	0.0625000
NODE_20688_length_645_cov_95.882784	232	312	8	11	80	0.1375000
NODE_20688_length_645_cov_95.882784	232	312	9	5	80	0.0625000
NODE_20688_length_645_cov_95.882784	232	312	10	17	80	0.2125000
NODE_20688_length_645_cov_95.882784	232	312	11	6	80	0.0750000
NODE_20689_length_645_cov_12.985348	343	423	0	19	80	0.2375000
NODE_20689_length_645_cov_12.985348	343	423	2	61	80	0.7625000
NODE_20689_length_645_cov_12.985348	396	476	0	40	80	0.5000000
NODE_20689_length_645_cov_12.985348	396	476	2	40	80	0.5000000
NODE_20691_length_645_cov_9.228938	254	334	3	27	80	0.3375000
NODE_20691_length_645_cov_9.228938	254	334	4	53	80	0.6625000
NODE_20691_length_645_cov_9.228938	307	387	2	17	80	0.2125000
NODE_20691_length_645_cov_9.228938	307	387	3	34	80	0.4250000
NODE_20691_length_645_cov_9.228938	307	387	4	29	80	0.3625000
NODE_20692_length_645_cov_9.172161	293	373	0	80	80	1.0000000
NODE_20692_length_645_cov_9.172161	346	426	0	80	80	1.0000000
NODE_20697_length_645_cov_5.609890	461	541	0	80	80	1.0000000
NODE_20697_length_645_cov_5.609890	514	594	0	80	80	1.0000000
NODE_20698_length_645_cov_4.743590	237	317	0	24	80	0.3000000
NODE_20698_length_645_cov_4.743590	237	317	1	56	80	0.7000000
NODE_20698_length_645_cov_4.743590	290	370	0	60	80	0.7500000
NODE_20698_length_645_cov_4.743590	290	370	1	5	80	0.0625000
NODE_20698_length_645_cov_4.743590	290	370	2	15	80	0.1875000
NODE_20716_length_645_cov_2.177656	373	416	0	43	43	1.0000000
NODE_20762_length_644_cov_59.286239	323	401	37	1	78	0.0128205
NODE_20762_length_644_cov_59.286239	323	401	39	1	78	0.0128205
NODE_20762_length_644_cov_59.286239	323	401	42	2	78	0.0256410
NODE_20762_length_644_cov_59.286239	323	401	46	3	78	0.0384615
NODE_20762_length_644_cov_59.286239	323	401	47	1	78	0.0128205
NODE_20762_length_644_cov_59.286239	323	401	49	3	78	0.0384615
NODE_20762_length_644_cov_59.286239	323	401	51	1	78	0.0128205
NODE_20762_length_644_cov_59.286239	323	401	52	4	78	0.0512821
NODE_20762_length_644_cov_59.286239	323	401	54	1	78	0.0128205
NODE_20762_length_644_cov_59.286239	323	401	55	1	78	0.0128205
NODE_20762_length_644_cov_59.286239	323	401	59	1	78	0.0128205
NODE_20762_length_644_cov_59.286239	323	401	62	1	78	0.0128205
NODE_20762_length_644_cov_59.286239	323	401	63	1	78	0.0128205
NODE_20762_length_644_cov_59.286239	323	401	66	2	78	0.0256410
NODE_20762_length_644_cov_59.286239	323	401	68	4	78	0.0512821
NODE_20762_length_644_cov_59.286239	323	401	69	1	78	0.0128205
NODE_20762_length_644_cov_59.286239	323	401	70	1	78	0.0128205
NODE_20762_length_644_cov_59.286239	323	401	72	6	78	0.0769231
NODE_20762_length_644_cov_59.286239	323	401	74	1	78	0.0128205
NODE_20762_length_644_cov_59.286239	323	401	77	1	78	0.0128205
NODE_20762_length_644_cov_59.286239	323	401	79	3	78	0.0384615
NODE_20762_length_644_cov_59.286239	323	401	80	2	78	0.0256410
NODE_20762_length_644_cov_59.286239	323	401	82	1	78	0.0128205
NODE_20762_length_644_cov_59.286239	323	401	87	1	78	0.0128205
NODE_20762_length_644_cov_59.286239	323	401	90	1	78	0.0128205
NODE_20762_length_644_cov_59.286239	323	401	92	1	78	0.0128205
NODE_20762_length_644_cov_59.286239	323	401	94	6	78	0.0769231
NODE_20762_length_644_cov_59.286239	323	401	96	1	78	0.0128205
NODE_20762_length_644_cov_59.286239	323	401	97	4	78	0.0512821
NODE_20762_length_644_cov_59.286239	323	401	101	1	78	0.0128205
NODE_20762_length_644_cov_59.286239	323	401	105	1	78	0.0128205
NODE_20762_length_644_cov_59.286239	323	401	106	1	78	0.0128205
NODE_20762_length_644_cov_59.286239	323	401	107	1	78	0.0128205
NODE_20762_length_644_cov_59.286239	323	401	108	3	78	0.0384615
NODE_20762_length_644_cov_59.286239	323	401	109	1	78	0.0128205
NODE_20762_length_644_cov_59.286239	323	401	112	8	78	0.1025641
NODE_20762_length_644_cov_59.286239	323	401	114	2	78	0.0256410
NODE_20762_length_644_cov_59.286239	323	401	115	1	78	0.0128205
NODE_20762_length_644_cov_59.286239	323	401	118	2	78	0.0256410
NODE_20763_length_644_cov_27.577982	63	143	6	80	80	1.0000000
NODE_20763_length_644_cov_27.577982	116	196	4	4	80	0.0500000
NODE_20763_length_644_cov_27.577982	116	196	5	32	80	0.4000000
NODE_20763_length_644_cov_27.577982	116	196	6	44	80	0.5500000
NODE_20765_length_644_cov_10.073394	284	364	1	10	80	0.1250000
NODE_20765_length_644_cov_10.073394	284	364	3	14	80	0.1750000
NODE_20765_length_644_cov_10.073394	284	364	4	15	80	0.1875000
NODE_20765_length_644_cov_10.073394	284	364	5	4	80	0.0500000
NODE_20765_length_644_cov_10.073394	284	364	6	37	80	0.4625000
NODE_20765_length_644_cov_10.073394	337	417	5	5	80	0.0625000
NODE_20765_length_644_cov_10.073394	337	417	6	75	80	0.9375000
NODE_20845_length_643_cov_27.562500	201	281	1	33	80	0.4125000
NODE_20845_length_643_cov_27.562500	201	281	2	8	80	0.1000000
NODE_20845_length_643_cov_27.562500	201	281	3	36	80	0.4500000
NODE_20845_length_643_cov_27.562500	201	281	4	3	80	0.0375000
NODE_20845_length_643_cov_27.562500	254	334	3	75	80	0.9375000
NODE_20845_length_643_cov_27.562500	254	334	4	5	80	0.0625000
NODE_20845_length_643_cov_27.562500	330	410	1	18	80	0.2250000
NODE_20845_length_643_cov_27.562500	330	410	2	8	80	0.1000000
NODE_20845_length_643_cov_27.562500	330	410	3	54	80	0.6750000
NODE_20845_length_643_cov_27.562500	383	463	0	35	80	0.4375000
NODE_20845_length_643_cov_27.562500	383	463	1	36	80	0.4500000
NODE_20845_length_643_cov_27.562500	383	463	2	8	80	0.1000000
NODE_20845_length_643_cov_27.562500	383	463	3	1	80	0.0125000
NODE_20846_length_643_cov_12.895221	203	283	0	32	80	0.4000000
NODE_20846_length_643_cov_12.895221	203	283	1	47	80	0.5875000
NODE_20846_length_643_cov_12.895221	203	283	2	1	80	0.0125000
NODE_20846_length_643_cov_12.895221	256	336	1	26	80	0.3250000
NODE_20846_length_643_cov_12.895221	256	336	2	54	80	0.6750000
NODE_20847_length_643_cov_10.501838	280	360	0	14	80	0.1750000
NODE_20847_length_643_cov_10.501838	280	360	1	2	80	0.0250000
NODE_20847_length_643_cov_10.501838	280	360	2	64	80	0.8000000
NODE_20847_length_643_cov_10.501838	333	413	2	39	80	0.4875000
NODE_20847_length_643_cov_10.501838	333	413	3	41	80	0.5125000
NODE_20848_length_643_cov_9.136029	307	385	3	23	78	0.2948718
NODE_20848_length_643_cov_9.136029	307	385	4	48	78	0.6153846
NODE_20848_length_643_cov_9.136029	307	385	5	7	78	0.0897436
NODE_20848_length_643_cov_9.136029	358	438	2	37	80	0.4625000
NODE_20848_length_643_cov_9.136029	358	438	3	14	80	0.1750000
NODE_20848_length_643_cov_9.136029	358	438	4	29	80	0.3625000
NODE_20849_length_643_cov_8.264706	202	282	0	80	80	1.0000000
NODE_20849_length_643_cov_8.264706	255	335	0	80	80	1.0000000
NODE_20851_length_643_cov_7.137868	173	253	0	80	80	1.0000000
NODE_20851_length_643_cov_7.137868	226	306	0	80	80	1.0000000
NODE_20855_length_643_cov_5.851103	255	335	12	2	80	0.0250000
NODE_20855_length_643_cov_5.851103	255	335	13	1	80	0.0125000
NODE_20855_length_643_cov_5.851103	255	335	14	2	80	0.0250000
NODE_20855_length_643_cov_5.851103	255	335	15	16	80	0.2000000
NODE_20855_length_643_cov_5.851103	255	335	16	33	80	0.4125000
NODE_20855_length_643_cov_5.851103	255	335	17	26	80	0.3250000
NODE_20855_length_643_cov_5.851103	308	388	10	16	80	0.2000000
NODE_20855_length_643_cov_5.851103	308	388	11	18	80	0.2250000
NODE_20855_length_643_cov_5.851103	308	388	12	21	80	0.2625000
NODE_20855_length_643_cov_5.851103	308	388	13	1	80	0.0125000
NODE_20855_length_643_cov_5.851103	308	388	14	2	80	0.0250000
NODE_20855_length_643_cov_5.851103	308	388	16	14	80	0.1750000
NODE_20855_length_643_cov_5.851103	308	388	17	8	80	0.1000000
NODE_20869_length_643_cov_3.121324	283	348	0	26	65	0.4000000
NODE_20869_length_643_cov_3.121324	283	348	1	39	65	0.6000000
NODE_20872_length_643_cov_2.806985	387	451	0	64	64	1.0000000
NODE_20942_length_642_cov_36.309392	156	236	1	79	80	0.9875000
NODE_20942_length_642_cov_36.309392	156	236	2	1	80	0.0125000
NODE_20942_length_642_cov_36.309392	209	289	0	37	80	0.4625000
NODE_20942_length_642_cov_36.309392	209	289	1	43	80	0.5375000
NODE_20943_length_642_cov_27.046041	154	234	1	80	80	1.0000000
NODE_20943_length_642_cov_27.046041	207	287	1	36	80	0.4500000
NODE_20943_length_642_cov_27.046041	207	287	2	44	80	0.5500000
NODE_20944_length_642_cov_26.290976	209	289	1	80	80	1.0000000
NODE_20944_length_642_cov_26.290976	262	342	1	64	80	0.8000000
NODE_20944_length_642_cov_26.290976	262	342	2	16	80	0.2000000
NODE_20945_length_642_cov_11.651934	309	389	0	80	80	1.0000000
NODE_20945_length_642_cov_11.651934	362	442	0	80	80	1.0000000
NODE_20947_length_642_cov_6.692449	453	533	0	80	80	1.0000000
NODE_20947_length_642_cov_6.692449	506	586	0	80	80	1.0000000
NODE_20951_length_642_cov_5.933702	260	340	1	57	80	0.7125000
NODE_20951_length_642_cov_5.933702	260	340	2	10	80	0.1250000
NODE_20951_length_642_cov_5.933702	260	340	3	11	80	0.1375000
NODE_20951_length_642_cov_5.933702	260	340	4	2	80	0.0250000
NODE_20951_length_642_cov_5.933702	313	391	1	16	78	0.2051282
NODE_20951_length_642_cov_5.933702	313	391	2	12	78	0.1538462
NODE_20951_length_642_cov_5.933702	313	391	3	48	78	0.6153846
NODE_20951_length_642_cov_5.933702	313	391	4	2	78	0.0256410
NODE_20967_length_642_cov_2.823204	115	158	8	8	43	0.1860465
NODE_20967_length_642_cov_2.823204	115	158	9	10	43	0.2325581
NODE_20967_length_642_cov_2.823204	115	158	10	1	43	0.0232558
NODE_20967_length_642_cov_2.823204	115	158	12	14	43	0.3255814
NODE_20967_length_642_cov_2.823204	115	158	14	10	43	0.2325581
NODE_20967_length_642_cov_2.823204	245	300	19	6	55	0.1090909
NODE_20967_length_642_cov_2.823204	245	300	20	10	55	0.1818182
NODE_20967_length_642_cov_2.823204	245	300	21	2	55	0.0363636
NODE_20967_length_642_cov_2.823204	245	300	22	1	55	0.0181818
NODE_20967_length_642_cov_2.823204	245	300	23	1	55	0.0181818
NODE_20967_length_642_cov_2.823204	245	300	24	6	55	0.1090909
NODE_20967_length_642_cov_2.823204	245	300	25	15	55	0.2727273
NODE_20967_length_642_cov_2.823204	245	300	26	10	55	0.1818182
NODE_20967_length_642_cov_2.823204	245	300	27	4	55	0.0727273
NODE_20967_length_642_cov_2.823204	329	410	12	15	81	0.1851852
NODE_20967_length_642_cov_2.823204	329	410	13	7	81	0.0864198
NODE_20967_length_642_cov_2.823204	329	410	14	1	81	0.0123457
NODE_20967_length_642_cov_2.823204	329	410	15	9	81	0.1111111
NODE_20967_length_642_cov_2.823204	329	410	16	1	81	0.0123457
NODE_20967_length_642_cov_2.823204	329	410	17	2	81	0.0246914
NODE_20967_length_642_cov_2.823204	329	410	19	3	81	0.0370370
NODE_20967_length_642_cov_2.823204	329	410	22	10	81	0.1234568
NODE_20967_length_642_cov_2.823204	329	410	23	9	81	0.1111111
NODE_20967_length_642_cov_2.823204	329	410	24	11	81	0.1358025
NODE_20967_length_642_cov_2.823204	329	410	25	3	81	0.0370370
NODE_20967_length_642_cov_2.823204	329	410	26	5	81	0.0617284
NODE_20967_length_642_cov_2.823204	329	410	27	5	81	0.0617284
NODE_20991_length_642_cov_1.357274	0	75	0	75	75	1.0000000
NODE_21018_length_641_cov_38.675277	284	345	9	3	61	0.0491803
NODE_21018_length_641_cov_38.675277	284	345	10	24	61	0.3934426
NODE_21018_length_641_cov_38.675277	284	345	11	15	61	0.2459016
NODE_21018_length_641_cov_38.675277	284	345	12	2	61	0.0327869
NODE_21018_length_641_cov_38.675277	284	345	14	9	61	0.1475410
NODE_21018_length_641_cov_38.675277	284	345	16	4	61	0.0655738
NODE_21018_length_641_cov_38.675277	284	345	17	4	61	0.0655738
NODE_21018_length_641_cov_38.675277	318	369	9	2	51	0.0392157
NODE_21018_length_641_cov_38.675277	318	369	10	4	51	0.0784314
NODE_21018_length_641_cov_38.675277	318	369	11	2	51	0.0392157
NODE_21018_length_641_cov_38.675277	318	369	12	2	51	0.0392157
NODE_21018_length_641_cov_38.675277	318	369	14	9	51	0.1764706
NODE_21018_length_641_cov_38.675277	318	369	15	21	51	0.4117647
NODE_21018_length_641_cov_38.675277	318	369	16	6	51	0.1176471
NODE_21018_length_641_cov_38.675277	318	369	17	5	51	0.0980392
NODE_21019_length_641_cov_15.271218	260	340	2	38	80	0.4750000
NODE_21019_length_641_cov_15.271218	260	340	4	42	80	0.5250000
NODE_21019_length_641_cov_15.271218	313	393	3	32	80	0.4000000
NODE_21019_length_641_cov_15.271218	313	393	4	48	80	0.6000000
NODE_21021_length_641_cov_12.584871	363	443	0	72	80	0.9000000
NODE_21021_length_641_cov_12.584871	363	443	1	8	80	0.1000000
NODE_21021_length_641_cov_12.584871	416	496	0	80	80	1.0000000
NODE_21022_length_641_cov_11.125461	38	118	0	80	80	1.0000000
NODE_21022_length_641_cov_11.125461	91	171	0	80	80	1.0000000
NODE_21025_length_641_cov_7.719557	84	138	6	18	54	0.3333333
NODE_21025_length_641_cov_7.719557	84	138	7	36	54	0.6666667
NODE_21025_length_641_cov_7.719557	113	193	3	4	80	0.0500000
NODE_21025_length_641_cov_7.719557	113	193	4	7	80	0.0875000
NODE_21025_length_641_cov_7.719557	113	193	5	40	80	0.5000000
NODE_21025_length_641_cov_7.719557	113	193	7	29	80	0.3625000
NODE_21026_length_641_cov_7.675277	232	312	2	4	80	0.0500000
NODE_21026_length_641_cov_7.675277	232	312	3	53	80	0.6625000
NODE_21026_length_641_cov_7.675277	232	312	4	23	80	0.2875000
NODE_21026_length_641_cov_7.675277	285	365	1	13	80	0.1625000
NODE_21026_length_641_cov_7.675277	285	365	2	44	80	0.5500000
NODE_21026_length_641_cov_7.675277	285	365	3	23	80	0.2875000
NODE_21027_length_641_cov_7.675277	255	335	0	3	80	0.0375000
NODE_21027_length_641_cov_7.675277	255	335	2	77	80	0.9625000
NODE_21027_length_641_cov_7.675277	308	388	0	15	80	0.1875000
NODE_21027_length_641_cov_7.675277	308	388	2	65	80	0.8125000
NODE_21028_length_641_cov_7.627306	262	342	1	80	80	1.0000000
NODE_21028_length_641_cov_7.627306	315	395	0	15	80	0.1875000
NODE_21028_length_641_cov_7.627306	315	395	1	65	80	0.8125000
NODE_21029_length_641_cov_7.282288	247	300	0	53	53	1.0000000
NODE_21031_length_641_cov_5.029520	138	218	0	22	80	0.2750000
NODE_21031_length_641_cov_5.029520	138	218	2	3	80	0.0375000
NODE_21031_length_641_cov_5.029520	138	218	4	36	80	0.4500000
NODE_21031_length_641_cov_5.029520	138	218	6	19	80	0.2375000
NODE_21031_length_641_cov_5.029520	191	271	4	8	80	0.1000000
NODE_21031_length_641_cov_5.029520	191	271	6	72	80	0.9000000
NODE_21034_length_641_cov_4.701107	238	282	3	44	44	1.0000000
NODE_21109_length_640_cov_39.676525	524	597	40	1	73	0.0136986
NODE_21109_length_640_cov_39.676525	524	597	42	3	73	0.0410959
NODE_21109_length_640_cov_39.676525	524	597	43	2	73	0.0273973
NODE_21109_length_640_cov_39.676525	524	597	44	1	73	0.0136986
NODE_21109_length_640_cov_39.676525	524	597	45	1	73	0.0136986
NODE_21109_length_640_cov_39.676525	524	597	46	1	73	0.0136986
NODE_21109_length_640_cov_39.676525	524	597	47	3	73	0.0410959
NODE_21109_length_640_cov_39.676525	524	597	48	3	73	0.0410959
NODE_21109_length_640_cov_39.676525	524	597	49	1	73	0.0136986
NODE_21109_length_640_cov_39.676525	524	597	50	3	73	0.0410959
NODE_21109_length_640_cov_39.676525	524	597	51	3	73	0.0410959
NODE_21109_length_640_cov_39.676525	524	597	52	3	73	0.0410959
NODE_21109_length_640_cov_39.676525	524	597	53	2	73	0.0273973
NODE_21109_length_640_cov_39.676525	524	597	55	2	73	0.0273973
NODE_21109_length_640_cov_39.676525	524	597	56	2	73	0.0273973
NODE_21109_length_640_cov_39.676525	524	597	57	1	73	0.0136986
NODE_21109_length_640_cov_39.676525	524	597	59	6	73	0.0821918
NODE_21109_length_640_cov_39.676525	524	597	61	6	73	0.0821918
NODE_21109_length_640_cov_39.676525	524	597	62	4	73	0.0547945
NODE_21109_length_640_cov_39.676525	524	597	63	2	73	0.0273973
NODE_21109_length_640_cov_39.676525	524	597	64	3	73	0.0410959
NODE_21109_length_640_cov_39.676525	524	597	65	3	73	0.0410959
NODE_21109_length_640_cov_39.676525	524	597	66	1	73	0.0136986
NODE_21109_length_640_cov_39.676525	524	597	67	2	73	0.0273973
NODE_21109_length_640_cov_39.676525	524	597	70	9	73	0.1232877
NODE_21109_length_640_cov_39.676525	524	597	71	3	73	0.0410959
NODE_21109_length_640_cov_39.676525	524	597	72	2	73	0.0273973
NODE_21109_length_640_cov_39.676525	564	605	35	8	41	0.1951219
NODE_21109_length_640_cov_39.676525	564	605	40	1	41	0.0243902
NODE_21109_length_640_cov_39.676525	564	605	42	3	41	0.0731707
NODE_21109_length_640_cov_39.676525	564	605	43	2	41	0.0487805
NODE_21109_length_640_cov_39.676525	564	605	44	1	41	0.0243902
NODE_21109_length_640_cov_39.676525	564	605	45	1	41	0.0243902
NODE_21109_length_640_cov_39.676525	564	605	46	1	41	0.0243902
NODE_21109_length_640_cov_39.676525	564	605	47	3	41	0.0731707
NODE_21109_length_640_cov_39.676525	564	605	48	3	41	0.0731707
NODE_21109_length_640_cov_39.676525	564	605	49	1	41	0.0243902
NODE_21109_length_640_cov_39.676525	564	605	50	3	41	0.0731707
NODE_21109_length_640_cov_39.676525	564	605	51	3	41	0.0731707
NODE_21109_length_640_cov_39.676525	564	605	52	3	41	0.0731707
NODE_21109_length_640_cov_39.676525	564	605	53	2	41	0.0487805
NODE_21109_length_640_cov_39.676525	564	605	55	2	41	0.0487805
NODE_21109_length_640_cov_39.676525	564	605	56	2	41	0.0487805
NODE_21109_length_640_cov_39.676525	564	605	57	1	41	0.0243902
NODE_21109_length_640_cov_39.676525	564	605	59	1	41	0.0243902
NODE_21110_length_640_cov_19.578558	273	353	0	80	80	1.0000000
NODE_21110_length_640_cov_19.578558	326	406	0	80	80	1.0000000
NODE_21111_length_640_cov_15.717190	178	258	0	80	80	1.0000000
NODE_21111_length_640_cov_15.717190	231	311	0	80	80	1.0000000
NODE_21112_length_640_cov_15.338262	319	399	0	80	80	1.0000000
NODE_21112_length_640_cov_15.338262	372	452	0	80	80	1.0000000
NODE_21113_length_640_cov_9.523105	20	43	0	23	23	1.0000000
NODE_21118_length_640_cov_5.123845	272	335	0	9	63	0.1428571
NODE_21118_length_640_cov_5.123845	272	335	1	54	63	0.8571429
NODE_21121_length_640_cov_4.410351	254	334	0	80	80	1.0000000
NODE_21121_length_640_cov_4.410351	307	387	0	80	80	1.0000000
NODE_21129_length_640_cov_3.406654	244	324	2	29	80	0.3625000
NODE_21129_length_640_cov_3.406654	244	324	3	51	80	0.6375000
NODE_21140_length_640_cov_2.316081	21	57	0	36	36	1.0000000
NODE_21190_length_639_cov_58.092593	302	377	11	5	75	0.0666667
NODE_21190_length_639_cov_58.092593	302	377	12	1	75	0.0133333
NODE_21190_length_639_cov_58.092593	302	377	13	8	75	0.1066667
NODE_21190_length_639_cov_58.092593	302	377	15	10	75	0.1333333
NODE_21190_length_639_cov_58.092593	302	377	16	21	75	0.2800000
NODE_21190_length_639_cov_58.092593	302	377	17	6	75	0.0800000
NODE_21190_length_639_cov_58.092593	302	377	18	16	75	0.2133333
NODE_21190_length_639_cov_58.092593	302	377	20	4	75	0.0533333
NODE_21190_length_639_cov_58.092593	302	377	21	4	75	0.0533333
NODE_21190_length_639_cov_58.092593	350	430	9	7	80	0.0875000
NODE_21190_length_639_cov_58.092593	350	430	10	20	80	0.2500000
NODE_21190_length_639_cov_58.092593	350	430	12	7	80	0.0875000
NODE_21190_length_639_cov_58.092593	350	430	13	3	80	0.0375000
NODE_21190_length_639_cov_58.092593	350	430	15	1	80	0.0125000
NODE_21190_length_639_cov_58.092593	350	430	17	14	80	0.1750000
NODE_21190_length_639_cov_58.092593	350	430	18	20	80	0.2500000
NODE_21190_length_639_cov_58.092593	350	430	20	4	80	0.0500000
NODE_21190_length_639_cov_58.092593	350	430	21	4	80	0.0500000
NODE_21191_length_639_cov_32.951852	213	293	0	80	80	1.0000000
NODE_21191_length_639_cov_32.951852	266	346	0	80	80	1.0000000
NODE_21192_length_639_cov_24.564815	290	370	0	8	80	0.1000000
NODE_21192_length_639_cov_24.564815	290	370	2	72	80	0.9000000
NODE_21192_length_639_cov_24.564815	343	423	0	3	80	0.0375000
NODE_21192_length_639_cov_24.564815	343	423	2	77	80	0.9625000
NODE_21193_length_639_cov_14.448148	288	368	0	80	80	1.0000000
NODE_21193_length_639_cov_14.448148	341	421	0	80	80	1.0000000
NODE_21195_length_639_cov_9.001852	265	345	0	13	80	0.1625000
NODE_21195_length_639_cov_9.001852	265	345	1	2	80	0.0250000
NODE_21195_length_639_cov_9.001852	265	345	2	65	80	0.8125000
NODE_21195_length_639_cov_9.001852	318	398	0	66	80	0.8250000
NODE_21195_length_639_cov_9.001852	318	398	1	2	80	0.0250000
NODE_21195_length_639_cov_9.001852	318	398	2	12	80	0.1500000
NODE_21197_length_639_cov_8.444444	161	241	3	80	80	1.0000000
NODE_21197_length_639_cov_8.444444	214	294	1	5	80	0.0625000
NODE_21197_length_639_cov_8.444444	214	294	2	35	80	0.4375000
NODE_21197_length_639_cov_8.444444	214	294	3	40	80	0.5000000
NODE_21202_length_639_cov_6.283333	157	176	0	19	19	1.0000000
NODE_21207_length_639_cov_4.188889	258	335	0	77	77	1.0000000
NODE_21207_length_639_cov_4.188889	308	354	0	46	46	1.0000000
NODE_21213_length_639_cov_3.448148	126	206	2	80	80	1.0000000
NODE_21213_length_639_cov_3.448148	179	259	0	22	80	0.2750000
NODE_21213_length_639_cov_3.448148	179	259	1	25	80	0.3125000
NODE_21213_length_639_cov_3.448148	179	259	2	33	80	0.4125000
NODE_21223_length_639_cov_2.683333	256	288	0	32	32	1.0000000
NODE_21224_length_639_cov_2.555556	189	240	6	8	51	0.1568628
NODE_21224_length_639_cov_2.555556	189	240	8	4	51	0.0784314
NODE_21224_length_639_cov_2.555556	189	240	9	37	51	0.7254902
NODE_21224_length_639_cov_2.555556	189	240	11	2	51	0.0392157
NODE_21225_length_639_cov_2.477778	562	635	0	70	73	0.9589041
NODE_21225_length_639_cov_2.477778	562	635	1	3	73	0.0410959
NODE_21265_length_639_cov_1.179630	542	564	0	22	22	1.0000000
NODE_21269_length_639_cov_1.051852	404	455	0	51	51	1.0000000
NODE_21278_length_638_cov_13.018553	273	353	0	80	80	1.0000000
NODE_21278_length_638_cov_13.018553	326	406	0	48	80	0.6000000
NODE_21278_length_638_cov_13.018553	326	406	1	14	80	0.1750000
NODE_21278_length_638_cov_13.018553	326	406	2	18	80	0.2250000
NODE_21279_length_638_cov_12.656772	343	423	0	80	80	1.0000000
NODE_21279_length_638_cov_12.656772	396	476	0	80	80	1.0000000
NODE_21280_length_638_cov_11.877551	298	378	0	58	80	0.7250000
NODE_21280_length_638_cov_11.877551	298	378	1	22	80	0.2750000
NODE_21280_length_638_cov_11.877551	351	431	0	80	80	1.0000000
NODE_21281_length_638_cov_8.779221	330	408	0	78	78	1.0000000
NODE_21281_length_638_cov_8.779221	383	461	0	78	78	1.0000000
NODE_21284_length_638_cov_5.543599	315	395	4	57	80	0.7125000
NODE_21284_length_638_cov_5.543599	315	395	6	5	80	0.0625000
NODE_21284_length_638_cov_5.543599	315	395	7	18	80	0.2250000
NODE_21290_length_638_cov_3.966605	307	387	0	54	80	0.6750000
NODE_21290_length_638_cov_3.966605	307	387	2	26	80	0.3250000
NODE_21301_length_638_cov_2.786642	157	208	2	10	51	0.1960784
NODE_21301_length_638_cov_2.786642	157	208	3	6	51	0.1176471
NODE_21301_length_638_cov_2.786642	157	208	4	1	51	0.0196078
NODE_21301_length_638_cov_2.786642	157	208	5	7	51	0.1372549
NODE_21301_length_638_cov_2.786642	157	208	6	27	51	0.5294118
NODE_21301_length_638_cov_2.786642	181	261	0	7	80	0.0875000
NODE_21301_length_638_cov_2.786642	181	261	1	23	80	0.2875000
NODE_21301_length_638_cov_2.786642	181	261	2	33	80	0.4125000
NODE_21301_length_638_cov_2.786642	181	261	3	6	80	0.0750000
NODE_21301_length_638_cov_2.786642	181	261	4	1	80	0.0125000
NODE_21301_length_638_cov_2.786642	181	261	5	7	80	0.0875000
NODE_21301_length_638_cov_2.786642	181	261	6	3	80	0.0375000
NODE_21364_length_637_cov_67.157993	285	365	1	64	80	0.8000000
NODE_21364_length_637_cov_67.157993	285	365	2	16	80	0.2000000
NODE_21364_length_637_cov_67.157993	338	418	1	56	80	0.7000000
NODE_21364_length_637_cov_67.157993	338	418	2	24	80	0.3000000
NODE_21364_length_637_cov_67.157993	414	494	2	13	80	0.1625000
NODE_21364_length_637_cov_67.157993	414	494	4	5	80	0.0625000
NODE_21364_length_637_cov_67.157993	414	494	5	39	80	0.4875000
NODE_21364_length_637_cov_67.157993	414	494	6	23	80	0.2875000
NODE_21364_length_637_cov_67.157993	467	547	3	3	80	0.0375000
NODE_21364_length_637_cov_67.157993	467	547	4	11	80	0.1375000
NODE_21364_length_637_cov_67.157993	467	547	5	1	80	0.0125000
NODE_21364_length_637_cov_67.157993	467	547	6	65	80	0.8125000
NODE_21365_length_637_cov_63.029740	195	275	2	12	80	0.1500000
NODE_21365_length_637_cov_63.029740	195	275	3	68	80	0.8500000
NODE_21365_length_637_cov_63.029740	248	328	0	39	80	0.4875000
NODE_21365_length_637_cov_63.029740	248	328	2	26	80	0.3250000
NODE_21365_length_637_cov_63.029740	248	328	3	15	80	0.1875000
NODE_21366_length_637_cov_44.923792	53	133	2	31	80	0.3875000
NODE_21366_length_637_cov_44.923792	53	133	3	8	80	0.1000000
NODE_21366_length_637_cov_44.923792	53	133	5	41	80	0.5125000
NODE_21366_length_637_cov_44.923792	54	133	2	30	79	0.3797468
NODE_21366_length_637_cov_44.923792	54	133	3	8	79	0.1012658
NODE_21366_length_637_cov_44.923792	54	133	5	41	79	0.5189874
NODE_21366_length_637_cov_44.923792	106	186	5	54	80	0.6750000
NODE_21366_length_637_cov_44.923792	106	186	6	1	80	0.0125000
NODE_21366_length_637_cov_44.923792	106	186	7	7	80	0.0875000
NODE_21366_length_637_cov_44.923792	106	186	8	7	80	0.0875000
NODE_21366_length_637_cov_44.923792	106	186	9	11	80	0.1375000
NODE_21366_length_637_cov_44.923792	106	186	5	54	80	0.6750000
NODE_21366_length_637_cov_44.923792	106	186	6	1	80	0.0125000
NODE_21366_length_637_cov_44.923792	106	186	7	7	80	0.0875000
NODE_21366_length_637_cov_44.923792	106	186	8	7	80	0.0875000
NODE_21366_length_637_cov_44.923792	106	186	9	11	80	0.1375000
NODE_21366_length_637_cov_44.923792	182	262	9	41	80	0.5125000
NODE_21366_length_637_cov_44.923792	182	262	10	15	80	0.1875000
NODE_21366_length_637_cov_44.923792	182	262	11	24	80	0.3000000
NODE_21366_length_637_cov_44.923792	235	315	6	7	80	0.0875000
NODE_21366_length_637_cov_44.923792	235	315	7	1	80	0.0125000
NODE_21366_length_637_cov_44.923792	235	315	8	42	80	0.5250000
NODE_21366_length_637_cov_44.923792	235	315	9	23	80	0.2875000
NODE_21366_length_637_cov_44.923792	235	315	10	7	80	0.0875000
NODE_21367_length_637_cov_44.193309	193	273	0	25	80	0.3125000
NODE_21367_length_637_cov_44.193309	193	273	2	55	80	0.6875000
NODE_21367_length_637_cov_44.193309	246	326	2	80	80	1.0000000
NODE_21368_length_637_cov_37.855019	215	295	2	80	80	1.0000000
NODE_21368_length_637_cov_37.855019	268	347	2	79	79	1.0000000
NODE_21369_length_637_cov_33.957249	332	412	2	8	80	0.1000000
NODE_21369_length_637_cov_33.957249	332	412	4	72	80	0.9000000
NODE_21369_length_637_cov_33.957249	385	465	0	39	80	0.4875000
NODE_21369_length_637_cov_33.957249	385	465	2	22	80	0.2750000
NODE_21369_length_637_cov_33.957249	385	465	4	19	80	0.2375000
NODE_21370_length_637_cov_23.682156	275	355	5	6	80	0.0750000
NODE_21370_length_637_cov_23.682156	275	355	7	3	80	0.0375000
NODE_21370_length_637_cov_23.682156	275	355	8	13	80	0.1625000
NODE_21370_length_637_cov_23.682156	275	355	9	3	80	0.0375000
NODE_21370_length_637_cov_23.682156	275	355	10	9	80	0.1125000
NODE_21370_length_637_cov_23.682156	275	355	11	26	80	0.3250000
NODE_21370_length_637_cov_23.682156	275	355	12	20	80	0.2500000
NODE_21370_length_637_cov_23.682156	328	408	2	16	80	0.2000000
NODE_21370_length_637_cov_23.682156	328	408	3	7	80	0.0875000
NODE_21370_length_637_cov_23.682156	328	408	4	13	80	0.1625000
NODE_21370_length_637_cov_23.682156	328	408	5	23	80	0.2875000
NODE_21370_length_637_cov_23.682156	328	408	7	3	80	0.0375000
NODE_21370_length_637_cov_23.682156	328	408	8	13	80	0.1625000
NODE_21370_length_637_cov_23.682156	328	408	9	3	80	0.0375000
NODE_21370_length_637_cov_23.682156	328	408	10	2	80	0.0250000
NODE_21371_length_637_cov_19.676580	267	347	0	21	80	0.2625000
NODE_21371_length_637_cov_19.676580	267	347	1	59	80	0.7375000
NODE_21371_length_637_cov_19.676580	320	400	1	63	80	0.7875000
NODE_21371_length_637_cov_19.676580	320	400	2	17	80	0.2125000
NODE_21373_length_637_cov_9.182156	226	276	0	50	50	1.0000000
NODE_21373_length_637_cov_9.182156	312	357	0	45	45	1.0000000
NODE_21374_length_637_cov_9.078067	276	357	1	24	81	0.2962963
NODE_21374_length_637_cov_9.078067	276	357	2	14	81	0.1728395
NODE_21374_length_637_cov_9.078067	276	357	3	1	81	0.0123457
NODE_21374_length_637_cov_9.078067	276	357	5	4	81	0.0493827
NODE_21374_length_637_cov_9.078067	276	357	6	14	81	0.1728395
NODE_21374_length_637_cov_9.078067	276	357	7	13	81	0.1604938
NODE_21374_length_637_cov_9.078067	276	357	9	8	81	0.0987654
NODE_21374_length_637_cov_9.078067	276	357	10	3	81	0.0370370
NODE_21374_length_637_cov_9.078067	330	410	1	14	80	0.1750000
NODE_21374_length_637_cov_9.078067	330	410	2	66	80	0.8250000
NODE_21375_length_637_cov_8.566914	235	315	0	24	80	0.3000000
NODE_21375_length_637_cov_8.566914	235	315	1	32	80	0.4000000
NODE_21375_length_637_cov_8.566914	235	315	2	24	80	0.3000000
NODE_21375_length_637_cov_8.566914	288	368	1	3	80	0.0375000
NODE_21375_length_637_cov_8.566914	288	368	2	24	80	0.3000000
NODE_21375_length_637_cov_8.566914	288	368	3	15	80	0.1875000
NODE_21375_length_637_cov_8.566914	288	368	4	38	80	0.4750000
NODE_21378_length_637_cov_6.652416	337	415	2	78	78	1.0000000
NODE_21378_length_637_cov_6.652416	390	472	1	57	82	0.6951219
NODE_21378_length_637_cov_6.652416	390	472	2	25	82	0.3048781
NODE_21385_length_637_cov_4.522305	284	364	1	80	80	1.0000000
NODE_21385_length_637_cov_4.522305	337	417	1	80	80	1.0000000
NODE_21389_length_637_cov_4.131970	292	370	0	78	78	1.0000000
NODE_21389_length_637_cov_4.131970	343	423	0	80	80	1.0000000
NODE_21457_length_636_cov_19.938547	214	294	0	80	80	1.0000000
NODE_21457_length_636_cov_19.938547	267	347	0	80	80	1.0000000
NODE_21458_length_636_cov_12.283054	295	375	0	80	80	1.0000000
NODE_21458_length_636_cov_12.283054	348	428	0	80	80	1.0000000
NODE_21460_length_636_cov_8.312849	346	413	0	67	67	1.0000000
NODE_21460_length_636_cov_8.312849	399	479	0	80	80	1.0000000
NODE_21467_length_636_cov_4.324022	185	251	2	5	66	0.0757576
NODE_21467_length_636_cov_4.324022	185	251	3	42	66	0.6363636
NODE_21467_length_636_cov_4.324022	185	251	4	19	66	0.2878788
NODE_21467_length_636_cov_4.324022	224	266	2	5	42	0.1190476
NODE_21467_length_636_cov_4.324022	224	266	3	3	42	0.0714286
NODE_21467_length_636_cov_4.324022	224	266	4	34	42	0.8095238
NODE_21467_length_636_cov_4.324022	224	264	2	5	40	0.1250000
NODE_21467_length_636_cov_4.324022	224	264	3	3	40	0.0750000
NODE_21467_length_636_cov_4.324022	224	264	4	32	40	0.8000000
NODE_21539_length_635_cov_45.483209	195	239	54	1	44	0.0227273
NODE_21539_length_635_cov_45.483209	195	239	55	2	44	0.0454545
NODE_21539_length_635_cov_45.483209	195	239	56	1	44	0.0227273
NODE_21539_length_635_cov_45.483209	195	239	57	1	44	0.0227273
NODE_21539_length_635_cov_45.483209	195	239	58	3	44	0.0681818
NODE_21539_length_635_cov_45.483209	195	239	62	1	44	0.0227273
NODE_21539_length_635_cov_45.483209	195	239	64	12	44	0.2727273
NODE_21539_length_635_cov_45.483209	195	239	65	5	44	0.1136364
NODE_21539_length_635_cov_45.483209	195	239	66	3	44	0.0681818
NODE_21539_length_635_cov_45.483209	195	239	67	10	44	0.2272727
NODE_21539_length_635_cov_45.483209	195	239	68	5	44	0.1136364
NODE_21539_length_635_cov_45.483209	225	268	45	3	43	0.0697674
NODE_21539_length_635_cov_45.483209	225	268	46	2	43	0.0465116
NODE_21539_length_635_cov_45.483209	225	268	47	2	43	0.0465116
NODE_21539_length_635_cov_45.483209	225	268	48	1	43	0.0232558
NODE_21539_length_635_cov_45.483209	225	268	49	4	43	0.0930233
NODE_21539_length_635_cov_45.483209	225	268	50	2	43	0.0465116
NODE_21539_length_635_cov_45.483209	225	268	51	1	43	0.0232558
NODE_21539_length_635_cov_45.483209	225	268	52	4	43	0.0930233
NODE_21539_length_635_cov_45.483209	225	268	53	2	43	0.0465116
NODE_21539_length_635_cov_45.483209	225	268	54	7	43	0.1627907
NODE_21539_length_635_cov_45.483209	225	268	55	3	43	0.0697674
NODE_21539_length_635_cov_45.483209	225	268	56	2	43	0.0465116
NODE_21539_length_635_cov_45.483209	225	268	57	1	43	0.0232558
NODE_21539_length_635_cov_45.483209	225	268	58	3	43	0.0697674
NODE_21539_length_635_cov_45.483209	225	268	62	1	43	0.0232558
NODE_21539_length_635_cov_45.483209	225	268	64	5	43	0.1162791
NODE_21539_length_635_cov_45.483209	248	298	34	1	50	0.0200000
NODE_21539_length_635_cov_45.483209	248	298	36	1	50	0.0200000
NODE_21539_length_635_cov_45.483209	248	298	37	3	50	0.0600000
NODE_21539_length_635_cov_45.483209	248	298	39	1	50	0.0200000
NODE_21539_length_635_cov_45.483209	248	298	40	4	50	0.0800000
NODE_21539_length_635_cov_45.483209	248	298	41	1	50	0.0200000
NODE_21539_length_635_cov_45.483209	248	298	45	4	50	0.0800000
NODE_21539_length_635_cov_45.483209	248	298	46	4	50	0.0800000
NODE_21539_length_635_cov_45.483209	248	298	47	6	50	0.1200000
NODE_21539_length_635_cov_45.483209	248	298	48	1	50	0.0200000
NODE_21539_length_635_cov_45.483209	248	298	49	6	50	0.1200000
NODE_21539_length_635_cov_45.483209	248	298	50	2	50	0.0400000
NODE_21539_length_635_cov_45.483209	248	298	51	6	50	0.1200000
NODE_21539_length_635_cov_45.483209	248	298	52	6	50	0.1200000
NODE_21539_length_635_cov_45.483209	248	298	53	4	50	0.0800000
NODE_21541_length_635_cov_23.895522	179	259	2	80	80	1.0000000
NODE_21541_length_635_cov_23.895522	232	312	0	9	80	0.1125000
NODE_21541_length_635_cov_23.895522	232	312	2	71	80	0.8875000
NODE_21543_length_635_cov_14.772388	48	128	0	80	80	1.0000000
NODE_21543_length_635_cov_14.772388	101	181	0	80	80	1.0000000
NODE_21549_length_635_cov_6.180970	276	356	0	80	80	1.0000000
NODE_21549_length_635_cov_6.180970	329	409	0	80	80	1.0000000
NODE_21554_length_635_cov_4.421642	442	522	2	49	80	0.6125000
NODE_21554_length_635_cov_4.421642	442	522	3	31	80	0.3875000
NODE_21560_length_635_cov_2.985075	296	376	2	19	80	0.2375000
NODE_21560_length_635_cov_2.985075	296	376	4	16	80	0.2000000
NODE_21560_length_635_cov_2.985075	296	376	5	45	80	0.5625000
NODE_21625_length_634_cov_53.315888	349	429	0	26	80	0.3250000
NODE_21625_length_634_cov_53.315888	349	429	2	54	80	0.6750000
NODE_21625_length_634_cov_53.315888	402	482	0	79	80	0.9875000
NODE_21625_length_634_cov_53.315888	402	482	2	1	80	0.0125000
NODE_21626_length_634_cov_28.530841	156	236	1	22	80	0.2750000
NODE_21626_length_634_cov_28.530841	156	236	2	26	80	0.3250000
NODE_21626_length_634_cov_28.530841	156	236	3	32	80	0.4000000
NODE_21626_length_634_cov_28.530841	209	289	2	69	80	0.8625000
NODE_21626_length_634_cov_28.530841	209	289	3	11	80	0.1375000
NODE_21627_length_634_cov_19.117757	151	229	0	78	78	1.0000000
NODE_21627_length_634_cov_19.117757	204	268	0	62	64	0.9687500
NODE_21627_length_634_cov_19.117757	204	268	2	2	64	0.0312500
NODE_21628_length_634_cov_18.762617	84	164	0	80	80	1.0000000
NODE_21628_length_634_cov_18.762617	137	217	0	80	80	1.0000000
NODE_21629_length_634_cov_18.136449	162	242	0	80	80	1.0000000
NODE_21629_length_634_cov_18.136449	215	295	0	80	80	1.0000000
NODE_21635_length_634_cov_9.988785	508	553	0	45	45	1.0000000
NODE_21636_length_634_cov_9.381308	267	353	2	38	86	0.4418605
NODE_21636_length_634_cov_9.381308	267	353	3	48	86	0.5581396
NODE_21636_length_634_cov_9.381308	324	404	2	24	80	0.3000000
NODE_21636_length_634_cov_9.381308	324	404	3	56	80	0.7000000
NODE_21651_length_634_cov_3.702804	460	532	0	72	72	1.0000000
NODE_21720_length_633_cov_30.076779	180	214	0	2	34	0.0588235
NODE_21720_length_633_cov_30.076779	180	214	1	32	34	0.9411765
NODE_21720_length_633_cov_30.076779	187	267	1	80	80	1.0000000
NODE_21720_length_633_cov_30.076779	263	343	0	11	80	0.1375000
NODE_21720_length_633_cov_30.076779	263	343	1	69	80	0.8625000
NODE_21720_length_633_cov_30.076779	316	396	0	13	80	0.1625000
NODE_21720_length_633_cov_30.076779	316	396	1	16	80	0.2000000
NODE_21720_length_633_cov_30.076779	316	396	2	51	80	0.6375000
NODE_21721_length_633_cov_17.595506	282	362	2	80	80	1.0000000
NODE_21721_length_633_cov_17.595506	335	415	0	18	80	0.2250000
NODE_21721_length_633_cov_17.595506	335	415	2	62	80	0.7750000
NODE_21722_length_633_cov_17.327715	228	308	1	61	80	0.7625000
NODE_21722_length_633_cov_17.327715	228	308	2	19	80	0.2375000
NODE_21722_length_633_cov_17.327715	281	361	1	9	80	0.1125000
NODE_21722_length_633_cov_17.327715	281	361	2	63	80	0.7875000
NODE_21722_length_633_cov_17.327715	281	361	3	8	80	0.1000000
NODE_21723_length_633_cov_9.689139	79	147	2	68	68	1.0000000
NODE_21729_length_633_cov_7.018727	309	389	0	2	80	0.0250000
NODE_21729_length_633_cov_7.018727	309	389	1	27	80	0.3375000
NODE_21729_length_633_cov_7.018727	309	389	2	51	80	0.6375000
NODE_21729_length_633_cov_7.018727	362	442	0	55	80	0.6875000
NODE_21729_length_633_cov_7.018727	362	442	1	25	80	0.3125000
NODE_21755_length_633_cov_2.644195	166	240	0	74	74	1.0000000
NODE_21816_length_632_cov_25.425891	332	412	0	80	80	1.0000000
NODE_21816_length_632_cov_25.425891	385	465	0	80	80	1.0000000
NODE_21817_length_632_cov_21.613508	243	323	0	80	80	1.0000000
NODE_21817_length_632_cov_21.613508	296	376	0	80	80	1.0000000
NODE_21818_length_632_cov_16.465291	293	373	0	80	80	1.0000000
NODE_21818_length_632_cov_16.465291	346	426	0	80	80	1.0000000
NODE_21819_length_632_cov_13.260788	232	312	1	5	80	0.0625000
NODE_21819_length_632_cov_13.260788	232	312	2	6	80	0.0750000
NODE_21819_length_632_cov_13.260788	232	312	4	16	80	0.2000000
NODE_21819_length_632_cov_13.260788	232	312	5	53	80	0.6625000
NODE_21819_length_632_cov_13.260788	285	365	4	24	80	0.3000000
NODE_21819_length_632_cov_13.260788	285	365	5	56	80	0.7000000
NODE_21821_length_632_cov_9.106942	188	268	0	17	80	0.2125000
NODE_21821_length_632_cov_9.106942	188	268	2	32	80	0.4000000
NODE_21821_length_632_cov_9.106942	188	268	3	31	80	0.3875000
NODE_21821_length_632_cov_9.106942	241	321	2	4	80	0.0500000
NODE_21821_length_632_cov_9.106942	241	321	3	65	80	0.8125000
NODE_21821_length_632_cov_9.106942	241	321	4	11	80	0.1375000
NODE_21834_length_632_cov_4.135084	229	309	1	80	80	1.0000000
NODE_21834_length_632_cov_4.135084	282	359	0	9	77	0.1168831
NODE_21834_length_632_cov_4.135084	282	359	1	68	77	0.8831169
NODE_21841_length_632_cov_2.939962	216	274	0	58	58	1.0000000
NODE_21841_length_632_cov_2.939962	247	327	0	31	80	0.3875000
NODE_21841_length_632_cov_2.939962	247	327	2	4	80	0.0500000
NODE_21841_length_632_cov_2.939962	247	327	4	45	80	0.5625000
NODE_21848_length_632_cov_2.330206	57	76	0	19	19	1.0000000
NODE_21912_length_631_cov_31.469925	321	396	2	75	75	1.0000000
NODE_21912_length_631_cov_31.469925	369	449	1	1	80	0.0125000
NODE_21912_length_631_cov_31.469925	369	449	2	79	80	0.9875000
NODE_21913_length_631_cov_26.453008	383	463	0	80	80	1.0000000
NODE_21913_length_631_cov_26.453008	436	516	0	80	80	1.0000000
NODE_21917_length_631_cov_8.374060	318	398	0	80	80	1.0000000
NODE_21917_length_631_cov_8.374060	371	451	0	80	80	1.0000000
NODE_21924_length_631_cov_5.507519	335	386	0	5	51	0.0980392
NODE_21924_length_631_cov_5.507519	335	386	1	36	51	0.7058824
NODE_21924_length_631_cov_5.507519	335	386	3	2	51	0.0392157
NODE_21924_length_631_cov_5.507519	335	386	4	7	51	0.1372549
NODE_21924_length_631_cov_5.507519	335	386	6	1	51	0.0196078
NODE_21927_length_631_cov_5.227444	443	523	0	80	80	1.0000000
NODE_21927_length_631_cov_5.227444	496	576	0	80	80	1.0000000
NODE_21942_length_631_cov_2.926692	307	354	3	27	47	0.5744681
NODE_21942_length_631_cov_2.926692	307	354	4	13	47	0.2765957
NODE_21942_length_631_cov_2.926692	307	354	8	7	47	0.1489362
NODE_21983_length_631_cov_1.383459	248	267	2	19	19	1.0000000
NODE_22011_length_630_cov_41.728814	6	86	0	4	80	0.0500000
NODE_22011_length_630_cov_41.728814	6	86	1	49	80	0.6125000
NODE_22011_length_630_cov_41.728814	6	86	3	10	80	0.1250000
NODE_22011_length_630_cov_41.728814	6	86	5	1	80	0.0125000
NODE_22011_length_630_cov_41.728814	6	86	8	16	80	0.2000000
NODE_22011_length_630_cov_41.728814	59	139	3	10	80	0.1250000
NODE_22011_length_630_cov_41.728814	59	139	5	1	80	0.0125000
NODE_22011_length_630_cov_41.728814	59	139	8	34	80	0.4250000
NODE_22011_length_630_cov_41.728814	59	139	9	6	80	0.0750000
NODE_22011_length_630_cov_41.728814	59	139	10	4	80	0.0500000
NODE_22011_length_630_cov_41.728814	59	139	12	25	80	0.3125000
NODE_22012_length_630_cov_24.856874	421	501	0	80	80	1.0000000
NODE_22012_length_630_cov_24.856874	474	554	0	80	80	1.0000000
NODE_22013_length_630_cov_14.323917	196	276	0	80	80	1.0000000
NODE_22013_length_630_cov_14.323917	249	329	0	80	80	1.0000000
NODE_22014_length_630_cov_9.964218	284	364	0	80	80	1.0000000
NODE_22014_length_630_cov_9.964218	337	417	0	80	80	1.0000000
NODE_22086_length_629_cov_38.271698	288	368	0	80	80	1.0000000
NODE_22086_length_629_cov_38.271698	341	421	0	80	80	1.0000000
NODE_22087_length_629_cov_27.556604	212	292	1	41	80	0.5125000
NODE_22087_length_629_cov_27.556604	212	292	2	34	80	0.4250000
NODE_22087_length_629_cov_27.556604	212	292	4	5	80	0.0625000
NODE_22087_length_629_cov_27.556604	265	345	2	22	80	0.2750000
NODE_22087_length_629_cov_27.556604	265	345	4	58	80	0.7250000
NODE_22088_length_629_cov_24.150943	356	436	4	18	80	0.2250000
NODE_22088_length_629_cov_24.150943	356	436	5	62	80	0.7750000
NODE_22088_length_629_cov_24.150943	409	489	2	4	80	0.0500000
NODE_22088_length_629_cov_24.150943	409	489	4	28	80	0.3500000
NODE_22088_length_629_cov_24.150943	409	489	5	48	80	0.6000000
NODE_22091_length_629_cov_13.641509	176	256	2	80	80	1.0000000
NODE_22091_length_629_cov_13.641509	229	309	1	47	80	0.5875000
NODE_22091_length_629_cov_13.641509	229	309	2	33	80	0.4125000
NODE_22101_length_629_cov_4.264151	362	442	0	12	80	0.1500000
NODE_22101_length_629_cov_4.264151	362	442	1	66	80	0.8250000
NODE_22101_length_629_cov_4.264151	362	442	2	2	80	0.0250000
NODE_22188_length_628_cov_5.015123	210	274	2	25	64	0.3906250
NODE_22188_length_628_cov_5.015123	210	274	3	39	64	0.6093750
NODE_22257_length_627_cov_24.500000	217	297	0	70	80	0.8750000
NODE_22257_length_627_cov_24.500000	217	297	2	10	80	0.1250000
NODE_22257_length_627_cov_24.500000	270	350	0	17	80	0.2125000
NODE_22257_length_627_cov_24.500000	270	350	2	63	80	0.7875000
NODE_22258_length_627_cov_20.395833	84	164	1	4	80	0.0500000
NODE_22258_length_627_cov_20.395833	84	164	2	14	80	0.1750000
NODE_22258_length_627_cov_20.395833	84	164	3	50	80	0.6250000
NODE_22258_length_627_cov_20.395833	84	164	4	12	80	0.1500000
NODE_22258_length_627_cov_20.395833	137	217	3	19	80	0.2375000
NODE_22258_length_627_cov_20.395833	137	217	4	61	80	0.7625000
NODE_22259_length_627_cov_19.676136	308	388	4	27	80	0.3375000
NODE_22259_length_627_cov_19.676136	308	388	5	14	80	0.1750000
NODE_22259_length_627_cov_19.676136	308	388	7	15	80	0.1875000
NODE_22259_length_627_cov_19.676136	308	388	8	24	80	0.3000000
NODE_22259_length_627_cov_19.676136	361	441	3	6	80	0.0750000
NODE_22259_length_627_cov_19.676136	361	441	4	5	80	0.0625000
NODE_22259_length_627_cov_19.676136	361	441	6	26	80	0.3250000
NODE_22259_length_627_cov_19.676136	361	441	7	3	80	0.0375000
NODE_22259_length_627_cov_19.676136	361	441	8	40	80	0.5000000
NODE_22260_length_627_cov_17.634470	264	296	0	32	32	1.0000000
NODE_22260_length_627_cov_17.634470	360	385	0	25	25	1.0000000
NODE_22260_length_627_cov_17.634470	365	385	0	20	20	1.0000000
NODE_22260_length_627_cov_17.634470	385	424	0	39	39	1.0000000
NODE_22267_length_627_cov_5.634470	298	346	0	35	48	0.7291667
NODE_22267_length_627_cov_5.634470	298	346	2	13	48	0.2708333
NODE_22274_length_627_cov_4.517045	323	403	0	80	80	1.0000000
NODE_22274_length_627_cov_4.517045	376	456	0	80	80	1.0000000
NODE_22357_length_626_cov_24.184061	140	220	0	2	80	0.0250000
NODE_22357_length_626_cov_24.184061	140	220	1	22	80	0.2750000
NODE_22357_length_626_cov_24.184061	140	220	2	35	80	0.4375000
NODE_22357_length_626_cov_24.184061	140	220	4	21	80	0.2625000
NODE_22357_length_626_cov_24.184061	193	273	2	6	80	0.0750000
NODE_22357_length_626_cov_24.184061	193	273	4	53	80	0.6625000
NODE_22357_length_626_cov_24.184061	193	273	5	2	80	0.0250000
NODE_22357_length_626_cov_24.184061	193	273	6	19	80	0.2375000
NODE_22358_length_626_cov_21.189753	342	419	2	11	77	0.1428571
NODE_22358_length_626_cov_21.189753	342	419	3	48	77	0.6233766
NODE_22358_length_626_cov_21.189753	342	419	4	17	77	0.2207792
NODE_22358_length_626_cov_21.189753	342	419	5	1	77	0.0129870
NODE_22358_length_626_cov_21.189753	342	419	2	11	77	0.1428571
NODE_22358_length_626_cov_21.189753	342	419	3	48	77	0.6233766
NODE_22358_length_626_cov_21.189753	342	419	4	17	77	0.2207792
NODE_22358_length_626_cov_21.189753	342	419	5	1	77	0.0129870
NODE_22358_length_626_cov_21.189753	392	453	3	11	61	0.1803279
NODE_22358_length_626_cov_21.189753	392	453	4	20	61	0.3278688
NODE_22358_length_626_cov_21.189753	392	453	5	30	61	0.4918033
NODE_22364_length_626_cov_7.100569	236	311	0	75	75	1.0000000
NODE_22364_length_626_cov_7.100569	284	364	0	80	80	1.0000000
NODE_22366_length_626_cov_6.296015	193	273	0	80	80	1.0000000
NODE_22366_length_626_cov_6.296015	246	326	0	80	80	1.0000000
NODE_22367_length_626_cov_6.163188	257	337	0	80	80	1.0000000
NODE_22367_length_626_cov_6.163188	310	390	0	80	80	1.0000000
NODE_22438_length_625_cov_33.100760	239	319	0	80	80	1.0000000
NODE_22438_length_625_cov_33.100760	292	372	0	80	80	1.0000000
NODE_22438_length_625_cov_33.100760	368	448	0	80	80	1.0000000
NODE_22438_length_625_cov_33.100760	421	501	0	80	80	1.0000000
NODE_22439_length_625_cov_21.062738	267	347	0	80	80	1.0000000
NODE_22439_length_625_cov_21.062738	320	400	0	80	80	1.0000000
NODE_22440_length_625_cov_14.237643	28	108	2	22	80	0.2750000
NODE_22440_length_625_cov_14.237643	28	108	3	58	80	0.7250000
NODE_22440_length_625_cov_14.237643	81	161	3	74	80	0.9250000
NODE_22440_length_625_cov_14.237643	81	161	4	6	80	0.0750000
NODE_22441_length_625_cov_14.207224	358	438	0	80	80	1.0000000
NODE_22441_length_625_cov_14.207224	411	491	0	80	80	1.0000000
NODE_22455_length_625_cov_4.157795	548	600	2	11	52	0.2115385
NODE_22455_length_625_cov_4.157795	548	600	3	41	52	0.7884616
NODE_22466_length_625_cov_2.929658	118	198	0	18	80	0.2250000
NODE_22466_length_625_cov_2.929658	118	198	1	27	80	0.3375000
NODE_22466_length_625_cov_2.929658	118	198	2	35	80	0.4375000
NODE_22466_length_625_cov_2.929658	171	251	2	44	80	0.5500000
NODE_22466_length_625_cov_2.929658	171	251	3	31	80	0.3875000
NODE_22466_length_625_cov_2.929658	171	251	4	5	80	0.0625000
NODE_22491_length_625_cov_1.570342	471	502	0	31	31	1.0000000
NODE_22542_length_624_cov_9.598095	77	126	0	49	49	1.0000000
NODE_22542_length_624_cov_9.598095	103	183	0	80	80	1.0000000
NODE_22544_length_624_cov_8.485714	271	351	0	80	80	1.0000000
NODE_22544_length_624_cov_8.485714	324	404	0	80	80	1.0000000
NODE_22546_length_624_cov_6.691429	386	466	1	80	80	1.0000000
NODE_22546_length_624_cov_6.691429	439	519	0	3	80	0.0375000
NODE_22546_length_624_cov_6.691429	439	519	1	77	80	0.9625000
NODE_22547_length_624_cov_5.592381	312	387	7	16	75	0.2133333
NODE_22547_length_624_cov_5.592381	312	387	8	15	75	0.2000000
NODE_22547_length_624_cov_5.592381	312	387	9	8	75	0.1066667
NODE_22547_length_624_cov_5.592381	312	387	10	30	75	0.4000000
NODE_22547_length_624_cov_5.592381	312	387	11	6	75	0.0800000
NODE_22551_length_624_cov_4.638095	328	388	0	60	60	1.0000000
NODE_22642_length_623_cov_41.877863	419	499	1	29	80	0.3625000
NODE_22642_length_623_cov_41.877863	419	499	2	51	80	0.6375000
NODE_22642_length_623_cov_41.877863	472	552	1	19	80	0.2375000
NODE_22642_length_623_cov_41.877863	472	552	2	61	80	0.7625000
NODE_22643_length_623_cov_31.875954	148	228	2	38	80	0.4750000
NODE_22643_length_623_cov_31.875954	148	228	3	23	80	0.2875000
NODE_22643_length_623_cov_31.875954	148	228	4	3	80	0.0375000
NODE_22643_length_623_cov_31.875954	148	228	5	16	80	0.2000000
NODE_22643_length_623_cov_31.875954	201	281	3	26	80	0.3250000
NODE_22643_length_623_cov_31.875954	201	281	4	22	80	0.2750000
NODE_22643_length_623_cov_31.875954	201	281	5	32	80	0.4000000
NODE_22644_length_623_cov_31.192748	313	393	0	80	80	1.0000000
NODE_22644_length_623_cov_31.192748	366	446	0	80	80	1.0000000
NODE_22645_length_623_cov_20.187023	287	367	0	8	80	0.1000000
NODE_22645_length_623_cov_20.187023	287	367	1	2	80	0.0250000
NODE_22645_length_623_cov_20.187023	287	367	2	6	80	0.0750000
NODE_22645_length_623_cov_20.187023	287	367	3	29	80	0.3625000
NODE_22645_length_623_cov_20.187023	287	367	4	35	80	0.4375000
NODE_22645_length_623_cov_20.187023	340	420	4	80	80	1.0000000
NODE_22646_length_623_cov_12.045802	377	457	0	80	80	1.0000000
NODE_22646_length_623_cov_12.045802	430	510	0	80	80	1.0000000
NODE_22668_length_623_cov_2.891221	457	535	1	12	78	0.1538462
NODE_22668_length_623_cov_2.891221	457	535	3	6	78	0.0769231
NODE_22668_length_623_cov_2.891221	457	535	4	10	78	0.1282051
NODE_22668_length_623_cov_2.891221	457	535	5	9	78	0.1153846
NODE_22668_length_623_cov_2.891221	457	535	6	5	78	0.0641026
NODE_22668_length_623_cov_2.891221	457	535	8	7	78	0.0897436
NODE_22668_length_623_cov_2.891221	457	535	9	23	78	0.2948718
NODE_22668_length_623_cov_2.891221	457	535	10	6	78	0.0769231
NODE_22725_length_622_cov_19.042065	368	448	0	80	80	1.0000000
NODE_22725_length_622_cov_19.042065	421	501	0	80	80	1.0000000
NODE_22726_length_622_cov_13.470363	109	189	0	18	80	0.2250000
NODE_22726_length_622_cov_13.470363	109	189	2	24	80	0.3000000
NODE_22726_length_622_cov_13.470363	109	189	4	38	80	0.4750000
NODE_22726_length_622_cov_13.470363	162	242	4	80	80	1.0000000
NODE_22752_length_622_cov_2.407266	94	170	2	35	76	0.4605263
NODE_22752_length_622_cov_2.407266	94	170	3	41	76	0.5394737
NODE_22796_length_622_cov_1.353728	346	376	0	30	30	1.0000000
NODE_22819_length_621_cov_46.247126	0	52	0	52	52	1.0000000
NODE_22819_length_621_cov_46.247126	25	105	0	48	80	0.6000000
NODE_22819_length_621_cov_46.247126	25	105	2	32	80	0.4000000
NODE_22819_length_621_cov_46.247126	101	181	2	80	80	1.0000000
NODE_22819_length_621_cov_46.247126	154	234	0	33	80	0.4125000
NODE_22819_length_621_cov_46.247126	154	234	2	47	80	0.5875000
NODE_22820_length_621_cov_45.764368	344	424	2	10	80	0.1250000
NODE_22820_length_621_cov_45.764368	344	424	3	5	80	0.0625000
NODE_22820_length_621_cov_45.764368	344	424	4	65	80	0.8125000
NODE_22820_length_621_cov_45.764368	397	477	1	4	80	0.0500000
NODE_22820_length_621_cov_45.764368	397	477	3	54	80	0.6750000
NODE_22820_length_621_cov_45.764368	397	477	4	22	80	0.2750000
NODE_22821_length_621_cov_35.147510	393	473	2	8	80	0.1000000
NODE_22821_length_621_cov_35.147510	393	473	3	60	80	0.7500000
NODE_22821_length_621_cov_35.147510	393	473	4	12	80	0.1500000
NODE_22821_length_621_cov_35.147510	446	526	2	2	80	0.0250000
NODE_22821_length_621_cov_35.147510	446	526	3	78	80	0.9750000
NODE_22822_length_621_cov_13.842912	231	311	1	16	80	0.2000000
NODE_22822_length_621_cov_13.842912	231	311	2	64	80	0.8000000
NODE_22822_length_621_cov_13.842912	284	364	1	9	80	0.1125000
NODE_22822_length_621_cov_13.842912	284	364	2	71	80	0.8875000
NODE_22825_length_621_cov_6.279693	376	406	3	10	30	0.3333333
NODE_22825_length_621_cov_6.279693	376	406	5	20	30	0.6666667
NODE_22845_length_621_cov_2.645594	367	426	0	59	59	1.0000000
NODE_22914_length_620_cov_23.913628	433	513	0	80	80	1.0000000
NODE_22914_length_620_cov_23.913628	486	566	0	80	80	1.0000000
NODE_22915_length_620_cov_9.222649	186	266	0	80	80	1.0000000
NODE_22915_length_620_cov_9.222649	239	319	0	80	80	1.0000000
NODE_22919_length_620_cov_7.804223	57	137	0	53	80	0.6625000
NODE_22919_length_620_cov_7.804223	57	137	1	27	80	0.3375000
NODE_22919_length_620_cov_7.804223	110	190	1	80	80	1.0000000
NODE_22920_length_620_cov_6.909789	199	279	0	80	80	1.0000000
NODE_22920_length_620_cov_6.909789	252	332	0	80	80	1.0000000
NODE_22930_length_620_cov_4.560461	309	347	12	6	38	0.1578947
NODE_22930_length_620_cov_4.560461	309	347	13	1	38	0.0263158
NODE_22930_length_620_cov_4.560461	309	347	14	31	38	0.8157895
NODE_22930_length_620_cov_4.560461	395	421	0	17	26	0.6538461
NODE_22930_length_620_cov_4.560461	395	421	3	9	26	0.3461539
NODE_22930_length_620_cov_4.560461	395	451	0	29	56	0.5178571
NODE_22930_length_620_cov_4.560461	395	451	3	14	56	0.2500000
NODE_22930_length_620_cov_4.560461	395	451	4	13	56	0.2321429
NODE_23031_length_619_cov_26.309615	118	198	4	23	80	0.2875000
NODE_23031_length_619_cov_26.309615	118	198	5	5	80	0.0625000
NODE_23031_length_619_cov_26.309615	118	198	6	1	80	0.0125000
NODE_23031_length_619_cov_26.309615	118	198	7	3	80	0.0375000
NODE_23031_length_619_cov_26.309615	118	198	8	48	80	0.6000000
NODE_23031_length_619_cov_26.309615	171	251	6	17	80	0.2125000
NODE_23031_length_619_cov_26.309615	171	251	7	9	80	0.1125000
NODE_23031_length_619_cov_26.309615	171	251	8	54	80	0.6750000
NODE_23033_length_619_cov_10.417308	427	487	0	60	60	1.0000000
NODE_23034_length_619_cov_7.944231	213	293	0	80	80	1.0000000
NODE_23034_length_619_cov_7.944231	266	346	0	80	80	1.0000000
NODE_23135_length_618_cov_14.477842	223	299	0	76	76	1.0000000
NODE_23135_length_618_cov_14.477842	223	299	0	76	76	1.0000000
NODE_23135_length_618_cov_14.477842	276	337	0	61	61	1.0000000
NODE_23136_length_618_cov_13.840077	377	457	0	80	80	1.0000000
NODE_23136_length_618_cov_13.840077	430	510	0	80	80	1.0000000
NODE_23137_length_618_cov_12.048170	348	428	0	80	80	1.0000000
NODE_23137_length_618_cov_12.048170	401	481	0	80	80	1.0000000
NODE_23138_length_618_cov_8.799615	353	433	0	1	80	0.0125000
NODE_23138_length_618_cov_8.799615	353	433	1	24	80	0.3000000
NODE_23138_length_618_cov_8.799615	353	433	3	18	80	0.2250000
NODE_23138_length_618_cov_8.799615	353	433	4	37	80	0.4625000
NODE_23138_length_618_cov_8.799615	406	486	4	33	80	0.4125000
NODE_23138_length_618_cov_8.799615	406	486	5	47	80	0.5875000
NODE_23147_length_618_cov_3.793834	412	478	0	66	66	1.0000000
NODE_23148_length_618_cov_3.761079	305	385	1	80	80	1.0000000
NODE_23252_length_617_cov_29.565637	378	458	4	78	80	0.9750000
NODE_23252_length_617_cov_29.565637	378	458	5	2	80	0.0250000
NODE_23252_length_617_cov_29.565637	431	511	1	47	80	0.5875000
NODE_23252_length_617_cov_29.565637	431	511	4	31	80	0.3875000
NODE_23252_length_617_cov_29.565637	431	511	5	2	80	0.0250000
NODE_23253_length_617_cov_16.781853	253	333	0	15	80	0.1875000
NODE_23253_length_617_cov_16.781853	253	333	2	34	80	0.4250000
NODE_23253_length_617_cov_16.781853	253	333	4	3	80	0.0375000
NODE_23253_length_617_cov_16.781853	253	333	6	28	80	0.3500000
NODE_23253_length_617_cov_16.781853	306	386	5	33	80	0.4125000
NODE_23253_length_617_cov_16.781853	306	386	6	47	80	0.5875000
NODE_23254_length_617_cov_9.175676	373	453	3	5	80	0.0625000
NODE_23254_length_617_cov_9.175676	373	453	4	43	80	0.5375000
NODE_23254_length_617_cov_9.175676	373	453	5	24	80	0.3000000
NODE_23254_length_617_cov_9.175676	373	453	6	8	80	0.1000000
NODE_23254_length_617_cov_9.175676	426	506	3	7	80	0.0875000
NODE_23254_length_617_cov_9.175676	426	506	4	23	80	0.2875000
NODE_23254_length_617_cov_9.175676	426	506	5	50	80	0.6250000
NODE_23255_length_617_cov_8.774131	320	406	1	20	86	0.2325581
NODE_23255_length_617_cov_8.774131	320	406	2	4	86	0.0465116
NODE_23255_length_617_cov_8.774131	320	406	3	58	86	0.6744186
NODE_23255_length_617_cov_8.774131	320	406	4	4	86	0.0465116
NODE_23255_length_617_cov_8.774131	379	458	3	57	79	0.7215190
NODE_23255_length_617_cov_8.774131	379	458	4	22	79	0.2784810
NODE_23257_length_617_cov_8.416988	359	439	0	30	80	0.3750000
NODE_23257_length_617_cov_8.416988	359	439	2	50	80	0.6250000
NODE_23257_length_617_cov_8.416988	412	492	0	80	80	1.0000000
NODE_23259_length_617_cov_7.683398	197	275	0	78	78	1.0000000
NODE_23259_length_617_cov_7.683398	250	330	0	80	80	1.0000000
NODE_23263_length_617_cov_5.330116	288	360	1	9	72	0.1250000
NODE_23263_length_617_cov_5.330116	288	360	2	17	72	0.2361111
NODE_23263_length_617_cov_5.330116	288	360	3	33	72	0.4583333
NODE_23263_length_617_cov_5.330116	288	360	4	13	72	0.1805556
NODE_23263_length_617_cov_5.330116	333	413	3	36	80	0.4500000
NODE_23263_length_617_cov_5.330116	333	413	4	44	80	0.5500000
NODE_23302_length_617_cov_1.967181	384	430	0	33	46	0.7173913
NODE_23302_length_617_cov_1.967181	384	430	2	13	46	0.2826087
NODE_23311_length_617_cov_1.847490	273	344	0	50	71	0.7042254
NODE_23311_length_617_cov_1.847490	273	344	1	21	71	0.2957746
NODE_23331_length_617_cov_1.322394	269	318	25	1	49	0.0204082
NODE_23331_length_617_cov_1.322394	269	318	28	4	49	0.0816327
NODE_23331_length_617_cov_1.322394	269	318	30	7	49	0.1428571
NODE_23331_length_617_cov_1.322394	269	318	31	12	49	0.2448980
NODE_23331_length_617_cov_1.322394	269	318	32	4	49	0.0816327
NODE_23331_length_617_cov_1.322394	269	318	33	3	49	0.0612245
NODE_23331_length_617_cov_1.322394	269	318	34	11	49	0.2244898
NODE_23331_length_617_cov_1.322394	269	318	35	7	49	0.1428571
NODE_23365_length_616_cov_15.914894	292	370	0	78	78	1.0000000
NODE_23365_length_616_cov_15.914894	343	423	0	80	80	1.0000000
NODE_23366_length_616_cov_14.276596	191	271	0	80	80	1.0000000
NODE_23366_length_616_cov_14.276596	244	319	0	75	75	1.0000000
NODE_23366_length_616_cov_14.276596	368	448	0	80	80	1.0000000
NODE_23367_length_616_cov_12.119923	273	353	0	80	80	1.0000000
NODE_23367_length_616_cov_12.119923	326	406	0	80	80	1.0000000
NODE_23373_length_616_cov_6.379110	305	385	1	36	80	0.4500000
NODE_23373_length_616_cov_6.379110	305	385	2	31	80	0.3875000
NODE_23373_length_616_cov_6.379110	305	385	3	13	80	0.1625000
NODE_23373_length_616_cov_6.379110	358	438	2	80	80	1.0000000
NODE_23381_length_616_cov_4.441006	286	350	0	64	64	1.0000000
NODE_23381_length_616_cov_4.441006	286	306	0	20	20	1.0000000
NODE_23400_length_616_cov_2.541586	375	415	0	40	40	1.0000000
NODE_23430_length_616_cov_1.491296	105	183	1	2	78	0.0256410
NODE_23430_length_616_cov_1.491296	105	183	3	7	78	0.0897436
NODE_23430_length_616_cov_1.491296	105	183	5	38	78	0.4871795
NODE_23430_length_616_cov_1.491296	105	183	6	31	78	0.3974359
NODE_23474_length_615_cov_27.519380	302	382	0	80	80	1.0000000
NODE_23474_length_615_cov_27.519380	355	435	0	80	80	1.0000000
NODE_23475_length_615_cov_17.792636	239	319	1	22	80	0.2750000
NODE_23475_length_615_cov_17.792636	239	319	3	58	80	0.7250000
NODE_23475_length_615_cov_17.792636	292	372	1	2	80	0.0250000
NODE_23475_length_615_cov_17.792636	292	372	2	3	80	0.0375000
NODE_23475_length_615_cov_17.792636	292	372	3	75	80	0.9375000
NODE_23477_length_615_cov_11.835271	240	320	0	80	80	1.0000000
NODE_23477_length_615_cov_11.835271	293	373	0	80	80	1.0000000
NODE_23478_length_615_cov_8.591085	287	367	4	35	80	0.4375000
NODE_23478_length_615_cov_8.591085	287	367	5	26	80	0.3250000
NODE_23478_length_615_cov_8.591085	287	367	7	19	80	0.2375000
NODE_23478_length_615_cov_8.591085	340	420	4	79	80	0.9875000
NODE_23478_length_615_cov_8.591085	340	420	5	1	80	0.0125000
NODE_23513_length_615_cov_2.461240	429	509	2	21	80	0.2625000
NODE_23513_length_615_cov_2.461240	429	509	4	59	80	0.7375000
NODE_23513_length_615_cov_2.461240	482	562	4	80	80	1.0000000
NODE_23516_length_615_cov_2.379845	405	467	4	54	62	0.8709677
NODE_23516_length_615_cov_2.379845	405	467	5	1	62	0.0161290
NODE_23516_length_615_cov_2.379845	405	467	6	7	62	0.1129032
NODE_23516_length_615_cov_2.379845	440	520	2	25	80	0.3125000
NODE_23516_length_615_cov_2.379845	440	520	4	55	80	0.6875000
NODE_23517_length_615_cov_2.294574	205	268	0	63	63	1.0000000
NODE_23554_length_615_cov_1.122093	255	335	0	38	80	0.4750000
NODE_23554_length_615_cov_1.122093	255	335	2	42	80	0.5250000
NODE_23566_length_615_cov_0.887597	561	582	0	21	21	1.0000000
NODE_23575_length_614_cov_17.772816	257	337	0	14	80	0.1750000
NODE_23575_length_614_cov_17.772816	257	337	1	66	80	0.8250000
NODE_23575_length_614_cov_17.772816	310	390	0	67	80	0.8375000
NODE_23575_length_614_cov_17.772816	310	390	1	13	80	0.1625000
NODE_23576_length_614_cov_10.706796	425	505	2	80	80	1.0000000
NODE_23576_length_614_cov_10.706796	478	558	0	37	80	0.4625000
NODE_23576_length_614_cov_10.706796	478	558	2	43	80	0.5375000
NODE_23578_length_614_cov_8.545631	193	273	0	39	80	0.4875000
NODE_23578_length_614_cov_8.545631	193	273	1	12	80	0.1500000
NODE_23578_length_614_cov_8.545631	193	273	2	1	80	0.0125000
NODE_23578_length_614_cov_8.545631	193	273	3	2	80	0.0250000
NODE_23578_length_614_cov_8.545631	193	273	4	1	80	0.0125000
NODE_23578_length_614_cov_8.545631	193	273	6	10	80	0.1250000
NODE_23578_length_614_cov_8.545631	193	273	7	11	80	0.1375000
NODE_23578_length_614_cov_8.545631	193	273	9	4	80	0.0500000
NODE_23578_length_614_cov_8.545631	246	326	0	15	80	0.1875000
NODE_23578_length_614_cov_8.545631	246	326	1	49	80	0.6125000
NODE_23578_length_614_cov_8.545631	246	326	2	16	80	0.2000000
NODE_23604_length_614_cov_2.450485	315	393	0	78	78	1.0000000
NODE_23604_length_614_cov_2.450485	355	383	0	28	28	1.0000000
NODE_23604_length_614_cov_2.450485	368	448	0	80	80	1.0000000
NODE_23604_length_614_cov_2.450485	379	448	0	69	69	1.0000000
NODE_23662_length_613_cov_18.075875	211	291	5	68	80	0.8500000
NODE_23662_length_613_cov_18.075875	211	291	6	12	80	0.1500000
NODE_23662_length_613_cov_18.075875	264	344	1	8	80	0.1000000
NODE_23662_length_613_cov_18.075875	264	344	3	8	80	0.1000000
NODE_23662_length_613_cov_18.075875	264	344	4	3	80	0.0375000
NODE_23662_length_613_cov_18.075875	264	344	5	50	80	0.6250000
NODE_23662_length_613_cov_18.075875	264	344	6	11	80	0.1375000
NODE_23663_length_613_cov_16.118677	283	363	0	56	80	0.7000000
NODE_23663_length_613_cov_16.118677	283	363	2	24	80	0.3000000
NODE_23663_length_613_cov_16.118677	336	416	0	80	80	1.0000000
NODE_23665_length_613_cov_12.883268	155	235	0	80	80	1.0000000
NODE_23665_length_613_cov_12.883268	208	288	0	80	80	1.0000000
NODE_23674_length_613_cov_3.857977	167	247	0	80	80	1.0000000
NODE_23674_length_613_cov_3.857977	220	300	0	80	80	1.0000000
NODE_23771_length_612_cov_24.023392	173	253	0	80	80	1.0000000
NODE_23771_length_612_cov_24.023392	226	306	0	80	80	1.0000000
NODE_23772_length_612_cov_23.846004	141	221	6	1	80	0.0125000
NODE_23772_length_612_cov_23.846004	141	221	7	46	80	0.5750000
NODE_23772_length_612_cov_23.846004	141	221	8	24	80	0.3000000
NODE_23772_length_612_cov_23.846004	141	221	9	1	80	0.0125000
NODE_23772_length_612_cov_23.846004	141	221	10	8	80	0.1000000
NODE_23772_length_612_cov_23.846004	194	274	4	39	80	0.4875000
NODE_23772_length_612_cov_23.846004	194	274	5	3	80	0.0375000
NODE_23772_length_612_cov_23.846004	194	274	6	2	80	0.0250000
NODE_23772_length_612_cov_23.846004	194	274	7	36	80	0.4500000
NODE_23773_length_612_cov_12.448343	244	324	0	80	80	1.0000000
NODE_23773_length_612_cov_12.448343	297	377	0	80	80	1.0000000
NODE_23774_length_612_cov_12.068226	267	347	0	80	80	1.0000000
NODE_23774_length_612_cov_12.068226	320	400	0	80	80	1.0000000
NODE_23779_length_612_cov_6.393762	242	322	0	80	80	1.0000000
NODE_23779_length_612_cov_6.393762	295	375	0	80	80	1.0000000
NODE_23814_length_612_cov_1.904483	288	354	0	66	66	1.0000000
NODE_23869_length_611_cov_38.705078	132	212	0	36	80	0.4500000
NODE_23869_length_611_cov_38.705078	132	212	1	14	80	0.1750000
NODE_23869_length_611_cov_38.705078	132	212	2	30	80	0.3750000
NODE_23869_length_611_cov_38.705078	185	262	2	77	77	1.0000000
NODE_23869_length_611_cov_38.705078	185	262	2	77	77	1.0000000
NODE_23871_length_611_cov_12.669922	264	344	3	41	80	0.5125000
NODE_23871_length_611_cov_12.669922	264	344	4	11	80	0.1375000
NODE_23871_length_611_cov_12.669922	264	344	5	28	80	0.3500000
NODE_23871_length_611_cov_12.669922	317	397	2	46	80	0.5750000
NODE_23871_length_611_cov_12.669922	317	397	3	26	80	0.3250000
NODE_23871_length_611_cov_12.669922	317	397	4	8	80	0.1000000
NODE_23880_length_611_cov_4.943359	27	107	1	10	80	0.1250000
NODE_23880_length_611_cov_4.943359	27	107	3	70	80	0.8750000
NODE_23880_length_611_cov_4.943359	80	137	3	57	57	1.0000000
NODE_23880_length_611_cov_4.943359	143	209	2	66	66	1.0000000
NODE_23880_length_611_cov_4.943359	182	262	0	20	80	0.2500000
NODE_23880_length_611_cov_4.943359	182	262	2	60	80	0.7500000
NODE_23894_length_611_cov_3.294922	271	300	4	10	29	0.3448276
NODE_23894_length_611_cov_3.294922	271	300	5	11	29	0.3793103
NODE_23894_length_611_cov_3.294922	271	300	6	8	29	0.2758621
NODE_23894_length_611_cov_3.294922	434	469	5	35	35	1.0000000
NODE_23897_length_611_cov_3.162109	313	342	3	26	29	0.8965517
NODE_23897_length_611_cov_3.162109	313	342	4	3	29	0.1034483
NODE_23973_length_610_cov_20.673190	87	167	0	10	80	0.1250000
NODE_23973_length_610_cov_20.673190	87	167	1	6	80	0.0750000
NODE_23973_length_610_cov_20.673190	87	167	2	20	80	0.2500000
NODE_23973_length_610_cov_20.673190	87	167	3	44	80	0.5500000
NODE_23973_length_610_cov_20.673190	140	220	3	52	80	0.6500000
NODE_23973_length_610_cov_20.673190	140	220	4	28	80	0.3500000
NODE_23974_length_610_cov_10.191781	250	330	0	80	80	1.0000000
NODE_23974_length_610_cov_10.191781	303	383	0	80	80	1.0000000
NODE_23980_length_610_cov_4.998043	129	181	0	52	52	1.0000000
NODE_23980_length_610_cov_4.998043	182	234	0	52	52	1.0000000
NODE_23989_length_610_cov_3.479452	215	267	0	21	52	0.4038461
NODE_23989_length_610_cov_3.479452	215	267	1	17	52	0.3269231
NODE_23989_length_610_cov_3.479452	215	267	2	5	52	0.0961538
NODE_23989_length_610_cov_3.479452	215	267	3	4	52	0.0769231
NODE_23989_length_610_cov_3.479452	215	267	4	5	52	0.0961538
NODE_24059_length_609_cov_21.117647	80	160	0	80	80	1.0000000
NODE_24059_length_609_cov_21.117647	133	213	0	80	80	1.0000000
NODE_24060_length_609_cov_11.300000	218	298	0	80	80	1.0000000
NODE_24060_length_609_cov_11.300000	271	351	0	80	80	1.0000000
NODE_24061_length_609_cov_10.778431	239	319	1	19	80	0.2375000
NODE_24061_length_609_cov_10.778431	239	319	2	9	80	0.1125000
NODE_24061_length_609_cov_10.778431	239	319	3	52	80	0.6500000
NODE_24061_length_609_cov_10.778431	292	372	1	72	80	0.9000000
NODE_24061_length_609_cov_10.778431	292	372	2	1	80	0.0125000
NODE_24061_length_609_cov_10.778431	292	372	3	7	80	0.0875000
NODE_24062_length_609_cov_10.298039	340	420	0	39	80	0.4875000
NODE_24062_length_609_cov_10.298039	340	420	1	22	80	0.2750000
NODE_24062_length_609_cov_10.298039	340	420	2	19	80	0.2375000
NODE_24062_length_609_cov_10.298039	393	473	1	8	80	0.1000000
NODE_24062_length_609_cov_10.298039	393	473	2	72	80	0.9000000
NODE_24062_length_609_cov_10.298039	469	537	1	8	68	0.1176471
NODE_24062_length_609_cov_10.298039	469	537	2	60	68	0.8823529
NODE_24063_length_609_cov_10.270588	217	297	1	80	80	1.0000000
NODE_24063_length_609_cov_10.270588	270	353	0	54	83	0.6506024
NODE_24063_length_609_cov_10.270588	270	353	1	29	83	0.3493976
NODE_24064_length_609_cov_8.345098	408	488	0	80	80	1.0000000
NODE_24064_length_609_cov_8.345098	461	515	0	54	54	1.0000000
NODE_24064_length_609_cov_8.345098	537	566	0	29	29	1.0000000
NODE_24066_length_609_cov_6.054902	219	299	1	29	80	0.3625000
NODE_24066_length_609_cov_6.054902	219	299	2	51	80	0.6375000
NODE_24066_length_609_cov_6.054902	272	352	2	80	80	1.0000000
NODE_24067_length_609_cov_5.986275	219	299	0	80	80	1.0000000
NODE_24067_length_609_cov_5.986275	272	352	0	80	80	1.0000000
NODE_24160_length_608_cov_76.257367	300	380	1	80	80	1.0000000
NODE_24160_length_608_cov_76.257367	353	433	0	53	80	0.6625000
NODE_24160_length_608_cov_76.257367	353	433	1	27	80	0.3375000
NODE_24161_length_608_cov_13.271120	252	332	0	59	80	0.7375000
NODE_24161_length_608_cov_13.271120	252	332	1	21	80	0.2625000
NODE_24161_length_608_cov_13.271120	305	385	0	6	80	0.0750000
NODE_24161_length_608_cov_13.271120	305	385	1	74	80	0.9250000
NODE_24162_length_608_cov_11.583497	63	139	0	76	76	1.0000000
NODE_24162_length_608_cov_11.583497	112	192	0	80	80	1.0000000
NODE_24164_length_608_cov_8.076621	53	133	20	2	80	0.0250000
NODE_24164_length_608_cov_8.076621	53	133	24	3	80	0.0375000
NODE_24164_length_608_cov_8.076621	53	133	28	5	80	0.0625000
NODE_24164_length_608_cov_8.076621	53	133	34	4	80	0.0500000
NODE_24164_length_608_cov_8.076621	53	133	35	7	80	0.0875000
NODE_24164_length_608_cov_8.076621	53	133	36	3	80	0.0375000
NODE_24164_length_608_cov_8.076621	53	133	37	6	80	0.0750000
NODE_24164_length_608_cov_8.076621	53	133	38	14	80	0.1750000
NODE_24164_length_608_cov_8.076621	53	133	39	1	80	0.0125000
NODE_24164_length_608_cov_8.076621	53	133	40	1	80	0.0125000
NODE_24164_length_608_cov_8.076621	53	133	41	13	80	0.1625000
NODE_24164_length_608_cov_8.076621	53	133	43	20	80	0.2500000
NODE_24164_length_608_cov_8.076621	53	133	44	1	80	0.0125000
NODE_24164_length_608_cov_8.076621	106	186	0	28	80	0.3500000
NODE_24164_length_608_cov_8.076621	106	186	2	4	80	0.0500000
NODE_24164_length_608_cov_8.076621	106	186	3	2	80	0.0250000
NODE_24164_length_608_cov_8.076621	106	186	5	3	80	0.0375000
NODE_24164_length_608_cov_8.076621	106	186	7	2	80	0.0250000
NODE_24164_length_608_cov_8.076621	106	186	9	1	80	0.0125000
NODE_24164_length_608_cov_8.076621	106	186	11	2	80	0.0250000
NODE_24164_length_608_cov_8.076621	106	186	13	1	80	0.0125000
NODE_24164_length_608_cov_8.076621	106	186	15	2	80	0.0250000
NODE_24164_length_608_cov_8.076621	106	186	16	8	80	0.1000000
NODE_24164_length_608_cov_8.076621	106	186	20	2	80	0.0250000
NODE_24164_length_608_cov_8.076621	106	186	24	3	80	0.0375000
NODE_24164_length_608_cov_8.076621	106	186	28	5	80	0.0625000
NODE_24164_length_608_cov_8.076621	106	186	34	4	80	0.0500000
NODE_24164_length_608_cov_8.076621	106	186	36	3	80	0.0375000
NODE_24164_length_608_cov_8.076621	106	186	38	10	80	0.1250000
NODE_24165_length_608_cov_7.994106	279	326	1	47	47	1.0000000
NODE_24165_length_608_cov_7.994106	348	373	0	25	25	1.0000000
NODE_24166_length_608_cov_7.939096	247	277	2	30	30	1.0000000
NODE_24177_length_608_cov_3.829077	313	393	0	80	80	1.0000000
NODE_24177_length_608_cov_3.829077	366	446	0	40	80	0.5000000
NODE_24177_length_608_cov_3.829077	366	446	2	40	80	0.5000000
NODE_24251_length_608_cov_1.064833	472	512	0	40	40	1.0000000
NODE_24281_length_607_cov_61.316929	347	427	11	1	80	0.0125000
NODE_24281_length_607_cov_61.316929	347	427	17	4	80	0.0500000
NODE_24281_length_607_cov_61.316929	347	427	18	1	80	0.0125000
NODE_24281_length_607_cov_61.316929	347	427	19	5	80	0.0625000
NODE_24281_length_607_cov_61.316929	347	427	20	11	80	0.1375000
NODE_24281_length_607_cov_61.316929	347	427	22	4	80	0.0500000
NODE_24281_length_607_cov_61.316929	347	427	23	11	80	0.1375000
NODE_24281_length_607_cov_61.316929	347	427	24	8	80	0.1000000
NODE_24281_length_607_cov_61.316929	347	427	25	2	80	0.0250000
NODE_24281_length_607_cov_61.316929	347	427	26	3	80	0.0375000
NODE_24281_length_607_cov_61.316929	347	427	27	3	80	0.0375000
NODE_24281_length_607_cov_61.316929	347	427	29	2	80	0.0250000
NODE_24281_length_607_cov_61.316929	347	427	30	3	80	0.0375000
NODE_24281_length_607_cov_61.316929	347	427	32	1	80	0.0125000
NODE_24281_length_607_cov_61.316929	347	427	33	2	80	0.0250000
NODE_24281_length_607_cov_61.316929	347	427	34	8	80	0.1000000
NODE_24281_length_607_cov_61.316929	347	427	35	7	80	0.0875000
NODE_24281_length_607_cov_61.316929	347	427	36	4	80	0.0500000
NODE_24281_length_607_cov_61.316929	347	427	11	1	80	0.0125000
NODE_24281_length_607_cov_61.316929	347	427	17	4	80	0.0500000
NODE_24281_length_607_cov_61.316929	347	427	18	1	80	0.0125000
NODE_24281_length_607_cov_61.316929	347	427	19	5	80	0.0625000
NODE_24281_length_607_cov_61.316929	347	427	20	11	80	0.1375000
NODE_24281_length_607_cov_61.316929	347	427	22	4	80	0.0500000
NODE_24281_length_607_cov_61.316929	347	427	23	11	80	0.1375000
NODE_24281_length_607_cov_61.316929	347	427	24	8	80	0.1000000
NODE_24281_length_607_cov_61.316929	347	427	25	2	80	0.0250000
NODE_24281_length_607_cov_61.316929	347	427	26	3	80	0.0375000
NODE_24281_length_607_cov_61.316929	347	427	27	3	80	0.0375000
NODE_24281_length_607_cov_61.316929	347	427	29	2	80	0.0250000
NODE_24281_length_607_cov_61.316929	347	427	30	3	80	0.0375000
NODE_24281_length_607_cov_61.316929	347	427	32	1	80	0.0125000
NODE_24281_length_607_cov_61.316929	347	427	33	2	80	0.0250000
NODE_24281_length_607_cov_61.316929	347	427	34	8	80	0.1000000
NODE_24281_length_607_cov_61.316929	347	427	35	7	80	0.0875000
NODE_24281_length_607_cov_61.316929	347	427	36	4	80	0.0500000
NODE_24281_length_607_cov_61.316929	347	427	11	1	80	0.0125000
NODE_24281_length_607_cov_61.316929	347	427	17	4	80	0.0500000
NODE_24281_length_607_cov_61.316929	347	427	18	1	80	0.0125000
NODE_24281_length_607_cov_61.316929	347	427	19	5	80	0.0625000
NODE_24281_length_607_cov_61.316929	347	427	20	11	80	0.1375000
NODE_24281_length_607_cov_61.316929	347	427	22	4	80	0.0500000
NODE_24281_length_607_cov_61.316929	347	427	23	11	80	0.1375000
NODE_24281_length_607_cov_61.316929	347	427	24	8	80	0.1000000
NODE_24281_length_607_cov_61.316929	347	427	25	2	80	0.0250000
NODE_24281_length_607_cov_61.316929	347	427	26	3	80	0.0375000
NODE_24281_length_607_cov_61.316929	347	427	27	3	80	0.0375000
NODE_24281_length_607_cov_61.316929	347	427	29	2	80	0.0250000
NODE_24281_length_607_cov_61.316929	347	427	30	3	80	0.0375000
NODE_24281_length_607_cov_61.316929	347	427	32	1	80	0.0125000
NODE_24281_length_607_cov_61.316929	347	427	33	2	80	0.0250000
NODE_24281_length_607_cov_61.316929	347	427	34	8	80	0.1000000
NODE_24281_length_607_cov_61.316929	347	427	35	7	80	0.0875000
NODE_24281_length_607_cov_61.316929	347	427	36	4	80	0.0500000
NODE_24281_length_607_cov_61.316929	364	427	20	5	63	0.0793651
NODE_24281_length_607_cov_61.316929	364	427	22	4	63	0.0634921
NODE_24281_length_607_cov_61.316929	364	427	23	11	63	0.1746032
NODE_24281_length_607_cov_61.316929	364	427	24	8	63	0.1269841
NODE_24281_length_607_cov_61.316929	364	427	25	2	63	0.0317460
NODE_24281_length_607_cov_61.316929	364	427	26	3	63	0.0476190
NODE_24281_length_607_cov_61.316929	364	427	27	3	63	0.0476190
NODE_24281_length_607_cov_61.316929	364	427	29	2	63	0.0317460
NODE_24281_length_607_cov_61.316929	364	427	30	3	63	0.0476190
NODE_24281_length_607_cov_61.316929	364	427	32	1	63	0.0158730
NODE_24281_length_607_cov_61.316929	364	427	33	2	63	0.0317460
NODE_24281_length_607_cov_61.316929	364	427	34	8	63	0.1269841
NODE_24281_length_607_cov_61.316929	364	427	35	7	63	0.1111111
NODE_24281_length_607_cov_61.316929	364	427	36	4	63	0.0634921
NODE_24281_length_607_cov_61.316929	400	480	29	2	80	0.0250000
NODE_24281_length_607_cov_61.316929	400	480	30	3	80	0.0375000
NODE_24281_length_607_cov_61.316929	400	480	32	1	80	0.0125000
NODE_24281_length_607_cov_61.316929	400	480	33	2	80	0.0250000
NODE_24281_length_607_cov_61.316929	400	480	34	15	80	0.1875000
NODE_24281_length_607_cov_61.316929	400	480	35	11	80	0.1375000
NODE_24281_length_607_cov_61.316929	400	480	36	31	80	0.3875000
NODE_24281_length_607_cov_61.316929	400	480	37	6	80	0.0750000
NODE_24281_length_607_cov_61.316929	400	480	38	9	80	0.1125000
NODE_24281_length_607_cov_61.316929	400	480	29	2	80	0.0250000
NODE_24281_length_607_cov_61.316929	400	480	30	3	80	0.0375000
NODE_24281_length_607_cov_61.316929	400	480	32	1	80	0.0125000
NODE_24281_length_607_cov_61.316929	400	480	33	2	80	0.0250000
NODE_24281_length_607_cov_61.316929	400	480	34	15	80	0.1875000
NODE_24281_length_607_cov_61.316929	400	480	35	11	80	0.1375000
NODE_24281_length_607_cov_61.316929	400	480	36	31	80	0.3875000
NODE_24281_length_607_cov_61.316929	400	480	37	6	80	0.0750000
NODE_24281_length_607_cov_61.316929	400	480	38	9	80	0.1125000
NODE_24281_length_607_cov_61.316929	400	480	29	2	80	0.0250000
NODE_24281_length_607_cov_61.316929	400	480	30	3	80	0.0375000
NODE_24281_length_607_cov_61.316929	400	480	32	1	80	0.0125000
NODE_24281_length_607_cov_61.316929	400	480	33	2	80	0.0250000
NODE_24281_length_607_cov_61.316929	400	480	34	15	80	0.1875000
NODE_24281_length_607_cov_61.316929	400	480	35	11	80	0.1375000
NODE_24281_length_607_cov_61.316929	400	480	36	31	80	0.3875000
NODE_24281_length_607_cov_61.316929	400	480	37	6	80	0.0750000
NODE_24281_length_607_cov_61.316929	400	480	38	9	80	0.1125000
NODE_24281_length_607_cov_61.316929	400	480	29	2	80	0.0250000
NODE_24281_length_607_cov_61.316929	400	480	30	3	80	0.0375000
NODE_24281_length_607_cov_61.316929	400	480	32	1	80	0.0125000
NODE_24281_length_607_cov_61.316929	400	480	33	2	80	0.0250000
NODE_24281_length_607_cov_61.316929	400	480	34	15	80	0.1875000
NODE_24281_length_607_cov_61.316929	400	480	35	11	80	0.1375000
NODE_24281_length_607_cov_61.316929	400	480	36	31	80	0.3875000
NODE_24281_length_607_cov_61.316929	400	480	37	6	80	0.0750000
NODE_24281_length_607_cov_61.316929	400	480	38	9	80	0.1125000
NODE_24281_length_607_cov_61.316929	476	556	8	1	80	0.0125000
NODE_24281_length_607_cov_61.316929	476	556	9	3	80	0.0375000
NODE_24281_length_607_cov_61.316929	476	556	10	8	80	0.1000000
NODE_24281_length_607_cov_61.316929	476	556	12	2	80	0.0250000
NODE_24281_length_607_cov_61.316929	476	556	13	21	80	0.2625000
NODE_24281_length_607_cov_61.316929	476	556	14	2	80	0.0250000
NODE_24281_length_607_cov_61.316929	476	556	16	11	80	0.1375000
NODE_24281_length_607_cov_61.316929	476	556	17	3	80	0.0375000
NODE_24281_length_607_cov_61.316929	476	556	19	2	80	0.0250000
NODE_24281_length_607_cov_61.316929	476	556	20	1	80	0.0125000
NODE_24281_length_607_cov_61.316929	476	556	21	4	80	0.0500000
NODE_24281_length_607_cov_61.316929	476	556	25	2	80	0.0250000
NODE_24281_length_607_cov_61.316929	476	556	26	2	80	0.0250000
NODE_24281_length_607_cov_61.316929	476	556	29	1	80	0.0125000
NODE_24281_length_607_cov_61.316929	476	556	30	2	80	0.0250000
NODE_24281_length_607_cov_61.316929	476	556	31	1	80	0.0125000
NODE_24281_length_607_cov_61.316929	476	556	32	1	80	0.0125000
NODE_24281_length_607_cov_61.316929	476	556	33	7	80	0.0875000
NODE_24281_length_607_cov_61.316929	476	556	34	6	80	0.0750000
NODE_24281_length_607_cov_61.316929	476	556	8	1	80	0.0125000
NODE_24281_length_607_cov_61.316929	476	556	9	3	80	0.0375000
NODE_24281_length_607_cov_61.316929	476	556	10	8	80	0.1000000
NODE_24281_length_607_cov_61.316929	476	556	12	2	80	0.0250000
NODE_24281_length_607_cov_61.316929	476	556	13	21	80	0.2625000
NODE_24281_length_607_cov_61.316929	476	556	14	2	80	0.0250000
NODE_24281_length_607_cov_61.316929	476	556	16	11	80	0.1375000
NODE_24281_length_607_cov_61.316929	476	556	17	3	80	0.0375000
NODE_24281_length_607_cov_61.316929	476	556	19	2	80	0.0250000
NODE_24281_length_607_cov_61.316929	476	556	20	1	80	0.0125000
NODE_24281_length_607_cov_61.316929	476	556	21	4	80	0.0500000
NODE_24281_length_607_cov_61.316929	476	556	25	2	80	0.0250000
NODE_24281_length_607_cov_61.316929	476	556	26	2	80	0.0250000
NODE_24281_length_607_cov_61.316929	476	556	29	1	80	0.0125000
NODE_24281_length_607_cov_61.316929	476	556	30	2	80	0.0250000
NODE_24281_length_607_cov_61.316929	476	556	31	1	80	0.0125000
NODE_24281_length_607_cov_61.316929	476	556	32	1	80	0.0125000
NODE_24281_length_607_cov_61.316929	476	556	33	7	80	0.0875000
NODE_24281_length_607_cov_61.316929	476	556	34	6	80	0.0750000
NODE_24281_length_607_cov_61.316929	476	556	8	1	80	0.0125000
NODE_24281_length_607_cov_61.316929	476	556	9	3	80	0.0375000
NODE_24281_length_607_cov_61.316929	476	556	10	8	80	0.1000000
NODE_24281_length_607_cov_61.316929	476	556	12	2	80	0.0250000
NODE_24281_length_607_cov_61.316929	476	556	13	21	80	0.2625000
NODE_24281_length_607_cov_61.316929	476	556	14	2	80	0.0250000
NODE_24281_length_607_cov_61.316929	476	556	16	11	80	0.1375000
NODE_24281_length_607_cov_61.316929	476	556	17	3	80	0.0375000
NODE_24281_length_607_cov_61.316929	476	556	19	2	80	0.0250000
NODE_24281_length_607_cov_61.316929	476	556	20	1	80	0.0125000
NODE_24281_length_607_cov_61.316929	476	556	21	4	80	0.0500000
NODE_24281_length_607_cov_61.316929	476	556	25	2	80	0.0250000
NODE_24281_length_607_cov_61.316929	476	556	26	2	80	0.0250000
NODE_24281_length_607_cov_61.316929	476	556	29	1	80	0.0125000
NODE_24281_length_607_cov_61.316929	476	556	30	2	80	0.0250000
NODE_24281_length_607_cov_61.316929	476	556	31	1	80	0.0125000
NODE_24281_length_607_cov_61.316929	476	556	32	1	80	0.0125000
NODE_24281_length_607_cov_61.316929	476	556	33	7	80	0.0875000
NODE_24281_length_607_cov_61.316929	476	556	34	6	80	0.0750000
NODE_24281_length_607_cov_61.316929	529	595	2	8	66	0.1212121
NODE_24281_length_607_cov_61.316929	529	595	4	14	66	0.2121212
NODE_24281_length_607_cov_61.316929	529	595	5	7	66	0.1060606
NODE_24281_length_607_cov_61.316929	529	595	6	8	66	0.1212121
NODE_24281_length_607_cov_61.316929	529	595	7	2	66	0.0303030
NODE_24281_length_607_cov_61.316929	529	595	8	1	66	0.0151515
NODE_24281_length_607_cov_61.316929	529	595	9	3	66	0.0454545
NODE_24281_length_607_cov_61.316929	529	595	10	8	66	0.1212121
NODE_24281_length_607_cov_61.316929	529	595	12	2	66	0.0303030
NODE_24281_length_607_cov_61.316929	529	595	13	13	66	0.1969697
NODE_24281_length_607_cov_61.316929	529	607	0	2	78	0.0256410
NODE_24281_length_607_cov_61.316929	529	607	2	18	78	0.2307692
NODE_24281_length_607_cov_61.316929	529	607	4	14	78	0.1794872
NODE_24281_length_607_cov_61.316929	529	607	5	7	78	0.0897436
NODE_24281_length_607_cov_61.316929	529	607	6	8	78	0.1025641
NODE_24281_length_607_cov_61.316929	529	607	7	2	78	0.0256410
NODE_24281_length_607_cov_61.316929	529	607	8	1	78	0.0128205
NODE_24281_length_607_cov_61.316929	529	607	9	3	78	0.0384615
NODE_24281_length_607_cov_61.316929	529	607	10	8	78	0.1025641
NODE_24281_length_607_cov_61.316929	529	607	12	2	78	0.0256410
NODE_24281_length_607_cov_61.316929	529	607	13	13	78	0.1666667
NODE_24281_length_607_cov_61.316929	529	600	2	13	71	0.1830986
NODE_24281_length_607_cov_61.316929	529	600	4	14	71	0.1971831
NODE_24281_length_607_cov_61.316929	529	600	5	7	71	0.0985916
NODE_24281_length_607_cov_61.316929	529	600	6	8	71	0.1126761
NODE_24281_length_607_cov_61.316929	529	600	7	2	71	0.0281690
NODE_24281_length_607_cov_61.316929	529	600	8	1	71	0.0140845
NODE_24281_length_607_cov_61.316929	529	600	9	3	71	0.0422535
NODE_24281_length_607_cov_61.316929	529	600	10	8	71	0.1126761
NODE_24281_length_607_cov_61.316929	529	600	12	2	71	0.0281690
NODE_24281_length_607_cov_61.316929	529	600	13	13	71	0.1830986
NODE_24281_length_607_cov_61.316929	534	607	0	2	73	0.0273973
NODE_24281_length_607_cov_61.316929	534	607	2	18	73	0.2465753
NODE_24281_length_607_cov_61.316929	534	607	4	14	73	0.1917808
NODE_24281_length_607_cov_61.316929	534	607	5	7	73	0.0958904
NODE_24281_length_607_cov_61.316929	534	607	6	8	73	0.1095890
NODE_24281_length_607_cov_61.316929	534	607	7	2	73	0.0273973
NODE_24281_length_607_cov_61.316929	534	607	8	1	73	0.0136986
NODE_24281_length_607_cov_61.316929	534	607	9	3	73	0.0410959
NODE_24281_length_607_cov_61.316929	534	607	10	8	73	0.1095890
NODE_24281_length_607_cov_61.316929	534	607	12	2	73	0.0273973
NODE_24281_length_607_cov_61.316929	534	607	13	8	73	0.1095890
NODE_24282_length_607_cov_16.852362	383	463	6	62	80	0.7750000
NODE_24282_length_607_cov_16.852362	383	463	7	18	80	0.2250000
NODE_24282_length_607_cov_16.852362	436	516	2	13	80	0.1625000
NODE_24282_length_607_cov_16.852362	436	516	4	15	80	0.1875000
NODE_24282_length_607_cov_16.852362	436	516	5	4	80	0.0500000
NODE_24282_length_607_cov_16.852362	436	516	6	39	80	0.4875000
NODE_24282_length_607_cov_16.852362	436	516	7	9	80	0.1125000
NODE_24283_length_607_cov_12.889764	67	147	0	80	80	1.0000000
NODE_24283_length_607_cov_12.889764	120	200	0	80	80	1.0000000
NODE_24284_length_607_cov_11.023622	122	202	4	80	80	1.0000000
NODE_24284_length_607_cov_11.023622	175	255	2	13	80	0.1625000
NODE_24284_length_607_cov_11.023622	175	255	4	67	80	0.8375000
NODE_24285_length_607_cov_10.690945	199	279	3	80	80	1.0000000
NODE_24285_length_607_cov_10.690945	252	332	0	29	80	0.3625000
NODE_24285_length_607_cov_10.690945	252	332	1	7	80	0.0875000
NODE_24285_length_607_cov_10.690945	252	332	3	44	80	0.5500000
NODE_24290_length_607_cov_5.818898	301	386	0	85	85	1.0000000
NODE_24291_length_607_cov_5.771654	278	358	0	34	80	0.4250000
NODE_24291_length_607_cov_5.771654	278	358	1	46	80	0.5750000
NODE_24291_length_607_cov_5.771654	331	411	1	39	80	0.4875000
NODE_24291_length_607_cov_5.771654	331	411	2	41	80	0.5125000
NODE_24295_length_607_cov_4.816929	282	362	0	80	80	1.0000000
NODE_24295_length_607_cov_4.816929	335	415	0	80	80	1.0000000
NODE_24300_length_607_cov_4.015748	295	354	0	59	59	1.0000000
NODE_24310_length_607_cov_3.088583	107	158	0	43	51	0.8431373
NODE_24310_length_607_cov_3.088583	107	158	1	8	51	0.1568628
NODE_24331_length_607_cov_1.791339	204	247	2	27	43	0.6279070
NODE_24331_length_607_cov_1.791339	204	247	4	16	43	0.3720930
NODE_24400_length_606_cov_42.264300	182	262	1	3	80	0.0375000
NODE_24400_length_606_cov_42.264300	182	262	2	19	80	0.2375000
NODE_24400_length_606_cov_42.264300	182	262	3	1	80	0.0125000
NODE_24400_length_606_cov_42.264300	182	262	4	57	80	0.7125000
NODE_24400_length_606_cov_42.264300	235	315	4	31	80	0.3875000
NODE_24400_length_606_cov_42.264300	235	315	5	6	80	0.0750000
NODE_24400_length_606_cov_42.264300	235	315	6	36	80	0.4500000
NODE_24400_length_606_cov_42.264300	235	315	7	7	80	0.0875000
NODE_24402_length_606_cov_26.341223	371	451	1	50	80	0.6250000
NODE_24402_length_606_cov_26.341223	371	451	2	30	80	0.3750000
NODE_24402_length_606_cov_26.341223	424	504	2	80	80	1.0000000
NODE_24403_length_606_cov_14.895464	308	388	0	29	80	0.3625000
NODE_24403_length_606_cov_14.895464	308	388	2	51	80	0.6375000
NODE_24403_length_606_cov_14.895464	361	441	0	52	80	0.6500000
NODE_24403_length_606_cov_14.895464	361	441	2	28	80	0.3500000
NODE_24406_length_606_cov_7.934911	412	492	0	54	80	0.6750000
NODE_24406_length_606_cov_7.934911	412	492	2	26	80	0.3250000
NODE_24406_length_606_cov_7.934911	465	545	0	80	80	1.0000000
NODE_24407_length_606_cov_7.481262	250	330	5	37	80	0.4625000
NODE_24407_length_606_cov_7.481262	250	330	6	43	80	0.5375000
NODE_24407_length_606_cov_7.481262	303	383	3	1	80	0.0125000
NODE_24407_length_606_cov_7.481262	303	383	4	49	80	0.6125000
NODE_24407_length_606_cov_7.481262	303	383	5	2	80	0.0250000
NODE_24407_length_606_cov_7.481262	303	383	6	28	80	0.3500000
NODE_24409_length_606_cov_6.842209	139	219	2	80	80	1.0000000
NODE_24409_length_606_cov_6.842209	192	272	1	23	80	0.2875000
NODE_24409_length_606_cov_6.842209	192	272	2	57	80	0.7125000
NODE_24428_length_606_cov_3.384615	156	206	3	50	50	1.0000000
NODE_24433_length_606_cov_2.670611	113	193	0	80	80	1.0000000
NODE_24525_length_605_cov_63.343874	7	83	1	3	76	0.0394737
NODE_24525_length_605_cov_63.343874	7	83	2	6	76	0.0789474
NODE_24525_length_605_cov_63.343874	7	83	3	5	76	0.0657895
NODE_24525_length_605_cov_63.343874	7	83	4	35	76	0.4605263
NODE_24525_length_605_cov_63.343874	7	83	6	19	76	0.2500000
NODE_24525_length_605_cov_63.343874	7	83	7	8	76	0.1052632
NODE_24525_length_605_cov_63.343874	12	83	2	4	71	0.0563380
NODE_24525_length_605_cov_63.343874	12	83	3	5	71	0.0704225
NODE_24525_length_605_cov_63.343874	12	83	4	35	71	0.4929577
NODE_24525_length_605_cov_63.343874	12	83	6	19	71	0.2676056
NODE_24525_length_605_cov_63.343874	12	83	7	8	71	0.1126761
NODE_24525_length_605_cov_63.343874	17	83	3	4	66	0.0606061
NODE_24525_length_605_cov_63.343874	17	83	4	35	66	0.5303030
NODE_24525_length_605_cov_63.343874	17	83	6	19	66	0.2878788
NODE_24525_length_605_cov_63.343874	17	83	7	8	66	0.1212121
NODE_24525_length_605_cov_63.343874	56	136	6	19	80	0.2375000
NODE_24525_length_605_cov_63.343874	56	136	7	8	80	0.1000000
NODE_24525_length_605_cov_63.343874	56	136	9	3	80	0.0375000
NODE_24525_length_605_cov_63.343874	56	136	10	25	80	0.3125000
NODE_24525_length_605_cov_63.343874	56	136	11	25	80	0.3125000
NODE_24525_length_605_cov_63.343874	56	136	6	19	80	0.2375000
NODE_24525_length_605_cov_63.343874	56	136	7	8	80	0.1000000
NODE_24525_length_605_cov_63.343874	56	136	9	3	80	0.0375000
NODE_24525_length_605_cov_63.343874	56	136	10	25	80	0.3125000
NODE_24525_length_605_cov_63.343874	56	136	11	25	80	0.3125000
NODE_24525_length_605_cov_63.343874	56	136	6	19	80	0.2375000
NODE_24525_length_605_cov_63.343874	56	136	7	8	80	0.1000000
NODE_24525_length_605_cov_63.343874	56	136	9	3	80	0.0375000
NODE_24525_length_605_cov_63.343874	56	136	10	25	80	0.3125000
NODE_24525_length_605_cov_63.343874	56	136	11	25	80	0.3125000
NODE_24525_length_605_cov_63.343874	132	212	7	33	80	0.4125000
NODE_24525_length_605_cov_63.343874	132	212	8	6	80	0.0750000
NODE_24525_length_605_cov_63.343874	132	212	9	2	80	0.0250000
NODE_24525_length_605_cov_63.343874	132	212	10	16	80	0.2000000
NODE_24525_length_605_cov_63.343874	132	212	11	12	80	0.1500000
NODE_24525_length_605_cov_63.343874	132	212	12	11	80	0.1375000
NODE_24525_length_605_cov_63.343874	132	212	7	33	80	0.4125000
NODE_24525_length_605_cov_63.343874	132	212	8	6	80	0.0750000
NODE_24525_length_605_cov_63.343874	132	212	9	2	80	0.0250000
NODE_24525_length_605_cov_63.343874	132	212	10	16	80	0.2000000
NODE_24525_length_605_cov_63.343874	132	212	11	12	80	0.1500000
NODE_24525_length_605_cov_63.343874	132	212	12	11	80	0.1375000
NODE_24525_length_605_cov_63.343874	132	210	7	33	78	0.4230769
NODE_24525_length_605_cov_63.343874	132	210	8	4	78	0.0512821
NODE_24525_length_605_cov_63.343874	132	210	9	2	78	0.0256410
NODE_24525_length_605_cov_63.343874	132	210	10	16	78	0.2051282
NODE_24525_length_605_cov_63.343874	132	210	11	12	78	0.1538462
NODE_24525_length_605_cov_63.343874	132	210	12	11	78	0.1410256
NODE_24525_length_605_cov_63.343874	132	212	7	33	80	0.4125000
NODE_24525_length_605_cov_63.343874	132	212	8	6	80	0.0750000
NODE_24525_length_605_cov_63.343874	132	212	9	2	80	0.0250000
NODE_24525_length_605_cov_63.343874	132	212	10	16	80	0.2000000
NODE_24525_length_605_cov_63.343874	132	212	11	12	80	0.1500000
NODE_24525_length_605_cov_63.343874	132	212	12	11	80	0.1375000
NODE_24525_length_605_cov_63.343874	132	212	7	33	80	0.4125000
NODE_24525_length_605_cov_63.343874	132	212	8	6	80	0.0750000
NODE_24525_length_605_cov_63.343874	132	212	9	2	80	0.0250000
NODE_24525_length_605_cov_63.343874	132	212	10	16	80	0.2000000
NODE_24525_length_605_cov_63.343874	132	212	11	12	80	0.1500000
NODE_24525_length_605_cov_63.343874	132	212	12	11	80	0.1375000
NODE_24525_length_605_cov_63.343874	185	265	1	9	80	0.1125000
NODE_24525_length_605_cov_63.343874	185	265	2	20	80	0.2500000
NODE_24525_length_605_cov_63.343874	185	265	3	8	80	0.1000000
NODE_24525_length_605_cov_63.343874	185	265	5	1	80	0.0125000
NODE_24525_length_605_cov_63.343874	185	265	7	23	80	0.2875000
NODE_24525_length_605_cov_63.343874	185	265	8	19	80	0.2375000
NODE_24526_length_605_cov_48.191700	298	374	1	10	76	0.1315790
NODE_24526_length_605_cov_48.191700	298	374	3	66	76	0.8684211
NODE_24526_length_605_cov_48.191700	347	427	1	11	80	0.1375000
NODE_24526_length_605_cov_48.191700	347	427	3	69	80	0.8625000
NODE_24528_length_605_cov_33.328063	57	137	126	1	80	0.0125000
NODE_24528_length_605_cov_33.328063	57	137	128	1	80	0.0125000
NODE_24528_length_605_cov_33.328063	57	137	130	1	80	0.0125000
NODE_24528_length_605_cov_33.328063	57	137	133	1	80	0.0125000
NODE_24528_length_605_cov_33.328063	57	137	135	1	80	0.0125000
NODE_24528_length_605_cov_33.328063	57	137	136	1	80	0.0125000
NODE_24528_length_605_cov_33.328063	57	137	137	2	80	0.0250000
NODE_24528_length_605_cov_33.328063	57	137	138	2	80	0.0250000
NODE_24528_length_605_cov_33.328063	57	137	145	1	80	0.0125000
NODE_24528_length_605_cov_33.328063	57	137	148	1	80	0.0125000
NODE_24528_length_605_cov_33.328063	57	137	149	2	80	0.0250000
NODE_24528_length_605_cov_33.328063	57	137	150	1	80	0.0125000
NODE_24528_length_605_cov_33.328063	57	137	156	2	80	0.0250000
NODE_24528_length_605_cov_33.328063	57	137	157	1	80	0.0125000
NODE_24528_length_605_cov_33.328063	57	137	161	1	80	0.0125000
NODE_24528_length_605_cov_33.328063	57	137	164	1	80	0.0125000
NODE_24528_length_605_cov_33.328063	57	137	166	1	80	0.0125000
NODE_24528_length_605_cov_33.328063	57	137	167	4	80	0.0500000
NODE_24528_length_605_cov_33.328063	57	137	170	1	80	0.0125000
NODE_24528_length_605_cov_33.328063	57	137	173	1	80	0.0125000
NODE_24528_length_605_cov_33.328063	57	137	174	1	80	0.0125000
NODE_24528_length_605_cov_33.328063	57	137	175	1	80	0.0125000
NODE_24528_length_605_cov_33.328063	57	137	178	1	80	0.0125000
NODE_24528_length_605_cov_33.328063	57	137	180	1	80	0.0125000
NODE_24528_length_605_cov_33.328063	57	137	187	1	80	0.0125000
NODE_24528_length_605_cov_33.328063	57	137	188	1	80	0.0125000
NODE_24528_length_605_cov_33.328063	57	137	191	1	80	0.0125000
NODE_24528_length_605_cov_33.328063	57	137	194	1	80	0.0125000
NODE_24528_length_605_cov_33.328063	57	137	195	3	80	0.0375000
NODE_24528_length_605_cov_33.328063	57	137	200	3	80	0.0375000
NODE_24528_length_605_cov_33.328063	57	137	202	1	80	0.0125000
NODE_24528_length_605_cov_33.328063	57	137	204	1	80	0.0125000
NODE_24528_length_605_cov_33.328063	57	137	208	1	80	0.0125000
NODE_24528_length_605_cov_33.328063	57	137	211	1	80	0.0125000
NODE_24528_length_605_cov_33.328063	57	137	212	1	80	0.0125000
NODE_24528_length_605_cov_33.328063	57	137	214	2	80	0.0250000
NODE_24528_length_605_cov_33.328063	57	137	216	1	80	0.0125000
NODE_24528_length_605_cov_33.328063	57	137	218	1	80	0.0125000
NODE_24528_length_605_cov_33.328063	57	137	220	2	80	0.0250000
NODE_24528_length_605_cov_33.328063	57	137	222	1	80	0.0125000
NODE_24528_length_605_cov_33.328063	57	137	224	1	80	0.0125000
NODE_24528_length_605_cov_33.328063	57	137	225	2	80	0.0250000
NODE_24528_length_605_cov_33.328063	57	137	226	1	80	0.0125000
NODE_24528_length_605_cov_33.328063	57	137	232	1	80	0.0125000
NODE_24528_length_605_cov_33.328063	57	137	234	1	80	0.0125000
NODE_24528_length_605_cov_33.328063	57	137	235	1	80	0.0125000
NODE_24528_length_605_cov_33.328063	57	137	236	1	80	0.0125000
NODE_24528_length_605_cov_33.328063	57	137	237	2	80	0.0250000
NODE_24528_length_605_cov_33.328063	57	137	238	1	80	0.0125000
NODE_24528_length_605_cov_33.328063	57	137	239	3	80	0.0375000
NODE_24528_length_605_cov_33.328063	57	137	240	3	80	0.0375000
NODE_24528_length_605_cov_33.328063	57	137	241	3	80	0.0375000
NODE_24528_length_605_cov_33.328063	57	137	242	2	80	0.0250000
NODE_24528_length_605_cov_33.328063	57	137	244	2	80	0.0250000
NODE_24528_length_605_cov_33.328063	57	137	245	1	80	0.0125000
NODE_24528_length_605_cov_33.328063	57	137	247	1	80	0.0125000
NODE_24528_length_605_cov_33.328063	57	137	250	1	80	0.0125000
NODE_24528_length_605_cov_33.328063	140	175	257	1	35	0.0285714
NODE_24528_length_605_cov_33.328063	140	175	262	1	35	0.0285714
NODE_24528_length_605_cov_33.328063	140	175	263	1	35	0.0285714
NODE_24528_length_605_cov_33.328063	140	175	264	2	35	0.0571429
NODE_24528_length_605_cov_33.328063	140	175	265	1	35	0.0285714
NODE_24528_length_605_cov_33.328063	140	175	266	3	35	0.0857143
NODE_24528_length_605_cov_33.328063	140	175	267	5	35	0.1428571
NODE_24528_length_605_cov_33.328063	140	175	268	3	35	0.0857143
NODE_24528_length_605_cov_33.328063	140	175	269	1	35	0.0285714
NODE_24528_length_605_cov_33.328063	140	175	270	2	35	0.0571429
NODE_24528_length_605_cov_33.328063	140	175	271	1	35	0.0285714
NODE_24528_length_605_cov_33.328063	140	175	272	3	35	0.0857143
NODE_24528_length_605_cov_33.328063	140	175	273	1	35	0.0285714
NODE_24528_length_605_cov_33.328063	140	175	274	4	35	0.1142857
NODE_24528_length_605_cov_33.328063	140	175	275	3	35	0.0857143
NODE_24528_length_605_cov_33.328063	140	175	276	2	35	0.0571429
NODE_24528_length_605_cov_33.328063	140	175	278	1	35	0.0285714
NODE_24529_length_605_cov_26.717391	353	433	1	80	80	1.0000000
NODE_24529_length_605_cov_26.717391	406	486	1	60	80	0.7500000
NODE_24529_length_605_cov_26.717391	406	486	2	20	80	0.2500000
NODE_24530_length_605_cov_17.677866	215	295	1	80	80	1.0000000
NODE_24530_length_605_cov_17.677866	268	348	0	29	80	0.3625000
NODE_24530_length_605_cov_17.677866	268	348	1	51	80	0.6375000
NODE_24531_length_605_cov_15.225296	144	224	0	80	80	1.0000000
NODE_24531_length_605_cov_15.225296	197	277	0	80	80	1.0000000
NODE_24532_length_605_cov_14.990119	136	216	4	38	80	0.4750000
NODE_24532_length_605_cov_14.990119	136	216	5	42	80	0.5250000
NODE_24532_length_605_cov_14.990119	189	269	3	1	80	0.0125000
NODE_24532_length_605_cov_14.990119	189	269	4	2	80	0.0250000
NODE_24532_length_605_cov_14.990119	189	269	5	77	80	0.9625000
NODE_24533_length_605_cov_10.835968	103	183	1	30	80	0.3750000
NODE_24533_length_605_cov_10.835968	103	183	2	1	80	0.0125000
NODE_24533_length_605_cov_10.835968	103	183	4	49	80	0.6125000
NODE_24533_length_605_cov_10.835968	156	236	3	26	80	0.3250000
NODE_24533_length_605_cov_10.835968	156	236	4	54	80	0.6750000
NODE_24534_length_605_cov_9.169960	306	377	2	32	71	0.4507042
NODE_24534_length_605_cov_9.169960	306	377	3	20	71	0.2816902
NODE_24534_length_605_cov_9.169960	306	377	4	19	71	0.2676056
NODE_24534_length_605_cov_9.169960	359	432	1	3	73	0.0410959
NODE_24534_length_605_cov_9.169960	359	432	2	70	73	0.9589041
NODE_24546_length_605_cov_4.308300	159	239	0	80	80	1.0000000
NODE_24546_length_605_cov_4.308300	271	338	2	11	67	0.1641791
NODE_24546_length_605_cov_4.308300	271	338	4	8	67	0.1194030
NODE_24546_length_605_cov_4.308300	271	338	8	12	67	0.1791045
NODE_24546_length_605_cov_4.308300	271	338	9	36	67	0.5373135
NODE_24546_length_605_cov_4.308300	275	350	2	7	75	0.0933333
NODE_24546_length_605_cov_4.308300	275	350	4	8	75	0.1066667
NODE_24546_length_605_cov_4.308300	275	350	7	6	75	0.0800000
NODE_24546_length_605_cov_4.308300	275	350	8	12	75	0.1600000
NODE_24546_length_605_cov_4.308300	275	350	9	42	75	0.5600000
NODE_24546_length_605_cov_4.308300	315	372	5	7	57	0.1228070
NODE_24546_length_605_cov_4.308300	315	372	7	21	57	0.3684210
NODE_24546_length_605_cov_4.308300	315	372	9	29	57	0.5087720
NODE_24546_length_605_cov_4.308300	328	373	5	8	45	0.1777778
NODE_24546_length_605_cov_4.308300	328	373	7	21	45	0.4666667
NODE_24546_length_605_cov_4.308300	328	373	9	16	45	0.3555556
NODE_24558_length_605_cov_3.120553	216	287	1	71	71	1.0000000
NODE_24561_length_605_cov_2.909091	408	487	9	7	79	0.0886076
NODE_24561_length_605_cov_2.909091	408	487	11	9	79	0.1139240
NODE_24561_length_605_cov_2.909091	408	487	13	8	79	0.1012658
NODE_24561_length_605_cov_2.909091	408	487	15	14	79	0.1772152
NODE_24561_length_605_cov_2.909091	408	487	16	28	79	0.3544304
NODE_24561_length_605_cov_2.909091	408	487	17	13	79	0.1645570
NODE_24577_length_605_cov_1.897233	230	273	0	43	43	1.0000000
NODE_24603_length_605_cov_1.339921	168	210	0	42	42	1.0000000
NODE_24636_length_604_cov_30.411881	93	173	0	2	80	0.0250000
NODE_24636_length_604_cov_30.411881	93	173	2	78	80	0.9750000
NODE_24636_length_604_cov_30.411881	146	226	0	30	80	0.3750000
NODE_24636_length_604_cov_30.411881	146	226	2	50	80	0.6250000
NODE_24637_length_604_cov_20.099010	414	494	1	7	80	0.0875000
NODE_24637_length_604_cov_20.099010	414	494	2	73	80	0.9125000
NODE_24637_length_604_cov_20.099010	467	547	0	1	80	0.0125000
NODE_24637_length_604_cov_20.099010	467	547	1	59	80	0.7375000
NODE_24637_length_604_cov_20.099010	467	547	2	20	80	0.2500000
NODE_24639_length_604_cov_10.291089	184	264	0	80	80	1.0000000
NODE_24639_length_604_cov_10.291089	237	317	0	80	80	1.0000000
NODE_24646_length_604_cov_6.033663	265	345	3	17	80	0.2125000
NODE_24646_length_604_cov_6.033663	265	345	4	31	80	0.3875000
NODE_24646_length_604_cov_6.033663	265	345	5	32	80	0.4000000
NODE_24646_length_604_cov_6.033663	318	397	3	26	79	0.3291139
NODE_24646_length_604_cov_6.033663	318	397	4	44	79	0.5569620
NODE_24646_length_604_cov_6.033663	318	397	5	9	79	0.1139240
NODE_24654_length_604_cov_4.316832	40	106	0	66	66	1.0000000
NODE_24654_length_604_cov_4.316832	377	435	0	58	58	1.0000000
NODE_24692_length_604_cov_1.805941	299	380	0	81	81	1.0000000
NODE_24692_length_604_cov_1.805941	353	433	0	80	80	1.0000000
NODE_24732_length_603_cov_18.761905	108	188	0	80	80	1.0000000
NODE_24732_length_603_cov_18.761905	161	241	0	80	80	1.0000000
NODE_24734_length_603_cov_8.996032	163	243	0	21	80	0.2625000
NODE_24734_length_603_cov_8.996032	163	243	1	21	80	0.2625000
NODE_24734_length_603_cov_8.996032	163	243	2	38	80	0.4750000
NODE_24734_length_603_cov_8.996032	216	296	2	43	80	0.5375000
NODE_24734_length_603_cov_8.996032	216	296	3	37	80	0.4625000
NODE_24735_length_603_cov_8.970238	413	493	1	56	80	0.7000000
NODE_24735_length_603_cov_8.970238	413	493	2	24	80	0.3000000
NODE_24736_length_603_cov_7.212302	324	404	0	80	80	1.0000000
NODE_24736_length_603_cov_7.212302	377	457	0	80	80	1.0000000
NODE_24739_length_603_cov_5.831349	351	385	0	34	34	1.0000000
NODE_24744_length_603_cov_4.744048	103	183	3	71	80	0.8875000
NODE_24744_length_603_cov_4.744048	103	183	4	9	80	0.1125000
NODE_24744_length_603_cov_4.744048	156	236	1	12	80	0.1500000
NODE_24744_length_603_cov_4.744048	156	236	2	11	80	0.1375000
NODE_24744_length_603_cov_4.744048	156	236	3	57	80	0.7125000
NODE_24748_length_603_cov_4.115079	219	259	0	40	40	1.0000000
NODE_24755_length_603_cov_3.269841	186	223	0	37	37	1.0000000
NODE_24755_length_603_cov_3.269841	196	276	0	80	80	1.0000000
NODE_24755_length_603_cov_3.269841	367	441	0	74	74	1.0000000
NODE_24843_length_602_cov_33.208748	106	186	2	47	80	0.5875000
NODE_24843_length_602_cov_33.208748	106	186	4	33	80	0.4125000
NODE_24843_length_602_cov_33.208748	159	239	3	6	80	0.0750000
NODE_24843_length_602_cov_33.208748	159	239	4	45	80	0.5625000
NODE_24843_length_602_cov_33.208748	159	239	5	7	80	0.0875000
NODE_24843_length_602_cov_33.208748	159	239	6	22	80	0.2750000
NODE_24844_length_602_cov_28.922465	319	399	2	44	80	0.5500000
NODE_24844_length_602_cov_28.922465	319	399	3	36	80	0.4500000
NODE_24844_length_602_cov_28.922465	372	452	2	43	80	0.5375000
NODE_24844_length_602_cov_28.922465	372	452	3	37	80	0.4625000
NODE_24846_length_602_cov_10.930417	248	328	0	80	80	1.0000000
NODE_24846_length_602_cov_10.930417	301	381	0	80	80	1.0000000
NODE_24847_length_602_cov_10.447316	148	207	3	8	59	0.1355932
NODE_24847_length_602_cov_10.447316	148	207	4	13	59	0.2203390
NODE_24847_length_602_cov_10.447316	148	207	5	30	59	0.5084746
NODE_24847_length_602_cov_10.447316	148	207	6	8	59	0.1355932
NODE_24847_length_602_cov_10.447316	181	207	5	23	26	0.8846154
NODE_24847_length_602_cov_10.447316	181	207	6	3	26	0.1153846
NODE_24847_length_602_cov_10.447316	259	291	11	20	32	0.6250000
NODE_24847_length_602_cov_10.447316	259	291	12	2	32	0.0625000
NODE_24847_length_602_cov_10.447316	259	291	13	10	32	0.3125000
NODE_24851_length_602_cov_7.787276	544	565	0	21	21	1.0000000
NODE_24875_length_602_cov_3.332008	157	239	2	82	82	1.0000000
NODE_24957_length_601_cov_14.952191	183	263	0	52	80	0.6500000
NODE_24957_length_601_cov_14.952191	183	263	1	1	80	0.0125000
NODE_24957_length_601_cov_14.952191	183	263	2	23	80	0.2875000
NODE_24957_length_601_cov_14.952191	183	263	4	2	80	0.0250000
NODE_24957_length_601_cov_14.952191	183	263	5	2	80	0.0250000
NODE_24957_length_601_cov_14.952191	236	316	2	23	80	0.2875000
NODE_24957_length_601_cov_14.952191	236	316	4	2	80	0.0250000
NODE_24957_length_601_cov_14.952191	236	316	5	55	80	0.6875000
NODE_24958_length_601_cov_14.747012	324	404	2	56	80	0.7000000
NODE_24958_length_601_cov_14.747012	324	404	3	24	80	0.3000000
NODE_24958_length_601_cov_14.747012	377	457	2	66	80	0.8250000
NODE_24958_length_601_cov_14.747012	377	457	3	14	80	0.1750000
NODE_24959_length_601_cov_11.561753	226	306	2	17	80	0.2125000
NODE_24959_length_601_cov_11.561753	226	306	3	63	80	0.7875000
NODE_24959_length_601_cov_11.561753	279	359	2	37	80	0.4625000
NODE_24959_length_601_cov_11.561753	279	359	3	43	80	0.5375000
NODE_24960_length_601_cov_10.826693	320	388	1	65	68	0.9558824
NODE_24960_length_601_cov_10.826693	320	388	2	3	68	0.0441176
NODE_24961_length_601_cov_10.392430	243	323	0	80	80	1.0000000
NODE_24961_length_601_cov_10.392430	296	375	0	79	79	1.0000000
NODE_24965_length_601_cov_7.037849	236	316	1	5	80	0.0625000
NODE_24965_length_601_cov_7.037849	236	316	2	75	80	0.9375000
NODE_24965_length_601_cov_7.037849	289	369	1	58	80	0.7250000
NODE_24965_length_601_cov_7.037849	289	369	2	22	80	0.2750000
NODE_24969_length_601_cov_5.798805	290	361	0	71	71	1.0000000
NODE_24970_length_601_cov_5.657371	228	308	0	76	80	0.9500000
NODE_24970_length_601_cov_5.657371	228	308	2	4	80	0.0500000
NODE_24973_length_601_cov_5.039841	395	462	7	19	67	0.2835821
NODE_24973_length_601_cov_5.039841	395	462	8	9	67	0.1343284
NODE_24973_length_601_cov_5.039841	395	462	9	25	67	0.3731343
NODE_24973_length_601_cov_5.039841	395	462	10	7	67	0.1044776
NODE_24973_length_601_cov_5.039841	395	462	11	7	67	0.1044776
NODE_24975_length_601_cov_4.735060	184	247	0	63	63	1.0000000
NODE_24995_length_601_cov_2.599602	371	430	3	20	59	0.3389831
NODE_24995_length_601_cov_2.599602	371	430	5	36	59	0.6101695
NODE_24995_length_601_cov_2.599602	371	430	6	3	59	0.0508475
NODE_24995_length_601_cov_2.599602	441	494	5	53	53	1.0000000
NODE_25090_length_600_cov_6.341317	125	147	0	22	22	1.0000000
NODE_25103_length_600_cov_3.754491	142	222	0	14	80	0.1750000
NODE_25103_length_600_cov_3.754491	142	222	1	3	80	0.0375000
NODE_25103_length_600_cov_3.754491	142	222	2	47	80	0.5875000
NODE_25103_length_600_cov_3.754491	142	222	3	16	80	0.2000000
NODE_25126_length_600_cov_2.081836	282	328	0	46	46	1.0000000
NODE_25141_length_600_cov_1.728543	381	423	0	42	42	1.0000000
NODE_25190_length_599_cov_36.488000	25	105	5	10	80	0.1250000
NODE_25190_length_599_cov_36.488000	25	105	6	70	80	0.8750000
NODE_25191_length_599_cov_27.870000	255	335	0	38	80	0.4750000
NODE_25191_length_599_cov_27.870000	255	335	1	42	80	0.5250000
NODE_25191_length_599_cov_27.870000	308	388	1	80	80	1.0000000
NODE_25192_length_599_cov_22.640000	229	309	5	80	80	1.0000000
NODE_25192_length_599_cov_22.640000	229	309	5	80	80	1.0000000
NODE_25192_length_599_cov_22.640000	229	309	5	80	80	1.0000000
NODE_25192_length_599_cov_22.640000	229	309	5	80	80	1.0000000
NODE_25192_length_599_cov_22.640000	229	309	5	80	80	1.0000000
NODE_25192_length_599_cov_22.640000	282	362	0	7	80	0.0875000
NODE_25192_length_599_cov_22.640000	282	362	1	4	80	0.0500000
NODE_25192_length_599_cov_22.640000	282	362	2	5	80	0.0625000
NODE_25192_length_599_cov_22.640000	282	362	3	4	80	0.0500000
NODE_25192_length_599_cov_22.640000	282	362	4	7	80	0.0875000
NODE_25192_length_599_cov_22.640000	282	362	5	53	80	0.6625000
NODE_25192_length_599_cov_22.640000	282	362	0	7	80	0.0875000
NODE_25192_length_599_cov_22.640000	282	362	1	4	80	0.0500000
NODE_25192_length_599_cov_22.640000	282	362	2	5	80	0.0625000
NODE_25192_length_599_cov_22.640000	282	362	3	4	80	0.0500000
NODE_25192_length_599_cov_22.640000	282	362	4	7	80	0.0875000
NODE_25192_length_599_cov_22.640000	282	362	5	53	80	0.6625000
NODE_25192_length_599_cov_22.640000	282	353	1	2	71	0.0281690
NODE_25192_length_599_cov_22.640000	282	353	2	5	71	0.0704225
NODE_25192_length_599_cov_22.640000	282	353	3	4	71	0.0563380
NODE_25192_length_599_cov_22.640000	282	353	4	7	71	0.0985916
NODE_25192_length_599_cov_22.640000	282	353	5	53	71	0.7464789
NODE_25192_length_599_cov_22.640000	285	355	1	4	70	0.0571429
NODE_25192_length_599_cov_22.640000	285	355	2	5	70	0.0714286
NODE_25192_length_599_cov_22.640000	285	355	3	4	70	0.0571429
NODE_25192_length_599_cov_22.640000	285	355	4	7	70	0.1000000
NODE_25192_length_599_cov_22.640000	285	355	5	50	70	0.7142857
NODE_25192_length_599_cov_22.640000	287	362	0	7	75	0.0933333
NODE_25192_length_599_cov_22.640000	287	362	1	4	75	0.0533333
NODE_25192_length_599_cov_22.640000	287	362	2	5	75	0.0666667
NODE_25192_length_599_cov_22.640000	287	362	3	4	75	0.0533333
NODE_25192_length_599_cov_22.640000	287	362	4	7	75	0.0933333
NODE_25192_length_599_cov_22.640000	287	362	5	48	75	0.6400000
NODE_25193_length_599_cov_14.618000	279	359	0	80	80	1.0000000
NODE_25193_length_599_cov_14.618000	332	412	0	80	80	1.0000000
NODE_25195_length_599_cov_10.308000	245	325	2	35	80	0.4375000
NODE_25195_length_599_cov_10.308000	245	325	3	45	80	0.5625000
NODE_25195_length_599_cov_10.308000	298	378	1	2	80	0.0250000
NODE_25195_length_599_cov_10.308000	298	378	2	78	80	0.9750000
NODE_25196_length_599_cov_9.224000	160	240	0	56	80	0.7000000
NODE_25196_length_599_cov_9.224000	160	240	1	24	80	0.3000000
NODE_25196_length_599_cov_9.224000	213	297	0	84	84	1.0000000
NODE_25201_length_599_cov_5.536000	58	112	0	49	54	0.9074074
NODE_25201_length_599_cov_5.536000	58	112	1	5	54	0.0925926
NODE_25208_length_599_cov_3.810000	271	334	0	54	63	0.8571429
NODE_25208_length_599_cov_3.810000	271	334	4	9	63	0.1428571
NODE_25208_length_599_cov_3.810000	324	390	0	1	66	0.0151515
NODE_25208_length_599_cov_3.810000	324	390	4	17	66	0.2575758
NODE_25208_length_599_cov_3.810000	324	390	6	48	66	0.7272727
NODE_25211_length_599_cov_3.598000	238	318	0	14	80	0.1750000
NODE_25211_length_599_cov_3.598000	238	318	1	66	80	0.8250000
NODE_25211_length_599_cov_3.598000	291	371	1	80	80	1.0000000
NODE_25308_length_598_cov_54.450902	264	344	0	80	80	1.0000000
NODE_25308_length_598_cov_54.450902	317	397	0	74	80	0.9250000
NODE_25308_length_598_cov_54.450902	317	397	1	6	80	0.0750000
NODE_25309_length_598_cov_8.326653	204	284	0	80	80	1.0000000
NODE_25309_length_598_cov_8.326653	257	337	0	80	80	1.0000000
NODE_25316_length_598_cov_5.623246	169	240	1	34	71	0.4788733
NODE_25316_length_598_cov_5.623246	169	240	2	1	71	0.0140845
NODE_25316_length_598_cov_5.623246	169	240	3	28	71	0.3943662
NODE_25316_length_598_cov_5.623246	169	240	5	8	71	0.1126761
NODE_25320_length_598_cov_4.929860	73	153	0	80	80	1.0000000
NODE_25320_length_598_cov_4.929860	126	206	0	80	80	1.0000000
NODE_25421_length_597_cov_15.142570	197	277	2	80	80	1.0000000
NODE_25421_length_597_cov_15.142570	250	330	0	53	80	0.6625000
NODE_25421_length_597_cov_15.142570	250	330	2	27	80	0.3375000
NODE_25422_length_597_cov_12.387550	118	198	1	75	80	0.9375000
NODE_25422_length_597_cov_12.387550	118	198	2	5	80	0.0625000
NODE_25422_length_597_cov_12.387550	171	251	1	31	80	0.3875000
NODE_25422_length_597_cov_12.387550	171	251	2	49	80	0.6125000
NODE_25423_length_597_cov_7.016064	213	293	0	80	80	1.0000000
NODE_25423_length_597_cov_7.016064	266	346	0	80	80	1.0000000
NODE_25426_length_597_cov_6.212851	374	449	5	42	75	0.5600000
NODE_25426_length_597_cov_6.212851	374	449	6	16	75	0.2133333
NODE_25426_length_597_cov_6.212851	374	449	7	17	75	0.2266667
NODE_25434_length_597_cov_4.273092	368	448	0	46	80	0.5750000
NODE_25434_length_597_cov_4.273092	368	448	1	34	80	0.4250000
NODE_25434_length_597_cov_4.273092	421	507	1	86	86	1.0000000
NODE_25464_length_597_cov_2.162651	92	172	0	80	80	1.0000000
NODE_25464_length_597_cov_2.162651	145	225	0	80	80	1.0000000
NODE_25467_length_597_cov_2.096386	440	509	1	52	69	0.7536232
NODE_25467_length_597_cov_2.096386	440	509	3	17	69	0.2463768
NODE_25469_length_597_cov_1.977912	392	472	2	19	80	0.2375000
NODE_25469_length_597_cov_1.977912	392	472	3	1	80	0.0125000
NODE_25469_length_597_cov_1.977912	392	472	4	1	80	0.0125000
NODE_25469_length_597_cov_1.977912	392	472	6	33	80	0.4125000
NODE_25469_length_597_cov_1.977912	392	472	8	7	80	0.0875000
NODE_25469_length_597_cov_1.977912	392	472	9	19	80	0.2375000
NODE_25469_length_597_cov_1.977912	437	494	6	9	57	0.1578947
NODE_25469_length_597_cov_1.977912	437	494	8	7	57	0.1228070
NODE_25469_length_597_cov_1.977912	437	494	9	41	57	0.7192982
NODE_25469_length_597_cov_1.977912	445	525	6	1	80	0.0125000
NODE_25469_length_597_cov_1.977912	445	525	7	27	80	0.3375000
NODE_25469_length_597_cov_1.977912	445	525	8	7	80	0.0875000
NODE_25469_length_597_cov_1.977912	445	525	9	45	80	0.5625000
NODE_25552_length_596_cov_32.293763	221	301	1	80	80	1.0000000
NODE_25552_length_596_cov_32.293763	274	354	0	43	80	0.5375000
NODE_25552_length_596_cov_32.293763	274	354	1	37	80	0.4625000
NODE_25552_length_596_cov_32.293763	351	406	1	37	55	0.6727273
NODE_25552_length_596_cov_32.293763	351	406	2	18	55	0.3272727
NODE_25552_length_596_cov_32.293763	381	459	1	7	78	0.0897436
NODE_25552_length_596_cov_32.293763	381	459	2	71	78	0.9102564
NODE_25553_length_596_cov_26.891348	199	279	4	48	80	0.6000000
NODE_25553_length_596_cov_26.891348	199	279	5	32	80	0.4000000
NODE_25553_length_596_cov_26.891348	252	332	3	41	80	0.5125000
NODE_25553_length_596_cov_26.891348	252	332	4	33	80	0.4125000
NODE_25553_length_596_cov_26.891348	252	332	5	6	80	0.0750000
NODE_25554_length_596_cov_17.082495	179	259	0	80	80	1.0000000
NODE_25554_length_596_cov_17.082495	232	312	0	80	80	1.0000000
NODE_25555_length_596_cov_10.372233	354	434	2	20	80	0.2500000
NODE_25555_length_596_cov_10.372233	354	434	3	60	80	0.7500000
NODE_25555_length_596_cov_10.372233	407	487	3	80	80	1.0000000
NODE_25557_length_596_cov_6.955734	142	222	0	80	80	1.0000000
NODE_25558_length_596_cov_6.225352	242	322	0	80	80	1.0000000
NODE_25558_length_596_cov_6.225352	308	375	0	67	67	1.0000000
NODE_25567_length_596_cov_4.197183	369	444	0	18	75	0.2400000
NODE_25567_length_596_cov_4.197183	369	444	1	4	75	0.0533333
NODE_25567_length_596_cov_4.197183	369	444	2	25	75	0.3333333
NODE_25567_length_596_cov_4.197183	369	444	3	28	75	0.3733333
NODE_25593_length_596_cov_2.066398	534	583	0	49	49	1.0000000
NODE_25666_length_595_cov_52.532258	248	328	1	12	80	0.1500000
NODE_25666_length_595_cov_52.532258	248	328	2	68	80	0.8500000
NODE_25666_length_595_cov_52.532258	301	381	0	9	80	0.1125000
NODE_25666_length_595_cov_52.532258	301	381	2	71	80	0.8875000
NODE_25667_length_595_cov_38.584677	122	202	0	9	80	0.1125000
NODE_25667_length_595_cov_38.584677	122	202	2	71	80	0.8875000
NODE_25667_length_595_cov_38.584677	175	255	0	1	80	0.0125000
NODE_25667_length_595_cov_38.584677	175	255	2	79	80	0.9875000
NODE_25669_length_595_cov_10.576613	323	403	3	9	80	0.1125000
NODE_25669_length_595_cov_10.576613	323	403	4	71	80	0.8875000
NODE_25669_length_595_cov_10.576613	376	456	2	8	80	0.1000000
NODE_25669_length_595_cov_10.576613	376	456	3	40	80	0.5000000
NODE_25669_length_595_cov_10.576613	376	456	4	32	80	0.4000000
NODE_25672_length_595_cov_7.917339	342	415	0	23	73	0.3150685
NODE_25672_length_595_cov_7.917339	342	415	1	21	73	0.2876712
NODE_25672_length_595_cov_7.917339	342	415	2	29	73	0.3972603
NODE_25672_length_595_cov_7.917339	388	438	0	46	50	0.9200000
NODE_25672_length_595_cov_7.917339	388	438	1	4	50	0.0800000
NODE_25702_length_595_cov_2.792339	178	258	0	80	80	1.0000000
NODE_25702_length_595_cov_2.792339	231	311	0	80	80	1.0000000
NODE_25807_length_594_cov_34.157576	283	363	5	80	80	1.0000000
NODE_25807_length_594_cov_34.157576	336	416	1	41	80	0.5125000
NODE_25807_length_594_cov_34.157576	336	416	3	2	80	0.0250000
NODE_25807_length_594_cov_34.157576	336	416	4	2	80	0.0250000
NODE_25807_length_594_cov_34.157576	336	416	5	35	80	0.4375000
NODE_25811_length_594_cov_8.933333	258	338	0	80	80	1.0000000
NODE_25811_length_594_cov_8.933333	311	389	0	78	78	1.0000000
NODE_25815_length_594_cov_5.759596	82	118	0	36	36	1.0000000
NODE_25815_length_594_cov_5.759596	114	194	0	10	80	0.1250000
NODE_25815_length_594_cov_5.759596	114	194	1	70	80	0.8750000
NODE_25815_length_594_cov_5.759596	167	242	1	75	75	1.0000000
NODE_25825_length_594_cov_3.913131	275	355	0	63	80	0.7875000
NODE_25825_length_594_cov_3.913131	275	355	2	17	80	0.2125000
NODE_25844_length_594_cov_2.470707	209	247	1	25	38	0.6578947
NODE_25844_length_594_cov_2.470707	209	247	2	13	38	0.3421053
NODE_25919_length_594_cov_0.698990	33	73	0	40	40	1.0000000
NODE_25928_length_593_cov_124.985830	247	285	158	1	38	0.0263158
NODE_25928_length_593_cov_124.985830	247	285	159	1	38	0.0263158
NODE_25928_length_593_cov_124.985830	247	285	161	2	38	0.0526316
NODE_25928_length_593_cov_124.985830	247	285	163	2	38	0.0526316
NODE_25928_length_593_cov_124.985830	247	285	164	3	38	0.0789474
NODE_25928_length_593_cov_124.985830	247	285	172	1	38	0.0263158
NODE_25928_length_593_cov_124.985830	247	285	174	1	38	0.0263158
NODE_25928_length_593_cov_124.985830	247	285	176	1	38	0.0263158
NODE_25928_length_593_cov_124.985830	247	285	179	1	38	0.0263158
NODE_25928_length_593_cov_124.985830	247	285	184	1	38	0.0263158
NODE_25928_length_593_cov_124.985830	247	285	186	1	38	0.0263158
NODE_25928_length_593_cov_124.985830	247	285	188	1	38	0.0263158
NODE_25928_length_593_cov_124.985830	247	285	196	2	38	0.0526316
NODE_25928_length_593_cov_124.985830	247	285	203	1	38	0.0263158
NODE_25928_length_593_cov_124.985830	247	285	204	1	38	0.0263158
NODE_25928_length_593_cov_124.985830	247	285	205	4	38	0.1052632
NODE_25928_length_593_cov_124.985830	247	285	209	1	38	0.0263158
NODE_25928_length_593_cov_124.985830	247	285	210	1	38	0.0263158
NODE_25928_length_593_cov_124.985830	247	285	219	2	38	0.0526316
NODE_25928_length_593_cov_124.985830	247	285	220	1	38	0.0263158
NODE_25928_length_593_cov_124.985830	247	285	223	1	38	0.0263158
NODE_25928_length_593_cov_124.985830	247	285	229	1	38	0.0263158
NODE_25928_length_593_cov_124.985830	247	285	230	1	38	0.0263158
NODE_25928_length_593_cov_124.985830	247	285	231	2	38	0.0526316
NODE_25928_length_593_cov_124.985830	247	285	232	1	38	0.0263158
NODE_25928_length_593_cov_124.985830	247	285	233	1	38	0.0263158
NODE_25928_length_593_cov_124.985830	247	285	234	1	38	0.0263158
NODE_25928_length_593_cov_124.985830	247	285	236	1	38	0.0263158
NODE_25929_length_593_cov_36.161943	150	230	0	39	80	0.4875000
NODE_25929_length_593_cov_36.161943	150	230	2	41	80	0.5125000
NODE_25929_length_593_cov_36.161943	203	283	2	80	80	1.0000000
NODE_25930_length_593_cov_14.979757	219	299	0	80	80	1.0000000
NODE_25930_length_593_cov_14.979757	272	352	0	80	80	1.0000000
NODE_25931_length_593_cov_11.018219	324	404	1	80	80	1.0000000
NODE_25931_length_593_cov_11.018219	377	457	0	38	80	0.4750000
NODE_25931_length_593_cov_11.018219	377	457	1	42	80	0.5250000
NODE_25946_length_593_cov_3.232794	210	273	0	60	63	0.9523810
NODE_25946_length_593_cov_3.232794	210	273	1	3	63	0.0476190
NODE_25946_length_593_cov_3.232794	263	326	0	7	63	0.1111111
NODE_25946_length_593_cov_3.232794	263	326	1	56	63	0.8888889
NODE_25996_length_593_cov_1.261134	227	249	0	22	22	1.0000000
NODE_26033_length_592_cov_18.908722	163	243	0	13	80	0.1625000
NODE_26033_length_592_cov_18.908722	163	243	2	67	80	0.8375000
NODE_26033_length_592_cov_18.908722	230	296	0	66	66	1.0000000
NODE_26034_length_592_cov_7.531440	232	312	3	7	80	0.0875000
NODE_26034_length_592_cov_7.531440	232	312	4	33	80	0.4125000
NODE_26034_length_592_cov_7.531440	232	312	5	35	80	0.4375000
NODE_26034_length_592_cov_7.531440	232	312	6	5	80	0.0625000
NODE_26034_length_592_cov_7.531440	285	361	3	4	76	0.0526316
NODE_26034_length_592_cov_7.531440	285	361	4	68	76	0.8947368
NODE_26034_length_592_cov_7.531440	285	361	5	4	76	0.0526316
NODE_26035_length_592_cov_7.000000	77	157	2	80	80	1.0000000
NODE_26035_length_592_cov_7.000000	130	210	0	49	80	0.6125000
NODE_26035_length_592_cov_7.000000	130	210	2	31	80	0.3875000
NODE_26040_length_592_cov_5.036511	270	349	1	58	79	0.7341772
NODE_26040_length_592_cov_5.036511	270	349	2	21	79	0.2658228
NODE_26041_length_592_cov_5.024341	205	285	2	9	80	0.1125000
NODE_26041_length_592_cov_5.024341	205	285	4	13	80	0.1625000
NODE_26041_length_592_cov_5.024341	205	285	5	2	80	0.0250000
NODE_26041_length_592_cov_5.024341	205	285	7	41	80	0.5125000
NODE_26041_length_592_cov_5.024341	205	285	9	15	80	0.1875000
NODE_26041_length_592_cov_5.024341	258	309	7	12	51	0.2352941
NODE_26041_length_592_cov_5.024341	258	309	9	39	51	0.7647059
NODE_26062_length_592_cov_2.866126	61	127	0	66	66	1.0000000
NODE_26069_length_592_cov_2.361055	476	526	0	2	50	0.0400000
NODE_26069_length_592_cov_2.361055	476	526	2	27	50	0.5400000
NODE_26069_length_592_cov_2.361055	476	526	4	21	50	0.4200000
NODE_26142_length_591_cov_11.286585	245	325	0	80	80	1.0000000
NODE_26142_length_591_cov_11.286585	298	378	0	80	80	1.0000000
NODE_26143_length_591_cov_9.432927	241	321	0	45	80	0.5625000
NODE_26143_length_591_cov_9.432927	241	321	2	35	80	0.4375000
NODE_26143_length_591_cov_9.432927	294	374	2	80	80	1.0000000
NODE_26184_length_591_cov_2.365854	396	476	0	80	80	1.0000000
NODE_26184_length_591_cov_2.365854	449	529	0	80	80	1.0000000
NODE_26272_length_590_cov_29.661914	26	106	2	8	80	0.1000000
NODE_26272_length_590_cov_29.661914	26	106	3	4	80	0.0500000
NODE_26272_length_590_cov_29.661914	26	106	4	12	80	0.1500000
NODE_26272_length_590_cov_29.661914	26	106	5	22	80	0.2750000
NODE_26272_length_590_cov_29.661914	26	106	6	34	80	0.4250000
NODE_26272_length_590_cov_29.661914	79	159	6	52	80	0.6500000
NODE_26272_length_590_cov_29.661914	79	159	7	28	80	0.3500000
NODE_26272_length_590_cov_29.661914	155	235	3	13	80	0.1625000
NODE_26272_length_590_cov_29.661914	155	235	4	22	80	0.2750000
NODE_26272_length_590_cov_29.661914	155	235	5	12	80	0.1500000
NODE_26272_length_590_cov_29.661914	155	235	6	17	80	0.2125000
NODE_26272_length_590_cov_29.661914	155	235	7	16	80	0.2000000
NODE_26272_length_590_cov_29.661914	208	288	3	41	80	0.5125000
NODE_26272_length_590_cov_29.661914	208	288	4	39	80	0.4875000
NODE_26273_length_590_cov_21.360489	178	258	0	26	80	0.3250000
NODE_26273_length_590_cov_21.360489	178	258	2	54	80	0.6750000
NODE_26273_length_590_cov_21.360489	231	311	2	80	80	1.0000000
NODE_26274_length_590_cov_18.395112	161	241	0	80	80	1.0000000
NODE_26274_length_590_cov_18.395112	214	294	0	80	80	1.0000000
NODE_26275_length_590_cov_17.376782	238	318	2	80	80	1.0000000
NODE_26275_length_590_cov_17.376782	291	371	0	37	80	0.4625000
NODE_26275_length_590_cov_17.376782	291	371	2	43	80	0.5375000
NODE_26279_length_590_cov_6.205703	262	333	4	8	71	0.1126761
NODE_26279_length_590_cov_6.205703	262	333	5	31	71	0.4366197
NODE_26279_length_590_cov_6.205703	262	333	6	32	71	0.4507042
NODE_26283_length_590_cov_5.319756	224	304	2	80	80	1.0000000
NODE_26283_length_590_cov_5.319756	277	357	0	18	80	0.2250000
NODE_26283_length_590_cov_5.319756	277	357	2	62	80	0.7750000
NODE_26366_length_590_cov_0.971487	0	32	0	32	32	1.0000000
NODE_26390_length_589_cov_15.810204	384	464	0	80	80	1.0000000
NODE_26390_length_589_cov_15.810204	437	517	0	80	80	1.0000000
NODE_26391_length_589_cov_13.855102	320	400	1	28	80	0.3500000
NODE_26391_length_589_cov_13.855102	320	400	2	52	80	0.6500000
NODE_26391_length_589_cov_13.855102	373	453	1	40	80	0.5000000
NODE_26391_length_589_cov_13.855102	373	453	2	40	80	0.5000000
NODE_26395_length_589_cov_6.297959	186	266	0	13	80	0.1625000
NODE_26395_length_589_cov_6.297959	186	266	1	67	80	0.8375000
NODE_26395_length_589_cov_6.297959	239	319	1	36	80	0.4500000
NODE_26395_length_589_cov_6.297959	239	319	2	44	80	0.5500000
NODE_26430_length_589_cov_2.320408	431	511	4	18	80	0.2250000
NODE_26430_length_589_cov_2.320408	431	511	5	19	80	0.2375000
NODE_26430_length_589_cov_2.320408	431	511	6	11	80	0.1375000
NODE_26430_length_589_cov_2.320408	431	511	7	28	80	0.3500000
NODE_26430_length_589_cov_2.320408	431	511	8	4	80	0.0500000
NODE_26515_length_588_cov_49.936605	264	341	1	41	77	0.5324675
NODE_26515_length_588_cov_49.936605	264	341	2	36	77	0.4675325
NODE_26515_length_588_cov_49.936605	314	394	2	80	80	1.0000000
NODE_26516_length_588_cov_33.691207	273	353	0	80	80	1.0000000
NODE_26516_length_588_cov_33.691207	326	406	0	80	80	1.0000000
NODE_26517_length_588_cov_16.564417	245	325	0	61	80	0.7625000
NODE_26517_length_588_cov_16.564417	245	325	2	19	80	0.2375000
NODE_26517_length_588_cov_16.564417	298	378	0	8	80	0.1000000
NODE_26517_length_588_cov_16.564417	298	378	2	72	80	0.9000000
NODE_26518_length_588_cov_14.595092	266	346	2	34	80	0.4250000
NODE_26518_length_588_cov_14.595092	266	346	3	46	80	0.5750000
NODE_26518_length_588_cov_14.595092	319	399	2	61	80	0.7625000
NODE_26518_length_588_cov_14.595092	319	399	3	19	80	0.2375000
NODE_26522_length_588_cov_7.439673	155	235	0	80	80	1.0000000
NODE_26522_length_588_cov_7.439673	208	288	0	80	80	1.0000000
NODE_26523_length_588_cov_7.094070	191	263	0	72	72	1.0000000
NODE_26523_length_588_cov_7.094070	244	310	0	66	66	1.0000000
NODE_26523_length_588_cov_7.094070	439	519	0	80	80	1.0000000
NODE_26523_length_588_cov_7.094070	492	572	0	80	80	1.0000000
NODE_26534_length_588_cov_4.167689	65	122	0	57	57	1.0000000
NODE_26634_length_587_cov_39.782787	123	203	2	80	80	1.0000000
NODE_26634_length_587_cov_39.782787	176	256	0	9	80	0.1125000
NODE_26634_length_587_cov_39.782787	176	256	2	71	80	0.8875000
NODE_26634_length_587_cov_39.782787	252	332	0	80	80	1.0000000
NODE_26634_length_587_cov_39.782787	305	385	0	80	80	1.0000000
NODE_26635_length_587_cov_31.807377	141	221	0	80	80	1.0000000
NODE_26635_length_587_cov_31.807377	194	274	0	80	80	1.0000000
NODE_26636_length_587_cov_12.629098	219	299	0	80	80	1.0000000
NODE_26636_length_587_cov_12.629098	272	352	0	80	80	1.0000000
NODE_26639_length_587_cov_9.067623	203	283	0	80	80	1.0000000
NODE_26639_length_587_cov_9.067623	256	336	0	80	80	1.0000000
NODE_26640_length_587_cov_8.411885	253	311	3	14	58	0.2413793
NODE_26640_length_587_cov_8.411885	253	311	4	28	58	0.4827586
NODE_26640_length_587_cov_8.411885	253	311	5	5	58	0.0862069
NODE_26640_length_587_cov_8.411885	253	311	6	11	58	0.1896552
NODE_26656_length_587_cov_3.231557	201	256	3	36	55	0.6545454
NODE_26656_length_587_cov_3.231557	201	256	4	19	55	0.3454545
NODE_26665_length_587_cov_2.850410	255	288	2	28	33	0.8484849
NODE_26665_length_587_cov_2.850410	255	288	4	5	33	0.1515152
NODE_26749_length_586_cov_37.843943	268	348	0	80	80	1.0000000
NODE_26749_length_586_cov_37.843943	321	401	0	80	80	1.0000000
NODE_26749_length_586_cov_37.843943	397	477	0	80	80	1.0000000
NODE_26749_length_586_cov_37.843943	450	531	0	81	81	1.0000000
NODE_26750_length_586_cov_12.831622	186	266	0	9	80	0.1125000
NODE_26750_length_586_cov_12.831622	186	266	2	71	80	0.8875000
NODE_26750_length_586_cov_12.831622	239	319	0	62	80	0.7750000
NODE_26750_length_586_cov_12.831622	239	319	2	18	80	0.2250000
NODE_26752_length_586_cov_11.264887	108	188	3	7	80	0.0875000
NODE_26752_length_586_cov_11.264887	108	188	4	14	80	0.1750000
NODE_26752_length_586_cov_11.264887	108	188	5	14	80	0.1750000
NODE_26752_length_586_cov_11.264887	108	188	7	45	80	0.5625000
NODE_26752_length_586_cov_11.264887	161	241	6	1	80	0.0125000
NODE_26752_length_586_cov_11.264887	161	241	7	69	80	0.8625000
NODE_26752_length_586_cov_11.264887	161	241	8	10	80	0.1250000
NODE_26754_length_586_cov_9.624230	299	360	1	11	61	0.1803279
NODE_26754_length_586_cov_9.624230	299	360	2	50	61	0.8196721
NODE_26754_length_586_cov_9.624230	299	360	1	11	61	0.1803279
NODE_26754_length_586_cov_9.624230	299	360	2	50	61	0.8196721
NODE_26754_length_586_cov_9.624230	299	360	1	11	61	0.1803279
NODE_26754_length_586_cov_9.624230	299	360	2	50	61	0.8196721
NODE_26754_length_586_cov_9.624230	301	360	1	11	59	0.1864407
NODE_26754_length_586_cov_9.624230	301	360	2	48	59	0.8135593
NODE_26756_length_586_cov_8.591376	273	353	0	80	80	1.0000000
NODE_26756_length_586_cov_8.591376	326	406	0	80	80	1.0000000
NODE_26758_length_586_cov_6.135524	334	375	0	41	41	1.0000000
NODE_26758_length_586_cov_6.135524	334	375	0	41	41	1.0000000
NODE_26760_length_586_cov_5.634497	150	230	0	80	80	1.0000000
NODE_26760_length_586_cov_5.634497	203	283	0	80	80	1.0000000
NODE_26765_length_586_cov_4.626283	296	362	0	66	66	1.0000000
NODE_26765_length_586_cov_4.626283	453	533	1	80	80	1.0000000
NODE_26885_length_585_cov_112.094650	456	536	59	1	80	0.0125000
NODE_26885_length_585_cov_112.094650	456	536	60	3	80	0.0375000
NODE_26885_length_585_cov_112.094650	456	536	61	1	80	0.0125000
NODE_26885_length_585_cov_112.094650	456	536	67	2	80	0.0250000
NODE_26885_length_585_cov_112.094650	456	536	69	1	80	0.0125000
NODE_26885_length_585_cov_112.094650	456	536	70	1	80	0.0125000
NODE_26885_length_585_cov_112.094650	456	536	72	3	80	0.0375000
NODE_26885_length_585_cov_112.094650	456	536	73	2	80	0.0250000
NODE_26885_length_585_cov_112.094650	456	536	74	3	80	0.0375000
NODE_26885_length_585_cov_112.094650	456	536	75	1	80	0.0125000
NODE_26885_length_585_cov_112.094650	456	536	76	1	80	0.0125000
NODE_26885_length_585_cov_112.094650	456	536	79	1	80	0.0125000
NODE_26885_length_585_cov_112.094650	456	536	80	1	80	0.0125000
NODE_26885_length_585_cov_112.094650	456	536	81	7	80	0.0875000
NODE_26885_length_585_cov_112.094650	456	536	82	1	80	0.0125000
NODE_26885_length_585_cov_112.094650	456	536	83	3	80	0.0375000
NODE_26885_length_585_cov_112.094650	456	536	84	3	80	0.0375000
NODE_26885_length_585_cov_112.094650	456	536	86	4	80	0.0500000
NODE_26885_length_585_cov_112.094650	456	536	89	2	80	0.0250000
NODE_26885_length_585_cov_112.094650	456	536	90	2	80	0.0250000
NODE_26885_length_585_cov_112.094650	456	536	91	1	80	0.0125000
NODE_26885_length_585_cov_112.094650	456	536	93	3	80	0.0375000
NODE_26885_length_585_cov_112.094650	456	536	94	1	80	0.0125000
NODE_26885_length_585_cov_112.094650	456	536	95	5	80	0.0625000
NODE_26885_length_585_cov_112.094650	456	536	96	4	80	0.0500000
NODE_26885_length_585_cov_112.094650	456	536	98	5	80	0.0625000
NODE_26885_length_585_cov_112.094650	456	536	99	6	80	0.0750000
NODE_26885_length_585_cov_112.094650	456	536	100	1	80	0.0125000
NODE_26885_length_585_cov_112.094650	456	536	101	2	80	0.0250000
NODE_26885_length_585_cov_112.094650	456	536	102	4	80	0.0500000
NODE_26885_length_585_cov_112.094650	456	536	106	1	80	0.0125000
NODE_26885_length_585_cov_112.094650	456	536	107	3	80	0.0375000
NODE_26885_length_585_cov_112.094650	456	536	109	1	80	0.0125000
NODE_26885_length_585_cov_112.094650	509	585	12	4	76	0.0526316
NODE_26885_length_585_cov_112.094650	509	585	13	2	76	0.0263158
NODE_26885_length_585_cov_112.094650	509	585	15	2	76	0.0263158
NODE_26885_length_585_cov_112.094650	509	585	16	2	76	0.0263158
NODE_26885_length_585_cov_112.094650	509	585	18	1	76	0.0131579
NODE_26885_length_585_cov_112.094650	509	585	20	2	76	0.0263158
NODE_26885_length_585_cov_112.094650	509	585	22	1	76	0.0131579
NODE_26885_length_585_cov_112.094650	509	585	23	1	76	0.0131579
NODE_26885_length_585_cov_112.094650	509	585	25	2	76	0.0263158
NODE_26885_length_585_cov_112.094650	509	585	27	1	76	0.0131579
NODE_26885_length_585_cov_112.094650	509	585	29	1	76	0.0131579
NODE_26885_length_585_cov_112.094650	509	585	30	6	76	0.0789474
NODE_26885_length_585_cov_112.094650	509	585	31	3	76	0.0394737
NODE_26885_length_585_cov_112.094650	509	585	34	1	76	0.0131579
NODE_26885_length_585_cov_112.094650	509	585	36	1	76	0.0131579
NODE_26885_length_585_cov_112.094650	509	585	38	1	76	0.0131579
NODE_26885_length_585_cov_112.094650	509	585	40	2	76	0.0263158
NODE_26885_length_585_cov_112.094650	509	585	43	4	76	0.0526316
NODE_26885_length_585_cov_112.094650	509	585	44	1	76	0.0131579
NODE_26885_length_585_cov_112.094650	509	585	45	5	76	0.0657895
NODE_26885_length_585_cov_112.094650	509	585	48	1	76	0.0131579
NODE_26885_length_585_cov_112.094650	509	585	50	2	76	0.0263158
NODE_26885_length_585_cov_112.094650	509	585	53	1	76	0.0131579
NODE_26885_length_585_cov_112.094650	509	585	56	2	76	0.0263158
NODE_26885_length_585_cov_112.094650	509	585	59	1	76	0.0131579
NODE_26885_length_585_cov_112.094650	509	585	60	3	76	0.0394737
NODE_26885_length_585_cov_112.094650	509	585	61	1	76	0.0131579
NODE_26885_length_585_cov_112.094650	509	585	67	2	76	0.0263158
NODE_26885_length_585_cov_112.094650	509	585	69	1	76	0.0131579
NODE_26885_length_585_cov_112.094650	509	585	70	1	76	0.0131579
NODE_26885_length_585_cov_112.094650	509	585	72	3	76	0.0394737
NODE_26885_length_585_cov_112.094650	509	585	73	2	76	0.0263158
NODE_26885_length_585_cov_112.094650	509	585	74	3	76	0.0394737
NODE_26885_length_585_cov_112.094650	509	585	75	1	76	0.0131579
NODE_26885_length_585_cov_112.094650	509	585	76	1	76	0.0131579
NODE_26885_length_585_cov_112.094650	509	585	79	1	76	0.0131579
NODE_26885_length_585_cov_112.094650	509	585	80	1	76	0.0131579
NODE_26885_length_585_cov_112.094650	509	585	81	6	76	0.0789474
NODE_26886_length_585_cov_23.872428	168	248	2	28	80	0.3500000
NODE_26886_length_585_cov_23.872428	168	248	3	29	80	0.3625000
NODE_26886_length_585_cov_23.872428	168	248	4	21	80	0.2625000
NODE_26886_length_585_cov_23.872428	168	248	5	2	80	0.0250000
NODE_26886_length_585_cov_23.872428	222	301	2	11	79	0.1392405
NODE_26886_length_585_cov_23.872428	222	301	3	36	79	0.4556962
NODE_26886_length_585_cov_23.872428	222	301	5	32	79	0.4050633
NODE_26887_length_585_cov_18.981481	360	440	2	43	80	0.5375000
NODE_26887_length_585_cov_18.981481	360	440	3	37	80	0.4625000
NODE_26887_length_585_cov_18.981481	413	493	1	36	80	0.4500000
NODE_26887_length_585_cov_18.981481	413	493	2	36	80	0.4500000
NODE_26887_length_585_cov_18.981481	413	493	3	8	80	0.1000000
NODE_26888_length_585_cov_13.967078	323	387	0	64	64	1.0000000
NODE_26889_length_585_cov_10.555556	229	309	0	80	80	1.0000000
NODE_26889_length_585_cov_10.555556	282	362	0	46	80	0.5750000
NODE_26889_length_585_cov_10.555556	282	362	2	34	80	0.4250000
NODE_26891_length_585_cov_9.216049	233	313	0	80	80	1.0000000
NODE_26891_length_585_cov_9.216049	286	366	0	80	80	1.0000000
NODE_26894_length_585_cov_8.090535	292	372	0	80	80	1.0000000
NODE_26894_length_585_cov_8.090535	345	425	0	80	80	1.0000000
NODE_26895_length_585_cov_8.018519	339	381	0	42	42	1.0000000
NODE_26895_length_585_cov_8.018519	354	419	0	65	65	1.0000000
NODE_26900_length_585_cov_4.954733	147	227	0	80	80	1.0000000
NODE_26912_length_585_cov_3.751029	288	368	0	64	80	0.8000000
NODE_26912_length_585_cov_3.751029	288	368	1	16	80	0.2000000
NODE_26912_length_585_cov_3.751029	341	421	0	80	80	1.0000000
NODE_27019_length_584_cov_21.657732	57	137	0	80	80	1.0000000
NODE_27019_length_584_cov_21.657732	110	190	0	80	80	1.0000000
NODE_27020_length_584_cov_11.915464	280	360	0	80	80	1.0000000
NODE_27020_length_584_cov_11.915464	333	413	0	80	80	1.0000000
NODE_27021_length_584_cov_11.197938	217	297	1	16	80	0.2000000
NODE_27021_length_584_cov_11.197938	217	297	3	64	80	0.8000000
NODE_27021_length_584_cov_11.197938	270	350	0	26	80	0.3250000
NODE_27021_length_584_cov_11.197938	270	350	1	1	80	0.0125000
NODE_27021_length_584_cov_11.197938	270	350	3	53	80	0.6625000
NODE_27022_length_584_cov_9.824742	375	441	5	2	66	0.0303030
NODE_27022_length_584_cov_9.824742	375	441	6	6	66	0.0909091
NODE_27022_length_584_cov_9.824742	375	441	7	28	66	0.4242424
NODE_27022_length_584_cov_9.824742	375	441	8	14	66	0.2121212
NODE_27022_length_584_cov_9.824742	375	441	9	16	66	0.2424242
NODE_27022_length_584_cov_9.824742	375	441	5	2	66	0.0303030
NODE_27022_length_584_cov_9.824742	375	441	6	6	66	0.0909091
NODE_27022_length_584_cov_9.824742	375	441	7	28	66	0.4242424
NODE_27022_length_584_cov_9.824742	375	441	8	14	66	0.2121212
NODE_27022_length_584_cov_9.824742	375	441	9	16	66	0.2424242
NODE_27023_length_584_cov_9.160825	369	449	3	80	80	1.0000000
NODE_27023_length_584_cov_9.160825	422	502	0	2	80	0.0250000
NODE_27023_length_584_cov_9.160825	422	502	1	25	80	0.3125000
NODE_27023_length_584_cov_9.160825	422	502	3	53	80	0.6625000
NODE_27023_length_584_cov_9.160825	422	502	0	2	80	0.0250000
NODE_27023_length_584_cov_9.160825	422	502	1	25	80	0.3125000
NODE_27023_length_584_cov_9.160825	422	502	3	53	80	0.6625000
NODE_27026_length_584_cov_7.736082	51	131	0	31	80	0.3875000
NODE_27026_length_584_cov_7.736082	51	131	2	27	80	0.3375000
NODE_27026_length_584_cov_7.736082	51	131	3	22	80	0.2750000
NODE_27026_length_584_cov_7.736082	104	184	2	5	80	0.0625000
NODE_27026_length_584_cov_7.736082	104	184	3	75	80	0.9375000
NODE_27031_length_584_cov_7.113402	213	293	2	80	80	1.0000000
NODE_27031_length_584_cov_7.113402	266	346	0	49	80	0.6125000
NODE_27031_length_584_cov_7.113402	266	346	2	31	80	0.3875000
NODE_27035_length_584_cov_5.843299	281	341	0	60	60	1.0000000
NODE_27039_length_584_cov_5.032990	240	320	0	2	80	0.0250000
NODE_27039_length_584_cov_5.032990	240	320	1	11	80	0.1375000
NODE_27039_length_584_cov_5.032990	240	320	3	67	80	0.8375000
NODE_27039_length_584_cov_5.032990	293	373	1	12	80	0.1500000
NODE_27039_length_584_cov_5.032990	293	373	3	68	80	0.8500000
NODE_27061_length_584_cov_2.707216	186	257	0	71	71	1.0000000
NODE_27147_length_583_cov_7.973140	232	312	0	80	80	1.0000000
NODE_27147_length_583_cov_7.973140	285	365	0	80	80	1.0000000
NODE_27148_length_583_cov_6.731405	328	408	0	80	80	1.0000000
NODE_27148_length_583_cov_6.731405	381	461	0	80	80	1.0000000
NODE_27149_length_583_cov_6.363636	161	231	1	43	70	0.6142857
NODE_27149_length_583_cov_6.363636	161	231	2	23	70	0.3285714
NODE_27149_length_583_cov_6.363636	161	231	3	4	70	0.0571429
NODE_27152_length_583_cov_5.766529	132	186	0	54	54	1.0000000
NODE_27263_length_583_cov_0.762397	9	50	0	41	41	1.0000000
NODE_27278_length_582_cov_74.269151	295	375	5	13	80	0.1625000
NODE_27278_length_582_cov_74.269151	295	375	7	21	80	0.2625000
NODE_27278_length_582_cov_74.269151	295	375	9	15	80	0.1875000
NODE_27278_length_582_cov_74.269151	295	375	10	24	80	0.3000000
NODE_27278_length_582_cov_74.269151	295	375	11	7	80	0.0875000
NODE_27278_length_582_cov_74.269151	348	428	7	9	80	0.1125000
NODE_27278_length_582_cov_74.269151	348	428	8	3	80	0.0375000
NODE_27278_length_582_cov_74.269151	348	428	9	18	80	0.2250000
NODE_27278_length_582_cov_74.269151	348	428	10	47	80	0.5875000
NODE_27278_length_582_cov_74.269151	348	428	11	3	80	0.0375000
NODE_27279_length_582_cov_53.093168	11	91	0	80	80	1.0000000
NODE_27279_length_582_cov_53.093168	64	144	0	80	80	1.0000000
NODE_27279_length_582_cov_53.093168	140	220	0	80	80	1.0000000
NODE_27279_length_582_cov_53.093168	193	273	0	80	80	1.0000000
NODE_27280_length_582_cov_47.393375	345	425	1	63	80	0.7875000
NODE_27280_length_582_cov_47.393375	345	425	2	17	80	0.2125000
NODE_27280_length_582_cov_47.393375	398	478	1	19	80	0.2375000
NODE_27280_length_582_cov_47.393375	398	478	2	61	80	0.7625000
NODE_27281_length_582_cov_16.358178	297	377	0	80	80	1.0000000
NODE_27281_length_582_cov_16.358178	350	431	0	81	81	1.0000000
NODE_27282_length_582_cov_14.107660	128	208	0	80	80	1.0000000
NODE_27282_length_582_cov_14.107660	181	261	0	80	80	1.0000000
NODE_27283_length_582_cov_7.923395	208	287	0	79	79	1.0000000
NODE_27283_length_582_cov_7.923395	262	340	0	78	78	1.0000000
NODE_27284_length_582_cov_7.722567	216	296	0	80	80	1.0000000
NODE_27284_length_582_cov_7.722567	269	349	0	80	80	1.0000000
NODE_27289_length_582_cov_4.956522	294	325	0	31	31	1.0000000
NODE_27295_length_582_cov_4.308489	151	192	4	16	41	0.3902439
NODE_27295_length_582_cov_4.308489	151	192	5	25	41	0.6097561
NODE_27297_length_582_cov_3.838509	223	299	0	67	76	0.8815789
NODE_27297_length_582_cov_3.838509	223	299	1	9	76	0.1184211
NODE_27297_length_582_cov_3.838509	272	354	0	82	82	1.0000000
NODE_27350_length_582_cov_1.650104	375	450	0	75	75	1.0000000
NODE_27405_length_581_cov_16.890041	244	316	4	43	72	0.5972222
NODE_27405_length_581_cov_16.890041	244	316	5	6	72	0.0833333
NODE_27405_length_581_cov_16.890041	244	316	6	23	72	0.3194444
NODE_27413_length_581_cov_6.340249	262	342	0	80	80	1.0000000
NODE_27413_length_581_cov_6.340249	315	395	0	80	80	1.0000000
NODE_27416_length_581_cov_5.827801	122	192	5	7	70	0.1000000
NODE_27416_length_581_cov_5.827801	122	192	6	8	70	0.1142857
NODE_27416_length_581_cov_5.827801	122	192	7	11	70	0.1571429
NODE_27416_length_581_cov_5.827801	122	192	8	14	70	0.2000000
NODE_27416_length_581_cov_5.827801	122	192	9	10	70	0.1428571
NODE_27416_length_581_cov_5.827801	122	192	10	5	70	0.0714286
NODE_27416_length_581_cov_5.827801	122	192	12	12	70	0.1714286
NODE_27416_length_581_cov_5.827801	122	192	14	3	70	0.0428571
NODE_27420_length_581_cov_5.072614	392	466	0	64	74	0.8648649
NODE_27420_length_581_cov_5.072614	392	466	1	10	74	0.1351351
NODE_27420_length_581_cov_5.072614	424	444	0	20	20	1.0000000
NODE_27464_length_581_cov_1.881743	474	538	0	64	64	1.0000000
NODE_27541_length_580_cov_39.353430	358	438	0	7	80	0.0875000
NODE_27541_length_580_cov_39.353430	358	438	1	1	80	0.0125000
NODE_27541_length_580_cov_39.353430	358	438	2	24	80	0.3000000
NODE_27541_length_580_cov_39.353430	358	438	3	1	80	0.0125000
NODE_27541_length_580_cov_39.353430	358	438	4	16	80	0.2000000
NODE_27541_length_580_cov_39.353430	358	438	5	4	80	0.0500000
NODE_27541_length_580_cov_39.353430	358	438	6	9	80	0.1125000
NODE_27541_length_580_cov_39.353430	358	438	7	18	80	0.2250000
NODE_27541_length_580_cov_39.353430	411	491	6	9	80	0.1125000
NODE_27541_length_580_cov_39.353430	411	491	7	23	80	0.2875000
NODE_27541_length_580_cov_39.353430	411	491	8	48	80	0.6000000
NODE_27541_length_580_cov_39.353430	487	567	2	6	80	0.0750000
NODE_27541_length_580_cov_39.353430	487	567	3	4	80	0.0500000
NODE_27541_length_580_cov_39.353430	487	567	4	16	80	0.2000000
NODE_27541_length_580_cov_39.353430	487	567	5	1	80	0.0125000
NODE_27541_length_580_cov_39.353430	487	567	6	24	80	0.3000000
NODE_27541_length_580_cov_39.353430	487	567	7	1	80	0.0125000
NODE_27541_length_580_cov_39.353430	487	567	8	28	80	0.3500000
NODE_27541_length_580_cov_39.353430	487	567	2	6	80	0.0750000
NODE_27541_length_580_cov_39.353430	487	567	3	4	80	0.0500000
NODE_27541_length_580_cov_39.353430	487	567	4	16	80	0.2000000
NODE_27541_length_580_cov_39.353430	487	567	5	1	80	0.0125000
NODE_27541_length_580_cov_39.353430	487	567	6	24	80	0.3000000
NODE_27541_length_580_cov_39.353430	487	567	7	1	80	0.0125000
NODE_27541_length_580_cov_39.353430	487	567	8	28	80	0.3500000
NODE_27541_length_580_cov_39.353430	487	567	2	6	80	0.0750000
NODE_27541_length_580_cov_39.353430	487	567	3	4	80	0.0500000
NODE_27541_length_580_cov_39.353430	487	567	4	16	80	0.2000000
NODE_27541_length_580_cov_39.353430	487	567	5	1	80	0.0125000
NODE_27541_length_580_cov_39.353430	487	567	6	24	80	0.3000000
NODE_27541_length_580_cov_39.353430	487	567	7	1	80	0.0125000
NODE_27541_length_580_cov_39.353430	487	567	8	28	80	0.3500000
NODE_27541_length_580_cov_39.353430	487	567	2	6	80	0.0750000
NODE_27541_length_580_cov_39.353430	487	567	3	4	80	0.0500000
NODE_27541_length_580_cov_39.353430	487	567	4	16	80	0.2000000
NODE_27541_length_580_cov_39.353430	487	567	5	1	80	0.0125000
NODE_27541_length_580_cov_39.353430	487	567	6	24	80	0.3000000
NODE_27541_length_580_cov_39.353430	487	567	7	1	80	0.0125000
NODE_27541_length_580_cov_39.353430	487	567	8	28	80	0.3500000
NODE_27541_length_580_cov_39.353430	487	567	2	6	80	0.0750000
NODE_27541_length_580_cov_39.353430	487	567	3	4	80	0.0500000
NODE_27541_length_580_cov_39.353430	487	567	4	16	80	0.2000000
NODE_27541_length_580_cov_39.353430	487	567	5	1	80	0.0125000
NODE_27541_length_580_cov_39.353430	487	567	6	24	80	0.3000000
NODE_27541_length_580_cov_39.353430	487	567	7	1	80	0.0125000
NODE_27541_length_580_cov_39.353430	487	567	8	28	80	0.3500000
NODE_27541_length_580_cov_39.353430	487	567	2	6	80	0.0750000
NODE_27541_length_580_cov_39.353430	487	567	3	4	80	0.0500000
NODE_27541_length_580_cov_39.353430	487	567	4	16	80	0.2000000
NODE_27541_length_580_cov_39.353430	487	567	5	1	80	0.0125000
NODE_27541_length_580_cov_39.353430	487	567	6	24	80	0.3000000
NODE_27541_length_580_cov_39.353430	487	567	7	1	80	0.0125000
NODE_27541_length_580_cov_39.353430	487	567	8	28	80	0.3500000
NODE_27544_length_580_cov_8.925156	198	238	0	40	40	1.0000000
NODE_27544_length_580_cov_8.925156	258	338	0	80	80	1.0000000
NODE_27545_length_580_cov_8.634096	197	277	5	68	80	0.8500000
NODE_27545_length_580_cov_8.634096	197	277	6	4	80	0.0500000
NODE_27545_length_580_cov_8.634096	197	277	7	8	80	0.1000000
NODE_27545_length_580_cov_8.634096	250	330	2	42	80	0.5250000
NODE_27545_length_580_cov_8.634096	250	330	3	8	80	0.1000000
NODE_27545_length_580_cov_8.634096	250	330	5	26	80	0.3250000
NODE_27545_length_580_cov_8.634096	250	330	7	4	80	0.0500000
NODE_27551_length_580_cov_6.291060	356	398	0	42	42	1.0000000
NODE_27554_length_580_cov_5.494802	110	190	0	80	80	1.0000000
NODE_27554_length_580_cov_5.494802	163	243	0	80	80	1.0000000
NODE_27559_length_580_cov_4.563410	231	292	0	8	61	0.1311475
NODE_27559_length_580_cov_4.563410	231	292	1	9	61	0.1475410
NODE_27559_length_580_cov_4.563410	231	292	3	44	61	0.7213115
NODE_27559_length_580_cov_4.563410	322	357	4	35	35	1.0000000
NODE_27590_length_580_cov_2.264033	215	277	0	40	62	0.6451613
NODE_27590_length_580_cov_2.264033	215	277	2	4	62	0.0645161
NODE_27590_length_580_cov_2.264033	215	277	3	1	62	0.0161290
NODE_27590_length_580_cov_2.264033	215	277	4	17	62	0.2741936
NODE_27597_length_580_cov_2.116424	265	345	4	8	80	0.1000000
NODE_27597_length_580_cov_2.116424	265	345	5	72	80	0.9000000
NODE_27659_length_579_cov_24.231250	159	239	1	80	80	1.0000000
NODE_27659_length_579_cov_24.231250	212	287	1	72	75	0.9600000
NODE_27659_length_579_cov_24.231250	212	287	2	3	75	0.0400000
NODE_27660_length_579_cov_12.602083	246	326	1	30	80	0.3750000
NODE_27660_length_579_cov_12.602083	246	326	2	50	80	0.6250000
NODE_27660_length_579_cov_12.602083	299	377	1	18	78	0.2307692
NODE_27660_length_579_cov_12.602083	299	377	2	60	78	0.7692308
NODE_27663_length_579_cov_9.195833	254	334	2	1	80	0.0125000
NODE_27663_length_579_cov_9.195833	254	334	3	42	80	0.5250000
NODE_27663_length_579_cov_9.195833	254	334	5	1	80	0.0125000
NODE_27663_length_579_cov_9.195833	254	334	6	5	80	0.0625000
NODE_27663_length_579_cov_9.195833	254	334	8	31	80	0.3875000
NODE_27663_length_579_cov_9.195833	307	387	7	30	80	0.3750000
NODE_27663_length_579_cov_9.195833	307	387	8	50	80	0.6250000
NODE_27663_length_579_cov_9.195833	383	463	1	29	80	0.3625000
NODE_27663_length_579_cov_9.195833	383	463	2	14	80	0.1750000
NODE_27663_length_579_cov_9.195833	383	463	4	15	80	0.1875000
NODE_27663_length_579_cov_9.195833	383	463	5	9	80	0.1125000
NODE_27663_length_579_cov_9.195833	383	463	7	13	80	0.1625000
NODE_27664_length_579_cov_6.600000	169	249	0	80	80	1.0000000
NODE_27664_length_579_cov_6.600000	222	302	0	80	80	1.0000000
NODE_27667_length_579_cov_5.956250	225	295	6	2	70	0.0285714
NODE_27667_length_579_cov_5.956250	225	295	7	15	70	0.2142857
NODE_27667_length_579_cov_5.956250	225	295	8	46	70	0.6571429
NODE_27667_length_579_cov_5.956250	225	295	9	7	70	0.1000000
NODE_27667_length_579_cov_5.956250	279	316	6	13	37	0.3513514
NODE_27667_length_579_cov_5.956250	279	316	7	3	37	0.0810811
NODE_27667_length_579_cov_5.956250	279	316	8	9	37	0.2432432
NODE_27667_length_579_cov_5.956250	279	316	9	12	37	0.3243243
NODE_27674_length_579_cov_4.850000	105	185	0	18	80	0.2250000
NODE_27674_length_579_cov_4.850000	105	185	1	27	80	0.3375000
NODE_27674_length_579_cov_4.850000	105	185	2	35	80	0.4375000
NODE_27674_length_579_cov_4.850000	158	238	2	80	80	1.0000000
NODE_27688_length_579_cov_3.291667	290	343	0	53	53	1.0000000
NODE_27695_length_579_cov_2.420833	251	331	0	80	80	1.0000000
NODE_27695_length_579_cov_2.420833	304	384	0	80	80	1.0000000
NODE_27724_length_579_cov_1.435417	463	497	0	34	34	1.0000000
NODE_27781_length_578_cov_70.192067	100	180	1	71	80	0.8875000
NODE_27781_length_578_cov_70.192067	100	180	2	9	80	0.1125000
NODE_27781_length_578_cov_70.192067	153	233	0	6	80	0.0750000
NODE_27781_length_578_cov_70.192067	153	233	1	65	80	0.8125000
NODE_27781_length_578_cov_70.192067	153	233	2	9	80	0.1125000
NODE_27782_length_578_cov_51.676409	129	209	0	80	80	1.0000000
NODE_27782_length_578_cov_51.676409	182	262	0	80	80	1.0000000
NODE_27783_length_578_cov_32.152401	310	390	3	7	80	0.0875000
NODE_27783_length_578_cov_32.152401	310	390	4	4	80	0.0500000
NODE_27783_length_578_cov_32.152401	310	390	6	32	80	0.4000000
NODE_27783_length_578_cov_32.152401	310	390	7	1	80	0.0125000
NODE_27783_length_578_cov_32.152401	310	390	8	3	80	0.0375000
NODE_27783_length_578_cov_32.152401	310	390	9	14	80	0.1750000
NODE_27783_length_578_cov_32.152401	310	390	10	19	80	0.2375000
NODE_27783_length_578_cov_32.152401	363	443	2	20	80	0.2500000
NODE_27783_length_578_cov_32.152401	363	443	3	40	80	0.5000000
NODE_27783_length_578_cov_32.152401	363	443	4	4	80	0.0500000
NODE_27783_length_578_cov_32.152401	363	443	6	16	80	0.2000000
NODE_27784_length_578_cov_30.484342	215	295	2	51	80	0.6375000
NODE_27784_length_578_cov_30.484342	215	295	3	13	80	0.1625000
NODE_27784_length_578_cov_30.484342	215	295	4	16	80	0.2000000
NODE_27784_length_578_cov_30.484342	268	348	2	16	80	0.2000000
NODE_27784_length_578_cov_30.484342	268	348	3	50	80	0.6250000
NODE_27784_length_578_cov_30.484342	268	348	4	14	80	0.1750000
NODE_27785_length_578_cov_15.983299	213	265	8	4	52	0.0769231
NODE_27785_length_578_cov_15.983299	213	265	9	1	52	0.0192308
NODE_27785_length_578_cov_15.983299	213	265	10	4	52	0.0769231
NODE_27785_length_578_cov_15.983299	213	265	11	2	52	0.0384615
NODE_27785_length_578_cov_15.983299	213	265	12	4	52	0.0769231
NODE_27785_length_578_cov_15.983299	213	265	13	17	52	0.3269231
NODE_27785_length_578_cov_15.983299	213	265	14	20	52	0.3846154
NODE_27786_length_578_cov_14.968685	147	227	0	80	80	1.0000000
NODE_27786_length_578_cov_14.968685	200	280	0	80	80	1.0000000
NODE_27787_length_578_cov_9.567850	273	328	0	55	55	1.0000000
NODE_27792_length_578_cov_6.670146	273	353	1	11	80	0.1375000
NODE_27792_length_578_cov_6.670146	273	353	2	45	80	0.5625000
NODE_27792_length_578_cov_6.670146	273	353	4	3	80	0.0375000
NODE_27792_length_578_cov_6.670146	273	353	6	21	80	0.2625000
NODE_27792_length_578_cov_6.670146	326	406	2	3	80	0.0375000
NODE_27792_length_578_cov_6.670146	326	406	4	3	80	0.0375000
NODE_27792_length_578_cov_6.670146	326	406	5	35	80	0.4375000
NODE_27792_length_578_cov_6.670146	326	406	6	39	80	0.4875000
NODE_27793_length_578_cov_6.465553	320	400	2	80	80	1.0000000
NODE_27793_length_578_cov_6.465553	373	453	0	29	80	0.3625000
NODE_27793_length_578_cov_6.465553	373	453	1	20	80	0.2500000
NODE_27793_length_578_cov_6.465553	373	453	2	31	80	0.3875000
NODE_27863_length_578_cov_1.480167	185	265	0	80	80	1.0000000
NODE_27863_length_578_cov_1.480167	238	318	0	80	80	1.0000000
NODE_27935_length_577_cov_11.638075	312	392	0	73	80	0.9125000
NODE_27935_length_577_cov_11.638075	312	392	1	7	80	0.0875000
NODE_27942_length_577_cov_4.912134	218	249	4	31	31	1.0000000
NODE_27942_length_577_cov_4.912134	301	330	1	15	29	0.5172414
NODE_27942_length_577_cov_4.912134	301	330	2	14	29	0.4827586
NODE_27961_length_577_cov_2.970711	78	126	4	2	48	0.0416667
NODE_27961_length_577_cov_2.970711	78	126	6	14	48	0.2916667
NODE_27961_length_577_cov_2.970711	78	126	7	3	48	0.0625000
NODE_27961_length_577_cov_2.970711	78	126	8	29	48	0.6041667
NODE_27968_length_577_cov_2.631799	169	253	11	6	84	0.0714286
NODE_27968_length_577_cov_2.631799	169	253	12	25	84	0.2976190
NODE_27968_length_577_cov_2.631799	169	253	14	8	84	0.0952381
NODE_27968_length_577_cov_2.631799	169	253	16	7	84	0.0833333
NODE_27968_length_577_cov_2.631799	169	253	17	11	84	0.1309524
NODE_27968_length_577_cov_2.631799	169	253	18	9	84	0.1071429
NODE_27968_length_577_cov_2.631799	169	253	19	5	84	0.0595238
NODE_27968_length_577_cov_2.631799	169	253	20	13	84	0.1547619
NODE_27968_length_577_cov_2.631799	226	269	17	7	43	0.1627907
NODE_27968_length_577_cov_2.631799	226	269	18	2	43	0.0465116
NODE_27968_length_577_cov_2.631799	226	269	19	7	43	0.1627907
NODE_27968_length_577_cov_2.631799	226	269	20	27	43	0.6279070
NODE_28003_length_577_cov_1.468619	71	146	0	75	75	1.0000000
NODE_28003_length_577_cov_1.468619	119	199	0	80	80	1.0000000
NODE_28058_length_576_cov_10.903564	194	274	0	80	80	1.0000000
NODE_28059_length_576_cov_9.039832	271	351	0	80	80	1.0000000
NODE_28059_length_576_cov_9.039832	324	404	0	80	80	1.0000000
NODE_28060_length_576_cov_8.490566	338	418	0	80	80	1.0000000
NODE_28060_length_576_cov_8.490566	391	471	0	80	80	1.0000000
NODE_28061_length_576_cov_7.002096	157	237	0	61	80	0.7625000
NODE_28061_length_576_cov_7.002096	157	237	1	19	80	0.2375000
NODE_28061_length_576_cov_7.002096	210	290	0	14	80	0.1750000
NODE_28061_length_576_cov_7.002096	210	290	1	47	80	0.5875000
NODE_28061_length_576_cov_7.002096	210	290	2	19	80	0.2375000
NODE_28076_length_576_cov_3.322851	118	183	1	13	65	0.2000000
NODE_28076_length_576_cov_3.322851	118	183	3	52	65	0.8000000
NODE_28102_length_576_cov_1.964361	148	228	0	80	80	1.0000000
NODE_28102_length_576_cov_1.964361	201	281	0	80	80	1.0000000
NODE_28104_length_576_cov_1.951782	159	239	0	21	80	0.2625000
NODE_28104_length_576_cov_1.951782	159	239	1	27	80	0.3375000
NODE_28104_length_576_cov_1.951782	159	239	2	32	80	0.4000000
NODE_28104_length_576_cov_1.951782	212	292	0	74	80	0.9250000
NODE_28104_length_576_cov_1.951782	212	292	1	6	80	0.0750000
NODE_28116_length_576_cov_1.584906	381	455	3	74	74	1.0000000
NODE_28179_length_575_cov_15.319328	319	399	2	7	80	0.0875000
NODE_28179_length_575_cov_15.319328	319	399	4	73	80	0.9125000
NODE_28179_length_575_cov_15.319328	372	452	0	18	80	0.2250000
NODE_28179_length_575_cov_15.319328	372	452	2	4	80	0.0500000
NODE_28179_length_575_cov_15.319328	372	452	4	58	80	0.7250000
NODE_28181_length_575_cov_8.254202	286	366	0	13	80	0.1625000
NODE_28181_length_575_cov_8.254202	286	366	2	67	80	0.8375000
NODE_28181_length_575_cov_8.254202	339	419	0	26	80	0.3250000
NODE_28181_length_575_cov_8.254202	339	419	2	54	80	0.6750000
NODE_28182_length_575_cov_7.558824	300	380	1	33	80	0.4125000
NODE_28182_length_575_cov_7.558824	300	380	5	47	80	0.5875000
NODE_28313_length_574_cov_6.282105	185	265	4	4	80	0.0500000
NODE_28313_length_574_cov_6.282105	185	265	5	40	80	0.5000000
NODE_28313_length_574_cov_6.282105	185	265	6	1	80	0.0125000
NODE_28313_length_574_cov_6.282105	185	265	7	26	80	0.3250000
NODE_28313_length_574_cov_6.282105	185	265	8	8	80	0.1000000
NODE_28313_length_574_cov_6.282105	185	265	9	1	80	0.0125000
NODE_28313_length_574_cov_6.282105	238	318	5	30	80	0.3750000
NODE_28313_length_574_cov_6.282105	238	318	7	20	80	0.2500000
NODE_28313_length_574_cov_6.282105	238	318	8	29	80	0.3625000
NODE_28313_length_574_cov_6.282105	238	318	9	1	80	0.0125000
NODE_28330_length_574_cov_2.993684	215	234	1	18	19	0.9473684
NODE_28330_length_574_cov_2.993684	215	234	2	1	19	0.0526316
NODE_28438_length_573_cov_53.668776	393	473	3	34	80	0.4250000
NODE_28438_length_573_cov_53.668776	393	473	4	1	80	0.0125000
NODE_28438_length_573_cov_53.668776	393	473	6	9	80	0.1125000
NODE_28438_length_573_cov_53.668776	393	473	7	21	80	0.2625000
NODE_28438_length_573_cov_53.668776	393	473	8	15	80	0.1875000
NODE_28438_length_573_cov_53.668776	446	526	2	35	80	0.4375000
NODE_28438_length_573_cov_53.668776	446	526	3	45	80	0.5625000
NODE_28439_length_573_cov_30.658228	451	531	0	11	80	0.1375000
NODE_28439_length_573_cov_30.658228	451	531	1	53	80	0.6625000
NODE_28439_length_573_cov_30.658228	451	531	2	16	80	0.2000000
NODE_28440_length_573_cov_30.116034	435	515	6	24	80	0.3000000
NODE_28440_length_573_cov_30.116034	435	515	7	2	80	0.0250000
NODE_28440_length_573_cov_30.116034	435	515	8	5	80	0.0625000
NODE_28440_length_573_cov_30.116034	435	515	10	3	80	0.0375000
NODE_28440_length_573_cov_30.116034	435	515	11	7	80	0.0875000
NODE_28440_length_573_cov_30.116034	435	515	13	7	80	0.0875000
NODE_28440_length_573_cov_30.116034	435	515	16	3	80	0.0375000
NODE_28440_length_573_cov_30.116034	435	515	17	3	80	0.0375000
NODE_28440_length_573_cov_30.116034	435	515	18	7	80	0.0875000
NODE_28440_length_573_cov_30.116034	435	515	19	5	80	0.0625000
NODE_28440_length_573_cov_30.116034	435	515	20	2	80	0.0250000
NODE_28440_length_573_cov_30.116034	435	515	21	12	80	0.1500000
NODE_28440_length_573_cov_30.116034	488	568	2	8	80	0.1000000
NODE_28440_length_573_cov_30.116034	488	568	3	6	80	0.0750000
NODE_28440_length_573_cov_30.116034	488	568	4	39	80	0.4875000
NODE_28440_length_573_cov_30.116034	488	568	6	24	80	0.3000000
NODE_28440_length_573_cov_30.116034	488	568	7	2	80	0.0250000
NODE_28440_length_573_cov_30.116034	488	568	8	1	80	0.0125000
NODE_28441_length_573_cov_24.234177	210	290	0	80	80	1.0000000
NODE_28441_length_573_cov_24.234177	263	343	0	80	80	1.0000000
NODE_28442_length_573_cov_13.464135	278	358	0	80	80	1.0000000
NODE_28442_length_573_cov_13.464135	331	411	0	80	80	1.0000000
NODE_28443_length_573_cov_8.761603	124	204	1	38	80	0.4750000
NODE_28443_length_573_cov_8.761603	124	204	2	42	80	0.5250000
NODE_28443_length_573_cov_8.761603	177	257	1	61	80	0.7625000
NODE_28443_length_573_cov_8.761603	177	257	2	19	80	0.2375000
NODE_28456_length_573_cov_3.364979	365	398	30	6	33	0.1818182
NODE_28456_length_573_cov_3.364979	365	398	31	12	33	0.3636364
NODE_28456_length_573_cov_3.364979	365	398	32	10	33	0.3030303
NODE_28456_length_573_cov_3.364979	365	398	33	5	33	0.1515152
NODE_28565_length_572_cov_17.530655	312	392	0	80	80	1.0000000
NODE_28565_length_572_cov_17.530655	365	445	0	80	80	1.0000000
NODE_28567_length_572_cov_8.059197	250	321	1	71	71	1.0000000
NODE_28568_length_572_cov_7.873150	134	214	2	80	80	1.0000000
NODE_28568_length_572_cov_7.873150	187	267	0	28	80	0.3500000
NODE_28568_length_572_cov_7.873150	187	267	2	52	80	0.6500000
NODE_28570_length_572_cov_6.706131	365	445	0	80	80	1.0000000
NODE_28570_length_572_cov_6.706131	418	498	0	80	80	1.0000000
NODE_28573_length_572_cov_5.625793	137	217	2	34	80	0.4250000
NODE_28573_length_572_cov_5.625793	137	217	3	46	80	0.5750000
NODE_28573_length_572_cov_5.625793	190	270	1	32	80	0.4000000
NODE_28573_length_572_cov_5.625793	190	270	2	9	80	0.1125000
NODE_28573_length_572_cov_5.625793	190	270	3	39	80	0.4875000
NODE_28574_length_572_cov_5.617336	331	401	0	70	70	1.0000000
NODE_28578_length_572_cov_4.596195	212	288	0	76	76	1.0000000
NODE_28578_length_572_cov_4.596195	261	341	0	80	80	1.0000000
NODE_28585_length_572_cov_3.843552	210	290	7	1	80	0.0125000
NODE_28585_length_572_cov_3.843552	210	290	9	23	80	0.2875000
NODE_28585_length_572_cov_3.843552	210	290	11	9	80	0.1125000
NODE_28585_length_572_cov_3.843552	210	290	14	15	80	0.1875000
NODE_28585_length_572_cov_3.843552	210	290	15	15	80	0.1875000
NODE_28585_length_572_cov_3.843552	210	290	16	17	80	0.2125000
NODE_28585_length_572_cov_3.843552	263	343	9	1	80	0.0125000
NODE_28585_length_572_cov_3.843552	263	343	11	16	80	0.2000000
NODE_28585_length_572_cov_3.843552	263	343	13	34	80	0.4250000
NODE_28585_length_572_cov_3.843552	263	343	14	17	80	0.2125000
NODE_28585_length_572_cov_3.843552	263	343	16	12	80	0.1500000
NODE_28621_length_572_cov_2.319239	357	431	4	1	74	0.0135135
NODE_28621_length_572_cov_2.319239	357	431	5	19	74	0.2567568
NODE_28621_length_572_cov_2.319239	357	431	6	31	74	0.4189189
NODE_28621_length_572_cov_2.319239	357	431	7	15	74	0.2027027
NODE_28621_length_572_cov_2.319239	357	431	8	8	74	0.1081081
NODE_28621_length_572_cov_2.319239	410	478	4	18	68	0.2647059
NODE_28621_length_572_cov_2.319239	410	478	5	42	68	0.6176471
NODE_28621_length_572_cov_2.319239	410	478	6	8	68	0.1176471
NODE_28625_length_572_cov_2.107822	184	254	1	4	70	0.0571429
NODE_28625_length_572_cov_2.107822	184	254	2	32	70	0.4571429
NODE_28625_length_572_cov_2.107822	184	254	3	34	70	0.4857143
NODE_28625_length_572_cov_2.107822	415	493	0	33	78	0.4230769
NODE_28625_length_572_cov_2.107822	415	493	1	15	78	0.1923077
NODE_28625_length_572_cov_2.107822	415	493	2	8	78	0.1025641
NODE_28625_length_572_cov_2.107822	415	493	3	22	78	0.2820513
NODE_28631_length_572_cov_1.947146	327	363	2	36	36	1.0000000
NODE_28631_length_572_cov_1.947146	328	354	2	26	26	1.0000000
NODE_28700_length_571_cov_14.262712	237	317	0	80	80	1.0000000
NODE_28700_length_571_cov_14.262712	290	370	0	80	80	1.0000000
NODE_28717_length_571_cov_4.033898	154	234	2	34	80	0.4250000
NODE_28717_length_571_cov_4.033898	154	234	4	46	80	0.5750000
NODE_28717_length_571_cov_4.033898	207	273	0	9	66	0.1363636
NODE_28717_length_571_cov_4.033898	207	273	2	57	66	0.8636364
NODE_28809_length_570_cov_28.269639	487	559	29	1	72	0.0138889
NODE_28809_length_570_cov_28.269639	487	559	31	3	72	0.0416667
NODE_28809_length_570_cov_28.269639	487	559	34	2	72	0.0277778
NODE_28809_length_570_cov_28.269639	487	559	37	5	72	0.0694444
NODE_28809_length_570_cov_28.269639	487	559	43	11	72	0.1527778
NODE_28809_length_570_cov_28.269639	487	559	44	1	72	0.0138889
NODE_28809_length_570_cov_28.269639	487	559	45	1	72	0.0138889
NODE_28809_length_570_cov_28.269639	487	559	48	2	72	0.0277778
NODE_28809_length_570_cov_28.269639	487	559	49	1	72	0.0138889
NODE_28809_length_570_cov_28.269639	487	559	50	3	72	0.0416667
NODE_28809_length_570_cov_28.269639	487	559	51	8	72	0.1111111
NODE_28809_length_570_cov_28.269639	487	559	52	2	72	0.0277778
NODE_28809_length_570_cov_28.269639	487	559	55	4	72	0.0555556
NODE_28809_length_570_cov_28.269639	487	559	56	2	72	0.0277778
NODE_28809_length_570_cov_28.269639	487	559	57	19	72	0.2638889
NODE_28809_length_570_cov_28.269639	487	559	59	1	72	0.0138889
NODE_28809_length_570_cov_28.269639	487	559	65	1	72	0.0138889
NODE_28809_length_570_cov_28.269639	487	559	66	5	72	0.0694444
NODE_28812_length_570_cov_10.161359	167	247	0	8	80	0.1000000
NODE_28812_length_570_cov_10.161359	167	247	2	3	80	0.0375000
NODE_28812_length_570_cov_10.161359	167	247	3	13	80	0.1625000
NODE_28812_length_570_cov_10.161359	167	247	5	56	80	0.7000000
NODE_28812_length_570_cov_10.161359	220	256	0	17	36	0.4722222
NODE_28812_length_570_cov_10.161359	220	256	2	3	36	0.0833333
NODE_28812_length_570_cov_10.161359	220	256	3	13	36	0.3611111
NODE_28812_length_570_cov_10.161359	220	256	5	3	36	0.0833333
NODE_28819_length_570_cov_5.010616	179	216	0	37	37	1.0000000
NODE_28819_length_570_cov_5.010616	189	269	0	80	80	1.0000000
NODE_28828_length_570_cov_3.898089	236	316	0	80	80	1.0000000
NODE_28828_length_570_cov_3.898089	289	369	0	80	80	1.0000000
NODE_28840_length_570_cov_2.938429	202	280	1	55	78	0.7051282
NODE_28840_length_570_cov_2.938429	202	280	2	23	78	0.2948718
NODE_28840_length_570_cov_2.938429	262	333	1	18	71	0.2535211
NODE_28840_length_570_cov_2.938429	262	333	2	53	71	0.7464789
NODE_28842_length_570_cov_2.891720	204	260	0	1	56	0.0178571
NODE_28842_length_570_cov_2.891720	204	260	2	55	56	0.9821429
NODE_28950_length_569_cov_20.559574	275	355	0	80	80	1.0000000
NODE_28950_length_569_cov_20.559574	328	408	0	80	80	1.0000000
NODE_28951_length_569_cov_15.282979	272	352	1	67	80	0.8375000
NODE_28951_length_569_cov_15.282979	272	352	2	1	80	0.0125000
NODE_28951_length_569_cov_15.282979	272	352	3	12	80	0.1500000
NODE_28951_length_569_cov_15.282979	325	405	1	14	80	0.1750000
NODE_28951_length_569_cov_15.282979	325	405	2	54	80	0.6750000
NODE_28951_length_569_cov_15.282979	325	405	3	12	80	0.1500000
NODE_28952_length_569_cov_11.023404	280	360	1	7	80	0.0875000
NODE_28952_length_569_cov_11.023404	280	360	2	73	80	0.9125000
NODE_28952_length_569_cov_11.023404	333	413	0	40	80	0.5000000
NODE_28952_length_569_cov_11.023404	333	413	1	20	80	0.2500000
NODE_28952_length_569_cov_11.023404	333	413	2	20	80	0.2500000
NODE_28953_length_569_cov_9.310638	231	277	8	21	46	0.4565217
NODE_28953_length_569_cov_9.310638	231	277	9	6	46	0.1304348
NODE_28953_length_569_cov_9.310638	231	277	11	11	46	0.2391304
NODE_28953_length_569_cov_9.310638	231	277	12	8	46	0.1739130
NODE_28956_length_569_cov_6.989362	258	338	3	7	80	0.0875000
NODE_28956_length_569_cov_6.989362	258	338	4	1	80	0.0125000
NODE_28956_length_569_cov_6.989362	258	338	5	6	80	0.0750000
NODE_28956_length_569_cov_6.989362	258	338	6	23	80	0.2875000
NODE_28956_length_569_cov_6.989362	258	338	7	4	80	0.0500000
NODE_28956_length_569_cov_6.989362	258	338	8	20	80	0.2500000
NODE_28956_length_569_cov_6.989362	258	338	9	19	80	0.2375000
NODE_28956_length_569_cov_6.989362	294	329	5	5	35	0.1428571
NODE_28956_length_569_cov_6.989362	294	329	7	4	35	0.1142857
NODE_28956_length_569_cov_6.989362	294	329	8	7	35	0.2000000
NODE_28956_length_569_cov_6.989362	294	329	9	19	35	0.5428572
NODE_28956_length_569_cov_6.989362	296	338	3	7	42	0.1666667
NODE_28956_length_569_cov_6.989362	296	338	4	1	42	0.0238095
NODE_28956_length_569_cov_6.989362	296	338	5	6	42	0.1428571
NODE_28956_length_569_cov_6.989362	296	338	7	4	42	0.0952381
NODE_28956_length_569_cov_6.989362	296	338	8	5	42	0.1190476
NODE_28956_length_569_cov_6.989362	296	338	9	19	42	0.4523810
NODE_28957_length_569_cov_6.978723	264	344	2	80	80	1.0000000
NODE_28957_length_569_cov_6.978723	317	397	0	38	80	0.4750000
NODE_28957_length_569_cov_6.978723	317	397	2	42	80	0.5250000
NODE_28960_length_569_cov_6.434043	228	308	0	80	80	1.0000000
NODE_28973_length_569_cov_3.353191	340	419	0	79	79	1.0000000
NODE_28981_length_569_cov_3.027660	277	348	0	71	71	1.0000000
NODE_29072_length_568_cov_59.729211	124	204	4	10	80	0.1250000
NODE_29072_length_568_cov_59.729211	124	204	5	11	80	0.1375000
NODE_29072_length_568_cov_59.729211	124	204	6	59	80	0.7375000
NODE_29072_length_568_cov_59.729211	177	257	0	50	80	0.6250000
NODE_29072_length_568_cov_59.729211	177	257	2	3	80	0.0375000
NODE_29072_length_568_cov_59.729211	177	257	4	10	80	0.1250000
NODE_29072_length_568_cov_59.729211	177	257	5	11	80	0.1375000
NODE_29072_length_568_cov_59.729211	177	257	6	6	80	0.0750000
NODE_29075_length_568_cov_7.763326	215	294	0	9	79	0.1139240
NODE_29075_length_568_cov_7.763326	215	294	2	70	79	0.8860760
NODE_29075_length_568_cov_7.763326	267	347	0	26	80	0.3250000
NODE_29075_length_568_cov_7.763326	267	347	2	54	80	0.6750000
NODE_29078_length_568_cov_6.257996	397	471	1	74	74	1.0000000
NODE_29091_length_568_cov_3.748401	170	236	0	66	66	1.0000000
NODE_29091_length_568_cov_3.748401	262	311	0	49	49	1.0000000
NODE_29133_length_568_cov_1.769723	192	233	0	41	41	1.0000000
NODE_29160_length_568_cov_1.358209	355	432	0	77	77	1.0000000
NODE_29182_length_568_cov_1.038380	195	275	1	20	80	0.2500000
NODE_29182_length_568_cov_1.038380	195	275	2	60	80	0.7500000
NODE_29216_length_567_cov_21.155983	347	427	3	10	80	0.1250000
NODE_29216_length_567_cov_21.155983	347	427	5	49	80	0.6125000
NODE_29216_length_567_cov_21.155983	347	427	6	7	80	0.0875000
NODE_29216_length_567_cov_21.155983	347	427	7	12	80	0.1500000
NODE_29216_length_567_cov_21.155983	347	427	8	2	80	0.0250000
NODE_29216_length_567_cov_21.155983	400	480	0	16	80	0.2000000
NODE_29216_length_567_cov_21.155983	400	480	2	13	80	0.1625000
NODE_29216_length_567_cov_21.155983	400	480	3	34	80	0.4250000
NODE_29216_length_567_cov_21.155983	400	480	5	17	80	0.2125000
NODE_29217_length_567_cov_18.292735	367	447	1	6	80	0.0750000
NODE_29217_length_567_cov_18.292735	367	447	2	74	80	0.9250000
NODE_29217_length_567_cov_18.292735	420	500	0	51	80	0.6375000
NODE_29217_length_567_cov_18.292735	420	500	1	8	80	0.1000000
NODE_29217_length_567_cov_18.292735	420	500	2	21	80	0.2625000
NODE_29218_length_567_cov_17.579060	259	339	0	25	80	0.3125000
NODE_29218_length_567_cov_17.579060	259	339	1	13	80	0.1625000
NODE_29218_length_567_cov_17.579060	259	339	2	42	80	0.5250000
NODE_29218_length_567_cov_17.579060	312	392	0	78	80	0.9750000
NODE_29218_length_567_cov_17.579060	312	392	1	2	80	0.0250000
NODE_29220_length_567_cov_15.457265	276	356	1	46	80	0.5750000
NODE_29220_length_567_cov_15.457265	276	356	3	34	80	0.4250000
NODE_29220_length_567_cov_15.457265	329	409	0	44	80	0.5500000
NODE_29220_length_567_cov_15.457265	329	409	1	36	80	0.4500000
NODE_29221_length_567_cov_14.393162	270	350	1	80	80	1.0000000
NODE_29221_length_567_cov_14.393162	323	403	0	13	80	0.1625000
NODE_29221_length_567_cov_14.393162	323	403	1	67	80	0.8375000
NODE_29225_length_567_cov_6.611111	356	436	0	51	80	0.6375000
NODE_29225_length_567_cov_6.611111	356	436	2	29	80	0.3625000
NODE_29225_length_567_cov_6.611111	409	489	2	80	80	1.0000000
NODE_29245_length_567_cov_2.884615	204	284	0	80	80	1.0000000
NODE_29245_length_567_cov_2.884615	204	254	0	50	50	1.0000000
NODE_29245_length_567_cov_2.884615	266	297	0	31	31	1.0000000
NODE_29363_length_566_cov_47.747323	157	237	3	11	80	0.1375000
NODE_29363_length_566_cov_47.747323	157	237	4	69	80	0.8625000
NODE_29363_length_566_cov_47.747323	210	290	3	2	80	0.0250000
NODE_29363_length_566_cov_47.747323	210	290	4	78	80	0.9750000
NODE_29364_length_566_cov_44.824411	14	94	9	5	80	0.0625000
NODE_29364_length_566_cov_44.824411	14	94	11	46	80	0.5750000
NODE_29364_length_566_cov_44.824411	14	94	12	29	80	0.3625000
NODE_29364_length_566_cov_44.824411	15	94	9	4	79	0.0506329
NODE_29364_length_566_cov_44.824411	15	94	11	46	79	0.5822785
NODE_29364_length_566_cov_44.824411	15	94	12	29	79	0.3670886
NODE_29364_length_566_cov_44.824411	67	147	9	5	80	0.0625000
NODE_29364_length_566_cov_44.824411	67	147	10	30	80	0.3750000
NODE_29364_length_566_cov_44.824411	67	147	11	4	80	0.0500000
NODE_29364_length_566_cov_44.824411	67	147	12	29	80	0.3625000
NODE_29364_length_566_cov_44.824411	67	147	13	12	80	0.1500000
NODE_29364_length_566_cov_44.824411	67	147	9	5	80	0.0625000
NODE_29364_length_566_cov_44.824411	67	147	10	30	80	0.3750000
NODE_29364_length_566_cov_44.824411	67	147	11	4	80	0.0500000
NODE_29364_length_566_cov_44.824411	67	147	12	29	80	0.3625000
NODE_29364_length_566_cov_44.824411	67	147	13	12	80	0.1500000
NODE_29364_length_566_cov_44.824411	77	147	9	5	70	0.0714286
NODE_29364_length_566_cov_44.824411	77	147	10	30	70	0.4285714
NODE_29364_length_566_cov_44.824411	77	147	11	4	70	0.0571429
NODE_29364_length_566_cov_44.824411	77	147	12	19	70	0.2714286
NODE_29364_length_566_cov_44.824411	77	147	13	12	70	0.1714286
NODE_29364_length_566_cov_44.824411	143	223	3	8	80	0.1000000
NODE_29364_length_566_cov_44.824411	143	223	4	62	80	0.7750000
NODE_29364_length_566_cov_44.824411	143	223	5	3	80	0.0375000
NODE_29364_length_566_cov_44.824411	143	223	6	2	80	0.0250000
NODE_29364_length_566_cov_44.824411	143	223	9	3	80	0.0375000
NODE_29364_length_566_cov_44.824411	143	223	11	2	80	0.0250000
NODE_29364_length_566_cov_44.824411	196	276	1	6	80	0.0750000
NODE_29364_length_566_cov_44.824411	196	276	2	25	80	0.3125000
NODE_29364_length_566_cov_44.824411	196	276	3	30	80	0.3750000
NODE_29364_length_566_cov_44.824411	196	276	4	19	80	0.2375000
NODE_29367_length_566_cov_18.494647	344	424	0	54	80	0.6750000
NODE_29367_length_566_cov_18.494647	344	424	2	26	80	0.3250000
NODE_29367_length_566_cov_18.494647	397	477	0	1	80	0.0125000
NODE_29367_length_566_cov_18.494647	397	477	2	79	80	0.9875000
NODE_29368_length_566_cov_17.537473	324	404	0	80	80	1.0000000
NODE_29368_length_566_cov_17.537473	377	457	0	80	80	1.0000000
NODE_29369_length_566_cov_13.019272	157	237	3	1	80	0.0125000
NODE_29369_length_566_cov_13.019272	157	237	4	19	80	0.2375000
NODE_29369_length_566_cov_13.019272	157	237	5	60	80	0.7500000
NODE_29369_length_566_cov_13.019272	210	290	3	17	80	0.2125000
NODE_29369_length_566_cov_13.019272	210	290	4	9	80	0.1125000
NODE_29369_length_566_cov_13.019272	210	290	5	53	80	0.6625000
NODE_29369_length_566_cov_13.019272	210	290	6	1	80	0.0125000
NODE_29371_length_566_cov_9.513919	191	279	2	10	88	0.1136364
NODE_29371_length_566_cov_9.513919	191	279	3	75	88	0.8522727
NODE_29371_length_566_cov_9.513919	191	279	4	3	88	0.0340909
NODE_29371_length_566_cov_9.513919	252	332	3	24	80	0.3000000
NODE_29371_length_566_cov_9.513919	252	332	4	17	80	0.2125000
NODE_29371_length_566_cov_9.513919	252	332	6	19	80	0.2375000
NODE_29371_length_566_cov_9.513919	252	332	7	20	80	0.2500000
NODE_29397_length_566_cov_3.239829	292	334	0	42	42	1.0000000
NODE_29397_length_566_cov_3.239829	351	375	0	24	24	1.0000000
NODE_29437_length_566_cov_1.698073	432	481	1	49	49	1.0000000
NODE_29472_length_566_cov_0.957173	378	405	0	27	27	1.0000000
NODE_29503_length_565_cov_10.508584	202	280	0	61	78	0.7820513
NODE_29503_length_565_cov_10.508584	202	280	2	17	78	0.2179487
NODE_29503_length_565_cov_10.508584	253	334	0	10	81	0.1234568
NODE_29503_length_565_cov_10.508584	253	334	2	71	81	0.8765432
NODE_29509_length_565_cov_7.560086	170	246	1	73	76	0.9605263
NODE_29509_length_565_cov_7.560086	170	246	3	3	76	0.0394737
NODE_29520_length_565_cov_4.045064	231	311	0	80	80	1.0000000
NODE_29520_length_565_cov_4.045064	284	364	0	80	80	1.0000000
NODE_29528_length_565_cov_3.399142	161	241	1	9	80	0.1125000
NODE_29528_length_565_cov_3.399142	161	241	2	17	80	0.2125000
NODE_29528_length_565_cov_3.399142	161	241	3	51	80	0.6375000
NODE_29528_length_565_cov_3.399142	161	241	4	3	80	0.0375000
NODE_29528_length_565_cov_3.399142	214	294	3	24	80	0.3000000
NODE_29528_length_565_cov_3.399142	214	294	4	56	80	0.7000000
NODE_29542_length_565_cov_2.542918	302	382	1	80	80	1.0000000
NODE_29542_length_565_cov_2.542918	355	435	0	40	80	0.5000000
NODE_29542_length_565_cov_2.542918	355	435	1	40	80	0.5000000
NODE_29650_length_564_cov_46.901075	129	209	6	40	80	0.5000000
NODE_29650_length_564_cov_46.901075	129	209	7	19	80	0.2375000
NODE_29650_length_564_cov_46.901075	129	209	8	21	80	0.2625000
NODE_29650_length_564_cov_46.901075	182	262	4	33	80	0.4125000
NODE_29650_length_564_cov_46.901075	182	262	5	8	80	0.1000000
NODE_29650_length_564_cov_46.901075	182	262	6	39	80	0.4875000
NODE_29651_length_564_cov_13.520430	300	380	2	80	80	1.0000000
NODE_29651_length_564_cov_13.520430	353	433	0	4	80	0.0500000
NODE_29651_length_564_cov_13.520430	353	433	2	76	80	0.9500000
NODE_29653_length_564_cov_7.965591	291	332	0	41	41	1.0000000
NODE_29796_length_563_cov_24.487069	97	177	4	25	80	0.3125000
NODE_29796_length_563_cov_24.487069	97	177	5	32	80	0.4000000
NODE_29796_length_563_cov_24.487069	97	177	6	23	80	0.2875000
NODE_29796_length_563_cov_24.487069	150	230	3	36	80	0.4500000
NODE_29796_length_563_cov_24.487069	150	230	4	4	80	0.0500000
NODE_29796_length_563_cov_24.487069	150	230	5	10	80	0.1250000
NODE_29796_length_563_cov_24.487069	150	230	6	30	80	0.3750000
NODE_29800_length_563_cov_6.758621	301	367	4	45	66	0.6818182
NODE_29800_length_563_cov_6.758621	301	367	5	21	66	0.3181818
NODE_29800_length_563_cov_6.758621	378	422	3	10	44	0.2272727
NODE_29800_length_563_cov_6.758621	378	422	4	21	44	0.4772727
NODE_29800_length_563_cov_6.758621	378	422	5	13	44	0.2954545
NODE_29802_length_563_cov_5.762931	48	135	2	87	87	1.0000000
NODE_29802_length_563_cov_5.762931	108	188	0	9	80	0.1125000
NODE_29802_length_563_cov_5.762931	108	188	1	9	80	0.1125000
NODE_29802_length_563_cov_5.762931	108	188	2	62	80	0.7750000
NODE_29808_length_563_cov_4.176724	197	277	0	80	80	1.0000000
NODE_29808_length_563_cov_4.176724	250	330	0	80	80	1.0000000
NODE_29809_length_563_cov_4.155172	273	315	1	1	42	0.0238095
NODE_29809_length_563_cov_4.155172	273	315	2	1	42	0.0238095
NODE_29809_length_563_cov_4.155172	273	315	3	32	42	0.7619048
NODE_29809_length_563_cov_4.155172	273	315	4	8	42	0.1904762
NODE_29809_length_563_cov_4.155172	288	358	3	19	70	0.2714286
NODE_29809_length_563_cov_4.155172	288	358	4	51	70	0.7285714
NODE_29925_length_562_cov_31.194384	47	127	0	31	80	0.3875000
NODE_29925_length_562_cov_31.194384	47	127	2	49	80	0.6125000
NODE_29925_length_562_cov_31.194384	100	180	0	19	80	0.2375000
NODE_29925_length_562_cov_31.194384	100	180	2	61	80	0.7625000
NODE_29926_length_562_cov_29.857451	33	113	0	48	80	0.6000000
NODE_29926_length_562_cov_29.857451	33	113	1	32	80	0.4000000
NODE_29926_length_562_cov_29.857451	86	166	1	80	80	1.0000000
NODE_29927_length_562_cov_23.194384	245	325	3	3	80	0.0375000
NODE_29927_length_562_cov_23.194384	245	325	4	50	80	0.6250000
NODE_29927_length_562_cov_23.194384	245	325	5	11	80	0.1375000
NODE_29927_length_562_cov_23.194384	245	325	6	16	80	0.2000000
NODE_29927_length_562_cov_23.194384	298	378	3	43	80	0.5375000
NODE_29927_length_562_cov_23.194384	298	378	4	16	80	0.2000000
NODE_29927_length_562_cov_23.194384	298	378	5	5	80	0.0625000
NODE_29927_length_562_cov_23.194384	298	378	6	16	80	0.2000000
NODE_29930_length_562_cov_10.304536	271	321	5	50	50	1.0000000
NODE_29931_length_562_cov_9.131749	265	346	2	81	81	1.0000000
NODE_29931_length_562_cov_9.131749	319	399	0	42	80	0.5250000
NODE_29931_length_562_cov_9.131749	319	399	2	38	80	0.4750000
NODE_29960_length_562_cov_2.961123	350	398	0	48	48	1.0000000
NODE_30083_length_561_cov_18.049784	54	134	0	80	80	1.0000000
NODE_30083_length_561_cov_18.049784	107	187	0	80	80	1.0000000
NODE_30087_length_561_cov_5.348485	208	274	2	66	66	1.0000000
NODE_30105_length_561_cov_2.787879	216	285	1	44	69	0.6376812
NODE_30105_length_561_cov_2.787879	216	285	2	25	69	0.3623188
NODE_30120_length_561_cov_2.233766	339	419	0	80	80	1.0000000
NODE_30120_length_561_cov_2.233766	391	445	0	54	54	1.0000000
NODE_30120_length_561_cov_2.233766	392	438	0	46	46	1.0000000
NODE_30133_length_561_cov_1.803030	258	334	3	76	76	1.0000000
NODE_30224_length_560_cov_41.433839	67	147	0	80	80	1.0000000
NODE_30224_length_560_cov_41.433839	120	200	0	80	80	1.0000000
NODE_30225_length_560_cov_35.993492	366	446	3	43	80	0.5375000
NODE_30225_length_560_cov_35.993492	366	446	4	37	80	0.4625000
NODE_30225_length_560_cov_35.993492	419	499	1	4	80	0.0500000
NODE_30225_length_560_cov_35.993492	419	499	2	46	80	0.5750000
NODE_30225_length_560_cov_35.993492	419	499	3	20	80	0.2500000
NODE_30225_length_560_cov_35.993492	419	499	4	10	80	0.1250000
NODE_30226_length_560_cov_20.433839	342	422	0	15	80	0.1875000
NODE_30226_length_560_cov_20.433839	342	422	1	16	80	0.2000000
NODE_30226_length_560_cov_20.433839	342	422	2	5	80	0.0625000
NODE_30226_length_560_cov_20.433839	342	422	3	44	80	0.5500000
NODE_30226_length_560_cov_20.433839	395	475	3	80	80	1.0000000
NODE_30227_length_560_cov_13.850325	274	327	3	25	53	0.4716981
NODE_30227_length_560_cov_13.850325	274	327	4	28	53	0.5283019
NODE_30228_length_560_cov_12.075922	233	314	3	7	81	0.0864198
NODE_30228_length_560_cov_12.075922	233	314	5	8	81	0.0987654
NODE_30228_length_560_cov_12.075922	233	314	6	37	81	0.4567901
NODE_30228_length_560_cov_12.075922	233	314	7	25	81	0.3086420
NODE_30228_length_560_cov_12.075922	233	314	8	4	81	0.0493827
NODE_30229_length_560_cov_8.594360	263	343	0	80	80	1.0000000
NODE_30229_length_560_cov_8.594360	316	396	0	80	80	1.0000000
NODE_30237_length_560_cov_5.227766	264	328	3	28	64	0.4375000
NODE_30237_length_560_cov_5.227766	264	328	4	4	64	0.0625000
NODE_30237_length_560_cov_5.227766	264	328	5	32	64	0.5000000
NODE_30238_length_560_cov_5.056399	299	379	0	80	80	1.0000000
NODE_30238_length_560_cov_5.056399	352	432	0	80	80	1.0000000
NODE_30244_length_560_cov_4.518438	156	236	0	80	80	1.0000000
NODE_30281_length_560_cov_2.154013	204	275	0	19	71	0.2676056
NODE_30281_length_560_cov_2.154013	204	275	2	52	71	0.7323943
NODE_30281_length_560_cov_2.154013	255	335	0	6	80	0.0750000
NODE_30281_length_560_cov_2.154013	255	335	2	74	80	0.9250000
NODE_30288_length_560_cov_2.017354	52	114	3	62	62	1.0000000
NODE_30363_length_559_cov_37.526087	289	370	0	81	81	1.0000000
NODE_30363_length_559_cov_37.526087	343	423	0	80	80	1.0000000
NODE_30363_length_559_cov_37.526087	419	500	0	81	81	1.0000000
NODE_30363_length_559_cov_37.526087	473	553	0	80	80	1.0000000
NODE_30365_length_559_cov_19.126087	388	468	0	80	80	1.0000000
NODE_30365_length_559_cov_19.126087	441	521	0	80	80	1.0000000
NODE_30366_length_559_cov_12.489130	262	341	1	28	79	0.3544304
NODE_30366_length_559_cov_12.489130	262	341	2	51	79	0.6455696
NODE_30366_length_559_cov_12.489130	316	394	2	78	78	1.0000000
NODE_30370_length_559_cov_6.530435	283	363	2	39	80	0.4875000
NODE_30370_length_559_cov_6.530435	283	363	3	3	80	0.0375000
NODE_30370_length_559_cov_6.530435	283	363	4	1	80	0.0125000
NODE_30370_length_559_cov_6.530435	283	363	5	3	80	0.0375000
NODE_30370_length_559_cov_6.530435	283	363	7	21	80	0.2625000
NODE_30370_length_559_cov_6.530435	283	363	8	13	80	0.1625000
NODE_30377_length_559_cov_4.930435	112	192	0	80	80	1.0000000
NODE_30377_length_559_cov_4.930435	165	244	0	79	79	1.0000000
NODE_30419_length_559_cov_1.776087	395	433	100	1	38	0.0263158
NODE_30419_length_559_cov_1.776087	395	433	101	3	38	0.0789474
NODE_30419_length_559_cov_1.776087	395	433	103	3	38	0.0789474
NODE_30419_length_559_cov_1.776087	395	433	104	9	38	0.2368421
NODE_30419_length_559_cov_1.776087	395	433	105	17	38	0.4473684
NODE_30419_length_559_cov_1.776087	395	433	106	5	38	0.1315790
NODE_30480_length_558_cov_13.102397	297	364	0	67	67	1.0000000
NODE_30482_length_558_cov_9.309368	369	449	2	80	80	1.0000000
NODE_30482_length_558_cov_9.309368	422	502	0	2	80	0.0250000
NODE_30482_length_558_cov_9.309368	422	502	1	32	80	0.4000000
NODE_30482_length_558_cov_9.309368	422	502	2	46	80	0.5750000
NODE_30489_length_558_cov_5.921569	304	361	0	57	57	1.0000000
NODE_30493_length_558_cov_4.801743	197	266	2	12	69	0.1739130
NODE_30493_length_558_cov_4.801743	197	266	3	15	69	0.2173913
NODE_30493_length_558_cov_4.801743	197	266	4	42	69	0.6086956
NODE_30493_length_558_cov_4.801743	197	277	2	12	80	0.1500000
NODE_30493_length_558_cov_4.801743	197	277	3	15	80	0.1875000
NODE_30493_length_558_cov_4.801743	197	277	4	53	80	0.6625000
NODE_30493_length_558_cov_4.801743	250	330	4	58	80	0.7250000
NODE_30493_length_558_cov_4.801743	250	330	5	2	80	0.0250000
NODE_30493_length_558_cov_4.801743	250	330	6	18	80	0.2250000
NODE_30493_length_558_cov_4.801743	250	330	7	2	80	0.0250000
NODE_30493_length_558_cov_4.801743	250	330	4	58	80	0.7250000
NODE_30493_length_558_cov_4.801743	250	330	5	2	80	0.0250000
NODE_30493_length_558_cov_4.801743	250	330	6	18	80	0.2250000
NODE_30493_length_558_cov_4.801743	250	330	7	2	80	0.0250000
NODE_30495_length_558_cov_4.570806	188	244	0	20	56	0.3571429
NODE_30495_length_558_cov_4.570806	188	244	1	36	56	0.6428571
NODE_30536_length_558_cov_2.259259	236	294	2	58	58	1.0000000
NODE_30536_length_558_cov_2.259259	267	347	0	13	80	0.1625000
NODE_30536_length_558_cov_2.259259	267	347	2	67	80	0.8375000
NODE_30568_length_558_cov_1.544662	403	483	0	80	80	1.0000000
NODE_30568_length_558_cov_1.544662	456	536	0	80	80	1.0000000
NODE_30623_length_557_cov_9.141921	255	335	1	14	80	0.1750000
NODE_30623_length_557_cov_9.141921	255	335	2	66	80	0.8250000
NODE_30623_length_557_cov_9.141921	308	388	1	67	80	0.8375000
NODE_30623_length_557_cov_9.141921	308	388	2	13	80	0.1625000
NODE_30626_length_557_cov_7.316594	210	290	2	35	80	0.4375000
NODE_30626_length_557_cov_7.316594	210	290	3	14	80	0.1750000
NODE_30626_length_557_cov_7.316594	210	290	5	31	80	0.3875000
NODE_30626_length_557_cov_7.316594	263	341	0	26	78	0.3333333
NODE_30626_length_557_cov_7.316594	263	341	1	23	78	0.2948718
NODE_30626_length_557_cov_7.316594	263	341	2	29	78	0.3717949
NODE_30636_length_557_cov_4.259825	185	267	1	82	82	1.0000000
NODE_30646_length_557_cov_3.794760	131	188	1	7	57	0.1228070
NODE_30646_length_557_cov_3.794760	131	188	2	50	57	0.8771930
NODE_30646_length_557_cov_3.794760	139	219	1	38	80	0.4750000
NODE_30646_length_557_cov_3.794760	139	219	2	42	80	0.5250000
NODE_30650_length_557_cov_3.517467	246	325	0	5	79	0.0632911
NODE_30650_length_557_cov_3.517467	246	325	1	74	79	0.9367089
NODE_30650_length_557_cov_3.517467	298	378	1	43	80	0.5375000
NODE_30650_length_557_cov_3.517467	298	378	2	12	80	0.1500000
NODE_30650_length_557_cov_3.517467	298	378	3	25	80	0.3125000
NODE_30652_length_557_cov_3.390830	366	395	8	29	29	1.0000000
NODE_30792_length_556_cov_37.258206	122	202	2	43	80	0.5375000
NODE_30792_length_556_cov_37.258206	122	202	4	37	80	0.4625000
NODE_30792_length_556_cov_37.258206	175	255	0	53	80	0.6625000
NODE_30792_length_556_cov_37.258206	175	255	2	27	80	0.3375000
NODE_30793_length_556_cov_15.266958	360	440	2	65	80	0.8125000
NODE_30793_length_556_cov_15.266958	360	440	3	15	80	0.1875000
NODE_30793_length_556_cov_15.266958	413	493	1	10	80	0.1250000
NODE_30793_length_556_cov_15.266958	413	493	2	70	80	0.8750000
NODE_30794_length_556_cov_12.781182	341	421	0	80	80	1.0000000
NODE_30794_length_556_cov_12.781182	394	474	0	80	80	1.0000000
NODE_30795_length_556_cov_11.131291	304	384	1	6	80	0.0750000
NODE_30795_length_556_cov_11.131291	304	384	2	11	80	0.1375000
NODE_30795_length_556_cov_11.131291	304	384	3	16	80	0.2000000
NODE_30795_length_556_cov_11.131291	304	384	4	47	80	0.5875000
NODE_30795_length_556_cov_11.131291	357	437	4	80	80	1.0000000
NODE_30797_length_556_cov_7.168490	163	243	0	80	80	1.0000000
NODE_30797_length_556_cov_7.168490	216	296	0	80	80	1.0000000
NODE_30798_length_556_cov_7.089716	325	379	0	54	54	1.0000000
NODE_30801_length_556_cov_6.505470	232	312	0	80	80	1.0000000
NODE_30801_length_556_cov_6.505470	285	365	0	80	80	1.0000000
NODE_30802_length_556_cov_6.496718	140	179	3	4	39	0.1025641
NODE_30802_length_556_cov_6.496718	140	179	4	6	39	0.1538462
NODE_30802_length_556_cov_6.496718	140	179	6	4	39	0.1025641
NODE_30802_length_556_cov_6.496718	140	179	8	6	39	0.1538462
NODE_30802_length_556_cov_6.496718	140	179	9	3	39	0.0769231
NODE_30802_length_556_cov_6.496718	140	179	10	16	39	0.4102564
NODE_30802_length_556_cov_6.496718	226	255	4	22	29	0.7586207
NODE_30802_length_556_cov_6.496718	226	255	6	7	29	0.2413793
NODE_30809_length_556_cov_4.457330	197	277	2	33	80	0.4125000
NODE_30809_length_556_cov_4.457330	197	277	3	15	80	0.1875000
NODE_30809_length_556_cov_4.457330	197	277	4	17	80	0.2125000
NODE_30809_length_556_cov_4.457330	197	277	5	1	80	0.0125000
NODE_30809_length_556_cov_4.457330	197	277	6	14	80	0.1750000
NODE_30818_length_556_cov_3.761488	234	307	5	35	73	0.4794520
NODE_30818_length_556_cov_3.761488	234	307	6	38	73	0.5205479
NODE_30930_length_555_cov_20.949561	322	402	2	80	80	1.0000000
NODE_30930_length_555_cov_20.949561	375	455	0	33	80	0.4125000
NODE_30930_length_555_cov_20.949561	375	455	2	47	80	0.5875000
NODE_30931_length_555_cov_16.822368	268	348	3	2	80	0.0250000
NODE_30931_length_555_cov_16.822368	268	348	4	32	80	0.4000000
NODE_30931_length_555_cov_16.822368	268	348	5	21	80	0.2625000
NODE_30931_length_555_cov_16.822368	268	348	6	25	80	0.3125000
NODE_30931_length_555_cov_16.822368	321	401	2	34	80	0.4250000
NODE_30931_length_555_cov_16.822368	321	401	3	21	80	0.2625000
NODE_30931_length_555_cov_16.822368	321	401	5	9	80	0.1125000
NODE_30931_length_555_cov_16.822368	321	401	6	16	80	0.2000000
NODE_30933_length_555_cov_9.912281	313	393	0	80	80	1.0000000
NODE_30935_length_555_cov_8.057018	277	357	0	44	80	0.5500000
NODE_30935_length_555_cov_8.057018	277	357	1	36	80	0.4500000
NODE_30935_length_555_cov_8.057018	330	410	1	53	80	0.6625000
NODE_30935_length_555_cov_8.057018	330	410	2	27	80	0.3375000
NODE_30938_length_555_cov_6.778509	62	92	0	30	30	1.0000000
NODE_30986_length_555_cov_2.177632	208	288	0	54	80	0.6750000
NODE_30986_length_555_cov_2.177632	208	288	2	26	80	0.3250000
NODE_30986_length_555_cov_2.177632	261	329	0	1	68	0.0147059
NODE_30986_length_555_cov_2.177632	261	329	2	67	68	0.9852941
NODE_31092_length_554_cov_11.942857	118	198	0	79	80	0.9875000
NODE_31092_length_554_cov_11.942857	118	198	1	1	80	0.0125000
NODE_31092_length_554_cov_11.942857	171	251	0	80	80	1.0000000
NODE_31096_length_554_cov_8.426374	242	322	0	80	80	1.0000000
NODE_31096_length_554_cov_8.426374	295	375	0	80	80	1.0000000
NODE_31101_length_554_cov_6.116484	264	344	0	38	80	0.4750000
NODE_31101_length_554_cov_6.116484	264	344	1	15	80	0.1875000
NODE_31101_length_554_cov_6.116484	264	344	2	27	80	0.3375000
NODE_31101_length_554_cov_6.116484	317	393	2	76	76	1.0000000
NODE_31115_length_554_cov_3.586813	207	286	1	34	79	0.4303797
NODE_31115_length_554_cov_3.586813	207	286	2	21	79	0.2658228
NODE_31115_length_554_cov_3.586813	207	286	3	6	79	0.0759494
NODE_31115_length_554_cov_3.586813	207	286	4	18	79	0.2278481
NODE_31240_length_553_cov_42.017621	197	277	3	39	80	0.4875000
NODE_31240_length_553_cov_42.017621	197	277	4	41	80	0.5125000
NODE_31240_length_553_cov_42.017621	250	330	1	5	80	0.0625000
NODE_31240_length_553_cov_42.017621	250	330	2	9	80	0.1125000
NODE_31240_length_553_cov_42.017621	250	330	3	57	80	0.7125000
NODE_31240_length_553_cov_42.017621	250	330	4	9	80	0.1125000
NODE_31241_length_553_cov_28.944934	333	413	3	39	80	0.4875000
NODE_31241_length_553_cov_28.944934	333	413	4	41	80	0.5125000
NODE_31241_length_553_cov_28.944934	386	466	1	6	80	0.0750000
NODE_31241_length_553_cov_28.944934	386	466	2	19	80	0.2375000
NODE_31241_length_553_cov_28.944934	386	466	3	1	80	0.0125000
NODE_31241_length_553_cov_28.944934	386	466	4	54	80	0.6750000
NODE_31242_length_553_cov_12.176211	242	322	0	80	80	1.0000000
NODE_31242_length_553_cov_12.176211	295	375	0	80	80	1.0000000
NODE_31244_length_553_cov_9.876652	232	312	0	80	80	1.0000000
NODE_31244_length_553_cov_9.876652	285	365	0	80	80	1.0000000
NODE_31246_length_553_cov_9.306167	207	287	0	80	80	1.0000000
NODE_31246_length_553_cov_9.306167	207	287	0	80	80	1.0000000
NODE_31246_length_553_cov_9.306167	260	340	0	80	80	1.0000000
NODE_31259_length_553_cov_3.729075	36	93	7	37	57	0.6491228
NODE_31259_length_553_cov_3.729075	36	93	9	6	57	0.1052632
NODE_31259_length_553_cov_3.729075	36	93	10	14	57	0.2456140
NODE_31259_length_553_cov_3.729075	89	146	10	57	57	1.0000000
NODE_31266_length_553_cov_3.310573	226	293	0	67	67	1.0000000
NODE_31279_length_553_cov_2.678414	102	180	0	59	78	0.7564102
NODE_31279_length_553_cov_2.678414	102	180	1	19	78	0.2435897
NODE_31279_length_553_cov_2.678414	248	275	2	27	27	1.0000000
NODE_31295_length_553_cov_1.958150	416	462	0	46	46	1.0000000
NODE_31295_length_553_cov_1.958150	469	515	0	46	46	1.0000000
NODE_31377_length_552_cov_92.070640	298	378	0	80	80	1.0000000
NODE_31377_length_552_cov_92.070640	298	378	0	80	80	1.0000000
NODE_31377_length_552_cov_92.070640	374	454	0	80	80	1.0000000
NODE_31377_length_552_cov_92.070640	374	454	0	80	80	1.0000000
NODE_31377_length_552_cov_92.070640	374	454	0	80	80	1.0000000
NODE_31377_length_552_cov_92.070640	374	454	0	80	80	1.0000000
NODE_31377_length_552_cov_92.070640	374	450	0	76	76	1.0000000
NODE_31377_length_552_cov_92.070640	427	507	0	80	80	1.0000000
NODE_31377_length_552_cov_92.070640	427	507	0	80	80	1.0000000
NODE_31377_length_552_cov_92.070640	427	498	0	71	71	1.0000000
NODE_31377_length_552_cov_92.070640	430	500	0	70	70	1.0000000
NODE_31377_length_552_cov_92.070640	432	507	0	75	75	1.0000000
NODE_31378_length_552_cov_20.432671	151	231	0	80	80	1.0000000
NODE_31378_length_552_cov_20.432671	204	284	0	80	80	1.0000000
NODE_31379_length_552_cov_18.075055	257	333	1	76	76	1.0000000
NODE_31380_length_552_cov_13.331126	214	294	0	80	80	1.0000000
NODE_31380_length_552_cov_13.331126	267	347	0	80	80	1.0000000
NODE_31381_length_552_cov_12.774834	360	440	1	36	80	0.4500000
NODE_31381_length_552_cov_12.774834	360	440	2	44	80	0.5500000
NODE_31381_length_552_cov_12.774834	413	493	1	59	80	0.7375000
NODE_31381_length_552_cov_12.774834	413	493	2	21	80	0.2625000
NODE_31384_length_552_cov_8.883002	310	390	0	16	80	0.2000000
NODE_31384_length_552_cov_8.883002	310	390	1	64	80	0.8000000
NODE_31384_length_552_cov_8.883002	363	443	1	43	80	0.5375000
NODE_31384_length_552_cov_8.883002	363	443	2	37	80	0.4625000
NODE_31385_length_552_cov_6.916115	206	281	5	75	75	1.0000000
NODE_31538_length_551_cov_34.070796	324	406	0	82	82	1.0000000
NODE_31538_length_551_cov_34.070796	379	444	0	65	65	1.0000000
NODE_31541_length_551_cov_10.252212	164	244	0	80	80	1.0000000
NODE_31541_length_551_cov_10.252212	217	297	0	80	80	1.0000000
NODE_31543_length_551_cov_8.075221	363	406	0	18	43	0.4186046
NODE_31543_length_551_cov_8.075221	363	406	2	25	43	0.5813953
NODE_31547_length_551_cov_5.668142	213	293	0	80	80	1.0000000
NODE_31547_length_551_cov_5.668142	266	346	0	80	80	1.0000000
NODE_31552_length_551_cov_4.212389	171	242	3	10	71	0.1408451
NODE_31552_length_551_cov_4.212389	171	242	4	1	71	0.0140845
NODE_31552_length_551_cov_4.212389	171	242	5	60	71	0.8450704
NODE_31552_length_551_cov_4.212389	215	263	3	31	48	0.6458333
NODE_31552_length_551_cov_4.212389	215	263	5	17	48	0.3541667
NODE_31563_length_551_cov_3.307522	227	307	0	80	80	1.0000000
NODE_31563_length_551_cov_3.307522	280	360	0	80	80	1.0000000
NODE_31693_length_550_cov_17.308204	101	181	0	10	80	0.1250000
NODE_31693_length_550_cov_17.308204	101	181	2	1	80	0.0125000
NODE_31693_length_550_cov_17.308204	101	181	4	15	80	0.1875000
NODE_31693_length_550_cov_17.308204	101	181	5	32	80	0.4000000
NODE_31693_length_550_cov_17.308204	101	181	6	22	80	0.2750000
NODE_31693_length_550_cov_17.308204	154	234	2	6	80	0.0750000
NODE_31693_length_550_cov_17.308204	154	234	3	18	80	0.2250000
NODE_31693_length_550_cov_17.308204	154	234	5	55	80	0.6875000
NODE_31693_length_550_cov_17.308204	154	234	6	1	80	0.0125000
NODE_31700_length_550_cov_5.580931	286	329	1	4	43	0.0930233
NODE_31700_length_550_cov_5.580931	286	329	2	3	43	0.0697674
NODE_31700_length_550_cov_5.580931	286	329	3	36	43	0.8372093
NODE_31701_length_550_cov_5.490022	458	500	0	4	42	0.0952381
NODE_31701_length_550_cov_5.490022	458	500	1	38	42	0.9047619
NODE_31701_length_550_cov_5.490022	459	523	0	27	64	0.4218750
NODE_31701_length_550_cov_5.490022	459	523	1	37	64	0.5781250
NODE_31703_length_550_cov_5.243902	194	274	0	80	80	1.0000000
NODE_31703_length_550_cov_5.243902	247	327	0	80	80	1.0000000
NODE_31706_length_550_cov_4.815965	184	264	0	80	80	1.0000000
NODE_31726_length_550_cov_3.252772	308	388	4	80	80	1.0000000
NODE_31756_length_550_cov_1.864745	189	259	0	70	70	1.0000000
NODE_31756_length_550_cov_1.864745	189	258	0	69	69	1.0000000
NODE_31847_length_549_cov_31.826667	216	292	9	31	76	0.4078947
NODE_31847_length_549_cov_31.826667	216	292	10	16	76	0.2105263
NODE_31847_length_549_cov_31.826667	216	292	11	20	76	0.2631579
NODE_31847_length_549_cov_31.826667	216	292	12	9	76	0.1184211
NODE_31847_length_549_cov_31.826667	267	331	6	8	64	0.1250000
NODE_31847_length_549_cov_31.826667	267	331	7	8	64	0.1250000
NODE_31847_length_549_cov_31.826667	267	331	8	12	64	0.1875000
NODE_31847_length_549_cov_31.826667	267	331	9	23	64	0.3593750
NODE_31847_length_549_cov_31.826667	267	331	10	7	64	0.1093750
NODE_31847_length_549_cov_31.826667	267	331	11	6	64	0.0937500
NODE_31848_length_549_cov_14.124444	174	263	1	20	89	0.2247191
NODE_31848_length_549_cov_14.124444	174	263	3	67	89	0.7528090
NODE_31848_length_549_cov_14.124444	174	263	4	2	89	0.0224719
NODE_31848_length_549_cov_14.124444	242	315	1	16	73	0.2191781
NODE_31848_length_549_cov_14.124444	242	315	3	19	73	0.2602740
NODE_31848_length_549_cov_14.124444	242	315	4	38	73	0.5205479
NODE_31857_length_549_cov_5.375556	181	257	132	1	76	0.0131579
NODE_31857_length_549_cov_5.375556	181	257	133	2	76	0.0263158
NODE_31857_length_549_cov_5.375556	181	257	134	1	76	0.0131579
NODE_31857_length_549_cov_5.375556	181	257	135	1	76	0.0131579
NODE_31857_length_549_cov_5.375556	181	257	137	1	76	0.0131579
NODE_31857_length_549_cov_5.375556	181	257	138	1	76	0.0131579
NODE_31857_length_549_cov_5.375556	181	257	143	3	76	0.0394737
NODE_31857_length_549_cov_5.375556	181	257	144	1	76	0.0131579
NODE_31857_length_549_cov_5.375556	181	257	146	1	76	0.0131579
NODE_31857_length_549_cov_5.375556	181	257	149	1	76	0.0131579
NODE_31857_length_549_cov_5.375556	181	257	151	2	76	0.0263158
NODE_31857_length_549_cov_5.375556	181	257	152	2	76	0.0263158
NODE_31857_length_549_cov_5.375556	181	257	153	1	76	0.0131579
NODE_31857_length_549_cov_5.375556	181	257	154	3	76	0.0394737
NODE_31857_length_549_cov_5.375556	181	257	156	1	76	0.0131579
NODE_31857_length_549_cov_5.375556	181	257	159	1	76	0.0131579
NODE_31857_length_549_cov_5.375556	181	257	161	5	76	0.0657895
NODE_31857_length_549_cov_5.375556	181	257	163	2	76	0.0263158
NODE_31857_length_549_cov_5.375556	181	257	164	3	76	0.0394737
NODE_31857_length_549_cov_5.375556	181	257	165	1	76	0.0131579
NODE_31857_length_549_cov_5.375556	181	257	168	1	76	0.0131579
NODE_31857_length_549_cov_5.375556	181	257	170	1	76	0.0131579
NODE_31857_length_549_cov_5.375556	181	257	171	2	76	0.0263158
NODE_31857_length_549_cov_5.375556	181	257	173	1	76	0.0131579
NODE_31857_length_549_cov_5.375556	181	257	174	3	76	0.0394737
NODE_31857_length_549_cov_5.375556	181	257	178	1	76	0.0131579
NODE_31857_length_549_cov_5.375556	181	257	182	1	76	0.0131579
NODE_31857_length_549_cov_5.375556	181	257	185	1	76	0.0131579
NODE_31857_length_549_cov_5.375556	181	257	188	2	76	0.0263158
NODE_31857_length_549_cov_5.375556	181	257	190	1	76	0.0131579
NODE_31857_length_549_cov_5.375556	181	257	195	1	76	0.0131579
NODE_31857_length_549_cov_5.375556	181	257	197	1	76	0.0131579
NODE_31857_length_549_cov_5.375556	181	257	198	1	76	0.0131579
NODE_31857_length_549_cov_5.375556	181	257	200	2	76	0.0263158
NODE_31857_length_549_cov_5.375556	181	257	204	1	76	0.0131579
NODE_31857_length_549_cov_5.375556	181	257	205	1	76	0.0131579
NODE_31857_length_549_cov_5.375556	181	257	206	1	76	0.0131579
NODE_31857_length_549_cov_5.375556	181	257	207	6	76	0.0789474
NODE_31857_length_549_cov_5.375556	181	257	208	3	76	0.0394737
NODE_31857_length_549_cov_5.375556	181	257	209	7	76	0.0921053
NODE_31857_length_549_cov_5.375556	181	257	210	2	76	0.0263158
NODE_31857_length_549_cov_5.375556	181	257	211	1	76	0.0131579
NODE_31857_length_549_cov_5.375556	181	257	212	1	76	0.0131579
NODE_31859_length_549_cov_4.933333	260	340	3	3	80	0.0375000
NODE_31859_length_549_cov_4.933333	260	340	5	13	80	0.1625000
NODE_31859_length_549_cov_4.933333	260	340	6	64	80	0.8000000
NODE_31864_length_549_cov_4.537778	345	430	0	85	85	1.0000000
NODE_31864_length_549_cov_4.537778	403	483	0	80	80	1.0000000
NODE_31865_length_549_cov_4.124444	406	486	9	7	80	0.0875000
NODE_31865_length_549_cov_4.124444	406	486	10	17	80	0.2125000
NODE_31865_length_549_cov_4.124444	406	486	11	17	80	0.2125000
NODE_31865_length_549_cov_4.124444	406	486	12	17	80	0.2125000
NODE_31865_length_549_cov_4.124444	406	486	13	22	80	0.2750000
NODE_31866_length_549_cov_3.931111	182	219	0	37	37	1.0000000
NODE_31868_length_549_cov_3.893333	287	367	0	80	80	1.0000000
NODE_31868_length_549_cov_3.893333	340	420	0	80	80	1.0000000
NODE_31887_length_549_cov_2.673333	282	343	0	61	61	1.0000000
NODE_31890_length_549_cov_2.622222	144	220	2	76	76	1.0000000
NODE_32013_length_548_cov_13.962138	285	371	0	10	86	0.1162791
NODE_32013_length_548_cov_13.962138	285	371	1	76	86	0.8837209
NODE_32013_length_548_cov_13.962138	344	424	0	63	80	0.7875000
NODE_32013_length_548_cov_13.962138	344	424	1	17	80	0.2125000
NODE_32022_length_548_cov_4.683742	261	336	0	75	75	1.0000000
NODE_32023_length_548_cov_4.670379	140	182	0	7	42	0.1666667
NODE_32023_length_548_cov_4.670379	140	182	1	35	42	0.8333333
NODE_32023_length_548_cov_4.670379	282	311	4	29	29	1.0000000
NODE_32023_length_548_cov_4.670379	410	455	2	12	45	0.2666667
NODE_32023_length_548_cov_4.670379	410	455	4	33	45	0.7333333
NODE_32029_length_548_cov_3.630290	111	177	2	6	66	0.0909091
NODE_32029_length_548_cov_3.630290	111	177	4	60	66	0.9090909
NODE_32039_length_548_cov_3.080178	142	191	1	43	49	0.8775510
NODE_32039_length_548_cov_3.080178	142	191	2	6	49	0.1224490
NODE_32180_length_547_cov_23.982143	243	323	0	19	80	0.2375000
NODE_32180_length_547_cov_23.982143	243	323	1	33	80	0.4125000
NODE_32180_length_547_cov_23.982143	243	323	3	11	80	0.1375000
NODE_32180_length_547_cov_23.982143	243	323	4	16	80	0.2000000
NODE_32180_length_547_cov_23.982143	243	323	6	1	80	0.0125000
NODE_32180_length_547_cov_23.982143	243	323	0	19	80	0.2375000
NODE_32180_length_547_cov_23.982143	243	323	1	33	80	0.4125000
NODE_32180_length_547_cov_23.982143	243	323	3	11	80	0.1375000
NODE_32180_length_547_cov_23.982143	243	323	4	16	80	0.2000000
NODE_32180_length_547_cov_23.982143	243	323	6	1	80	0.0125000
NODE_32180_length_547_cov_23.982143	252	323	0	10	71	0.1408451
NODE_32180_length_547_cov_23.982143	252	323	1	33	71	0.4647887
NODE_32180_length_547_cov_23.982143	252	323	3	11	71	0.1549296
NODE_32180_length_547_cov_23.982143	252	323	4	16	71	0.2253521
NODE_32180_length_547_cov_23.982143	252	323	6	1	71	0.0140845
NODE_32181_length_547_cov_23.555804	42	122	0	32	80	0.4000000
NODE_32181_length_547_cov_23.555804	42	122	1	44	80	0.5500000
NODE_32181_length_547_cov_23.555804	42	122	2	4	80	0.0500000
NODE_32181_length_547_cov_23.555804	95	175	1	23	80	0.2875000
NODE_32181_length_547_cov_23.555804	95	175	2	57	80	0.7125000
NODE_32183_length_547_cov_12.819196	190	270	0	31	80	0.3875000
NODE_32183_length_547_cov_12.819196	190	270	1	45	80	0.5625000
NODE_32183_length_547_cov_12.819196	190	270	2	4	80	0.0500000
NODE_32195_length_547_cov_5.207589	290	370	2	43	80	0.5375000
NODE_32195_length_547_cov_5.207589	290	370	3	37	80	0.4625000
NODE_32195_length_547_cov_5.207589	343	423	1	12	80	0.1500000
NODE_32195_length_547_cov_5.207589	343	423	2	54	80	0.6750000
NODE_32195_length_547_cov_5.207589	343	423	3	14	80	0.1750000
NODE_32197_length_547_cov_4.975446	411	488	2	31	77	0.4025974
NODE_32197_length_547_cov_4.975446	411	488	3	10	77	0.1298701
NODE_32197_length_547_cov_4.975446	411	488	4	36	77	0.4675325
NODE_32197_length_547_cov_4.975446	461	542	2	13	81	0.1604938
NODE_32197_length_547_cov_4.975446	461	542	3	48	81	0.5925926
NODE_32197_length_547_cov_4.975446	461	542	4	20	81	0.2469136
NODE_32199_length_547_cov_4.683036	451	492	0	6	41	0.1463415
NODE_32199_length_547_cov_4.683036	451	492	1	35	41	0.8536586
NODE_32204_length_547_cov_4.138393	97	175	4	18	78	0.2307692
NODE_32204_length_547_cov_4.138393	97	175	5	11	78	0.1410256
NODE_32204_length_547_cov_4.138393	97	175	6	2	78	0.0256410
NODE_32204_length_547_cov_4.138393	97	175	8	18	78	0.2307692
NODE_32204_length_547_cov_4.138393	97	175	10	20	78	0.2564103
NODE_32204_length_547_cov_4.138393	97	175	11	9	78	0.1153846
NODE_32204_length_547_cov_4.138393	151	228	7	25	77	0.3246753
NODE_32204_length_547_cov_4.138393	151	228	9	19	77	0.2467532
NODE_32204_length_547_cov_4.138393	151	228	10	24	77	0.3116883
NODE_32204_length_547_cov_4.138393	151	228	11	9	77	0.1168831
NODE_32206_length_547_cov_4.026786	136	216	0	80	80	1.0000000
NODE_32206_length_547_cov_4.026786	189	269	0	80	80	1.0000000
NODE_32215_length_547_cov_3.468750	219	299	0	80	80	1.0000000
NODE_32222_length_547_cov_2.901786	304	384	0	80	80	1.0000000
NODE_32347_length_546_cov_17.733781	159	239	1	35	80	0.4375000
NODE_32347_length_546_cov_17.733781	159	239	2	32	80	0.4000000
NODE_32347_length_546_cov_17.733781	159	239	3	13	80	0.1625000
NODE_32347_length_546_cov_17.733781	212	293	1	1	81	0.0123457
NODE_32347_length_546_cov_17.733781	212	293	2	28	81	0.3456790
NODE_32347_length_546_cov_17.733781	212	293	3	52	81	0.6419753
NODE_32348_length_546_cov_16.275168	272	352	0	7	80	0.0875000
NODE_32348_length_546_cov_16.275168	272	352	1	20	80	0.2500000
NODE_32348_length_546_cov_16.275168	272	352	2	53	80	0.6625000
NODE_32348_length_546_cov_16.275168	325	405	0	60	80	0.7500000
NODE_32348_length_546_cov_16.275168	325	405	1	20	80	0.2500000
NODE_32349_length_546_cov_8.201342	179	259	4	24	80	0.3000000
NODE_32349_length_546_cov_8.201342	179	259	5	14	80	0.1750000
NODE_32349_length_546_cov_8.201342	179	259	6	6	80	0.0750000
NODE_32349_length_546_cov_8.201342	179	259	7	36	80	0.4500000
NODE_32351_length_546_cov_7.454139	241	321	0	80	80	1.0000000
NODE_32351_length_546_cov_7.454139	294	374	0	80	80	1.0000000
NODE_32380_length_546_cov_3.192394	171	251	0	39	80	0.4875000
NODE_32380_length_546_cov_3.192394	171	251	1	35	80	0.4375000
NODE_32380_length_546_cov_3.192394	171	251	2	6	80	0.0750000
NODE_32510_length_545_cov_31.524664	38	118	0	80	80	1.0000000
NODE_32510_length_545_cov_31.524664	91	171	0	80	80	1.0000000
NODE_32517_length_545_cov_5.524664	268	348	2	76	80	0.9500000
NODE_32517_length_545_cov_5.524664	268	348	4	4	80	0.0500000
NODE_32525_length_545_cov_3.885650	137	217	1	47	80	0.5875000
NODE_32525_length_545_cov_3.885650	137	217	2	33	80	0.4125000
NODE_32571_length_545_cov_2.013453	246	318	0	5	72	0.0694444
NODE_32571_length_545_cov_2.013453	246	318	2	67	72	0.9305556
NODE_32599_length_545_cov_1.450673	130	179	0	48	49	0.9795918
NODE_32599_length_545_cov_1.450673	130	179	2	1	49	0.0204082
NODE_32616_length_545_cov_1.179372	431	469	0	38	38	1.0000000
NODE_32673_length_544_cov_37.705618	258	338	1	53	80	0.6625000
NODE_32673_length_544_cov_37.705618	258	338	2	27	80	0.3375000
NODE_32673_length_544_cov_37.705618	311	391	1	59	80	0.7375000
NODE_32673_length_544_cov_37.705618	311	391	2	21	80	0.2625000
NODE_32674_length_544_cov_33.847191	189	269	0	5	80	0.0625000
NODE_32674_length_544_cov_33.847191	189	269	1	75	80	0.9375000
NODE_32674_length_544_cov_33.847191	242	327	0	63	85	0.7411765
NODE_32674_length_544_cov_33.847191	242	327	1	22	85	0.2588235
NODE_32675_length_544_cov_19.467416	251	331	2	80	80	1.0000000
NODE_32675_length_544_cov_19.467416	304	384	0	25	80	0.3125000
NODE_32675_length_544_cov_19.467416	304	384	2	55	80	0.6875000
NODE_32676_length_544_cov_16.775281	163	243	0	80	80	1.0000000
NODE_32676_length_544_cov_16.775281	216	296	0	80	80	1.0000000
NODE_32677_length_544_cov_8.943820	81	161	0	80	80	1.0000000
NODE_32677_length_544_cov_8.943820	134	214	0	80	80	1.0000000
NODE_32678_length_544_cov_8.537079	283	363	2	4	80	0.0500000
NODE_32678_length_544_cov_8.537079	283	363	3	76	80	0.9500000
NODE_32678_length_544_cov_8.537079	336	416	1	19	80	0.2375000
NODE_32678_length_544_cov_8.537079	336	416	3	61	80	0.7625000
NODE_32680_length_544_cov_8.440449	209	289	5	44	80	0.5500000
NODE_32680_length_544_cov_8.440449	209	289	6	14	80	0.1750000
NODE_32680_length_544_cov_8.440449	209	289	7	22	80	0.2750000
NODE_32680_length_544_cov_8.440449	262	342	2	2	80	0.0250000
NODE_32680_length_544_cov_8.440449	262	342	3	41	80	0.5125000
NODE_32680_length_544_cov_8.440449	262	342	5	19	80	0.2375000
NODE_32680_length_544_cov_8.440449	262	342	7	18	80	0.2250000
NODE_32681_length_544_cov_7.604494	332	412	0	56	80	0.7000000
NODE_32681_length_544_cov_7.604494	332	412	2	24	80	0.3000000
NODE_32681_length_544_cov_7.604494	385	465	0	80	80	1.0000000
NODE_32684_length_544_cov_6.000000	461	513	2	52	52	1.0000000
NODE_32830_length_543_cov_38.790541	116	196	0	38	80	0.4750000
NODE_32830_length_543_cov_38.790541	116	196	2	42	80	0.5250000
NODE_32830_length_543_cov_38.790541	169	249	0	15	80	0.1875000
NODE_32830_length_543_cov_38.790541	169	249	2	65	80	0.8125000
NODE_32831_length_543_cov_31.713964	193	273	4	29	80	0.3625000
NODE_32831_length_543_cov_31.713964	193	273	5	25	80	0.3125000
NODE_32831_length_543_cov_31.713964	193	273	6	26	80	0.3250000
NODE_32831_length_543_cov_31.713964	246	326	3	14	80	0.1750000
NODE_32831_length_543_cov_31.713964	246	326	5	56	80	0.7000000
NODE_32831_length_543_cov_31.713964	246	326	6	10	80	0.1250000
NODE_32832_length_543_cov_13.689189	118	198	0	80	80	1.0000000
NODE_32832_length_543_cov_13.689189	171	251	0	80	80	1.0000000
NODE_32833_length_543_cov_10.601351	271	351	2	35	80	0.4375000
NODE_32833_length_543_cov_10.601351	271	351	3	45	80	0.5625000
NODE_32833_length_543_cov_10.601351	324	404	2	24	80	0.3000000
NODE_32833_length_543_cov_10.601351	324	404	3	56	80	0.7000000
NODE_32833_length_543_cov_10.601351	400	480	3	80	80	1.0000000
NODE_32833_length_543_cov_10.601351	453	533	1	10	80	0.1250000
NODE_32833_length_543_cov_10.601351	453	533	2	31	80	0.3875000
NODE_32833_length_543_cov_10.601351	453	533	3	39	80	0.4875000
NODE_32834_length_543_cov_9.202703	291	341	1	3	50	0.0600000
NODE_32834_length_543_cov_9.202703	291	341	3	40	50	0.8000000
NODE_32834_length_543_cov_9.202703	291	341	4	6	50	0.1200000
NODE_32834_length_543_cov_9.202703	291	341	5	1	50	0.0200000
NODE_32834_length_543_cov_9.202703	347	384	0	34	37	0.9189189
NODE_32834_length_543_cov_9.202703	347	384	1	3	37	0.0810811
NODE_32835_length_543_cov_7.722973	300	378	0	36	78	0.4615385
NODE_32835_length_543_cov_7.722973	300	378	2	42	78	0.5384616
NODE_32835_length_543_cov_7.722973	351	431	0	80	80	1.0000000
NODE_32836_length_543_cov_6.815315	181	260	0	4	79	0.0506329
NODE_32836_length_543_cov_6.815315	181	260	1	13	79	0.1645570
NODE_32836_length_543_cov_6.815315	181	260	3	62	79	0.7848101
NODE_32845_length_543_cov_4.704955	145	225	1	80	80	1.0000000
NODE_32845_length_543_cov_4.704955	198	275	1	70	77	0.9090909
NODE_32845_length_543_cov_4.704955	198	275	2	7	77	0.0909091
NODE_32864_length_543_cov_3.301802	247	312	0	55	65	0.8461539
NODE_32864_length_543_cov_3.301802	247	312	2	10	65	0.1538462
NODE_32875_length_543_cov_2.635135	253	316	1	61	63	0.9682540
NODE_32875_length_543_cov_2.635135	253	316	2	2	63	0.0317460
NODE_32875_length_543_cov_2.635135	293	373	0	45	80	0.5625000
NODE_32875_length_543_cov_2.635135	293	373	1	35	80	0.4375000
NODE_33002_length_543_cov_0.682432	98	178	6	10	80	0.1250000
NODE_33002_length_543_cov_0.682432	98	178	7	70	80	0.8750000
NODE_33012_length_542_cov_57.370203	287	367	5	31	80	0.3875000
NODE_33012_length_542_cov_57.370203	287	367	7	49	80	0.6125000
NODE_33012_length_542_cov_57.370203	340	378	2	2	38	0.0526316
NODE_33012_length_542_cov_57.370203	340	378	3	1	38	0.0263158
NODE_33012_length_542_cov_57.370203	340	378	5	35	38	0.9210526
NODE_33014_length_542_cov_11.616253	277	357	2	28	80	0.3500000
NODE_33014_length_542_cov_11.616253	277	357	3	39	80	0.4875000
NODE_33014_length_542_cov_11.616253	277	357	4	13	80	0.1625000
NODE_33014_length_542_cov_11.616253	330	410	2	40	80	0.5000000
NODE_33014_length_542_cov_11.616253	330	410	3	40	80	0.5000000
NODE_33015_length_542_cov_9.988713	253	333	0	80	80	1.0000000
NODE_33015_length_542_cov_9.988713	306	386	0	80	80	1.0000000
NODE_33018_length_542_cov_7.934537	215	295	5	15	80	0.1875000
NODE_33018_length_542_cov_7.934537	215	295	6	38	80	0.4750000
NODE_33018_length_542_cov_7.934537	215	295	7	27	80	0.3375000
NODE_33018_length_542_cov_7.934537	268	348	4	34	80	0.4250000
NODE_33018_length_542_cov_7.934537	268	348	5	7	80	0.0875000
NODE_33018_length_542_cov_7.934537	268	348	6	39	80	0.4875000
NODE_33020_length_542_cov_7.266366	159	239	0	2	80	0.0250000
NODE_33020_length_542_cov_7.266366	159	239	1	12	80	0.1500000
NODE_33020_length_542_cov_7.266366	159	239	2	66	80	0.8250000
NODE_33021_length_542_cov_7.069977	230	304	0	27	74	0.3648649
NODE_33021_length_542_cov_7.069977	230	304	1	47	74	0.6351351
NODE_33021_length_542_cov_7.069977	284	362	1	78	78	1.0000000
NODE_33025_length_542_cov_4.783296	237	267	4	30	30	1.0000000
NODE_33035_length_542_cov_3.882619	275	303	2	28	28	1.0000000
NODE_33040_length_542_cov_3.600451	82	131	2	42	49	0.8571429
NODE_33040_length_542_cov_3.600451	82	131	4	1	49	0.0204082
NODE_33040_length_542_cov_3.600451	82	131	8	4	49	0.0816327
NODE_33040_length_542_cov_3.600451	82	131	10	2	49	0.0408163
NODE_33188_length_541_cov_22.463801	247	327	1	80	80	1.0000000
NODE_33188_length_541_cov_22.463801	300	380	1	44	80	0.5500000
NODE_33188_length_541_cov_22.463801	300	380	2	36	80	0.4500000
NODE_33190_length_541_cov_11.070136	60	140	0	80	80	1.0000000
NODE_33190_length_541_cov_11.070136	113	193	0	80	80	1.0000000
NODE_33204_length_541_cov_3.690045	179	250	0	27	71	0.3802817
NODE_33204_length_541_cov_3.690045	179	250	1	44	71	0.6197183
NODE_33300_length_541_cov_1.187783	352	400	0	48	48	1.0000000
NODE_33359_length_540_cov_78.353741	219	299	1	80	80	1.0000000
NODE_33359_length_540_cov_78.353741	272	352	0	16	80	0.2000000
NODE_33359_length_540_cov_78.353741	272	352	1	64	80	0.8000000
NODE_33360_length_540_cov_33.473923	59	139	2	15	80	0.1875000
NODE_33360_length_540_cov_33.473923	59	139	4	65	80	0.8125000
NODE_33360_length_540_cov_33.473923	112	192	2	31	80	0.3875000
NODE_33360_length_540_cov_33.473923	112	192	4	49	80	0.6125000
NODE_33361_length_540_cov_20.380952	97	177	4	80	80	1.0000000
NODE_33361_length_540_cov_20.380952	150	230	2	18	80	0.2250000
NODE_33361_length_540_cov_20.380952	150	230	3	14	80	0.1750000
NODE_33361_length_540_cov_20.380952	150	230	4	48	80	0.6000000
NODE_33362_length_540_cov_12.657596	248	328	0	80	80	1.0000000
NODE_33362_length_540_cov_12.657596	301	381	0	80	80	1.0000000
NODE_33363_length_540_cov_11.111111	180	260	0	80	80	1.0000000
NODE_33363_length_540_cov_11.111111	233	313	0	80	80	1.0000000
NODE_33365_length_540_cov_6.328798	260	340	0	40	80	0.5000000
NODE_33365_length_540_cov_6.328798	260	340	1	4	80	0.0500000
NODE_33365_length_540_cov_6.328798	260	340	2	36	80	0.4500000
NODE_33365_length_540_cov_6.328798	313	393	0	80	80	1.0000000
NODE_33382_length_540_cov_3.587302	351	411	2	41	60	0.6833333
NODE_33382_length_540_cov_3.587302	351	411	3	2	60	0.0333333
NODE_33382_length_540_cov_3.587302	351	411	4	17	60	0.2833333
NODE_33503_length_539_cov_1023.604545	264	344	790	1	80	0.0125000
NODE_33503_length_539_cov_1023.604545	264	344	791	1	80	0.0125000
NODE_33503_length_539_cov_1023.604545	264	344	792	1	80	0.0125000
NODE_33503_length_539_cov_1023.604545	264	344	794	1	80	0.0125000
NODE_33503_length_539_cov_1023.604545	264	344	800	2	80	0.0250000
NODE_33503_length_539_cov_1023.604545	264	344	802	2	80	0.0250000
NODE_33503_length_539_cov_1023.604545	264	344	805	1	80	0.0125000
NODE_33503_length_539_cov_1023.604545	264	344	806	1	80	0.0125000
NODE_33503_length_539_cov_1023.604545	264	344	808	2	80	0.0250000
NODE_33503_length_539_cov_1023.604545	264	344	809	1	80	0.0125000
NODE_33503_length_539_cov_1023.604545	264	344	810	1	80	0.0125000
NODE_33503_length_539_cov_1023.604545	264	344	815	1	80	0.0125000
NODE_33503_length_539_cov_1023.604545	264	344	817	1	80	0.0125000
NODE_33503_length_539_cov_1023.604545	264	344	819	1	80	0.0125000
NODE_33503_length_539_cov_1023.604545	264	344	820	1	80	0.0125000
NODE_33503_length_539_cov_1023.604545	264	344	821	1	80	0.0125000
NODE_33503_length_539_cov_1023.604545	264	344	822	3	80	0.0375000
NODE_33503_length_539_cov_1023.604545	264	344	824	2	80	0.0250000
NODE_33503_length_539_cov_1023.604545	264	344	825	1	80	0.0125000
NODE_33503_length_539_cov_1023.604545	264	344	826	5	80	0.0625000
NODE_33503_length_539_cov_1023.604545	264	344	827	2	80	0.0250000
NODE_33503_length_539_cov_1023.604545	264	344	828	2	80	0.0250000
NODE_33503_length_539_cov_1023.604545	264	344	829	2	80	0.0250000
NODE_33503_length_539_cov_1023.604545	264	344	830	4	80	0.0500000
NODE_33503_length_539_cov_1023.604545	264	344	831	4	80	0.0500000
NODE_33503_length_539_cov_1023.604545	264	344	832	5	80	0.0625000
NODE_33503_length_539_cov_1023.604545	264	344	833	2	80	0.0250000
NODE_33503_length_539_cov_1023.604545	264	344	834	4	80	0.0500000
NODE_33503_length_539_cov_1023.604545	264	344	835	3	80	0.0375000
NODE_33503_length_539_cov_1023.604545	264	344	836	2	80	0.0250000
NODE_33503_length_539_cov_1023.604545	264	344	837	1	80	0.0125000
NODE_33503_length_539_cov_1023.604545	264	344	838	1	80	0.0125000
NODE_33503_length_539_cov_1023.604545	264	344	839	1	80	0.0125000
NODE_33503_length_539_cov_1023.604545	264	344	840	1	80	0.0125000
NODE_33503_length_539_cov_1023.604545	264	344	841	3	80	0.0375000
NODE_33503_length_539_cov_1023.604545	264	344	842	2	80	0.0250000
NODE_33503_length_539_cov_1023.604545	264	344	843	1	80	0.0125000
NODE_33503_length_539_cov_1023.604545	264	344	844	3	80	0.0375000
NODE_33503_length_539_cov_1023.604545	264	344	845	1	80	0.0125000
NODE_33503_length_539_cov_1023.604545	264	344	847	2	80	0.0250000
NODE_33503_length_539_cov_1023.604545	264	344	848	3	80	0.0375000
NODE_33503_length_539_cov_1023.604545	264	344	849	1	80	0.0125000
NODE_33503_length_539_cov_1023.604545	317	397	779	3	80	0.0375000
NODE_33503_length_539_cov_1023.604545	317	397	781	1	80	0.0125000
NODE_33503_length_539_cov_1023.604545	317	397	782	1	80	0.0125000
NODE_33503_length_539_cov_1023.604545	317	397	783	1	80	0.0125000
NODE_33503_length_539_cov_1023.604545	317	397	784	1	80	0.0125000
NODE_33503_length_539_cov_1023.604545	317	397	785	2	80	0.0250000
NODE_33503_length_539_cov_1023.604545	317	397	787	3	80	0.0375000
NODE_33503_length_539_cov_1023.604545	317	397	788	2	80	0.0250000
NODE_33503_length_539_cov_1023.604545	317	397	789	1	80	0.0125000
NODE_33503_length_539_cov_1023.604545	317	397	791	5	80	0.0625000
NODE_33503_length_539_cov_1023.604545	317	397	792	2	80	0.0250000
NODE_33503_length_539_cov_1023.604545	317	397	793	1	80	0.0125000
NODE_33503_length_539_cov_1023.604545	317	397	795	1	80	0.0125000
NODE_33503_length_539_cov_1023.604545	317	397	801	1	80	0.0125000
NODE_33503_length_539_cov_1023.604545	317	397	802	2	80	0.0250000
NODE_33503_length_539_cov_1023.604545	317	397	803	1	80	0.0125000
NODE_33503_length_539_cov_1023.604545	317	397	804	1	80	0.0125000
NODE_33503_length_539_cov_1023.604545	317	397	812	2	80	0.0250000
NODE_33503_length_539_cov_1023.604545	317	397	813	1	80	0.0125000
NODE_33503_length_539_cov_1023.604545	317	397	814	2	80	0.0250000
NODE_33503_length_539_cov_1023.604545	317	397	818	1	80	0.0125000
NODE_33503_length_539_cov_1023.604545	317	397	819	1	80	0.0125000
NODE_33503_length_539_cov_1023.604545	317	397	820	2	80	0.0250000
NODE_33503_length_539_cov_1023.604545	317	397	821	3	80	0.0375000
NODE_33503_length_539_cov_1023.604545	317	397	823	1	80	0.0125000
NODE_33503_length_539_cov_1023.604545	317	397	824	1	80	0.0125000
NODE_33503_length_539_cov_1023.604545	317	397	826	4	80	0.0500000
NODE_33503_length_539_cov_1023.604545	317	397	827	1	80	0.0125000
NODE_33503_length_539_cov_1023.604545	317	397	828	2	80	0.0250000
NODE_33503_length_539_cov_1023.604545	317	397	830	4	80	0.0500000
NODE_33503_length_539_cov_1023.604545	317	397	831	3	80	0.0375000
NODE_33503_length_539_cov_1023.604545	317	397	832	2	80	0.0250000
NODE_33503_length_539_cov_1023.604545	317	397	834	2	80	0.0250000
NODE_33503_length_539_cov_1023.604545	317	397	835	2	80	0.0250000
NODE_33503_length_539_cov_1023.604545	317	397	837	2	80	0.0250000
NODE_33503_length_539_cov_1023.604545	317	397	838	1	80	0.0125000
NODE_33503_length_539_cov_1023.604545	317	397	840	1	80	0.0125000
NODE_33503_length_539_cov_1023.604545	317	397	841	3	80	0.0375000
NODE_33503_length_539_cov_1023.604545	317	397	842	1	80	0.0125000
NODE_33503_length_539_cov_1023.604545	317	397	843	1	80	0.0125000
NODE_33503_length_539_cov_1023.604545	317	397	844	2	80	0.0250000
NODE_33503_length_539_cov_1023.604545	317	397	845	1	80	0.0125000
NODE_33503_length_539_cov_1023.604545	317	397	847	2	80	0.0250000
NODE_33503_length_539_cov_1023.604545	317	397	848	2	80	0.0250000
NODE_33503_length_539_cov_1023.604545	317	397	849	1	80	0.0125000
NODE_33504_length_539_cov_99.579545	478	539	16	1	61	0.0163934
NODE_33504_length_539_cov_99.579545	478	539	17	1	61	0.0163934
NODE_33504_length_539_cov_99.579545	478	539	21	4	61	0.0655738
NODE_33504_length_539_cov_99.579545	478	539	22	3	61	0.0491803
NODE_33504_length_539_cov_99.579545	478	539	23	3	61	0.0491803
NODE_33504_length_539_cov_99.579545	478	539	25	2	61	0.0327869
NODE_33504_length_539_cov_99.579545	478	539	27	2	61	0.0327869
NODE_33504_length_539_cov_99.579545	478	539	29	2	61	0.0327869
NODE_33504_length_539_cov_99.579545	478	539	33	2	61	0.0327869
NODE_33504_length_539_cov_99.579545	478	539	34	1	61	0.0163934
NODE_33504_length_539_cov_99.579545	478	539	36	2	61	0.0327869
NODE_33504_length_539_cov_99.579545	478	539	38	2	61	0.0327869
NODE_33504_length_539_cov_99.579545	478	539	40	2	61	0.0327869
NODE_33504_length_539_cov_99.579545	478	539	43	4	61	0.0655738
NODE_33504_length_539_cov_99.579545	478	539	44	1	61	0.0163934
NODE_33504_length_539_cov_99.579545	478	539	45	2	61	0.0327869
NODE_33504_length_539_cov_99.579545	478	539	46	2	61	0.0327869
NODE_33504_length_539_cov_99.579545	478	539	47	2	61	0.0327869
NODE_33504_length_539_cov_99.579545	478	539	49	5	61	0.0819672
NODE_33504_length_539_cov_99.579545	478	539	50	8	61	0.1311475
NODE_33504_length_539_cov_99.579545	478	539	51	2	61	0.0327869
NODE_33504_length_539_cov_99.579545	478	539	52	4	61	0.0655738
NODE_33504_length_539_cov_99.579545	478	539	54	3	61	0.0491803
NODE_33504_length_539_cov_99.579545	478	539	58	1	61	0.0163934
NODE_33505_length_539_cov_15.247727	217	297	0	80	80	1.0000000
NODE_33505_length_539_cov_15.247727	270	350	0	80	80	1.0000000
NODE_33506_length_539_cov_14.172727	278	350	0	14	72	0.1944444
NODE_33506_length_539_cov_14.172727	278	350	1	58	72	0.8055556
NODE_33507_length_539_cov_13.154545	118	198	1	80	80	1.0000000
NODE_33507_length_539_cov_13.154545	171	251	0	29	80	0.3625000
NODE_33507_length_539_cov_13.154545	171	251	1	51	80	0.6375000
NODE_33508_length_539_cov_10.811364	48	128	0	80	80	1.0000000
NODE_33508_length_539_cov_10.811364	101	181	0	80	80	1.0000000
NODE_33509_length_539_cov_9.563636	201	277	8	19	76	0.2500000
NODE_33509_length_539_cov_9.563636	201	277	9	14	76	0.1842105
NODE_33509_length_539_cov_9.563636	201	277	10	2	76	0.0263158
NODE_33509_length_539_cov_9.563636	201	277	11	41	76	0.5394737
NODE_33510_length_539_cov_7.934091	311	369	1	2	58	0.0344828
NODE_33510_length_539_cov_7.934091	311	369	2	48	58	0.8275862
NODE_33510_length_539_cov_7.934091	311	369	3	8	58	0.1379310
NODE_33510_length_539_cov_7.934091	342	422	2	19	80	0.2375000
NODE_33510_length_539_cov_7.934091	342	422	3	25	80	0.3125000
NODE_33510_length_539_cov_7.934091	342	422	4	36	80	0.4500000
NODE_33517_length_539_cov_5.740909	251	319	0	26	68	0.3823529
NODE_33517_length_539_cov_5.740909	251	319	2	42	68	0.6176471
NODE_33517_length_539_cov_5.740909	301	372	2	71	71	1.0000000
NODE_33533_length_539_cov_3.627273	80	157	0	77	77	1.0000000
NODE_33533_length_539_cov_3.627273	130	175	0	45	45	1.0000000
NODE_33569_length_539_cov_2.143182	325	371	2	46	46	1.0000000
NODE_33595_length_539_cov_1.618182	408	456	2	48	48	1.0000000
NODE_33623_length_539_cov_1.129545	97	134	0	37	37	1.0000000
NODE_33669_length_538_cov_23.193622	171	256	0	85	85	1.0000000
NODE_33669_length_538_cov_23.193622	225	305	0	80	80	1.0000000
NODE_33672_length_538_cov_7.378132	145	225	1	12	80	0.1500000
NODE_33672_length_538_cov_7.378132	145	225	3	68	80	0.8500000
NODE_33672_length_538_cov_7.378132	198	278	0	9	80	0.1125000
NODE_33672_length_538_cov_7.378132	198	278	1	56	80	0.7000000
NODE_33672_length_538_cov_7.378132	198	278	3	15	80	0.1875000
NODE_33683_length_538_cov_4.496583	277	357	1	34	80	0.4250000
NODE_33683_length_538_cov_4.496583	277	357	2	31	80	0.3875000
NODE_33683_length_538_cov_4.496583	277	357	3	15	80	0.1875000
NODE_33683_length_538_cov_4.496583	330	410	0	46	80	0.5750000
NODE_33683_length_538_cov_4.496583	330	410	1	34	80	0.4250000
NODE_33687_length_538_cov_3.753986	251	309	0	5	58	0.0862069
NODE_33687_length_538_cov_3.753986	251	309	1	6	58	0.1034483
NODE_33687_length_538_cov_3.753986	251	309	2	47	58	0.8103448
NODE_33713_length_538_cov_2.239180	256	338	1	62	82	0.7560976
NODE_33713_length_538_cov_2.239180	256	338	2	20	82	0.2439024
NODE_33814_length_538_cov_0.822323	397	477	0	80	80	1.0000000
NODE_33852_length_537_cov_13.031963	258	309	0	51	51	1.0000000
NODE_33854_length_537_cov_9.552511	198	278	0	80	80	1.0000000
NODE_33854_length_537_cov_9.552511	251	332	0	81	81	1.0000000
NODE_33960_length_537_cov_1.244292	107	187	4	3	80	0.0375000
NODE_33960_length_537_cov_1.244292	107	187	7	3	80	0.0375000
NODE_33960_length_537_cov_1.244292	107	187	9	1	80	0.0125000
NODE_33960_length_537_cov_1.244292	107	187	10	5	80	0.0625000
NODE_33960_length_537_cov_1.244292	107	187	11	4	80	0.0500000
NODE_33960_length_537_cov_1.244292	107	187	12	2	80	0.0250000
NODE_33960_length_537_cov_1.244292	107	187	14	12	80	0.1500000
NODE_33960_length_537_cov_1.244292	107	187	18	2	80	0.0250000
NODE_33960_length_537_cov_1.244292	107	187	19	5	80	0.0625000
NODE_33960_length_537_cov_1.244292	107	187	21	3	80	0.0375000
NODE_33960_length_537_cov_1.244292	107	187	22	17	80	0.2125000
NODE_33960_length_537_cov_1.244292	107	187	24	10	80	0.1250000
NODE_33960_length_537_cov_1.244292	107	187	26	13	80	0.1625000
NODE_34029_length_536_cov_87.622426	430	462	205	1	32	0.0312500
NODE_34029_length_536_cov_87.622426	430	462	206	1	32	0.0312500
NODE_34029_length_536_cov_87.622426	430	462	207	1	32	0.0312500
NODE_34029_length_536_cov_87.622426	430	462	208	1	32	0.0312500
NODE_34029_length_536_cov_87.622426	430	462	210	1	32	0.0312500
NODE_34029_length_536_cov_87.622426	430	462	211	1	32	0.0312500
NODE_34029_length_536_cov_87.622426	430	462	213	1	32	0.0312500
NODE_34029_length_536_cov_87.622426	430	462	219	1	32	0.0312500
NODE_34029_length_536_cov_87.622426	430	462	224	1	32	0.0312500
NODE_34029_length_536_cov_87.622426	430	462	226	1	32	0.0312500
NODE_34029_length_536_cov_87.622426	430	462	228	1	32	0.0312500
NODE_34029_length_536_cov_87.622426	430	462	229	1	32	0.0312500
NODE_34029_length_536_cov_87.622426	430	462	231	1	32	0.0312500
NODE_34029_length_536_cov_87.622426	430	462	232	1	32	0.0312500
NODE_34029_length_536_cov_87.622426	430	462	240	1	32	0.0312500
NODE_34029_length_536_cov_87.622426	430	462	241	1	32	0.0312500
NODE_34029_length_536_cov_87.622426	430	462	252	1	32	0.0312500
NODE_34029_length_536_cov_87.622426	430	462	255	1	32	0.0312500
NODE_34029_length_536_cov_87.622426	430	462	258	1	32	0.0312500
NODE_34029_length_536_cov_87.622426	430	462	261	1	32	0.0312500
NODE_34029_length_536_cov_87.622426	430	462	262	2	32	0.0625000
NODE_34029_length_536_cov_87.622426	430	462	263	2	32	0.0625000
NODE_34029_length_536_cov_87.622426	430	462	266	1	32	0.0312500
NODE_34029_length_536_cov_87.622426	430	462	273	1	32	0.0312500
NODE_34029_length_536_cov_87.622426	430	462	275	1	32	0.0312500
NODE_34029_length_536_cov_87.622426	430	462	277	2	32	0.0625000
NODE_34029_length_536_cov_87.622426	430	462	288	1	32	0.0312500
NODE_34029_length_536_cov_87.622426	430	462	289	2	32	0.0625000
NODE_34030_length_536_cov_11.629291	119	199	0	38	80	0.4750000
NODE_34030_length_536_cov_11.629291	119	199	1	42	80	0.5250000
NODE_34030_length_536_cov_11.629291	172	252	1	45	80	0.5625000
NODE_34030_length_536_cov_11.629291	172	252	2	35	80	0.4375000
NODE_34032_length_536_cov_6.613272	286	372	0	41	86	0.4767442
NODE_34032_length_536_cov_6.613272	286	372	2	45	86	0.5232558
NODE_34035_length_536_cov_5.810069	191	271	0	13	80	0.1625000
NODE_34035_length_536_cov_5.810069	191	271	1	10	80	0.1250000
NODE_34035_length_536_cov_5.810069	191	271	2	3	80	0.0375000
NODE_34035_length_536_cov_5.810069	191	271	3	54	80	0.6750000
NODE_34035_length_536_cov_5.810069	244	324	3	49	80	0.6125000
NODE_34035_length_536_cov_5.810069	244	324	4	31	80	0.3875000
NODE_34035_length_536_cov_5.810069	374	404	1	30	30	1.0000000
NODE_34039_length_536_cov_4.729977	202	245	0	24	43	0.5581396
NODE_34039_length_536_cov_4.729977	202	245	1	19	43	0.4418605
NODE_34057_length_536_cov_3.297483	86	126	0	40	40	1.0000000
NODE_34068_length_536_cov_2.796339	223	280	0	57	57	1.0000000
NODE_34094_length_536_cov_1.956522	181	230	28	3	49	0.0612245
NODE_34094_length_536_cov_1.956522	181	230	29	6	49	0.1224490
NODE_34094_length_536_cov_1.956522	181	230	30	20	49	0.4081633
NODE_34094_length_536_cov_1.956522	181	230	31	9	49	0.1836735
NODE_34094_length_536_cov_1.956522	181	230	32	4	49	0.0816327
NODE_34094_length_536_cov_1.956522	181	230	33	5	49	0.1020408
NODE_34094_length_536_cov_1.956522	181	230	34	2	49	0.0408163
NODE_34095_length_536_cov_1.951945	203	284	4	63	81	0.7777778
NODE_34095_length_536_cov_1.951945	203	284	5	18	81	0.2222222
NODE_34095_length_536_cov_1.951945	306	368	1	17	62	0.2741936
NODE_34095_length_536_cov_1.951945	306	368	3	10	62	0.1612903
NODE_34095_length_536_cov_1.951945	306	368	4	35	62	0.5645161
NODE_34209_length_535_cov_32.277523	158	238	5	10	80	0.1250000
NODE_34209_length_535_cov_32.277523	158	238	6	4	80	0.0500000
NODE_34209_length_535_cov_32.277523	158	238	7	53	80	0.6625000
NODE_34209_length_535_cov_32.277523	158	238	8	13	80	0.1625000
NODE_34209_length_535_cov_32.277523	211	291	5	29	80	0.3625000
NODE_34209_length_535_cov_32.277523	211	291	6	10	80	0.1250000
NODE_34209_length_535_cov_32.277523	211	291	7	41	80	0.5125000
NODE_34215_length_535_cov_5.910550	110	162	0	52	52	1.0000000
NODE_34229_length_535_cov_3.795872	217	297	2	11	80	0.1375000
NODE_34229_length_535_cov_3.795872	217	297	3	1	80	0.0125000
NODE_34229_length_535_cov_3.795872	217	297	5	12	80	0.1500000
NODE_34229_length_535_cov_3.795872	217	297	6	9	80	0.1125000
NODE_34229_length_535_cov_3.795872	217	297	8	47	80	0.5875000
NODE_34375_length_534_cov_54.331034	435	498	0	53	63	0.8412699
NODE_34375_length_534_cov_54.331034	435	498	2	4	63	0.0634921
NODE_34375_length_534_cov_54.331034	435	498	3	1	63	0.0158730
NODE_34375_length_534_cov_54.331034	435	498	7	1	63	0.0158730
NODE_34375_length_534_cov_54.331034	435	498	25	1	63	0.0158730
NODE_34375_length_534_cov_54.331034	435	498	27	3	63	0.0476190
NODE_34375_length_534_cov_54.331034	471	534	0	63	63	1.0000000
NODE_34377_length_534_cov_15.462069	460	534	2	58	74	0.7837838
NODE_34377_length_534_cov_15.462069	460	534	3	16	74	0.2162162
NODE_34377_length_534_cov_15.462069	512	534	2	22	22	1.0000000
NODE_34378_length_534_cov_10.308046	268	348	2	80	80	1.0000000
NODE_34378_length_534_cov_10.308046	321	401	1	1	80	0.0125000
NODE_34378_length_534_cov_10.308046	321	401	2	79	80	0.9875000
NODE_34380_length_534_cov_9.041379	204	284	1	4	80	0.0500000
NODE_34380_length_534_cov_9.041379	204	284	2	76	80	0.9500000
NODE_34380_length_534_cov_9.041379	257	332	1	32	75	0.4266667
NODE_34380_length_534_cov_9.041379	257	332	2	43	75	0.5733333
NODE_34383_length_534_cov_6.958621	273	303	0	30	30	1.0000000
NODE_34392_length_534_cov_5.022989	291	371	5	4	80	0.0500000
NODE_34392_length_534_cov_5.022989	291	371	6	32	80	0.4000000
NODE_34392_length_534_cov_5.022989	291	371	7	1	80	0.0125000
NODE_34392_length_534_cov_5.022989	291	371	8	27	80	0.3375000
NODE_34392_length_534_cov_5.022989	291	371	9	5	80	0.0625000
NODE_34392_length_534_cov_5.022989	291	371	10	9	80	0.1125000
NODE_34392_length_534_cov_5.022989	291	371	11	2	80	0.0250000
NODE_34402_length_534_cov_3.873563	110	190	0	80	80	1.0000000
NODE_34409_length_534_cov_3.202299	221	301	0	80	80	1.0000000
NODE_34411_length_534_cov_3.158621	171	200	0	29	29	1.0000000
NODE_34418_length_534_cov_3.002299	175	219	0	44	44	1.0000000
NODE_34489_length_534_cov_1.344828	475	518	1	43	43	1.0000000
NODE_34494_length_534_cov_1.291954	273	336	1	63	63	1.0000000
NODE_34511_length_534_cov_1.160920	227	264	1	22	37	0.5945946
NODE_34511_length_534_cov_1.160920	227	264	3	15	37	0.4054054
NODE_34570_length_533_cov_13.956221	216	296	0	16	80	0.2000000
NODE_34570_length_533_cov_13.956221	216	296	1	64	80	0.8000000
NODE_34570_length_533_cov_13.956221	269	349	1	80	80	1.0000000
NODE_34575_length_533_cov_8.207373	244	322	0	78	78	1.0000000
NODE_34576_length_533_cov_8.023041	230	310	0	80	80	1.0000000
NODE_34576_length_533_cov_8.023041	283	364	0	81	81	1.0000000
NODE_34585_length_533_cov_5.170507	308	369	0	61	61	1.0000000
NODE_34588_length_533_cov_4.988479	229	309	3	53	80	0.6625000
NODE_34588_length_533_cov_4.988479	229	309	4	27	80	0.3375000
NODE_34588_length_533_cov_4.988479	282	362	0	8	80	0.1000000
NODE_34588_length_533_cov_4.988479	282	362	1	8	80	0.1000000
NODE_34588_length_533_cov_4.988479	282	362	2	5	80	0.0625000
NODE_34588_length_533_cov_4.988479	282	362	3	59	80	0.7375000
NODE_34600_length_533_cov_3.638249	201	265	0	30	64	0.4687500
NODE_34600_length_533_cov_3.638249	201	265	2	34	64	0.5312500
NODE_34603_length_533_cov_3.511521	138	218	1	4	80	0.0500000
NODE_34603_length_533_cov_3.511521	138	218	2	46	80	0.5750000
NODE_34603_length_533_cov_3.511521	138	218	3	30	80	0.3750000
NODE_34615_length_533_cov_3.073733	294	340	0	46	46	1.0000000
NODE_34617_length_533_cov_3.052995	256	304	1	3	48	0.0625000
NODE_34617_length_533_cov_3.052995	256	304	2	45	48	0.9375000
NODE_34631_length_533_cov_2.366359	229	311	0	82	82	1.0000000
NODE_34635_length_533_cov_2.288018	468	490	0	22	22	1.0000000
NODE_34767_length_532_cov_73.279446	0	64	1	9	64	0.1406250
NODE_34767_length_532_cov_73.279446	0	64	2	7	64	0.1093750
NODE_34767_length_532_cov_73.279446	0	64	4	7	64	0.1093750
NODE_34767_length_532_cov_73.279446	0	64	8	13	64	0.2031250
NODE_34767_length_532_cov_73.279446	0	64	10	5	64	0.0781250
NODE_34767_length_532_cov_73.279446	0	64	11	12	64	0.1875000
NODE_34767_length_532_cov_73.279446	0	64	12	11	64	0.1718750
NODE_34768_length_532_cov_23.055427	168	248	3	30	80	0.3750000
NODE_34768_length_532_cov_23.055427	168	248	4	50	80	0.6250000
NODE_34768_length_532_cov_23.055427	221	301	0	7	80	0.0875000
NODE_34768_length_532_cov_23.055427	221	301	1	26	80	0.3250000
NODE_34768_length_532_cov_23.055427	221	301	2	16	80	0.2000000
NODE_34768_length_532_cov_23.055427	221	301	3	31	80	0.3875000
NODE_34769_length_532_cov_22.778291	256	336	2	1	80	0.0125000
NODE_34769_length_532_cov_22.778291	256	336	3	45	80	0.5625000
NODE_34769_length_532_cov_22.778291	256	336	4	34	80	0.4250000
NODE_34769_length_532_cov_22.778291	309	389	3	54	80	0.6750000
NODE_34769_length_532_cov_22.778291	309	389	4	26	80	0.3250000
NODE_34770_length_532_cov_13.279446	85	165	2	8	80	0.1000000
NODE_34770_length_532_cov_13.279446	85	165	3	72	80	0.9000000
NODE_34770_length_532_cov_13.279446	138	218	1	2	80	0.0250000
NODE_34770_length_532_cov_13.279446	138	218	2	49	80	0.6125000
NODE_34770_length_532_cov_13.279446	138	218	3	29	80	0.3625000
NODE_34774_length_532_cov_7.591224	171	235	0	60	64	0.9375000
NODE_34774_length_532_cov_7.591224	171	235	1	4	64	0.0625000
NODE_34774_length_532_cov_7.591224	172	235	0	59	63	0.9365079
NODE_34774_length_532_cov_7.591224	172	235	1	4	63	0.0634921
NODE_34774_length_532_cov_7.591224	173	226	0	53	53	1.0000000
NODE_34774_length_532_cov_7.591224	173	228	0	55	55	1.0000000
NODE_34774_length_532_cov_7.591224	208	282	0	23	74	0.3108108
NODE_34774_length_532_cov_7.591224	208	282	1	51	74	0.6891892
NODE_34774_length_532_cov_7.591224	208	282	0	23	74	0.3108108
NODE_34774_length_532_cov_7.591224	208	282	1	51	74	0.6891892
NODE_34774_length_532_cov_7.591224	208	282	0	23	74	0.3108108
NODE_34774_length_532_cov_7.591224	208	282	1	51	74	0.6891892
NODE_34774_length_532_cov_7.591224	208	282	0	23	74	0.3108108
NODE_34774_length_532_cov_7.591224	208	282	1	51	74	0.6891892
NODE_34788_length_532_cov_4.524249	84	151	0	67	67	1.0000000
NODE_34788_length_532_cov_4.524249	137	218	0	81	81	1.0000000
NODE_34838_length_532_cov_1.866051	263	309	0	46	46	1.0000000
NODE_34845_length_532_cov_1.757506	126	146	0	20	20	1.0000000
NODE_34948_length_531_cov_35.539352	7	45	0	31	38	0.8157895
NODE_34948_length_531_cov_35.539352	7	45	2	7	38	0.1842105
NODE_34948_length_531_cov_35.539352	18	98	0	20	80	0.2500000
NODE_34948_length_531_cov_35.539352	18	98	2	60	80	0.7500000
NODE_34949_length_531_cov_13.162037	129	209	1	17	80	0.2125000
NODE_34949_length_531_cov_13.162037	129	209	2	6	80	0.0750000
NODE_34949_length_531_cov_13.162037	129	209	3	11	80	0.1375000
NODE_34949_length_531_cov_13.162037	129	209	4	46	80	0.5750000
NODE_34949_length_531_cov_13.162037	182	251	4	69	69	1.0000000
NODE_34953_length_531_cov_6.821759	242	322	0	80	80	1.0000000
NODE_34953_length_531_cov_6.821759	295	375	0	80	80	1.0000000
NODE_34958_length_531_cov_5.261574	261	336	2	29	75	0.3866667
NODE_34958_length_531_cov_5.261574	261	336	4	46	75	0.6133333
NODE_34958_length_531_cov_5.261574	309	362	4	53	53	1.0000000
NODE_34963_length_531_cov_4.527778	177	255	0	78	78	1.0000000
NODE_34965_length_531_cov_4.319444	283	363	0	80	80	1.0000000
NODE_34965_length_531_cov_4.319444	336	416	0	80	80	1.0000000
NODE_34979_length_531_cov_3.488426	238	318	0	80	80	1.0000000
NODE_34979_length_531_cov_3.488426	291	371	0	80	80	1.0000000
NODE_34980_length_531_cov_3.375000	153	207	2	6	54	0.1111111
NODE_34980_length_531_cov_3.375000	153	207	3	40	54	0.7407407
NODE_34980_length_531_cov_3.375000	153	207	5	8	54	0.1481481
NODE_34980_length_531_cov_3.375000	180	260	3	19	80	0.2375000
NODE_34980_length_531_cov_3.375000	180	260	5	45	80	0.5625000
NODE_34980_length_531_cov_3.375000	180	260	6	13	80	0.1625000
NODE_34980_length_531_cov_3.375000	180	260	7	3	80	0.0375000
NODE_34986_length_531_cov_3.111111	243	323	1	80	80	1.0000000
NODE_34986_length_531_cov_3.111111	296	376	0	35	80	0.4375000
NODE_34986_length_531_cov_3.111111	296	376	1	45	80	0.5625000
NODE_35008_length_531_cov_2.201389	302	373	0	3	71	0.0422535
NODE_35008_length_531_cov_2.201389	302	373	1	68	71	0.9577465
NODE_35008_length_531_cov_2.201389	350	426	1	76	76	1.0000000
NODE_35141_length_530_cov_30.605568	250	330	0	39	80	0.4875000
NODE_35141_length_530_cov_30.605568	250	330	1	41	80	0.5125000
NODE_35141_length_530_cov_30.605568	303	383	1	29	80	0.3625000
NODE_35141_length_530_cov_30.605568	303	383	2	51	80	0.6375000
NODE_35142_length_530_cov_16.937355	404	484	6	73	80	0.9125000
NODE_35142_length_530_cov_16.937355	404	484	7	3	80	0.0375000
NODE_35142_length_530_cov_16.937355	404	484	8	1	80	0.0125000
NODE_35142_length_530_cov_16.937355	404	484	9	2	80	0.0250000
NODE_35142_length_530_cov_16.937355	404	484	10	1	80	0.0125000
NODE_35142_length_530_cov_16.937355	457	530	0	1	73	0.0136986
NODE_35142_length_530_cov_16.937355	457	530	2	2	73	0.0273973
NODE_35142_length_530_cov_16.937355	457	530	4	32	73	0.4383562
NODE_35142_length_530_cov_16.937355	457	530	6	38	73	0.5205479
NODE_35143_length_530_cov_9.902552	273	353	0	43	80	0.5375000
NODE_35143_length_530_cov_9.902552	273	353	2	36	80	0.4500000
NODE_35143_length_530_cov_9.902552	273	353	3	1	80	0.0125000
NODE_35143_length_530_cov_9.902552	326	406	2	26	80	0.3250000
NODE_35143_length_530_cov_9.902552	326	406	3	54	80	0.6750000
NODE_35144_length_530_cov_7.928074	46	126	0	80	80	1.0000000
NODE_35144_length_530_cov_7.928074	99	179	0	80	80	1.0000000
NODE_35150_length_530_cov_4.647332	188	268	0	80	80	1.0000000
NODE_35150_length_530_cov_4.647332	241	321	0	80	80	1.0000000
NODE_35154_length_530_cov_4.389791	162	242	0	80	80	1.0000000
NODE_35159_length_530_cov_4.046404	76	111	2	35	35	1.0000000
NODE_35319_length_529_cov_38.983721	140	220	7	26	80	0.3250000
NODE_35319_length_529_cov_38.983721	140	220	8	5	80	0.0625000
NODE_35319_length_529_cov_38.983721	140	220	9	9	80	0.1125000
NODE_35319_length_529_cov_38.983721	140	220	10	5	80	0.0625000
NODE_35319_length_529_cov_38.983721	140	220	11	6	80	0.0750000
NODE_35319_length_529_cov_38.983721	140	220	12	15	80	0.1875000
NODE_35319_length_529_cov_38.983721	140	220	13	14	80	0.1750000
NODE_35320_length_529_cov_18.223256	189	269	2	66	80	0.8250000
NODE_35320_length_529_cov_18.223256	189	269	3	14	80	0.1750000
NODE_35320_length_529_cov_18.223256	242	322	1	33	80	0.4125000
NODE_35320_length_529_cov_18.223256	242	322	2	13	80	0.1625000
NODE_35320_length_529_cov_18.223256	242	322	3	34	80	0.4250000
NODE_35321_length_529_cov_17.009302	358	438	0	80	80	1.0000000
NODE_35321_length_529_cov_17.009302	411	491	0	80	80	1.0000000
NODE_35331_length_529_cov_6.195349	211	291	1	56	80	0.7000000
NODE_35331_length_529_cov_6.195349	211	291	2	24	80	0.3000000
NODE_35331_length_529_cov_6.195349	264	322	1	3	58	0.0517241
NODE_35331_length_529_cov_6.195349	264	322	2	55	58	0.9482759
NODE_35336_length_529_cov_5.176744	139	207	0	5	68	0.0735294
NODE_35336_length_529_cov_5.176744	139	207	1	31	68	0.4558823
NODE_35336_length_529_cov_5.176744	139	207	4	11	68	0.1617647
NODE_35336_length_529_cov_5.176744	139	207	5	21	68	0.3088235
NODE_35336_length_529_cov_5.176744	185	260	4	1	75	0.0133333
NODE_35336_length_529_cov_5.176744	185	260	5	31	75	0.4133333
NODE_35336_length_529_cov_5.176744	185	260	6	8	75	0.1066667
NODE_35336_length_529_cov_5.176744	185	260	7	35	75	0.4666667
NODE_35364_length_529_cov_2.883721	223	281	0	58	58	1.0000000
NODE_35374_length_529_cov_2.660465	89	168	0	12	79	0.1518987
NODE_35374_length_529_cov_2.660465	89	168	1	67	79	0.8481013
NODE_35375_length_529_cov_2.595349	278	321	1	43	43	1.0000000
NODE_35384_length_529_cov_2.272093	247	313	0	54	66	0.8181818
NODE_35384_length_529_cov_2.272093	247	313	2	12	66	0.1818182
NODE_35427_length_529_cov_1.597674	289	332	2	43	43	1.0000000
NODE_35521_length_528_cov_25.808858	233	313	0	6	80	0.0750000
NODE_35521_length_528_cov_25.808858	233	313	1	74	80	0.9250000
NODE_35521_length_528_cov_25.808858	286	366	0	59	80	0.7375000
NODE_35521_length_528_cov_25.808858	286	366	1	21	80	0.2625000
NODE_35522_length_528_cov_17.331002	219	299	3	80	80	1.0000000
NODE_35522_length_528_cov_17.331002	272	352	1	23	80	0.2875000
NODE_35522_length_528_cov_17.331002	272	352	3	49	80	0.6125000
NODE_35522_length_528_cov_17.331002	272	352	4	8	80	0.1000000
NODE_35523_length_528_cov_16.165501	262	342	0	28	80	0.3500000
NODE_35523_length_528_cov_16.165501	262	342	2	52	80	0.6500000
NODE_35523_length_528_cov_16.165501	315	395	2	80	80	1.0000000
NODE_35529_length_528_cov_5.776224	204	284	0	80	80	1.0000000
NODE_35529_length_528_cov_5.776224	257	337	0	80	80	1.0000000
NODE_35542_length_528_cov_4.016317	235	315	0	80	80	1.0000000
NODE_35542_length_528_cov_4.016317	288	368	0	80	80	1.0000000
NODE_35545_length_528_cov_3.799534	144	192	0	48	48	1.0000000
NODE_35561_length_528_cov_2.902098	252	305	1	6	53	0.1132075
NODE_35561_length_528_cov_2.902098	252	305	2	47	53	0.8867925
NODE_35575_length_528_cov_2.324009	137	188	0	51	51	1.0000000
NODE_35575_length_528_cov_2.324009	161	241	0	80	80	1.0000000
NODE_35597_length_528_cov_1.755245	268	348	0	57	80	0.7125000
NODE_35597_length_528_cov_1.755245	268	348	2	23	80	0.2875000
NODE_35597_length_528_cov_1.755245	321	401	0	4	80	0.0500000
NODE_35597_length_528_cov_1.755245	321	401	2	76	80	0.9500000
NODE_35687_length_527_cov_19.247664	306	386	0	80	80	1.0000000
NODE_35687_length_527_cov_19.247664	359	439	0	80	80	1.0000000
NODE_35688_length_527_cov_15.974299	250	349	0	99	99	1.0000000
NODE_35688_length_527_cov_15.974299	322	402	0	80	80	1.0000000
NODE_35691_length_527_cov_8.221963	235	315	0	21	80	0.2625000
NODE_35691_length_527_cov_8.221963	235	315	2	59	80	0.7375000
NODE_35691_length_527_cov_8.221963	288	368	0	14	80	0.1750000
NODE_35691_length_527_cov_8.221963	288	368	2	13	80	0.1625000
NODE_35691_length_527_cov_8.221963	288	368	4	22	80	0.2750000
NODE_35691_length_527_cov_8.221963	288	368	6	31	80	0.3875000
NODE_35693_length_527_cov_7.200935	190	270	1	7	80	0.0875000
NODE_35693_length_527_cov_7.200935	190	270	2	73	80	0.9125000
NODE_35693_length_527_cov_7.200935	243	346	1	59	103	0.5728155
NODE_35693_length_527_cov_7.200935	243	346	2	44	103	0.4271845
NODE_35693_length_527_cov_7.200935	342	422	0	65	80	0.8125000
NODE_35693_length_527_cov_7.200935	342	422	1	15	80	0.1875000
NODE_35693_length_527_cov_7.200935	395	475	0	80	80	1.0000000
NODE_35696_length_527_cov_6.862150	279	359	0	80	80	1.0000000
NODE_35697_length_527_cov_6.046729	155	235	1	80	80	1.0000000
NODE_35697_length_527_cov_6.046729	208	288	1	59	80	0.7375000
NODE_35697_length_527_cov_6.046729	208	288	2	21	80	0.2625000
NODE_35736_length_527_cov_2.238318	226	306	0	23	80	0.2875000
NODE_35736_length_527_cov_2.238318	226	306	2	57	80	0.7125000
NODE_35858_length_526_cov_50.866511	169	242	4	6	73	0.0821918
NODE_35858_length_526_cov_50.866511	169	242	6	67	73	0.9178082
NODE_35858_length_526_cov_50.866511	215	295	2	3	80	0.0375000
NODE_35858_length_526_cov_50.866511	215	295	3	27	80	0.3375000
NODE_35858_length_526_cov_50.866511	215	295	4	29	80	0.3625000
NODE_35858_length_526_cov_50.866511	215	295	6	21	80	0.2625000
NODE_35858_length_526_cov_50.866511	291	371	2	53	80	0.6625000
NODE_35858_length_526_cov_50.866511	291	371	3	27	80	0.3375000
NODE_35858_length_526_cov_50.866511	344	424	1	7	80	0.0875000
NODE_35858_length_526_cov_50.866511	344	424	2	73	80	0.9125000
NODE_35860_length_526_cov_26.395785	315	395	4	13	80	0.1625000
NODE_35860_length_526_cov_26.395785	315	395	5	67	80	0.8375000
NODE_35860_length_526_cov_26.395785	368	448	2	24	80	0.3000000
NODE_35860_length_526_cov_26.395785	368	448	4	20	80	0.2500000
NODE_35860_length_526_cov_26.395785	368	448	5	36	80	0.4500000
NODE_35861_length_526_cov_16.611241	305	385	0	80	80	1.0000000
NODE_35861_length_526_cov_16.611241	358	438	0	80	80	1.0000000
NODE_35866_length_526_cov_6.215457	303	351	0	48	48	1.0000000
NODE_35877_length_526_cov_3.936768	118	142	0	24	24	1.0000000
NODE_35877_length_526_cov_3.936768	118	163	0	45	45	1.0000000
NODE_35901_length_526_cov_2.466042	138	184	0	46	46	1.0000000
NODE_36055_length_525_cov_33.910798	98	178	0	21	80	0.2625000
NODE_36055_length_525_cov_33.910798	98	178	2	6	80	0.0750000
NODE_36055_length_525_cov_33.910798	98	178	6	21	80	0.2625000
NODE_36055_length_525_cov_33.910798	98	178	7	15	80	0.1875000
NODE_36055_length_525_cov_33.910798	98	178	9	3	80	0.0375000
NODE_36055_length_525_cov_33.910798	98	178	13	14	80	0.1750000
NODE_36055_length_525_cov_33.910798	151	231	0	21	80	0.2625000
NODE_36055_length_525_cov_33.910798	151	231	2	7	80	0.0875000
NODE_36055_length_525_cov_33.910798	151	231	4	52	80	0.6500000
NODE_36055_length_525_cov_33.910798	159	231	0	13	72	0.1805556
NODE_36055_length_525_cov_33.910798	159	231	2	7	72	0.0972222
NODE_36055_length_525_cov_33.910798	159	231	4	52	72	0.7222222
NODE_36058_length_525_cov_8.788732	175	255	0	80	80	1.0000000
NODE_36058_length_525_cov_8.788732	228	308	0	80	80	1.0000000
NODE_36059_length_525_cov_7.880282	242	285	0	43	43	1.0000000
NODE_36098_length_525_cov_2.417840	229	306	0	21	77	0.2727273
NODE_36098_length_525_cov_2.417840	229	306	2	56	77	0.7272727
NODE_36230_length_524_cov_21.649412	262	342	1	46	80	0.5750000
NODE_36230_length_524_cov_21.649412	262	342	3	12	80	0.1500000
NODE_36230_length_524_cov_21.649412	262	342	4	22	80	0.2750000
NODE_36230_length_524_cov_21.649412	315	395	3	5	80	0.0625000
NODE_36230_length_524_cov_21.649412	315	395	4	48	80	0.6000000
NODE_36230_length_524_cov_21.649412	315	395	5	7	80	0.0875000
NODE_36230_length_524_cov_21.649412	315	395	6	20	80	0.2500000
NODE_36231_length_524_cov_14.131765	136	201	0	65	65	1.0000000
NODE_36232_length_524_cov_10.392941	237	317	2	80	80	1.0000000
NODE_36232_length_524_cov_10.392941	290	370	0	2	80	0.0250000
NODE_36232_length_524_cov_10.392941	290	370	1	25	80	0.3125000
NODE_36232_length_524_cov_10.392941	290	370	2	53	80	0.6625000
NODE_36262_length_524_cov_3.221176	195	272	0	77	77	1.0000000
NODE_36262_length_524_cov_3.221176	253	324	0	71	71	1.0000000
NODE_36264_length_524_cov_3.148235	317	397	0	80	80	1.0000000
NODE_36410_length_523_cov_113.438679	0	48	2	3	48	0.0625000
NODE_36410_length_523_cov_113.438679	0	48	4	1	48	0.0208333
NODE_36410_length_523_cov_113.438679	0	48	5	10	48	0.2083333
NODE_36410_length_523_cov_113.438679	0	48	6	10	48	0.2083333
NODE_36410_length_523_cov_113.438679	0	48	7	12	48	0.2500000
NODE_36410_length_523_cov_113.438679	0	48	9	4	48	0.0833333
NODE_36410_length_523_cov_113.438679	0	48	10	8	48	0.1666667
NODE_36410_length_523_cov_113.438679	14	69	6	10	55	0.1818182
NODE_36410_length_523_cov_113.438679	14	69	7	12	55	0.2181818
NODE_36410_length_523_cov_113.438679	14	69	9	4	55	0.0727273
NODE_36410_length_523_cov_113.438679	14	69	10	8	55	0.1454545
NODE_36410_length_523_cov_113.438679	14	69	11	3	55	0.0545455
NODE_36410_length_523_cov_113.438679	14	69	12	2	55	0.0363636
NODE_36410_length_523_cov_113.438679	14	69	13	1	55	0.0181818
NODE_36410_length_523_cov_113.438679	14	69	14	2	55	0.0363636
NODE_36410_length_523_cov_113.438679	14	69	15	2	55	0.0363636
NODE_36410_length_523_cov_113.438679	14	69	16	3	55	0.0545455
NODE_36410_length_523_cov_113.438679	14	69	17	8	55	0.1454545
NODE_36410_length_523_cov_113.438679	25	101	7	11	76	0.1447368
NODE_36410_length_523_cov_113.438679	25	101	9	4	76	0.0526316
NODE_36410_length_523_cov_113.438679	25	101	10	8	76	0.1052632
NODE_36410_length_523_cov_113.438679	25	101	11	3	76	0.0394737
NODE_36410_length_523_cov_113.438679	25	101	12	2	76	0.0263158
NODE_36410_length_523_cov_113.438679	25	101	13	1	76	0.0131579
NODE_36410_length_523_cov_113.438679	25	101	14	2	76	0.0263158
NODE_36410_length_523_cov_113.438679	25	101	15	2	76	0.0263158
NODE_36410_length_523_cov_113.438679	25	101	16	3	76	0.0394737
NODE_36410_length_523_cov_113.438679	25	101	17	8	76	0.1052632
NODE_36410_length_523_cov_113.438679	25	101	18	1	76	0.0131579
NODE_36410_length_523_cov_113.438679	25	101	19	2	76	0.0263158
NODE_36410_length_523_cov_113.438679	25	101	23	8	76	0.1052632
NODE_36410_length_523_cov_113.438679	25	101	25	2	76	0.0263158
NODE_36410_length_523_cov_113.438679	25	101	28	1	76	0.0131579
NODE_36410_length_523_cov_113.438679	25	101	30	1	76	0.0131579
NODE_36410_length_523_cov_113.438679	25	101	31	2	76	0.0263158
NODE_36410_length_523_cov_113.438679	25	101	32	1	76	0.0131579
NODE_36410_length_523_cov_113.438679	25	101	35	1	76	0.0131579
NODE_36410_length_523_cov_113.438679	25	101	36	1	76	0.0131579
NODE_36410_length_523_cov_113.438679	25	101	38	2	76	0.0263158
NODE_36410_length_523_cov_113.438679	25	101	39	1	76	0.0131579
NODE_36410_length_523_cov_113.438679	25	101	40	1	76	0.0131579
NODE_36410_length_523_cov_113.438679	25	101	42	2	76	0.0263158
NODE_36410_length_523_cov_113.438679	25	101	44	1	76	0.0131579
NODE_36410_length_523_cov_113.438679	25	101	46	2	76	0.0263158
NODE_36410_length_523_cov_113.438679	25	101	48	3	76	0.0394737
NODE_36410_length_523_cov_113.438679	105	181	50	1	76	0.0131579
NODE_36410_length_523_cov_113.438679	105	181	51	2	76	0.0263158
NODE_36410_length_523_cov_113.438679	105	181	52	2	76	0.0263158
NODE_36410_length_523_cov_113.438679	105	181	54	4	76	0.0526316
NODE_36410_length_523_cov_113.438679	105	181	55	2	76	0.0263158
NODE_36410_length_523_cov_113.438679	105	181	56	3	76	0.0394737
NODE_36410_length_523_cov_113.438679	105	181	57	3	76	0.0394737
NODE_36410_length_523_cov_113.438679	105	181	59	3	76	0.0394737
NODE_36410_length_523_cov_113.438679	105	181	61	1	76	0.0131579
NODE_36410_length_523_cov_113.438679	105	181	62	2	76	0.0263158
NODE_36410_length_523_cov_113.438679	105	181	63	2	76	0.0263158
NODE_36410_length_523_cov_113.438679	105	181	65	1	76	0.0131579
NODE_36410_length_523_cov_113.438679	105	181	66	1	76	0.0131579
NODE_36410_length_523_cov_113.438679	105	181	68	1	76	0.0131579
NODE_36410_length_523_cov_113.438679	105	181	70	2	76	0.0263158
NODE_36410_length_523_cov_113.438679	105	181	72	2	76	0.0263158
NODE_36410_length_523_cov_113.438679	105	181	73	4	76	0.0526316
NODE_36410_length_523_cov_113.438679	105	181	74	1	76	0.0131579
NODE_36410_length_523_cov_113.438679	105	181	75	2	76	0.0263158
NODE_36410_length_523_cov_113.438679	105	181	79	2	76	0.0263158
NODE_36410_length_523_cov_113.438679	105	181	80	1	76	0.0131579
NODE_36410_length_523_cov_113.438679	105	181	81	4	76	0.0526316
NODE_36410_length_523_cov_113.438679	105	181	82	2	76	0.0263158
NODE_36410_length_523_cov_113.438679	105	181	83	1	76	0.0131579
NODE_36410_length_523_cov_113.438679	105	181	84	2	76	0.0263158
NODE_36410_length_523_cov_113.438679	105	181	85	1	76	0.0131579
NODE_36410_length_523_cov_113.438679	105	181	86	4	76	0.0526316
NODE_36410_length_523_cov_113.438679	105	181	87	3	76	0.0394737
NODE_36410_length_523_cov_113.438679	105	181	88	5	76	0.0657895
NODE_36410_length_523_cov_113.438679	105	181	89	3	76	0.0394737
NODE_36410_length_523_cov_113.438679	105	181	91	2	76	0.0263158
NODE_36410_length_523_cov_113.438679	105	181	92	2	76	0.0263158
NODE_36410_length_523_cov_113.438679	105	181	93	1	76	0.0131579
NODE_36410_length_523_cov_113.438679	105	181	95	1	76	0.0131579
NODE_36410_length_523_cov_113.438679	105	181	100	1	76	0.0131579
NODE_36410_length_523_cov_113.438679	105	181	103	1	76	0.0131579
NODE_36410_length_523_cov_113.438679	105	181	104	1	76	0.0131579
NODE_36410_length_523_cov_113.438679	154	234	84	2	80	0.0250000
NODE_36410_length_523_cov_113.438679	154	234	85	1	80	0.0125000
NODE_36410_length_523_cov_113.438679	154	234	86	4	80	0.0500000
NODE_36410_length_523_cov_113.438679	154	234	87	3	80	0.0375000
NODE_36410_length_523_cov_113.438679	154	234	88	5	80	0.0625000
NODE_36410_length_523_cov_113.438679	154	234	89	3	80	0.0375000
NODE_36410_length_523_cov_113.438679	154	234	91	2	80	0.0250000
NODE_36410_length_523_cov_113.438679	154	234	92	2	80	0.0250000
NODE_36410_length_523_cov_113.438679	154	234	93	1	80	0.0125000
NODE_36410_length_523_cov_113.438679	154	234	95	1	80	0.0125000
NODE_36410_length_523_cov_113.438679	154	234	100	1	80	0.0125000
NODE_36410_length_523_cov_113.438679	154	234	103	1	80	0.0125000
NODE_36410_length_523_cov_113.438679	154	234	104	2	80	0.0250000
NODE_36410_length_523_cov_113.438679	154	234	106	1	80	0.0125000
NODE_36410_length_523_cov_113.438679	154	234	107	7	80	0.0875000
NODE_36410_length_523_cov_113.438679	154	234	110	1	80	0.0125000
NODE_36410_length_523_cov_113.438679	154	234	111	3	80	0.0375000
NODE_36410_length_523_cov_113.438679	154	234	112	4	80	0.0500000
NODE_36410_length_523_cov_113.438679	154	234	113	1	80	0.0125000
NODE_36410_length_523_cov_113.438679	154	234	114	2	80	0.0250000
NODE_36410_length_523_cov_113.438679	154	234	115	1	80	0.0125000
NODE_36410_length_523_cov_113.438679	154	234	116	1	80	0.0125000
NODE_36410_length_523_cov_113.438679	154	234	117	3	80	0.0375000
NODE_36410_length_523_cov_113.438679	154	234	118	3	80	0.0375000
NODE_36410_length_523_cov_113.438679	154	234	119	2	80	0.0250000
NODE_36410_length_523_cov_113.438679	154	234	120	5	80	0.0625000
NODE_36410_length_523_cov_113.438679	154	234	121	2	80	0.0250000
NODE_36410_length_523_cov_113.438679	154	234	122	4	80	0.0500000
NODE_36410_length_523_cov_113.438679	154	234	123	3	80	0.0375000
NODE_36410_length_523_cov_113.438679	154	234	124	2	80	0.0250000
NODE_36410_length_523_cov_113.438679	154	234	125	3	80	0.0375000
NODE_36410_length_523_cov_113.438679	154	234	126	2	80	0.0250000
NODE_36410_length_523_cov_113.438679	154	234	127	2	80	0.0250000
NODE_36410_length_523_cov_113.438679	312	355	114	1	43	0.0232558
NODE_36410_length_523_cov_113.438679	312	355	115	2	43	0.0465116
NODE_36410_length_523_cov_113.438679	312	355	116	5	43	0.1162791
NODE_36410_length_523_cov_113.438679	312	355	117	7	43	0.1627907
NODE_36410_length_523_cov_113.438679	312	355	118	2	43	0.0465116
NODE_36410_length_523_cov_113.438679	312	355	119	6	43	0.1395349
NODE_36410_length_523_cov_113.438679	312	355	120	8	43	0.1860465
NODE_36410_length_523_cov_113.438679	312	355	121	1	43	0.0232558
NODE_36410_length_523_cov_113.438679	312	355	122	9	43	0.2093023
NODE_36410_length_523_cov_113.438679	312	355	123	1	43	0.0232558
NODE_36410_length_523_cov_113.438679	312	355	126	1	43	0.0232558
NODE_36412_length_523_cov_64.695755	35	115	2	55	80	0.6875000
NODE_36412_length_523_cov_64.695755	35	115	4	6	80	0.0750000
NODE_36412_length_523_cov_64.695755	35	115	5	19	80	0.2375000
NODE_36412_length_523_cov_64.695755	88	168	1	7	80	0.0875000
NODE_36412_length_523_cov_64.695755	88	168	2	2	80	0.0250000
NODE_36412_length_523_cov_64.695755	88	168	3	13	80	0.1625000
NODE_36412_length_523_cov_64.695755	88	168	4	6	80	0.0750000
NODE_36412_length_523_cov_64.695755	88	168	5	52	80	0.6500000
NODE_36414_length_523_cov_20.724057	235	315	0	80	80	1.0000000
NODE_36414_length_523_cov_20.724057	288	368	0	80	80	1.0000000
NODE_36415_length_523_cov_18.500000	164	244	4	19	80	0.2375000
NODE_36415_length_523_cov_18.500000	164	244	6	61	80	0.7625000
NODE_36415_length_523_cov_18.500000	217	297	3	5	80	0.0625000
NODE_36415_length_523_cov_18.500000	217	297	5	13	80	0.1625000
NODE_36415_length_523_cov_18.500000	217	297	6	62	80	0.7750000
NODE_36416_length_523_cov_15.216981	62	142	2	30	80	0.3750000
NODE_36416_length_523_cov_15.216981	62	142	3	50	80	0.6250000
NODE_36416_length_523_cov_15.216981	115	195	0	16	80	0.2000000
NODE_36416_length_523_cov_15.216981	115	195	2	62	80	0.7750000
NODE_36416_length_523_cov_15.216981	115	195	3	2	80	0.0250000
NODE_36417_length_523_cov_10.575472	157	183	10	13	26	0.5000000
NODE_36417_length_523_cov_10.575472	157	183	11	9	26	0.3461539
NODE_36417_length_523_cov_10.575472	157	183	12	4	26	0.1538462
NODE_36418_length_523_cov_9.962264	212	292	0	23	80	0.2875000
NODE_36418_length_523_cov_9.962264	212	292	2	57	80	0.7125000
NODE_36418_length_523_cov_9.962264	265	345	2	80	80	1.0000000
NODE_36427_length_523_cov_4.943396	108	188	21	19	80	0.2375000
NODE_36427_length_523_cov_4.943396	108	188	22	19	80	0.2375000
NODE_36427_length_523_cov_4.943396	108	188	23	10	80	0.1250000
NODE_36427_length_523_cov_4.943396	108	188	24	5	80	0.0625000
NODE_36427_length_523_cov_4.943396	108	188	25	4	80	0.0500000
NODE_36427_length_523_cov_4.943396	108	188	26	2	80	0.0250000
NODE_36427_length_523_cov_4.943396	108	188	27	1	80	0.0125000
NODE_36427_length_523_cov_4.943396	108	188	28	12	80	0.1500000
NODE_36427_length_523_cov_4.943396	108	188	30	1	80	0.0125000
NODE_36427_length_523_cov_4.943396	108	188	31	3	80	0.0375000
NODE_36427_length_523_cov_4.943396	108	188	33	4	80	0.0500000
NODE_36427_length_523_cov_4.943396	161	241	24	4	80	0.0500000
NODE_36427_length_523_cov_4.943396	161	241	26	5	80	0.0625000
NODE_36427_length_523_cov_4.943396	161	241	27	8	80	0.1000000
NODE_36427_length_523_cov_4.943396	161	241	28	14	80	0.1750000
NODE_36427_length_523_cov_4.943396	161	241	29	12	80	0.1500000
NODE_36427_length_523_cov_4.943396	161	241	30	15	80	0.1875000
NODE_36427_length_523_cov_4.943396	161	241	31	3	80	0.0375000
NODE_36427_length_523_cov_4.943396	161	241	32	9	80	0.1125000
NODE_36427_length_523_cov_4.943396	161	241	33	10	80	0.1250000
NODE_36429_length_523_cov_4.787736	110	141	2	11	31	0.3548387
NODE_36429_length_523_cov_4.787736	110	141	3	7	31	0.2258064
NODE_36429_length_523_cov_4.787736	110	141	4	13	31	0.4193548
NODE_36429_length_523_cov_4.787736	131	194	4	63	63	1.0000000
NODE_36439_length_523_cov_3.792453	139	219	2	80	80	1.0000000
NODE_36439_length_523_cov_3.792453	192	272	0	20	80	0.2500000
NODE_36439_length_523_cov_3.792453	192	272	1	8	80	0.1000000
NODE_36439_length_523_cov_3.792453	192	272	2	52	80	0.6500000
NODE_36481_length_523_cov_2.259434	337	372	0	35	35	1.0000000
NODE_36490_length_523_cov_2.096698	307	351	3	12	44	0.2727273
NODE_36490_length_523_cov_2.096698	307	351	4	3	44	0.0681818
NODE_36490_length_523_cov_2.096698	307	351	6	16	44	0.3636364
NODE_36490_length_523_cov_2.096698	307	351	7	13	44	0.2954545
NODE_36518_length_523_cov_1.700472	176	195	0	19	19	1.0000000
NODE_36632_length_522_cov_33.579196	55	135	4	2	80	0.0250000
NODE_36632_length_522_cov_33.579196	55	135	6	1	80	0.0125000
NODE_36632_length_522_cov_33.579196	55	135	7	54	80	0.6750000
NODE_36632_length_522_cov_33.579196	55	135	8	23	80	0.2875000
NODE_36632_length_522_cov_33.579196	108	188	5	15	80	0.1875000
NODE_36632_length_522_cov_33.579196	108	188	6	26	80	0.3250000
NODE_36632_length_522_cov_33.579196	108	188	7	9	80	0.1125000
NODE_36632_length_522_cov_33.579196	108	188	8	30	80	0.3750000
NODE_36634_length_522_cov_12.851064	266	342	0	76	76	1.0000000
NODE_36634_length_522_cov_12.851064	319	395	0	76	76	1.0000000
NODE_36637_length_522_cov_7.349882	212	283	0	71	71	1.0000000
NODE_36637_length_522_cov_7.349882	400	469	2	69	69	1.0000000
NODE_36670_length_522_cov_2.933806	178	258	1	42	80	0.5250000
NODE_36670_length_522_cov_2.933806	178	258	2	38	80	0.4750000
NODE_36670_length_522_cov_2.933806	231	311	0	18	80	0.2250000
NODE_36670_length_522_cov_2.933806	231	311	1	62	80	0.7750000
NODE_36676_length_522_cov_2.661939	187	241	0	54	54	1.0000000
NODE_36820_length_521_cov_9.303318	106	186	0	80	80	1.0000000
NODE_36820_length_521_cov_9.303318	159	239	0	80	80	1.0000000
NODE_36832_length_521_cov_4.971564	218	298	0	80	80	1.0000000
NODE_36832_length_521_cov_4.971564	271	351	0	80	80	1.0000000
NODE_36845_length_521_cov_3.504739	113	191	0	78	78	1.0000000
NODE_36845_length_521_cov_3.504739	164	205	0	41	41	1.0000000
NODE_36848_length_521_cov_3.324645	158	244	1	31	86	0.3604651
NODE_36848_length_521_cov_3.324645	158	244	3	19	86	0.2209302
NODE_36848_length_521_cov_3.324645	158	244	5	36	86	0.4186046
NODE_36848_length_521_cov_3.324645	217	280	4	35	63	0.5555556
NODE_36848_length_521_cov_3.324645	217	280	5	28	63	0.4444444
NODE_36916_length_521_cov_1.613744	165	227	0	60	62	0.9677419
NODE_36916_length_521_cov_1.613744	165	227	2	2	62	0.0322581
NODE_37036_length_520_cov_50.676960	0	75	0	75	75	1.0000000
NODE_37036_length_520_cov_50.676960	48	128	0	64	80	0.8000000
NODE_37036_length_520_cov_50.676960	48	128	1	16	80	0.2000000
NODE_37036_length_520_cov_50.676960	124	204	1	12	80	0.1500000
NODE_37036_length_520_cov_50.676960	124	204	2	68	80	0.8500000
NODE_37036_length_520_cov_50.676960	177	257	2	80	80	1.0000000
NODE_37037_length_520_cov_43.294537	10	90	0	80	80	1.0000000
NODE_37037_length_520_cov_43.294537	10	90	0	80	80	1.0000000
NODE_37037_length_520_cov_43.294537	10	90	0	80	80	1.0000000
NODE_37037_length_520_cov_43.294537	10	90	0	80	80	1.0000000
NODE_37037_length_520_cov_43.294537	10	90	0	80	80	1.0000000
NODE_37037_length_520_cov_43.294537	10	90	0	80	80	1.0000000
NODE_37037_length_520_cov_43.294537	63	129	0	66	66	1.0000000
NODE_37037_length_520_cov_43.294537	63	142	0	79	79	1.0000000
NODE_37037_length_520_cov_43.294537	63	143	0	80	80	1.0000000
NODE_37037_length_520_cov_43.294537	63	133	0	70	70	1.0000000
NODE_37037_length_520_cov_43.294537	66	133	0	67	67	1.0000000
NODE_37037_length_520_cov_43.294537	68	143	0	75	75	1.0000000
NODE_37038_length_520_cov_29.427553	224	304	0	80	80	1.0000000
NODE_37038_length_520_cov_29.427553	277	357	0	36	80	0.4500000
NODE_37038_length_520_cov_29.427553	277	357	1	14	80	0.1750000
NODE_37038_length_520_cov_29.427553	277	357	2	30	80	0.3750000
NODE_37038_length_520_cov_29.427553	353	433	2	80	80	1.0000000
NODE_37038_length_520_cov_29.427553	406	486	0	9	80	0.1125000
NODE_37038_length_520_cov_29.427553	406	486	1	28	80	0.3500000
NODE_37038_length_520_cov_29.427553	406	486	2	43	80	0.5375000
NODE_37039_length_520_cov_14.365796	103	183	1	29	80	0.3625000
NODE_37039_length_520_cov_14.365796	103	183	2	51	80	0.6375000
NODE_37039_length_520_cov_14.365796	156	237	1	36	81	0.4444444
NODE_37039_length_520_cov_14.365796	156	237	2	45	81	0.5555556
NODE_37059_length_520_cov_4.121140	79	159	0	33	80	0.4125000
NODE_37059_length_520_cov_4.121140	79	159	1	47	80	0.5875000
NODE_37059_length_520_cov_4.121140	132	212	1	80	80	1.0000000
NODE_37063_length_520_cov_3.900238	203	233	0	30	30	1.0000000
NODE_37235_length_519_cov_42.842857	8	88	3	22	80	0.2750000
NODE_37235_length_519_cov_42.842857	8	88	4	58	80	0.7250000
NODE_37235_length_519_cov_42.842857	61	139	2	8	78	0.1025641
NODE_37235_length_519_cov_42.842857	61	139	3	16	78	0.2051282
NODE_37235_length_519_cov_42.842857	61	139	4	30	78	0.3846154
NODE_37235_length_519_cov_42.842857	61	139	5	24	78	0.3076923
NODE_37236_length_519_cov_19.269048	284	363	2	79	79	1.0000000
NODE_37236_length_519_cov_19.269048	336	416	0	35	80	0.4375000
NODE_37236_length_519_cov_19.269048	336	416	2	45	80	0.5625000
NODE_37237_length_519_cov_8.500000	195	267	0	9	72	0.1250000
NODE_37237_length_519_cov_8.500000	195	267	1	35	72	0.4861111
NODE_37237_length_519_cov_8.500000	195	267	2	28	72	0.3888889
NODE_37245_length_519_cov_5.169048	282	346	0	4	64	0.0625000
NODE_37245_length_519_cov_5.169048	282	346	1	60	64	0.9375000
NODE_37290_length_519_cov_2.783333	174	235	0	61	61	1.0000000
NODE_37349_length_519_cov_1.538095	147	213	0	66	66	1.0000000
NODE_37447_length_518_cov_40.026253	385	465	3	12	80	0.1500000
NODE_37447_length_518_cov_40.026253	385	465	4	57	80	0.7125000
NODE_37447_length_518_cov_40.026253	385	465	5	11	80	0.1375000
NODE_37447_length_518_cov_40.026253	438	518	0	2	80	0.0250000
NODE_37447_length_518_cov_40.026253	438	518	2	6	80	0.0750000
NODE_37447_length_518_cov_40.026253	438	518	3	45	80	0.5625000
NODE_37447_length_518_cov_40.026253	438	518	4	27	80	0.3375000
NODE_37449_length_518_cov_12.083532	144	224	0	60	80	0.7500000
NODE_37449_length_518_cov_12.083532	144	224	1	15	80	0.1875000
NODE_37449_length_518_cov_12.083532	144	224	2	1	80	0.0125000
NODE_37449_length_518_cov_12.083532	144	224	3	4	80	0.0500000
NODE_37449_length_518_cov_12.083532	197	277	0	20	80	0.2500000
NODE_37449_length_518_cov_12.083532	197	277	1	2	80	0.0250000
NODE_37449_length_518_cov_12.083532	197	277	2	1	80	0.0125000
NODE_37449_length_518_cov_12.083532	197	277	3	57	80	0.7125000
NODE_37449_length_518_cov_12.083532	407	481	0	74	74	1.0000000
NODE_37449_length_518_cov_12.083532	454	518	0	64	64	1.0000000
NODE_37450_length_518_cov_11.467780	171	200	3	9	29	0.3103448
NODE_37450_length_518_cov_11.467780	171	200	4	4	29	0.1379310
NODE_37450_length_518_cov_11.467780	171	200	5	16	29	0.5517241
NODE_37450_length_518_cov_11.467780	253	320	0	1	67	0.0149254
NODE_37450_length_518_cov_11.467780	253	320	2	51	67	0.7611941
NODE_37450_length_518_cov_11.467780	253	320	3	15	67	0.2238806
NODE_37450_length_518_cov_11.467780	253	282	2	14	29	0.4827586
NODE_37450_length_518_cov_11.467780	253	282	3	15	29	0.5172414
NODE_37454_length_518_cov_7.441527	188	273	2	85	85	1.0000000
NODE_37461_length_518_cov_5.563246	315	366	0	51	51	1.0000000
NODE_37461_length_518_cov_5.563246	339	383	0	44	44	1.0000000
NODE_37465_length_518_cov_4.732697	214	276	0	9	62	0.1451613
NODE_37465_length_518_cov_4.732697	214	276	1	53	62	0.8548387
NODE_37465_length_518_cov_4.732697	350	430	0	23	80	0.2875000
NODE_37465_length_518_cov_4.732697	350	430	1	57	80	0.7125000
NODE_37479_length_518_cov_3.503580	291	333	4	6	42	0.1428571
NODE_37479_length_518_cov_3.503580	291	333	5	10	42	0.2380952
NODE_37479_length_518_cov_3.503580	291	333	6	17	42	0.4047619
NODE_37479_length_518_cov_3.503580	291	333	7	9	42	0.2142857
NODE_37479_length_518_cov_3.503580	306	363	4	6	57	0.1052632
NODE_37479_length_518_cov_3.503580	306	363	5	22	57	0.3859649
NODE_37479_length_518_cov_3.503580	306	363	6	23	57	0.4035088
NODE_37479_length_518_cov_3.503580	306	363	7	6	57	0.1052632
NODE_37483_length_518_cov_3.136038	269	338	6	4	69	0.0579710
NODE_37483_length_518_cov_3.136038	269	338	8	3	69	0.0434783
NODE_37483_length_518_cov_3.136038	269	338	10	38	69	0.5507246
NODE_37483_length_518_cov_3.136038	269	338	11	24	69	0.3478261
NODE_37483_length_518_cov_3.136038	269	348	6	4	79	0.0506329
NODE_37483_length_518_cov_3.136038	269	348	8	13	79	0.1645570
NODE_37483_length_518_cov_3.136038	269	348	10	38	79	0.4810127
NODE_37483_length_518_cov_3.136038	269	348	11	24	79	0.3037975
NODE_37483_length_518_cov_3.136038	269	349	6	4	80	0.0500000
NODE_37483_length_518_cov_3.136038	269	349	8	14	80	0.1750000
NODE_37483_length_518_cov_3.136038	269	349	10	38	80	0.4750000
NODE_37483_length_518_cov_3.136038	269	349	11	24	80	0.3000000
NODE_37483_length_518_cov_3.136038	322	402	3	33	80	0.4125000
NODE_37483_length_518_cov_3.136038	322	402	4	8	80	0.1000000
NODE_37483_length_518_cov_3.136038	322	402	6	2	80	0.0250000
NODE_37483_length_518_cov_3.136038	322	402	8	22	80	0.2750000
NODE_37483_length_518_cov_3.136038	322	402	10	15	80	0.1875000
NODE_37483_length_518_cov_3.136038	322	364	4	3	42	0.0714286
NODE_37483_length_518_cov_3.136038	322	364	6	2	42	0.0476190
NODE_37483_length_518_cov_3.136038	322	364	8	22	42	0.5238096
NODE_37483_length_518_cov_3.136038	322	364	10	15	42	0.3571429
NODE_37483_length_518_cov_3.136038	322	368	4	7	46	0.1521739
NODE_37483_length_518_cov_3.136038	322	368	6	2	46	0.0434783
NODE_37483_length_518_cov_3.136038	322	368	8	22	46	0.4782609
NODE_37483_length_518_cov_3.136038	322	368	10	15	46	0.3260870
NODE_37483_length_518_cov_3.136038	331	366	4	5	35	0.1428571
NODE_37483_length_518_cov_3.136038	331	366	6	2	35	0.0571429
NODE_37483_length_518_cov_3.136038	331	366	8	22	35	0.6285715
NODE_37483_length_518_cov_3.136038	331	366	10	6	35	0.1714286
NODE_37637_length_517_cov_55.267943	177	257	1	11	80	0.1375000
NODE_37637_length_517_cov_55.267943	177	257	2	69	80	0.8625000
NODE_37637_length_517_cov_55.267943	230	310	2	39	80	0.4875000
NODE_37637_length_517_cov_55.267943	230	310	3	15	80	0.1875000
NODE_37637_length_517_cov_55.267943	230	310	4	26	80	0.3250000
NODE_37639_length_517_cov_30.863636	0	72	1	3	72	0.0416667
NODE_37639_length_517_cov_30.863636	0	72	3	11	72	0.1527778
NODE_37639_length_517_cov_30.863636	0	72	5	58	72	0.8055556
NODE_37639_length_517_cov_30.863636	0	72	1	3	72	0.0416667
NODE_37639_length_517_cov_30.863636	0	72	3	11	72	0.1527778
NODE_37639_length_517_cov_30.863636	0	72	5	58	72	0.8055556
NODE_37639_length_517_cov_30.863636	45	125	5	36	80	0.4500000
NODE_37639_length_517_cov_30.863636	45	125	7	10	80	0.1250000
NODE_37639_length_517_cov_30.863636	45	125	8	34	80	0.4250000
NODE_37639_length_517_cov_30.863636	45	99	5	35	54	0.6481481
NODE_37639_length_517_cov_30.863636	45	99	7	9	54	0.1666667
NODE_37639_length_517_cov_30.863636	45	99	8	10	54	0.1851852
NODE_37641_length_517_cov_12.258373	305	385	3	41	80	0.5125000
NODE_37641_length_517_cov_12.258373	305	385	4	19	80	0.2375000
NODE_37641_length_517_cov_12.258373	305	385	5	20	80	0.2500000
NODE_37641_length_517_cov_12.258373	358	438	2	26	80	0.3250000
NODE_37641_length_517_cov_12.258373	358	438	3	54	80	0.6750000
NODE_37643_length_517_cov_7.131579	100	152	0	52	52	1.0000000
NODE_37662_length_517_cov_4.492823	140	220	0	80	80	1.0000000
NODE_37662_length_517_cov_4.492823	193	273	0	80	80	1.0000000
NODE_37697_length_517_cov_2.437799	331	388	0	57	57	1.0000000
NODE_37850_length_516_cov_17.570743	147	227	0	80	80	1.0000000
NODE_37850_length_516_cov_17.570743	200	280	0	80	80	1.0000000
NODE_37861_length_516_cov_5.268585	402	448	0	46	46	1.0000000
NODE_37862_length_516_cov_5.067146	114	194	0	80	80	1.0000000
NODE_37862_length_516_cov_5.067146	167	247	0	80	80	1.0000000
NODE_37864_length_516_cov_4.788969	156	236	0	80	80	1.0000000
NODE_37864_length_516_cov_4.788969	209	277	0	68	68	1.0000000
NODE_37881_length_516_cov_3.167866	48	93	0	45	45	1.0000000
NODE_37881_length_516_cov_3.167866	103	177	0	74	74	1.0000000
NODE_38044_length_515_cov_69.442308	177	257	8	11	80	0.1375000
NODE_38044_length_515_cov_69.442308	177	257	9	16	80	0.2000000
NODE_38044_length_515_cov_69.442308	177	257	10	22	80	0.2750000
NODE_38044_length_515_cov_69.442308	177	257	11	10	80	0.1250000
NODE_38044_length_515_cov_69.442308	177	257	12	11	80	0.1375000
NODE_38044_length_515_cov_69.442308	177	257	13	4	80	0.0500000
NODE_38044_length_515_cov_69.442308	177	257	14	6	80	0.0750000
NODE_38044_length_515_cov_69.442308	177	257	8	11	80	0.1375000
NODE_38044_length_515_cov_69.442308	177	257	9	16	80	0.2000000
NODE_38044_length_515_cov_69.442308	177	257	10	22	80	0.2750000
NODE_38044_length_515_cov_69.442308	177	257	11	10	80	0.1250000
NODE_38044_length_515_cov_69.442308	177	257	12	11	80	0.1375000
NODE_38044_length_515_cov_69.442308	177	257	13	4	80	0.0500000
NODE_38044_length_515_cov_69.442308	177	257	14	6	80	0.0750000
NODE_38044_length_515_cov_69.442308	177	257	8	11	80	0.1375000
NODE_38044_length_515_cov_69.442308	177	257	9	16	80	0.2000000
NODE_38044_length_515_cov_69.442308	177	257	10	22	80	0.2750000
NODE_38044_length_515_cov_69.442308	177	257	11	10	80	0.1250000
NODE_38044_length_515_cov_69.442308	177	257	12	11	80	0.1375000
NODE_38044_length_515_cov_69.442308	177	257	13	4	80	0.0500000
NODE_38044_length_515_cov_69.442308	177	257	14	6	80	0.0750000
NODE_38044_length_515_cov_69.442308	230	291	9	16	61	0.2622951
NODE_38044_length_515_cov_69.442308	230	291	10	45	61	0.7377049
NODE_38044_length_515_cov_69.442308	230	308	9	16	78	0.2051282
NODE_38044_length_515_cov_69.442308	230	308	10	62	78	0.7948718
NODE_38044_length_515_cov_69.442308	235	308	9	12	73	0.1643836
NODE_38044_length_515_cov_69.442308	235	308	10	61	73	0.8356164
NODE_38045_length_515_cov_13.271635	168	248	0	80	80	1.0000000
NODE_38045_length_515_cov_13.271635	221	301	0	80	80	1.0000000
NODE_38048_length_515_cov_8.314904	213	290	1	8	77	0.1038961
NODE_38048_length_515_cov_8.314904	213	290	2	63	77	0.8181818
NODE_38048_length_515_cov_8.314904	213	290	3	6	77	0.0779221
NODE_38054_length_515_cov_5.487981	317	402	1	38	85	0.4470588
NODE_38054_length_515_cov_5.487981	317	402	2	47	85	0.5529412
NODE_38242_length_514_cov_26.910843	170	250	7	24	80	0.3000000
NODE_38242_length_514_cov_26.910843	170	250	9	20	80	0.2500000
NODE_38242_length_514_cov_26.910843	170	250	11	35	80	0.4375000
NODE_38242_length_514_cov_26.910843	170	250	12	1	80	0.0125000
NODE_38242_length_514_cov_26.910843	223	303	2	6	80	0.0750000
NODE_38242_length_514_cov_26.910843	223	303	4	21	80	0.2625000
NODE_38242_length_514_cov_26.910843	223	303	5	7	80	0.0875000
NODE_38242_length_514_cov_26.910843	223	303	7	43	80	0.5375000
NODE_38242_length_514_cov_26.910843	223	303	9	3	80	0.0375000
NODE_38243_length_514_cov_12.775904	85	149	1	64	64	1.0000000
NODE_38243_length_514_cov_12.775904	123	202	1	43	79	0.5443038
NODE_38243_length_514_cov_12.775904	123	202	2	36	79	0.4556962
NODE_38244_length_514_cov_11.156627	124	204	7	10	80	0.1250000
NODE_38244_length_514_cov_11.156627	124	204	8	25	80	0.3125000
NODE_38244_length_514_cov_11.156627	124	204	9	26	80	0.3250000
NODE_38244_length_514_cov_11.156627	124	204	10	10	80	0.1250000
NODE_38244_length_514_cov_11.156627	124	204	11	9	80	0.1125000
NODE_38244_length_514_cov_11.156627	177	257	6	8	80	0.1000000
NODE_38244_length_514_cov_11.156627	177	257	7	6	80	0.0750000
NODE_38244_length_514_cov_11.156627	177	257	8	46	80	0.5750000
NODE_38244_length_514_cov_11.156627	177	257	9	6	80	0.0750000
NODE_38244_length_514_cov_11.156627	177	257	10	5	80	0.0625000
NODE_38244_length_514_cov_11.156627	177	257	11	9	80	0.1125000
NODE_38253_length_514_cov_5.802410	165	217	3	33	52	0.6346154
NODE_38253_length_514_cov_5.802410	165	217	5	19	52	0.3653846
NODE_38253_length_514_cov_5.802410	190	270	3	8	80	0.1000000
NODE_38253_length_514_cov_5.802410	190	270	4	19	80	0.2375000
NODE_38253_length_514_cov_5.802410	190	270	5	53	80	0.6625000
NODE_38254_length_514_cov_5.554217	192	272	0	80	80	1.0000000
NODE_38254_length_514_cov_5.554217	294	340	0	46	46	1.0000000
NODE_38257_length_514_cov_5.322892	230	260	0	30	30	1.0000000
NODE_38262_length_514_cov_4.337349	220	300	0	80	80	1.0000000
NODE_38286_length_514_cov_3.012048	264	328	0	64	64	1.0000000
NODE_38432_length_513_cov_14.613527	118	198	0	80	80	1.0000000
NODE_38432_length_513_cov_14.613527	171	251	0	80	80	1.0000000
NODE_38433_length_513_cov_9.898551	253	333	2	80	80	1.0000000
NODE_38433_length_513_cov_9.898551	306	386	0	3	80	0.0375000
NODE_38433_length_513_cov_9.898551	306	386	2	77	80	0.9625000
NODE_38434_length_513_cov_9.164251	185	265	1	20	80	0.2500000
NODE_38434_length_513_cov_9.164251	185	265	2	60	80	0.7500000
NODE_38434_length_513_cov_9.164251	238	318	2	80	80	1.0000000
NODE_38441_length_513_cov_6.123188	284	364	3	26	80	0.3250000
NODE_38441_length_513_cov_6.123188	284	364	4	54	80	0.6750000
NODE_38441_length_513_cov_6.123188	337	417	3	39	80	0.4875000
NODE_38441_length_513_cov_6.123188	337	417	4	41	80	0.5125000
NODE_38460_length_513_cov_3.456522	283	350	4	2	67	0.0298507
NODE_38460_length_513_cov_3.456522	283	350	5	4	67	0.0597015
NODE_38460_length_513_cov_3.456522	283	350	7	21	67	0.3134328
NODE_38460_length_513_cov_3.456522	283	350	8	40	67	0.5970149
NODE_38460_length_513_cov_3.456522	336	398	6	15	62	0.2419355
NODE_38460_length_513_cov_3.456522	336	398	8	47	62	0.7580645
NODE_38482_length_513_cov_2.309179	134	174	3	30	40	0.7500000
NODE_38482_length_513_cov_2.309179	134	174	4	10	40	0.2500000
NODE_38482_length_513_cov_2.309179	170	223	1	18	53	0.3396226
NODE_38482_length_513_cov_2.309179	170	223	2	5	53	0.0943396
NODE_38482_length_513_cov_2.309179	170	223	3	30	53	0.5660377
NODE_38482_length_513_cov_2.309179	238	285	0	6	47	0.1276596
NODE_38482_length_513_cov_2.309179	238	285	1	41	47	0.8723404
NODE_38515_length_513_cov_1.671498	427	476	4	49	49	1.0000000
NODE_38646_length_512_cov_45.070218	34	114	0	49	80	0.6125000
NODE_38646_length_512_cov_45.070218	34	114	1	7	80	0.0875000
NODE_38646_length_512_cov_45.070218	34	114	2	23	80	0.2875000
NODE_38646_length_512_cov_45.070218	34	114	3	1	80	0.0125000
NODE_38646_length_512_cov_45.070218	87	167	1	3	80	0.0375000
NODE_38646_length_512_cov_45.070218	87	167	2	23	80	0.2875000
NODE_38646_length_512_cov_45.070218	87	167	3	54	80	0.6750000
NODE_38647_length_512_cov_39.639225	323	404	2	81	81	1.0000000
NODE_38647_length_512_cov_39.639225	377	457	0	49	80	0.6125000
NODE_38647_length_512_cov_39.639225	377	457	2	31	80	0.3875000
NODE_38648_length_512_cov_8.581114	192	256	3	9	64	0.1406250
NODE_38648_length_512_cov_8.581114	192	256	4	18	64	0.2812500
NODE_38648_length_512_cov_8.581114	192	256	5	5	64	0.0781250
NODE_38648_length_512_cov_8.581114	192	256	6	5	64	0.0781250
NODE_38648_length_512_cov_8.581114	192	256	8	27	64	0.4218750
NODE_38661_length_512_cov_4.869249	327	407	0	54	80	0.6750000
NODE_38661_length_512_cov_4.869249	327	407	2	26	80	0.3250000
NODE_38661_length_512_cov_4.869249	380	460	0	1	80	0.0125000
NODE_38661_length_512_cov_4.869249	380	460	2	79	80	0.9875000
NODE_38668_length_512_cov_4.157385	161	204	2	9	43	0.2093023
NODE_38668_length_512_cov_4.157385	161	204	3	34	43	0.7906977
NODE_38668_length_512_cov_4.157385	178	257	1	25	79	0.3164557
NODE_38668_length_512_cov_4.157385	178	257	2	37	79	0.4683544
NODE_38668_length_512_cov_4.157385	178	257	3	17	79	0.2151899
NODE_38677_length_512_cov_3.435835	138	218	0	80	80	1.0000000
NODE_38677_length_512_cov_3.435835	191	271	0	80	80	1.0000000
NODE_38693_length_512_cov_2.888620	320	400	0	62	80	0.7750000
NODE_38693_length_512_cov_2.888620	320	400	1	4	80	0.0500000
NODE_38693_length_512_cov_2.888620	320	400	2	14	80	0.1750000
NODE_38768_length_512_cov_1.341404	198	269	0	2	71	0.0281690
NODE_38768_length_512_cov_1.341404	198	269	2	4	71	0.0563380
NODE_38768_length_512_cov_1.341404	198	269	3	15	71	0.2112676
NODE_38768_length_512_cov_1.341404	198	269	4	3	71	0.0422535
NODE_38768_length_512_cov_1.341404	198	269	6	8	71	0.1126761
NODE_38768_length_512_cov_1.341404	198	269	7	6	71	0.0845070
NODE_38768_length_512_cov_1.341404	198	269	8	3	71	0.0422535
NODE_38768_length_512_cov_1.341404	198	269	9	4	71	0.0563380
NODE_38768_length_512_cov_1.341404	198	269	10	7	71	0.0985916
NODE_38768_length_512_cov_1.341404	198	269	11	6	71	0.0845070
NODE_38768_length_512_cov_1.341404	198	269	12	13	71	0.1830986
NODE_38866_length_511_cov_9.796117	251	331	0	80	80	1.0000000
NODE_38866_length_511_cov_9.796117	304	370	0	66	66	1.0000000
NODE_38869_length_511_cov_8.873786	239	319	2	7	80	0.0875000
NODE_38869_length_511_cov_8.873786	239	319	4	55	80	0.6875000
NODE_38869_length_511_cov_8.873786	239	319	5	18	80	0.2250000
NODE_38869_length_511_cov_8.873786	292	356	3	22	64	0.3437500
NODE_38869_length_511_cov_8.873786	292	356	4	42	64	0.6562500
NODE_38870_length_511_cov_8.434466	232	312	0	80	80	1.0000000
NODE_38870_length_511_cov_8.434466	285	366	0	81	81	1.0000000
NODE_38872_length_511_cov_7.519417	157	237	5	56	80	0.7000000
NODE_38872_length_511_cov_7.519417	157	237	7	24	80	0.3000000
NODE_38872_length_511_cov_7.519417	210	290	4	24	80	0.3000000
NODE_38872_length_511_cov_7.519417	210	290	5	56	80	0.7000000
NODE_38877_length_511_cov_5.762136	102	179	6	1	77	0.0129870
NODE_38877_length_511_cov_5.762136	102	179	7	13	77	0.1688312
NODE_38877_length_511_cov_5.762136	102	179	8	41	77	0.5324675
NODE_38877_length_511_cov_5.762136	102	179	9	22	77	0.2857143
NODE_38877_length_511_cov_5.762136	155	230	8	7	75	0.0933333
NODE_38877_length_511_cov_5.762136	155	230	9	39	75	0.5200000
NODE_38877_length_511_cov_5.762136	155	230	10	29	75	0.3866667
NODE_38878_length_511_cov_5.655340	133	213	0	80	80	1.0000000
NODE_38878_length_511_cov_5.655340	186	266	0	80	80	1.0000000
NODE_38911_length_511_cov_2.978155	219	255	1	9	36	0.2500000
NODE_38911_length_511_cov_2.978155	219	255	2	27	36	0.7500000
NODE_39013_length_511_cov_1.225728	99	127	0	28	28	1.0000000
NODE_39092_length_511_cov_0.708738	98	146	0	48	48	1.0000000
NODE_39105_length_510_cov_18.206813	334	414	1	3	80	0.0375000
NODE_39105_length_510_cov_18.206813	334	414	2	2	80	0.0250000
NODE_39105_length_510_cov_18.206813	334	414	4	1	80	0.0125000
NODE_39105_length_510_cov_18.206813	334	414	5	74	80	0.9250000
NODE_39105_length_510_cov_18.206813	387	467	5	80	80	1.0000000
NODE_39110_length_510_cov_8.017032	211	291	0	80	80	1.0000000
NODE_39110_length_510_cov_8.017032	264	344	0	80	80	1.0000000
NODE_39110_length_510_cov_8.017032	391	413	0	22	22	1.0000000
NODE_39112_length_510_cov_6.476886	208	251	3	31	43	0.7209302
NODE_39112_length_510_cov_6.476886	208	251	4	12	43	0.2790698
NODE_39115_length_510_cov_6.133820	149	200	1	12	51	0.2352941
NODE_39115_length_510_cov_6.133820	149	200	2	6	51	0.1176471
NODE_39115_length_510_cov_6.133820	149	200	3	33	51	0.6470588
NODE_39122_length_510_cov_4.313869	32	106	3	74	74	1.0000000
NODE_39131_length_510_cov_3.435523	149	213	0	64	64	1.0000000
NODE_39131_length_510_cov_3.435523	191	249	0	58	58	1.0000000
NODE_39293_length_509_cov_13.378049	160	240	0	80	80	1.0000000
NODE_39293_length_509_cov_13.378049	213	294	0	81	81	1.0000000
NODE_39302_length_509_cov_5.190244	203	283	0	12	80	0.1500000
NODE_39302_length_509_cov_5.190244	203	283	1	68	80	0.8500000
NODE_39302_length_509_cov_5.190244	256	336	1	33	80	0.4125000
NODE_39302_length_509_cov_5.190244	256	336	2	47	80	0.5875000
NODE_39309_length_509_cov_4.478049	221	301	0	80	80	1.0000000
NODE_39309_length_509_cov_4.478049	274	354	0	80	80	1.0000000
NODE_39311_length_509_cov_4.451220	203	283	0	80	80	1.0000000
NODE_39322_length_509_cov_3.443902	133	185	0	52	52	1.0000000
NODE_39326_length_509_cov_3.207317	367	445	0	78	78	1.0000000
NODE_39337_length_509_cov_2.853659	194	274	1	79	80	0.9875000
NODE_39337_length_509_cov_2.853659	194	274	2	1	80	0.0125000
NODE_39480_length_509_cov_0.809756	229	272	1	43	43	1.0000000
NODE_39506_length_508_cov_22.009780	440	508	0	27	68	0.3970588
NODE_39506_length_508_cov_22.009780	440	508	1	41	68	0.6029412
NODE_39512_length_508_cov_5.158924	248	284	0	36	36	1.0000000
NODE_39539_length_508_cov_2.662592	165	244	0	41	79	0.5189874
NODE_39539_length_508_cov_2.662592	165	244	2	7	79	0.0886076
NODE_39539_length_508_cov_2.662592	165	244	3	6	79	0.0759494
NODE_39539_length_508_cov_2.662592	165	244	5	25	79	0.3164557
NODE_39698_length_507_cov_32.286765	0	61	14	2	61	0.0327869
NODE_39698_length_507_cov_32.286765	0	61	17	1	61	0.0163934
NODE_39698_length_507_cov_32.286765	0	61	18	1	61	0.0163934
NODE_39698_length_507_cov_32.286765	0	61	20	1	61	0.0163934
NODE_39698_length_507_cov_32.286765	0	61	26	2	61	0.0327869
NODE_39698_length_507_cov_32.286765	0	61	27	1	61	0.0163934
NODE_39698_length_507_cov_32.286765	0	61	32	1	61	0.0163934
NODE_39698_length_507_cov_32.286765	0	61	34	1	61	0.0163934
NODE_39698_length_507_cov_32.286765	0	61	37	1	61	0.0163934
NODE_39698_length_507_cov_32.286765	0	61	43	1	61	0.0163934
NODE_39698_length_507_cov_32.286765	0	61	45	1	61	0.0163934
NODE_39698_length_507_cov_32.286765	0	61	48	2	61	0.0327869
NODE_39698_length_507_cov_32.286765	0	61	54	2	61	0.0327869
NODE_39698_length_507_cov_32.286765	0	61	57	1	61	0.0163934
NODE_39698_length_507_cov_32.286765	0	61	58	2	61	0.0327869
NODE_39698_length_507_cov_32.286765	0	61	60	1	61	0.0163934
NODE_39698_length_507_cov_32.286765	0	61	61	1	61	0.0163934
NODE_39698_length_507_cov_32.286765	0	61	63	3	61	0.0491803
NODE_39698_length_507_cov_32.286765	0	61	64	1	61	0.0163934
NODE_39698_length_507_cov_32.286765	0	61	66	1	61	0.0163934
NODE_39698_length_507_cov_32.286765	0	61	68	1	61	0.0163934
NODE_39698_length_507_cov_32.286765	0	61	73	2	61	0.0327869
NODE_39698_length_507_cov_32.286765	0	61	75	1	61	0.0163934
NODE_39698_length_507_cov_32.286765	0	61	79	1	61	0.0163934
NODE_39698_length_507_cov_32.286765	0	61	80	1	61	0.0163934
NODE_39698_length_507_cov_32.286765	0	61	84	1	61	0.0163934
NODE_39698_length_507_cov_32.286765	0	61	86	2	61	0.0327869
NODE_39698_length_507_cov_32.286765	0	61	89	1	61	0.0163934
NODE_39698_length_507_cov_32.286765	0	61	90	1	61	0.0163934
NODE_39698_length_507_cov_32.286765	0	61	94	1	61	0.0163934
NODE_39698_length_507_cov_32.286765	0	61	96	3	61	0.0491803
NODE_39698_length_507_cov_32.286765	0	61	98	1	61	0.0163934
NODE_39698_length_507_cov_32.286765	0	61	100	1	61	0.0163934
NODE_39698_length_507_cov_32.286765	0	61	102	3	61	0.0491803
NODE_39698_length_507_cov_32.286765	0	61	103	3	61	0.0491803
NODE_39698_length_507_cov_32.286765	0	61	105	1	61	0.0163934
NODE_39698_length_507_cov_32.286765	0	61	108	1	61	0.0163934
NODE_39698_length_507_cov_32.286765	0	61	112	1	61	0.0163934
NODE_39698_length_507_cov_32.286765	0	61	117	1	61	0.0163934
NODE_39698_length_507_cov_32.286765	0	61	119	1	61	0.0163934
NODE_39698_length_507_cov_32.286765	0	61	120	1	61	0.0163934
NODE_39698_length_507_cov_32.286765	0	61	121	1	61	0.0163934
NODE_39698_length_507_cov_32.286765	0	61	124	1	61	0.0163934
NODE_39698_length_507_cov_32.286765	0	61	129	1	61	0.0163934
NODE_39698_length_507_cov_32.286765	0	61	132	1	61	0.0163934
NODE_39698_length_507_cov_32.286765	0	61	135	1	61	0.0163934
NODE_39698_length_507_cov_32.286765	53	97	117	1	44	0.0227273
NODE_39698_length_507_cov_32.286765	53	97	119	1	44	0.0227273
NODE_39698_length_507_cov_32.286765	53	97	120	1	44	0.0227273
NODE_39698_length_507_cov_32.286765	53	97	121	1	44	0.0227273
NODE_39698_length_507_cov_32.286765	53	97	124	1	44	0.0227273
NODE_39698_length_507_cov_32.286765	53	97	129	1	44	0.0227273
NODE_39698_length_507_cov_32.286765	53	97	132	1	44	0.0227273
NODE_39698_length_507_cov_32.286765	53	97	135	1	44	0.0227273
NODE_39698_length_507_cov_32.286765	53	97	137	2	44	0.0454545
NODE_39698_length_507_cov_32.286765	53	97	140	1	44	0.0227273
NODE_39698_length_507_cov_32.286765	53	97	142	3	44	0.0681818
NODE_39698_length_507_cov_32.286765	53	97	144	2	44	0.0454545
NODE_39698_length_507_cov_32.286765	53	97	146	1	44	0.0227273
NODE_39698_length_507_cov_32.286765	53	97	149	1	44	0.0227273
NODE_39698_length_507_cov_32.286765	53	97	153	2	44	0.0454545
NODE_39698_length_507_cov_32.286765	53	97	155	1	44	0.0227273
NODE_39698_length_507_cov_32.286765	53	97	157	1	44	0.0227273
NODE_39698_length_507_cov_32.286765	53	97	160	1	44	0.0227273
NODE_39698_length_507_cov_32.286765	53	97	164	1	44	0.0227273
NODE_39698_length_507_cov_32.286765	53	97	166	2	44	0.0454545
NODE_39698_length_507_cov_32.286765	53	97	167	2	44	0.0454545
NODE_39698_length_507_cov_32.286765	53	97	168	1	44	0.0227273
NODE_39698_length_507_cov_32.286765	53	97	173	1	44	0.0227273
NODE_39698_length_507_cov_32.286765	53	97	177	1	44	0.0227273
NODE_39698_length_507_cov_32.286765	53	97	180	2	44	0.0454545
NODE_39698_length_507_cov_32.286765	53	97	181	1	44	0.0227273
NODE_39698_length_507_cov_32.286765	53	97	182	1	44	0.0227273
NODE_39698_length_507_cov_32.286765	53	97	184	1	44	0.0227273
NODE_39698_length_507_cov_32.286765	53	97	187	1	44	0.0227273
NODE_39698_length_507_cov_32.286765	53	97	189	2	44	0.0454545
NODE_39698_length_507_cov_32.286765	53	97	190	1	44	0.0227273
NODE_39698_length_507_cov_32.286765	53	97	192	1	44	0.0227273
NODE_39698_length_507_cov_32.286765	53	97	197	1	44	0.0227273
NODE_39698_length_507_cov_32.286765	53	97	201	1	44	0.0227273
NODE_39698_length_507_cov_32.286765	53	97	203	1	44	0.0227273
NODE_39701_length_507_cov_7.553922	203	283	3	3	80	0.0375000
NODE_39701_length_507_cov_7.553922	203	283	4	1	80	0.0125000
NODE_39701_length_507_cov_7.553922	203	283	6	75	80	0.9375000
NODE_39701_length_507_cov_7.553922	203	283	7	1	80	0.0125000
NODE_39709_length_507_cov_5.154412	296	362	0	66	66	1.0000000
NODE_39714_length_507_cov_4.710784	248	328	3	4	80	0.0500000
NODE_39714_length_507_cov_4.710784	248	328	4	1	80	0.0125000
NODE_39714_length_507_cov_4.710784	248	328	5	8	80	0.1000000
NODE_39714_length_507_cov_4.710784	248	328	7	67	80	0.8375000
NODE_39714_length_507_cov_4.710784	308	379	1	19	71	0.2676056
NODE_39714_length_507_cov_4.710784	308	379	2	15	71	0.2112676
NODE_39714_length_507_cov_4.710784	308	379	3	4	71	0.0563380
NODE_39714_length_507_cov_4.710784	308	379	4	18	71	0.2535211
NODE_39714_length_507_cov_4.710784	308	379	5	6	71	0.0845070
NODE_39714_length_507_cov_4.710784	308	379	7	9	71	0.1267606
NODE_39728_length_507_cov_3.649510	80	109	5	22	29	0.7586207
NODE_39728_length_507_cov_3.649510	80	109	7	7	29	0.2413793
NODE_39728_length_507_cov_3.649510	184	266	11	29	82	0.3536585
NODE_39728_length_507_cov_3.649510	184	266	13	19	82	0.2317073
NODE_39728_length_507_cov_3.649510	184	266	14	2	82	0.0243902
NODE_39728_length_507_cov_3.649510	184	266	15	5	82	0.0609756
NODE_39728_length_507_cov_3.649510	184	266	16	7	82	0.0853659
NODE_39728_length_507_cov_3.649510	184	266	17	7	82	0.0853659
NODE_39728_length_507_cov_3.649510	184	266	19	13	82	0.1585366
NODE_39728_length_507_cov_3.649510	189	273	7	4	84	0.0476190
NODE_39728_length_507_cov_3.649510	189	273	8	1	84	0.0119048
NODE_39728_length_507_cov_3.649510	189	273	9	2	84	0.0238095
NODE_39728_length_507_cov_3.649510	189	273	11	29	84	0.3452381
NODE_39728_length_507_cov_3.649510	189	273	13	19	84	0.2261905
NODE_39728_length_507_cov_3.649510	189	273	14	2	84	0.0238095
NODE_39728_length_507_cov_3.649510	189	273	15	5	84	0.0595238
NODE_39728_length_507_cov_3.649510	189	273	16	7	84	0.0833333
NODE_39728_length_507_cov_3.649510	189	273	17	7	84	0.0833333
NODE_39728_length_507_cov_3.649510	189	273	19	8	84	0.0952381
NODE_39728_length_507_cov_3.649510	207	266	11	29	59	0.4915254
NODE_39728_length_507_cov_3.649510	207	266	13	19	59	0.3220339
NODE_39728_length_507_cov_3.649510	207	266	14	2	59	0.0338983
NODE_39728_length_507_cov_3.649510	207	266	15	5	59	0.0847458
NODE_39728_length_507_cov_3.649510	207	266	16	4	59	0.0677966
NODE_39747_length_507_cov_2.754902	345	425	0	80	80	1.0000000
NODE_39747_length_507_cov_2.754902	428	463	0	35	35	1.0000000
NODE_39918_length_506_cov_31.987715	71	156	2	85	85	1.0000000
NODE_39918_length_506_cov_31.987715	71	156	2	85	85	1.0000000
NODE_39918_length_506_cov_31.987715	71	156	2	85	85	1.0000000
NODE_39918_length_506_cov_31.987715	129	209	0	22	80	0.2750000
NODE_39918_length_506_cov_31.987715	129	209	1	16	80	0.2000000
NODE_39918_length_506_cov_31.987715	129	209	2	42	80	0.5250000
NODE_39919_length_506_cov_15.877150	210	279	1	9	69	0.1304348
NODE_39919_length_506_cov_15.877150	210	279	3	60	69	0.8695652
NODE_39920_length_506_cov_15.461916	334	414	0	80	80	1.0000000
NODE_39920_length_506_cov_15.461916	387	467	0	80	80	1.0000000
NODE_39921_length_506_cov_9.749386	197	276	0	79	79	1.0000000
NODE_39921_length_506_cov_9.749386	249	329	0	80	80	1.0000000
NODE_39947_length_506_cov_3.122850	218	298	0	80	80	1.0000000
NODE_39947_length_506_cov_3.122850	271	351	0	63	80	0.7875000
NODE_39947_length_506_cov_3.122850	271	351	1	17	80	0.2125000
NODE_39951_length_506_cov_2.894349	190	270	1	80	80	1.0000000
NODE_40133_length_505_cov_35.541872	373	453	10	5	80	0.0625000
NODE_40133_length_505_cov_35.541872	373	453	11	5	80	0.0625000
NODE_40133_length_505_cov_35.541872	373	453	12	2	80	0.0250000
NODE_40133_length_505_cov_35.541872	373	453	14	5	80	0.0625000
NODE_40133_length_505_cov_35.541872	373	453	15	18	80	0.2250000
NODE_40133_length_505_cov_35.541872	373	453	16	3	80	0.0375000
NODE_40133_length_505_cov_35.541872	373	453	17	42	80	0.5250000
NODE_40135_length_505_cov_10.339901	30	110	1	22	80	0.2750000
NODE_40135_length_505_cov_10.339901	30	110	2	58	80	0.7250000
NODE_40135_length_505_cov_10.339901	83	163	2	80	80	1.0000000
NODE_40158_length_505_cov_3.554187	225	305	0	37	80	0.4625000
NODE_40158_length_505_cov_3.554187	225	305	1	8	80	0.1000000
NODE_40158_length_505_cov_3.554187	225	305	2	35	80	0.4375000
NODE_40158_length_505_cov_3.554187	278	358	2	30	80	0.3750000
NODE_40158_length_505_cov_3.554187	278	358	3	17	80	0.2125000
NODE_40158_length_505_cov_3.554187	278	358	4	33	80	0.4125000
NODE_40160_length_505_cov_3.403941	207	287	2	80	80	1.0000000
NODE_40175_length_505_cov_2.975369	162	227	0	65	65	1.0000000
NODE_40222_length_505_cov_1.864532	55	126	0	25	71	0.3521127
NODE_40222_length_505_cov_1.864532	55	126	2	2	71	0.0281690
NODE_40222_length_505_cov_1.864532	55	126	3	44	71	0.6197183
NODE_40368_length_504_cov_115.891358	122	202	53	2	80	0.0250000
NODE_40368_length_504_cov_115.891358	122	202	55	1	80	0.0125000
NODE_40368_length_504_cov_115.891358	122	202	56	1	80	0.0125000
NODE_40368_length_504_cov_115.891358	122	202	59	1	80	0.0125000
NODE_40368_length_504_cov_115.891358	122	202	62	2	80	0.0250000
NODE_40368_length_504_cov_115.891358	122	202	66	3	80	0.0375000
NODE_40368_length_504_cov_115.891358	122	202	69	2	80	0.0250000
NODE_40368_length_504_cov_115.891358	122	202	71	1	80	0.0125000
NODE_40368_length_504_cov_115.891358	122	202	72	3	80	0.0375000
NODE_40368_length_504_cov_115.891358	122	202	73	7	80	0.0875000
NODE_40368_length_504_cov_115.891358	122	202	74	5	80	0.0625000
NODE_40368_length_504_cov_115.891358	122	202	75	4	80	0.0500000
NODE_40368_length_504_cov_115.891358	122	202	76	3	80	0.0375000
NODE_40368_length_504_cov_115.891358	122	202	77	1	80	0.0125000
NODE_40368_length_504_cov_115.891358	122	202	79	1	80	0.0125000
NODE_40368_length_504_cov_115.891358	122	202	80	1	80	0.0125000
NODE_40368_length_504_cov_115.891358	122	202	82	4	80	0.0500000
NODE_40368_length_504_cov_115.891358	122	202	83	1	80	0.0125000
NODE_40368_length_504_cov_115.891358	122	202	84	1	80	0.0125000
NODE_40368_length_504_cov_115.891358	122	202	88	2	80	0.0250000
NODE_40368_length_504_cov_115.891358	122	202	89	3	80	0.0375000
NODE_40368_length_504_cov_115.891358	122	202	93	1	80	0.0125000
NODE_40368_length_504_cov_115.891358	122	202	94	1	80	0.0125000
NODE_40368_length_504_cov_115.891358	122	202	98	4	80	0.0500000
NODE_40368_length_504_cov_115.891358	122	202	100	1	80	0.0125000
NODE_40368_length_504_cov_115.891358	122	202	101	2	80	0.0250000
NODE_40368_length_504_cov_115.891358	122	202	102	1	80	0.0125000
NODE_40368_length_504_cov_115.891358	122	202	103	3	80	0.0375000
NODE_40368_length_504_cov_115.891358	122	202	104	1	80	0.0125000
NODE_40368_length_504_cov_115.891358	122	202	105	2	80	0.0250000
NODE_40368_length_504_cov_115.891358	122	202	106	1	80	0.0125000
NODE_40368_length_504_cov_115.891358	122	202	108	3	80	0.0375000
NODE_40368_length_504_cov_115.891358	122	202	109	5	80	0.0625000
NODE_40368_length_504_cov_115.891358	122	202	110	6	80	0.0750000
NODE_40368_length_504_cov_115.891358	175	255	78	2	80	0.0250000
NODE_40368_length_504_cov_115.891358	175	255	79	1	80	0.0125000
NODE_40368_length_504_cov_115.891358	175	255	80	2	80	0.0250000
NODE_40368_length_504_cov_115.891358	175	255	81	1	80	0.0125000
NODE_40368_length_504_cov_115.891358	175	255	82	1	80	0.0125000
NODE_40368_length_504_cov_115.891358	175	255	85	1	80	0.0125000
NODE_40368_length_504_cov_115.891358	175	255	87	2	80	0.0250000
NODE_40368_length_504_cov_115.891358	175	255	88	4	80	0.0500000
NODE_40368_length_504_cov_115.891358	175	255	89	1	80	0.0125000
NODE_40368_length_504_cov_115.891358	175	255	91	1	80	0.0125000
NODE_40368_length_504_cov_115.891358	175	255	92	2	80	0.0250000
NODE_40368_length_504_cov_115.891358	175	255	94	2	80	0.0250000
NODE_40368_length_504_cov_115.891358	175	255	97	3	80	0.0375000
NODE_40368_length_504_cov_115.891358	175	255	98	8	80	0.1000000
NODE_40368_length_504_cov_115.891358	175	255	100	3	80	0.0375000
NODE_40368_length_504_cov_115.891358	175	255	101	4	80	0.0500000
NODE_40368_length_504_cov_115.891358	175	255	102	5	80	0.0625000
NODE_40368_length_504_cov_115.891358	175	255	103	3	80	0.0375000
NODE_40368_length_504_cov_115.891358	175	255	104	5	80	0.0625000
NODE_40368_length_504_cov_115.891358	175	255	105	4	80	0.0500000
NODE_40368_length_504_cov_115.891358	175	255	106	3	80	0.0375000
NODE_40368_length_504_cov_115.891358	175	255	108	3	80	0.0375000
NODE_40368_length_504_cov_115.891358	175	255	109	7	80	0.0875000
NODE_40368_length_504_cov_115.891358	175	255	110	11	80	0.1375000
NODE_40368_length_504_cov_115.891358	175	255	111	1	80	0.0125000
NODE_40369_length_504_cov_33.360494	28	108	2	80	80	1.0000000
NODE_40369_length_504_cov_33.360494	81	161	0	10	80	0.1250000
NODE_40369_length_504_cov_33.360494	81	161	2	70	80	0.8750000
NODE_40370_length_504_cov_15.669136	176	256	0	9	80	0.1125000
NODE_40370_length_504_cov_15.669136	176	256	1	18	80	0.2250000
NODE_40370_length_504_cov_15.669136	176	256	2	53	80	0.6625000
NODE_40370_length_504_cov_15.669136	229	309	2	80	80	1.0000000
NODE_40371_length_504_cov_13.202469	134	215	0	81	81	1.0000000
NODE_40371_length_504_cov_13.202469	188	268	0	80	80	1.0000000
NODE_40377_length_504_cov_6.770370	55	135	0	80	80	1.0000000
NODE_40377_length_504_cov_6.770370	108	188	0	80	80	1.0000000
NODE_40427_length_504_cov_2.234568	359	407	1	32	48	0.6666667
NODE_40427_length_504_cov_2.234568	359	407	2	16	48	0.3333333
NODE_40428_length_504_cov_2.227160	307	370	0	63	63	1.0000000
NODE_40434_length_504_cov_2.116049	245	325	0	67	80	0.8375000
NODE_40434_length_504_cov_2.116049	245	325	1	13	80	0.1625000
NODE_40434_length_504_cov_2.116049	298	378	0	80	80	1.0000000
NODE_40446_length_504_cov_1.925926	196	262	2	6	66	0.0909091
NODE_40446_length_504_cov_1.925926	196	262	3	49	66	0.7424242
NODE_40446_length_504_cov_1.925926	196	262	4	11	66	0.1666667
NODE_40601_length_503_cov_11.356436	268	348	2	5	80	0.0625000
NODE_40601_length_503_cov_11.356436	268	348	3	75	80	0.9375000
NODE_40601_length_503_cov_11.356436	321	401	2	20	80	0.2500000
NODE_40601_length_503_cov_11.356436	321	401	3	60	80	0.7500000
NODE_40615_length_503_cov_5.537129	314	381	1	7	67	0.1044776
NODE_40615_length_503_cov_5.537129	314	381	2	60	67	0.8955224
NODE_40645_length_503_cov_3.012376	264	285	2	21	21	1.0000000
NODE_40652_length_503_cov_2.757426	266	334	1	32	68	0.4705882
NODE_40652_length_503_cov_2.757426	266	334	2	36	68	0.5294118
NODE_40652_length_503_cov_2.757426	307	387	1	21	80	0.2625000
NODE_40652_length_503_cov_2.757426	307	387	2	59	80	0.7375000
NODE_40655_length_503_cov_2.705446	158	237	0	79	79	1.0000000
NODE_40655_length_503_cov_2.705446	211	291	0	80	80	1.0000000
NODE_40656_length_503_cov_2.705446	251	331	1	16	80	0.2000000
NODE_40656_length_503_cov_2.705446	251	331	2	15	80	0.1875000
NODE_40656_length_503_cov_2.705446	251	331	3	49	80	0.6125000
NODE_40656_length_503_cov_2.705446	251	321	1	16	70	0.2285714
NODE_40656_length_503_cov_2.705446	251	321	2	15	70	0.2142857
NODE_40656_length_503_cov_2.705446	251	321	3	39	70	0.5571429
NODE_40656_length_503_cov_2.705446	330	384	3	11	54	0.2037037
NODE_40656_length_503_cov_2.705446	330	384	4	43	54	0.7962963
NODE_40656_length_503_cov_2.705446	338	384	3	3	46	0.0652174
NODE_40656_length_503_cov_2.705446	338	384	4	43	46	0.9347826
NODE_40664_length_503_cov_2.584158	95	163	0	68	68	1.0000000
NODE_40857_length_502_cov_45.292804	353	433	6	17	80	0.2125000
NODE_40857_length_502_cov_45.292804	353	433	8	3	80	0.0375000
NODE_40857_length_502_cov_45.292804	353	433	9	12	80	0.1500000
NODE_40857_length_502_cov_45.292804	353	433	10	11	80	0.1375000
NODE_40857_length_502_cov_45.292804	353	433	11	2	80	0.0250000
NODE_40857_length_502_cov_45.292804	353	433	12	8	80	0.1000000
NODE_40857_length_502_cov_45.292804	353	433	13	1	80	0.0125000
NODE_40857_length_502_cov_45.292804	353	433	14	9	80	0.1125000
NODE_40857_length_502_cov_45.292804	353	433	15	11	80	0.1375000
NODE_40857_length_502_cov_45.292804	353	433	16	6	80	0.0750000
NODE_40864_length_502_cov_5.980149	305	381	6	16	76	0.2105263
NODE_40864_length_502_cov_5.980149	305	381	7	10	76	0.1315790
NODE_40864_length_502_cov_5.980149	305	381	8	12	76	0.1578947
NODE_40864_length_502_cov_5.980149	305	381	9	35	76	0.4605263
NODE_40864_length_502_cov_5.980149	305	381	10	3	76	0.0394737
NODE_41070_length_501_cov_208.708955	288	350	16	5	62	0.0806452
NODE_41070_length_501_cov_208.708955	288	350	17	1	62	0.0161290
NODE_41070_length_501_cov_208.708955	288	350	18	1	62	0.0161290
NODE_41070_length_501_cov_208.708955	288	350	19	5	62	0.0806452
NODE_41070_length_501_cov_208.708955	288	350	20	12	62	0.1935484
NODE_41070_length_501_cov_208.708955	288	350	21	6	62	0.0967742
NODE_41070_length_501_cov_208.708955	288	350	22	15	62	0.2419355
NODE_41070_length_501_cov_208.708955	288	350	23	17	62	0.2741936
NODE_41070_length_501_cov_208.708955	327	413	6	9	86	0.1046512
NODE_41070_length_501_cov_208.708955	327	413	8	1	86	0.0116279
NODE_41070_length_501_cov_208.708955	327	413	10	3	86	0.0348837
NODE_41070_length_501_cov_208.708955	327	413	11	2	86	0.0232558
NODE_41070_length_501_cov_208.708955	327	413	14	4	86	0.0465116
NODE_41070_length_501_cov_208.708955	327	413	17	6	86	0.0697674
NODE_41070_length_501_cov_208.708955	327	413	21	15	86	0.1744186
NODE_41070_length_501_cov_208.708955	327	413	22	34	86	0.3953488
NODE_41070_length_501_cov_208.708955	327	413	23	12	86	0.1395349
NODE_41071_length_501_cov_29.126866	23	103	0	80	80	1.0000000
NODE_41071_length_501_cov_29.126866	76	156	0	80	80	1.0000000
NODE_41072_length_501_cov_23.736318	85	165	5	23	80	0.2875000
NODE_41072_length_501_cov_23.736318	85	165	6	6	80	0.0750000
NODE_41072_length_501_cov_23.736318	85	165	7	16	80	0.2000000
NODE_41072_length_501_cov_23.736318	85	165	8	30	80	0.3750000
NODE_41072_length_501_cov_23.736318	85	165	9	5	80	0.0625000
NODE_41072_length_501_cov_23.736318	138	218	6	11	80	0.1375000
NODE_41072_length_501_cov_23.736318	138	218	7	30	80	0.3750000
NODE_41072_length_501_cov_23.736318	138	218	8	34	80	0.4250000
NODE_41072_length_501_cov_23.736318	138	218	9	5	80	0.0625000
NODE_41075_length_501_cov_7.820896	270	350	6	26	80	0.3250000
NODE_41075_length_501_cov_7.820896	270	350	7	12	80	0.1500000
NODE_41075_length_501_cov_7.820896	270	350	8	37	80	0.4625000
NODE_41075_length_501_cov_7.820896	270	350	9	5	80	0.0625000
NODE_41075_length_501_cov_7.820896	323	403	7	14	80	0.1750000
NODE_41075_length_501_cov_7.820896	323	403	8	27	80	0.3375000
NODE_41075_length_501_cov_7.820896	323	403	9	9	80	0.1125000
NODE_41075_length_501_cov_7.820896	323	403	10	30	80	0.3750000
NODE_41080_length_501_cov_6.437811	309	389	2	24	80	0.3000000
NODE_41080_length_501_cov_6.437811	309	389	4	22	80	0.2750000
NODE_41080_length_501_cov_6.437811	309	389	6	10	80	0.1250000
NODE_41080_length_501_cov_6.437811	309	389	7	24	80	0.3000000
NODE_41097_length_501_cov_3.656716	289	312	0	23	23	1.0000000
NODE_41097_length_501_cov_3.656716	355	420	1	65	65	1.0000000
NODE_41103_length_501_cov_3.477612	329	409	1	8	80	0.1000000
NODE_41103_length_501_cov_3.477612	329	409	2	72	80	0.9000000
NODE_41109_length_501_cov_3.134328	266	345	1	6	79	0.0759494
NODE_41109_length_501_cov_3.134328	266	345	2	73	79	0.9240506
NODE_41308_length_500_cov_77.895262	456	500	0	44	44	1.0000000
NODE_41309_length_500_cov_35.805486	326	406	0	7	80	0.0875000
NODE_41309_length_500_cov_35.805486	326	406	3	73	80	0.9125000
NODE_41309_length_500_cov_35.805486	379	459	0	60	80	0.7500000
NODE_41309_length_500_cov_35.805486	379	459	3	20	80	0.2500000
NODE_41310_length_500_cov_13.084788	160	221	3	59	61	0.9672131
NODE_41310_length_500_cov_13.084788	160	221	4	1	61	0.0163934
NODE_41310_length_500_cov_13.084788	160	221	5	1	61	0.0163934
NODE_41311_length_500_cov_12.650873	215	295	0	80	80	1.0000000
NODE_41311_length_500_cov_12.650873	268	348	0	80	80	1.0000000
NODE_41312_length_500_cov_12.009975	203	268	2	22	65	0.3384615
NODE_41312_length_500_cov_12.009975	203	268	4	43	65	0.6615385
NODE_41312_length_500_cov_12.009975	241	321	4	63	80	0.7875000
NODE_41312_length_500_cov_12.009975	241	321	6	17	80	0.2125000
NODE_41325_length_500_cov_4.653367	224	295	0	71	71	1.0000000
NODE_41415_length_500_cov_1.650873	355	435	0	80	80	1.0000000
NODE_41415_length_500_cov_1.650873	408	488	0	80	80	1.0000000
NODE_41462_length_500_cov_1.231920	169	212	0	43	43	1.0000000
NODE_41542_length_499_cov_358.730000	425	492	67	1	67	0.0149254
NODE_41542_length_499_cov_358.730000	425	492	72	2	67	0.0298507
NODE_41542_length_499_cov_358.730000	425	492	77	1	67	0.0149254
NODE_41542_length_499_cov_358.730000	425	492	83	1	67	0.0149254
NODE_41542_length_499_cov_358.730000	425	492	84	2	67	0.0298507
NODE_41542_length_499_cov_358.730000	425	492	92	1	67	0.0149254
NODE_41542_length_499_cov_358.730000	425	492	104	1	67	0.0149254
NODE_41542_length_499_cov_358.730000	425	492	112	1	67	0.0149254
NODE_41542_length_499_cov_358.730000	425	492	117	1	67	0.0149254
NODE_41542_length_499_cov_358.730000	425	492	119	1	67	0.0149254
NODE_41542_length_499_cov_358.730000	425	492	122	1	67	0.0149254
NODE_41542_length_499_cov_358.730000	425	492	128	2	67	0.0298507
NODE_41542_length_499_cov_358.730000	425	492	133	1	67	0.0149254
NODE_41542_length_499_cov_358.730000	425	492	136	2	67	0.0298507
NODE_41542_length_499_cov_358.730000	425	492	139	1	67	0.0149254
NODE_41542_length_499_cov_358.730000	425	492	144	1	67	0.0149254
NODE_41542_length_499_cov_358.730000	425	492	147	1	67	0.0149254
NODE_41542_length_499_cov_358.730000	425	492	151	1	67	0.0149254
NODE_41542_length_499_cov_358.730000	425	492	153	1	67	0.0149254
NODE_41542_length_499_cov_358.730000	425	492	157	2	67	0.0298507
NODE_41542_length_499_cov_358.730000	425	492	160	2	67	0.0298507
NODE_41542_length_499_cov_358.730000	425	492	162	1	67	0.0149254
NODE_41542_length_499_cov_358.730000	425	492	163	1	67	0.0149254
NODE_41542_length_499_cov_358.730000	425	492	164	1	67	0.0149254
NODE_41542_length_499_cov_358.730000	425	492	165	2	67	0.0298507
NODE_41542_length_499_cov_358.730000	425	492	170	1	67	0.0149254
NODE_41542_length_499_cov_358.730000	425	492	173	1	67	0.0149254
NODE_41542_length_499_cov_358.730000	425	492	179	1	67	0.0149254
NODE_41542_length_499_cov_358.730000	425	492	181	1	67	0.0149254
NODE_41542_length_499_cov_358.730000	425	492	187	1	67	0.0149254
NODE_41542_length_499_cov_358.730000	425	492	191	2	67	0.0298507
NODE_41542_length_499_cov_358.730000	425	492	192	1	67	0.0149254
NODE_41542_length_499_cov_358.730000	425	492	200	1	67	0.0149254
NODE_41542_length_499_cov_358.730000	425	492	201	1	67	0.0149254
NODE_41542_length_499_cov_358.730000	425	492	206	2	67	0.0298507
NODE_41542_length_499_cov_358.730000	425	492	210	1	67	0.0149254
NODE_41542_length_499_cov_358.730000	425	492	211	1	67	0.0149254
NODE_41542_length_499_cov_358.730000	425	492	213	1	67	0.0149254
NODE_41542_length_499_cov_358.730000	425	492	218	1	67	0.0149254
NODE_41542_length_499_cov_358.730000	425	492	220	1	67	0.0149254
NODE_41542_length_499_cov_358.730000	425	492	226	1	67	0.0149254
NODE_41542_length_499_cov_358.730000	425	492	227	1	67	0.0149254
NODE_41542_length_499_cov_358.730000	425	492	230	1	67	0.0149254
NODE_41542_length_499_cov_358.730000	425	492	232	1	67	0.0149254
NODE_41542_length_499_cov_358.730000	425	492	233	2	67	0.0298507
NODE_41542_length_499_cov_358.730000	425	492	236	1	67	0.0149254
NODE_41542_length_499_cov_358.730000	425	492	237	1	67	0.0149254
NODE_41542_length_499_cov_358.730000	425	492	242	1	67	0.0149254
NODE_41542_length_499_cov_358.730000	425	492	245	1	67	0.0149254
NODE_41542_length_499_cov_358.730000	425	492	254	1	67	0.0149254
NODE_41542_length_499_cov_358.730000	425	492	259	1	67	0.0149254
NODE_41542_length_499_cov_358.730000	425	492	261	1	67	0.0149254
NODE_41542_length_499_cov_358.730000	425	492	263	2	67	0.0298507
NODE_41542_length_499_cov_358.730000	425	492	267	1	67	0.0149254
NODE_41542_length_499_cov_358.730000	425	492	272	1	67	0.0149254
NODE_41542_length_499_cov_358.730000	425	492	274	1	67	0.0149254
NODE_41543_length_499_cov_21.135000	52	132	0	80	80	1.0000000
NODE_41543_length_499_cov_21.135000	105	185	0	80	80	1.0000000
NODE_41544_length_499_cov_11.917500	50	130	1	10	80	0.1250000
NODE_41544_length_499_cov_11.917500	50	130	2	62	80	0.7750000
NODE_41544_length_499_cov_11.917500	50	130	3	8	80	0.1000000
NODE_41544_length_499_cov_11.917500	103	183	1	63	80	0.7875000
NODE_41544_length_499_cov_11.917500	103	183	2	9	80	0.1125000
NODE_41544_length_499_cov_11.917500	103	183	3	8	80	0.1000000
NODE_41549_length_499_cov_5.007500	0	54	0	54	54	1.0000000
NODE_41563_length_499_cov_3.482500	307	336	11	2	29	0.0689655
NODE_41563_length_499_cov_3.482500	307	336	13	22	29	0.7586207
NODE_41563_length_499_cov_3.482500	307	336	15	5	29	0.1724138
NODE_41594_length_499_cov_2.420000	198	247	0	49	49	1.0000000
NODE_41662_length_499_cov_1.445000	311	372	0	61	61	1.0000000
NODE_41770_length_498_cov_31.704261	12	92	0	80	80	1.0000000
NODE_41770_length_498_cov_31.704261	65	145	0	80	80	1.0000000
NODE_41775_length_498_cov_7.002506	256	336	3	30	80	0.3750000
NODE_41775_length_498_cov_7.002506	256	336	4	2	80	0.0250000
NODE_41775_length_498_cov_7.002506	256	336	5	48	80	0.6000000
NODE_41780_length_498_cov_5.759398	217	247	0	4	30	0.1333333
NODE_41780_length_498_cov_5.759398	217	247	2	26	30	0.8666667
NODE_41814_length_498_cov_3.075188	225	262	1	9	37	0.2432432
NODE_41814_length_498_cov_3.075188	225	262	3	14	37	0.3783784
NODE_41814_length_498_cov_3.075188	225	262	5	14	37	0.3783784
NODE_41814_length_498_cov_3.075188	246	324	3	3	78	0.0384615
NODE_41814_length_498_cov_3.075188	246	324	5	69	78	0.8846154
NODE_41814_length_498_cov_3.075188	246	324	6	6	78	0.0769231
NODE_42016_length_497_cov_44.105528	169	249	5	19	80	0.2375000
NODE_42016_length_497_cov_44.105528	169	249	6	32	80	0.4000000
NODE_42016_length_497_cov_44.105528	169	249	8	29	80	0.3625000
NODE_42016_length_497_cov_44.105528	222	302	3	27	80	0.3375000
NODE_42016_length_497_cov_44.105528	222	302	4	1	80	0.0125000
NODE_42016_length_497_cov_44.105528	222	302	6	36	80	0.4500000
NODE_42016_length_497_cov_44.105528	222	302	8	16	80	0.2000000
NODE_42017_length_497_cov_10.145729	85	165	0	33	80	0.4125000
NODE_42017_length_497_cov_10.145729	85	165	2	47	80	0.5875000
NODE_42017_length_497_cov_10.145729	138	226	2	88	88	1.0000000
NODE_42024_length_497_cov_6.618090	231	304	2	73	73	1.0000000
NODE_42024_length_497_cov_6.618090	284	364	0	47	80	0.5875000
NODE_42024_length_497_cov_6.618090	284	364	2	33	80	0.4125000
NODE_42065_length_497_cov_2.889447	109	189	0	11	80	0.1375000
NODE_42065_length_497_cov_2.889447	109	189	1	7	80	0.0875000
NODE_42065_length_497_cov_2.889447	109	189	3	62	80	0.7750000
NODE_42065_length_497_cov_2.889447	162	242	1	9	80	0.1125000
NODE_42065_length_497_cov_2.889447	162	242	3	71	80	0.8875000
NODE_42071_length_497_cov_2.623116	302	368	0	34	66	0.5151515
NODE_42071_length_497_cov_2.623116	302	368	1	32	66	0.4848485
NODE_42071_length_497_cov_2.623116	355	406	0	51	51	1.0000000
NODE_42100_length_497_cov_1.909548	106	186	4	1	80	0.0125000
NODE_42100_length_497_cov_1.909548	106	186	5	7	80	0.0875000
NODE_42100_length_497_cov_1.909548	106	186	6	1	80	0.0125000
NODE_42100_length_497_cov_1.909548	106	186	7	2	80	0.0250000
NODE_42100_length_497_cov_1.909548	106	186	8	8	80	0.1000000
NODE_42100_length_497_cov_1.909548	106	186	9	6	80	0.0750000
NODE_42100_length_497_cov_1.909548	106	186	10	1	80	0.0125000
NODE_42100_length_497_cov_1.909548	106	186	11	6	80	0.0750000
NODE_42100_length_497_cov_1.909548	106	186	12	6	80	0.0750000
NODE_42100_length_497_cov_1.909548	106	186	13	12	80	0.1500000
NODE_42100_length_497_cov_1.909548	106	186	14	1	80	0.0125000
NODE_42100_length_497_cov_1.909548	106	186	15	1	80	0.0125000
NODE_42100_length_497_cov_1.909548	106	186	16	4	80	0.0500000
NODE_42100_length_497_cov_1.909548	106	186	18	12	80	0.1500000
NODE_42100_length_497_cov_1.909548	106	186	20	12	80	0.1500000
NODE_42100_length_497_cov_1.909548	159	240	16	3	81	0.0370370
NODE_42100_length_497_cov_1.909548	159	240	18	18	81	0.2222222
NODE_42100_length_497_cov_1.909548	159	240	20	26	81	0.3209876
NODE_42100_length_497_cov_1.909548	159	240	21	1	81	0.0123457
NODE_42100_length_497_cov_1.909548	159	240	22	11	81	0.1358025
NODE_42100_length_497_cov_1.909548	159	240	23	22	81	0.2716049
NODE_42100_length_497_cov_1.909548	262	324	3	3	62	0.0483871
NODE_42100_length_497_cov_1.909548	262	324	5	3	62	0.0483871
NODE_42100_length_497_cov_1.909548	262	324	7	10	62	0.1612903
NODE_42100_length_497_cov_1.909548	262	324	8	1	62	0.0161290
NODE_42100_length_497_cov_1.909548	262	324	9	1	62	0.0161290
NODE_42100_length_497_cov_1.909548	262	324	10	11	62	0.1774193
NODE_42100_length_497_cov_1.909548	262	324	11	1	62	0.0161290
NODE_42100_length_497_cov_1.909548	262	324	12	2	62	0.0322581
NODE_42100_length_497_cov_1.909548	262	324	14	2	62	0.0322581
NODE_42100_length_497_cov_1.909548	262	324	15	8	62	0.1290323
NODE_42100_length_497_cov_1.909548	262	324	16	1	62	0.0161290
NODE_42100_length_497_cov_1.909548	262	324	17	6	62	0.0967742
NODE_42100_length_497_cov_1.909548	262	324	18	3	62	0.0483871
NODE_42100_length_497_cov_1.909548	262	324	19	4	62	0.0645161
NODE_42100_length_497_cov_1.909548	262	324	20	2	62	0.0322581
NODE_42100_length_497_cov_1.909548	262	324	21	4	62	0.0645161
NODE_42131_length_497_cov_1.500000	259	339	0	9	80	0.1125000
NODE_42131_length_497_cov_1.500000	259	339	2	71	80	0.8875000
NODE_42136_length_497_cov_1.404523	211	263	0	21	52	0.4038461
NODE_42136_length_497_cov_1.404523	211	263	1	12	52	0.2307692
NODE_42136_length_497_cov_1.404523	211	263	2	19	52	0.3653846
NODE_42279_length_496_cov_5.619647	239	269	0	30	30	1.0000000
NODE_42281_length_496_cov_5.392947	103	168	0	65	65	1.0000000
NODE_42281_length_496_cov_5.392947	141	221	0	80	80	1.0000000
NODE_42281_length_496_cov_5.392947	217	295	0	78	78	1.0000000
NODE_42281_length_496_cov_5.392947	270	295	0	25	25	1.0000000
NODE_42287_length_496_cov_4.397985	388	467	0	79	79	1.0000000
NODE_42288_length_496_cov_4.193955	235	315	0	80	80	1.0000000
NODE_42297_length_496_cov_3.531486	192	273	1	10	81	0.1234568
NODE_42297_length_496_cov_3.531486	192	273	2	71	81	0.8765432
NODE_42297_length_496_cov_3.531486	245	325	0	14	80	0.1750000
NODE_42297_length_496_cov_3.531486	245	325	1	48	80	0.6000000
NODE_42297_length_496_cov_3.531486	245	325	2	18	80	0.2250000
NODE_42298_length_496_cov_3.377834	252	332	1	16	80	0.2000000
NODE_42298_length_496_cov_3.377834	252	332	2	64	80	0.8000000
NODE_42298_length_496_cov_3.377834	305	383	0	30	78	0.3846154
NODE_42298_length_496_cov_3.377834	305	383	1	37	78	0.4743590
NODE_42298_length_496_cov_3.377834	305	383	2	11	78	0.1410256
NODE_42316_length_496_cov_2.659950	203	251	1	7	48	0.1458333
NODE_42316_length_496_cov_2.659950	203	251	2	41	48	0.8541667
NODE_42328_length_496_cov_2.445844	95	165	0	37	70	0.5285714
NODE_42328_length_496_cov_2.445844	95	165	1	33	70	0.4714286
NODE_42328_length_496_cov_2.445844	148	228	0	80	80	1.0000000
NODE_42333_length_496_cov_2.214106	299	359	0	46	60	0.7666667
NODE_42333_length_496_cov_2.214106	299	359	1	14	60	0.2333333
NODE_42415_length_496_cov_1.395466	273	317	0	44	44	1.0000000
NODE_42461_length_496_cov_0.979849	214	294	1	14	80	0.1750000
NODE_42461_length_496_cov_0.979849	214	294	2	66	80	0.8250000
NODE_42525_length_495_cov_34.888889	209	264	1	8	55	0.1454545
NODE_42525_length_495_cov_34.888889	209	264	2	30	55	0.5454546
NODE_42525_length_495_cov_34.888889	209	264	3	8	55	0.1454545
NODE_42525_length_495_cov_34.888889	209	264	4	9	55	0.1636364
NODE_42526_length_495_cov_12.800505	268	348	2	4	80	0.0500000
NODE_42526_length_495_cov_12.800505	268	348	3	20	80	0.2500000
NODE_42526_length_495_cov_12.800505	268	348	4	56	80	0.7000000
NODE_42526_length_495_cov_12.800505	321	401	2	57	80	0.7125000
NODE_42526_length_495_cov_12.800505	321	401	3	10	80	0.1250000
NODE_42526_length_495_cov_12.800505	321	401	4	13	80	0.1625000
NODE_42529_length_495_cov_7.080808	386	416	0	30	30	1.0000000
NODE_42548_length_495_cov_3.868687	218	298	0	80	80	1.0000000
NODE_42736_length_495_cov_0.792929	274	309	0	35	35	1.0000000
NODE_42773_length_494_cov_20.096203	182	262	1	21	80	0.2625000
NODE_42773_length_494_cov_20.096203	182	262	2	59	80	0.7375000
NODE_42773_length_494_cov_20.096203	235	315	2	27	80	0.3375000
NODE_42773_length_494_cov_20.096203	235	315	3	9	80	0.1125000
NODE_42773_length_494_cov_20.096203	235	315	4	44	80	0.5500000
NODE_42778_length_494_cov_7.498734	187	240	2	53	53	1.0000000
NODE_42788_length_494_cov_4.283544	255	332	1	44	77	0.5714286
NODE_42788_length_494_cov_4.283544	255	332	2	33	77	0.4285714
NODE_42804_length_494_cov_3.496203	209	276	2	67	67	1.0000000
NODE_42812_length_494_cov_3.032911	385	432	1	5	47	0.1063830
NODE_42812_length_494_cov_3.032911	385	432	3	8	47	0.1702128
NODE_42812_length_494_cov_3.032911	385	432	5	5	47	0.1063830
NODE_42812_length_494_cov_3.032911	385	432	7	29	47	0.6170213
NODE_42816_length_494_cov_2.908861	189	269	7	7	80	0.0875000
NODE_42816_length_494_cov_2.908861	189	269	8	2	80	0.0250000
NODE_42816_length_494_cov_2.908861	189	269	9	71	80	0.8875000
NODE_42822_length_494_cov_2.777215	145	188	0	43	43	1.0000000
NODE_42834_length_494_cov_2.531646	371	430	0	55	59	0.9322034
NODE_42834_length_494_cov_2.531646	371	430	2	4	59	0.0677966
NODE_42834_length_494_cov_2.531646	428	494	0	66	66	1.0000000
NODE_43021_length_493_cov_34.946701	140	220	3	16	80	0.2000000
NODE_43021_length_493_cov_34.946701	140	220	4	64	80	0.8000000
NODE_43021_length_493_cov_34.946701	193	265	0	6	72	0.0833333
NODE_43021_length_493_cov_34.946701	193	265	2	32	72	0.4444444
NODE_43021_length_493_cov_34.946701	193	265	3	23	72	0.3194444
NODE_43021_length_493_cov_34.946701	193	265	4	11	72	0.1527778
NODE_43022_length_493_cov_12.451777	173	253	0	80	80	1.0000000
NODE_43022_length_493_cov_12.451777	226	306	0	80	80	1.0000000
NODE_43025_length_493_cov_8.540609	116	146	1	11	30	0.3666667
NODE_43025_length_493_cov_8.540609	116	146	3	19	30	0.6333333
NODE_43025_length_493_cov_8.540609	119	199	1	8	80	0.1000000
NODE_43025_length_493_cov_8.540609	119	199	3	20	80	0.2500000
NODE_43025_length_493_cov_8.540609	119	199	4	14	80	0.1750000
NODE_43025_length_493_cov_8.540609	119	199	5	16	80	0.2000000
NODE_43025_length_493_cov_8.540609	119	199	7	13	80	0.1625000
NODE_43025_length_493_cov_8.540609	119	199	9	7	80	0.0875000
NODE_43025_length_493_cov_8.540609	119	199	11	2	80	0.0250000
NODE_43031_length_493_cov_6.144670	300	380	0	16	80	0.2000000
NODE_43031_length_493_cov_6.144670	300	380	1	64	80	0.8000000
NODE_43031_length_493_cov_6.144670	353	433	1	80	80	1.0000000
NODE_43046_length_493_cov_3.840102	178	258	0	80	80	1.0000000
NODE_43046_length_493_cov_3.840102	231	311	0	80	80	1.0000000
NODE_43125_length_493_cov_1.588832	126	206	0	80	80	1.0000000
NODE_43125_length_493_cov_1.588832	179	259	0	80	80	1.0000000
NODE_43261_length_492_cov_5.488550	117	197	0	53	80	0.6625000
NODE_43261_length_492_cov_5.488550	117	197	1	17	80	0.2125000
NODE_43261_length_492_cov_5.488550	117	197	2	2	80	0.0250000
NODE_43261_length_492_cov_5.488550	117	197	4	8	80	0.1000000
NODE_43261_length_492_cov_5.488550	170	250	1	17	80	0.2125000
NODE_43261_length_492_cov_5.488550	170	250	2	2	80	0.0250000
NODE_43261_length_492_cov_5.488550	170	250	4	61	80	0.7625000
NODE_43270_length_492_cov_4.445293	158	234	1	27	76	0.3552631
NODE_43270_length_492_cov_4.445293	158	234	2	49	76	0.6447368
NODE_43270_length_492_cov_4.445293	207	285	0	2	78	0.0256410
NODE_43270_length_492_cov_4.445293	207	285	1	76	78	0.9743590
NODE_43273_length_492_cov_4.244275	272	315	0	12	43	0.2790698
NODE_43273_length_492_cov_4.244275	272	315	1	17	43	0.3953488
NODE_43273_length_492_cov_4.244275	272	315	2	14	43	0.3255814
NODE_43293_length_492_cov_3.297710	113	193	1	52	80	0.6500000
NODE_43293_length_492_cov_3.297710	113	193	3	28	80	0.3500000
NODE_43528_length_491_cov_17.196429	138	218	0	59	80	0.7375000
NODE_43528_length_491_cov_17.196429	138	218	1	5	80	0.0625000
NODE_43528_length_491_cov_17.196429	138	218	2	16	80	0.2000000
NODE_43528_length_491_cov_17.196429	191	271	0	6	80	0.0750000
NODE_43528_length_491_cov_17.196429	191	271	1	5	80	0.0625000
NODE_43528_length_491_cov_17.196429	191	271	2	17	80	0.2125000
NODE_43528_length_491_cov_17.196429	191	271	3	52	80	0.6500000
NODE_43529_length_491_cov_17.193878	77	157	2	80	80	1.0000000
NODE_43529_length_491_cov_17.193878	130	210	2	80	80	1.0000000
NODE_43535_length_491_cov_5.505102	215	284	5	11	69	0.1594203
NODE_43535_length_491_cov_5.505102	215	284	6	11	69	0.1594203
NODE_43535_length_491_cov_5.505102	215	284	7	32	69	0.4637681
NODE_43535_length_491_cov_5.505102	215	284	8	15	69	0.2173913
NODE_43535_length_491_cov_5.505102	215	295	5	11	80	0.1375000
NODE_43535_length_491_cov_5.505102	215	295	6	11	80	0.1375000
NODE_43535_length_491_cov_5.505102	215	295	7	32	80	0.4000000
NODE_43535_length_491_cov_5.505102	215	295	8	26	80	0.3250000
NODE_43535_length_491_cov_5.505102	268	348	5	27	80	0.3375000
NODE_43535_length_491_cov_5.505102	268	348	6	4	80	0.0500000
NODE_43535_length_491_cov_5.505102	268	348	7	9	80	0.1125000
NODE_43535_length_491_cov_5.505102	268	348	8	40	80	0.5000000
NODE_43536_length_491_cov_5.477041	169	222	0	53	53	1.0000000
NODE_43546_length_491_cov_4.176020	383	449	0	13	66	0.1969697
NODE_43546_length_491_cov_4.176020	383	449	1	1	66	0.0151515
NODE_43546_length_491_cov_4.176020	383	449	2	52	66	0.7878788
NODE_43546_length_491_cov_4.176020	422	476	2	54	54	1.0000000
NODE_43570_length_491_cov_2.887755	348	428	2	67	80	0.8375000
NODE_43570_length_491_cov_2.887755	348	428	3	13	80	0.1625000
NODE_43570_length_491_cov_2.887755	401	472	2	71	71	1.0000000
NODE_43575_length_491_cov_2.693878	239	316	0	40	77	0.5194805
NODE_43575_length_491_cov_2.693878	239	316	1	37	77	0.4805195
NODE_43744_length_490_cov_10.058824	192	272	1	80	80	1.0000000
NODE_43744_length_490_cov_10.058824	245	325	0	21	80	0.2625000
NODE_43744_length_490_cov_10.058824	245	325	1	59	80	0.7375000
NODE_43748_length_490_cov_6.652174	304	363	0	10	59	0.1694915
NODE_43748_length_490_cov_6.652174	304	363	1	49	59	0.8305085
NODE_43816_length_490_cov_2.212276	241	300	0	59	59	1.0000000
NODE_43816_length_490_cov_2.212276	280	358	0	78	78	1.0000000
NODE_43886_length_490_cov_1.360614	97	159	2	28	62	0.4516129
NODE_43886_length_490_cov_1.360614	97	159	4	34	62	0.5483871
NODE_43886_length_490_cov_1.360614	132	212	4	80	80	1.0000000
NODE_43993_length_489_cov_55.992308	50	130	0	80	80	1.0000000
NODE_43993_length_489_cov_55.992308	103	183	0	80	80	1.0000000
NODE_43993_length_489_cov_55.992308	179	259	0	80	80	1.0000000
NODE_43993_length_489_cov_55.992308	232	312	0	80	80	1.0000000
NODE_43994_length_489_cov_31.707692	299	384	4	6	85	0.0705882
NODE_43994_length_489_cov_31.707692	299	384	5	40	85	0.4705882
NODE_43994_length_489_cov_31.707692	299	384	7	39	85	0.4588235
NODE_43994_length_489_cov_31.707692	299	384	4	6	85	0.0705882
NODE_43994_length_489_cov_31.707692	299	384	5	40	85	0.4705882
NODE_43994_length_489_cov_31.707692	299	384	7	39	85	0.4588235
NODE_43996_length_489_cov_13.661538	227	307	0	12	80	0.1500000
NODE_43996_length_489_cov_13.661538	227	307	2	68	80	0.8500000
NODE_43996_length_489_cov_13.661538	280	358	0	63	78	0.8076923
NODE_43996_length_489_cov_13.661538	280	358	2	15	78	0.1923077
NODE_43997_length_489_cov_12.017949	214	294	0	80	80	1.0000000
NODE_43997_length_489_cov_12.017949	267	347	0	80	80	1.0000000
NODE_43998_length_489_cov_10.774359	262	304	3	33	42	0.7857143
NODE_43998_length_489_cov_10.774359	262	304	4	7	42	0.1666667
NODE_43998_length_489_cov_10.774359	262	304	6	2	42	0.0476190
NODE_44001_length_489_cov_8.094872	141	221	5	5	80	0.0625000
NODE_44001_length_489_cov_8.094872	141	221	6	16	80	0.2000000
NODE_44001_length_489_cov_8.094872	141	221	7	5	80	0.0625000
NODE_44001_length_489_cov_8.094872	141	221	8	54	80	0.6750000
NODE_44001_length_489_cov_8.094872	194	247	4	9	53	0.1698113
NODE_44001_length_489_cov_8.094872	194	247	5	4	53	0.0754717
NODE_44001_length_489_cov_8.094872	194	247	7	9	53	0.1698113
NODE_44001_length_489_cov_8.094872	194	247	8	31	53	0.5849057
NODE_44007_length_489_cov_5.284615	176	256	3	11	80	0.1375000
NODE_44007_length_489_cov_5.284615	176	256	5	47	80	0.5875000
NODE_44007_length_489_cov_5.284615	176	256	6	9	80	0.1125000
NODE_44007_length_489_cov_5.284615	176	256	7	13	80	0.1625000
NODE_44007_length_489_cov_5.284615	229	309	5	11	80	0.1375000
NODE_44007_length_489_cov_5.284615	229	309	6	23	80	0.2875000
NODE_44007_length_489_cov_5.284615	229	309	7	46	80	0.5750000
NODE_44096_length_489_cov_1.646154	234	278	0	44	44	1.0000000
NODE_44105_length_489_cov_1.574359	351	391	1	21	40	0.5250000
NODE_44105_length_489_cov_1.574359	351	391	2	19	40	0.4750000
NODE_44105_length_489_cov_1.574359	351	383	1	13	32	0.4062500
NODE_44105_length_489_cov_1.574359	351	383	2	19	32	0.5937500
NODE_44105_length_489_cov_1.574359	365	445	0	14	80	0.1750000
NODE_44105_length_489_cov_1.574359	365	445	1	61	80	0.7625000
NODE_44105_length_489_cov_1.574359	365	445	2	5	80	0.0625000
NODE_44105_length_489_cov_1.574359	365	445	0	14	80	0.1750000
NODE_44105_length_489_cov_1.574359	365	445	1	61	80	0.7625000
NODE_44105_length_489_cov_1.574359	365	445	2	5	80	0.0625000
NODE_44105_length_489_cov_1.574359	366	445	0	14	79	0.1772152
NODE_44105_length_489_cov_1.574359	366	445	1	61	79	0.7721519
NODE_44105_length_489_cov_1.574359	366	445	2	4	79	0.0506329
NODE_44231_length_488_cov_15.406170	235	313	2	78	78	1.0000000
NODE_44231_length_488_cov_15.406170	286	367	0	47	81	0.5802469
NODE_44231_length_488_cov_15.406170	286	367	2	34	81	0.4197531
NODE_44234_length_488_cov_8.416452	210	290	0	80	80	1.0000000
NODE_44234_length_488_cov_8.416452	263	343	0	80	80	1.0000000
NODE_44240_length_488_cov_6.084833	254	302	0	36	48	0.7500000
NODE_44240_length_488_cov_6.084833	254	302	2	12	48	0.2500000
NODE_44243_length_488_cov_5.434447	210	279	2	69	69	1.0000000
NODE_44243_length_488_cov_5.434447	265	300	2	35	35	1.0000000
NODE_44263_length_488_cov_3.431877	212	248	0	36	36	1.0000000
NODE_44264_length_488_cov_3.424165	320	367	1	32	47	0.6808510
NODE_44264_length_488_cov_3.424165	320	367	3	15	47	0.3191489
NODE_44264_length_488_cov_3.424165	320	378	1	32	58	0.5517241
NODE_44264_length_488_cov_3.424165	320	378	3	26	58	0.4482759
NODE_44264_length_488_cov_3.424165	351	393	1	1	42	0.0238095
NODE_44264_length_488_cov_3.424165	351	393	3	41	42	0.9761904
NODE_44264_length_488_cov_3.424165	360	395	3	35	35	1.0000000
NODE_44274_length_488_cov_2.850900	276	356	0	27	80	0.3375000
NODE_44274_length_488_cov_2.850900	276	356	2	53	80	0.6625000
NODE_44376_length_488_cov_1.562982	31	67	0	36	36	1.0000000
NODE_44496_length_487_cov_7.028351	278	358	3	61	80	0.7625000
NODE_44496_length_487_cov_7.028351	278	358	4	5	80	0.0625000
NODE_44496_length_487_cov_7.028351	278	358	5	14	80	0.1750000
NODE_44498_length_487_cov_6.804124	242	313	5	21	71	0.2957746
NODE_44498_length_487_cov_6.804124	242	313	6	9	71	0.1267606
NODE_44498_length_487_cov_6.804124	242	313	8	41	71	0.5774648
NODE_44498_length_487_cov_6.804124	286	366	3	9	80	0.1125000
NODE_44498_length_487_cov_6.804124	286	366	4	3	80	0.0375000
NODE_44498_length_487_cov_6.804124	286	366	5	16	80	0.2000000
NODE_44498_length_487_cov_6.804124	286	366	6	3	80	0.0375000
NODE_44498_length_487_cov_6.804124	286	366	7	7	80	0.0875000
NODE_44498_length_487_cov_6.804124	286	366	8	42	80	0.5250000
NODE_44500_length_487_cov_5.917526	140	220	0	80	80	1.0000000
NODE_44500_length_487_cov_5.917526	193	273	0	80	80	1.0000000
NODE_44520_length_487_cov_3.296392	235	315	5	42	80	0.5250000
NODE_44520_length_487_cov_3.296392	235	315	6	6	80	0.0750000
NODE_44520_length_487_cov_3.296392	235	315	8	2	80	0.0250000
NODE_44520_length_487_cov_3.296392	235	315	10	4	80	0.0500000
NODE_44520_length_487_cov_3.296392	235	315	12	8	80	0.1000000
NODE_44520_length_487_cov_3.296392	235	315	13	9	80	0.1125000
NODE_44520_length_487_cov_3.296392	235	315	14	8	80	0.1000000
NODE_44520_length_487_cov_3.296392	235	315	15	1	80	0.0125000
NODE_44521_length_487_cov_3.237113	301	363	1	62	62	1.0000000
NODE_44525_length_487_cov_3.074742	214	294	1	45	80	0.5625000
NODE_44525_length_487_cov_3.074742	214	294	2	4	80	0.0500000
NODE_44525_length_487_cov_3.074742	214	294	3	1	80	0.0125000
NODE_44525_length_487_cov_3.074742	214	294	4	12	80	0.1500000
NODE_44525_length_487_cov_3.074742	214	294	6	6	80	0.0750000
NODE_44525_length_487_cov_3.074742	214	294	7	12	80	0.1500000
NODE_44723_length_486_cov_6.609819	206	286	4	11	80	0.1375000
NODE_44723_length_486_cov_6.609819	206	286	6	69	80	0.8625000
NODE_44728_length_486_cov_5.428941	147	227	6	36	80	0.4500000
NODE_44728_length_486_cov_5.428941	147	227	7	24	80	0.3000000
NODE_44728_length_486_cov_5.428941	147	227	8	20	80	0.2500000
NODE_44754_length_486_cov_3.072351	131	211	0	80	80	1.0000000
NODE_44754_length_486_cov_3.072351	190	235	0	45	45	1.0000000
NODE_44769_length_486_cov_2.581395	156	236	0	80	80	1.0000000
NODE_44769_length_486_cov_2.581395	209	289	0	80	80	1.0000000
NODE_44781_length_486_cov_2.343669	189	230	1	41	41	1.0000000
NODE_44781_length_486_cov_2.343669	242	306	1	64	64	1.0000000
NODE_44959_length_485_cov_29.505181	270	350	0	80	80	1.0000000
NODE_44959_length_485_cov_29.505181	323	403	0	80	80	1.0000000
NODE_44959_length_485_cov_29.505181	399	479	0	80	80	1.0000000
NODE_44960_length_485_cov_10.450777	67	153	0	86	86	1.0000000
NODE_44960_length_485_cov_10.450777	133	206	0	73	73	1.0000000
NODE_44965_length_485_cov_5.922280	196	273	4	39	77	0.5064935
NODE_44965_length_485_cov_5.922280	196	273	5	5	77	0.0649351
NODE_44965_length_485_cov_5.922280	196	273	6	33	77	0.4285714
NODE_44965_length_485_cov_5.922280	246	326	3	41	80	0.5125000
NODE_44965_length_485_cov_5.922280	246	326	4	20	80	0.2500000
NODE_44965_length_485_cov_5.922280	246	326	5	5	80	0.0625000
NODE_44965_length_485_cov_5.922280	246	326	6	14	80	0.1750000
NODE_44966_length_485_cov_5.818653	279	359	0	80	80	1.0000000
NODE_44966_length_485_cov_5.818653	332	412	0	80	80	1.0000000
NODE_44968_length_485_cov_5.670984	321	396	4	14	75	0.1866667
NODE_44968_length_485_cov_5.670984	321	396	6	6	75	0.0800000
NODE_44968_length_485_cov_5.670984	321	396	8	39	75	0.5200000
NODE_44968_length_485_cov_5.670984	321	396	9	16	75	0.2133333
NODE_44992_length_485_cov_3.518135	162	210	0	48	48	1.0000000
NODE_45005_length_485_cov_2.790155	193	253	1	60	60	1.0000000
NODE_45021_length_485_cov_2.427461	170	249	0	79	79	1.0000000
NODE_45100_length_485_cov_1.264249	232	251	0	19	19	1.0000000
NODE_45193_length_484_cov_33.384416	92	172	0	80	80	1.0000000
NODE_45193_length_484_cov_33.384416	145	225	0	80	80	1.0000000
NODE_45195_length_484_cov_9.111688	136	216	0	80	80	1.0000000
NODE_45195_length_484_cov_9.111688	189	270	0	81	81	1.0000000
NODE_45196_length_484_cov_8.353247	165	244	0	79	79	1.0000000
NODE_45196_length_484_cov_8.353247	217	297	0	80	80	1.0000000
NODE_45197_length_484_cov_8.119481	108	188	2	80	80	1.0000000
NODE_45197_length_484_cov_8.119481	161	241	1	35	80	0.4375000
NODE_45197_length_484_cov_8.119481	161	241	2	45	80	0.5625000
NODE_45200_length_484_cov_7.703896	208	288	0	80	80	1.0000000
NODE_45200_length_484_cov_7.703896	261	341	0	80	80	1.0000000
NODE_45202_length_484_cov_7.153247	230	292	1	12	62	0.1935484
NODE_45202_length_484_cov_7.153247	230	292	2	17	62	0.2741936
NODE_45202_length_484_cov_7.153247	230	292	3	33	62	0.5322581
NODE_45204_length_484_cov_6.594805	221	301	0	18	80	0.2250000
NODE_45204_length_484_cov_6.594805	221	301	2	43	80	0.5375000
NODE_45204_length_484_cov_6.594805	221	301	4	19	80	0.2375000
NODE_45204_length_484_cov_6.594805	274	354	2	20	80	0.2500000
NODE_45204_length_484_cov_6.594805	274	354	3	2	80	0.0250000
NODE_45204_length_484_cov_6.594805	274	354	4	58	80	0.7250000
NODE_45218_length_484_cov_4.044156	267	347	0	44	80	0.5500000
NODE_45218_length_484_cov_4.044156	267	347	1	19	80	0.2375000
NODE_45218_length_484_cov_4.044156	267	347	2	17	80	0.2125000
NODE_45218_length_484_cov_4.044156	342	396	2	54	54	1.0000000
NODE_45225_length_484_cov_3.787013	287	331	1	44	44	1.0000000
NODE_45225_length_484_cov_3.787013	307	386	1	41	79	0.5189874
NODE_45225_length_484_cov_3.787013	307	386	2	38	79	0.4810127
NODE_45225_length_484_cov_3.787013	317	386	1	31	69	0.4492754
NODE_45225_length_484_cov_3.787013	317	386	2	38	69	0.5507246
NODE_45276_length_484_cov_2.254545	79	132	3	2	53	0.0377358
NODE_45276_length_484_cov_2.254545	79	132	4	51	53	0.9622642
NODE_45352_length_484_cov_1.322078	429	477	0	48	48	1.0000000
NODE_45353_length_484_cov_1.314286	431	472	0	41	41	1.0000000
NODE_45459_length_483_cov_40.815104	396	473	0	4	77	0.0519481
NODE_45459_length_483_cov_40.815104	396	473	1	6	77	0.0779221
NODE_45459_length_483_cov_40.815104	396	473	2	19	77	0.2467532
NODE_45459_length_483_cov_40.815104	396	473	3	38	77	0.4935065
NODE_45459_length_483_cov_40.815104	396	473	5	10	77	0.1298701
NODE_45459_length_483_cov_40.815104	396	473	0	4	77	0.0519481
NODE_45459_length_483_cov_40.815104	396	473	1	6	77	0.0779221
NODE_45459_length_483_cov_40.815104	396	473	2	19	77	0.2467532
NODE_45459_length_483_cov_40.815104	396	473	3	38	77	0.4935065
NODE_45459_length_483_cov_40.815104	396	473	5	10	77	0.1298701
NODE_45473_length_483_cov_5.289062	124	185	0	61	61	1.0000000
NODE_45494_length_483_cov_4.114583	226	306	1	32	80	0.4000000
NODE_45494_length_483_cov_4.114583	226	306	2	48	80	0.6000000
NODE_45494_length_483_cov_4.114583	226	305	1	31	79	0.3924051
NODE_45494_length_483_cov_4.114583	226	305	2	48	79	0.6075949
NODE_45494_length_483_cov_4.114583	226	306	1	32	80	0.4000000
NODE_45494_length_483_cov_4.114583	226	306	2	48	80	0.6000000
NODE_45494_length_483_cov_4.114583	226	306	1	32	80	0.4000000
NODE_45494_length_483_cov_4.114583	226	306	2	48	80	0.6000000
NODE_45494_length_483_cov_4.114583	279	359	0	14	80	0.1750000
NODE_45494_length_483_cov_4.114583	279	359	1	66	80	0.8250000
NODE_45494_length_483_cov_4.114583	279	325	1	46	46	1.0000000
NODE_45494_length_483_cov_4.114583	297	323	1	26	26	1.0000000
NODE_45495_length_483_cov_4.046875	68	117	0	49	49	1.0000000
NODE_45495_length_483_cov_4.046875	184	250	0	23	66	0.3484848
NODE_45495_length_483_cov_4.046875	184	250	2	43	66	0.6515151
NODE_45635_length_483_cov_1.205729	249	291	2	42	42	1.0000000
NODE_45725_length_482_cov_37.900783	72	152	4	24	80	0.3000000
NODE_45725_length_482_cov_37.900783	72	152	5	40	80	0.5000000
NODE_45725_length_482_cov_37.900783	72	152	6	16	80	0.2000000
NODE_45725_length_482_cov_37.900783	125	205	3	17	80	0.2125000
NODE_45725_length_482_cov_37.900783	125	205	4	4	80	0.0500000
NODE_45725_length_482_cov_37.900783	125	205	5	13	80	0.1625000
NODE_45725_length_482_cov_37.900783	125	205	6	20	80	0.2500000
NODE_45725_length_482_cov_37.900783	125	205	7	26	80	0.3250000
NODE_45728_length_482_cov_10.545692	233	297	0	64	64	1.0000000
NODE_45729_length_482_cov_9.342037	281	333	0	52	52	1.0000000
NODE_45730_length_482_cov_8.190601	247	311	0	8	64	0.1250000
NODE_45730_length_482_cov_8.190601	247	311	1	56	64	0.8750000
NODE_45730_length_482_cov_8.190601	284	355	0	52	71	0.7323943
NODE_45730_length_482_cov_8.190601	284	355	1	19	71	0.2676056
NODE_45734_length_482_cov_6.002611	112	192	0	80	80	1.0000000
NODE_45734_length_482_cov_6.002611	165	245	0	80	80	1.0000000
NODE_45735_length_482_cov_5.953003	315	395	0	80	80	1.0000000
NODE_45735_length_482_cov_5.953003	368	441	0	73	73	1.0000000
NODE_45748_length_482_cov_4.530026	20	85	0	56	65	0.8615385
NODE_45748_length_482_cov_4.530026	20	85	2	9	65	0.1384615
NODE_45759_length_482_cov_3.791123	278	358	0	80	80	1.0000000
NODE_45759_length_482_cov_3.791123	331	411	0	80	80	1.0000000
NODE_45842_length_482_cov_1.647520	382	446	0	64	64	1.0000000
NODE_45842_length_482_cov_1.647520	435	482	0	47	47	1.0000000
NODE_45994_length_481_cov_50.623037	154	234	5	53	80	0.6625000
NODE_45994_length_481_cov_50.623037	154	234	6	27	80	0.3375000
NODE_45994_length_481_cov_50.623037	207	287	2	14	80	0.1750000
NODE_45994_length_481_cov_50.623037	207	287	3	29	80	0.3625000
NODE_45994_length_481_cov_50.623037	207	287	5	25	80	0.3125000
NODE_45994_length_481_cov_50.623037	207	287	6	12	80	0.1500000
NODE_45995_length_481_cov_30.939791	149	198	0	49	49	1.0000000
NODE_45995_length_481_cov_30.939791	171	235	0	64	64	1.0000000
NODE_45995_length_481_cov_30.939791	171	235	0	64	64	1.0000000
NODE_45996_length_481_cov_30.183246	0	41	1	2	41	0.0487805
NODE_45996_length_481_cov_30.183246	0	41	2	3	41	0.0731707
NODE_45996_length_481_cov_30.183246	0	41	5	2	41	0.0487805
NODE_45996_length_481_cov_30.183246	0	41	6	4	41	0.0975610
NODE_45996_length_481_cov_30.183246	0	41	7	5	41	0.1219512
NODE_45996_length_481_cov_30.183246	0	41	8	5	41	0.1219512
NODE_45996_length_481_cov_30.183246	0	41	9	1	41	0.0243902
NODE_45996_length_481_cov_30.183246	0	41	10	6	41	0.1463415
NODE_45996_length_481_cov_30.183246	0	41	11	6	41	0.1463415
NODE_45996_length_481_cov_30.183246	0	41	12	7	41	0.1707317
NODE_45996_length_481_cov_30.183246	0	39	1	2	39	0.0512821
NODE_45996_length_481_cov_30.183246	0	39	2	3	39	0.0769231
NODE_45996_length_481_cov_30.183246	0	39	5	2	39	0.0512821
NODE_45996_length_481_cov_30.183246	0	39	6	4	39	0.1025641
NODE_45996_length_481_cov_30.183246	0	39	7	5	39	0.1282051
NODE_45996_length_481_cov_30.183246	0	39	8	5	39	0.1282051
NODE_45996_length_481_cov_30.183246	0	39	9	1	39	0.0256410
NODE_45996_length_481_cov_30.183246	0	39	10	6	39	0.1538462
NODE_45996_length_481_cov_30.183246	0	39	11	6	39	0.1538462
NODE_45996_length_481_cov_30.183246	0	39	12	5	39	0.1282051
NODE_45996_length_481_cov_30.183246	0	44	1	2	44	0.0454545
NODE_45996_length_481_cov_30.183246	0	44	2	3	44	0.0681818
NODE_45996_length_481_cov_30.183246	0	44	5	2	44	0.0454545
NODE_45996_length_481_cov_30.183246	0	44	6	4	44	0.0909091
NODE_45996_length_481_cov_30.183246	0	44	7	5	44	0.1136364
NODE_45996_length_481_cov_30.183246	0	44	8	5	44	0.1136364
NODE_45996_length_481_cov_30.183246	0	44	9	1	44	0.0227273
NODE_45996_length_481_cov_30.183246	0	44	10	6	44	0.1363636
NODE_45996_length_481_cov_30.183246	0	44	11	6	44	0.1363636
NODE_45996_length_481_cov_30.183246	0	44	12	10	44	0.2272727
NODE_45996_length_481_cov_30.183246	0	44	1	2	44	0.0454545
NODE_45996_length_481_cov_30.183246	0	44	2	3	44	0.0681818
NODE_45996_length_481_cov_30.183246	0	44	5	2	44	0.0454545
NODE_45996_length_481_cov_30.183246	0	44	6	4	44	0.0909091
NODE_45996_length_481_cov_30.183246	0	44	7	5	44	0.1136364
NODE_45996_length_481_cov_30.183246	0	44	8	5	44	0.1136364
NODE_45996_length_481_cov_30.183246	0	44	9	1	44	0.0227273
NODE_45996_length_481_cov_30.183246	0	44	10	6	44	0.1363636
NODE_45996_length_481_cov_30.183246	0	44	11	6	44	0.1363636
NODE_45996_length_481_cov_30.183246	0	44	12	10	44	0.2272727
NODE_45996_length_481_cov_30.183246	0	44	1	2	44	0.0454545
NODE_45996_length_481_cov_30.183246	0	44	2	3	44	0.0681818
NODE_45996_length_481_cov_30.183246	0	44	5	2	44	0.0454545
NODE_45996_length_481_cov_30.183246	0	44	6	4	44	0.0909091
NODE_45996_length_481_cov_30.183246	0	44	7	5	44	0.1136364
NODE_45996_length_481_cov_30.183246	0	44	8	5	44	0.1136364
NODE_45996_length_481_cov_30.183246	0	44	9	1	44	0.0227273
NODE_45996_length_481_cov_30.183246	0	44	10	6	44	0.1363636
NODE_45996_length_481_cov_30.183246	0	44	11	6	44	0.1363636
NODE_45996_length_481_cov_30.183246	0	44	12	10	44	0.2272727
NODE_45996_length_481_cov_30.183246	0	44	1	2	44	0.0454545
NODE_45996_length_481_cov_30.183246	0	44	2	3	44	0.0681818
NODE_45996_length_481_cov_30.183246	0	44	5	2	44	0.0454545
NODE_45996_length_481_cov_30.183246	0	44	6	4	44	0.0909091
NODE_45996_length_481_cov_30.183246	0	44	7	5	44	0.1136364
NODE_45996_length_481_cov_30.183246	0	44	8	5	44	0.1136364
NODE_45996_length_481_cov_30.183246	0	44	9	1	44	0.0227273
NODE_45996_length_481_cov_30.183246	0	44	10	6	44	0.1363636
NODE_45996_length_481_cov_30.183246	0	44	11	6	44	0.1363636
NODE_45996_length_481_cov_30.183246	0	44	12	10	44	0.2272727
NODE_45996_length_481_cov_30.183246	17	97	8	4	80	0.0500000
NODE_45996_length_481_cov_30.183246	17	97	9	1	80	0.0125000
NODE_45996_length_481_cov_30.183246	17	97	10	6	80	0.0750000
NODE_45996_length_481_cov_30.183246	17	97	11	6	80	0.0750000
NODE_45996_length_481_cov_30.183246	17	97	12	16	80	0.2000000
NODE_45996_length_481_cov_30.183246	17	97	13	47	80	0.5875000
NODE_45996_length_481_cov_30.183246	17	97	8	4	80	0.0500000
NODE_45996_length_481_cov_30.183246	17	97	9	1	80	0.0125000
NODE_45996_length_481_cov_30.183246	17	97	10	6	80	0.0750000
NODE_45996_length_481_cov_30.183246	17	97	11	6	80	0.0750000
NODE_45996_length_481_cov_30.183246	17	97	12	16	80	0.2000000
NODE_45996_length_481_cov_30.183246	17	97	13	47	80	0.5875000
NODE_45996_length_481_cov_30.183246	17	97	8	4	80	0.0500000
NODE_45996_length_481_cov_30.183246	17	97	9	1	80	0.0125000
NODE_45996_length_481_cov_30.183246	17	97	10	6	80	0.0750000
NODE_45996_length_481_cov_30.183246	17	97	11	6	80	0.0750000
NODE_45996_length_481_cov_30.183246	17	97	12	16	80	0.2000000
NODE_45996_length_481_cov_30.183246	17	97	13	47	80	0.5875000
NODE_45996_length_481_cov_30.183246	17	97	8	4	80	0.0500000
NODE_45996_length_481_cov_30.183246	17	97	9	1	80	0.0125000
NODE_45996_length_481_cov_30.183246	17	97	10	6	80	0.0750000
NODE_45996_length_481_cov_30.183246	17	97	11	6	80	0.0750000
NODE_45996_length_481_cov_30.183246	17	97	12	16	80	0.2000000
NODE_45996_length_481_cov_30.183246	17	97	13	47	80	0.5875000
NODE_45996_length_481_cov_30.183246	17	97	8	4	80	0.0500000
NODE_45996_length_481_cov_30.183246	17	97	9	1	80	0.0125000
NODE_45996_length_481_cov_30.183246	17	97	10	6	80	0.0750000
NODE_45996_length_481_cov_30.183246	17	97	11	6	80	0.0750000
NODE_45996_length_481_cov_30.183246	17	97	12	16	80	0.2000000
NODE_45996_length_481_cov_30.183246	17	97	13	47	80	0.5875000
NODE_45996_length_481_cov_30.183246	17	97	8	4	80	0.0500000
NODE_45996_length_481_cov_30.183246	17	97	9	1	80	0.0125000
NODE_45996_length_481_cov_30.183246	17	97	10	6	80	0.0750000
NODE_45996_length_481_cov_30.183246	17	97	11	6	80	0.0750000
NODE_45996_length_481_cov_30.183246	17	97	12	16	80	0.2000000
NODE_45996_length_481_cov_30.183246	17	97	13	47	80	0.5875000
NODE_45997_length_481_cov_12.709424	250	330	4	5	80	0.0625000
NODE_45997_length_481_cov_12.709424	250	330	6	3	80	0.0375000
NODE_45997_length_481_cov_12.709424	250	330	7	14	80	0.1750000
NODE_45997_length_481_cov_12.709424	250	330	8	9	80	0.1125000
NODE_45997_length_481_cov_12.709424	250	330	9	22	80	0.2750000
NODE_45997_length_481_cov_12.709424	250	330	10	14	80	0.1750000
NODE_45997_length_481_cov_12.709424	250	330	12	13	80	0.1625000
NODE_45997_length_481_cov_12.709424	303	383	6	18	80	0.2250000
NODE_45997_length_481_cov_12.709424	303	383	7	5	80	0.0625000
NODE_45997_length_481_cov_12.709424	303	383	9	6	80	0.0750000
NODE_45997_length_481_cov_12.709424	303	383	10	35	80	0.4375000
NODE_45997_length_481_cov_12.709424	303	383	12	16	80	0.2000000
NODE_46037_length_481_cov_3.002618	197	277	0	80	80	1.0000000
NODE_46064_length_481_cov_2.261780	271	351	0	49	80	0.6125000
NODE_46064_length_481_cov_2.261780	271	351	2	31	80	0.3875000
NODE_46256_length_480_cov_22.346457	318	398	0	80	80	1.0000000
NODE_46256_length_480_cov_22.346457	371	451	0	80	80	1.0000000
NODE_46257_length_480_cov_16.488189	252	332	4	80	80	1.0000000
NODE_46257_length_480_cov_16.488189	305	385	0	35	80	0.4375000
NODE_46257_length_480_cov_16.488189	305	385	1	13	80	0.1625000
NODE_46257_length_480_cov_16.488189	305	385	4	32	80	0.4000000
NODE_46258_length_480_cov_12.874016	164	234	0	70	70	1.0000000
NODE_46258_length_480_cov_12.874016	207	273	0	66	66	1.0000000
NODE_46260_length_480_cov_11.879265	170	250	0	6	80	0.0750000
NODE_46260_length_480_cov_11.879265	170	250	2	74	80	0.9250000
NODE_46260_length_480_cov_11.879265	223	303	2	57	80	0.7125000
NODE_46260_length_480_cov_11.879265	223	303	4	23	80	0.2875000
NODE_46261_length_480_cov_8.774278	114	143	2	29	29	1.0000000
NODE_46261_length_480_cov_8.774278	165	245	1	15	80	0.1875000
NODE_46261_length_480_cov_8.774278	165	245	2	50	80	0.6250000
NODE_46261_length_480_cov_8.774278	165	245	3	15	80	0.1875000
NODE_46261_length_480_cov_8.774278	218	298	2	18	80	0.2250000
NODE_46261_length_480_cov_8.774278	218	298	3	21	80	0.2625000
NODE_46261_length_480_cov_8.774278	218	298	4	41	80	0.5125000
NODE_46261_length_480_cov_8.774278	385	428	2	21	43	0.4883721
NODE_46261_length_480_cov_8.774278	385	428	3	21	43	0.4883721
NODE_46261_length_480_cov_8.774278	385	428	4	1	43	0.0232558
NODE_46271_length_480_cov_5.671916	231	302	4	49	71	0.6901408
NODE_46271_length_480_cov_5.671916	231	302	5	22	71	0.3098592
NODE_46283_length_480_cov_4.354331	126	187	0	61	61	1.0000000
NODE_46283_length_480_cov_4.354331	218	298	2	26	80	0.3250000
NODE_46283_length_480_cov_4.354331	218	298	3	2	80	0.0250000
NODE_46283_length_480_cov_4.354331	218	298	5	6	80	0.0750000
NODE_46283_length_480_cov_4.354331	218	298	7	4	80	0.0500000
NODE_46283_length_480_cov_4.354331	218	298	9	8	80	0.1000000
NODE_46283_length_480_cov_4.354331	218	298	11	17	80	0.2125000
NODE_46283_length_480_cov_4.354331	218	298	12	11	80	0.1375000
NODE_46283_length_480_cov_4.354331	218	298	13	6	80	0.0750000
NODE_46445_length_480_cov_1.152231	142	216	0	74	74	1.0000000
NODE_46470_length_480_cov_0.973753	31	71	0	40	40	1.0000000
NODE_46533_length_479_cov_28.205263	308	388	6	9	80	0.1125000
NODE_46533_length_479_cov_28.205263	308	388	7	41	80	0.5125000
NODE_46533_length_479_cov_28.205263	308	388	8	30	80	0.3750000
NODE_46533_length_479_cov_28.205263	361	441	6	40	80	0.5000000
NODE_46533_length_479_cov_28.205263	361	441	7	40	80	0.5000000
NODE_46534_length_479_cov_23.944737	189	269	3	1	80	0.0125000
NODE_46534_length_479_cov_23.944737	189	269	5	21	80	0.2625000
NODE_46534_length_479_cov_23.944737	189	269	6	23	80	0.2875000
NODE_46534_length_479_cov_23.944737	189	269	7	35	80	0.4375000
NODE_46534_length_479_cov_23.944737	242	322	3	5	80	0.0625000
NODE_46534_length_479_cov_23.944737	242	322	4	37	80	0.4625000
NODE_46534_length_479_cov_23.944737	242	322	5	2	80	0.0250000
NODE_46534_length_479_cov_23.944737	242	322	6	34	80	0.4250000
NODE_46534_length_479_cov_23.944737	242	322	7	2	80	0.0250000
NODE_46554_length_479_cov_4.942105	283	363	0	80	80	1.0000000
NODE_46554_length_479_cov_4.942105	336	416	0	80	80	1.0000000
NODE_46574_length_479_cov_3.494737	217	279	1	42	62	0.6774194
NODE_46574_length_479_cov_3.494737	217	279	2	20	62	0.3225806
NODE_46574_length_479_cov_3.494737	272	332	0	45	60	0.7500000
NODE_46574_length_479_cov_3.494737	272	332	1	15	60	0.2500000
NODE_46611_length_479_cov_2.281579	219	265	1	4	46	0.0869565
NODE_46611_length_479_cov_2.281579	219	265	2	42	46	0.9130435
NODE_46638_length_479_cov_1.839474	376	431	2	18	55	0.3272727
NODE_46638_length_479_cov_1.839474	376	431	3	14	55	0.2545455
NODE_46638_length_479_cov_1.839474	376	431	4	1	55	0.0181818
NODE_46638_length_479_cov_1.839474	376	431	5	22	55	0.4000000
NODE_46654_length_479_cov_1.710526	203	265	0	62	62	1.0000000
NODE_46654_length_479_cov_1.710526	248	318	0	70	70	1.0000000
NODE_46828_length_478_cov_336.139842	153	233	195	1	80	0.0125000
NODE_46828_length_478_cov_336.139842	153	233	196	1	80	0.0125000
NODE_46828_length_478_cov_336.139842	153	233	199	2	80	0.0250000
NODE_46828_length_478_cov_336.139842	153	233	201	1	80	0.0125000
NODE_46828_length_478_cov_336.139842	153	233	202	2	80	0.0250000
NODE_46828_length_478_cov_336.139842	153	233	203	2	80	0.0250000
NODE_46828_length_478_cov_336.139842	153	233	206	1	80	0.0125000
NODE_46828_length_478_cov_336.139842	153	233	207	2	80	0.0250000
NODE_46828_length_478_cov_336.139842	153	233	208	1	80	0.0125000
NODE_46828_length_478_cov_336.139842	153	233	209	2	80	0.0250000
NODE_46828_length_478_cov_336.139842	153	233	210	1	80	0.0125000
NODE_46828_length_478_cov_336.139842	153	233	211	5	80	0.0625000
NODE_46828_length_478_cov_336.139842	153	233	212	1	80	0.0125000
NODE_46828_length_478_cov_336.139842	153	233	213	3	80	0.0375000
NODE_46828_length_478_cov_336.139842	153	233	214	1	80	0.0125000
NODE_46828_length_478_cov_336.139842	153	233	215	4	80	0.0500000
NODE_46828_length_478_cov_336.139842	153	233	217	3	80	0.0375000
NODE_46828_length_478_cov_336.139842	153	233	218	1	80	0.0125000
NODE_46828_length_478_cov_336.139842	153	233	219	1	80	0.0125000
NODE_46828_length_478_cov_336.139842	153	233	220	1	80	0.0125000
NODE_46828_length_478_cov_336.139842	153	233	225	1	80	0.0125000
NODE_46828_length_478_cov_336.139842	153	233	226	3	80	0.0375000
NODE_46828_length_478_cov_336.139842	153	233	227	2	80	0.0250000
NODE_46828_length_478_cov_336.139842	153	233	228	1	80	0.0125000
NODE_46828_length_478_cov_336.139842	153	233	230	4	80	0.0500000
NODE_46828_length_478_cov_336.139842	153	233	231	2	80	0.0250000
NODE_46828_length_478_cov_336.139842	153	233	232	2	80	0.0250000
NODE_46828_length_478_cov_336.139842	153	233	233	1	80	0.0125000
NODE_46828_length_478_cov_336.139842	153	233	234	3	80	0.0375000
NODE_46828_length_478_cov_336.139842	153	233	235	2	80	0.0250000
NODE_46828_length_478_cov_336.139842	153	233	236	3	80	0.0375000
NODE_46828_length_478_cov_336.139842	153	233	237	4	80	0.0500000
NODE_46828_length_478_cov_336.139842	153	233	238	1	80	0.0125000
NODE_46828_length_478_cov_336.139842	153	233	239	4	80	0.0500000
NODE_46828_length_478_cov_336.139842	153	233	240	1	80	0.0125000
NODE_46828_length_478_cov_336.139842	153	233	241	4	80	0.0500000
NODE_46828_length_478_cov_336.139842	153	233	242	1	80	0.0125000
NODE_46828_length_478_cov_336.139842	153	233	243	3	80	0.0375000
NODE_46828_length_478_cov_336.139842	153	233	244	1	80	0.0125000
NODE_46828_length_478_cov_336.139842	153	233	245	1	80	0.0125000
NODE_46828_length_478_cov_336.139842	206	286	194	2	80	0.0250000
NODE_46828_length_478_cov_336.139842	206	286	195	2	80	0.0250000
NODE_46828_length_478_cov_336.139842	206	286	196	1	80	0.0125000
NODE_46828_length_478_cov_336.139842	206	286	197	1	80	0.0125000
NODE_46828_length_478_cov_336.139842	206	286	198	3	80	0.0375000
NODE_46828_length_478_cov_336.139842	206	286	200	2	80	0.0250000
NODE_46828_length_478_cov_336.139842	206	286	202	1	80	0.0125000
NODE_46828_length_478_cov_336.139842	206	286	203	2	80	0.0250000
NODE_46828_length_478_cov_336.139842	206	286	206	1	80	0.0125000
NODE_46828_length_478_cov_336.139842	206	286	207	1	80	0.0125000
NODE_46828_length_478_cov_336.139842	206	286	208	1	80	0.0125000
NODE_46828_length_478_cov_336.139842	206	286	209	3	80	0.0375000
NODE_46828_length_478_cov_336.139842	206	286	212	2	80	0.0250000
NODE_46828_length_478_cov_336.139842	206	286	215	1	80	0.0125000
NODE_46828_length_478_cov_336.139842	206	286	216	2	80	0.0250000
NODE_46828_length_478_cov_336.139842	206	286	217	6	80	0.0750000
NODE_46828_length_478_cov_336.139842	206	286	218	4	80	0.0500000
NODE_46828_length_478_cov_336.139842	206	286	220	3	80	0.0375000
NODE_46828_length_478_cov_336.139842	206	286	222	1	80	0.0125000
NODE_46828_length_478_cov_336.139842	206	286	223	4	80	0.0500000
NODE_46828_length_478_cov_336.139842	206	286	224	1	80	0.0125000
NODE_46828_length_478_cov_336.139842	206	286	226	3	80	0.0375000
NODE_46828_length_478_cov_336.139842	206	286	227	2	80	0.0250000
NODE_46828_length_478_cov_336.139842	206	286	228	1	80	0.0125000
NODE_46828_length_478_cov_336.139842	206	286	229	1	80	0.0125000
NODE_46828_length_478_cov_336.139842	206	286	230	4	80	0.0500000
NODE_46828_length_478_cov_336.139842	206	286	231	3	80	0.0375000
NODE_46828_length_478_cov_336.139842	206	286	232	3	80	0.0375000
NODE_46828_length_478_cov_336.139842	206	286	233	1	80	0.0125000
NODE_46828_length_478_cov_336.139842	206	286	234	4	80	0.0500000
NODE_46828_length_478_cov_336.139842	206	286	235	2	80	0.0250000
NODE_46828_length_478_cov_336.139842	206	286	237	2	80	0.0250000
NODE_46828_length_478_cov_336.139842	206	286	238	1	80	0.0125000
NODE_46828_length_478_cov_336.139842	206	286	239	2	80	0.0250000
NODE_46828_length_478_cov_336.139842	206	286	241	3	80	0.0375000
NODE_46828_length_478_cov_336.139842	206	286	242	1	80	0.0125000
NODE_46828_length_478_cov_336.139842	206	286	243	2	80	0.0250000
NODE_46828_length_478_cov_336.139842	206	286	244	1	80	0.0125000
NODE_46846_length_478_cov_4.448549	150	230	1	80	80	1.0000000
NODE_46846_length_478_cov_4.448549	203	284	1	70	81	0.8641976
NODE_46846_length_478_cov_4.448549	203	284	2	11	81	0.1358025
NODE_46874_length_478_cov_2.627968	228	278	0	30	50	0.6000000
NODE_46874_length_478_cov_2.627968	228	278	2	20	50	0.4000000
NODE_47128_length_477_cov_36.230159	225	305	2	80	80	1.0000000
NODE_47128_length_477_cov_36.230159	278	358	0	9	80	0.1125000
NODE_47128_length_477_cov_36.230159	278	358	1	2	80	0.0250000
NODE_47128_length_477_cov_36.230159	278	358	2	69	80	0.8625000
NODE_47129_length_477_cov_33.111111	307	387	3	9	80	0.1125000
NODE_47129_length_477_cov_33.111111	307	387	4	24	80	0.3000000
NODE_47129_length_477_cov_33.111111	307	387	5	47	80	0.5875000
NODE_47129_length_477_cov_33.111111	360	440	1	6	80	0.0750000
NODE_47129_length_477_cov_33.111111	360	440	3	46	80	0.5750000
NODE_47129_length_477_cov_33.111111	360	440	4	11	80	0.1375000
NODE_47129_length_477_cov_33.111111	360	440	5	17	80	0.2125000
NODE_47133_length_477_cov_11.235450	119	199	0	80	80	1.0000000
NODE_47133_length_477_cov_11.235450	172	247	0	75	75	1.0000000
NODE_47135_length_477_cov_9.359788	221	301	0	3	80	0.0375000
NODE_47135_length_477_cov_9.359788	221	301	2	23	80	0.2875000
NODE_47135_length_477_cov_9.359788	221	301	4	54	80	0.6750000
NODE_47135_length_477_cov_9.359788	274	354	0	56	80	0.7000000
NODE_47135_length_477_cov_9.359788	274	354	2	23	80	0.2875000
NODE_47135_length_477_cov_9.359788	274	354	4	1	80	0.0125000
NODE_47139_length_477_cov_7.436508	230	304	0	18	74	0.2432432
NODE_47139_length_477_cov_7.436508	230	304	1	15	74	0.2027027
NODE_47139_length_477_cov_7.436508	230	304	2	22	74	0.2972973
NODE_47139_length_477_cov_7.436508	230	304	3	19	74	0.2567568
NODE_47140_length_477_cov_7.433862	43	123	0	80	80	1.0000000
NODE_47140_length_477_cov_7.433862	96	176	0	39	80	0.4875000
NODE_47140_length_477_cov_7.433862	96	176	2	41	80	0.5125000
NODE_47143_length_477_cov_6.846561	163	243	0	80	80	1.0000000
NODE_47143_length_477_cov_6.846561	216	296	0	80	80	1.0000000
NODE_47147_length_477_cov_5.677249	150	228	0	78	78	1.0000000
NODE_47148_length_477_cov_5.084656	227	288	4	41	61	0.6721311
NODE_47148_length_477_cov_5.084656	227	288	6	20	61	0.3278688
NODE_47253_length_477_cov_1.629630	115	171	0	56	56	1.0000000
NODE_47253_length_477_cov_1.629630	167	224	0	57	57	1.0000000
NODE_47375_length_477_cov_0.859788	445	477	0	32	32	1.0000000
NODE_47427_length_476_cov_7.533156	221	301	0	80	80	1.0000000
NODE_47427_length_476_cov_7.533156	274	354	0	46	80	0.5750000
NODE_47427_length_476_cov_7.533156	274	354	2	34	80	0.4250000
NODE_47529_length_476_cov_1.618037	385	444	1	7	59	0.1186441
NODE_47529_length_476_cov_1.618037	385	444	2	52	59	0.8813559
NODE_47601_length_476_cov_1.129973	15	34	0	10	19	0.5263158
NODE_47601_length_476_cov_1.129973	15	34	1	1	19	0.0526316
NODE_47601_length_476_cov_1.129973	15	34	5	5	19	0.2631579
NODE_47601_length_476_cov_1.129973	15	34	6	3	19	0.1578947
NODE_47620_length_476_cov_1.037135	180	243	0	57	63	0.9047619
NODE_47620_length_476_cov_1.037135	180	243	1	6	63	0.0952381
NODE_47620_length_476_cov_1.037135	237	296	0	59	59	1.0000000
NODE_47693_length_475_cov_34.460106	270	350	2	24	80	0.3000000
NODE_47693_length_475_cov_34.460106	270	350	3	38	80	0.4750000
NODE_47693_length_475_cov_34.460106	270	350	4	3	80	0.0375000
NODE_47693_length_475_cov_34.460106	270	350	5	15	80	0.1875000
NODE_47693_length_475_cov_34.460106	323	403	2	77	80	0.9625000
NODE_47693_length_475_cov_34.460106	323	403	3	3	80	0.0375000
NODE_47694_length_475_cov_30.087766	273	353	0	28	80	0.3500000
NODE_47694_length_475_cov_30.087766	273	353	1	52	80	0.6500000
NODE_47694_length_475_cov_30.087766	326	406	1	80	80	1.0000000
NODE_47695_length_475_cov_10.247340	42	122	0	80	80	1.0000000
NODE_47701_length_475_cov_8.393617	9	89	0	80	80	1.0000000
NODE_47701_length_475_cov_8.393617	62	142	0	80	80	1.0000000
NODE_47828_length_475_cov_1.531915	272	352	1	7	80	0.0875000
NODE_47828_length_475_cov_1.531915	272	352	2	46	80	0.5750000
NODE_47828_length_475_cov_1.531915	272	352	3	27	80	0.3375000
NODE_47839_length_475_cov_1.457447	50	93	0	6	43	0.1395349
NODE_47839_length_475_cov_1.457447	50	93	2	37	43	0.8604651
NODE_47979_length_474_cov_49.453333	392	472	34	2	80	0.0250000
NODE_47979_length_474_cov_49.453333	392	472	36	1	80	0.0125000
NODE_47979_length_474_cov_49.453333	392	472	39	2	80	0.0250000
NODE_47979_length_474_cov_49.453333	392	472	44	1	80	0.0125000
NODE_47979_length_474_cov_49.453333	392	472	49	1	80	0.0125000
NODE_47979_length_474_cov_49.453333	392	472	52	2	80	0.0250000
NODE_47979_length_474_cov_49.453333	392	472	53	1	80	0.0125000
NODE_47979_length_474_cov_49.453333	392	472	55	3	80	0.0375000
NODE_47979_length_474_cov_49.453333	392	472	57	2	80	0.0250000
NODE_47979_length_474_cov_49.453333	392	472	61	1	80	0.0125000
NODE_47979_length_474_cov_49.453333	392	472	62	1	80	0.0125000
NODE_47979_length_474_cov_49.453333	392	472	63	1	80	0.0125000
NODE_47979_length_474_cov_49.453333	392	472	68	1	80	0.0125000
NODE_47979_length_474_cov_49.453333	392	472	69	2	80	0.0250000
NODE_47979_length_474_cov_49.453333	392	472	70	1	80	0.0125000
NODE_47979_length_474_cov_49.453333	392	472	72	1	80	0.0125000
NODE_47979_length_474_cov_49.453333	392	472	73	2	80	0.0250000
NODE_47979_length_474_cov_49.453333	392	472	75	3	80	0.0375000
NODE_47979_length_474_cov_49.453333	392	472	76	1	80	0.0125000
NODE_47979_length_474_cov_49.453333	392	472	77	10	80	0.1250000
NODE_47979_length_474_cov_49.453333	392	472	79	1	80	0.0125000
NODE_47979_length_474_cov_49.453333	392	472	80	1	80	0.0125000
NODE_47979_length_474_cov_49.453333	392	472	81	1	80	0.0125000
NODE_47979_length_474_cov_49.453333	392	472	83	1	80	0.0125000
NODE_47979_length_474_cov_49.453333	392	472	86	1	80	0.0125000
NODE_47979_length_474_cov_49.453333	392	472	90	3	80	0.0375000
NODE_47979_length_474_cov_49.453333	392	472	91	1	80	0.0125000
NODE_47979_length_474_cov_49.453333	392	472	92	2	80	0.0250000
NODE_47979_length_474_cov_49.453333	392	472	94	1	80	0.0125000
NODE_47979_length_474_cov_49.453333	392	472	96	1	80	0.0125000
NODE_47979_length_474_cov_49.453333	392	472	97	1	80	0.0125000
NODE_47979_length_474_cov_49.453333	392	472	101	1	80	0.0125000
NODE_47979_length_474_cov_49.453333	392	472	102	1	80	0.0125000
NODE_47979_length_474_cov_49.453333	392	472	104	1	80	0.0125000
NODE_47979_length_474_cov_49.453333	392	472	105	1	80	0.0125000
NODE_47979_length_474_cov_49.453333	392	472	106	1	80	0.0125000
NODE_47979_length_474_cov_49.453333	392	472	107	1	80	0.0125000
NODE_47979_length_474_cov_49.453333	392	472	108	1	80	0.0125000
NODE_47979_length_474_cov_49.453333	392	472	110	1	80	0.0125000
NODE_47979_length_474_cov_49.453333	392	472	112	1	80	0.0125000
NODE_47979_length_474_cov_49.453333	392	472	113	2	80	0.0250000
NODE_47979_length_474_cov_49.453333	392	472	115	1	80	0.0125000
NODE_47979_length_474_cov_49.453333	392	472	116	3	80	0.0375000
NODE_47979_length_474_cov_49.453333	392	472	119	1	80	0.0125000
NODE_47979_length_474_cov_49.453333	392	472	121	2	80	0.0250000
NODE_47979_length_474_cov_49.453333	392	472	124	1	80	0.0125000
NODE_47979_length_474_cov_49.453333	392	472	125	3	80	0.0375000
NODE_47979_length_474_cov_49.453333	392	472	127	4	80	0.0500000
NODE_47979_length_474_cov_49.453333	392	472	128	1	80	0.0125000
NODE_47979_length_474_cov_49.453333	445	474	30	2	29	0.0689655
NODE_47979_length_474_cov_49.453333	445	474	34	2	29	0.0689655
NODE_47979_length_474_cov_49.453333	445	474	36	1	29	0.0344828
NODE_47979_length_474_cov_49.453333	445	474	39	2	29	0.0689655
NODE_47979_length_474_cov_49.453333	445	474	44	1	29	0.0344828
NODE_47979_length_474_cov_49.453333	445	474	49	1	29	0.0344828
NODE_47979_length_474_cov_49.453333	445	474	52	2	29	0.0689655
NODE_47979_length_474_cov_49.453333	445	474	53	1	29	0.0344828
NODE_47979_length_474_cov_49.453333	445	474	55	3	29	0.1034483
NODE_47979_length_474_cov_49.453333	445	474	57	2	29	0.0689655
NODE_47979_length_474_cov_49.453333	445	474	61	1	29	0.0344828
NODE_47979_length_474_cov_49.453333	445	474	62	1	29	0.0344828
NODE_47979_length_474_cov_49.453333	445	474	63	1	29	0.0344828
NODE_47979_length_474_cov_49.453333	445	474	68	1	29	0.0344828
NODE_47979_length_474_cov_49.453333	445	474	69	2	29	0.0689655
NODE_47979_length_474_cov_49.453333	445	474	70	1	29	0.0344828
NODE_47979_length_474_cov_49.453333	445	474	72	1	29	0.0344828
NODE_47979_length_474_cov_49.453333	445	474	73	2	29	0.0689655
NODE_47979_length_474_cov_49.453333	445	474	75	2	29	0.0689655
NODE_47981_length_474_cov_24.930667	287	367	4	3	80	0.0375000
NODE_47981_length_474_cov_24.930667	287	367	6	25	80	0.3125000
NODE_47981_length_474_cov_24.930667	287	367	8	52	80	0.6500000
NODE_47981_length_474_cov_24.930667	340	420	2	8	80	0.1000000
NODE_47981_length_474_cov_24.930667	340	420	3	13	80	0.1625000
NODE_47981_length_474_cov_24.930667	340	420	5	19	80	0.2375000
NODE_47981_length_474_cov_24.930667	340	420	6	27	80	0.3375000
NODE_47981_length_474_cov_24.930667	340	420	8	13	80	0.1625000
NODE_47982_length_474_cov_15.952000	258	338	2	39	80	0.4875000
NODE_47982_length_474_cov_15.952000	258	338	4	41	80	0.5125000
NODE_47982_length_474_cov_15.952000	311	391	0	45	80	0.5625000
NODE_47982_length_474_cov_15.952000	311	391	2	35	80	0.4375000
NODE_48003_length_474_cov_3.986667	172	252	9	69	80	0.8625000
NODE_48003_length_474_cov_3.986667	172	252	10	11	80	0.1375000
NODE_48015_length_474_cov_3.496000	163	243	2	37	80	0.4625000
NODE_48015_length_474_cov_3.496000	163	243	3	2	80	0.0250000
NODE_48015_length_474_cov_3.496000	163	243	4	41	80	0.5125000
NODE_48038_length_474_cov_2.784000	259	300	0	41	41	1.0000000
NODE_48116_length_474_cov_1.538667	41	62	0	21	21	1.0000000
NODE_48181_length_474_cov_1.085333	0	50	0	50	50	1.0000000
NODE_48184_length_474_cov_1.056000	95	133	0	38	38	1.0000000
NODE_48266_length_473_cov_82.374332	123	203	3	23	80	0.2875000
NODE_48266_length_473_cov_82.374332	123	203	4	11	80	0.1375000
NODE_48266_length_473_cov_82.374332	123	203	5	3	80	0.0375000
NODE_48266_length_473_cov_82.374332	123	203	6	43	80	0.5375000
NODE_48266_length_473_cov_82.374332	176	256	3	76	80	0.9500000
NODE_48266_length_473_cov_82.374332	176	256	5	3	80	0.0375000
NODE_48266_length_473_cov_82.374332	176	256	6	1	80	0.0125000
NODE_48267_length_473_cov_54.882353	199	279	3	32	80	0.4000000
NODE_48267_length_473_cov_54.882353	199	279	4	48	80	0.6000000
NODE_48267_length_473_cov_54.882353	252	332	0	3	80	0.0375000
NODE_48267_length_473_cov_54.882353	252	332	1	36	80	0.4500000
NODE_48267_length_473_cov_54.882353	252	332	3	41	80	0.5125000
NODE_48268_length_473_cov_48.997326	119	194	4	31	75	0.4133333
NODE_48268_length_473_cov_48.997326	119	194	5	44	75	0.5866666
NODE_48268_length_473_cov_48.997326	119	194	4	31	75	0.4133333
NODE_48268_length_473_cov_48.997326	119	194	5	44	75	0.5866666
NODE_48268_length_473_cov_48.997326	167	247	1	7	80	0.0875000
NODE_48268_length_473_cov_48.997326	167	247	2	31	80	0.3875000
NODE_48268_length_473_cov_48.997326	167	247	3	14	80	0.1750000
NODE_48268_length_473_cov_48.997326	167	247	4	28	80	0.3500000
NODE_48269_length_473_cov_30.679144	174	254	7	3	80	0.0375000
NODE_48269_length_473_cov_30.679144	174	254	8	31	80	0.3875000
NODE_48269_length_473_cov_30.679144	174	254	9	1	80	0.0125000
NODE_48269_length_473_cov_30.679144	174	254	10	10	80	0.1250000
NODE_48269_length_473_cov_30.679144	174	254	11	24	80	0.3000000
NODE_48269_length_473_cov_30.679144	174	254	12	11	80	0.1375000
NODE_48269_length_473_cov_30.679144	226	307	0	7	81	0.0864198
NODE_48269_length_473_cov_30.679144	226	307	2	13	81	0.1604938
NODE_48269_length_473_cov_30.679144	226	307	4	5	81	0.0617284
NODE_48269_length_473_cov_30.679144	226	307	6	28	81	0.3456790
NODE_48269_length_473_cov_30.679144	226	307	7	3	81	0.0370370
NODE_48269_length_473_cov_30.679144	226	307	8	25	81	0.3086420
NODE_48269_length_473_cov_30.679144	227	307	0	7	80	0.0875000
NODE_48269_length_473_cov_30.679144	227	307	2	13	80	0.1625000
NODE_48269_length_473_cov_30.679144	227	307	4	5	80	0.0625000
NODE_48269_length_473_cov_30.679144	227	307	6	28	80	0.3500000
NODE_48269_length_473_cov_30.679144	227	307	7	3	80	0.0375000
NODE_48269_length_473_cov_30.679144	227	307	8	24	80	0.3000000
NODE_48270_length_473_cov_24.967914	295	370	0	3	75	0.0400000
NODE_48270_length_473_cov_24.967914	295	370	2	71	75	0.9466667
NODE_48270_length_473_cov_24.967914	295	370	3	1	75	0.0133333
NODE_48270_length_473_cov_24.967914	343	423	0	56	80	0.7000000
NODE_48270_length_473_cov_24.967914	343	423	2	24	80	0.3000000
NODE_48271_length_473_cov_18.540107	168	248	0	80	80	1.0000000
NODE_48271_length_473_cov_18.540107	221	301	0	67	80	0.8375000
NODE_48271_length_473_cov_18.540107	221	301	2	13	80	0.1625000
NODE_48272_length_473_cov_15.871658	143	223	1	80	80	1.0000000
NODE_48272_length_473_cov_15.871658	196	276	0	13	80	0.1625000
NODE_48272_length_473_cov_15.871658	196	276	1	67	80	0.8375000
NODE_48291_length_473_cov_4.363636	160	240	0	9	80	0.1125000
NODE_48291_length_473_cov_4.363636	160	240	2	71	80	0.8875000
NODE_48291_length_473_cov_4.363636	213	293	2	80	80	1.0000000
NODE_48320_length_473_cov_2.959893	199	267	0	68	68	1.0000000
NODE_48325_length_473_cov_2.804813	207	269	0	14	62	0.2258064
NODE_48325_length_473_cov_2.804813	207	269	2	48	62	0.7741935
NODE_48350_length_473_cov_2.251337	48	128	2	18	80	0.2250000
NODE_48350_length_473_cov_2.251337	48	128	4	5	80	0.0625000
NODE_48350_length_473_cov_2.251337	48	128	5	1	80	0.0125000
NODE_48350_length_473_cov_2.251337	48	128	6	56	80	0.7000000
NODE_48350_length_473_cov_2.251337	101	181	4	21	80	0.2625000
NODE_48350_length_473_cov_2.251337	101	181	6	59	80	0.7375000
NODE_48568_length_472_cov_50.077748	1	81	0	2	80	0.0250000
NODE_48568_length_472_cov_50.077748	1	81	1	3	80	0.0375000
NODE_48568_length_472_cov_50.077748	1	81	2	33	80	0.4125000
NODE_48568_length_472_cov_50.077748	1	81	3	15	80	0.1875000
NODE_48568_length_472_cov_50.077748	1	81	5	2	80	0.0250000
NODE_48568_length_472_cov_50.077748	1	81	7	4	80	0.0500000
NODE_48568_length_472_cov_50.077748	1	81	8	6	80	0.0750000
NODE_48568_length_472_cov_50.077748	1	81	9	15	80	0.1875000
NODE_48568_length_472_cov_50.077748	1	81	0	2	80	0.0250000
NODE_48568_length_472_cov_50.077748	1	81	1	3	80	0.0375000
NODE_48568_length_472_cov_50.077748	1	81	2	33	80	0.4125000
NODE_48568_length_472_cov_50.077748	1	81	3	15	80	0.1875000
NODE_48568_length_472_cov_50.077748	1	81	5	2	80	0.0250000
NODE_48568_length_472_cov_50.077748	1	81	7	4	80	0.0500000
NODE_48568_length_472_cov_50.077748	1	81	8	6	80	0.0750000
NODE_48568_length_472_cov_50.077748	1	81	9	15	80	0.1875000
NODE_48568_length_472_cov_50.077748	1	81	0	2	80	0.0250000
NODE_48568_length_472_cov_50.077748	1	81	1	3	80	0.0375000
NODE_48568_length_472_cov_50.077748	1	81	2	33	80	0.4125000
NODE_48568_length_472_cov_50.077748	1	81	3	15	80	0.1875000
NODE_48568_length_472_cov_50.077748	1	81	5	2	80	0.0250000
NODE_48568_length_472_cov_50.077748	1	81	7	4	80	0.0500000
NODE_48568_length_472_cov_50.077748	1	81	8	6	80	0.0750000
NODE_48568_length_472_cov_50.077748	1	81	9	15	80	0.1875000
NODE_48568_length_472_cov_50.077748	1	81	0	2	80	0.0250000
NODE_48568_length_472_cov_50.077748	1	81	1	3	80	0.0375000
NODE_48568_length_472_cov_50.077748	1	81	2	33	80	0.4125000
NODE_48568_length_472_cov_50.077748	1	81	3	15	80	0.1875000
NODE_48568_length_472_cov_50.077748	1	81	5	2	80	0.0250000
NODE_48568_length_472_cov_50.077748	1	81	7	4	80	0.0500000
NODE_48568_length_472_cov_50.077748	1	81	8	6	80	0.0750000
NODE_48568_length_472_cov_50.077748	1	81	9	15	80	0.1875000
NODE_48568_length_472_cov_50.077748	1	81	0	2	80	0.0250000
NODE_48568_length_472_cov_50.077748	1	81	1	3	80	0.0375000
NODE_48568_length_472_cov_50.077748	1	81	2	33	80	0.4125000
NODE_48568_length_472_cov_50.077748	1	81	3	15	80	0.1875000
NODE_48568_length_472_cov_50.077748	1	81	5	2	80	0.0250000
NODE_48568_length_472_cov_50.077748	1	81	7	4	80	0.0500000
NODE_48568_length_472_cov_50.077748	1	81	8	6	80	0.0750000
NODE_48568_length_472_cov_50.077748	1	81	9	15	80	0.1875000
NODE_48568_length_472_cov_50.077748	10	81	2	29	71	0.4084507
NODE_48568_length_472_cov_50.077748	10	81	3	15	71	0.2112676
NODE_48568_length_472_cov_50.077748	10	81	5	2	71	0.0281690
NODE_48568_length_472_cov_50.077748	10	81	7	4	71	0.0563380
NODE_48568_length_472_cov_50.077748	10	81	8	6	71	0.0845070
NODE_48568_length_472_cov_50.077748	10	81	9	15	71	0.2112676
NODE_48568_length_472_cov_50.077748	54	131	5	2	77	0.0259740
NODE_48568_length_472_cov_50.077748	54	131	7	4	77	0.0519481
NODE_48568_length_472_cov_50.077748	54	131	8	6	77	0.0779221
NODE_48568_length_472_cov_50.077748	54	131	9	23	77	0.2987013
NODE_48568_length_472_cov_50.077748	54	131	11	2	77	0.0259740
NODE_48568_length_472_cov_50.077748	54	131	12	11	77	0.1428571
NODE_48568_length_472_cov_50.077748	54	131	13	4	77	0.0519481
NODE_48568_length_472_cov_50.077748	54	131	14	14	77	0.1818182
NODE_48568_length_472_cov_50.077748	54	131	17	11	77	0.1428571
NODE_48568_length_472_cov_50.077748	54	131	5	2	77	0.0259740
NODE_48568_length_472_cov_50.077748	54	131	7	4	77	0.0519481
NODE_48568_length_472_cov_50.077748	54	131	8	6	77	0.0779221
NODE_48568_length_472_cov_50.077748	54	131	9	23	77	0.2987013
NODE_48568_length_472_cov_50.077748	54	131	11	2	77	0.0259740
NODE_48568_length_472_cov_50.077748	54	131	12	11	77	0.1428571
NODE_48568_length_472_cov_50.077748	54	131	13	4	77	0.0519481
NODE_48568_length_472_cov_50.077748	54	131	14	14	77	0.1818182
NODE_48568_length_472_cov_50.077748	54	131	17	11	77	0.1428571
NODE_48568_length_472_cov_50.077748	54	131	5	2	77	0.0259740
NODE_48568_length_472_cov_50.077748	54	131	7	4	77	0.0519481
NODE_48568_length_472_cov_50.077748	54	131	8	6	77	0.0779221
NODE_48568_length_472_cov_50.077748	54	131	9	23	77	0.2987013
NODE_48568_length_472_cov_50.077748	54	131	11	2	77	0.0259740
NODE_48568_length_472_cov_50.077748	54	131	12	11	77	0.1428571
NODE_48568_length_472_cov_50.077748	54	131	13	4	77	0.0519481
NODE_48568_length_472_cov_50.077748	54	131	14	14	77	0.1818182
NODE_48568_length_472_cov_50.077748	54	131	17	11	77	0.1428571
NODE_48568_length_472_cov_50.077748	130	204	13	6	74	0.0810811
NODE_48568_length_472_cov_50.077748	130	204	15	12	74	0.1621622
NODE_48568_length_472_cov_50.077748	130	204	16	34	74	0.4594595
NODE_48568_length_472_cov_50.077748	130	204	17	22	74	0.2972973
NODE_48569_length_472_cov_10.469169	294	374	0	80	80	1.0000000
NODE_48569_length_472_cov_10.469169	347	427	0	80	80	1.0000000
NODE_48570_length_472_cov_10.195710	143	223	0	35	80	0.4375000
NODE_48570_length_472_cov_10.195710	143	223	1	27	80	0.3375000
NODE_48570_length_472_cov_10.195710	143	223	2	18	80	0.2250000
NODE_48570_length_472_cov_10.195710	196	276	1	9	80	0.1125000
NODE_48570_length_472_cov_10.195710	196	276	2	71	80	0.8875000
NODE_48593_length_472_cov_4.375335	165	245	0	32	80	0.4000000
NODE_48593_length_472_cov_4.375335	165	245	1	23	80	0.2875000
NODE_48593_length_472_cov_4.375335	165	245	3	25	80	0.3125000
NODE_48593_length_472_cov_4.375335	218	251	1	2	33	0.0606061
NODE_48593_length_472_cov_4.375335	218	251	3	25	33	0.7575758
NODE_48593_length_472_cov_4.375335	218	251	4	6	33	0.1818182
NODE_48614_length_472_cov_3.495979	305	349	0	44	44	1.0000000
NODE_48620_length_472_cov_3.093834	220	295	0	75	75	1.0000000
NODE_48638_length_472_cov_2.592493	431	471	0	40	40	1.0000000
NODE_48745_length_472_cov_1.294906	43	98	0	55	55	1.0000000
NODE_48745_length_472_cov_1.294906	71	151	0	80	80	1.0000000
NODE_48768_length_472_cov_1.211796	106	126	0	20	20	1.0000000
NODE_48873_length_471_cov_39.319892	119	193	3	43	74	0.5810811
NODE_48873_length_471_cov_39.319892	119	193	5	26	74	0.3513514
NODE_48873_length_471_cov_39.319892	119	193	7	3	74	0.0405405
NODE_48873_length_471_cov_39.319892	119	193	8	1	74	0.0135135
NODE_48873_length_471_cov_39.319892	119	193	16	1	74	0.0135135
NODE_48874_length_471_cov_24.279570	185	265	4	15	80	0.1875000
NODE_48874_length_471_cov_24.279570	185	265	5	65	80	0.8125000
NODE_48874_length_471_cov_24.279570	238	318	2	9	80	0.1125000
NODE_48874_length_471_cov_24.279570	238	318	3	29	80	0.3625000
NODE_48874_length_471_cov_24.279570	238	318	5	38	80	0.4750000
NODE_48874_length_471_cov_24.279570	238	318	6	4	80	0.0500000
NODE_48875_length_471_cov_19.669355	83	163	1	80	80	1.0000000
NODE_48875_length_471_cov_19.669355	136	216	1	44	80	0.5500000
NODE_48875_length_471_cov_19.669355	136	216	2	36	80	0.4500000
NODE_48876_length_471_cov_14.387097	198	278	0	80	80	1.0000000
NODE_48876_length_471_cov_14.387097	251	331	0	80	80	1.0000000
NODE_48881_length_471_cov_6.948925	186	213	1	25	27	0.9259259
NODE_48881_length_471_cov_6.948925	186	213	3	2	27	0.0740741
NODE_48881_length_471_cov_6.948925	204	284	1	7	80	0.0875000
NODE_48881_length_471_cov_6.948925	204	284	3	73	80	0.9125000
NODE_48881_length_471_cov_6.948925	244	275	3	31	31	1.0000000
NODE_48881_length_471_cov_6.948925	257	337	0	14	80	0.1750000
NODE_48881_length_471_cov_6.948925	257	337	2	15	80	0.1875000
NODE_48881_length_471_cov_6.948925	257	337	3	51	80	0.6375000
NODE_48881_length_471_cov_6.948925	268	337	0	14	69	0.2028985
NODE_48881_length_471_cov_6.948925	268	337	2	15	69	0.2173913
NODE_48881_length_471_cov_6.948925	268	337	3	40	69	0.5797101
NODE_48902_length_471_cov_3.803763	83	162	0	32	79	0.4050633
NODE_48902_length_471_cov_3.803763	83	162	2	47	79	0.5949367
NODE_48902_length_471_cov_3.803763	135	215	0	80	80	1.0000000
NODE_48924_length_471_cov_2.954301	284	315	2	6	31	0.1935484
NODE_48924_length_471_cov_2.954301	284	315	3	7	31	0.2258064
NODE_48924_length_471_cov_2.954301	284	315	6	1	31	0.0322581
NODE_48924_length_471_cov_2.954301	284	315	7	3	31	0.0967742
NODE_48924_length_471_cov_2.954301	284	315	8	2	31	0.0645161
NODE_48924_length_471_cov_2.954301	284	315	9	2	31	0.0645161
NODE_48924_length_471_cov_2.954301	284	315	10	2	31	0.0645161
NODE_48924_length_471_cov_2.954301	284	315	11	4	31	0.1290323
NODE_48924_length_471_cov_2.954301	284	315	12	3	31	0.0967742
NODE_48924_length_471_cov_2.954301	284	315	13	1	31	0.0322581
NODE_48957_length_471_cov_2.287634	133	200	1	4	67	0.0597015
NODE_48957_length_471_cov_2.287634	133	200	2	4	67	0.0597015
NODE_48957_length_471_cov_2.287634	133	200	4	5	67	0.0746269
NODE_48957_length_471_cov_2.287634	133	200	5	2	67	0.0298507
NODE_48957_length_471_cov_2.287634	133	200	6	1	67	0.0149254
NODE_48957_length_471_cov_2.287634	133	200	7	5	67	0.0746269
NODE_48957_length_471_cov_2.287634	133	200	8	27	67	0.4029851
NODE_48957_length_471_cov_2.287634	133	200	9	16	67	0.2388060
NODE_48957_length_471_cov_2.287634	133	200	11	3	67	0.0447761
NODE_49186_length_470_cov_57.078167	184	264	4	16	80	0.2000000
NODE_49186_length_470_cov_57.078167	184	264	5	10	80	0.1250000
NODE_49186_length_470_cov_57.078167	184	264	6	14	80	0.1750000
NODE_49186_length_470_cov_57.078167	184	264	7	27	80	0.3375000
NODE_49186_length_470_cov_57.078167	184	264	8	8	80	0.1000000
NODE_49186_length_470_cov_57.078167	184	264	9	5	80	0.0625000
NODE_49186_length_470_cov_57.078167	237	317	5	2	80	0.0250000
NODE_49186_length_470_cov_57.078167	237	317	6	34	80	0.4250000
NODE_49186_length_470_cov_57.078167	237	317	7	14	80	0.1750000
NODE_49186_length_470_cov_57.078167	237	317	8	25	80	0.3125000
NODE_49186_length_470_cov_57.078167	237	317	9	5	80	0.0625000
NODE_49186_length_470_cov_57.078167	313	393	4	26	80	0.3250000
NODE_49186_length_470_cov_57.078167	313	393	5	22	80	0.2750000
NODE_49186_length_470_cov_57.078167	313	393	6	18	80	0.2250000
NODE_49186_length_470_cov_57.078167	313	393	7	14	80	0.1750000
NODE_49186_length_470_cov_57.078167	366	446	2	37	80	0.4625000
NODE_49186_length_470_cov_57.078167	366	446	3	8	80	0.1000000
NODE_49186_length_470_cov_57.078167	366	446	4	34	80	0.4250000
NODE_49186_length_470_cov_57.078167	366	446	5	1	80	0.0125000
NODE_49187_length_470_cov_34.035040	228	308	0	80	80	1.0000000
NODE_49187_length_470_cov_34.035040	281	361	0	80	80	1.0000000
NODE_49187_length_470_cov_34.035040	357	437	0	80	80	1.0000000
NODE_49187_length_470_cov_34.035040	410	470	0	60	60	1.0000000
NODE_49188_length_470_cov_15.539084	142	222	0	80	80	1.0000000
NODE_49188_length_470_cov_15.539084	195	275	0	80	80	1.0000000
NODE_49193_length_470_cov_6.070081	272	330	55	1	58	0.0172414
NODE_49193_length_470_cov_6.070081	272	330	56	3	58	0.0517241
NODE_49193_length_470_cov_6.070081	272	330	57	7	58	0.1206897
NODE_49193_length_470_cov_6.070081	272	330	58	8	58	0.1379310
NODE_49193_length_470_cov_6.070081	272	330	60	1	58	0.0172414
NODE_49193_length_470_cov_6.070081	272	330	61	2	58	0.0344828
NODE_49193_length_470_cov_6.070081	272	330	62	3	58	0.0517241
NODE_49193_length_470_cov_6.070081	272	330	63	1	58	0.0172414
NODE_49193_length_470_cov_6.070081	272	330	65	6	58	0.1034483
NODE_49193_length_470_cov_6.070081	272	330	66	3	58	0.0517241
NODE_49193_length_470_cov_6.070081	272	330	67	7	58	0.1206897
NODE_49193_length_470_cov_6.070081	272	330	70	3	58	0.0517241
NODE_49193_length_470_cov_6.070081	272	330	71	2	58	0.0344828
NODE_49193_length_470_cov_6.070081	272	330	72	6	58	0.1034483
NODE_49193_length_470_cov_6.070081	272	330	76	5	58	0.0862069
NODE_49193_length_470_cov_6.070081	325	383	5	1	58	0.0172414
NODE_49193_length_470_cov_6.070081	325	383	14	3	58	0.0517241
NODE_49193_length_470_cov_6.070081	325	383	15	1	58	0.0172414
NODE_49193_length_470_cov_6.070081	325	383	17	2	58	0.0344828
NODE_49193_length_470_cov_6.070081	325	383	18	2	58	0.0344828
NODE_49193_length_470_cov_6.070081	325	383	20	1	58	0.0172414
NODE_49193_length_470_cov_6.070081	325	383	21	7	58	0.1206897
NODE_49193_length_470_cov_6.070081	325	383	23	1	58	0.0172414
NODE_49193_length_470_cov_6.070081	325	383	25	1	58	0.0172414
NODE_49193_length_470_cov_6.070081	325	383	26	1	58	0.0172414
NODE_49193_length_470_cov_6.070081	325	383	27	1	58	0.0172414
NODE_49193_length_470_cov_6.070081	325	383	28	2	58	0.0344828
NODE_49193_length_470_cov_6.070081	325	383	29	1	58	0.0172414
NODE_49193_length_470_cov_6.070081	325	383	30	1	58	0.0172414
NODE_49193_length_470_cov_6.070081	325	383	32	5	58	0.0862069
NODE_49193_length_470_cov_6.070081	325	383	33	1	58	0.0172414
NODE_49193_length_470_cov_6.070081	325	383	35	1	58	0.0172414
NODE_49193_length_470_cov_6.070081	325	383	37	2	58	0.0344828
NODE_49193_length_470_cov_6.070081	325	383	38	2	58	0.0344828
NODE_49193_length_470_cov_6.070081	325	383	40	1	58	0.0172414
NODE_49193_length_470_cov_6.070081	325	383	41	1	58	0.0172414
NODE_49193_length_470_cov_6.070081	325	383	42	2	58	0.0344828
NODE_49193_length_470_cov_6.070081	325	383	46	1	58	0.0172414
NODE_49193_length_470_cov_6.070081	325	383	47	4	58	0.0689655
NODE_49193_length_470_cov_6.070081	325	383	48	2	58	0.0344828
NODE_49193_length_470_cov_6.070081	325	383	49	1	58	0.0172414
NODE_49193_length_470_cov_6.070081	325	383	50	1	58	0.0172414
NODE_49193_length_470_cov_6.070081	325	383	51	1	58	0.0172414
NODE_49193_length_470_cov_6.070081	325	383	53	2	58	0.0344828
NODE_49193_length_470_cov_6.070081	325	383	54	1	58	0.0172414
NODE_49193_length_470_cov_6.070081	325	383	55	1	58	0.0172414
NODE_49193_length_470_cov_6.070081	325	383	56	2	58	0.0344828
NODE_49193_length_470_cov_6.070081	325	383	57	2	58	0.0344828
NODE_49215_length_470_cov_3.735849	194	251	2	57	57	1.0000000
NODE_49260_length_470_cov_2.363881	403	422	3	15	19	0.7894737
NODE_49260_length_470_cov_2.363881	403	422	5	4	19	0.2105263
NODE_49260_length_470_cov_2.363881	403	422	3	15	19	0.7894737
NODE_49260_length_470_cov_2.363881	403	422	5	4	19	0.2105263
NODE_49389_length_470_cov_1.142857	414	470	1	51	56	0.9107143
NODE_49389_length_470_cov_1.142857	414	470	2	5	56	0.0892857
NODE_49502_length_469_cov_221.024324	150	228	104	1	78	0.0128205
NODE_49502_length_469_cov_221.024324	150	228	107	4	78	0.0512821
NODE_49502_length_469_cov_221.024324	150	228	112	2	78	0.0256410
NODE_49502_length_469_cov_221.024324	150	228	115	1	78	0.0128205
NODE_49502_length_469_cov_221.024324	150	228	117	1	78	0.0128205
NODE_49502_length_469_cov_221.024324	150	228	120	2	78	0.0256410
NODE_49502_length_469_cov_221.024324	150	228	121	2	78	0.0256410
NODE_49502_length_469_cov_221.024324	150	228	122	5	78	0.0641026
NODE_49502_length_469_cov_221.024324	150	228	123	12	78	0.1538462
NODE_49502_length_469_cov_221.024324	150	228	124	8	78	0.1025641
NODE_49502_length_469_cov_221.024324	150	228	125	14	78	0.1794872
NODE_49502_length_469_cov_221.024324	150	228	126	8	78	0.1025641
NODE_49502_length_469_cov_221.024324	150	228	127	9	78	0.1153846
NODE_49502_length_469_cov_221.024324	150	228	128	6	78	0.0769231
NODE_49502_length_469_cov_221.024324	150	228	129	2	78	0.0256410
NODE_49502_length_469_cov_221.024324	150	228	130	1	78	0.0128205
NODE_49502_length_469_cov_221.024324	150	228	104	1	78	0.0128205
NODE_49502_length_469_cov_221.024324	150	228	107	4	78	0.0512821
NODE_49502_length_469_cov_221.024324	150	228	112	2	78	0.0256410
NODE_49502_length_469_cov_221.024324	150	228	115	1	78	0.0128205
NODE_49502_length_469_cov_221.024324	150	228	117	1	78	0.0128205
NODE_49502_length_469_cov_221.024324	150	228	120	2	78	0.0256410
NODE_49502_length_469_cov_221.024324	150	228	121	2	78	0.0256410
NODE_49502_length_469_cov_221.024324	150	228	122	5	78	0.0641026
NODE_49502_length_469_cov_221.024324	150	228	123	12	78	0.1538462
NODE_49502_length_469_cov_221.024324	150	228	124	8	78	0.1025641
NODE_49502_length_469_cov_221.024324	150	228	125	14	78	0.1794872
NODE_49502_length_469_cov_221.024324	150	228	126	8	78	0.1025641
NODE_49502_length_469_cov_221.024324	150	228	127	9	78	0.1153846
NODE_49502_length_469_cov_221.024324	150	228	128	6	78	0.0769231
NODE_49502_length_469_cov_221.024324	150	228	129	2	78	0.0256410
NODE_49502_length_469_cov_221.024324	150	228	130	1	78	0.0128205
NODE_49502_length_469_cov_221.024324	150	219	120	2	69	0.0289855
NODE_49502_length_469_cov_221.024324	150	219	121	2	69	0.0289855
NODE_49502_length_469_cov_221.024324	150	219	122	5	69	0.0724638
NODE_49502_length_469_cov_221.024324	150	219	123	12	69	0.1739130
NODE_49502_length_469_cov_221.024324	150	219	124	8	69	0.1159420
NODE_49502_length_469_cov_221.024324	150	219	125	14	69	0.2028985
NODE_49502_length_469_cov_221.024324	150	219	126	8	69	0.1159420
NODE_49502_length_469_cov_221.024324	150	219	127	9	69	0.1304348
NODE_49502_length_469_cov_221.024324	150	219	128	6	69	0.0869565
NODE_49502_length_469_cov_221.024324	150	219	129	2	69	0.0289855
NODE_49502_length_469_cov_221.024324	150	219	130	1	69	0.0144928
NODE_49557_length_469_cov_2.686486	263	343	1	15	80	0.1875000
NODE_49557_length_469_cov_2.686486	263	343	2	65	80	0.8125000
NODE_49561_length_469_cov_2.521622	237	289	2	52	52	1.0000000
NODE_49579_length_469_cov_2.224324	279	331	0	52	52	1.0000000
NODE_49796_length_468_cov_8.043360	190	250	6	60	60	1.0000000
NODE_49796_length_468_cov_8.043360	223	303	4	23	80	0.2875000
NODE_49796_length_468_cov_8.043360	223	303	6	57	80	0.7125000
NODE_49800_length_468_cov_6.046070	152	232	0	80	80	1.0000000
NODE_49800_length_468_cov_6.046070	205	285	0	80	80	1.0000000
NODE_49801_length_468_cov_5.997290	81	161	0	9	80	0.1125000
NODE_49801_length_468_cov_5.997290	81	161	2	71	80	0.8875000
NODE_49801_length_468_cov_5.997290	134	214	2	80	80	1.0000000
NODE_49801_length_468_cov_5.997290	210	270	0	33	60	0.5500000
NODE_49801_length_468_cov_5.997290	210	270	2	27	60	0.4500000
NODE_49803_length_468_cov_5.872629	133	201	2	13	68	0.1911765
NODE_49803_length_468_cov_5.872629	133	201	3	55	68	0.8088235
NODE_49807_length_468_cov_5.384824	305	356	5	51	51	1.0000000
NODE_49894_length_468_cov_2.067751	45	96	0	7	51	0.1372549
NODE_49894_length_468_cov_2.067751	45	96	2	44	51	0.8627451
NODE_49913_length_468_cov_1.891599	4	63	0	59	59	1.0000000
NODE_49928_length_468_cov_1.758808	140	218	0	78	78	1.0000000
NODE_49928_length_468_cov_1.758808	191	257	0	66	66	1.0000000
NODE_49974_length_468_cov_1.390244	291	310	2	19	19	1.0000000
NODE_49974_length_468_cov_1.390244	369	405	0	36	36	1.0000000
NODE_50133_length_467_cov_14.100543	176	256	2	6	80	0.0750000
NODE_50133_length_467_cov_14.100543	176	256	4	29	80	0.3625000
NODE_50133_length_467_cov_14.100543	176	256	5	25	80	0.3125000
NODE_50133_length_467_cov_14.100543	176	256	6	20	80	0.2500000
NODE_50134_length_467_cov_11.902174	193	236	0	34	43	0.7906977
NODE_50134_length_467_cov_11.902174	193	236	1	9	43	0.2093023
NODE_50135_length_467_cov_10.875000	226	306	1	23	80	0.2875000
NODE_50135_length_467_cov_10.875000	226	306	2	57	80	0.7125000
NODE_50135_length_467_cov_10.875000	279	359	2	80	80	1.0000000
NODE_50144_length_467_cov_6.625000	206	275	2	3	69	0.0434783
NODE_50144_length_467_cov_6.625000	206	275	4	66	69	0.9565217
NODE_50144_length_467_cov_6.625000	257	328	2	12	71	0.1690141
NODE_50144_length_467_cov_6.625000	257	328	3	8	71	0.1126761
NODE_50144_length_467_cov_6.625000	257	328	4	51	71	0.7183099
NODE_50197_length_467_cov_2.709239	247	327	0	80	80	1.0000000
NODE_50215_length_467_cov_2.296196	284	329	2	45	45	1.0000000
NODE_50238_length_467_cov_2.027174	218	269	1	44	51	0.8627451
NODE_50238_length_467_cov_2.027174	218	269	2	7	51	0.1372549
NODE_50252_length_467_cov_1.836957	55	118	3	63	63	1.0000000
NODE_50267_length_467_cov_1.603261	92	141	2	14	49	0.2857143
NODE_50267_length_467_cov_1.603261	92	141	3	35	49	0.7142857
NODE_50283_length_467_cov_1.426630	135	183	0	48	48	1.0000000
NODE_50447_length_466_cov_42.839237	0	47	0	33	47	0.7021276
NODE_50447_length_466_cov_42.839237	0	47	2	14	47	0.2978723
NODE_50447_length_466_cov_42.839237	20	100	0	13	80	0.1625000
NODE_50447_length_466_cov_42.839237	20	100	2	29	80	0.3625000
NODE_50447_length_466_cov_42.839237	20	100	3	10	80	0.1250000
NODE_50447_length_466_cov_42.839237	20	100	4	28	80	0.3500000
NODE_50447_length_466_cov_42.839237	96	176	4	80	80	1.0000000
NODE_50447_length_466_cov_42.839237	149	229	0	7	80	0.0875000
NODE_50447_length_466_cov_42.839237	149	229	1	10	80	0.1250000
NODE_50447_length_466_cov_42.839237	149	229	2	29	80	0.3625000
NODE_50447_length_466_cov_42.839237	149	229	4	34	80	0.4250000
NODE_50448_length_466_cov_36.901907	85	165	0	4	80	0.0500000
NODE_50448_length_466_cov_36.901907	85	165	1	11	80	0.1375000
NODE_50448_length_466_cov_36.901907	85	165	2	54	80	0.6750000
NODE_50448_length_466_cov_36.901907	85	165	3	11	80	0.1375000
NODE_50448_length_466_cov_36.901907	138	218	1	33	80	0.4125000
NODE_50448_length_466_cov_36.901907	138	218	2	36	80	0.4500000
NODE_50448_length_466_cov_36.901907	138	218	3	11	80	0.1375000
NODE_50448_length_466_cov_36.901907	214	294	2	21	80	0.2625000
NODE_50448_length_466_cov_36.901907	214	294	4	28	80	0.3500000
NODE_50448_length_466_cov_36.901907	214	294	5	31	80	0.3875000
NODE_50448_length_466_cov_36.901907	267	347	1	11	80	0.1375000
NODE_50448_length_466_cov_36.901907	267	347	3	9	80	0.1125000
NODE_50448_length_466_cov_36.901907	267	347	4	52	80	0.6500000
NODE_50448_length_466_cov_36.901907	267	347	5	8	80	0.1000000
NODE_50457_length_466_cov_5.122616	275	316	0	41	41	1.0000000
NODE_50457_length_466_cov_5.122616	276	316	0	40	40	1.0000000
NODE_50457_length_466_cov_5.122616	289	338	0	49	49	1.0000000
NODE_50515_length_466_cov_2.602180	9	90	0	2	81	0.0246914
NODE_50515_length_466_cov_2.602180	9	90	1	78	81	0.9629630
NODE_50515_length_466_cov_2.602180	9	90	2	1	81	0.0123457
NODE_50515_length_466_cov_2.602180	312	341	0	11	29	0.3793103
NODE_50515_length_466_cov_2.602180	312	341	1	18	29	0.6206896
NODE_50549_length_466_cov_2.108992	130	182	4	52	52	1.0000000
NODE_50562_length_466_cov_1.980926	183	265	1	82	82	1.0000000
NODE_50787_length_465_cov_13.019126	170	250	2	20	80	0.2500000
NODE_50787_length_465_cov_13.019126	170	250	3	8	80	0.1000000
NODE_50787_length_465_cov_13.019126	170	250	4	24	80	0.3000000
NODE_50787_length_465_cov_13.019126	170	250	6	22	80	0.2750000
NODE_50787_length_465_cov_13.019126	170	250	8	6	80	0.0750000
NODE_50787_length_465_cov_13.019126	223	301	6	21	78	0.2692308
NODE_50787_length_465_cov_13.019126	223	301	7	9	78	0.1153846
NODE_50787_length_465_cov_13.019126	223	301	8	38	78	0.4871795
NODE_50787_length_465_cov_13.019126	223	301	10	2	78	0.0256410
NODE_50787_length_465_cov_13.019126	223	301	12	8	78	0.1025641
NODE_50799_length_465_cov_5.363388	316	393	3	28	77	0.3636364
NODE_50799_length_465_cov_5.363388	316	393	4	22	77	0.2857143
NODE_50799_length_465_cov_5.363388	316	393	5	27	77	0.3506494
NODE_50800_length_465_cov_4.898907	376	406	0	30	30	1.0000000
NODE_50869_length_465_cov_2.366120	147	227	0	80	80	1.0000000
NODE_50869_length_465_cov_2.366120	200	271	0	71	71	1.0000000
NODE_50911_length_465_cov_1.737705	338	383	2	45	45	1.0000000
NODE_51100_length_464_cov_8.473973	209	289	0	80	80	1.0000000
NODE_51100_length_464_cov_8.473973	262	342	0	80	80	1.0000000
NODE_51148_length_464_cov_2.528767	136	199	5	7	63	0.1111111
NODE_51148_length_464_cov_2.528767	136	199	9	30	63	0.4761905
NODE_51148_length_464_cov_2.528767	136	199	10	26	63	0.4126984
NODE_51167_length_464_cov_2.134247	130	203	2	73	73	1.0000000
NODE_51186_length_464_cov_1.901370	58	138	0	64	80	0.8000000
NODE_51186_length_464_cov_1.901370	58	138	1	16	80	0.2000000
NODE_51203_length_464_cov_1.706849	186	265	2	79	79	1.0000000
NODE_51377_length_463_cov_64.420330	375	455	8	2	80	0.0250000
NODE_51377_length_463_cov_64.420330	375	455	9	3	80	0.0375000
NODE_51377_length_463_cov_64.420330	375	455	11	8	80	0.1000000
NODE_51377_length_463_cov_64.420330	375	455	13	11	80	0.1375000
NODE_51377_length_463_cov_64.420330	375	455	15	1	80	0.0125000
NODE_51377_length_463_cov_64.420330	375	455	16	4	80	0.0500000
NODE_51377_length_463_cov_64.420330	375	455	17	2	80	0.0250000
NODE_51377_length_463_cov_64.420330	375	455	18	10	80	0.1250000
NODE_51377_length_463_cov_64.420330	375	455	20	16	80	0.2000000
NODE_51377_length_463_cov_64.420330	375	455	21	8	80	0.1000000
NODE_51377_length_463_cov_64.420330	375	455	23	5	80	0.0625000
NODE_51377_length_463_cov_64.420330	375	455	24	2	80	0.0250000
NODE_51377_length_463_cov_64.420330	375	455	25	8	80	0.1000000
NODE_51377_length_463_cov_64.420330	375	455	8	2	80	0.0250000
NODE_51377_length_463_cov_64.420330	375	455	9	3	80	0.0375000
NODE_51377_length_463_cov_64.420330	375	455	11	8	80	0.1000000
NODE_51377_length_463_cov_64.420330	375	455	13	11	80	0.1375000
NODE_51377_length_463_cov_64.420330	375	455	15	1	80	0.0125000
NODE_51377_length_463_cov_64.420330	375	455	16	4	80	0.0500000
NODE_51377_length_463_cov_64.420330	375	455	17	2	80	0.0250000
NODE_51377_length_463_cov_64.420330	375	455	18	10	80	0.1250000
NODE_51377_length_463_cov_64.420330	375	455	20	16	80	0.2000000
NODE_51377_length_463_cov_64.420330	375	455	21	8	80	0.1000000
NODE_51377_length_463_cov_64.420330	375	455	23	5	80	0.0625000
NODE_51377_length_463_cov_64.420330	375	455	24	2	80	0.0250000
NODE_51377_length_463_cov_64.420330	375	455	25	8	80	0.1000000
NODE_51377_length_463_cov_64.420330	375	455	8	2	80	0.0250000
NODE_51377_length_463_cov_64.420330	375	455	9	3	80	0.0375000
NODE_51377_length_463_cov_64.420330	375	455	11	8	80	0.1000000
NODE_51377_length_463_cov_64.420330	375	455	13	11	80	0.1375000
NODE_51377_length_463_cov_64.420330	375	455	15	1	80	0.0125000
NODE_51377_length_463_cov_64.420330	375	455	16	4	80	0.0500000
NODE_51377_length_463_cov_64.420330	375	455	17	2	80	0.0250000
NODE_51377_length_463_cov_64.420330	375	455	18	10	80	0.1250000
NODE_51377_length_463_cov_64.420330	375	455	20	16	80	0.2000000
NODE_51377_length_463_cov_64.420330	375	455	21	8	80	0.1000000
NODE_51377_length_463_cov_64.420330	375	455	23	5	80	0.0625000
NODE_51377_length_463_cov_64.420330	375	455	24	2	80	0.0250000
NODE_51377_length_463_cov_64.420330	375	455	25	8	80	0.1000000
NODE_51377_length_463_cov_64.420330	375	455	8	2	80	0.0250000
NODE_51377_length_463_cov_64.420330	375	455	9	3	80	0.0375000
NODE_51377_length_463_cov_64.420330	375	455	11	8	80	0.1000000
NODE_51377_length_463_cov_64.420330	375	455	13	11	80	0.1375000
NODE_51377_length_463_cov_64.420330	375	455	15	1	80	0.0125000
NODE_51377_length_463_cov_64.420330	375	455	16	4	80	0.0500000
NODE_51377_length_463_cov_64.420330	375	455	17	2	80	0.0250000
NODE_51377_length_463_cov_64.420330	375	455	18	10	80	0.1250000
NODE_51377_length_463_cov_64.420330	375	455	20	16	80	0.2000000
NODE_51377_length_463_cov_64.420330	375	455	21	8	80	0.1000000
NODE_51377_length_463_cov_64.420330	375	455	23	5	80	0.0625000
NODE_51377_length_463_cov_64.420330	375	455	24	2	80	0.0250000
NODE_51377_length_463_cov_64.420330	375	455	25	8	80	0.1000000
NODE_51377_length_463_cov_64.420330	375	455	8	2	80	0.0250000
NODE_51377_length_463_cov_64.420330	375	455	9	3	80	0.0375000
NODE_51377_length_463_cov_64.420330	375	455	11	8	80	0.1000000
NODE_51377_length_463_cov_64.420330	375	455	13	11	80	0.1375000
NODE_51377_length_463_cov_64.420330	375	455	15	1	80	0.0125000
NODE_51377_length_463_cov_64.420330	375	455	16	4	80	0.0500000
NODE_51377_length_463_cov_64.420330	375	455	17	2	80	0.0250000
NODE_51377_length_463_cov_64.420330	375	455	18	10	80	0.1250000
NODE_51377_length_463_cov_64.420330	375	455	20	16	80	0.2000000
NODE_51377_length_463_cov_64.420330	375	455	21	8	80	0.1000000
NODE_51377_length_463_cov_64.420330	375	455	23	5	80	0.0625000
NODE_51377_length_463_cov_64.420330	375	455	24	2	80	0.0250000
NODE_51377_length_463_cov_64.420330	375	455	25	8	80	0.1000000
NODE_51378_length_463_cov_49.673077	0	71	0	2	71	0.0281690
NODE_51378_length_463_cov_49.673077	0	71	3	4	71	0.0563380
NODE_51378_length_463_cov_49.673077	0	71	4	22	71	0.3098592
NODE_51378_length_463_cov_49.673077	0	71	5	5	71	0.0704225
NODE_51378_length_463_cov_49.673077	0	71	6	1	71	0.0140845
NODE_51378_length_463_cov_49.673077	0	71	8	4	71	0.0563380
NODE_51378_length_463_cov_49.673077	0	71	10	5	71	0.0704225
NODE_51378_length_463_cov_49.673077	0	71	11	28	71	0.3943662
NODE_51378_length_463_cov_49.673077	44	121	11	41	77	0.5324675
NODE_51378_length_463_cov_49.673077	44	121	12	1	77	0.0129870
NODE_51378_length_463_cov_49.673077	44	121	13	35	77	0.4545455
NODE_51379_length_463_cov_41.005495	8	88	1	11	80	0.1375000
NODE_51379_length_463_cov_41.005495	8	88	2	69	80	0.8625000
NODE_51379_length_463_cov_41.005495	61	141	2	80	80	1.0000000
NODE_51380_length_463_cov_30.626374	318	398	0	25	80	0.3125000
NODE_51380_length_463_cov_30.626374	318	398	2	55	80	0.6875000
NODE_51380_length_463_cov_30.626374	371	451	0	19	80	0.2375000
NODE_51380_length_463_cov_30.626374	371	451	2	61	80	0.7625000
NODE_51381_length_463_cov_27.475275	211	291	0	80	80	1.0000000
NODE_51381_length_463_cov_27.475275	264	344	0	80	80	1.0000000
NODE_51383_length_463_cov_11.211538	304	377	4	25	73	0.3424658
NODE_51383_length_463_cov_11.211538	304	377	5	9	73	0.1232877
NODE_51383_length_463_cov_11.211538	304	377	6	39	73	0.5342466
NODE_51383_length_463_cov_11.211538	350	430	3	31	80	0.3875000
NODE_51383_length_463_cov_11.211538	350	430	4	19	80	0.2375000
NODE_51383_length_463_cov_11.211538	350	430	5	12	80	0.1500000
NODE_51383_length_463_cov_11.211538	350	430	6	18	80	0.2250000
NODE_51391_length_463_cov_5.711538	181	261	0	58	80	0.7250000
NODE_51391_length_463_cov_5.711538	181	261	1	22	80	0.2750000
NODE_51391_length_463_cov_5.711538	234	314	0	5	80	0.0625000
NODE_51391_length_463_cov_5.711538	234	314	1	75	80	0.9375000
NODE_51399_length_463_cov_4.398352	119	169	0	13	50	0.2600000
NODE_51399_length_463_cov_4.398352	119	169	1	37	50	0.7400000
NODE_51402_length_463_cov_4.186813	175	233	2	58	58	1.0000000
NODE_51402_length_463_cov_4.186813	206	251	2	45	45	1.0000000
NODE_51408_length_463_cov_3.846154	235	268	2	33	33	1.0000000
NODE_51421_length_463_cov_3.063187	193	248	0	26	55	0.4727273
NODE_51421_length_463_cov_3.063187	193	248	2	29	55	0.5272727
NODE_51421_length_463_cov_3.063187	222	301	2	79	79	1.0000000
NODE_51680_length_462_cov_21.876033	93	173	1	15	80	0.1875000
NODE_51680_length_462_cov_21.876033	93	173	2	65	80	0.8125000
NODE_51680_length_462_cov_21.876033	146	226	2	80	80	1.0000000
NODE_51687_length_462_cov_5.033058	93	154	0	61	61	1.0000000
NODE_51687_length_462_cov_5.033058	159	209	0	50	50	1.0000000
NODE_51699_length_462_cov_4.101928	168	246	2	16	78	0.2051282
NODE_51699_length_462_cov_4.101928	168	246	4	62	78	0.7948718
NODE_51699_length_462_cov_4.101928	184	208	4	24	24	1.0000000
NODE_51699_length_462_cov_4.101928	219	299	2	26	80	0.3250000
NODE_51699_length_462_cov_4.101928	219	299	4	54	80	0.6750000
NODE_51708_length_462_cov_3.630854	149	194	0	45	45	1.0000000
NODE_51720_length_462_cov_3.079890	103	147	1	44	44	1.0000000
NODE_51735_length_462_cov_2.677686	78	118	0	40	40	1.0000000
NODE_51763_length_462_cov_2.209366	18	58	0	40	40	1.0000000
NODE_51817_length_462_cov_1.570248	68	113	0	10	45	0.2222222
NODE_51817_length_462_cov_1.570248	68	113	1	8	45	0.1777778
NODE_51817_length_462_cov_1.570248	68	113	2	27	45	0.6000000
NODE_51995_length_461_cov_35.116022	0	79	0	79	79	1.0000000
NODE_51995_length_461_cov_35.116022	52	132	0	80	80	1.0000000
NODE_51996_length_461_cov_11.124309	77	157	2	80	80	1.0000000
NODE_51996_length_461_cov_11.124309	130	210	0	12	80	0.1500000
NODE_51996_length_461_cov_11.124309	130	210	1	33	80	0.4125000
NODE_51996_length_461_cov_11.124309	130	210	2	35	80	0.4375000
NODE_52010_length_461_cov_5.361878	246	322	2	76	76	1.0000000
NODE_52018_length_461_cov_4.472376	268	333	0	65	65	1.0000000
NODE_52021_length_461_cov_4.168508	159	234	0	75	75	1.0000000
NODE_52047_length_461_cov_2.892265	233	312	2	79	79	1.0000000
NODE_52073_length_461_cov_2.392265	186	223	0	37	37	1.0000000
NODE_52154_length_461_cov_1.389503	283	349	0	66	66	1.0000000
NODE_52292_length_460_cov_172.986150	0	68	38	1	68	0.0147059
NODE_52292_length_460_cov_172.986150	0	68	41	1	68	0.0147059
NODE_52292_length_460_cov_172.986150	0	68	43	1	68	0.0147059
NODE_52292_length_460_cov_172.986150	0	68	46	1	68	0.0147059
NODE_52292_length_460_cov_172.986150	0	68	47	1	68	0.0147059
NODE_52292_length_460_cov_172.986150	0	68	53	2	68	0.0294118
NODE_52292_length_460_cov_172.986150	0	68	55	1	68	0.0147059
NODE_52292_length_460_cov_172.986150	0	68	62	2	68	0.0294118
NODE_52292_length_460_cov_172.986150	0	68	74	3	68	0.0441176
NODE_52292_length_460_cov_172.986150	0	68	76	1	68	0.0147059
NODE_52292_length_460_cov_172.986150	0	68	81	1	68	0.0147059
NODE_52292_length_460_cov_172.986150	0	68	87	1	68	0.0147059
NODE_52292_length_460_cov_172.986150	0	68	92	1	68	0.0147059
NODE_52292_length_460_cov_172.986150	0	68	103	1	68	0.0147059
NODE_52292_length_460_cov_172.986150	0	68	106	1	68	0.0147059
NODE_52292_length_460_cov_172.986150	0	68	109	1	68	0.0147059
NODE_52292_length_460_cov_172.986150	0	68	114	1	68	0.0147059
NODE_52292_length_460_cov_172.986150	0	68	117	1	68	0.0147059
NODE_52292_length_460_cov_172.986150	0	68	125	1	68	0.0147059
NODE_52292_length_460_cov_172.986150	0	68	135	1	68	0.0147059
NODE_52292_length_460_cov_172.986150	0	68	136	1	68	0.0147059
NODE_52292_length_460_cov_172.986150	0	68	140	1	68	0.0147059
NODE_52292_length_460_cov_172.986150	0	68	141	1	68	0.0147059
NODE_52292_length_460_cov_172.986150	0	68	149	1	68	0.0147059
NODE_52292_length_460_cov_172.986150	0	68	153	1	68	0.0147059
NODE_52292_length_460_cov_172.986150	0	68	157	1	68	0.0147059
NODE_52292_length_460_cov_172.986150	0	68	163	1	68	0.0147059
NODE_52292_length_460_cov_172.986150	0	68	165	3	68	0.0441176
NODE_52292_length_460_cov_172.986150	0	68	171	1	68	0.0147059
NODE_52292_length_460_cov_172.986150	0	68	176	1	68	0.0147059
NODE_52292_length_460_cov_172.986150	0	68	177	1	68	0.0147059
NODE_52292_length_460_cov_172.986150	0	68	180	1	68	0.0147059
NODE_52292_length_460_cov_172.986150	0	68	183	1	68	0.0147059
NODE_52292_length_460_cov_172.986150	0	68	185	1	68	0.0147059
NODE_52292_length_460_cov_172.986150	0	68	191	2	68	0.0294118
NODE_52292_length_460_cov_172.986150	0	68	195	2	68	0.0294118
NODE_52292_length_460_cov_172.986150	0	68	196	1	68	0.0147059
NODE_52292_length_460_cov_172.986150	0	68	197	1	68	0.0147059
NODE_52292_length_460_cov_172.986150	0	68	200	1	68	0.0147059
NODE_52292_length_460_cov_172.986150	0	68	201	1	68	0.0147059
NODE_52292_length_460_cov_172.986150	0	68	206	1	68	0.0147059
NODE_52292_length_460_cov_172.986150	0	68	207	1	68	0.0147059
NODE_52292_length_460_cov_172.986150	0	68	215	1	68	0.0147059
NODE_52292_length_460_cov_172.986150	0	68	218	1	68	0.0147059
NODE_52292_length_460_cov_172.986150	0	68	219	1	68	0.0147059
NODE_52292_length_460_cov_172.986150	0	68	223	1	68	0.0147059
NODE_52292_length_460_cov_172.986150	0	68	230	1	68	0.0147059
NODE_52292_length_460_cov_172.986150	0	68	234	1	68	0.0147059
NODE_52292_length_460_cov_172.986150	0	68	240	1	68	0.0147059
NODE_52292_length_460_cov_172.986150	0	68	246	1	68	0.0147059
NODE_52292_length_460_cov_172.986150	0	68	259	1	68	0.0147059
NODE_52292_length_460_cov_172.986150	0	68	264	1	68	0.0147059
NODE_52292_length_460_cov_172.986150	0	68	271	1	68	0.0147059
NODE_52292_length_460_cov_172.986150	0	68	276	1	68	0.0147059
NODE_52292_length_460_cov_172.986150	0	68	278	1	68	0.0147059
NODE_52292_length_460_cov_172.986150	0	68	279	1	68	0.0147059
NODE_52292_length_460_cov_172.986150	0	68	282	1	68	0.0147059
NODE_52292_length_460_cov_172.986150	0	68	283	1	68	0.0147059
NODE_52292_length_460_cov_172.986150	0	68	290	1	68	0.0147059
NODE_52292_length_460_cov_172.986150	0	68	294	1	68	0.0147059
NODE_52292_length_460_cov_172.986150	41	121	191	1	80	0.0125000
NODE_52292_length_460_cov_172.986150	41	121	195	2	80	0.0250000
NODE_52292_length_460_cov_172.986150	41	121	196	1	80	0.0125000
NODE_52292_length_460_cov_172.986150	41	121	197	1	80	0.0125000
NODE_52292_length_460_cov_172.986150	41	121	200	1	80	0.0125000
NODE_52292_length_460_cov_172.986150	41	121	201	1	80	0.0125000
NODE_52292_length_460_cov_172.986150	41	121	206	1	80	0.0125000
NODE_52292_length_460_cov_172.986150	41	121	207	1	80	0.0125000
NODE_52292_length_460_cov_172.986150	41	121	215	1	80	0.0125000
NODE_52292_length_460_cov_172.986150	41	121	218	1	80	0.0125000
NODE_52292_length_460_cov_172.986150	41	121	219	1	80	0.0125000
NODE_52292_length_460_cov_172.986150	41	121	223	1	80	0.0125000
NODE_52292_length_460_cov_172.986150	41	121	230	1	80	0.0125000
NODE_52292_length_460_cov_172.986150	41	121	234	1	80	0.0125000
NODE_52292_length_460_cov_172.986150	41	121	240	1	80	0.0125000
NODE_52292_length_460_cov_172.986150	41	121	246	1	80	0.0125000
NODE_52292_length_460_cov_172.986150	41	121	259	1	80	0.0125000
NODE_52292_length_460_cov_172.986150	41	121	264	1	80	0.0125000
NODE_52292_length_460_cov_172.986150	41	121	271	1	80	0.0125000
NODE_52292_length_460_cov_172.986150	41	121	276	1	80	0.0125000
NODE_52292_length_460_cov_172.986150	41	121	278	1	80	0.0125000
NODE_52292_length_460_cov_172.986150	41	121	279	1	80	0.0125000
NODE_52292_length_460_cov_172.986150	41	121	282	1	80	0.0125000
NODE_52292_length_460_cov_172.986150	41	121	283	1	80	0.0125000
NODE_52292_length_460_cov_172.986150	41	121	290	1	80	0.0125000
NODE_52292_length_460_cov_172.986150	41	121	294	1	80	0.0125000
NODE_52292_length_460_cov_172.986150	41	121	295	1	80	0.0125000
NODE_52292_length_460_cov_172.986150	41	121	297	1	80	0.0125000
NODE_52292_length_460_cov_172.986150	41	121	302	1	80	0.0125000
NODE_52292_length_460_cov_172.986150	41	121	308	1	80	0.0125000
NODE_52292_length_460_cov_172.986150	41	121	312	1	80	0.0125000
NODE_52292_length_460_cov_172.986150	41	121	317	1	80	0.0125000
NODE_52292_length_460_cov_172.986150	41	121	326	1	80	0.0125000
NODE_52292_length_460_cov_172.986150	41	121	332	1	80	0.0125000
NODE_52292_length_460_cov_172.986150	41	121	342	1	80	0.0125000
NODE_52292_length_460_cov_172.986150	41	121	351	1	80	0.0125000
NODE_52292_length_460_cov_172.986150	41	121	356	1	80	0.0125000
NODE_52292_length_460_cov_172.986150	41	121	364	1	80	0.0125000
NODE_52292_length_460_cov_172.986150	41	121	369	1	80	0.0125000
NODE_52292_length_460_cov_172.986150	41	121	372	1	80	0.0125000
NODE_52292_length_460_cov_172.986150	41	121	377	1	80	0.0125000
NODE_52292_length_460_cov_172.986150	41	121	385	1	80	0.0125000
NODE_52292_length_460_cov_172.986150	41	121	399	1	80	0.0125000
NODE_52292_length_460_cov_172.986150	41	121	402	1	80	0.0125000
NODE_52292_length_460_cov_172.986150	41	121	410	1	80	0.0125000
NODE_52292_length_460_cov_172.986150	41	121	412	1	80	0.0125000
NODE_52292_length_460_cov_172.986150	41	121	413	1	80	0.0125000
NODE_52292_length_460_cov_172.986150	41	121	416	2	80	0.0250000
NODE_52292_length_460_cov_172.986150	41	121	422	1	80	0.0125000
NODE_52292_length_460_cov_172.986150	41	121	432	1	80	0.0125000
NODE_52292_length_460_cov_172.986150	41	121	438	1	80	0.0125000
NODE_52292_length_460_cov_172.986150	41	121	445	1	80	0.0125000
NODE_52292_length_460_cov_172.986150	41	121	449	1	80	0.0125000
NODE_52292_length_460_cov_172.986150	41	121	454	1	80	0.0125000
NODE_52292_length_460_cov_172.986150	41	121	460	1	80	0.0125000
NODE_52292_length_460_cov_172.986150	41	121	462	1	80	0.0125000
NODE_52292_length_460_cov_172.986150	41	121	465	1	80	0.0125000
NODE_52292_length_460_cov_172.986150	41	121	472	1	80	0.0125000
NODE_52292_length_460_cov_172.986150	41	121	477	1	80	0.0125000
NODE_52292_length_460_cov_172.986150	41	121	478	1	80	0.0125000
NODE_52292_length_460_cov_172.986150	41	121	480	1	80	0.0125000
NODE_52292_length_460_cov_172.986150	41	121	486	1	80	0.0125000
NODE_52292_length_460_cov_172.986150	41	121	489	1	80	0.0125000
NODE_52292_length_460_cov_172.986150	41	121	500	1	80	0.0125000
NODE_52292_length_460_cov_172.986150	41	121	501	1	80	0.0125000
NODE_52292_length_460_cov_172.986150	41	121	511	1	80	0.0125000
NODE_52292_length_460_cov_172.986150	41	121	515	1	80	0.0125000
NODE_52292_length_460_cov_172.986150	41	121	526	1	80	0.0125000
NODE_52292_length_460_cov_172.986150	41	121	531	2	80	0.0250000
NODE_52292_length_460_cov_172.986150	41	121	534	1	80	0.0125000
NODE_52292_length_460_cov_172.986150	41	121	536	1	80	0.0125000
NODE_52292_length_460_cov_172.986150	41	121	556	1	80	0.0125000
NODE_52292_length_460_cov_172.986150	41	121	564	1	80	0.0125000
NODE_52292_length_460_cov_172.986150	41	121	573	1	80	0.0125000
NODE_52292_length_460_cov_172.986150	41	121	578	3	80	0.0375000
NODE_52293_length_460_cov_62.512465	9	48	4	8	39	0.2051282
NODE_52293_length_460_cov_62.512465	9	48	5	1	39	0.0256410
NODE_52293_length_460_cov_62.512465	9	48	6	2	39	0.0512821
NODE_52293_length_460_cov_62.512465	9	48	7	2	39	0.0512821
NODE_52293_length_460_cov_62.512465	9	48	8	4	39	0.1025641
NODE_52293_length_460_cov_62.512465	9	48	9	2	39	0.0512821
NODE_52293_length_460_cov_62.512465	9	48	10	3	39	0.0769231
NODE_52293_length_460_cov_62.512465	9	48	11	5	39	0.1282051
NODE_52293_length_460_cov_62.512465	9	48	13	3	39	0.0769231
NODE_52293_length_460_cov_62.512465	9	48	15	1	39	0.0256410
NODE_52293_length_460_cov_62.512465	9	48	16	4	39	0.1025641
NODE_52293_length_460_cov_62.512465	9	48	17	4	39	0.1025641
NODE_52294_length_460_cov_33.146814	0	47	0	47	47	1.0000000
NODE_52294_length_460_cov_33.146814	43	115	0	20	72	0.2777778
NODE_52294_length_460_cov_33.146814	43	115	2	52	72	0.7222222
NODE_52294_length_460_cov_33.146814	96	165	2	69	69	1.0000000
NODE_52295_length_460_cov_26.049861	0	63	3	9	63	0.1428571
NODE_52295_length_460_cov_26.049861	0	63	5	23	63	0.3650794
NODE_52295_length_460_cov_26.049861	0	63	7	25	63	0.3968254
NODE_52295_length_460_cov_26.049861	0	63	10	6	63	0.0952381
NODE_52296_length_460_cov_25.709141	246	326	1	30	80	0.3750000
NODE_52296_length_460_cov_25.709141	246	326	3	15	80	0.1875000
NODE_52296_length_460_cov_25.709141	246	326	4	35	80	0.4375000
NODE_52296_length_460_cov_25.709141	299	379	3	34	80	0.4250000
NODE_52296_length_460_cov_25.709141	299	379	4	46	80	0.5750000
NODE_52297_length_460_cov_11.063712	273	353	0	80	80	1.0000000
NODE_52297_length_460_cov_11.063712	326	406	0	80	80	1.0000000
NODE_52303_length_460_cov_7.285319	172	250	2	17	78	0.2179487
NODE_52303_length_460_cov_7.285319	172	250	3	61	78	0.7820513
NODE_52312_length_460_cov_5.163435	120	200	0	80	80	1.0000000
NODE_52312_length_460_cov_5.163435	173	253	0	80	80	1.0000000
NODE_52333_length_460_cov_3.457064	150	230	0	80	80	1.0000000
NODE_52333_length_460_cov_3.457064	203	246	0	43	43	1.0000000
NODE_52339_length_460_cov_3.027701	167	230	1	21	63	0.3333333
NODE_52339_length_460_cov_3.027701	167	230	2	42	63	0.6666667
NODE_52347_length_460_cov_2.819945	195	266	2	4	71	0.0563380
NODE_52347_length_460_cov_2.819945	195	266	6	67	71	0.9436620
NODE_52358_length_460_cov_2.626039	223	277	0	54	54	1.0000000
NODE_52612_length_459_cov_34.927778	165	239	7	4	74	0.0540541
NODE_52612_length_459_cov_34.927778	165	239	9	26	74	0.3513514
NODE_52612_length_459_cov_34.927778	165	239	10	44	74	0.5945946
NODE_52612_length_459_cov_34.927778	212	292	4	4	80	0.0500000
NODE_52612_length_459_cov_34.927778	212	292	5	13	80	0.1625000
NODE_52612_length_459_cov_34.927778	212	292	6	6	80	0.0750000
NODE_52612_length_459_cov_34.927778	212	292	7	6	80	0.0750000
NODE_52612_length_459_cov_34.927778	212	292	9	13	80	0.1625000
NODE_52612_length_459_cov_34.927778	212	292	10	38	80	0.4750000
NODE_52617_length_459_cov_7.261111	143	189	0	46	46	1.0000000
NODE_52617_length_459_cov_7.261111	162	242	0	80	80	1.0000000
NODE_52635_length_459_cov_4.127778	153	233	0	80	80	1.0000000
NODE_52685_length_459_cov_2.158333	219	285	0	66	66	1.0000000
NODE_52685_length_459_cov_2.158333	283	342	0	59	59	1.0000000
NODE_52704_length_459_cov_1.722222	280	353	0	73	73	1.0000000
NODE_52920_length_458_cov_71.047354	0	51	1	51	51	1.0000000
NODE_52920_length_458_cov_71.047354	24	104	1	72	80	0.9000000
NODE_52920_length_458_cov_71.047354	24	104	2	8	80	0.1000000
NODE_52920_length_458_cov_71.047354	100	180	2	23	80	0.2875000
NODE_52920_length_458_cov_71.047354	100	180	3	8	80	0.1000000
NODE_52920_length_458_cov_71.047354	100	180	4	24	80	0.3000000
NODE_52920_length_458_cov_71.047354	100	180	5	25	80	0.3125000
NODE_52920_length_458_cov_71.047354	153	233	4	2	80	0.0250000
NODE_52920_length_458_cov_71.047354	153	233	5	29	80	0.3625000
NODE_52920_length_458_cov_71.047354	153	233	6	5	80	0.0625000
NODE_52920_length_458_cov_71.047354	153	233	8	31	80	0.3875000
NODE_52920_length_458_cov_71.047354	153	233	10	5	80	0.0625000
NODE_52920_length_458_cov_71.047354	153	233	11	8	80	0.1000000
NODE_52921_length_458_cov_47.966574	151	231	0	80	80	1.0000000
NODE_52921_length_458_cov_47.966574	204	284	0	80	80	1.0000000
NODE_52921_length_458_cov_47.966574	280	360	0	80	80	1.0000000
NODE_52921_length_458_cov_47.966574	333	413	0	80	80	1.0000000
NODE_52924_length_458_cov_9.935933	267	347	0	19	80	0.2375000
NODE_52924_length_458_cov_9.935933	267	347	1	61	80	0.7625000
NODE_52924_length_458_cov_9.935933	320	400	0	72	80	0.9000000
NODE_52924_length_458_cov_9.935933	320	400	1	8	80	0.1000000
NODE_52929_length_458_cov_7.598886	87	167	1	80	80	1.0000000
NODE_52967_length_458_cov_3.061281	62	91	0	29	29	1.0000000
NODE_52967_length_458_cov_3.061281	185	224	0	27	39	0.6923077
NODE_52967_length_458_cov_3.061281	185	224	2	12	39	0.3076923
NODE_52992_length_458_cov_2.454039	210	251	0	41	41	1.0000000
NODE_53107_length_458_cov_1.139276	242	289	2	47	47	1.0000000
NODE_53107_length_458_cov_1.139276	262	328	0	25	66	0.3787879
NODE_53107_length_458_cov_1.139276	262	328	2	41	66	0.6212121
NODE_53205_length_457_cov_20.754190	123	203	0	80	80	1.0000000
NODE_53205_length_457_cov_20.754190	176	256	0	80	80	1.0000000
NODE_53207_length_457_cov_13.918994	218	298	0	80	80	1.0000000
NODE_53207_length_457_cov_13.918994	218	298	0	80	80	1.0000000
NODE_53207_length_457_cov_13.918994	218	298	0	80	80	1.0000000
NODE_53207_length_457_cov_13.918994	218	298	0	80	80	1.0000000
NODE_53207_length_457_cov_13.918994	271	320	0	49	49	1.0000000
NODE_53207_length_457_cov_13.918994	271	320	0	49	49	1.0000000
NODE_53207_length_457_cov_13.918994	271	320	0	49	49	1.0000000
NODE_53216_length_457_cov_6.050279	264	326	0	62	62	1.0000000
NODE_53220_length_457_cov_5.078212	71	149	0	78	78	1.0000000
NODE_53220_length_457_cov_5.078212	122	202	0	80	80	1.0000000
NODE_53225_length_457_cov_4.530726	193	273	1	10	80	0.1250000
NODE_53225_length_457_cov_4.530726	193	273	2	12	80	0.1500000
NODE_53225_length_457_cov_4.530726	193	273	3	10	80	0.1250000
NODE_53225_length_457_cov_4.530726	193	273	4	30	80	0.3750000
NODE_53225_length_457_cov_4.530726	193	273	5	18	80	0.2250000
NODE_53225_length_457_cov_4.530726	246	315	0	19	69	0.2753623
NODE_53225_length_457_cov_4.530726	246	315	1	33	69	0.4782609
NODE_53225_length_457_cov_4.530726	246	315	2	12	69	0.1739130
NODE_53225_length_457_cov_4.530726	246	315	3	5	69	0.0724638
NODE_53230_length_457_cov_3.986034	192	272	0	80	80	1.0000000
NODE_53267_length_457_cov_2.636872	117	197	0	2	80	0.0250000
NODE_53267_length_457_cov_2.636872	117	197	1	7	80	0.0875000
NODE_53267_length_457_cov_2.636872	117	197	2	47	80	0.5875000
NODE_53267_length_457_cov_2.636872	117	197	3	24	80	0.3000000
NODE_53462_length_457_cov_0.916201	108	188	0	80	80	1.0000000
NODE_53462_length_457_cov_0.916201	108	188	0	80	80	1.0000000
NODE_53462_length_457_cov_0.916201	161	241	0	80	80	1.0000000
NODE_53462_length_457_cov_0.916201	161	241	0	80	80	1.0000000
NODE_53512_length_456_cov_34.731092	0	63	3	43	63	0.6825397
NODE_53512_length_456_cov_34.731092	0	63	4	2	63	0.0317460
NODE_53512_length_456_cov_34.731092	0	63	5	13	63	0.2063492
NODE_53512_length_456_cov_34.731092	0	63	7	5	63	0.0793651
NODE_53512_length_456_cov_34.731092	36	116	3	7	80	0.0875000
NODE_53512_length_456_cov_34.731092	36	116	4	2	80	0.0250000
NODE_53512_length_456_cov_34.731092	36	116	5	13	80	0.1625000
NODE_53512_length_456_cov_34.731092	36	116	7	58	80	0.7250000
NODE_53512_length_456_cov_34.731092	112	194	2	1	82	0.0121951
NODE_53512_length_456_cov_34.731092	112	194	3	7	82	0.0853659
NODE_53512_length_456_cov_34.731092	112	194	4	9	82	0.1097561
NODE_53512_length_456_cov_34.731092	112	194	5	37	82	0.4512195
NODE_53512_length_456_cov_34.731092	112	194	6	5	82	0.0609756
NODE_53512_length_456_cov_34.731092	112	194	7	23	82	0.2804878
NODE_53532_length_456_cov_4.582633	269	349	0	80	80	1.0000000
NODE_53533_length_456_cov_4.554622	124	206	0	82	82	1.0000000
NODE_53533_length_456_cov_4.554622	179	263	0	76	84	0.9047619
NODE_53533_length_456_cov_4.554622	179	263	1	8	84	0.0952381
NODE_53546_length_456_cov_3.669468	123	186	1	25	63	0.3968254
NODE_53546_length_456_cov_3.669468	123	186	2	38	63	0.6031746
NODE_53566_length_456_cov_2.921569	302	362	0	60	60	1.0000000
NODE_53859_length_455_cov_113.589888	137	220	8	1	83	0.0120482
NODE_53859_length_455_cov_113.589888	137	220	9	29	83	0.3493976
NODE_53859_length_455_cov_113.589888	137	220	10	6	83	0.0722892
NODE_53859_length_455_cov_113.589888	137	220	11	4	83	0.0481928
NODE_53859_length_455_cov_113.589888	137	220	12	33	83	0.3975904
NODE_53859_length_455_cov_113.589888	137	220	13	10	83	0.1204819
NODE_53859_length_455_cov_113.589888	198	268	7	9	70	0.1285714
NODE_53859_length_455_cov_113.589888	198	268	8	11	70	0.1571429
NODE_53859_length_455_cov_113.589888	198	268	9	50	70	0.7142857
NODE_53859_length_455_cov_113.589888	269	348	4	9	79	0.1139240
NODE_53859_length_455_cov_113.589888	269	348	5	35	79	0.4430380
NODE_53859_length_455_cov_113.589888	269	348	6	12	79	0.1518987
NODE_53859_length_455_cov_113.589888	269	348	7	23	79	0.2911392
NODE_53859_length_455_cov_113.589888	321	401	5	16	80	0.2000000
NODE_53859_length_455_cov_113.589888	321	401	6	32	80	0.4000000
NODE_53859_length_455_cov_113.589888	321	401	7	32	80	0.4000000
NODE_53860_length_455_cov_52.941011	260	340	0	80	80	1.0000000
NODE_53860_length_455_cov_52.941011	313	393	0	80	80	1.0000000
NODE_53863_length_455_cov_8.584270	250	302	0	52	52	1.0000000
NODE_53863_length_455_cov_8.584270	275	355	0	80	80	1.0000000
NODE_53864_length_455_cov_8.084270	146	226	5	6	80	0.0750000
NODE_53864_length_455_cov_8.084270	146	226	7	1	80	0.0125000
NODE_53864_length_455_cov_8.084270	146	226	8	3	80	0.0375000
NODE_53864_length_455_cov_8.084270	146	226	9	15	80	0.1875000
NODE_53864_length_455_cov_8.084270	146	226	10	6	80	0.0750000
NODE_53864_length_455_cov_8.084270	146	226	14	7	80	0.0875000
NODE_53864_length_455_cov_8.084270	146	226	15	13	80	0.1625000
NODE_53864_length_455_cov_8.084270	146	226	16	28	80	0.3500000
NODE_53864_length_455_cov_8.084270	146	226	17	1	80	0.0125000
NODE_53864_length_455_cov_8.084270	199	279	4	21	80	0.2625000
NODE_53864_length_455_cov_8.084270	199	279	5	38	80	0.4750000
NODE_53864_length_455_cov_8.084270	199	279	7	1	80	0.0125000
NODE_53864_length_455_cov_8.084270	199	279	8	3	80	0.0375000
NODE_53864_length_455_cov_8.084270	199	279	9	15	80	0.1875000
NODE_53864_length_455_cov_8.084270	199	279	10	2	80	0.0250000
NODE_53870_length_455_cov_6.022472	122	203	0	81	81	1.0000000
NODE_53872_length_455_cov_5.140449	181	232	9	4	51	0.0784314
NODE_53872_length_455_cov_5.140449	181	232	10	6	51	0.1176471
NODE_53872_length_455_cov_5.140449	181	232	11	10	51	0.1960784
NODE_53872_length_455_cov_5.140449	181	232	12	8	51	0.1568628
NODE_53872_length_455_cov_5.140449	181	232	13	3	51	0.0588235
NODE_53872_length_455_cov_5.140449	181	232	14	20	51	0.3921569
NODE_54512_length_453_cov_29.528249	44	124	0	80	80	1.0000000
NODE_54512_length_453_cov_29.528249	97	177	0	80	80	1.0000000
NODE_54512_length_453_cov_29.528249	173	253	0	80	80	1.0000000
NODE_54512_length_453_cov_29.528249	226	301	0	75	75	1.0000000
NODE_54513_length_453_cov_11.146893	95	140	4	15	45	0.3333333
NODE_54513_length_453_cov_11.146893	95	140	5	20	45	0.4444444
NODE_54513_length_453_cov_11.146893	95	140	6	10	45	0.2222222
NODE_54513_length_453_cov_11.146893	146	220	6	7	74	0.0945946
NODE_54513_length_453_cov_11.146893	146	220	7	29	74	0.3918919
NODE_54513_length_453_cov_11.146893	146	220	8	21	74	0.2837838
NODE_54513_length_453_cov_11.146893	146	220	9	9	74	0.1216216
NODE_54513_length_453_cov_11.146893	146	220	10	8	74	0.1081081
NODE_54517_length_453_cov_7.709040	194	252	4	9	58	0.1551724
NODE_54517_length_453_cov_7.709040	194	252	5	1	58	0.0172414
NODE_54517_length_453_cov_7.709040	194	252	6	17	58	0.2931035
NODE_54517_length_453_cov_7.709040	194	252	7	31	58	0.5344828
NODE_54518_length_453_cov_7.440678	250	319	0	69	69	1.0000000
NODE_54533_length_453_cov_4.282486	190	270	0	12	80	0.1500000
NODE_54533_length_453_cov_4.282486	190	270	2	68	80	0.8500000
NODE_54533_length_453_cov_4.282486	243	283	2	40	40	1.0000000
NODE_54566_length_453_cov_2.836158	186	266	0	80	80	1.0000000
NODE_54566_length_453_cov_2.836158	239	319	0	80	80	1.0000000
NODE_54592_length_453_cov_2.048023	139	174	0	2	35	0.0571429
NODE_54592_length_453_cov_2.048023	139	174	2	7	35	0.2000000
NODE_54592_length_453_cov_2.048023	139	174	3	11	35	0.3142857
NODE_54592_length_453_cov_2.048023	139	174	4	5	35	0.1428571
NODE_54592_length_453_cov_2.048023	139	174	5	1	35	0.0285714
NODE_54592_length_453_cov_2.048023	139	174	6	6	35	0.1714286
NODE_54592_length_453_cov_2.048023	139	174	7	3	35	0.0857143
NODE_54600_length_453_cov_2.002825	78	98	0	20	20	1.0000000
NODE_54767_length_453_cov_0.774011	174	195	0	21	21	1.0000000
NODE_54822_length_452_cov_36.028329	0	72	0	31	72	0.4305556
NODE_54822_length_452_cov_36.028329	0	72	1	4	72	0.0555556
NODE_54822_length_452_cov_36.028329	0	72	2	14	72	0.1944444
NODE_54822_length_452_cov_36.028329	0	72	3	23	72	0.3194444
NODE_54822_length_452_cov_36.028329	0	72	0	31	72	0.4305556
NODE_54822_length_452_cov_36.028329	0	72	1	4	72	0.0555556
NODE_54822_length_452_cov_36.028329	0	72	2	14	72	0.1944444
NODE_54822_length_452_cov_36.028329	0	72	3	23	72	0.3194444
NODE_54822_length_452_cov_36.028329	45	99	2	4	54	0.0740741
NODE_54822_length_452_cov_36.028329	45	99	3	50	54	0.9259259
NODE_54822_length_452_cov_36.028329	45	125	2	4	80	0.0500000
NODE_54822_length_452_cov_36.028329	45	125	3	76	80	0.9500000
NODE_54823_length_452_cov_17.424929	29	109	1	54	80	0.6750000
NODE_54823_length_452_cov_17.424929	29	109	2	26	80	0.3250000
NODE_54823_length_452_cov_17.424929	82	162	1	1	80	0.0125000
NODE_54823_length_452_cov_17.424929	82	162	2	79	80	0.9875000
NODE_54844_length_452_cov_4.317280	141	200	0	59	59	1.0000000
NODE_54886_length_452_cov_2.634561	262	338	0	76	76	1.0000000
NODE_55146_length_451_cov_37.090909	230	310	0	35	80	0.4375000
NODE_55146_length_451_cov_37.090909	230	310	2	40	80	0.5000000
NODE_55146_length_451_cov_37.090909	230	310	4	5	80	0.0625000
NODE_55146_length_451_cov_37.090909	283	363	2	42	80	0.5250000
NODE_55146_length_451_cov_37.090909	283	363	4	38	80	0.4750000
NODE_55147_length_451_cov_16.517045	205	286	5	47	81	0.5802469
NODE_55147_length_451_cov_16.517045	205	286	6	10	81	0.1234568
NODE_55147_length_451_cov_16.517045	205	286	7	14	81	0.1728395
NODE_55147_length_451_cov_16.517045	205	286	9	10	81	0.1234568
NODE_55147_length_451_cov_16.517045	259	339	4	45	80	0.5625000
NODE_55147_length_451_cov_16.517045	259	339	6	18	80	0.2250000
NODE_55147_length_451_cov_16.517045	259	339	7	14	80	0.1750000
NODE_55147_length_451_cov_16.517045	259	339	9	3	80	0.0375000
NODE_55148_length_451_cov_13.153409	182	262	0	35	80	0.4375000
NODE_55148_length_451_cov_13.153409	182	262	1	32	80	0.4000000
NODE_55148_length_451_cov_13.153409	182	262	2	13	80	0.1625000
NODE_55148_length_451_cov_13.153409	235	315	0	80	80	1.0000000
NODE_55149_length_451_cov_11.926136	141	221	2	8	80	0.1000000
NODE_55149_length_451_cov_11.926136	141	221	3	72	80	0.9000000
NODE_55149_length_451_cov_11.926136	331	411	0	17	80	0.2125000
NODE_55149_length_451_cov_11.926136	331	411	1	63	80	0.7875000
NODE_55154_length_451_cov_7.102273	81	143	0	62	62	1.0000000
NODE_55161_length_451_cov_5.610795	1	31	0	30	30	1.0000000
NODE_55161_length_451_cov_5.610795	60	90	0	30	30	1.0000000
NODE_55166_length_451_cov_5.065341	219	285	4	66	66	1.0000000
NODE_55166_length_451_cov_5.065341	272	322	2	13	50	0.2600000
NODE_55166_length_451_cov_5.065341	272	322	4	37	50	0.7400000
NODE_55184_length_451_cov_3.696023	253	332	10	10	79	0.1265823
NODE_55184_length_451_cov_3.696023	253	332	11	20	79	0.2531646
NODE_55184_length_451_cov_3.696023	253	332	12	24	79	0.3037975
NODE_55184_length_451_cov_3.696023	253	332	13	6	79	0.0759494
NODE_55184_length_451_cov_3.696023	253	332	14	18	79	0.2278481
NODE_55184_length_451_cov_3.696023	253	332	15	1	79	0.0126582
NODE_55188_length_451_cov_3.406250	176	247	4	2	71	0.0281690
NODE_55188_length_451_cov_3.406250	176	247	6	8	71	0.1126761
NODE_55188_length_451_cov_3.406250	176	247	8	9	71	0.1267606
NODE_55188_length_451_cov_3.406250	176	247	9	52	71	0.7323943
NODE_55188_length_451_cov_3.406250	220	300	4	14	80	0.1750000
NODE_55188_length_451_cov_3.406250	220	300	6	12	80	0.1500000
NODE_55188_length_451_cov_3.406250	220	300	8	4	80	0.0500000
NODE_55188_length_451_cov_3.406250	220	300	9	47	80	0.5875000
NODE_55188_length_451_cov_3.406250	220	300	10	3	80	0.0375000
NODE_55198_length_451_cov_3.025568	72	148	0	22	76	0.2894737
NODE_55198_length_451_cov_3.025568	72	148	2	54	76	0.7105263
NODE_55213_length_451_cov_2.607955	84	143	0	59	59	1.0000000
NODE_55213_length_451_cov_2.607955	257	326	0	69	69	1.0000000
NODE_55234_length_451_cov_2.125000	156	224	0	68	68	1.0000000
NODE_55436_length_450_cov_105.723647	317	386	0	5	69	0.0724638
NODE_55436_length_450_cov_105.723647	317	386	1	62	69	0.8985507
NODE_55436_length_450_cov_105.723647	317	386	2	2	69	0.0289855
NODE_55438_length_450_cov_27.982906	98	120	1	12	22	0.5454546
NODE_55438_length_450_cov_27.982906	98	120	2	10	22	0.4545455
NODE_55438_length_450_cov_27.982906	225	305	5	12	80	0.1500000
NODE_55438_length_450_cov_27.982906	225	305	6	13	80	0.1625000
NODE_55438_length_450_cov_27.982906	225	305	7	30	80	0.3750000
NODE_55438_length_450_cov_27.982906	225	305	8	25	80	0.3125000
NODE_55438_length_450_cov_27.982906	278	358	3	6	80	0.0750000
NODE_55438_length_450_cov_27.982906	278	358	4	43	80	0.5375000
NODE_55438_length_450_cov_27.982906	278	358	5	16	80	0.2000000
NODE_55438_length_450_cov_27.982906	278	358	6	13	80	0.1625000
NODE_55438_length_450_cov_27.982906	278	358	7	2	80	0.0250000
NODE_55459_length_450_cov_3.991453	220	290	0	70	70	1.0000000
NODE_55459_length_450_cov_3.991453	223	290	0	67	67	1.0000000
NODE_55459_length_450_cov_3.991453	268	348	0	80	80	1.0000000
NODE_55459_length_450_cov_3.991453	268	348	0	80	80	1.0000000
NODE_55459_length_450_cov_3.991453	278	348	0	70	70	1.0000000
NODE_55459_length_450_cov_3.991453	344	363	0	19	19	1.0000000
NODE_55466_length_450_cov_3.717949	107	177	0	70	70	1.0000000
NODE_55483_length_450_cov_3.162393	99	157	1	55	58	0.9482759
NODE_55483_length_450_cov_3.162393	99	157	2	3	58	0.0517241
NODE_55550_length_450_cov_1.857550	114	172	7	1	58	0.0172414
NODE_55550_length_450_cov_1.857550	114	172	11	4	58	0.0689655
NODE_55550_length_450_cov_1.857550	114	172	12	7	58	0.1206897
NODE_55550_length_450_cov_1.857550	114	172	14	5	58	0.0862069
NODE_55550_length_450_cov_1.857550	114	172	15	3	58	0.0517241
NODE_55550_length_450_cov_1.857550	114	172	17	6	58	0.1034483
NODE_55550_length_450_cov_1.857550	114	172	19	3	58	0.0517241
NODE_55550_length_450_cov_1.857550	114	172	20	2	58	0.0344828
NODE_55550_length_450_cov_1.857550	114	172	21	4	58	0.0689655
NODE_55550_length_450_cov_1.857550	114	172	23	1	58	0.0172414
NODE_55550_length_450_cov_1.857550	114	172	26	11	58	0.1896552
NODE_55550_length_450_cov_1.857550	114	172	27	3	58	0.0517241
NODE_55550_length_450_cov_1.857550	114	172	29	1	58	0.0172414
NODE_55550_length_450_cov_1.857550	114	172	31	7	58	0.1206897
NODE_55560_length_450_cov_1.749288	321	376	0	55	55	1.0000000
NODE_55565_length_450_cov_1.723647	101	161	6	16	60	0.2666667
NODE_55565_length_450_cov_1.723647	101	161	8	14	60	0.2333333
NODE_55565_length_450_cov_1.723647	101	161	10	30	60	0.5000000
NODE_55685_length_450_cov_1.017094	116	196	0	80	80	1.0000000
NODE_55761_length_449_cov_46.882857	237	317	10	13	80	0.1625000
NODE_55761_length_449_cov_46.882857	237	317	11	14	80	0.1750000
NODE_55761_length_449_cov_46.882857	237	317	13	2	80	0.0250000
NODE_55761_length_449_cov_46.882857	237	317	14	3	80	0.0375000
NODE_55761_length_449_cov_46.882857	237	317	15	8	80	0.1000000
NODE_55761_length_449_cov_46.882857	237	317	16	31	80	0.3875000
NODE_55761_length_449_cov_46.882857	237	317	17	9	80	0.1125000
NODE_55761_length_449_cov_46.882857	290	370	13	8	80	0.1000000
NODE_55761_length_449_cov_46.882857	290	370	14	6	80	0.0750000
NODE_55761_length_449_cov_46.882857	290	370	15	9	80	0.1125000
NODE_55761_length_449_cov_46.882857	290	370	16	28	80	0.3500000
NODE_55761_length_449_cov_46.882857	290	370	17	29	80	0.3625000
NODE_55762_length_449_cov_36.031429	238	318	0	41	80	0.5125000
NODE_55762_length_449_cov_36.031429	238	318	2	39	80	0.4875000
NODE_55762_length_449_cov_36.031429	291	371	2	80	80	1.0000000
NODE_55783_length_449_cov_4.594286	137	184	3	47	47	1.0000000
NODE_55794_length_449_cov_3.797143	204	284	0	55	80	0.6875000
NODE_55794_length_449_cov_3.797143	204	284	1	10	80	0.1250000
NODE_55794_length_449_cov_3.797143	204	284	2	11	80	0.1375000
NODE_55794_length_449_cov_3.797143	204	284	3	2	80	0.0250000
NODE_55794_length_449_cov_3.797143	204	284	5	2	80	0.0250000
NODE_55844_length_449_cov_2.445714	346	376	0	30	30	1.0000000
NODE_56144_length_448_cov_44.664756	126	206	0	80	80	1.0000000
NODE_56144_length_448_cov_44.664756	179	259	0	80	80	1.0000000
NODE_56145_length_448_cov_36.148997	195	275	0	80	80	1.0000000
NODE_56145_length_448_cov_36.148997	248	328	0	80	80	1.0000000
NODE_56145_length_448_cov_36.148997	324	404	0	80	80	1.0000000
NODE_56145_length_448_cov_36.148997	377	448	0	71	71	1.0000000
NODE_56146_length_448_cov_31.816619	43	123	0	80	80	1.0000000
NODE_56151_length_448_cov_6.779370	197	277	0	66	80	0.8250000
NODE_56151_length_448_cov_6.779370	197	277	1	14	80	0.1750000
NODE_56151_length_448_cov_6.779370	250	313	0	13	63	0.2063492
NODE_56151_length_448_cov_6.779370	250	313	1	50	63	0.7936508
NODE_56180_length_448_cov_3.664756	148	189	2	39	41	0.9512195
NODE_56180_length_448_cov_3.664756	148	189	3	2	41	0.0487805
NODE_56189_length_448_cov_3.108883	242	324	4	46	82	0.5609756
NODE_56189_length_448_cov_3.108883	242	324	5	22	82	0.2682927
NODE_56189_length_448_cov_3.108883	242	324	6	14	82	0.1707317
NODE_56233_length_448_cov_2.263610	292	360	0	53	68	0.7794118
NODE_56233_length_448_cov_2.263610	292	360	1	15	68	0.2205882
NODE_56518_length_447_cov_10.505747	205	234	0	26	29	0.8965517
NODE_56518_length_447_cov_10.505747	205	234	2	3	29	0.1034483
NODE_56518_length_447_cov_10.505747	267	326	2	45	59	0.7627119
NODE_56518_length_447_cov_10.505747	267	326	3	2	59	0.0338983
NODE_56518_length_447_cov_10.505747	267	326	4	12	59	0.2033898
NODE_56518_length_447_cov_10.505747	299	379	2	13	80	0.1625000
NODE_56518_length_447_cov_10.505747	299	379	3	2	80	0.0250000
NODE_56518_length_447_cov_10.505747	299	379	4	65	80	0.8125000
NODE_56527_length_447_cov_5.767241	176	256	0	52	80	0.6500000
NODE_56527_length_447_cov_5.767241	176	256	2	28	80	0.3500000
NODE_56527_length_447_cov_5.767241	229	309	0	59	80	0.7375000
NODE_56527_length_447_cov_5.767241	229	309	2	21	80	0.2625000
NODE_56539_length_447_cov_4.583333	265	289	0	1	24	0.0416667
NODE_56539_length_447_cov_4.583333	265	289	1	12	24	0.5000000
NODE_56539_length_447_cov_4.583333	265	289	2	11	24	0.4583333
NODE_56545_length_447_cov_4.037356	58	138	0	80	80	1.0000000
NODE_56545_length_447_cov_4.037356	111	191	0	80	80	1.0000000
NODE_56890_length_446_cov_42.527378	239	310	6	28	71	0.3943662
NODE_56890_length_446_cov_42.527378	239	310	8	1	71	0.0140845
NODE_56890_length_446_cov_42.527378	239	310	10	9	71	0.1267606
NODE_56890_length_446_cov_42.527378	239	310	11	20	71	0.2816902
NODE_56890_length_446_cov_42.527378	239	310	12	7	71	0.0985916
NODE_56890_length_446_cov_42.527378	239	310	14	1	71	0.0140845
NODE_56890_length_446_cov_42.527378	239	310	15	1	71	0.0140845
NODE_56890_length_446_cov_42.527378	239	310	17	4	71	0.0563380
NODE_56890_length_446_cov_42.527378	359	433	6	6	74	0.0810811
NODE_56890_length_446_cov_42.527378	359	433	9	27	74	0.3648649
NODE_56890_length_446_cov_42.527378	359	433	11	10	74	0.1351351
NODE_56890_length_446_cov_42.527378	359	433	13	6	74	0.0810811
NODE_56890_length_446_cov_42.527378	359	433	15	18	74	0.2432432
NODE_56890_length_446_cov_42.527378	359	433	16	7	74	0.0945946
NODE_56891_length_446_cov_12.749280	92	172	1	42	80	0.5250000
NODE_56891_length_446_cov_12.749280	92	172	2	23	80	0.2875000
NODE_56891_length_446_cov_12.749280	92	172	3	15	80	0.1875000
NODE_56891_length_446_cov_12.749280	145	225	2	12	80	0.1500000
NODE_56891_length_446_cov_12.749280	145	225	3	23	80	0.2875000
NODE_56891_length_446_cov_12.749280	145	225	4	37	80	0.4625000
NODE_56891_length_446_cov_12.749280	145	225	5	8	80	0.1000000
NODE_56896_length_446_cov_6.902017	175	217	0	42	42	1.0000000
NODE_56902_length_446_cov_5.930836	165	245	2	24	80	0.3000000
NODE_56902_length_446_cov_5.930836	165	245	3	43	80	0.5375000
NODE_56902_length_446_cov_5.930836	165	245	4	13	80	0.1625000
NODE_56902_length_446_cov_5.930836	165	245	2	24	80	0.3000000
NODE_56902_length_446_cov_5.930836	165	245	3	43	80	0.5375000
NODE_56902_length_446_cov_5.930836	165	245	4	13	80	0.1625000
NODE_56902_length_446_cov_5.930836	165	235	2	24	70	0.3428572
NODE_56902_length_446_cov_5.930836	165	235	3	43	70	0.6142857
NODE_56902_length_446_cov_5.930836	165	235	4	3	70	0.0428571
NODE_56902_length_446_cov_5.930836	218	298	3	14	80	0.1750000
NODE_56902_length_446_cov_5.930836	218	298	4	15	80	0.1875000
NODE_56902_length_446_cov_5.930836	218	298	6	39	80	0.4875000
NODE_56902_length_446_cov_5.930836	218	298	7	12	80	0.1500000
NODE_56902_length_446_cov_5.930836	218	297	3	14	79	0.1772152
NODE_56902_length_446_cov_5.930836	218	297	4	15	79	0.1898734
NODE_56902_length_446_cov_5.930836	218	297	6	39	79	0.4936709
NODE_56902_length_446_cov_5.930836	218	297	7	11	79	0.1392405
NODE_56919_length_446_cov_3.896254	215	274	0	59	59	1.0000000
NODE_56934_length_446_cov_3.282421	130	168	1	31	38	0.8157895
NODE_56934_length_446_cov_3.282421	130	168	2	7	38	0.1842105
NODE_56952_length_446_cov_2.775216	337	417	0	57	80	0.7125000
NODE_56952_length_446_cov_2.775216	337	417	1	23	80	0.2875000
NODE_56995_length_446_cov_2.161383	17	97	0	80	80	1.0000000
NODE_57022_length_446_cov_1.907781	196	225	0	29	29	1.0000000
NODE_57277_length_445_cov_75.572254	108	188	0	80	80	1.0000000
NODE_57277_length_445_cov_75.572254	161	241	0	56	80	0.7000000
NODE_57277_length_445_cov_75.572254	161	241	2	24	80	0.3000000
NODE_57277_length_445_cov_75.572254	237	317	2	20	80	0.2500000
NODE_57277_length_445_cov_75.572254	237	317	4	60	80	0.7500000
NODE_57277_length_445_cov_75.572254	290	370	2	3	80	0.0375000
NODE_57277_length_445_cov_75.572254	290	370	4	77	80	0.9625000
NODE_57278_length_445_cov_33.973988	83	163	0	35	80	0.4375000
NODE_57278_length_445_cov_33.973988	83	163	2	45	80	0.5625000
NODE_57278_length_445_cov_33.973988	136	216	2	80	80	1.0000000
NODE_57280_length_445_cov_9.323699	78	148	2	70	70	1.0000000
NODE_57280_length_445_cov_9.323699	121	201	1	23	80	0.2875000
NODE_57280_length_445_cov_9.323699	121	201	2	57	80	0.7125000
NODE_57284_length_445_cov_6.439306	210	282	0	7	72	0.0972222
NODE_57284_length_445_cov_6.439306	210	282	1	56	72	0.7777778
NODE_57284_length_445_cov_6.439306	210	282	3	9	72	0.1250000
NODE_57286_length_445_cov_5.479769	115	184	0	69	69	1.0000000
NODE_57286_length_445_cov_5.479769	157	237	0	80	80	1.0000000
NODE_57286_length_445_cov_5.479769	233	309	0	59	76	0.7763158
NODE_57286_length_445_cov_5.479769	233	309	2	16	76	0.2105263
NODE_57286_length_445_cov_5.479769	233	309	5	1	76	0.0131579
NODE_57286_length_445_cov_5.479769	286	309	0	6	23	0.2608696
NODE_57286_length_445_cov_5.479769	286	309	2	16	23	0.6956522
NODE_57286_length_445_cov_5.479769	286	309	5	1	23	0.0434783
NODE_57345_length_445_cov_2.843931	124	199	0	75	75	1.0000000
NODE_57352_length_445_cov_2.682081	202	248	0	46	46	1.0000000
NODE_57400_length_445_cov_1.884393	252	332	1	80	80	1.0000000
NODE_57409_length_445_cov_1.783237	132	203	3	13	71	0.1830986
NODE_57409_length_445_cov_1.783237	132	203	5	1	71	0.0140845
NODE_57409_length_445_cov_1.783237	132	203	6	6	71	0.0845070
NODE_57409_length_445_cov_1.783237	132	203	7	51	71	0.7183099
NODE_57409_length_445_cov_1.783237	256	331	1	71	75	0.9466667
NODE_57409_length_445_cov_1.783237	256	331	3	4	75	0.0533333
NODE_57409_length_445_cov_1.783237	256	278	1	18	22	0.8181818
NODE_57409_length_445_cov_1.783237	256	278	3	4	22	0.1818182
NODE_57644_length_444_cov_34.075362	243	323	5	49	80	0.6125000
NODE_57644_length_444_cov_34.075362	243	323	6	31	80	0.3875000
NODE_57644_length_444_cov_34.075362	296	376	2	25	80	0.3125000
NODE_57644_length_444_cov_34.075362	296	376	4	24	80	0.3000000
NODE_57644_length_444_cov_34.075362	296	376	5	31	80	0.3875000
NODE_57645_length_444_cov_22.524638	98	178	0	80	80	1.0000000
NODE_57645_length_444_cov_22.524638	151	231	0	80	80	1.0000000
NODE_57646_length_444_cov_16.544928	263	343	1	71	80	0.8875000
NODE_57646_length_444_cov_16.544928	263	343	2	9	80	0.1125000
NODE_57646_length_444_cov_16.544928	316	396	1	80	80	1.0000000
NODE_57647_length_444_cov_12.684058	293	373	0	80	80	1.0000000
NODE_57647_length_444_cov_12.684058	346	426	0	80	80	1.0000000
NODE_57649_length_444_cov_9.284058	176	256	0	80	80	1.0000000
NODE_57649_length_444_cov_9.284058	229	309	0	80	80	1.0000000
NODE_57666_length_444_cov_5.159420	170	241	2	31	71	0.4366197
NODE_57666_length_444_cov_5.159420	170	241	3	12	71	0.1690141
NODE_57666_length_444_cov_5.159420	170	241	4	28	71	0.3943662
NODE_57668_length_444_cov_5.060870	201	245	0	44	44	1.0000000
NODE_57668_length_444_cov_5.060870	218	298	0	80	80	1.0000000
NODE_57717_length_444_cov_2.744928	73	136	1	27	63	0.4285714
NODE_57717_length_444_cov_2.744928	73	136	2	36	63	0.5714286
NODE_57770_length_444_cov_2.028986	46	113	20	2	67	0.0298507
NODE_57770_length_444_cov_2.028986	46	113	22	2	67	0.0298507
NODE_57770_length_444_cov_2.028986	46	113	27	5	67	0.0746269
NODE_57770_length_444_cov_2.028986	46	113	29	3	67	0.0447761
NODE_57770_length_444_cov_2.028986	46	113	30	1	67	0.0149254
NODE_57770_length_444_cov_2.028986	46	113	31	2	67	0.0298507
NODE_57770_length_444_cov_2.028986	46	113	32	2	67	0.0298507
NODE_57770_length_444_cov_2.028986	46	113	33	2	67	0.0298507
NODE_57770_length_444_cov_2.028986	46	113	34	1	67	0.0149254
NODE_57770_length_444_cov_2.028986	46	113	36	2	67	0.0298507
NODE_57770_length_444_cov_2.028986	46	113	37	5	67	0.0746269
NODE_57770_length_444_cov_2.028986	46	113	38	3	67	0.0447761
NODE_57770_length_444_cov_2.028986	46	113	39	1	67	0.0149254
NODE_57770_length_444_cov_2.028986	46	113	41	3	67	0.0447761
NODE_57770_length_444_cov_2.028986	46	113	43	2	67	0.0298507
NODE_57770_length_444_cov_2.028986	46	113	46	3	67	0.0447761
NODE_57770_length_444_cov_2.028986	46	113	47	6	67	0.0895522
NODE_57770_length_444_cov_2.028986	46	113	48	4	67	0.0597015
NODE_57770_length_444_cov_2.028986	46	113	49	3	67	0.0447761
NODE_57770_length_444_cov_2.028986	46	113	50	3	67	0.0447761
NODE_57770_length_444_cov_2.028986	46	113	51	1	67	0.0149254
NODE_57770_length_444_cov_2.028986	46	113	52	2	67	0.0298507
NODE_57770_length_444_cov_2.028986	46	113	54	1	67	0.0149254
NODE_57770_length_444_cov_2.028986	46	113	57	3	67	0.0447761
NODE_57770_length_444_cov_2.028986	46	113	59	5	67	0.0746269
NODE_57770_length_444_cov_2.028986	86	166	47	5	80	0.0625000
NODE_57770_length_444_cov_2.028986	86	166	48	4	80	0.0500000
NODE_57770_length_444_cov_2.028986	86	166	49	3	80	0.0375000
NODE_57770_length_444_cov_2.028986	86	166	50	3	80	0.0375000
NODE_57770_length_444_cov_2.028986	86	166	51	1	80	0.0125000
NODE_57770_length_444_cov_2.028986	86	166	52	2	80	0.0250000
NODE_57770_length_444_cov_2.028986	86	166	54	1	80	0.0125000
NODE_57770_length_444_cov_2.028986	86	166	57	4	80	0.0500000
NODE_57770_length_444_cov_2.028986	86	166	58	10	80	0.1250000
NODE_57770_length_444_cov_2.028986	86	166	59	11	80	0.1375000
NODE_57770_length_444_cov_2.028986	86	166	60	7	80	0.0875000
NODE_57770_length_444_cov_2.028986	86	166	61	5	80	0.0625000
NODE_57770_length_444_cov_2.028986	86	166	62	5	80	0.0625000
NODE_57770_length_444_cov_2.028986	86	166	63	5	80	0.0625000
NODE_57770_length_444_cov_2.028986	86	166	64	5	80	0.0625000
NODE_57770_length_444_cov_2.028986	86	166	65	1	80	0.0125000
NODE_57770_length_444_cov_2.028986	86	166	66	8	80	0.1000000
NODE_57873_length_444_cov_1.234783	335	407	0	72	72	1.0000000
NODE_57892_length_444_cov_1.173913	7	87	0	80	80	1.0000000
NODE_58026_length_443_cov_71.284884	209	289	13	7	80	0.0875000
NODE_58026_length_443_cov_71.284884	209	289	14	3	80	0.0375000
NODE_58026_length_443_cov_71.284884	209	289	16	1	80	0.0125000
NODE_58026_length_443_cov_71.284884	209	289	17	10	80	0.1250000
NODE_58026_length_443_cov_71.284884	209	289	18	19	80	0.2375000
NODE_58026_length_443_cov_71.284884	209	289	19	13	80	0.1625000
NODE_58026_length_443_cov_71.284884	209	289	20	24	80	0.3000000
NODE_58026_length_443_cov_71.284884	209	289	21	3	80	0.0375000
NODE_58026_length_443_cov_71.284884	262	342	14	19	80	0.2375000
NODE_58026_length_443_cov_71.284884	262	342	15	2	80	0.0250000
NODE_58026_length_443_cov_71.284884	262	342	16	3	80	0.0375000
NODE_58026_length_443_cov_71.284884	262	342	17	12	80	0.1500000
NODE_58026_length_443_cov_71.284884	262	342	18	12	80	0.1500000
NODE_58026_length_443_cov_71.284884	262	342	19	13	80	0.1625000
NODE_58026_length_443_cov_71.284884	262	342	20	16	80	0.2000000
NODE_58026_length_443_cov_71.284884	262	342	21	3	80	0.0375000
NODE_58026_length_443_cov_71.284884	338	418	3	1	80	0.0125000
NODE_58026_length_443_cov_71.284884	338	418	6	47	80	0.5875000
NODE_58026_length_443_cov_71.284884	338	418	7	1	80	0.0125000
NODE_58026_length_443_cov_71.284884	338	418	9	3	80	0.0375000
NODE_58026_length_443_cov_71.284884	338	418	10	5	80	0.0625000
NODE_58026_length_443_cov_71.284884	338	418	12	7	80	0.0875000
NODE_58026_length_443_cov_71.284884	338	418	14	6	80	0.0750000
NODE_58026_length_443_cov_71.284884	338	418	15	8	80	0.1000000
NODE_58026_length_443_cov_71.284884	338	418	16	2	80	0.0250000
NODE_58026_length_443_cov_71.284884	391	443	0	5	52	0.0961538
NODE_58026_length_443_cov_71.284884	391	443	2	10	52	0.1923077
NODE_58026_length_443_cov_71.284884	391	443	3	11	52	0.2115385
NODE_58026_length_443_cov_71.284884	391	443	6	26	52	0.5000000
NODE_58027_length_443_cov_68.973837	314	394	0	4	80	0.0500000
NODE_58027_length_443_cov_68.973837	314	394	1	7	80	0.0875000
NODE_58027_length_443_cov_68.973837	314	394	2	69	80	0.8625000
NODE_58027_length_443_cov_68.973837	367	443	0	53	76	0.6973684
NODE_58027_length_443_cov_68.973837	367	443	1	7	76	0.0921053
NODE_58027_length_443_cov_68.973837	367	443	2	16	76	0.2105263
NODE_58028_length_443_cov_61.116279	34	114	1	30	80	0.3750000
NODE_58028_length_443_cov_61.116279	34	114	5	6	80	0.0750000
NODE_58028_length_443_cov_61.116279	34	114	6	44	80	0.5500000
NODE_58028_length_443_cov_61.116279	87	167	6	80	80	1.0000000
NODE_58041_length_443_cov_4.895349	127	207	0	80	80	1.0000000
NODE_58086_length_443_cov_2.581395	121	195	0	74	74	1.0000000
NODE_58088_length_443_cov_2.508721	297	347	0	50	50	1.0000000
NODE_58088_length_443_cov_2.508721	320	395	0	75	75	1.0000000
NODE_58091_length_443_cov_2.456395	114	192	1	78	78	1.0000000
NODE_58091_length_443_cov_2.456395	118	141	1	23	23	1.0000000
NODE_58237_length_443_cov_1.151163	144	224	0	20	80	0.2500000
NODE_58237_length_443_cov_1.151163	144	224	2	60	80	0.7500000
NODE_58321_length_443_cov_0.715116	52	104	1	52	52	1.0000000
NODE_58321_length_443_cov_0.715116	105	146	1	34	41	0.8292683
NODE_58321_length_443_cov_0.715116	105	146	2	7	41	0.1707317
NODE_58346_length_442_cov_42.956268	290	375	2	10	85	0.1176471
NODE_58346_length_442_cov_42.956268	290	375	4	13	85	0.1529412
NODE_58346_length_442_cov_42.956268	290	375	6	62	85	0.7294118
NODE_58346_length_442_cov_42.956268	290	375	2	10	85	0.1176471
NODE_58346_length_442_cov_42.956268	290	375	4	13	85	0.1529412
NODE_58346_length_442_cov_42.956268	290	375	6	62	85	0.7294118
NODE_58347_length_442_cov_24.093294	225	305	0	17	80	0.2125000
NODE_58347_length_442_cov_24.093294	225	305	2	63	80	0.7875000
NODE_58347_length_442_cov_24.093294	278	358	0	11	80	0.1375000
NODE_58347_length_442_cov_24.093294	278	358	2	69	80	0.8625000
NODE_58348_length_442_cov_8.956268	173	192	0	19	19	1.0000000
NODE_58361_length_442_cov_5.052478	213	293	0	80	80	1.0000000
NODE_58361_length_442_cov_5.052478	266	346	0	80	80	1.0000000
NODE_58376_length_442_cov_3.871720	297	372	0	75	75	1.0000000
NODE_58376_length_442_cov_3.871720	360	413	0	53	53	1.0000000
NODE_58378_length_442_cov_3.804665	211	244	0	32	33	0.9696970
NODE_58378_length_442_cov_3.804665	211	244	2	1	33	0.0303030
NODE_58405_length_442_cov_3.206997	149	217	0	24	68	0.3529412
NODE_58405_length_442_cov_3.206997	149	217	2	27	68	0.3970588
NODE_58405_length_442_cov_3.206997	149	217	4	9	68	0.1323529
NODE_58405_length_442_cov_3.206997	149	217	5	8	68	0.1176471
NODE_58438_length_442_cov_2.434402	203	274	10	6	71	0.0845070
NODE_58438_length_442_cov_2.434402	203	274	12	1	71	0.0140845
NODE_58438_length_442_cov_2.434402	203	274	13	27	71	0.3802817
NODE_58438_length_442_cov_2.434402	203	274	14	37	71	0.5211267
NODE_58438_length_442_cov_2.434402	247	327	14	48	80	0.6000000
NODE_58438_length_442_cov_2.434402	247	327	16	32	80	0.4000000
NODE_58503_length_442_cov_1.746356	95	161	11	4	66	0.0606061
NODE_58503_length_442_cov_1.746356	95	161	12	16	66	0.2424242
NODE_58503_length_442_cov_1.746356	95	161	13	21	66	0.3181818
NODE_58503_length_442_cov_1.746356	95	161	14	25	66	0.3787879
NODE_58503_length_442_cov_1.746356	95	122	13	13	27	0.4814815
NODE_58503_length_442_cov_1.746356	95	122	14	14	27	0.5185185
NODE_58759_length_441_cov_21.877193	28	108	1	80	80	1.0000000
NODE_58759_length_441_cov_21.877193	81	161	1	75	80	0.9375000
NODE_58759_length_441_cov_21.877193	81	161	2	5	80	0.0625000
NODE_58760_length_441_cov_13.546784	152	232	0	4	80	0.0500000
NODE_58760_length_441_cov_13.546784	152	232	2	76	80	0.9500000
NODE_58760_length_441_cov_13.546784	205	285	0	57	80	0.7125000
NODE_58760_length_441_cov_13.546784	205	285	2	23	80	0.2875000
NODE_58771_length_441_cov_5.710526	200	280	0	62	80	0.7750000
NODE_58771_length_441_cov_5.710526	200	280	1	18	80	0.2250000
NODE_58771_length_441_cov_5.710526	253	333	0	9	80	0.1125000
NODE_58771_length_441_cov_5.710526	253	333	1	71	80	0.8875000
NODE_58817_length_441_cov_3.096491	240	324	0	78	84	0.9285714
NODE_58817_length_441_cov_3.096491	240	324	2	6	84	0.0714286
NODE_58820_length_441_cov_3.023392	105	163	0	58	58	1.0000000
NODE_58852_length_441_cov_2.438596	19	99	1	25	80	0.3125000
NODE_58852_length_441_cov_2.438596	19	99	2	15	80	0.1875000
NODE_58852_length_441_cov_2.438596	19	99	3	39	80	0.4875000
NODE_58852_length_441_cov_2.438596	19	99	4	1	80	0.0125000
NODE_58852_length_441_cov_2.438596	72	126	3	26	54	0.4814815
NODE_58852_length_441_cov_2.438596	72	126	4	17	54	0.3148148
NODE_58852_length_441_cov_2.438596	72	126	5	11	54	0.2037037
NODE_58970_length_441_cov_1.435673	105	156	0	51	51	1.0000000
NODE_59142_length_440_cov_43.131965	122	202	3	73	80	0.9125000
NODE_59142_length_440_cov_43.131965	122	202	4	7	80	0.0875000
NODE_59142_length_440_cov_43.131965	175	255	2	28	80	0.3500000
NODE_59142_length_440_cov_43.131965	175	255	3	29	80	0.3625000
NODE_59142_length_440_cov_43.131965	175	255	4	23	80	0.2875000
NODE_59142_length_440_cov_43.131965	251	331	2	6	80	0.0750000
NODE_59142_length_440_cov_43.131965	251	331	3	74	80	0.9250000
NODE_59142_length_440_cov_43.131965	304	384	2	41	80	0.5125000
NODE_59142_length_440_cov_43.131965	304	384	3	39	80	0.4875000
NODE_59143_length_440_cov_42.929619	116	196	4	80	80	1.0000000
NODE_59143_length_440_cov_42.929619	169	249	1	22	80	0.2750000
NODE_59143_length_440_cov_42.929619	169	249	2	21	80	0.2625000
NODE_59143_length_440_cov_42.929619	169	249	4	37	80	0.4625000
NODE_59147_length_440_cov_8.164223	45	125	0	80	80	1.0000000
NODE_59147_length_440_cov_8.164223	98	178	0	80	80	1.0000000
NODE_59157_length_440_cov_5.193548	146	210	1	21	64	0.3281250
NODE_59157_length_440_cov_5.193548	146	210	2	16	64	0.2500000
NODE_59157_length_440_cov_5.193548	146	210	3	27	64	0.4218750
NODE_59157_length_440_cov_5.193548	146	210	1	21	64	0.3281250
NODE_59157_length_440_cov_5.193548	146	210	2	16	64	0.2500000
NODE_59157_length_440_cov_5.193548	146	210	3	27	64	0.4218750
NODE_59157_length_440_cov_5.193548	146	210	1	21	64	0.3281250
NODE_59157_length_440_cov_5.193548	146	210	2	16	64	0.2500000
NODE_59157_length_440_cov_5.193548	146	210	3	27	64	0.4218750
NODE_59164_length_440_cov_4.595308	153	233	2	80	80	1.0000000
NODE_59164_length_440_cov_4.595308	153	180	2	27	27	1.0000000
NODE_59188_length_440_cov_3.431085	84	150	0	66	66	1.0000000
NODE_59191_length_440_cov_3.331378	139	195	0	8	56	0.1428571
NODE_59191_length_440_cov_3.331378	139	195	2	48	56	0.8571429
NODE_59517_length_439_cov_76.552941	0	68	1	7	68	0.1029412
NODE_59517_length_439_cov_76.552941	0	68	2	2	68	0.0294118
NODE_59517_length_439_cov_76.552941	0	68	4	21	68	0.3088235
NODE_59517_length_439_cov_76.552941	0	68	6	9	68	0.1323529
NODE_59517_length_439_cov_76.552941	0	68	7	15	68	0.2205882
NODE_59517_length_439_cov_76.552941	0	68	8	2	68	0.0294118
NODE_59517_length_439_cov_76.552941	0	68	9	10	68	0.1470588
NODE_59517_length_439_cov_76.552941	0	68	11	2	68	0.0294118
NODE_59517_length_439_cov_76.552941	0	68	1	7	68	0.1029412
NODE_59517_length_439_cov_76.552941	0	68	2	2	68	0.0294118
NODE_59517_length_439_cov_76.552941	0	68	4	21	68	0.3088235
NODE_59517_length_439_cov_76.552941	0	68	6	9	68	0.1323529
NODE_59517_length_439_cov_76.552941	0	68	7	15	68	0.2205882
NODE_59517_length_439_cov_76.552941	0	68	8	2	68	0.0294118
NODE_59517_length_439_cov_76.552941	0	68	9	10	68	0.1470588
NODE_59517_length_439_cov_76.552941	0	68	11	2	68	0.0294118
NODE_59517_length_439_cov_76.552941	0	68	1	7	68	0.1029412
NODE_59517_length_439_cov_76.552941	0	68	2	2	68	0.0294118
NODE_59517_length_439_cov_76.552941	0	68	4	21	68	0.3088235
NODE_59517_length_439_cov_76.552941	0	68	6	9	68	0.1323529
NODE_59517_length_439_cov_76.552941	0	68	7	15	68	0.2205882
NODE_59517_length_439_cov_76.552941	0	68	8	2	68	0.0294118
NODE_59517_length_439_cov_76.552941	0	68	9	10	68	0.1470588
NODE_59517_length_439_cov_76.552941	0	68	11	2	68	0.0294118
NODE_59517_length_439_cov_76.552941	1	68	1	6	67	0.0895522
NODE_59517_length_439_cov_76.552941	1	68	2	2	67	0.0298507
NODE_59517_length_439_cov_76.552941	1	68	4	21	67	0.3134328
NODE_59517_length_439_cov_76.552941	1	68	6	9	67	0.1343284
NODE_59517_length_439_cov_76.552941	1	68	7	15	67	0.2238806
NODE_59517_length_439_cov_76.552941	1	68	8	2	67	0.0298507
NODE_59517_length_439_cov_76.552941	1	68	9	10	67	0.1492537
NODE_59517_length_439_cov_76.552941	1	68	11	2	67	0.0298507
NODE_59517_length_439_cov_76.552941	64	144	9	2	80	0.0250000
NODE_59517_length_439_cov_76.552941	64	144	11	15	80	0.1875000
NODE_59517_length_439_cov_76.552941	64	144	12	1	80	0.0125000
NODE_59517_length_439_cov_76.552941	64	144	13	12	80	0.1500000
NODE_59517_length_439_cov_76.552941	64	144	14	15	80	0.1875000
NODE_59517_length_439_cov_76.552941	64	144	15	20	80	0.2500000
NODE_59517_length_439_cov_76.552941	64	144	16	15	80	0.1875000
NODE_59517_length_439_cov_76.552941	64	144	9	2	80	0.0250000
NODE_59517_length_439_cov_76.552941	64	144	11	15	80	0.1875000
NODE_59517_length_439_cov_76.552941	64	144	12	1	80	0.0125000
NODE_59517_length_439_cov_76.552941	64	144	13	12	80	0.1500000
NODE_59517_length_439_cov_76.552941	64	144	14	15	80	0.1875000
NODE_59517_length_439_cov_76.552941	64	144	15	20	80	0.2500000
NODE_59517_length_439_cov_76.552941	64	144	16	15	80	0.1875000
NODE_59517_length_439_cov_76.552941	117	197	11	15	80	0.1875000
NODE_59517_length_439_cov_76.552941	117	197	12	14	80	0.1750000
NODE_59517_length_439_cov_76.552941	117	197	13	11	80	0.1375000
NODE_59517_length_439_cov_76.552941	117	197	14	12	80	0.1500000
NODE_59517_length_439_cov_76.552941	117	197	15	13	80	0.1625000
NODE_59517_length_439_cov_76.552941	117	197	16	15	80	0.1875000
NODE_59517_length_439_cov_76.552941	117	195	11	15	78	0.1923077
NODE_59517_length_439_cov_76.552941	117	195	12	12	78	0.1538462
NODE_59517_length_439_cov_76.552941	117	195	13	11	78	0.1410256
NODE_59517_length_439_cov_76.552941	117	195	14	12	78	0.1538462
NODE_59517_length_439_cov_76.552941	117	195	15	13	78	0.1666667
NODE_59517_length_439_cov_76.552941	117	195	16	15	78	0.1923077
NODE_59533_length_439_cov_4.408824	174	238	1	54	64	0.8437500
NODE_59533_length_439_cov_4.408824	174	238	2	10	64	0.1562500
NODE_59536_length_439_cov_4.255882	258	318	0	60	60	1.0000000
NODE_59560_length_439_cov_3.011765	57	128	10	19	71	0.2676056
NODE_59560_length_439_cov_3.011765	57	128	11	13	71	0.1830986
NODE_59560_length_439_cov_3.011765	57	128	12	7	71	0.0985916
NODE_59560_length_439_cov_3.011765	57	128	13	11	71	0.1549296
NODE_59560_length_439_cov_3.011765	57	128	14	5	71	0.0704225
NODE_59560_length_439_cov_3.011765	57	128	15	7	71	0.0985916
NODE_59560_length_439_cov_3.011765	57	128	16	9	71	0.1267606
NODE_59560_length_439_cov_3.011765	101	140	13	6	39	0.1538462
NODE_59560_length_439_cov_3.011765	101	140	14	5	39	0.1282051
NODE_59560_length_439_cov_3.011765	101	140	15	12	39	0.3076923
NODE_59560_length_439_cov_3.011765	101	140	16	16	39	0.4102564
NODE_59592_length_439_cov_2.252941	227	269	0	42	42	1.0000000
NODE_59599_length_439_cov_2.135294	116	179	0	63	63	1.0000000
NODE_59617_length_439_cov_1.929412	388	439	0	51	51	1.0000000
NODE_59897_length_438_cov_29.952802	196	276	2	7	80	0.0875000
NODE_59897_length_438_cov_29.952802	196	276	3	5	80	0.0625000
NODE_59897_length_438_cov_29.952802	196	276	4	36	80	0.4500000
NODE_59897_length_438_cov_29.952802	196	276	5	30	80	0.3750000
NODE_59897_length_438_cov_29.952802	196	276	6	2	80	0.0250000
NODE_59897_length_438_cov_29.952802	249	329	5	25	80	0.3125000
NODE_59897_length_438_cov_29.952802	249	329	6	10	80	0.1250000
NODE_59897_length_438_cov_29.952802	249	329	7	6	80	0.0750000
NODE_59897_length_438_cov_29.952802	249	329	8	39	80	0.4875000
NODE_59898_length_438_cov_16.330383	225	305	2	41	80	0.5125000
NODE_59898_length_438_cov_16.330383	225	305	3	39	80	0.4875000
NODE_59898_length_438_cov_16.330383	278	358	1	49	80	0.6125000
NODE_59898_length_438_cov_16.330383	278	358	3	31	80	0.3875000
NODE_59899_length_438_cov_15.436578	74	154	0	80	80	1.0000000
NODE_59899_length_438_cov_15.436578	127	207	0	80	80	1.0000000
NODE_59901_length_438_cov_9.306785	256	309	0	53	53	1.0000000
NODE_59901_length_438_cov_9.306785	282	327	0	45	45	1.0000000
NODE_59916_length_438_cov_4.808260	46	133	0	15	87	0.1724138
NODE_59916_length_438_cov_4.808260	46	133	1	2	87	0.0229885
NODE_59916_length_438_cov_4.808260	46	133	2	30	87	0.3448276
NODE_59916_length_438_cov_4.808260	46	133	4	40	87	0.4597701
NODE_59916_length_438_cov_4.808260	106	186	4	80	80	1.0000000
NODE_59920_length_438_cov_4.622419	135	184	0	9	49	0.1836735
NODE_59920_length_438_cov_4.622419	135	184	2	2	49	0.0408163
NODE_59920_length_438_cov_4.622419	135	184	4	38	49	0.7755102
NODE_59936_length_438_cov_3.651917	86	166	1	2	80	0.0250000
NODE_59936_length_438_cov_3.651917	86	166	2	18	80	0.2250000
NODE_59936_length_438_cov_3.651917	86	166	3	56	80	0.7000000
NODE_59936_length_438_cov_3.651917	86	166	4	4	80	0.0500000
NODE_59936_length_438_cov_3.651917	139	219	1	2	80	0.0250000
NODE_59936_length_438_cov_3.651917	139	219	2	18	80	0.2250000
NODE_59936_length_438_cov_3.651917	139	219	3	3	80	0.0375000
NODE_59936_length_438_cov_3.651917	139	219	4	6	80	0.0750000
NODE_59936_length_438_cov_3.651917	139	219	5	5	80	0.0625000
NODE_59936_length_438_cov_3.651917	139	219	7	34	80	0.4250000
NODE_59936_length_438_cov_3.651917	139	219	8	12	80	0.1500000
NODE_59952_length_438_cov_3.109145	215	273	0	36	58	0.6206896
NODE_59952_length_438_cov_3.109145	215	273	1	22	58	0.3793103
NODE_59957_length_438_cov_3.005900	175	258	0	11	83	0.1325301
NODE_59957_length_438_cov_3.005900	175	258	1	54	83	0.6506024
NODE_59957_length_438_cov_3.005900	175	258	2	2	83	0.0240964
NODE_59957_length_438_cov_3.005900	175	258	3	16	83	0.1927711
NODE_60317_length_437_cov_57.260355	272	352	0	80	80	1.0000000
NODE_60317_length_437_cov_57.260355	325	405	0	80	80	1.0000000
NODE_60318_length_437_cov_40.964497	0	73	0	18	73	0.2465753
NODE_60318_length_437_cov_40.964497	0	73	1	17	73	0.2328767
NODE_60318_length_437_cov_40.964497	0	73	2	31	73	0.4246575
NODE_60318_length_437_cov_40.964497	0	73	4	7	73	0.0958904
NODE_60318_length_437_cov_40.964497	46	126	2	20	80	0.2500000
NODE_60318_length_437_cov_40.964497	46	126	4	60	80	0.7500000
NODE_60319_length_437_cov_30.843195	140	220	0	80	80	1.0000000
NODE_60319_length_437_cov_30.843195	193	273	0	80	80	1.0000000
NODE_60320_length_437_cov_14.736686	164	244	0	80	80	1.0000000
NODE_60320_length_437_cov_14.736686	217	297	0	80	80	1.0000000
NODE_60331_length_437_cov_6.032544	249	320	0	71	71	1.0000000
NODE_60332_length_437_cov_6.020710	272	352	1	12	80	0.1500000
NODE_60332_length_437_cov_6.020710	272	352	2	68	80	0.8500000
NODE_60332_length_437_cov_6.020710	325	405	1	65	80	0.8125000
NODE_60332_length_437_cov_6.020710	325	405	2	15	80	0.1875000
NODE_60336_length_437_cov_5.526627	129	209	1	65	80	0.8125000
NODE_60336_length_437_cov_5.526627	129	209	2	15	80	0.1875000
NODE_60336_length_437_cov_5.526627	182	262	1	73	80	0.9125000
NODE_60336_length_437_cov_5.526627	182	262	2	7	80	0.0875000
NODE_60348_length_437_cov_4.505917	247	327	0	80	80	1.0000000
NODE_60361_length_437_cov_3.470414	204	259	0	55	55	1.0000000
NODE_60369_length_437_cov_3.301775	95	149	6	3	54	0.0555556
NODE_60369_length_437_cov_3.301775	95	149	8	51	54	0.9444444
NODE_60381_length_437_cov_2.911243	91	171	0	4	80	0.0500000
NODE_60381_length_437_cov_2.911243	91	171	1	12	80	0.1500000
NODE_60381_length_437_cov_2.911243	91	171	2	17	80	0.2125000
NODE_60381_length_437_cov_2.911243	91	171	4	4	80	0.0500000
NODE_60381_length_437_cov_2.911243	91	171	5	1	80	0.0125000
NODE_60381_length_437_cov_2.911243	91	171	6	5	80	0.0625000
NODE_60381_length_437_cov_2.911243	91	171	8	37	80	0.4625000
NODE_60400_length_437_cov_2.650888	190	239	1	7	49	0.1428571
NODE_60400_length_437_cov_2.650888	190	239	2	13	49	0.2653061
NODE_60400_length_437_cov_2.650888	190	239	3	29	49	0.5918368
NODE_60400_length_437_cov_2.650888	212	292	1	30	80	0.3750000
NODE_60400_length_437_cov_2.650888	212	292	2	27	80	0.3375000
NODE_60400_length_437_cov_2.650888	212	292	3	23	80	0.2875000
NODE_60411_length_437_cov_2.514793	292	333	0	41	41	1.0000000
NODE_60509_length_437_cov_1.473373	252	324	2	72	72	1.0000000
NODE_60709_length_436_cov_125.940653	204	284	53	1	80	0.0125000
NODE_60709_length_436_cov_125.940653	204	284	54	7	80	0.0875000
NODE_60709_length_436_cov_125.940653	204	284	55	6	80	0.0750000
NODE_60709_length_436_cov_125.940653	204	284	56	6	80	0.0750000
NODE_60709_length_436_cov_125.940653	204	284	57	10	80	0.1250000
NODE_60709_length_436_cov_125.940653	204	284	58	11	80	0.1375000
NODE_60709_length_436_cov_125.940653	204	284	59	5	80	0.0625000
NODE_60709_length_436_cov_125.940653	204	284	60	2	80	0.0250000
NODE_60709_length_436_cov_125.940653	204	284	61	1	80	0.0125000
NODE_60709_length_436_cov_125.940653	204	284	62	2	80	0.0250000
NODE_60709_length_436_cov_125.940653	204	284	63	6	80	0.0750000
NODE_60709_length_436_cov_125.940653	204	284	65	1	80	0.0125000
NODE_60709_length_436_cov_125.940653	204	284	66	3	80	0.0375000
NODE_60709_length_436_cov_125.940653	204	284	67	4	80	0.0500000
NODE_60709_length_436_cov_125.940653	204	284	68	2	80	0.0250000
NODE_60709_length_436_cov_125.940653	204	284	69	1	80	0.0125000
NODE_60709_length_436_cov_125.940653	204	284	70	5	80	0.0625000
NODE_60709_length_436_cov_125.940653	204	284	72	2	80	0.0250000
NODE_60709_length_436_cov_125.940653	204	284	73	1	80	0.0125000
NODE_60709_length_436_cov_125.940653	204	284	74	2	80	0.0250000
NODE_60709_length_436_cov_125.940653	204	284	75	2	80	0.0250000
NODE_60709_length_436_cov_125.940653	255	301	52	8	46	0.1739130
NODE_60709_length_436_cov_125.940653	255	301	53	6	46	0.1304348
NODE_60709_length_436_cov_125.940653	255	301	54	8	46	0.1739130
NODE_60709_length_436_cov_125.940653	255	301	55	9	46	0.1956522
NODE_60709_length_436_cov_125.940653	255	301	56	4	46	0.0869565
NODE_60709_length_436_cov_125.940653	255	301	57	5	46	0.1086956
NODE_60709_length_436_cov_125.940653	255	301	58	5	46	0.1086956
NODE_60709_length_436_cov_125.940653	255	301	59	1	46	0.0217391
NODE_60709_length_436_cov_125.940653	257	337	39	1	80	0.0125000
NODE_60709_length_436_cov_125.940653	257	337	40	3	80	0.0375000
NODE_60709_length_436_cov_125.940653	257	337	41	2	80	0.0250000
NODE_60709_length_436_cov_125.940653	257	337	42	6	80	0.0750000
NODE_60709_length_436_cov_125.940653	257	337	43	1	80	0.0125000
NODE_60709_length_436_cov_125.940653	257	337	44	2	80	0.0250000
NODE_60709_length_436_cov_125.940653	257	337	45	3	80	0.0375000
NODE_60709_length_436_cov_125.940653	257	337	46	11	80	0.1375000
NODE_60709_length_436_cov_125.940653	257	337	48	2	80	0.0250000
NODE_60709_length_436_cov_125.940653	257	337	50	1	80	0.0125000
NODE_60709_length_436_cov_125.940653	257	337	52	10	80	0.1250000
NODE_60709_length_436_cov_125.940653	257	337	53	6	80	0.0750000
NODE_60709_length_436_cov_125.940653	257	337	54	9	80	0.1125000
NODE_60709_length_436_cov_125.940653	257	337	55	9	80	0.1125000
NODE_60709_length_436_cov_125.940653	257	337	56	4	80	0.0500000
NODE_60709_length_436_cov_125.940653	257	337	57	4	80	0.0500000
NODE_60709_length_436_cov_125.940653	257	337	58	5	80	0.0625000
NODE_60709_length_436_cov_125.940653	257	337	59	1	80	0.0125000
NODE_60709_length_436_cov_125.940653	333	413	10	1	80	0.0125000
NODE_60709_length_436_cov_125.940653	333	413	11	4	80	0.0500000
NODE_60709_length_436_cov_125.940653	333	413	14	8	80	0.1000000
NODE_60709_length_436_cov_125.940653	333	413	15	2	80	0.0250000
NODE_60709_length_436_cov_125.940653	333	413	16	6	80	0.0750000
NODE_60709_length_436_cov_125.940653	333	413	18	1	80	0.0125000
NODE_60709_length_436_cov_125.940653	333	413	19	3	80	0.0375000
NODE_60709_length_436_cov_125.940653	333	413	20	6	80	0.0750000
NODE_60709_length_436_cov_125.940653	333	413	22	2	80	0.0250000
NODE_60709_length_436_cov_125.940653	333	413	23	6	80	0.0750000
NODE_60709_length_436_cov_125.940653	333	413	24	1	80	0.0125000
NODE_60709_length_436_cov_125.940653	333	413	25	1	80	0.0125000
NODE_60709_length_436_cov_125.940653	333	413	27	3	80	0.0375000
NODE_60709_length_436_cov_125.940653	333	413	28	8	80	0.1000000
NODE_60709_length_436_cov_125.940653	333	413	29	6	80	0.0750000
NODE_60709_length_436_cov_125.940653	333	413	31	1	80	0.0125000
NODE_60709_length_436_cov_125.940653	333	413	32	3	80	0.0375000
NODE_60709_length_436_cov_125.940653	333	413	33	1	80	0.0125000
NODE_60709_length_436_cov_125.940653	333	413	35	4	80	0.0500000
NODE_60709_length_436_cov_125.940653	333	413	37	4	80	0.0500000
NODE_60709_length_436_cov_125.940653	333	413	38	2	80	0.0250000
NODE_60709_length_436_cov_125.940653	333	413	39	4	80	0.0500000
NODE_60709_length_436_cov_125.940653	333	413	41	2	80	0.0250000
NODE_60709_length_436_cov_125.940653	333	413	42	1	80	0.0125000
NODE_60709_length_436_cov_125.940653	386	436	4	6	50	0.1200000
NODE_60709_length_436_cov_125.940653	386	436	5	3	50	0.0600000
NODE_60709_length_436_cov_125.940653	386	436	6	2	50	0.0400000
NODE_60709_length_436_cov_125.940653	386	436	7	3	50	0.0600000
NODE_60709_length_436_cov_125.940653	386	436	8	2	50	0.0400000
NODE_60709_length_436_cov_125.940653	386	436	9	1	50	0.0200000
NODE_60709_length_436_cov_125.940653	386	436	10	7	50	0.1400000
NODE_60709_length_436_cov_125.940653	386	436	11	4	50	0.0800000
NODE_60709_length_436_cov_125.940653	386	436	14	8	50	0.1600000
NODE_60709_length_436_cov_125.940653	386	436	15	2	50	0.0400000
NODE_60709_length_436_cov_125.940653	386	436	16	6	50	0.1200000
NODE_60709_length_436_cov_125.940653	386	436	18	1	50	0.0200000
NODE_60709_length_436_cov_125.940653	386	436	19	3	50	0.0600000
NODE_60709_length_436_cov_125.940653	386	436	20	2	50	0.0400000
NODE_60712_length_436_cov_45.459941	166	246	0	5	80	0.0625000
NODE_60712_length_436_cov_45.459941	166	246	2	75	80	0.9375000
NODE_60712_length_436_cov_45.459941	219	299	0	44	80	0.5500000
NODE_60712_length_436_cov_45.459941	219	299	1	14	80	0.1750000
NODE_60712_length_436_cov_45.459941	219	299	2	22	80	0.2750000
NODE_60712_length_436_cov_45.459941	295	375	1	4	80	0.0500000
NODE_60712_length_436_cov_45.459941	295	375	2	76	80	0.9500000
NODE_60712_length_436_cov_45.459941	348	428	2	80	80	1.0000000
NODE_60713_length_436_cov_10.560831	74	154	0	80	80	1.0000000
NODE_60713_length_436_cov_10.560831	127	207	0	80	80	1.0000000
NODE_60716_length_436_cov_8.317507	51	127	1	13	76	0.1710526
NODE_60716_length_436_cov_8.317507	51	127	2	63	76	0.8289474
NODE_60716_length_436_cov_8.317507	104	182	1	13	78	0.1666667
NODE_60716_length_436_cov_8.317507	104	182	2	65	78	0.8333333
NODE_60760_length_436_cov_3.109792	153	205	0	52	52	1.0000000
NODE_60786_length_436_cov_2.551929	182	258	2	12	76	0.1578947
NODE_60786_length_436_cov_2.551929	182	258	3	17	76	0.2236842
NODE_60786_length_436_cov_2.551929	182	258	4	47	76	0.6184211
NODE_60786_length_436_cov_2.551929	235	315	2	7	80	0.0875000
NODE_60786_length_436_cov_2.551929	235	315	3	6	80	0.0750000
NODE_60786_length_436_cov_2.551929	235	315	4	67	80	0.8375000
NODE_60934_length_436_cov_1.207715	105	181	0	76	76	1.0000000
NODE_61088_length_435_cov_17.401786	55	135	1	47	80	0.5875000
NODE_61088_length_435_cov_17.401786	55	135	3	19	80	0.2375000
NODE_61088_length_435_cov_17.401786	55	135	4	14	80	0.1750000
NODE_61088_length_435_cov_17.401786	108	188	3	13	80	0.1625000
NODE_61088_length_435_cov_17.401786	108	188	4	67	80	0.8375000
NODE_61094_length_435_cov_6.910714	113	193	2	10	80	0.1250000
NODE_61094_length_435_cov_6.910714	113	193	3	17	80	0.2125000
NODE_61094_length_435_cov_6.910714	113	193	4	27	80	0.3375000
NODE_61094_length_435_cov_6.910714	113	193	5	26	80	0.3250000
NODE_61094_length_435_cov_6.910714	147	194	4	20	47	0.4255319
NODE_61094_length_435_cov_6.910714	147	194	5	27	47	0.5744681
NODE_61094_length_435_cov_6.910714	149	184	4	18	35	0.5142857
NODE_61094_length_435_cov_6.910714	149	184	5	17	35	0.4857143
NODE_61094_length_435_cov_6.910714	151	193	4	16	42	0.3809524
NODE_61094_length_435_cov_6.910714	151	193	5	26	42	0.6190476
NODE_61094_length_435_cov_6.910714	166	251	3	23	85	0.2705882
NODE_61094_length_435_cov_6.910714	166	251	4	34	85	0.4000000
NODE_61094_length_435_cov_6.910714	166	251	5	28	85	0.3294118
NODE_61094_length_435_cov_6.910714	167	251	3	23	84	0.2738095
NODE_61094_length_435_cov_6.910714	167	251	4	33	84	0.3928571
NODE_61094_length_435_cov_6.910714	167	251	5	28	84	0.3333333
NODE_61102_length_435_cov_5.630952	159	217	0	58	58	1.0000000
NODE_61102_length_435_cov_5.630952	190	270	0	80	80	1.0000000
NODE_61112_length_435_cov_4.601190	271	309	0	38	38	1.0000000
NODE_61112_length_435_cov_4.601190	282	344	0	62	62	1.0000000
NODE_61122_length_435_cov_3.770833	209	240	4	4	31	0.1290323
NODE_61122_length_435_cov_3.770833	209	240	6	27	31	0.8709677
NODE_61137_length_435_cov_2.836310	113	194	1	4	81	0.0493827
NODE_61137_length_435_cov_2.836310	113	194	2	22	81	0.2716049
NODE_61137_length_435_cov_2.836310	113	194	3	55	81	0.6790124
NODE_61357_length_435_cov_0.988095	286	322	0	36	36	1.0000000
NODE_61451_length_434_cov_136.483582	0	58	21	1	58	0.0172414
NODE_61451_length_434_cov_136.483582	0	58	23	1	58	0.0172414
NODE_61451_length_434_cov_136.483582	0	58	28	1	58	0.0172414
NODE_61451_length_434_cov_136.483582	0	58	30	1	58	0.0172414
NODE_61451_length_434_cov_136.483582	0	58	33	1	58	0.0172414
NODE_61451_length_434_cov_136.483582	0	58	34	1	58	0.0172414
NODE_61451_length_434_cov_136.483582	0	58	42	1	58	0.0172414
NODE_61451_length_434_cov_136.483582	0	58	45	1	58	0.0172414
NODE_61451_length_434_cov_136.483582	0	58	52	1	58	0.0172414
NODE_61451_length_434_cov_136.483582	0	58	53	1	58	0.0172414
NODE_61451_length_434_cov_136.483582	0	58	55	1	58	0.0172414
NODE_61451_length_434_cov_136.483582	0	58	56	1	58	0.0172414
NODE_61451_length_434_cov_136.483582	0	58	58	1	58	0.0172414
NODE_61451_length_434_cov_136.483582	0	58	59	1	58	0.0172414
NODE_61451_length_434_cov_136.483582	0	58	62	1	58	0.0172414
NODE_61451_length_434_cov_136.483582	0	58	63	1	58	0.0172414
NODE_61451_length_434_cov_136.483582	0	58	70	1	58	0.0172414
NODE_61451_length_434_cov_136.483582	0	58	72	1	58	0.0172414
NODE_61451_length_434_cov_136.483582	0	58	74	1	58	0.0172414
NODE_61451_length_434_cov_136.483582	0	58	77	1	58	0.0172414
NODE_61451_length_434_cov_136.483582	0	58	81	1	58	0.0172414
NODE_61451_length_434_cov_136.483582	0	58	87	4	58	0.0689655
NODE_61451_length_434_cov_136.483582	0	58	89	1	58	0.0172414
NODE_61451_length_434_cov_136.483582	0	58	95	1	58	0.0172414
NODE_61451_length_434_cov_136.483582	0	58	96	1	58	0.0172414
NODE_61451_length_434_cov_136.483582	0	58	106	1	58	0.0172414
NODE_61451_length_434_cov_136.483582	0	58	110	1	58	0.0172414
NODE_61451_length_434_cov_136.483582	0	58	115	1	58	0.0172414
NODE_61451_length_434_cov_136.483582	0	58	120	1	58	0.0172414
NODE_61451_length_434_cov_136.483582	0	58	122	1	58	0.0172414
NODE_61451_length_434_cov_136.483582	0	58	124	1	58	0.0172414
NODE_61451_length_434_cov_136.483582	0	58	125	4	58	0.0689655
NODE_61451_length_434_cov_136.483582	0	58	127	1	58	0.0172414
NODE_61451_length_434_cov_136.483582	0	58	130	1	58	0.0172414
NODE_61451_length_434_cov_136.483582	0	58	135	1	58	0.0172414
NODE_61451_length_434_cov_136.483582	0	58	136	1	58	0.0172414
NODE_61451_length_434_cov_136.483582	0	58	137	1	58	0.0172414
NODE_61451_length_434_cov_136.483582	0	58	143	1	58	0.0172414
NODE_61451_length_434_cov_136.483582	0	58	149	1	58	0.0172414
NODE_61451_length_434_cov_136.483582	0	58	153	1	58	0.0172414
NODE_61451_length_434_cov_136.483582	0	58	156	1	58	0.0172414
NODE_61451_length_434_cov_136.483582	0	58	158	1	58	0.0172414
NODE_61451_length_434_cov_136.483582	0	58	160	1	58	0.0172414
NODE_61451_length_434_cov_136.483582	0	58	162	1	58	0.0172414
NODE_61451_length_434_cov_136.483582	0	58	163	1	58	0.0172414
NODE_61451_length_434_cov_136.483582	0	58	168	1	58	0.0172414
NODE_61451_length_434_cov_136.483582	0	58	169	1	58	0.0172414
NODE_61451_length_434_cov_136.483582	0	58	170	4	58	0.0689655
NODE_61451_length_434_cov_136.483582	0	58	173	1	58	0.0172414
NODE_61451_length_434_cov_136.483582	31	111	120	1	80	0.0125000
NODE_61451_length_434_cov_136.483582	31	111	122	1	80	0.0125000
NODE_61451_length_434_cov_136.483582	31	111	124	1	80	0.0125000
NODE_61451_length_434_cov_136.483582	31	111	125	4	80	0.0500000
NODE_61451_length_434_cov_136.483582	31	111	127	1	80	0.0125000
NODE_61451_length_434_cov_136.483582	31	111	130	1	80	0.0125000
NODE_61451_length_434_cov_136.483582	31	111	135	1	80	0.0125000
NODE_61451_length_434_cov_136.483582	31	111	136	1	80	0.0125000
NODE_61451_length_434_cov_136.483582	31	111	137	1	80	0.0125000
NODE_61451_length_434_cov_136.483582	31	111	143	1	80	0.0125000
NODE_61451_length_434_cov_136.483582	31	111	149	1	80	0.0125000
NODE_61451_length_434_cov_136.483582	31	111	153	1	80	0.0125000
NODE_61451_length_434_cov_136.483582	31	111	156	1	80	0.0125000
NODE_61451_length_434_cov_136.483582	31	111	158	1	80	0.0125000
NODE_61451_length_434_cov_136.483582	31	111	160	1	80	0.0125000
NODE_61451_length_434_cov_136.483582	31	111	162	1	80	0.0125000
NODE_61451_length_434_cov_136.483582	31	111	163	1	80	0.0125000
NODE_61451_length_434_cov_136.483582	31	111	168	1	80	0.0125000
NODE_61451_length_434_cov_136.483582	31	111	169	1	80	0.0125000
NODE_61451_length_434_cov_136.483582	31	111	170	4	80	0.0500000
NODE_61451_length_434_cov_136.483582	31	111	173	1	80	0.0125000
NODE_61451_length_434_cov_136.483582	31	111	177	2	80	0.0250000
NODE_61451_length_434_cov_136.483582	31	111	193	1	80	0.0125000
NODE_61451_length_434_cov_136.483582	31	111	198	1	80	0.0125000
NODE_61451_length_434_cov_136.483582	31	111	201	1	80	0.0125000
NODE_61451_length_434_cov_136.483582	31	111	206	1	80	0.0125000
NODE_61451_length_434_cov_136.483582	31	111	207	1	80	0.0125000
NODE_61451_length_434_cov_136.483582	31	111	211	1	80	0.0125000
NODE_61451_length_434_cov_136.483582	31	111	212	1	80	0.0125000
NODE_61451_length_434_cov_136.483582	31	111	213	1	80	0.0125000
NODE_61451_length_434_cov_136.483582	31	111	214	1	80	0.0125000
NODE_61451_length_434_cov_136.483582	31	111	219	1	80	0.0125000
NODE_61451_length_434_cov_136.483582	31	111	221	1	80	0.0125000
NODE_61451_length_434_cov_136.483582	31	111	222	1	80	0.0125000
NODE_61451_length_434_cov_136.483582	31	111	223	1	80	0.0125000
NODE_61451_length_434_cov_136.483582	31	111	231	1	80	0.0125000
NODE_61451_length_434_cov_136.483582	31	111	233	1	80	0.0125000
NODE_61451_length_434_cov_136.483582	31	111	235	2	80	0.0250000
NODE_61451_length_434_cov_136.483582	31	111	237	1	80	0.0125000
NODE_61451_length_434_cov_136.483582	31	111	240	1	80	0.0125000
NODE_61451_length_434_cov_136.483582	31	111	241	1	80	0.0125000
NODE_61451_length_434_cov_136.483582	31	111	244	1	80	0.0125000
NODE_61451_length_434_cov_136.483582	31	111	246	2	80	0.0250000
NODE_61451_length_434_cov_136.483582	31	111	247	1	80	0.0125000
NODE_61451_length_434_cov_136.483582	31	111	248	1	80	0.0125000
NODE_61451_length_434_cov_136.483582	31	111	251	1	80	0.0125000
NODE_61451_length_434_cov_136.483582	31	111	252	1	80	0.0125000
NODE_61451_length_434_cov_136.483582	31	111	256	1	80	0.0125000
NODE_61451_length_434_cov_136.483582	31	111	260	1	80	0.0125000
NODE_61451_length_434_cov_136.483582	31	111	261	1	80	0.0125000
NODE_61451_length_434_cov_136.483582	31	111	265	1	80	0.0125000
NODE_61451_length_434_cov_136.483582	31	111	267	1	80	0.0125000
NODE_61451_length_434_cov_136.483582	31	111	271	1	80	0.0125000
NODE_61451_length_434_cov_136.483582	31	111	274	1	80	0.0125000
NODE_61451_length_434_cov_136.483582	31	111	276	1	80	0.0125000
NODE_61451_length_434_cov_136.483582	31	111	279	1	80	0.0125000
NODE_61451_length_434_cov_136.483582	31	111	280	1	80	0.0125000
NODE_61451_length_434_cov_136.483582	31	111	287	1	80	0.0125000
NODE_61451_length_434_cov_136.483582	31	111	290	1	80	0.0125000
NODE_61451_length_434_cov_136.483582	31	111	291	1	80	0.0125000
NODE_61451_length_434_cov_136.483582	31	111	292	1	80	0.0125000
NODE_61451_length_434_cov_136.483582	31	111	296	2	80	0.0250000
NODE_61451_length_434_cov_136.483582	31	111	297	2	80	0.0250000
NODE_61451_length_434_cov_136.483582	31	111	299	1	80	0.0125000
NODE_61451_length_434_cov_136.483582	31	111	300	1	80	0.0125000
NODE_61451_length_434_cov_136.483582	31	111	303	1	80	0.0125000
NODE_61451_length_434_cov_136.483582	31	111	307	1	80	0.0125000
NODE_61451_length_434_cov_136.483582	31	111	308	1	80	0.0125000
NODE_61451_length_434_cov_136.483582	31	111	312	1	80	0.0125000
NODE_61452_length_434_cov_43.214925	291	366	3	5	75	0.0666667
NODE_61452_length_434_cov_43.214925	291	366	4	2	75	0.0266667
NODE_61452_length_434_cov_43.214925	291	366	6	30	75	0.4000000
NODE_61452_length_434_cov_43.214925	291	366	7	38	75	0.5066667
NODE_61452_length_434_cov_43.214925	344	424	7	80	80	1.0000000
NODE_61452_length_434_cov_43.214925	344	424	7	80	80	1.0000000
NODE_61453_length_434_cov_22.373134	80	160	0	74	80	0.9250000
NODE_61453_length_434_cov_22.373134	80	160	1	6	80	0.0750000
NODE_61453_length_434_cov_22.373134	133	213	0	21	80	0.2625000
NODE_61453_length_434_cov_22.373134	133	213	1	59	80	0.7375000
NODE_61455_length_434_cov_11.549254	74	145	2	71	71	1.0000000
NODE_61455_length_434_cov_11.549254	118	198	0	26	80	0.3250000
NODE_61455_length_434_cov_11.549254	118	198	1	5	80	0.0625000
NODE_61455_length_434_cov_11.549254	118	198	2	49	80	0.6125000
NODE_61477_length_434_cov_4.125373	191	233	6	8	42	0.1904762
NODE_61477_length_434_cov_4.125373	191	233	7	22	42	0.5238096
NODE_61477_length_434_cov_4.125373	191	233	8	12	42	0.2857143
NODE_61477_length_434_cov_4.125373	200	235	6	10	35	0.2857143
NODE_61477_length_434_cov_4.125373	200	235	7	13	35	0.3714286
NODE_61477_length_434_cov_4.125373	200	235	8	12	35	0.3428572
NODE_61497_length_434_cov_3.104478	191	263	0	72	72	1.0000000
NODE_61528_length_434_cov_2.197015	129	168	0	39	39	1.0000000
NODE_61563_length_434_cov_1.883582	88	133	0	45	45	1.0000000
NODE_61563_length_434_cov_1.883582	141	182	0	41	41	1.0000000
NODE_61603_length_434_cov_1.626866	163	243	0	35	80	0.4375000
NODE_61603_length_434_cov_1.626866	163	243	2	45	80	0.5625000
NODE_61676_length_434_cov_1.220896	118	198	45	2	80	0.0250000
NODE_61676_length_434_cov_1.220896	118	198	46	4	80	0.0500000
NODE_61676_length_434_cov_1.220896	118	198	47	1	80	0.0125000
NODE_61676_length_434_cov_1.220896	118	198	48	1	80	0.0125000
NODE_61676_length_434_cov_1.220896	118	198	50	1	80	0.0125000
NODE_61676_length_434_cov_1.220896	118	198	58	1	80	0.0125000
NODE_61676_length_434_cov_1.220896	118	198	60	1	80	0.0125000
NODE_61676_length_434_cov_1.220896	118	198	61	1	80	0.0125000
NODE_61676_length_434_cov_1.220896	118	198	62	1	80	0.0125000
NODE_61676_length_434_cov_1.220896	118	198	63	1	80	0.0125000
NODE_61676_length_434_cov_1.220896	118	198	66	1	80	0.0125000
NODE_61676_length_434_cov_1.220896	118	198	67	1	80	0.0125000
NODE_61676_length_434_cov_1.220896	118	198	69	3	80	0.0375000
NODE_61676_length_434_cov_1.220896	118	198	71	1	80	0.0125000
NODE_61676_length_434_cov_1.220896	118	198	73	2	80	0.0250000
NODE_61676_length_434_cov_1.220896	118	198	75	1	80	0.0125000
NODE_61676_length_434_cov_1.220896	118	198	76	1	80	0.0125000
NODE_61676_length_434_cov_1.220896	118	198	77	2	80	0.0250000
NODE_61676_length_434_cov_1.220896	118	198	79	1	80	0.0125000
NODE_61676_length_434_cov_1.220896	118	198	81	1	80	0.0125000
NODE_61676_length_434_cov_1.220896	118	198	83	2	80	0.0250000
NODE_61676_length_434_cov_1.220896	118	198	84	2	80	0.0250000
NODE_61676_length_434_cov_1.220896	118	198	85	6	80	0.0750000
NODE_61676_length_434_cov_1.220896	118	198	86	1	80	0.0125000
NODE_61676_length_434_cov_1.220896	118	198	88	9	80	0.1125000
NODE_61676_length_434_cov_1.220896	118	198	89	6	80	0.0750000
NODE_61676_length_434_cov_1.220896	118	198	90	1	80	0.0125000
NODE_61676_length_434_cov_1.220896	118	198	94	7	80	0.0875000
NODE_61676_length_434_cov_1.220896	118	198	96	1	80	0.0125000
NODE_61676_length_434_cov_1.220896	118	198	98	1	80	0.0125000
NODE_61676_length_434_cov_1.220896	118	198	99	5	80	0.0625000
NODE_61676_length_434_cov_1.220896	118	198	100	2	80	0.0250000
NODE_61676_length_434_cov_1.220896	118	198	101	1	80	0.0125000
NODE_61676_length_434_cov_1.220896	118	198	103	1	80	0.0125000
NODE_61676_length_434_cov_1.220896	118	198	104	1	80	0.0125000
NODE_61676_length_434_cov_1.220896	118	198	106	1	80	0.0125000
NODE_61676_length_434_cov_1.220896	118	198	107	1	80	0.0125000
NODE_61676_length_434_cov_1.220896	118	198	108	1	80	0.0125000
NODE_61676_length_434_cov_1.220896	118	198	109	3	80	0.0375000
NODE_61727_length_434_cov_1.002985	245	286	9	3	41	0.0731707
NODE_61727_length_434_cov_1.002985	245	286	11	38	41	0.9268293
NODE_61727_length_434_cov_1.002985	258	339	3	7	81	0.0864198
NODE_61727_length_434_cov_1.002985	258	339	5	11	81	0.1358025
NODE_61727_length_434_cov_1.002985	258	339	7	2	81	0.0246914
NODE_61727_length_434_cov_1.002985	258	339	8	19	81	0.2345679
NODE_61727_length_434_cov_1.002985	258	339	9	17	81	0.2098765
NODE_61727_length_434_cov_1.002985	258	339	11	25	81	0.3086420
NODE_61826_length_433_cov_51.392216	2	82	0	62	80	0.7750000
NODE_61826_length_433_cov_51.392216	2	82	1	18	80	0.2250000
NODE_61826_length_433_cov_51.392216	55	135	0	9	80	0.1125000
NODE_61826_length_433_cov_51.392216	55	135	1	33	80	0.4125000
NODE_61826_length_433_cov_51.392216	55	135	2	37	80	0.4625000
NODE_61826_length_433_cov_51.392216	55	135	3	1	80	0.0125000
NODE_61826_length_433_cov_51.392216	131	213	2	3	82	0.0365854
NODE_61826_length_433_cov_51.392216	131	213	3	40	82	0.4878049
NODE_61826_length_433_cov_51.392216	131	213	4	39	82	0.4756097
NODE_61826_length_433_cov_51.392216	189	266	2	19	77	0.2467532
NODE_61826_length_433_cov_51.392216	189	266	3	33	77	0.4285714
NODE_61826_length_433_cov_51.392216	189	266	4	25	77	0.3246753
NODE_61827_length_433_cov_46.344311	248	328	0	80	80	1.0000000
NODE_61827_length_433_cov_46.344311	301	381	0	80	80	1.0000000
NODE_61828_length_433_cov_41.808383	92	172	1	13	80	0.1625000
NODE_61828_length_433_cov_41.808383	92	172	3	2	80	0.0250000
NODE_61828_length_433_cov_41.808383	92	172	4	40	80	0.5000000
NODE_61828_length_433_cov_41.808383	92	172	5	14	80	0.1750000
NODE_61828_length_433_cov_41.808383	92	172	6	11	80	0.1375000
NODE_61828_length_433_cov_41.808383	145	225	4	41	80	0.5125000
NODE_61828_length_433_cov_41.808383	145	225	5	14	80	0.1750000
NODE_61828_length_433_cov_41.808383	145	225	6	25	80	0.3125000
NODE_61835_length_433_cov_6.227545	157	237	0	80	80	1.0000000
NODE_61836_length_433_cov_6.080838	164	244	1	69	80	0.8625000
NODE_61836_length_433_cov_6.080838	164	244	2	11	80	0.1375000
NODE_61838_length_433_cov_5.547904	10	80	2	50	70	0.7142857
NODE_61838_length_433_cov_5.547904	10	80	4	9	70	0.1285714
NODE_61838_length_433_cov_5.547904	10	80	6	11	70	0.1571429
NODE_61838_length_433_cov_5.547904	51	133	2	9	82	0.1097561
NODE_61838_length_433_cov_5.547904	51	133	4	9	82	0.1097561
NODE_61838_length_433_cov_5.547904	51	133	6	64	82	0.7804878
NODE_61839_length_433_cov_5.476048	81	141	1	10	60	0.1666667
NODE_61839_length_433_cov_5.476048	81	141	2	6	60	0.1000000
NODE_61839_length_433_cov_5.476048	81	141	3	44	60	0.7333333
NODE_61855_length_433_cov_3.907186	77	107	2	30	30	1.0000000
NODE_61862_length_433_cov_3.595808	231	316	0	15	85	0.1764706
NODE_61862_length_433_cov_3.595808	231	316	2	6	85	0.0705882
NODE_61862_length_433_cov_3.595808	231	316	4	64	85	0.7529412
NODE_61864_length_433_cov_3.526946	107	178	2	71	71	1.0000000
NODE_61931_length_433_cov_2.137725	123	203	0	80	80	1.0000000
NODE_62258_length_432_cov_17.540541	150	230	0	2	80	0.0250000
NODE_62258_length_432_cov_17.540541	150	230	1	74	80	0.9250000
NODE_62258_length_432_cov_17.540541	150	230	3	4	80	0.0500000
NODE_62258_length_432_cov_17.540541	203	288	0	60	85	0.7058824
NODE_62258_length_432_cov_17.540541	203	288	1	25	85	0.2941177
NODE_62264_length_432_cov_6.555556	52	82	2	30	30	1.0000000
NODE_62268_length_432_cov_5.720721	77	157	0	80	80	1.0000000
NODE_62268_length_432_cov_5.720721	130	202	0	72	72	1.0000000
NODE_62269_length_432_cov_5.387387	65	95	2	30	30	1.0000000
NODE_62270_length_432_cov_5.345345	271	324	1	9	53	0.1698113
NODE_62270_length_432_cov_5.345345	271	324	2	44	53	0.8301887
NODE_62293_length_432_cov_3.678679	78	121	0	33	43	0.7674419
NODE_62293_length_432_cov_3.678679	78	121	2	10	43	0.2325581
NODE_62304_length_432_cov_3.246246	87	128	1	11	41	0.2682927
NODE_62304_length_432_cov_3.246246	87	128	2	22	41	0.5365854
NODE_62304_length_432_cov_3.246246	87	128	4	1	41	0.0243902
NODE_62304_length_432_cov_3.246246	87	128	6	7	41	0.1707317
NODE_62304_length_432_cov_3.246246	101	167	2	19	66	0.2878788
NODE_62304_length_432_cov_3.246246	101	167	4	1	66	0.0151515
NODE_62304_length_432_cov_3.246246	101	167	6	46	66	0.6969697
NODE_62396_length_432_cov_1.762763	4	71	0	67	67	1.0000000
NODE_62544_length_432_cov_1.027027	44	68	0	24	24	1.0000000
NODE_62650_length_431_cov_35.355422	202	284	0	6	82	0.0731707
NODE_62650_length_431_cov_35.355422	202	284	1	76	82	0.9268293
NODE_62650_length_431_cov_35.355422	257	333	0	55	76	0.7236842
NODE_62650_length_431_cov_35.355422	257	333	1	21	76	0.2763158
NODE_62652_length_431_cov_11.207831	185	265	0	80	80	1.0000000
NODE_62652_length_431_cov_11.207831	238	318	0	80	80	1.0000000
NODE_62657_length_431_cov_7.018072	110	190	1	80	80	1.0000000
NODE_62657_length_431_cov_7.018072	163	243	1	80	80	1.0000000
NODE_62661_length_431_cov_6.292169	123	203	0	80	80	1.0000000
NODE_62668_length_431_cov_5.608434	170	241	0	4	71	0.0563380
NODE_62668_length_431_cov_5.608434	170	241	2	67	71	0.9436620
NODE_62681_length_431_cov_4.250000	146	216	3	70	70	1.0000000
NODE_62684_length_431_cov_3.993976	210	290	1	7	80	0.0875000
NODE_62684_length_431_cov_3.993976	210	290	3	41	80	0.5125000
NODE_62684_length_431_cov_3.993976	210	290	4	32	80	0.4000000
NODE_62794_length_431_cov_1.695783	76	156	4	19	80	0.2375000
NODE_62794_length_431_cov_1.695783	76	156	5	2	80	0.0250000
NODE_62794_length_431_cov_1.695783	76	156	6	10	80	0.1250000
NODE_62794_length_431_cov_1.695783	76	156	7	4	80	0.0500000
NODE_62794_length_431_cov_1.695783	76	156	8	8	80	0.1000000
NODE_62794_length_431_cov_1.695783	76	156	9	31	80	0.3875000
NODE_62794_length_431_cov_1.695783	76	156	10	6	80	0.0750000
NODE_62794_length_431_cov_1.695783	129	199	8	9	70	0.1285714
NODE_62794_length_431_cov_1.695783	129	199	9	15	70	0.2142857
NODE_62794_length_431_cov_1.695783	129	199	10	34	70	0.4857143
NODE_62794_length_431_cov_1.695783	129	199	11	12	70	0.1714286
NODE_63043_length_430_cov_49.791541	319	399	34	2	80	0.0250000
NODE_63043_length_430_cov_49.791541	319	399	36	3	80	0.0375000
NODE_63043_length_430_cov_49.791541	319	399	38	1	80	0.0125000
NODE_63043_length_430_cov_49.791541	319	399	41	6	80	0.0750000
NODE_63043_length_430_cov_49.791541	319	399	44	3	80	0.0375000
NODE_63043_length_430_cov_49.791541	319	399	47	1	80	0.0125000
NODE_63043_length_430_cov_49.791541	319	399	48	1	80	0.0125000
NODE_63043_length_430_cov_49.791541	319	399	49	4	80	0.0500000
NODE_63043_length_430_cov_49.791541	319	399	52	1	80	0.0125000
NODE_63043_length_430_cov_49.791541	319	399	55	2	80	0.0250000
NODE_63043_length_430_cov_49.791541	319	399	58	3	80	0.0375000
NODE_63043_length_430_cov_49.791541	319	399	62	2	80	0.0250000
NODE_63043_length_430_cov_49.791541	319	399	67	1	80	0.0125000
NODE_63043_length_430_cov_49.791541	319	399	70	1	80	0.0125000
NODE_63043_length_430_cov_49.791541	319	399	71	1	80	0.0125000
NODE_63043_length_430_cov_49.791541	319	399	73	1	80	0.0125000
NODE_63043_length_430_cov_49.791541	319	399	75	5	80	0.0625000
NODE_63043_length_430_cov_49.791541	319	399	77	2	80	0.0250000
NODE_63043_length_430_cov_49.791541	319	399	78	1	80	0.0125000
NODE_63043_length_430_cov_49.791541	319	399	79	1	80	0.0125000
NODE_63043_length_430_cov_49.791541	319	399	80	1	80	0.0125000
NODE_63043_length_430_cov_49.791541	319	399	81	1	80	0.0125000
NODE_63043_length_430_cov_49.791541	319	399	82	2	80	0.0250000
NODE_63043_length_430_cov_49.791541	319	399	83	1	80	0.0125000
NODE_63043_length_430_cov_49.791541	319	399	84	2	80	0.0250000
NODE_63043_length_430_cov_49.791541	319	399	86	1	80	0.0125000
NODE_63043_length_430_cov_49.791541	319	399	87	4	80	0.0500000
NODE_63043_length_430_cov_49.791541	319	399	89	1	80	0.0125000
NODE_63043_length_430_cov_49.791541	319	399	91	1	80	0.0125000
NODE_63043_length_430_cov_49.791541	319	399	92	4	80	0.0500000
NODE_63043_length_430_cov_49.791541	319	399	94	4	80	0.0500000
NODE_63043_length_430_cov_49.791541	319	399	98	1	80	0.0125000
NODE_63043_length_430_cov_49.791541	319	399	99	3	80	0.0375000
NODE_63043_length_430_cov_49.791541	319	399	102	5	80	0.0625000
NODE_63043_length_430_cov_49.791541	319	399	104	6	80	0.0750000
NODE_63043_length_430_cov_49.791541	319	399	106	1	80	0.0125000
NODE_63043_length_430_cov_49.791541	372	430	9	3	58	0.0517241
NODE_63043_length_430_cov_49.791541	372	430	10	2	58	0.0344828
NODE_63043_length_430_cov_49.791541	372	430	12	1	58	0.0172414
NODE_63043_length_430_cov_49.791541	372	430	14	1	58	0.0172414
NODE_63043_length_430_cov_49.791541	372	430	16	1	58	0.0172414
NODE_63043_length_430_cov_49.791541	372	430	17	2	58	0.0344828
NODE_63043_length_430_cov_49.791541	372	430	18	6	58	0.1034483
NODE_63043_length_430_cov_49.791541	372	430	19	2	58	0.0344828
NODE_63043_length_430_cov_49.791541	372	430	22	1	58	0.0172414
NODE_63043_length_430_cov_49.791541	372	430	23	2	58	0.0344828
NODE_63043_length_430_cov_49.791541	372	430	24	1	58	0.0172414
NODE_63043_length_430_cov_49.791541	372	430	26	2	58	0.0344828
NODE_63043_length_430_cov_49.791541	372	430	28	1	58	0.0172414
NODE_63043_length_430_cov_49.791541	372	430	29	2	58	0.0344828
NODE_63043_length_430_cov_49.791541	372	430	30	1	58	0.0172414
NODE_63043_length_430_cov_49.791541	372	430	32	3	58	0.0517241
NODE_63043_length_430_cov_49.791541	372	430	34	2	58	0.0344828
NODE_63043_length_430_cov_49.791541	372	430	36	3	58	0.0517241
NODE_63043_length_430_cov_49.791541	372	430	38	1	58	0.0172414
NODE_63043_length_430_cov_49.791541	372	430	41	6	58	0.1034483
NODE_63043_length_430_cov_49.791541	372	430	44	3	58	0.0517241
NODE_63043_length_430_cov_49.791541	372	430	47	1	58	0.0172414
NODE_63043_length_430_cov_49.791541	372	430	48	1	58	0.0172414
NODE_63043_length_430_cov_49.791541	372	430	49	4	58	0.0689655
NODE_63043_length_430_cov_49.791541	372	430	52	1	58	0.0172414
NODE_63043_length_430_cov_49.791541	372	430	55	2	58	0.0344828
NODE_63043_length_430_cov_49.791541	372	430	58	3	58	0.0517241
NODE_63044_length_430_cov_44.365559	109	189	1	56	80	0.7000000
NODE_63044_length_430_cov_44.365559	109	189	2	24	80	0.3000000
NODE_63044_length_430_cov_44.365559	162	242	1	34	80	0.4250000
NODE_63044_length_430_cov_44.365559	162	242	2	46	80	0.5750000
NODE_63045_length_430_cov_16.746224	92	172	0	80	80	1.0000000
NODE_63045_length_430_cov_16.746224	145	225	0	80	80	1.0000000
NODE_63048_length_430_cov_7.737160	180	263	0	21	83	0.2530121
NODE_63048_length_430_cov_7.737160	180	263	2	57	83	0.6867470
NODE_63048_length_430_cov_7.737160	180	263	4	5	83	0.0602410
NODE_63050_length_430_cov_6.163142	135	197	0	62	62	1.0000000
NODE_63051_length_430_cov_5.873112	7	90	0	24	83	0.2891566
NODE_63051_length_430_cov_5.873112	7	90	1	59	83	0.7108434
NODE_63051_length_430_cov_5.873112	60	126	1	66	66	1.0000000
NODE_63066_length_430_cov_4.323263	18	90	0	72	72	1.0000000
NODE_63161_length_430_cov_1.945619	153	233	0	9	80	0.1125000
NODE_63161_length_430_cov_1.945619	153	233	1	71	80	0.8875000
NODE_63401_length_430_cov_0.664653	391	430	0	39	39	1.0000000
NODE_63437_length_429_cov_10.424242	78	158	0	11	80	0.1375000
NODE_63437_length_429_cov_10.424242	78	158	2	15	80	0.1875000
NODE_63437_length_429_cov_10.424242	78	158	4	54	80	0.6750000
NODE_63437_length_429_cov_10.424242	207	287	2	72	80	0.9000000
NODE_63437_length_429_cov_10.424242	207	287	4	8	80	0.1000000
NODE_63437_length_429_cov_10.424242	260	340	2	40	80	0.5000000
NODE_63437_length_429_cov_10.424242	260	340	4	40	80	0.5000000
NODE_63439_length_429_cov_8.957576	213	293	0	80	80	1.0000000
NODE_63439_length_429_cov_8.957576	266	346	0	80	80	1.0000000
NODE_63441_length_429_cov_6.772727	337	366	0	15	29	0.5172414
NODE_63441_length_429_cov_6.772727	337	366	1	1	29	0.0344828
NODE_63441_length_429_cov_6.772727	337	366	2	3	29	0.1034483
NODE_63441_length_429_cov_6.772727	337	366	3	10	29	0.3448276
NODE_63485_length_429_cov_3.003030	173	251	0	78	78	1.0000000
NODE_63516_length_429_cov_2.433333	220	300	4	9	80	0.1125000
NODE_63516_length_429_cov_2.433333	220	300	5	18	80	0.2250000
NODE_63516_length_429_cov_2.433333	220	300	6	43	80	0.5375000
NODE_63516_length_429_cov_2.433333	220	300	7	10	80	0.1250000
NODE_63519_length_429_cov_2.360606	24	85	0	61	61	1.0000000
NODE_63527_length_429_cov_2.224242	115	195	2	80	80	1.0000000
NODE_63547_length_429_cov_2.051515	114	143	0	29	29	1.0000000
NODE_63547_length_429_cov_2.051515	286	348	3	12	62	0.1935484
NODE_63547_length_429_cov_2.051515	286	348	4	50	62	0.8064516
NODE_63864_length_428_cov_40.449848	217	297	0	80	80	1.0000000
NODE_63864_length_428_cov_40.449848	270	350	0	80	80	1.0000000
NODE_63864_length_428_cov_40.449848	346	426	0	80	80	1.0000000
NODE_63865_length_428_cov_31.066869	249	325	10	1	76	0.0131579
NODE_63865_length_428_cov_31.066869	249	325	12	17	76	0.2236842
NODE_63865_length_428_cov_31.066869	249	325	13	23	76	0.3026316
NODE_63865_length_428_cov_31.066869	249	325	14	35	76	0.4605263
NODE_63865_length_428_cov_31.066869	297	378	4	17	81	0.2098765
NODE_63865_length_428_cov_31.066869	297	378	6	5	81	0.0617284
NODE_63865_length_428_cov_31.066869	297	378	7	3	81	0.0370370
NODE_63865_length_428_cov_31.066869	297	378	8	4	81	0.0493827
NODE_63865_length_428_cov_31.066869	297	378	10	6	81	0.0740741
NODE_63865_length_428_cov_31.066869	297	378	12	24	81	0.2962963
NODE_63865_length_428_cov_31.066869	297	378	13	21	81	0.2592593
NODE_63865_length_428_cov_31.066869	297	378	14	1	81	0.0123457
NODE_63866_length_428_cov_11.799392	62	142	2	80	80	1.0000000
NODE_63866_length_428_cov_11.799392	115	195	0	33	80	0.4125000
NODE_63866_length_428_cov_11.799392	115	195	2	47	80	0.5875000
NODE_63867_length_428_cov_10.595745	227	307	0	80	80	1.0000000
NODE_63870_length_428_cov_6.784195	344	374	0	30	30	1.0000000
NODE_63871_length_428_cov_6.768997	131	194	4	7	63	0.1111111
NODE_63871_length_428_cov_6.768997	131	194	6	56	63	0.8888889
NODE_63895_length_428_cov_4.206687	224	304	0	15	80	0.1875000
NODE_63895_length_428_cov_4.206687	224	304	1	2	80	0.0250000
NODE_63895_length_428_cov_4.206687	224	304	2	5	80	0.0625000
NODE_63895_length_428_cov_4.206687	224	304	3	14	80	0.1750000
NODE_63895_length_428_cov_4.206687	224	304	4	13	80	0.1625000
NODE_63895_length_428_cov_4.206687	224	304	6	19	80	0.2375000
NODE_63895_length_428_cov_4.206687	224	304	7	12	80	0.1500000
NODE_63905_length_428_cov_3.525836	168	236	0	68	68	1.0000000
NODE_63905_length_428_cov_3.525836	209	244	0	35	35	1.0000000
NODE_63959_length_428_cov_2.322188	1	42	0	41	41	1.0000000
NODE_63977_length_428_cov_2.124620	228	308	0	80	80	1.0000000
NODE_64011_length_428_cov_1.848024	178	260	5	4	82	0.0487805
NODE_64011_length_428_cov_1.848024	178	260	6	78	82	0.9512195
NODE_64027_length_428_cov_1.772036	187	255	0	48	68	0.7058824
NODE_64027_length_428_cov_1.772036	187	255	1	20	68	0.2941177
NODE_64245_length_428_cov_0.790274	275	308	1	25	33	0.7575758
NODE_64245_length_428_cov_0.790274	275	308	2	8	33	0.2424242
NODE_64245_length_428_cov_0.790274	276	302	1	19	26	0.7307692
NODE_64245_length_428_cov_0.790274	276	302	2	7	26	0.2692308
NODE_64310_length_427_cov_29.628049	312	392	0	80	80	1.0000000
NODE_64310_length_427_cov_29.628049	365	427	0	62	62	1.0000000
NODE_64310_length_427_cov_29.628049	365	427	0	62	62	1.0000000
NODE_64312_length_427_cov_9.371951	184	239	2	8	55	0.1454545
NODE_64312_length_427_cov_9.371951	184	239	4	34	55	0.6181818
NODE_64312_length_427_cov_9.371951	184	239	5	3	55	0.0545455
NODE_64312_length_427_cov_9.371951	184	239	6	10	55	0.1818182
NODE_64313_length_427_cov_9.359756	11	82	0	71	71	1.0000000
NODE_64313_length_427_cov_9.359756	70	149	0	79	79	1.0000000
NODE_64313_length_427_cov_9.359756	145	225	0	80	80	1.0000000
NODE_64313_length_427_cov_9.359756	198	278	0	80	80	1.0000000
NODE_64321_length_427_cov_5.929878	405	424	0	19	19	1.0000000
NODE_64324_length_427_cov_5.088415	257	332	0	16	75	0.2133333
NODE_64324_length_427_cov_5.088415	257	332	1	19	75	0.2533333
NODE_64324_length_427_cov_5.088415	257	332	2	40	75	0.5333334
NODE_64345_length_427_cov_3.884146	212	260	1	43	48	0.8958333
NODE_64345_length_427_cov_3.884146	212	260	2	5	48	0.1041667
NODE_64383_length_427_cov_2.765244	312	363	0	51	51	1.0000000
NODE_64409_length_427_cov_2.362805	142	177	0	35	35	1.0000000
NODE_64537_length_427_cov_1.359756	56	139	0	83	83	1.0000000
NODE_64728_length_426_cov_21.837920	178	258	0	11	80	0.1375000
NODE_64728_length_426_cov_21.837920	178	258	1	55	80	0.6875000
NODE_64728_length_426_cov_21.837920	178	258	3	14	80	0.1750000
NODE_64729_length_426_cov_16.850153	76	156	0	69	80	0.8625000
NODE_64729_length_426_cov_16.850153	76	156	1	11	80	0.1375000
NODE_64729_length_426_cov_16.850153	129	209	0	16	80	0.2000000
NODE_64729_length_426_cov_16.850153	129	209	1	25	80	0.3125000
NODE_64729_length_426_cov_16.850153	129	209	2	39	80	0.4875000
NODE_64731_length_426_cov_9.033639	152	232	0	80	80	1.0000000
NODE_64731_length_426_cov_9.033639	205	285	0	80	80	1.0000000
NODE_64734_length_426_cov_8.314985	133	213	3	36	80	0.4500000
NODE_64734_length_426_cov_8.314985	133	213	4	44	80	0.5500000
NODE_64734_length_426_cov_8.314985	186	266	1	8	80	0.1000000
NODE_64734_length_426_cov_8.314985	186	266	3	41	80	0.5125000
NODE_64734_length_426_cov_8.314985	186	266	4	31	80	0.3875000
NODE_64735_length_426_cov_8.278287	132	212	0	6	80	0.0750000
NODE_64735_length_426_cov_8.278287	132	212	1	74	80	0.9250000
NODE_64735_length_426_cov_8.278287	185	265	0	59	80	0.7375000
NODE_64735_length_426_cov_8.278287	185	265	1	21	80	0.2625000
NODE_64752_length_426_cov_4.926606	116	196	1	73	80	0.9125000
NODE_64752_length_426_cov_4.926606	116	196	2	7	80	0.0875000
NODE_64754_length_426_cov_4.743119	119	199	1	51	80	0.6375000
NODE_64754_length_426_cov_4.743119	119	199	2	29	80	0.3625000
NODE_64754_length_426_cov_4.743119	172	252	1	80	80	1.0000000
NODE_64833_length_426_cov_2.278287	92	132	3	8	40	0.2000000
NODE_64833_length_426_cov_2.278287	92	132	4	32	40	0.8000000
NODE_64833_length_426_cov_2.278287	139	205	2	42	66	0.6363636
NODE_64833_length_426_cov_2.278287	139	205	3	1	66	0.0151515
NODE_64833_length_426_cov_2.278287	139	205	5	23	66	0.3484848
NODE_64865_length_426_cov_1.896024	80	154	2	5	74	0.0675676
NODE_64865_length_426_cov_1.896024	80	154	3	60	74	0.8108108
NODE_64865_length_426_cov_1.896024	80	154	4	9	74	0.1216216
NODE_64948_length_426_cov_1.397554	240	290	1	2	50	0.0400000
NODE_64948_length_426_cov_1.397554	240	290	2	48	50	0.9600000
NODE_65135_length_426_cov_0.602446	127	158	1	31	31	1.0000000
NODE_65152_length_425_cov_63.938650	0	61	0	3	61	0.0491803
NODE_65152_length_425_cov_63.938650	0	61	1	20	61	0.3278688
NODE_65152_length_425_cov_63.938650	0	61	2	38	61	0.6229508
NODE_65152_length_425_cov_63.938650	34	114	2	80	80	1.0000000
NODE_65164_length_425_cov_4.877301	171	229	8	1	58	0.0172414
NODE_65164_length_425_cov_4.877301	171	229	9	14	58	0.2413793
NODE_65164_length_425_cov_4.877301	171	229	10	1	58	0.0172414
NODE_65164_length_425_cov_4.877301	171	229	11	4	58	0.0689655
NODE_65164_length_425_cov_4.877301	171	229	12	5	58	0.0862069
NODE_65164_length_425_cov_4.877301	171	229	15	2	58	0.0344828
NODE_65164_length_425_cov_4.877301	171	229	16	7	58	0.1206897
NODE_65164_length_425_cov_4.877301	171	229	17	1	58	0.0172414
NODE_65164_length_425_cov_4.877301	171	229	18	1	58	0.0172414
NODE_65164_length_425_cov_4.877301	171	229	20	1	58	0.0172414
NODE_65164_length_425_cov_4.877301	171	229	21	1	58	0.0172414
NODE_65164_length_425_cov_4.877301	171	229	22	3	58	0.0517241
NODE_65164_length_425_cov_4.877301	171	229	25	2	58	0.0344828
NODE_65164_length_425_cov_4.877301	171	229	26	4	58	0.0689655
NODE_65164_length_425_cov_4.877301	171	229	27	6	58	0.1034483
NODE_65164_length_425_cov_4.877301	171	229	28	5	58	0.0862069
NODE_65165_length_425_cov_4.822086	295	377	1	13	82	0.1585366
NODE_65165_length_425_cov_4.822086	295	377	2	33	82	0.4024390
NODE_65165_length_425_cov_4.822086	295	377	3	7	82	0.0853659
NODE_65165_length_425_cov_4.822086	295	377	4	29	82	0.3536585
NODE_65218_length_425_cov_2.809816	38	118	1	80	80	1.0000000
NODE_65278_length_425_cov_1.935583	93	138	0	3	45	0.0666667
NODE_65278_length_425_cov_1.935583	93	138	2	42	45	0.9333333
NODE_65278_length_425_cov_1.935583	170	225	0	44	55	0.8000000
NODE_65278_length_425_cov_1.935583	170	225	1	11	55	0.2000000
NODE_65278_length_425_cov_1.935583	312	355	8	5	43	0.1162791
NODE_65278_length_425_cov_1.935583	312	355	9	38	43	0.8837209
NODE_65565_length_425_cov_0.628834	104	131	0	27	27	1.0000000
NODE_65602_length_424_cov_5.295385	224	270	0	46	46	1.0000000
NODE_65634_length_424_cov_3.255385	266	329	0	22	63	0.3492064
NODE_65634_length_424_cov_3.255385	266	329	1	41	63	0.6507937
NODE_65669_length_424_cov_2.578462	403	422	0	19	19	1.0000000
NODE_65670_length_424_cov_2.578462	122	144	0	22	22	1.0000000
NODE_66111_length_423_cov_2.728395	150	229	0	79	79	1.0000000
NODE_66181_length_423_cov_1.879630	94	142	0	13	48	0.2708333
NODE_66181_length_423_cov_1.879630	94	142	2	5	48	0.1041667
NODE_66181_length_423_cov_1.879630	94	142	4	30	48	0.6250000
NODE_66222_length_423_cov_1.580247	128	208	0	54	80	0.6750000
NODE_66222_length_423_cov_1.580247	128	208	1	17	80	0.2125000
NODE_66222_length_423_cov_1.580247	128	208	2	9	80	0.1125000
NODE_66258_length_423_cov_1.410494	206	286	0	80	80	1.0000000
NODE_66459_length_422_cov_12.021672	201	236	3	11	35	0.3142857
NODE_66459_length_422_cov_12.021672	201	236	5	10	35	0.2857143
NODE_66459_length_422_cov_12.021672	201	236	7	14	35	0.4000000
NODE_66459_length_422_cov_12.021672	247	289	7	42	42	1.0000000
NODE_66460_length_422_cov_10.712074	62	140	1	34	78	0.4358974
NODE_66460_length_422_cov_10.712074	62	140	2	44	78	0.5641026
NODE_66460_length_422_cov_10.712074	115	195	1	26	80	0.3250000
NODE_66460_length_422_cov_10.712074	115	195	2	54	80	0.6750000
NODE_66468_length_422_cov_6.281734	37	117	1	37	80	0.4625000
NODE_66468_length_422_cov_6.281734	37	117	2	43	80	0.5375000
NODE_66468_length_422_cov_6.281734	90	170	2	80	80	1.0000000
NODE_66474_length_422_cov_5.266254	176	256	1	73	80	0.9125000
NODE_66474_length_422_cov_5.266254	176	256	2	7	80	0.0875000
NODE_66485_length_422_cov_4.148607	159	224	0	65	65	1.0000000
NODE_66485_length_422_cov_4.148607	197	277	0	80	80	1.0000000
NODE_66488_length_422_cov_4.003096	146	226	0	42	80	0.5250000
NODE_66488_length_422_cov_4.003096	146	226	2	22	80	0.2750000
NODE_66488_length_422_cov_4.003096	146	226	4	16	80	0.2000000
NODE_66488_length_422_cov_4.003096	199	279	2	11	80	0.1375000
NODE_66488_length_422_cov_4.003096	199	279	4	29	80	0.3625000
NODE_66488_length_422_cov_4.003096	199	279	5	16	80	0.2000000
NODE_66488_length_422_cov_4.003096	199	279	7	24	80	0.3000000
NODE_66512_length_422_cov_3.130031	93	173	0	80	80	1.0000000
NODE_66512_length_422_cov_3.130031	146	226	0	80	80	1.0000000
NODE_66515_length_422_cov_3.077399	291	359	2	15	68	0.2205882
NODE_66515_length_422_cov_3.077399	291	359	3	52	68	0.7647059
NODE_66515_length_422_cov_3.077399	291	359	4	1	68	0.0147059
NODE_66550_length_422_cov_2.191950	5	24	0	19	19	1.0000000
NODE_66560_length_422_cov_2.108359	97	177	0	29	80	0.3625000
NODE_66560_length_422_cov_2.108359	97	177	1	3	80	0.0375000
NODE_66560_length_422_cov_2.108359	97	177	2	48	80	0.6000000
NODE_66560_length_422_cov_2.108359	150	189	2	39	39	1.0000000
NODE_66560_length_422_cov_2.108359	249	289	5	18	40	0.4500000
NODE_66560_length_422_cov_2.108359	249	289	7	22	40	0.5500000
NODE_66806_length_422_cov_0.845201	2	76	0	74	74	1.0000000
NODE_66869_length_421_cov_10.664596	178	256	0	78	78	1.0000000
NODE_66869_length_421_cov_10.664596	229	309	0	80	80	1.0000000
NODE_66874_length_421_cov_7.552795	325	407	0	80	82	0.9756098
NODE_66874_length_421_cov_7.552795	325	407	4	2	82	0.0243902
NODE_66874_length_421_cov_7.552795	380	421	0	41	41	1.0000000
NODE_66875_length_421_cov_7.431677	96	118	0	22	22	1.0000000
NODE_66883_length_421_cov_5.279503	245	310	1	60	65	0.9230769
NODE_66883_length_421_cov_5.279503	245	310	2	5	65	0.0769231
NODE_66884_length_421_cov_5.158385	68	145	0	77	77	1.0000000
NODE_66897_length_421_cov_4.114907	221	287	0	13	66	0.1969697
NODE_66897_length_421_cov_4.114907	221	287	1	53	66	0.8030303
NODE_66898_length_421_cov_4.102484	202	277	0	75	75	1.0000000
NODE_66899_length_421_cov_4.040373	192	272	0	80	80	1.0000000
NODE_66899_length_421_cov_4.040373	245	314	0	69	69	1.0000000
NODE_66923_length_421_cov_3.319876	0	57	0	57	57	1.0000000
NODE_66955_length_421_cov_2.708075	95	118	2	23	23	1.0000000
NODE_66955_length_421_cov_2.708075	109	189	0	22	80	0.2750000
NODE_66955_length_421_cov_2.708075	109	189	1	38	80	0.4750000
NODE_66955_length_421_cov_2.708075	109	189	2	20	80	0.2500000
NODE_66955_length_421_cov_2.708075	248	300	0	52	52	1.0000000
NODE_67073_length_421_cov_1.559006	240	309	0	69	69	1.0000000
NODE_67073_length_421_cov_1.559006	240	310	0	70	70	1.0000000
NODE_67077_length_421_cov_1.537267	305	383	1	78	78	1.0000000
NODE_67098_length_421_cov_1.413043	254	303	2	49	49	1.0000000
NODE_67283_length_421_cov_0.633540	132	156	0	24	24	1.0000000
NODE_67317_length_420_cov_80.766355	90	170	0	45	80	0.5625000
NODE_67317_length_420_cov_80.766355	90	170	1	21	80	0.2625000
NODE_67317_length_420_cov_80.766355	90	170	2	14	80	0.1750000
NODE_67317_length_420_cov_80.766355	143	223	1	13	80	0.1625000
NODE_67317_length_420_cov_80.766355	143	223	2	19	80	0.2375000
NODE_67317_length_420_cov_80.766355	143	223	4	48	80	0.6000000
NODE_67319_length_420_cov_51.473520	171	250	0	47	79	0.5949367
NODE_67319_length_420_cov_51.473520	171	250	2	32	79	0.4050633
NODE_67319_length_420_cov_51.473520	223	307	0	84	84	1.0000000
NODE_67319_length_420_cov_51.473520	303	383	0	80	80	1.0000000
NODE_67319_length_420_cov_51.473520	356	420	0	64	64	1.0000000
NODE_67330_length_420_cov_5.071651	230	310	0	77	80	0.9625000
NODE_67330_length_420_cov_5.071651	230	310	1	3	80	0.0375000
NODE_67334_length_420_cov_4.775701	177	221	0	44	44	1.0000000
NODE_67345_length_420_cov_4.037383	161	240	0	43	79	0.5443038
NODE_67345_length_420_cov_4.037383	161	240	2	36	79	0.4556962
NODE_67358_length_420_cov_3.657321	291	373	0	82	82	1.0000000
NODE_67398_length_420_cov_2.542056	96	176	0	80	80	1.0000000
NODE_67398_length_420_cov_2.542056	148	202	0	54	54	1.0000000
NODE_67398_length_420_cov_2.542056	149	195	0	46	46	1.0000000
NODE_67414_length_420_cov_2.323988	89	108	0	19	19	1.0000000
NODE_67506_length_420_cov_1.641745	277	312	0	35	35	1.0000000
NODE_67547_length_420_cov_1.429907	15	68	6	1	53	0.0188679
NODE_67547_length_420_cov_1.429907	15	68	7	9	53	0.1698113
NODE_67547_length_420_cov_1.429907	15	68	8	25	53	0.4716981
NODE_67547_length_420_cov_1.429907	15	68	9	5	53	0.0943396
NODE_67547_length_420_cov_1.429907	15	68	10	13	53	0.2452830
NODE_67547_length_420_cov_1.429907	69	111	8	21	42	0.5000000
NODE_67547_length_420_cov_1.429907	69	111	9	2	42	0.0476190
NODE_67547_length_420_cov_1.429907	69	111	11	19	42	0.4523810
NODE_67770_length_419_cov_491.015625	0	67	6	1	67	0.0149254
NODE_67770_length_419_cov_491.015625	0	67	8	2	67	0.0298507
NODE_67770_length_419_cov_491.015625	0	67	10	1	67	0.0149254
NODE_67770_length_419_cov_491.015625	0	67	11	1	67	0.0149254
NODE_67770_length_419_cov_491.015625	0	67	14	2	67	0.0298507
NODE_67770_length_419_cov_491.015625	0	67	15	1	67	0.0149254
NODE_67770_length_419_cov_491.015625	0	67	16	1	67	0.0149254
NODE_67770_length_419_cov_491.015625	0	67	18	1	67	0.0149254
NODE_67770_length_419_cov_491.015625	0	67	19	1	67	0.0149254
NODE_67770_length_419_cov_491.015625	0	67	20	2	67	0.0298507
NODE_67770_length_419_cov_491.015625	0	67	21	1	67	0.0149254
NODE_67770_length_419_cov_491.015625	0	67	22	4	67	0.0597015
NODE_67770_length_419_cov_491.015625	0	67	23	1	67	0.0149254
NODE_67770_length_419_cov_491.015625	0	67	24	1	67	0.0149254
NODE_67770_length_419_cov_491.015625	0	67	26	1	67	0.0149254
NODE_67770_length_419_cov_491.015625	0	67	27	1	67	0.0149254
NODE_67770_length_419_cov_491.015625	0	67	28	1	67	0.0149254
NODE_67770_length_419_cov_491.015625	0	67	29	1	67	0.0149254
NODE_67770_length_419_cov_491.015625	0	67	30	5	67	0.0746269
NODE_67770_length_419_cov_491.015625	0	67	32	1	67	0.0149254
NODE_67770_length_419_cov_491.015625	0	67	34	1	67	0.0149254
NODE_67770_length_419_cov_491.015625	0	67	35	1	67	0.0149254
NODE_67770_length_419_cov_491.015625	0	67	37	2	67	0.0298507
NODE_67770_length_419_cov_491.015625	0	67	39	1	67	0.0149254
NODE_67770_length_419_cov_491.015625	0	67	40	2	67	0.0298507
NODE_67770_length_419_cov_491.015625	0	67	49	1	67	0.0149254
NODE_67770_length_419_cov_491.015625	0	67	52	1	67	0.0149254
NODE_67770_length_419_cov_491.015625	0	67	53	1	67	0.0149254
NODE_67770_length_419_cov_491.015625	0	67	57	2	67	0.0298507
NODE_67770_length_419_cov_491.015625	0	67	60	1	67	0.0149254
NODE_67770_length_419_cov_491.015625	0	67	62	3	67	0.0447761
NODE_67770_length_419_cov_491.015625	0	67	65	1	67	0.0149254
NODE_67770_length_419_cov_491.015625	0	67	68	2	67	0.0298507
NODE_67770_length_419_cov_491.015625	0	67	70	1	67	0.0149254
NODE_67770_length_419_cov_491.015625	0	67	71	1	67	0.0149254
NODE_67770_length_419_cov_491.015625	0	67	72	1	67	0.0149254
NODE_67770_length_419_cov_491.015625	0	67	74	1	67	0.0149254
NODE_67770_length_419_cov_491.015625	0	67	78	2	67	0.0298507
NODE_67770_length_419_cov_491.015625	0	67	80	2	67	0.0298507
NODE_67770_length_419_cov_491.015625	0	67	82	1	67	0.0149254
NODE_67770_length_419_cov_491.015625	0	67	84	2	67	0.0298507
NODE_67770_length_419_cov_491.015625	0	67	85	2	67	0.0298507
NODE_67770_length_419_cov_491.015625	0	67	87	2	67	0.0298507
NODE_67770_length_419_cov_491.015625	0	67	88	2	67	0.0298507
NODE_67770_length_419_cov_491.015625	0	67	89	1	67	0.0149254
NODE_67770_length_419_cov_491.015625	0	67	6	1	67	0.0149254
NODE_67770_length_419_cov_491.015625	0	67	8	2	67	0.0298507
NODE_67770_length_419_cov_491.015625	0	67	10	1	67	0.0149254
NODE_67770_length_419_cov_491.015625	0	67	11	1	67	0.0149254
NODE_67770_length_419_cov_491.015625	0	67	14	2	67	0.0298507
NODE_67770_length_419_cov_491.015625	0	67	15	1	67	0.0149254
NODE_67770_length_419_cov_491.015625	0	67	16	1	67	0.0149254
NODE_67770_length_419_cov_491.015625	0	67	18	1	67	0.0149254
NODE_67770_length_419_cov_491.015625	0	67	19	1	67	0.0149254
NODE_67770_length_419_cov_491.015625	0	67	20	2	67	0.0298507
NODE_67770_length_419_cov_491.015625	0	67	21	1	67	0.0149254
NODE_67770_length_419_cov_491.015625	0	67	22	4	67	0.0597015
NODE_67770_length_419_cov_491.015625	0	67	23	1	67	0.0149254
NODE_67770_length_419_cov_491.015625	0	67	24	1	67	0.0149254
NODE_67770_length_419_cov_491.015625	0	67	26	1	67	0.0149254
NODE_67770_length_419_cov_491.015625	0	67	27	1	67	0.0149254
NODE_67770_length_419_cov_491.015625	0	67	28	1	67	0.0149254
NODE_67770_length_419_cov_491.015625	0	67	29	1	67	0.0149254
NODE_67770_length_419_cov_491.015625	0	67	30	5	67	0.0746269
NODE_67770_length_419_cov_491.015625	0	67	32	1	67	0.0149254
NODE_67770_length_419_cov_491.015625	0	67	34	1	67	0.0149254
NODE_67770_length_419_cov_491.015625	0	67	35	1	67	0.0149254
NODE_67770_length_419_cov_491.015625	0	67	37	2	67	0.0298507
NODE_67770_length_419_cov_491.015625	0	67	39	1	67	0.0149254
NODE_67770_length_419_cov_491.015625	0	67	40	2	67	0.0298507
NODE_67770_length_419_cov_491.015625	0	67	49	1	67	0.0149254
NODE_67770_length_419_cov_491.015625	0	67	52	1	67	0.0149254
NODE_67770_length_419_cov_491.015625	0	67	53	1	67	0.0149254
NODE_67770_length_419_cov_491.015625	0	67	57	2	67	0.0298507
NODE_67770_length_419_cov_491.015625	0	67	60	1	67	0.0149254
NODE_67770_length_419_cov_491.015625	0	67	62	3	67	0.0447761
NODE_67770_length_419_cov_491.015625	0	67	65	1	67	0.0149254
NODE_67770_length_419_cov_491.015625	0	67	68	2	67	0.0298507
NODE_67770_length_419_cov_491.015625	0	67	70	1	67	0.0149254
NODE_67770_length_419_cov_491.015625	0	67	71	1	67	0.0149254
NODE_67770_length_419_cov_491.015625	0	67	72	1	67	0.0149254
NODE_67770_length_419_cov_491.015625	0	67	74	1	67	0.0149254
NODE_67770_length_419_cov_491.015625	0	67	78	2	67	0.0298507
NODE_67770_length_419_cov_491.015625	0	67	80	2	67	0.0298507
NODE_67770_length_419_cov_491.015625	0	67	82	1	67	0.0149254
NODE_67770_length_419_cov_491.015625	0	67	84	2	67	0.0298507
NODE_67770_length_419_cov_491.015625	0	67	85	2	67	0.0298507
NODE_67770_length_419_cov_491.015625	0	67	87	2	67	0.0298507
NODE_67770_length_419_cov_491.015625	0	67	88	2	67	0.0298507
NODE_67770_length_419_cov_491.015625	0	67	89	1	67	0.0149254
NODE_67770_length_419_cov_491.015625	0	67	6	1	67	0.0149254
NODE_67770_length_419_cov_491.015625	0	67	8	2	67	0.0298507
NODE_67770_length_419_cov_491.015625	0	67	10	1	67	0.0149254
NODE_67770_length_419_cov_491.015625	0	67	11	1	67	0.0149254
NODE_67770_length_419_cov_491.015625	0	67	14	2	67	0.0298507
NODE_67770_length_419_cov_491.015625	0	67	15	1	67	0.0149254
NODE_67770_length_419_cov_491.015625	0	67	16	1	67	0.0149254
NODE_67770_length_419_cov_491.015625	0	67	18	1	67	0.0149254
NODE_67770_length_419_cov_491.015625	0	67	19	1	67	0.0149254
NODE_67770_length_419_cov_491.015625	0	67	20	2	67	0.0298507
NODE_67770_length_419_cov_491.015625	0	67	21	1	67	0.0149254
NODE_67770_length_419_cov_491.015625	0	67	22	4	67	0.0597015
NODE_67770_length_419_cov_491.015625	0	67	23	1	67	0.0149254
NODE_67770_length_419_cov_491.015625	0	67	24	1	67	0.0149254
NODE_67770_length_419_cov_491.015625	0	67	26	1	67	0.0149254
NODE_67770_length_419_cov_491.015625	0	67	27	1	67	0.0149254
NODE_67770_length_419_cov_491.015625	0	67	28	1	67	0.0149254
NODE_67770_length_419_cov_491.015625	0	67	29	1	67	0.0149254
NODE_67770_length_419_cov_491.015625	0	67	30	5	67	0.0746269
NODE_67770_length_419_cov_491.015625	0	67	32	1	67	0.0149254
NODE_67770_length_419_cov_491.015625	0	67	34	1	67	0.0149254
NODE_67770_length_419_cov_491.015625	0	67	35	1	67	0.0149254
NODE_67770_length_419_cov_491.015625	0	67	37	2	67	0.0298507
NODE_67770_length_419_cov_491.015625	0	67	39	1	67	0.0149254
NODE_67770_length_419_cov_491.015625	0	67	40	2	67	0.0298507
NODE_67770_length_419_cov_491.015625	0	67	49	1	67	0.0149254
NODE_67770_length_419_cov_491.015625	0	67	52	1	67	0.0149254
NODE_67770_length_419_cov_491.015625	0	67	53	1	67	0.0149254
NODE_67770_length_419_cov_491.015625	0	67	57	2	67	0.0298507
NODE_67770_length_419_cov_491.015625	0	67	60	1	67	0.0149254
NODE_67770_length_419_cov_491.015625	0	67	62	3	67	0.0447761
NODE_67770_length_419_cov_491.015625	0	67	65	1	67	0.0149254
NODE_67770_length_419_cov_491.015625	0	67	68	2	67	0.0298507
NODE_67770_length_419_cov_491.015625	0	67	70	1	67	0.0149254
NODE_67770_length_419_cov_491.015625	0	67	71	1	67	0.0149254
NODE_67770_length_419_cov_491.015625	0	67	72	1	67	0.0149254
NODE_67770_length_419_cov_491.015625	0	67	74	1	67	0.0149254
NODE_67770_length_419_cov_491.015625	0	67	78	2	67	0.0298507
NODE_67770_length_419_cov_491.015625	0	67	80	2	67	0.0298507
NODE_67770_length_419_cov_491.015625	0	67	82	1	67	0.0149254
NODE_67770_length_419_cov_491.015625	0	67	84	2	67	0.0298507
NODE_67770_length_419_cov_491.015625	0	67	85	2	67	0.0298507
NODE_67770_length_419_cov_491.015625	0	67	87	2	67	0.0298507
NODE_67770_length_419_cov_491.015625	0	67	88	2	67	0.0298507
NODE_67770_length_419_cov_491.015625	0	67	89	1	67	0.0149254
NODE_67770_length_419_cov_491.015625	0	67	6	1	67	0.0149254
NODE_67770_length_419_cov_491.015625	0	67	8	2	67	0.0298507
NODE_67770_length_419_cov_491.015625	0	67	10	1	67	0.0149254
NODE_67770_length_419_cov_491.015625	0	67	11	1	67	0.0149254
NODE_67770_length_419_cov_491.015625	0	67	14	2	67	0.0298507
NODE_67770_length_419_cov_491.015625	0	67	15	1	67	0.0149254
NODE_67770_length_419_cov_491.015625	0	67	16	1	67	0.0149254
NODE_67770_length_419_cov_491.015625	0	67	18	1	67	0.0149254
NODE_67770_length_419_cov_491.015625	0	67	19	1	67	0.0149254
NODE_67770_length_419_cov_491.015625	0	67	20	2	67	0.0298507
NODE_67770_length_419_cov_491.015625	0	67	21	1	67	0.0149254
NODE_67770_length_419_cov_491.015625	0	67	22	4	67	0.0597015
NODE_67770_length_419_cov_491.015625	0	67	23	1	67	0.0149254
NODE_67770_length_419_cov_491.015625	0	67	24	1	67	0.0149254
NODE_67770_length_419_cov_491.015625	0	67	26	1	67	0.0149254
NODE_67770_length_419_cov_491.015625	0	67	27	1	67	0.0149254
NODE_67770_length_419_cov_491.015625	0	67	28	1	67	0.0149254
NODE_67770_length_419_cov_491.015625	0	67	29	1	67	0.0149254
NODE_67770_length_419_cov_491.015625	0	67	30	5	67	0.0746269
NODE_67770_length_419_cov_491.015625	0	67	32	1	67	0.0149254
NODE_67770_length_419_cov_491.015625	0	67	34	1	67	0.0149254
NODE_67770_length_419_cov_491.015625	0	67	35	1	67	0.0149254
NODE_67770_length_419_cov_491.015625	0	67	37	2	67	0.0298507
NODE_67770_length_419_cov_491.015625	0	67	39	1	67	0.0149254
NODE_67770_length_419_cov_491.015625	0	67	40	2	67	0.0298507
NODE_67770_length_419_cov_491.015625	0	67	49	1	67	0.0149254
NODE_67770_length_419_cov_491.015625	0	67	52	1	67	0.0149254
NODE_67770_length_419_cov_491.015625	0	67	53	1	67	0.0149254
NODE_67770_length_419_cov_491.015625	0	67	57	2	67	0.0298507
NODE_67770_length_419_cov_491.015625	0	67	60	1	67	0.0149254
NODE_67770_length_419_cov_491.015625	0	67	62	3	67	0.0447761
NODE_67770_length_419_cov_491.015625	0	67	65	1	67	0.0149254
NODE_67770_length_419_cov_491.015625	0	67	68	2	67	0.0298507
NODE_67770_length_419_cov_491.015625	0	67	70	1	67	0.0149254
NODE_67770_length_419_cov_491.015625	0	67	71	1	67	0.0149254
NODE_67770_length_419_cov_491.015625	0	67	72	1	67	0.0149254
NODE_67770_length_419_cov_491.015625	0	67	74	1	67	0.0149254
NODE_67770_length_419_cov_491.015625	0	67	78	2	67	0.0298507
NODE_67770_length_419_cov_491.015625	0	67	80	2	67	0.0298507
NODE_67770_length_419_cov_491.015625	0	67	82	1	67	0.0149254
NODE_67770_length_419_cov_491.015625	0	67	84	2	67	0.0298507
NODE_67770_length_419_cov_491.015625	0	67	85	2	67	0.0298507
NODE_67770_length_419_cov_491.015625	0	67	87	2	67	0.0298507
NODE_67770_length_419_cov_491.015625	0	67	88	2	67	0.0298507
NODE_67770_length_419_cov_491.015625	0	67	89	1	67	0.0149254
NODE_67770_length_419_cov_491.015625	63	143	87	1	80	0.0125000
NODE_67770_length_419_cov_491.015625	63	143	88	2	80	0.0250000
NODE_67770_length_419_cov_491.015625	63	143	89	1	80	0.0125000
NODE_67770_length_419_cov_491.015625	63	143	94	1	80	0.0125000
NODE_67770_length_419_cov_491.015625	63	143	97	1	80	0.0125000
NODE_67770_length_419_cov_491.015625	63	143	98	1	80	0.0125000
NODE_67770_length_419_cov_491.015625	63	143	100	2	80	0.0250000
NODE_67770_length_419_cov_491.015625	63	143	101	1	80	0.0125000
NODE_67770_length_419_cov_491.015625	63	143	102	1	80	0.0125000
NODE_67770_length_419_cov_491.015625	63	143	103	1	80	0.0125000
NODE_67770_length_419_cov_491.015625	63	143	104	1	80	0.0125000
NODE_67770_length_419_cov_491.015625	63	143	106	1	80	0.0125000
NODE_67770_length_419_cov_491.015625	63	143	107	1	80	0.0125000
NODE_67770_length_419_cov_491.015625	63	143	108	1	80	0.0125000
NODE_67770_length_419_cov_491.015625	63	143	111	1	80	0.0125000
NODE_67770_length_419_cov_491.015625	63	143	112	1	80	0.0125000
NODE_67770_length_419_cov_491.015625	63	143	114	1	80	0.0125000
NODE_67770_length_419_cov_491.015625	63	143	115	1	80	0.0125000
NODE_67770_length_419_cov_491.015625	63	143	116	1	80	0.0125000
NODE_67770_length_419_cov_491.015625	63	143	120	1	80	0.0125000
NODE_67770_length_419_cov_491.015625	63	143	121	6	80	0.0750000
NODE_67770_length_419_cov_491.015625	63	143	122	2	80	0.0250000
NODE_67770_length_419_cov_491.015625	63	143	123	1	80	0.0125000
NODE_67770_length_419_cov_491.015625	63	143	124	1	80	0.0125000
NODE_67770_length_419_cov_491.015625	63	143	125	1	80	0.0125000
NODE_67770_length_419_cov_491.015625	63	143	127	1	80	0.0125000
NODE_67770_length_419_cov_491.015625	63	143	130	3	80	0.0375000
NODE_67770_length_419_cov_491.015625	63	143	134	1	80	0.0125000
NODE_67770_length_419_cov_491.015625	63	143	135	1	80	0.0125000
NODE_67770_length_419_cov_491.015625	63	143	138	1	80	0.0125000
NODE_67770_length_419_cov_491.015625	63	143	139	1	80	0.0125000
NODE_67770_length_419_cov_491.015625	63	143	141	2	80	0.0250000
NODE_67770_length_419_cov_491.015625	63	143	142	1	80	0.0125000
NODE_67770_length_419_cov_491.015625	63	143	143	1	80	0.0125000
NODE_67770_length_419_cov_491.015625	63	143	147	1	80	0.0125000
NODE_67770_length_419_cov_491.015625	63	143	150	1	80	0.0125000
NODE_67770_length_419_cov_491.015625	63	143	154	1	80	0.0125000
NODE_67770_length_419_cov_491.015625	63	143	159	1	80	0.0125000
NODE_67770_length_419_cov_491.015625	63	143	163	1	80	0.0125000
NODE_67770_length_419_cov_491.015625	63	143	164	1	80	0.0125000
NODE_67770_length_419_cov_491.015625	63	143	167	2	80	0.0250000
NODE_67770_length_419_cov_491.015625	63	143	168	1	80	0.0125000
NODE_67770_length_419_cov_491.015625	63	143	169	2	80	0.0250000
NODE_67770_length_419_cov_491.015625	63	143	171	2	80	0.0250000
NODE_67770_length_419_cov_491.015625	63	143	173	1	80	0.0125000
NODE_67770_length_419_cov_491.015625	63	143	174	1	80	0.0125000
NODE_67770_length_419_cov_491.015625	63	143	175	1	80	0.0125000
NODE_67770_length_419_cov_491.015625	63	143	176	1	80	0.0125000
NODE_67770_length_419_cov_491.015625	63	143	177	1	80	0.0125000
NODE_67770_length_419_cov_491.015625	63	143	179	1	80	0.0125000
NODE_67770_length_419_cov_491.015625	63	143	181	2	80	0.0250000
NODE_67770_length_419_cov_491.015625	63	143	183	6	80	0.0750000
NODE_67770_length_419_cov_491.015625	63	143	184	1	80	0.0125000
NODE_67770_length_419_cov_491.015625	63	143	186	1	80	0.0125000
NODE_67770_length_419_cov_491.015625	63	143	188	2	80	0.0250000
NODE_67770_length_419_cov_491.015625	63	143	189	3	80	0.0375000
NODE_67770_length_419_cov_491.015625	63	143	190	1	80	0.0125000
NODE_67770_length_419_cov_491.015625	63	143	87	1	80	0.0125000
NODE_67770_length_419_cov_491.015625	63	143	88	2	80	0.0250000
NODE_67770_length_419_cov_491.015625	63	143	89	1	80	0.0125000
NODE_67770_length_419_cov_491.015625	63	143	94	1	80	0.0125000
NODE_67770_length_419_cov_491.015625	63	143	97	1	80	0.0125000
NODE_67770_length_419_cov_491.015625	63	143	98	1	80	0.0125000
NODE_67770_length_419_cov_491.015625	63	143	100	2	80	0.0250000
NODE_67770_length_419_cov_491.015625	63	143	101	1	80	0.0125000
NODE_67770_length_419_cov_491.015625	63	143	102	1	80	0.0125000
NODE_67770_length_419_cov_491.015625	63	143	103	1	80	0.0125000
NODE_67770_length_419_cov_491.015625	63	143	104	1	80	0.0125000
NODE_67770_length_419_cov_491.015625	63	143	106	1	80	0.0125000
NODE_67770_length_419_cov_491.015625	63	143	107	1	80	0.0125000
NODE_67770_length_419_cov_491.015625	63	143	108	1	80	0.0125000
NODE_67770_length_419_cov_491.015625	63	143	111	1	80	0.0125000
NODE_67770_length_419_cov_491.015625	63	143	112	1	80	0.0125000
NODE_67770_length_419_cov_491.015625	63	143	114	1	80	0.0125000
NODE_67770_length_419_cov_491.015625	63	143	115	1	80	0.0125000
NODE_67770_length_419_cov_491.015625	63	143	116	1	80	0.0125000
NODE_67770_length_419_cov_491.015625	63	143	120	1	80	0.0125000
NODE_67770_length_419_cov_491.015625	63	143	121	6	80	0.0750000
NODE_67770_length_419_cov_491.015625	63	143	122	2	80	0.0250000
NODE_67770_length_419_cov_491.015625	63	143	123	1	80	0.0125000
NODE_67770_length_419_cov_491.015625	63	143	124	1	80	0.0125000
NODE_67770_length_419_cov_491.015625	63	143	125	1	80	0.0125000
NODE_67770_length_419_cov_491.015625	63	143	127	1	80	0.0125000
NODE_67770_length_419_cov_491.015625	63	143	130	3	80	0.0375000
NODE_67770_length_419_cov_491.015625	63	143	134	1	80	0.0125000
NODE_67770_length_419_cov_491.015625	63	143	135	1	80	0.0125000
NODE_67770_length_419_cov_491.015625	63	143	138	1	80	0.0125000
NODE_67770_length_419_cov_491.015625	63	143	139	1	80	0.0125000
NODE_67770_length_419_cov_491.015625	63	143	141	2	80	0.0250000
NODE_67770_length_419_cov_491.015625	63	143	142	1	80	0.0125000
NODE_67770_length_419_cov_491.015625	63	143	143	1	80	0.0125000
NODE_67770_length_419_cov_491.015625	63	143	147	1	80	0.0125000
NODE_67770_length_419_cov_491.015625	63	143	150	1	80	0.0125000
NODE_67770_length_419_cov_491.015625	63	143	154	1	80	0.0125000
NODE_67770_length_419_cov_491.015625	63	143	159	1	80	0.0125000
NODE_67770_length_419_cov_491.015625	63	143	163	1	80	0.0125000
NODE_67770_length_419_cov_491.015625	63	143	164	1	80	0.0125000
NODE_67770_length_419_cov_491.015625	63	143	167	2	80	0.0250000
NODE_67770_length_419_cov_491.015625	63	143	168	1	80	0.0125000
NODE_67770_length_419_cov_491.015625	63	143	169	2	80	0.0250000
NODE_67770_length_419_cov_491.015625	63	143	171	2	80	0.0250000
NODE_67770_length_419_cov_491.015625	63	143	173	1	80	0.0125000
NODE_67770_length_419_cov_491.015625	63	143	174	1	80	0.0125000
NODE_67770_length_419_cov_491.015625	63	143	175	1	80	0.0125000
NODE_67770_length_419_cov_491.015625	63	143	176	1	80	0.0125000
NODE_67770_length_419_cov_491.015625	63	143	177	1	80	0.0125000
NODE_67770_length_419_cov_491.015625	63	143	179	1	80	0.0125000
NODE_67770_length_419_cov_491.015625	63	143	181	2	80	0.0250000
NODE_67770_length_419_cov_491.015625	63	143	183	6	80	0.0750000
NODE_67770_length_419_cov_491.015625	63	143	184	1	80	0.0125000
NODE_67770_length_419_cov_491.015625	63	143	186	1	80	0.0125000
NODE_67770_length_419_cov_491.015625	63	143	188	2	80	0.0250000
NODE_67770_length_419_cov_491.015625	63	143	189	3	80	0.0375000
NODE_67770_length_419_cov_491.015625	63	143	190	1	80	0.0125000
NODE_67770_length_419_cov_491.015625	63	143	87	1	80	0.0125000
NODE_67770_length_419_cov_491.015625	63	143	88	2	80	0.0250000
NODE_67770_length_419_cov_491.015625	63	143	89	1	80	0.0125000
NODE_67770_length_419_cov_491.015625	63	143	94	1	80	0.0125000
NODE_67770_length_419_cov_491.015625	63	143	97	1	80	0.0125000
NODE_67770_length_419_cov_491.015625	63	143	98	1	80	0.0125000
NODE_67770_length_419_cov_491.015625	63	143	100	2	80	0.0250000
NODE_67770_length_419_cov_491.015625	63	143	101	1	80	0.0125000
NODE_67770_length_419_cov_491.015625	63	143	102	1	80	0.0125000
NODE_67770_length_419_cov_491.015625	63	143	103	1	80	0.0125000
NODE_67770_length_419_cov_491.015625	63	143	104	1	80	0.0125000
NODE_67770_length_419_cov_491.015625	63	143	106	1	80	0.0125000
NODE_67770_length_419_cov_491.015625	63	143	107	1	80	0.0125000
NODE_67770_length_419_cov_491.015625	63	143	108	1	80	0.0125000
NODE_67770_length_419_cov_491.015625	63	143	111	1	80	0.0125000
NODE_67770_length_419_cov_491.015625	63	143	112	1	80	0.0125000
NODE_67770_length_419_cov_491.015625	63	143	114	1	80	0.0125000
NODE_67770_length_419_cov_491.015625	63	143	115	1	80	0.0125000
NODE_67770_length_419_cov_491.015625	63	143	116	1	80	0.0125000
NODE_67770_length_419_cov_491.015625	63	143	120	1	80	0.0125000
NODE_67770_length_419_cov_491.015625	63	143	121	6	80	0.0750000
NODE_67770_length_419_cov_491.015625	63	143	122	2	80	0.0250000
NODE_67770_length_419_cov_491.015625	63	143	123	1	80	0.0125000
NODE_67770_length_419_cov_491.015625	63	143	124	1	80	0.0125000
NODE_67770_length_419_cov_491.015625	63	143	125	1	80	0.0125000
NODE_67770_length_419_cov_491.015625	63	143	127	1	80	0.0125000
NODE_67770_length_419_cov_491.015625	63	143	130	3	80	0.0375000
NODE_67770_length_419_cov_491.015625	63	143	134	1	80	0.0125000
NODE_67770_length_419_cov_491.015625	63	143	135	1	80	0.0125000
NODE_67770_length_419_cov_491.015625	63	143	138	1	80	0.0125000
NODE_67770_length_419_cov_491.015625	63	143	139	1	80	0.0125000
NODE_67770_length_419_cov_491.015625	63	143	141	2	80	0.0250000
NODE_67770_length_419_cov_491.015625	63	143	142	1	80	0.0125000
NODE_67770_length_419_cov_491.015625	63	143	143	1	80	0.0125000
NODE_67770_length_419_cov_491.015625	63	143	147	1	80	0.0125000
NODE_67770_length_419_cov_491.015625	63	143	150	1	80	0.0125000
NODE_67770_length_419_cov_491.015625	63	143	154	1	80	0.0125000
NODE_67770_length_419_cov_491.015625	63	143	159	1	80	0.0125000
NODE_67770_length_419_cov_491.015625	63	143	163	1	80	0.0125000
NODE_67770_length_419_cov_491.015625	63	143	164	1	80	0.0125000
NODE_67770_length_419_cov_491.015625	63	143	167	2	80	0.0250000
NODE_67770_length_419_cov_491.015625	63	143	168	1	80	0.0125000
NODE_67770_length_419_cov_491.015625	63	143	169	2	80	0.0250000
NODE_67770_length_419_cov_491.015625	63	143	171	2	80	0.0250000
NODE_67770_length_419_cov_491.015625	63	143	173	1	80	0.0125000
NODE_67770_length_419_cov_491.015625	63	143	174	1	80	0.0125000
NODE_67770_length_419_cov_491.015625	63	143	175	1	80	0.0125000
NODE_67770_length_419_cov_491.015625	63	143	176	1	80	0.0125000
NODE_67770_length_419_cov_491.015625	63	143	177	1	80	0.0125000
NODE_67770_length_419_cov_491.015625	63	143	179	1	80	0.0125000
NODE_67770_length_419_cov_491.015625	63	143	181	2	80	0.0250000
NODE_67770_length_419_cov_491.015625	63	143	183	6	80	0.0750000
NODE_67770_length_419_cov_491.015625	63	143	184	1	80	0.0125000
NODE_67770_length_419_cov_491.015625	63	143	186	1	80	0.0125000
NODE_67770_length_419_cov_491.015625	63	143	188	2	80	0.0250000
NODE_67770_length_419_cov_491.015625	63	143	189	3	80	0.0375000
NODE_67770_length_419_cov_491.015625	63	143	190	1	80	0.0125000
NODE_67770_length_419_cov_491.015625	116	196	146	3	80	0.0375000
NODE_67770_length_419_cov_491.015625	116	196	148	1	80	0.0125000
NODE_67770_length_419_cov_491.015625	116	196	151	3	80	0.0375000
NODE_67770_length_419_cov_491.015625	116	196	152	1	80	0.0125000
NODE_67770_length_419_cov_491.015625	116	196	153	1	80	0.0125000
NODE_67770_length_419_cov_491.015625	116	196	157	1	80	0.0125000
NODE_67770_length_419_cov_491.015625	116	196	162	1	80	0.0125000
NODE_67770_length_419_cov_491.015625	116	196	163	1	80	0.0125000
NODE_67770_length_419_cov_491.015625	116	196	164	3	80	0.0375000
NODE_67770_length_419_cov_491.015625	116	196	165	1	80	0.0125000
NODE_67770_length_419_cov_491.015625	116	196	168	2	80	0.0250000
NODE_67770_length_419_cov_491.015625	116	196	169	7	80	0.0875000
NODE_67770_length_419_cov_491.015625	116	196	171	2	80	0.0250000
NODE_67770_length_419_cov_491.015625	116	196	173	3	80	0.0375000
NODE_67770_length_419_cov_491.015625	116	196	174	7	80	0.0875000
NODE_67770_length_419_cov_491.015625	116	196	175	3	80	0.0375000
NODE_67770_length_419_cov_491.015625	116	196	176	1	80	0.0125000
NODE_67770_length_419_cov_491.015625	116	196	177	2	80	0.0250000
NODE_67770_length_419_cov_491.015625	116	196	178	3	80	0.0375000
NODE_67770_length_419_cov_491.015625	116	196	179	3	80	0.0375000
NODE_67770_length_419_cov_491.015625	116	196	180	3	80	0.0375000
NODE_67770_length_419_cov_491.015625	116	196	181	2	80	0.0250000
NODE_67770_length_419_cov_491.015625	116	196	182	1	80	0.0125000
NODE_67770_length_419_cov_491.015625	116	196	183	6	80	0.0750000
NODE_67770_length_419_cov_491.015625	116	196	184	2	80	0.0250000
NODE_67770_length_419_cov_491.015625	116	196	186	6	80	0.0750000
NODE_67770_length_419_cov_491.015625	116	196	187	1	80	0.0125000
NODE_67770_length_419_cov_491.015625	116	196	188	2	80	0.0250000
NODE_67770_length_419_cov_491.015625	116	196	189	6	80	0.0750000
NODE_67770_length_419_cov_491.015625	116	196	190	1	80	0.0125000
NODE_67770_length_419_cov_491.015625	116	196	191	1	80	0.0125000
NODE_67770_length_419_cov_491.015625	116	196	146	3	80	0.0375000
NODE_67770_length_419_cov_491.015625	116	196	148	1	80	0.0125000
NODE_67770_length_419_cov_491.015625	116	196	151	3	80	0.0375000
NODE_67770_length_419_cov_491.015625	116	196	152	1	80	0.0125000
NODE_67770_length_419_cov_491.015625	116	196	153	1	80	0.0125000
NODE_67770_length_419_cov_491.015625	116	196	157	1	80	0.0125000
NODE_67770_length_419_cov_491.015625	116	196	162	1	80	0.0125000
NODE_67770_length_419_cov_491.015625	116	196	163	1	80	0.0125000
NODE_67770_length_419_cov_491.015625	116	196	164	3	80	0.0375000
NODE_67770_length_419_cov_491.015625	116	196	165	1	80	0.0125000
NODE_67770_length_419_cov_491.015625	116	196	168	2	80	0.0250000
NODE_67770_length_419_cov_491.015625	116	196	169	7	80	0.0875000
NODE_67770_length_419_cov_491.015625	116	196	171	2	80	0.0250000
NODE_67770_length_419_cov_491.015625	116	196	173	3	80	0.0375000
NODE_67770_length_419_cov_491.015625	116	196	174	7	80	0.0875000
NODE_67770_length_419_cov_491.015625	116	196	175	3	80	0.0375000
NODE_67770_length_419_cov_491.015625	116	196	176	1	80	0.0125000
NODE_67770_length_419_cov_491.015625	116	196	177	2	80	0.0250000
NODE_67770_length_419_cov_491.015625	116	196	178	3	80	0.0375000
NODE_67770_length_419_cov_491.015625	116	196	179	3	80	0.0375000
NODE_67770_length_419_cov_491.015625	116	196	180	3	80	0.0375000
NODE_67770_length_419_cov_491.015625	116	196	181	2	80	0.0250000
NODE_67770_length_419_cov_491.015625	116	196	182	1	80	0.0125000
NODE_67770_length_419_cov_491.015625	116	196	183	6	80	0.0750000
NODE_67770_length_419_cov_491.015625	116	196	184	2	80	0.0250000
NODE_67770_length_419_cov_491.015625	116	196	186	6	80	0.0750000
NODE_67770_length_419_cov_491.015625	116	196	187	1	80	0.0125000
NODE_67770_length_419_cov_491.015625	116	196	188	2	80	0.0250000
NODE_67770_length_419_cov_491.015625	116	196	189	6	80	0.0750000
NODE_67770_length_419_cov_491.015625	116	196	190	1	80	0.0125000
NODE_67770_length_419_cov_491.015625	116	196	191	1	80	0.0125000
NODE_67770_length_419_cov_491.015625	116	196	146	3	80	0.0375000
NODE_67770_length_419_cov_491.015625	116	196	148	1	80	0.0125000
NODE_67770_length_419_cov_491.015625	116	196	151	3	80	0.0375000
NODE_67770_length_419_cov_491.015625	116	196	152	1	80	0.0125000
NODE_67770_length_419_cov_491.015625	116	196	153	1	80	0.0125000
NODE_67770_length_419_cov_491.015625	116	196	157	1	80	0.0125000
NODE_67770_length_419_cov_491.015625	116	196	162	1	80	0.0125000
NODE_67770_length_419_cov_491.015625	116	196	163	1	80	0.0125000
NODE_67770_length_419_cov_491.015625	116	196	164	3	80	0.0375000
NODE_67770_length_419_cov_491.015625	116	196	165	1	80	0.0125000
NODE_67770_length_419_cov_491.015625	116	196	168	2	80	0.0250000
NODE_67770_length_419_cov_491.015625	116	196	169	7	80	0.0875000
NODE_67770_length_419_cov_491.015625	116	196	171	2	80	0.0250000
NODE_67770_length_419_cov_491.015625	116	196	173	3	80	0.0375000
NODE_67770_length_419_cov_491.015625	116	196	174	7	80	0.0875000
NODE_67770_length_419_cov_491.015625	116	196	175	3	80	0.0375000
NODE_67770_length_419_cov_491.015625	116	196	176	1	80	0.0125000
NODE_67770_length_419_cov_491.015625	116	196	177	2	80	0.0250000
NODE_67770_length_419_cov_491.015625	116	196	178	3	80	0.0375000
NODE_67770_length_419_cov_491.015625	116	196	179	3	80	0.0375000
NODE_67770_length_419_cov_491.015625	116	196	180	3	80	0.0375000
NODE_67770_length_419_cov_491.015625	116	196	181	2	80	0.0250000
NODE_67770_length_419_cov_491.015625	116	196	182	1	80	0.0125000
NODE_67770_length_419_cov_491.015625	116	196	183	6	80	0.0750000
NODE_67770_length_419_cov_491.015625	116	196	184	2	80	0.0250000
NODE_67770_length_419_cov_491.015625	116	196	186	6	80	0.0750000
NODE_67770_length_419_cov_491.015625	116	196	187	1	80	0.0125000
NODE_67770_length_419_cov_491.015625	116	196	188	2	80	0.0250000
NODE_67770_length_419_cov_491.015625	116	196	189	6	80	0.0750000
NODE_67770_length_419_cov_491.015625	116	196	190	1	80	0.0125000
NODE_67770_length_419_cov_491.015625	116	196	191	1	80	0.0125000
NODE_67770_length_419_cov_491.015625	116	196	146	3	80	0.0375000
NODE_67770_length_419_cov_491.015625	116	196	148	1	80	0.0125000
NODE_67770_length_419_cov_491.015625	116	196	151	3	80	0.0375000
NODE_67770_length_419_cov_491.015625	116	196	152	1	80	0.0125000
NODE_67770_length_419_cov_491.015625	116	196	153	1	80	0.0125000
NODE_67770_length_419_cov_491.015625	116	196	157	1	80	0.0125000
NODE_67770_length_419_cov_491.015625	116	196	162	1	80	0.0125000
NODE_67770_length_419_cov_491.015625	116	196	163	1	80	0.0125000
NODE_67770_length_419_cov_491.015625	116	196	164	3	80	0.0375000
NODE_67770_length_419_cov_491.015625	116	196	165	1	80	0.0125000
NODE_67770_length_419_cov_491.015625	116	196	168	2	80	0.0250000
NODE_67770_length_419_cov_491.015625	116	196	169	7	80	0.0875000
NODE_67770_length_419_cov_491.015625	116	196	171	2	80	0.0250000
NODE_67770_length_419_cov_491.015625	116	196	173	3	80	0.0375000
NODE_67770_length_419_cov_491.015625	116	196	174	7	80	0.0875000
NODE_67770_length_419_cov_491.015625	116	196	175	3	80	0.0375000
NODE_67770_length_419_cov_491.015625	116	196	176	1	80	0.0125000
NODE_67770_length_419_cov_491.015625	116	196	177	2	80	0.0250000
NODE_67770_length_419_cov_491.015625	116	196	178	3	80	0.0375000
NODE_67770_length_419_cov_491.015625	116	196	179	3	80	0.0375000
NODE_67770_length_419_cov_491.015625	116	196	180	3	80	0.0375000
NODE_67770_length_419_cov_491.015625	116	196	181	2	80	0.0250000
NODE_67770_length_419_cov_491.015625	116	196	182	1	80	0.0125000
NODE_67770_length_419_cov_491.015625	116	196	183	6	80	0.0750000
NODE_67770_length_419_cov_491.015625	116	196	184	2	80	0.0250000
NODE_67770_length_419_cov_491.015625	116	196	186	6	80	0.0750000
NODE_67770_length_419_cov_491.015625	116	196	187	1	80	0.0125000
NODE_67770_length_419_cov_491.015625	116	196	188	2	80	0.0250000
NODE_67770_length_419_cov_491.015625	116	196	189	6	80	0.0750000
NODE_67770_length_419_cov_491.015625	116	196	190	1	80	0.0125000
NODE_67770_length_419_cov_491.015625	116	196	191	1	80	0.0125000
NODE_67770_length_419_cov_491.015625	116	196	146	3	80	0.0375000
NODE_67770_length_419_cov_491.015625	116	196	148	1	80	0.0125000
NODE_67770_length_419_cov_491.015625	116	196	151	3	80	0.0375000
NODE_67770_length_419_cov_491.015625	116	196	152	1	80	0.0125000
NODE_67770_length_419_cov_491.015625	116	196	153	1	80	0.0125000
NODE_67770_length_419_cov_491.015625	116	196	157	1	80	0.0125000
NODE_67770_length_419_cov_491.015625	116	196	162	1	80	0.0125000
NODE_67770_length_419_cov_491.015625	116	196	163	1	80	0.0125000
NODE_67770_length_419_cov_491.015625	116	196	164	3	80	0.0375000
NODE_67770_length_419_cov_491.015625	116	196	165	1	80	0.0125000
NODE_67770_length_419_cov_491.015625	116	196	168	2	80	0.0250000
NODE_67770_length_419_cov_491.015625	116	196	169	7	80	0.0875000
NODE_67770_length_419_cov_491.015625	116	196	171	2	80	0.0250000
NODE_67770_length_419_cov_491.015625	116	196	173	3	80	0.0375000
NODE_67770_length_419_cov_491.015625	116	196	174	7	80	0.0875000
NODE_67770_length_419_cov_491.015625	116	196	175	3	80	0.0375000
NODE_67770_length_419_cov_491.015625	116	196	176	1	80	0.0125000
NODE_67770_length_419_cov_491.015625	116	196	177	2	80	0.0250000
NODE_67770_length_419_cov_491.015625	116	196	178	3	80	0.0375000
NODE_67770_length_419_cov_491.015625	116	196	179	3	80	0.0375000
NODE_67770_length_419_cov_491.015625	116	196	180	3	80	0.0375000
NODE_67770_length_419_cov_491.015625	116	196	181	2	80	0.0250000
NODE_67770_length_419_cov_491.015625	116	196	182	1	80	0.0125000
NODE_67770_length_419_cov_491.015625	116	196	183	6	80	0.0750000
NODE_67770_length_419_cov_491.015625	116	196	184	2	80	0.0250000
NODE_67770_length_419_cov_491.015625	116	196	186	6	80	0.0750000
NODE_67770_length_419_cov_491.015625	116	196	187	1	80	0.0125000
NODE_67770_length_419_cov_491.015625	116	196	188	2	80	0.0250000
NODE_67770_length_419_cov_491.015625	116	196	189	6	80	0.0750000
NODE_67770_length_419_cov_491.015625	116	196	190	1	80	0.0125000
NODE_67770_length_419_cov_491.015625	116	196	191	1	80	0.0125000
NODE_67772_length_419_cov_31.725000	12	92	0	80	80	1.0000000
NODE_67772_length_419_cov_31.725000	65	145	0	80	80	1.0000000
NODE_67789_length_419_cov_4.862500	47	103	0	4	56	0.0714286
NODE_67789_length_419_cov_4.862500	47	103	1	28	56	0.5000000
NODE_67789_length_419_cov_4.862500	47	103	3	23	56	0.4107143
NODE_67789_length_419_cov_4.862500	47	103	5	1	56	0.0178571
NODE_67789_length_419_cov_4.862500	258	327	0	69	69	1.0000000
NODE_67789_length_419_cov_4.862500	284	328	0	44	44	1.0000000
NODE_67803_length_419_cov_4.193750	215	262	2	6	47	0.1276596
NODE_67803_length_419_cov_4.193750	215	262	3	22	47	0.4680851
NODE_67803_length_419_cov_4.193750	215	262	4	19	47	0.4042553
NODE_67803_length_419_cov_4.193750	235	275	3	9	40	0.2250000
NODE_67803_length_419_cov_4.193750	235	275	4	31	40	0.7750000
NODE_67817_length_419_cov_3.696875	165	215	0	50	50	1.0000000
NODE_67854_length_419_cov_2.628125	234	314	2	5	80	0.0625000
NODE_67854_length_419_cov_2.628125	234	314	3	75	80	0.9375000
NODE_67856_length_419_cov_2.603125	154	196	0	19	42	0.4523810
NODE_67856_length_419_cov_2.603125	154	196	1	14	42	0.3333333
NODE_67856_length_419_cov_2.603125	154	196	2	9	42	0.2142857
NODE_67878_length_419_cov_2.350000	156	220	10	8	64	0.1250000
NODE_67878_length_419_cov_2.350000	156	220	11	4	64	0.0625000
NODE_67878_length_419_cov_2.350000	156	220	12	3	64	0.0468750
NODE_67878_length_419_cov_2.350000	156	220	13	6	64	0.0937500
NODE_67878_length_419_cov_2.350000	156	220	14	2	64	0.0312500
NODE_67878_length_419_cov_2.350000	156	220	15	1	64	0.0156250
NODE_67878_length_419_cov_2.350000	156	220	16	1	64	0.0156250
NODE_67878_length_419_cov_2.350000	156	220	18	3	64	0.0468750
NODE_67878_length_419_cov_2.350000	156	220	19	1	64	0.0156250
NODE_67878_length_419_cov_2.350000	156	220	20	1	64	0.0156250
NODE_67878_length_419_cov_2.350000	156	220	21	1	64	0.0156250
NODE_67878_length_419_cov_2.350000	156	220	22	4	64	0.0625000
NODE_67878_length_419_cov_2.350000	156	220	23	1	64	0.0156250
NODE_67878_length_419_cov_2.350000	156	220	24	8	64	0.1250000
NODE_67878_length_419_cov_2.350000	156	220	25	2	64	0.0312500
NODE_67878_length_419_cov_2.350000	156	220	26	5	64	0.0781250
NODE_67878_length_419_cov_2.350000	156	220	27	6	64	0.0937500
NODE_67878_length_419_cov_2.350000	156	220	29	7	64	0.1093750
NODE_67961_length_419_cov_1.593750	339	358	0	19	19	1.0000000
NODE_68250_length_418_cov_63.059561	105	186	0	7	81	0.0864198
NODE_68250_length_418_cov_63.059561	105	186	1	23	81	0.2839506
NODE_68250_length_418_cov_63.059561	105	186	2	51	81	0.6296296
NODE_68250_length_418_cov_63.059561	159	239	2	75	80	0.9375000
NODE_68250_length_418_cov_63.059561	159	239	3	5	80	0.0625000
NODE_68251_length_418_cov_49.796238	325	405	16	1	80	0.0125000
NODE_68251_length_418_cov_49.796238	325	405	17	3	80	0.0375000
NODE_68251_length_418_cov_49.796238	325	405	18	1	80	0.0125000
NODE_68251_length_418_cov_49.796238	325	405	19	8	80	0.1000000
NODE_68251_length_418_cov_49.796238	325	405	20	2	80	0.0250000
NODE_68251_length_418_cov_49.796238	325	405	22	5	80	0.0625000
NODE_68251_length_418_cov_49.796238	325	405	23	2	80	0.0250000
NODE_68251_length_418_cov_49.796238	325	405	24	3	80	0.0375000
NODE_68251_length_418_cov_49.796238	325	405	25	4	80	0.0500000
NODE_68251_length_418_cov_49.796238	325	405	26	1	80	0.0125000
NODE_68251_length_418_cov_49.796238	325	405	28	2	80	0.0250000
NODE_68251_length_418_cov_49.796238	325	405	29	5	80	0.0625000
NODE_68251_length_418_cov_49.796238	325	405	30	8	80	0.1000000
NODE_68251_length_418_cov_49.796238	325	405	31	3	80	0.0375000
NODE_68251_length_418_cov_49.796238	325	405	32	3	80	0.0375000
NODE_68251_length_418_cov_49.796238	325	405	33	11	80	0.1375000
NODE_68251_length_418_cov_49.796238	325	405	35	1	80	0.0125000
NODE_68251_length_418_cov_49.796238	325	405	37	17	80	0.2125000
NODE_68251_length_418_cov_49.796238	378	415	7	1	37	0.0270270
NODE_68251_length_418_cov_49.796238	378	415	8	2	37	0.0540541
NODE_68251_length_418_cov_49.796238	378	415	13	6	37	0.1621622
NODE_68251_length_418_cov_49.796238	378	415	15	1	37	0.0270270
NODE_68251_length_418_cov_49.796238	378	415	16	1	37	0.0270270
NODE_68251_length_418_cov_49.796238	378	415	17	3	37	0.0810811
NODE_68251_length_418_cov_49.796238	378	415	18	1	37	0.0270270
NODE_68251_length_418_cov_49.796238	378	415	19	8	37	0.2162162
NODE_68251_length_418_cov_49.796238	378	415	20	2	37	0.0540541
NODE_68251_length_418_cov_49.796238	378	415	22	5	37	0.1351351
NODE_68251_length_418_cov_49.796238	378	415	23	2	37	0.0540541
NODE_68251_length_418_cov_49.796238	378	415	24	3	37	0.0810811
NODE_68251_length_418_cov_49.796238	378	415	25	2	37	0.0540541
NODE_68252_length_418_cov_42.764890	119	196	0	77	77	1.0000000
NODE_68252_length_418_cov_42.764890	172	250	0	78	78	1.0000000
NODE_68253_length_418_cov_23.830721	73	153	0	80	80	1.0000000
NODE_68253_length_418_cov_23.830721	126	200	0	74	74	1.0000000
NODE_68255_length_418_cov_7.216301	211	291	2	35	80	0.4375000
NODE_68255_length_418_cov_7.216301	211	291	4	31	80	0.3875000
NODE_68255_length_418_cov_7.216301	211	291	5	14	80	0.1750000
NODE_68265_length_418_cov_5.382445	134	215	0	9	81	0.1111111
NODE_68265_length_418_cov_5.382445	134	215	1	72	81	0.8888889
NODE_68265_length_418_cov_5.382445	187	268	0	62	81	0.7654321
NODE_68265_length_418_cov_5.382445	187	268	1	19	81	0.2345679
NODE_68275_length_418_cov_4.463950	191	272	3	66	81	0.8148148
NODE_68275_length_418_cov_4.463950	191	272	4	15	81	0.1851852
NODE_68280_length_418_cov_4.216301	148	230	3	43	82	0.5243902
NODE_68280_length_418_cov_4.216301	148	230	5	38	82	0.4634146
NODE_68280_length_418_cov_4.216301	148	230	6	1	82	0.0121951
NODE_68281_length_418_cov_4.065831	211	280	2	56	69	0.8115942
NODE_68281_length_418_cov_4.065831	211	280	3	12	69	0.1739130
NODE_68281_length_418_cov_4.065831	211	280	4	1	69	0.0144928
NODE_68284_length_418_cov_3.909091	95	175	10	5	80	0.0625000
NODE_68284_length_418_cov_3.909091	95	175	11	9	80	0.1125000
NODE_68284_length_418_cov_3.909091	95	175	12	11	80	0.1375000
NODE_68284_length_418_cov_3.909091	95	175	14	6	80	0.0750000
NODE_68284_length_418_cov_3.909091	95	175	15	3	80	0.0375000
NODE_68284_length_418_cov_3.909091	95	175	16	21	80	0.2625000
NODE_68284_length_418_cov_3.909091	95	175	17	25	80	0.3125000
NODE_68284_length_418_cov_3.909091	148	224	10	5	76	0.0657895
NODE_68284_length_418_cov_3.909091	148	224	11	9	76	0.1184211
NODE_68284_length_418_cov_3.909091	148	224	12	13	76	0.1710526
NODE_68284_length_418_cov_3.909091	148	224	13	1	76	0.0131579
NODE_68284_length_418_cov_3.909091	148	224	14	4	76	0.0526316
NODE_68284_length_418_cov_3.909091	148	224	15	3	76	0.0394737
NODE_68284_length_418_cov_3.909091	148	224	16	2	76	0.0263158
NODE_68284_length_418_cov_3.909091	148	224	19	3	76	0.0394737
NODE_68284_length_418_cov_3.909091	148	224	20	4	76	0.0526316
NODE_68284_length_418_cov_3.909091	148	224	21	9	76	0.1184211
NODE_68284_length_418_cov_3.909091	148	224	22	4	76	0.0526316
NODE_68284_length_418_cov_3.909091	148	224	23	19	76	0.2500000
NODE_68288_length_418_cov_3.749216	181	247	4	66	66	1.0000000
NODE_68289_length_418_cov_3.711599	249	313	7	6	64	0.0937500
NODE_68289_length_418_cov_3.711599	249	313	8	50	64	0.7812500
NODE_68289_length_418_cov_3.711599	249	313	10	8	64	0.1250000
NODE_68307_length_418_cov_3.012539	101	181	2	18	80	0.2250000
NODE_68307_length_418_cov_3.012539	101	181	4	62	80	0.7750000
NODE_68354_length_418_cov_2.376176	95	115	0	20	20	1.0000000
NODE_68436_length_418_cov_1.623824	47	128	0	46	81	0.5679013
NODE_68436_length_418_cov_1.623824	47	128	1	35	81	0.4320988
NODE_68436_length_418_cov_1.623824	239	268	9	16	29	0.5517241
NODE_68436_length_418_cov_1.623824	239	268	10	13	29	0.4482759
NODE_68682_length_418_cov_0.626959	255	299	0	44	44	1.0000000
NODE_68708_length_417_cov_45.267296	212	292	0	80	80	1.0000000
NODE_68708_length_417_cov_45.267296	265	345	0	80	80	1.0000000
NODE_68708_length_417_cov_45.267296	341	417	0	76	76	1.0000000
NODE_68709_length_417_cov_36.006289	159	239	1	20	80	0.2500000
NODE_68709_length_417_cov_36.006289	159	239	2	9	80	0.1125000
NODE_68709_length_417_cov_36.006289	159	239	4	42	80	0.5250000
NODE_68709_length_417_cov_36.006289	159	239	5	9	80	0.1125000
NODE_68711_length_417_cov_12.886792	193	273	0	15	80	0.1875000
NODE_68711_length_417_cov_12.886792	193	273	1	65	80	0.8125000
NODE_68711_length_417_cov_12.886792	246	326	0	15	80	0.1875000
NODE_68711_length_417_cov_12.886792	246	326	1	65	80	0.8125000
NODE_68717_length_417_cov_7.056604	210	271	0	61	61	1.0000000
NODE_68717_length_417_cov_7.056604	263	315	0	52	52	1.0000000
NODE_68718_length_417_cov_6.669811	194	264	0	70	70	1.0000000
NODE_68779_length_417_cov_2.795597	20	91	0	46	71	0.6478873
NODE_68779_length_417_cov_2.795597	20	91	1	3	71	0.0422535
NODE_68779_length_417_cov_2.795597	20	91	3	22	71	0.3098592
NODE_69163_length_416_cov_115.782334	174	259	35	3	85	0.0352941
NODE_69163_length_416_cov_115.782334	174	259	36	3	85	0.0352941
NODE_69163_length_416_cov_115.782334	174	259	37	1	85	0.0117647
NODE_69163_length_416_cov_115.782334	174	259	39	1	85	0.0117647
NODE_69163_length_416_cov_115.782334	174	259	40	6	85	0.0705882
NODE_69163_length_416_cov_115.782334	174	259	41	3	85	0.0352941
NODE_69163_length_416_cov_115.782334	174	259	42	3	85	0.0352941
NODE_69163_length_416_cov_115.782334	174	259	43	7	85	0.0823529
NODE_69163_length_416_cov_115.782334	174	259	44	1	85	0.0117647
NODE_69163_length_416_cov_115.782334	174	259	46	2	85	0.0235294
NODE_69163_length_416_cov_115.782334	174	259	47	3	85	0.0352941
NODE_69163_length_416_cov_115.782334	174	259	48	2	85	0.0235294
NODE_69163_length_416_cov_115.782334	174	259	49	7	85	0.0823529
NODE_69163_length_416_cov_115.782334	174	259	55	1	85	0.0117647
NODE_69163_length_416_cov_115.782334	174	259	56	4	85	0.0470588
NODE_69163_length_416_cov_115.782334	174	259	57	1	85	0.0117647
NODE_69163_length_416_cov_115.782334	174	259	58	7	85	0.0823529
NODE_69163_length_416_cov_115.782334	174	259	60	2	85	0.0235294
NODE_69163_length_416_cov_115.782334	174	259	61	2	85	0.0235294
NODE_69163_length_416_cov_115.782334	174	259	62	3	85	0.0352941
NODE_69163_length_416_cov_115.782334	174	259	63	3	85	0.0352941
NODE_69163_length_416_cov_115.782334	174	259	64	5	85	0.0588235
NODE_69163_length_416_cov_115.782334	174	259	65	5	85	0.0588235
NODE_69163_length_416_cov_115.782334	174	259	66	3	85	0.0352941
NODE_69163_length_416_cov_115.782334	174	259	67	3	85	0.0352941
NODE_69163_length_416_cov_115.782334	174	259	68	4	85	0.0470588
NODE_69164_length_416_cov_70.678233	180	244	12	8	64	0.1250000
NODE_69164_length_416_cov_70.678233	180	244	13	2	64	0.0312500
NODE_69164_length_416_cov_70.678233	180	244	14	9	64	0.1406250
NODE_69164_length_416_cov_70.678233	180	244	15	28	64	0.4375000
NODE_69164_length_416_cov_70.678233	180	244	16	17	64	0.2656250
NODE_69166_length_416_cov_39.933754	288	368	0	14	80	0.1750000
NODE_69166_length_416_cov_39.933754	288	368	2	66	80	0.8250000
NODE_69166_length_416_cov_39.933754	341	416	0	62	75	0.8266667
NODE_69166_length_416_cov_39.933754	341	416	2	13	75	0.1733333
NODE_69167_length_416_cov_37.334385	158	238	7	37	80	0.4625000
NODE_69167_length_416_cov_37.334385	158	238	8	43	80	0.5375000
NODE_69167_length_416_cov_37.334385	211	291	4	7	80	0.0875000
NODE_69167_length_416_cov_37.334385	211	291	6	14	80	0.1750000
NODE_69167_length_416_cov_37.334385	211	291	7	55	80	0.6875000
NODE_69167_length_416_cov_37.334385	211	291	8	4	80	0.0500000
NODE_69167_length_416_cov_37.334385	287	367	2	20	80	0.2500000
NODE_69167_length_416_cov_37.334385	287	367	3	33	80	0.4125000
NODE_69167_length_416_cov_37.334385	287	367	4	27	80	0.3375000
NODE_69167_length_416_cov_37.334385	340	416	1	22	76	0.2894737
NODE_69167_length_416_cov_37.334385	340	416	2	47	76	0.6184211
NODE_69167_length_416_cov_37.334385	340	416	3	7	76	0.0921053
NODE_69179_length_416_cov_5.242902	89	169	0	80	80	1.0000000
NODE_69179_length_416_cov_5.242902	142	222	0	80	80	1.0000000
NODE_69184_length_416_cov_4.892744	79	145	0	66	66	1.0000000
NODE_69184_length_416_cov_4.892744	194	272	0	78	78	1.0000000
NODE_69184_length_416_cov_4.892744	247	272	0	25	25	1.0000000
NODE_69204_length_416_cov_3.886435	79	136	0	57	57	1.0000000
NODE_69279_length_416_cov_2.230284	10	90	0	80	80	1.0000000
NODE_69399_length_416_cov_1.520505	198	244	0	9	46	0.1956522
NODE_69399_length_416_cov_1.520505	198	244	1	15	46	0.3260870
NODE_69399_length_416_cov_1.520505	198	244	2	9	46	0.1956522
NODE_69399_length_416_cov_1.520505	198	244	3	9	46	0.1956522
NODE_69399_length_416_cov_1.520505	198	244	4	4	46	0.0869565
NODE_69399_length_416_cov_1.520505	261	328	6	31	67	0.4626866
NODE_69399_length_416_cov_1.520505	261	328	8	7	67	0.1044776
NODE_69399_length_416_cov_1.520505	261	328	10	29	67	0.4328358
NODE_69673_length_415_cov_35.924051	260	339	0	79	79	1.0000000
NODE_69673_length_415_cov_35.924051	316	392	0	76	76	1.0000000
NODE_69679_length_415_cov_6.376582	117	197	1	20	80	0.2500000
NODE_69679_length_415_cov_6.376582	117	197	2	46	80	0.5750000
NODE_69679_length_415_cov_6.376582	117	197	3	14	80	0.1750000
NODE_69679_length_415_cov_6.376582	254	334	3	6	80	0.0750000
NODE_69679_length_415_cov_6.376582	254	334	5	42	80	0.5250000
NODE_69679_length_415_cov_6.376582	254	334	6	14	80	0.1750000
NODE_69679_length_415_cov_6.376582	254	334	7	18	80	0.2250000
NODE_69774_length_415_cov_2.224684	144	224	3	28	80	0.3500000
NODE_69774_length_415_cov_2.224684	144	224	4	48	80	0.6000000
NODE_69774_length_415_cov_2.224684	144	224	5	4	80	0.0500000
NODE_69795_length_415_cov_2.069620	207	273	2	66	66	1.0000000
NODE_69817_length_415_cov_1.832278	225	283	8	2	58	0.0344828
NODE_69817_length_415_cov_1.832278	225	283	9	2	58	0.0344828
NODE_69817_length_415_cov_1.832278	225	283	10	17	58	0.2931035
NODE_69817_length_415_cov_1.832278	225	283	12	2	58	0.0344828
NODE_69817_length_415_cov_1.832278	225	283	14	4	58	0.0689655
NODE_69817_length_415_cov_1.832278	225	283	15	5	58	0.0862069
NODE_69817_length_415_cov_1.832278	225	283	16	1	58	0.0172414
NODE_69817_length_415_cov_1.832278	225	283	17	25	58	0.4310345
NODE_69845_length_415_cov_1.610759	90	170	45	3	80	0.0375000
NODE_69845_length_415_cov_1.610759	90	170	46	8	80	0.1000000
NODE_69845_length_415_cov_1.610759	90	170	47	2	80	0.0250000
NODE_69845_length_415_cov_1.610759	90	170	48	5	80	0.0625000
NODE_69845_length_415_cov_1.610759	90	170	50	2	80	0.0250000
NODE_69845_length_415_cov_1.610759	90	170	51	1	80	0.0125000
NODE_69845_length_415_cov_1.610759	90	170	52	2	80	0.0250000
NODE_69845_length_415_cov_1.610759	90	170	54	3	80	0.0375000
NODE_69845_length_415_cov_1.610759	90	170	56	3	80	0.0375000
NODE_69845_length_415_cov_1.610759	90	170	58	8	80	0.1000000
NODE_69845_length_415_cov_1.610759	90	170	59	3	80	0.0375000
NODE_69845_length_415_cov_1.610759	90	170	61	8	80	0.1000000
NODE_69845_length_415_cov_1.610759	90	170	62	9	80	0.1125000
NODE_69845_length_415_cov_1.610759	90	170	63	13	80	0.1625000
NODE_69845_length_415_cov_1.610759	90	170	64	7	80	0.0875000
NODE_69845_length_415_cov_1.610759	90	170	65	3	80	0.0375000
NODE_69845_length_415_cov_1.610759	335	376	0	41	41	1.0000000
NODE_70175_length_414_cov_46.263492	0	49	0	49	49	1.0000000
NODE_70175_length_414_cov_46.263492	22	102	0	80	80	1.0000000
NODE_70183_length_414_cov_7.460317	167	247	2	80	80	1.0000000
NODE_70183_length_414_cov_7.460317	220	300	2	80	80	1.0000000
NODE_70192_length_414_cov_5.676190	54	134	0	80	80	1.0000000
NODE_70192_length_414_cov_5.676190	107	187	0	80	80	1.0000000
NODE_70222_length_414_cov_4.130159	257	303	2	46	46	1.0000000
NODE_70222_length_414_cov_4.130159	276	356	0	5	80	0.0625000
NODE_70222_length_414_cov_4.130159	276	356	2	75	80	0.9375000
NODE_70254_length_414_cov_2.996825	75	135	15	3	60	0.0500000
NODE_70254_length_414_cov_2.996825	75	135	16	6	60	0.1000000
NODE_70254_length_414_cov_2.996825	75	135	17	9	60	0.1500000
NODE_70254_length_414_cov_2.996825	75	135	18	16	60	0.2666667
NODE_70254_length_414_cov_2.996825	75	135	20	26	60	0.4333333
NODE_70271_length_414_cov_2.631746	68	145	0	77	77	1.0000000
NODE_70284_length_414_cov_2.473016	164	197	0	25	33	0.7575758
NODE_70284_length_414_cov_2.473016	164	197	1	8	33	0.2424242
NODE_70284_length_414_cov_2.473016	170	255	0	19	85	0.2235294
NODE_70284_length_414_cov_2.473016	170	255	1	54	85	0.6352941
NODE_70284_length_414_cov_2.473016	170	255	2	12	85	0.1411765
NODE_70305_length_414_cov_2.222222	185	260	1	17	75	0.2266667
NODE_70305_length_414_cov_2.222222	185	260	2	6	75	0.0800000
NODE_70305_length_414_cov_2.222222	185	260	3	52	75	0.6933333
NODE_70305_length_414_cov_2.222222	233	304	1	4	71	0.0563380
NODE_70305_length_414_cov_2.222222	233	304	3	67	71	0.9436620
NODE_70307_length_414_cov_2.206349	88	163	0	75	75	1.0000000
NODE_70326_length_414_cov_2.047619	298	349	0	51	51	1.0000000
NODE_70486_length_414_cov_1.177778	106	190	0	84	84	1.0000000
NODE_70494_length_414_cov_1.155556	0	23	0	23	23	1.0000000
NODE_70690_length_413_cov_41.471338	35	115	0	80	80	1.0000000
NODE_70690_length_413_cov_41.471338	35	115	0	80	80	1.0000000
NODE_70690_length_413_cov_41.471338	88	168	0	80	80	1.0000000
NODE_70690_length_413_cov_41.471338	88	168	0	80	80	1.0000000
NODE_70691_length_413_cov_16.687898	222	302	3	24	80	0.3000000
NODE_70691_length_413_cov_16.687898	222	302	4	15	80	0.1875000
NODE_70691_length_413_cov_16.687898	222	302	5	34	80	0.4250000
NODE_70691_length_413_cov_16.687898	222	302	6	7	80	0.0875000
NODE_70691_length_413_cov_16.687898	275	355	2	30	80	0.3750000
NODE_70691_length_413_cov_16.687898	275	355	3	47	80	0.5875000
NODE_70691_length_413_cov_16.687898	275	355	4	3	80	0.0375000
NODE_70699_length_413_cov_7.057325	170	250	3	25	80	0.3125000
NODE_70699_length_413_cov_7.057325	170	250	4	10	80	0.1250000
NODE_70699_length_413_cov_7.057325	170	250	5	6	80	0.0750000
NODE_70699_length_413_cov_7.057325	170	250	7	39	80	0.4875000
NODE_70699_length_413_cov_7.057325	223	300	5	21	77	0.2727273
NODE_70699_length_413_cov_7.057325	223	300	7	56	77	0.7272727
NODE_70703_length_413_cov_5.665605	125	182	5	57	57	1.0000000
NODE_70712_length_413_cov_4.754777	140	184	3	44	44	1.0000000
NODE_70743_length_413_cov_3.506369	113	193	1	18	80	0.2250000
NODE_70743_length_413_cov_3.506369	113	193	2	34	80	0.4250000
NODE_70743_length_413_cov_3.506369	113	193	3	28	80	0.3500000
NODE_70749_length_413_cov_3.235669	251	331	0	80	80	1.0000000
NODE_70749_length_413_cov_3.235669	304	356	0	52	52	1.0000000
NODE_70792_length_413_cov_2.484076	209	257	0	32	48	0.6666667
NODE_70792_length_413_cov_2.484076	209	257	2	16	48	0.3333333
NODE_70835_length_413_cov_1.949045	224	296	2	72	72	1.0000000
NODE_71196_length_412_cov_9.996805	172	244	0	72	72	1.0000000
NODE_71218_length_412_cov_4.686901	112	167	0	55	55	1.0000000
NODE_71253_length_412_cov_3.204473	44	124	0	80	80	1.0000000
NODE_71276_length_412_cov_2.824281	225	305	0	80	80	1.0000000
NODE_71371_length_412_cov_1.782748	262	342	0	42	80	0.5250000
NODE_71371_length_412_cov_1.782748	262	342	2	38	80	0.4750000
NODE_71398_length_412_cov_1.603834	143	182	8	8	39	0.2051282
NODE_71398_length_412_cov_1.603834	143	182	17	1	39	0.0256410
NODE_71398_length_412_cov_1.603834	143	182	18	4	39	0.1025641
NODE_71398_length_412_cov_1.603834	143	182	20	5	39	0.1282051
NODE_71398_length_412_cov_1.603834	143	182	21	2	39	0.0512821
NODE_71398_length_412_cov_1.603834	143	182	25	3	39	0.0769231
NODE_71398_length_412_cov_1.603834	143	182	27	3	39	0.0769231
NODE_71398_length_412_cov_1.603834	143	182	29	2	39	0.0512821
NODE_71398_length_412_cov_1.603834	143	182	33	2	39	0.0512821
NODE_71398_length_412_cov_1.603834	143	182	35	1	39	0.0256410
NODE_71398_length_412_cov_1.603834	143	182	37	1	39	0.0256410
NODE_71398_length_412_cov_1.603834	143	182	38	5	39	0.1282051
NODE_71398_length_412_cov_1.603834	143	182	39	2	39	0.0512821
NODE_71665_length_411_cov_44.701923	4	72	0	68	68	1.0000000
NODE_71665_length_411_cov_44.701923	35	116	0	81	81	1.0000000
NODE_71665_length_411_cov_44.701923	161	242	0	81	81	1.0000000
NODE_71665_length_411_cov_44.701923	293	374	0	81	81	1.0000000
NODE_71665_length_411_cov_44.701923	337	411	0	74	74	1.0000000
NODE_71666_length_411_cov_43.144231	102	183	0	30	81	0.3703704
NODE_71666_length_411_cov_43.144231	102	183	1	20	81	0.2469136
NODE_71666_length_411_cov_43.144231	102	183	2	7	81	0.0864198
NODE_71666_length_411_cov_43.144231	102	183	3	24	81	0.2962963
NODE_71666_length_411_cov_43.144231	156	236	2	3	80	0.0375000
NODE_71666_length_411_cov_43.144231	156	236	3	28	80	0.3500000
NODE_71666_length_411_cov_43.144231	156	236	5	8	80	0.1000000
NODE_71666_length_411_cov_43.144231	156	236	7	26	80	0.3250000
NODE_71666_length_411_cov_43.144231	156	236	8	15	80	0.1875000
NODE_71666_length_411_cov_43.144231	232	312	5	3	80	0.0375000
NODE_71666_length_411_cov_43.144231	232	312	6	7	80	0.0875000
NODE_71666_length_411_cov_43.144231	232	312	7	19	80	0.2375000
NODE_71666_length_411_cov_43.144231	232	312	8	51	80	0.6375000
NODE_71666_length_411_cov_43.144231	285	365	1	20	80	0.2500000
NODE_71666_length_411_cov_43.144231	285	365	3	8	80	0.1000000
NODE_71666_length_411_cov_43.144231	285	365	5	28	80	0.3500000
NODE_71666_length_411_cov_43.144231	285	365	6	7	80	0.0875000
NODE_71666_length_411_cov_43.144231	285	365	7	17	80	0.2125000
NODE_71672_length_411_cov_8.471154	133	213	0	80	80	1.0000000
NODE_71672_length_411_cov_8.471154	186	266	0	80	80	1.0000000
NODE_71673_length_411_cov_8.407051	133	220	5	2	87	0.0229885
NODE_71673_length_411_cov_8.407051	133	220	6	11	87	0.1264368
NODE_71673_length_411_cov_8.407051	133	220	7	47	87	0.5402299
NODE_71673_length_411_cov_8.407051	133	220	8	18	87	0.2068966
NODE_71673_length_411_cov_8.407051	133	220	9	9	87	0.1034483
NODE_71675_length_411_cov_6.455128	249	316	0	54	67	0.8059701
NODE_71675_length_411_cov_6.455128	249	316	2	13	67	0.1940299
NODE_71675_length_411_cov_6.455128	292	344	0	11	52	0.2115385
NODE_71675_length_411_cov_6.455128	292	344	2	14	52	0.2692308
NODE_71675_length_411_cov_6.455128	292	344	3	8	52	0.1538462
NODE_71675_length_411_cov_6.455128	292	344	4	19	52	0.3653846
NODE_71687_length_411_cov_4.782051	98	178	0	80	80	1.0000000
NODE_71687_length_411_cov_4.782051	151	228	0	77	77	1.0000000
NODE_71705_length_411_cov_3.698718	282	347	0	65	65	1.0000000
NODE_71713_length_411_cov_3.378205	88	148	3	1	60	0.0166667
NODE_71713_length_411_cov_3.378205	88	148	4	59	60	0.9833333
NODE_71714_length_411_cov_3.371795	145	225	2	27	80	0.3375000
NODE_71714_length_411_cov_3.371795	145	225	3	53	80	0.6625000
NODE_71714_length_411_cov_3.371795	198	274	1	21	76	0.2763158
NODE_71714_length_411_cov_3.371795	198	274	2	19	76	0.2500000
NODE_71714_length_411_cov_3.371795	198	274	3	36	76	0.4736842
NODE_72163_length_410_cov_49.331190	320	400	2	21	80	0.2625000
NODE_72163_length_410_cov_49.331190	320	400	3	59	80	0.7375000
NODE_72163_length_410_cov_49.331190	320	400	2	21	80	0.2625000
NODE_72163_length_410_cov_49.331190	320	400	3	59	80	0.7375000
NODE_72163_length_410_cov_49.331190	320	400	2	21	80	0.2625000
NODE_72163_length_410_cov_49.331190	320	400	3	59	80	0.7375000
NODE_72163_length_410_cov_49.331190	320	400	2	21	80	0.2625000
NODE_72163_length_410_cov_49.331190	320	400	3	59	80	0.7375000
NODE_72163_length_410_cov_49.331190	320	400	2	21	80	0.2625000
NODE_72163_length_410_cov_49.331190	320	400	3	59	80	0.7375000
NODE_72163_length_410_cov_49.331190	329	400	2	21	71	0.2957746
NODE_72163_length_410_cov_49.331190	329	400	3	50	71	0.7042254
NODE_72169_length_410_cov_6.797428	179	259	0	79	80	0.9875000
NODE_72169_length_410_cov_6.797428	179	259	2	1	80	0.0125000
NODE_72169_length_410_cov_6.797428	232	312	0	26	80	0.3250000
NODE_72169_length_410_cov_6.797428	232	312	2	54	80	0.6750000
NODE_72184_length_410_cov_5.102894	153	222	2	69	69	1.0000000
NODE_72186_length_410_cov_4.884244	101	179	0	78	78	1.0000000
NODE_72187_length_410_cov_4.787781	287	344	0	57	57	1.0000000
NODE_72187_length_410_cov_4.787781	340	397	0	57	57	1.0000000
NODE_72194_length_410_cov_4.591640	245	303	0	58	58	1.0000000
NODE_72194_length_410_cov_4.591640	298	356	0	58	58	1.0000000
NODE_72230_length_410_cov_3.215434	32	112	0	12	80	0.1500000
NODE_72230_length_410_cov_3.215434	32	112	1	68	80	0.8500000
NODE_72230_length_410_cov_3.215434	85	165	1	80	80	1.0000000
NODE_72327_length_410_cov_1.913183	227	285	0	58	58	1.0000000
NODE_72526_length_410_cov_1.038585	272	316	1	34	44	0.7727273
NODE_72526_length_410_cov_1.038585	272	316	2	10	44	0.2272727
NODE_72688_length_409_cov_11.506452	56	136	0	27	80	0.3375000
NODE_72688_length_409_cov_11.506452	56	136	1	21	80	0.2625000
NODE_72688_length_409_cov_11.506452	56	136	2	32	80	0.4000000
NODE_72688_length_409_cov_11.506452	109	189	2	80	80	1.0000000
NODE_72689_length_409_cov_10.329032	131	186	0	55	55	1.0000000
NODE_72690_length_409_cov_9.625806	62	142	0	80	80	1.0000000
NODE_72690_length_409_cov_9.625806	115	195	0	80	80	1.0000000
NODE_72697_length_409_cov_6.867742	41	71	0	30	30	1.0000000
NODE_72730_length_409_cov_3.822581	103	158	0	17	55	0.3090909
NODE_72730_length_409_cov_3.822581	103	158	2	38	55	0.6909091
NODE_72730_length_409_cov_3.822581	151	232	2	43	81	0.5308642
NODE_72730_length_409_cov_3.822581	151	232	4	38	81	0.4691358
NODE_72754_length_409_cov_2.987097	240	287	0	47	47	1.0000000
NODE_72951_length_409_cov_1.319355	49	131	1	22	82	0.2682927
NODE_72951_length_409_cov_1.319355	49	131	2	60	82	0.7317073
NODE_72951_length_409_cov_1.319355	104	161	0	1	57	0.0175439
NODE_72951_length_409_cov_1.319355	104	161	1	12	57	0.2105263
NODE_72951_length_409_cov_1.319355	104	161	2	44	57	0.7719298
NODE_73196_length_408_cov_8.585761	57	137	0	57	80	0.7125000
NODE_73196_length_408_cov_8.585761	57	137	1	23	80	0.2875000
NODE_73196_length_408_cov_8.585761	110	190	0	4	80	0.0500000
NODE_73196_length_408_cov_8.585761	110	190	1	26	80	0.3250000
NODE_73196_length_408_cov_8.585761	110	190	2	11	80	0.1375000
NODE_73196_length_408_cov_8.585761	110	190	3	39	80	0.4875000
NODE_73198_length_408_cov_6.948220	71	151	1	22	80	0.2750000
NODE_73198_length_408_cov_6.948220	71	151	2	16	80	0.2000000
NODE_73198_length_408_cov_6.948220	71	151	3	6	80	0.0750000
NODE_73198_length_408_cov_6.948220	71	151	4	11	80	0.1375000
NODE_73198_length_408_cov_6.948220	71	151	5	6	80	0.0750000
NODE_73198_length_408_cov_6.948220	71	151	6	2	80	0.0250000
NODE_73198_length_408_cov_6.948220	71	151	8	2	80	0.0250000
NODE_73198_length_408_cov_6.948220	71	151	9	3	80	0.0375000
NODE_73198_length_408_cov_6.948220	71	151	10	12	80	0.1500000
NODE_73198_length_408_cov_6.948220	124	204	4	2	80	0.0250000
NODE_73198_length_408_cov_6.948220	124	204	5	6	80	0.0750000
NODE_73198_length_408_cov_6.948220	124	204	6	2	80	0.0250000
NODE_73198_length_408_cov_6.948220	124	204	8	2	80	0.0250000
NODE_73198_length_408_cov_6.948220	124	204	9	3	80	0.0375000
NODE_73198_length_408_cov_6.948220	124	204	10	31	80	0.3875000
NODE_73198_length_408_cov_6.948220	124	204	11	3	80	0.0375000
NODE_73198_length_408_cov_6.948220	124	204	12	11	80	0.1375000
NODE_73198_length_408_cov_6.948220	124	204	13	20	80	0.2500000
NODE_73219_length_408_cov_3.957929	83	132	2	19	49	0.3877551
NODE_73219_length_408_cov_3.957929	83	132	4	30	49	0.6122449
NODE_73226_length_408_cov_3.511327	40	97	0	57	57	1.0000000
NODE_73226_length_408_cov_3.511327	357	398	0	41	41	1.0000000
NODE_73262_length_408_cov_2.724919	128	180	3	52	52	1.0000000
NODE_73269_length_408_cov_2.563107	164	241	0	11	77	0.1428571
NODE_73269_length_408_cov_2.563107	164	241	2	36	77	0.4675325
NODE_73269_length_408_cov_2.563107	164	241	3	26	77	0.3376623
NODE_73269_length_408_cov_2.563107	164	241	5	1	77	0.0129870
NODE_73269_length_408_cov_2.563107	164	241	6	3	77	0.0389610
NODE_73271_length_408_cov_2.456311	314	379	0	65	65	1.0000000
NODE_73271_length_408_cov_2.456311	352	408	0	56	56	1.0000000
NODE_73690_length_407_cov_6.191558	144	208	0	64	64	1.0000000
NODE_73698_length_407_cov_4.961039	212	291	0	79	79	1.0000000
NODE_73719_length_407_cov_3.681818	314	375	0	61	61	1.0000000
NODE_73732_length_407_cov_3.344156	199	247	0	48	48	1.0000000
NODE_73736_length_407_cov_3.250000	142	223	3	3	81	0.0370370
NODE_73736_length_407_cov_3.250000	142	223	5	4	81	0.0493827
NODE_73736_length_407_cov_3.250000	142	223	7	4	81	0.0493827
NODE_73736_length_407_cov_3.250000	142	223	9	3	81	0.0370370
NODE_73736_length_407_cov_3.250000	142	223	11	6	81	0.0740741
NODE_73736_length_407_cov_3.250000	142	223	13	8	81	0.0987654
NODE_73736_length_407_cov_3.250000	142	223	14	53	81	0.6543210
NODE_73762_length_407_cov_2.594156	194	257	1	11	63	0.1746032
NODE_73762_length_407_cov_2.594156	194	257	2	22	63	0.3492064
NODE_73762_length_407_cov_2.594156	194	257	3	30	63	0.4761905
NODE_73769_length_407_cov_2.538961	34	114	0	80	80	1.0000000
NODE_73853_length_407_cov_1.737013	208	264	0	56	56	1.0000000
NODE_74200_length_406_cov_176.856678	200	271	225	1	71	0.0140845
NODE_74200_length_406_cov_176.856678	200	271	226	1	71	0.0140845
NODE_74200_length_406_cov_176.856678	200	271	228	1	71	0.0140845
NODE_74200_length_406_cov_176.856678	200	271	229	2	71	0.0281690
NODE_74200_length_406_cov_176.856678	200	271	230	2	71	0.0281690
NODE_74200_length_406_cov_176.856678	200	271	231	4	71	0.0563380
NODE_74200_length_406_cov_176.856678	200	271	232	1	71	0.0140845
NODE_74200_length_406_cov_176.856678	200	271	233	3	71	0.0422535
NODE_74200_length_406_cov_176.856678	200	271	234	6	71	0.0845070
NODE_74200_length_406_cov_176.856678	200	271	235	3	71	0.0422535
NODE_74200_length_406_cov_176.856678	200	271	237	1	71	0.0140845
NODE_74200_length_406_cov_176.856678	200	271	238	1	71	0.0140845
NODE_74200_length_406_cov_176.856678	200	271	240	3	71	0.0422535
NODE_74200_length_406_cov_176.856678	200	271	241	4	71	0.0563380
NODE_74200_length_406_cov_176.856678	200	271	242	3	71	0.0422535
NODE_74200_length_406_cov_176.856678	200	271	243	1	71	0.0140845
NODE_74200_length_406_cov_176.856678	200	271	244	2	71	0.0281690
NODE_74200_length_406_cov_176.856678	200	271	247	1	71	0.0140845
NODE_74200_length_406_cov_176.856678	200	271	250	2	71	0.0281690
NODE_74200_length_406_cov_176.856678	200	271	252	3	71	0.0422535
NODE_74200_length_406_cov_176.856678	200	271	253	1	71	0.0140845
NODE_74200_length_406_cov_176.856678	200	271	254	6	71	0.0845070
NODE_74200_length_406_cov_176.856678	200	271	255	5	71	0.0704225
NODE_74200_length_406_cov_176.856678	200	271	256	4	71	0.0563380
NODE_74200_length_406_cov_176.856678	200	271	257	2	71	0.0281690
NODE_74200_length_406_cov_176.856678	200	271	258	3	71	0.0422535
NODE_74200_length_406_cov_176.856678	200	271	259	2	71	0.0281690
NODE_74200_length_406_cov_176.856678	200	271	261	1	71	0.0140845
NODE_74200_length_406_cov_176.856678	200	271	262	1	71	0.0140845
NODE_74200_length_406_cov_176.856678	200	271	263	1	71	0.0140845
NODE_74200_length_406_cov_176.856678	244	321	179	4	77	0.0519481
NODE_74200_length_406_cov_176.856678	244	321	180	2	77	0.0259740
NODE_74200_length_406_cov_176.856678	244	321	182	1	77	0.0129870
NODE_74200_length_406_cov_176.856678	244	321	183	2	77	0.0259740
NODE_74200_length_406_cov_176.856678	244	321	185	1	77	0.0129870
NODE_74200_length_406_cov_176.856678	244	321	187	1	77	0.0129870
NODE_74200_length_406_cov_176.856678	244	321	192	1	77	0.0129870
NODE_74200_length_406_cov_176.856678	244	321	199	1	77	0.0129870
NODE_74200_length_406_cov_176.856678	244	321	200	1	77	0.0129870
NODE_74200_length_406_cov_176.856678	244	321	201	1	77	0.0129870
NODE_74200_length_406_cov_176.856678	244	321	205	1	77	0.0129870
NODE_74200_length_406_cov_176.856678	244	321	212	1	77	0.0129870
NODE_74200_length_406_cov_176.856678	244	321	216	1	77	0.0129870
NODE_74200_length_406_cov_176.856678	244	321	220	2	77	0.0259740
NODE_74200_length_406_cov_176.856678	244	321	224	1	77	0.0129870
NODE_74200_length_406_cov_176.856678	244	321	226	1	77	0.0129870
NODE_74200_length_406_cov_176.856678	244	321	236	2	77	0.0259740
NODE_74200_length_406_cov_176.856678	244	321	240	1	77	0.0129870
NODE_74200_length_406_cov_176.856678	244	321	242	3	77	0.0389610
NODE_74200_length_406_cov_176.856678	244	321	247	3	77	0.0389610
NODE_74200_length_406_cov_176.856678	244	321	248	2	77	0.0259740
NODE_74200_length_406_cov_176.856678	244	321	249	3	77	0.0389610
NODE_74200_length_406_cov_176.856678	244	321	250	3	77	0.0389610
NODE_74200_length_406_cov_176.856678	244	321	251	4	77	0.0519481
NODE_74200_length_406_cov_176.856678	244	321	252	2	77	0.0259740
NODE_74200_length_406_cov_176.856678	244	321	253	2	77	0.0259740
NODE_74200_length_406_cov_176.856678	244	321	254	10	77	0.1298701
NODE_74200_length_406_cov_176.856678	244	321	255	6	77	0.0779221
NODE_74200_length_406_cov_176.856678	244	321	256	4	77	0.0519481
NODE_74200_length_406_cov_176.856678	244	321	257	3	77	0.0389610
NODE_74200_length_406_cov_176.856678	244	321	258	2	77	0.0259740
NODE_74200_length_406_cov_176.856678	244	321	259	2	77	0.0259740
NODE_74200_length_406_cov_176.856678	244	321	261	1	77	0.0129870
NODE_74200_length_406_cov_176.856678	244	321	262	1	77	0.0129870
NODE_74200_length_406_cov_176.856678	244	321	263	1	77	0.0129870
NODE_74203_length_406_cov_37.723127	15	95	0	34	80	0.4250000
NODE_74203_length_406_cov_37.723127	15	95	2	42	80	0.5250000
NODE_74203_length_406_cov_37.723127	15	95	3	1	80	0.0125000
NODE_74203_length_406_cov_37.723127	15	95	7	1	80	0.0125000
NODE_74203_length_406_cov_37.723127	15	95	17	1	80	0.0125000
NODE_74203_length_406_cov_37.723127	15	95	32	1	80	0.0125000
NODE_74219_length_406_cov_4.960912	268	327	2	9	59	0.1525424
NODE_74219_length_406_cov_4.960912	268	327	3	50	59	0.8474576
NODE_74253_length_406_cov_3.087948	261	302	0	41	41	1.0000000
NODE_74284_length_406_cov_2.475570	220	270	0	6	50	0.1200000
NODE_74284_length_406_cov_2.475570	220	270	1	44	50	0.8800000
NODE_74332_length_406_cov_1.986971	238	276	0	31	38	0.8157895
NODE_74332_length_406_cov_1.986971	238	276	1	7	38	0.1842105
NODE_74368_length_406_cov_1.778502	159	195	3	12	36	0.3333333
NODE_74368_length_406_cov_1.778502	159	195	4	9	36	0.2500000
NODE_74368_length_406_cov_1.778502	159	195	5	6	36	0.1666667
NODE_74368_length_406_cov_1.778502	159	195	6	4	36	0.1111111
NODE_74368_length_406_cov_1.778502	159	195	10	5	36	0.1388889
NODE_74368_length_406_cov_1.778502	234	294	7	3	60	0.0500000
NODE_74368_length_406_cov_1.778502	234	294	9	8	60	0.1333333
NODE_74368_length_406_cov_1.778502	234	294	11	8	60	0.1333333
NODE_74368_length_406_cov_1.778502	234	294	12	12	60	0.2000000
NODE_74368_length_406_cov_1.778502	234	294	13	29	60	0.4833333
NODE_74368_length_406_cov_1.778502	267	347	0	11	80	0.1375000
NODE_74368_length_406_cov_1.778502	267	347	1	21	80	0.2625000
NODE_74368_length_406_cov_1.778502	267	347	3	7	80	0.0875000
NODE_74368_length_406_cov_1.778502	267	347	5	7	80	0.0875000
NODE_74368_length_406_cov_1.778502	267	347	7	10	80	0.1250000
NODE_74368_length_406_cov_1.778502	267	347	9	7	80	0.0875000
NODE_74368_length_406_cov_1.778502	267	347	11	4	80	0.0500000
NODE_74368_length_406_cov_1.778502	267	347	12	12	80	0.1500000
NODE_74368_length_406_cov_1.778502	267	347	13	1	80	0.0125000
NODE_74427_length_406_cov_1.495114	173	212	1	12	39	0.3076923
NODE_74427_length_406_cov_1.495114	173	212	2	27	39	0.6923077
NODE_74476_length_406_cov_1.325733	367	398	0	31	31	1.0000000
NODE_74588_length_406_cov_0.934853	1	32	0	31	31	1.0000000
NODE_74588_length_406_cov_0.934853	5	85	0	80	80	1.0000000
NODE_74696_length_405_cov_5.107843	332	380	0	25	48	0.5208333
NODE_74696_length_405_cov_5.107843	332	380	1	23	48	0.4791667
NODE_74697_length_405_cov_4.915033	15	46	0	31	31	1.0000000
NODE_74727_length_405_cov_3.346405	195	240	2	5	45	0.1111111
NODE_74727_length_405_cov_3.346405	195	240	3	9	45	0.2000000
NODE_74727_length_405_cov_3.346405	195	240	4	11	45	0.2444444
NODE_74727_length_405_cov_3.346405	195	240	5	20	45	0.4444444
NODE_74727_length_405_cov_3.346405	274	329	1	19	55	0.3454545
NODE_74727_length_405_cov_3.346405	274	329	2	36	55	0.6545454
NODE_74737_length_405_cov_3.124183	210	260	1	5	50	0.1000000
NODE_74737_length_405_cov_3.124183	210	260	2	13	50	0.2600000
NODE_74737_length_405_cov_3.124183	210	260	3	32	50	0.6400000
NODE_74737_length_405_cov_3.124183	240	286	2	4	46	0.0869565
NODE_74737_length_405_cov_3.124183	240	286	3	42	46	0.9130435
NODE_74737_length_405_cov_3.124183	260	339	2	57	79	0.7215190
NODE_74737_length_405_cov_3.124183	260	339	3	22	79	0.2784810
NODE_74737_length_405_cov_3.124183	272	339	2	57	67	0.8507463
NODE_74737_length_405_cov_3.124183	272	339	3	10	67	0.1492537
NODE_74780_length_405_cov_2.503268	352	399	2	26	47	0.5531915
NODE_74780_length_405_cov_2.503268	352	399	4	21	47	0.4468085
NODE_74787_length_405_cov_2.460784	0	73	0	73	73	1.0000000
NODE_75145_length_405_cov_0.666667	207	268	0	61	61	1.0000000
NODE_75196_length_404_cov_40.937705	40	120	0	80	80	1.0000000
NODE_75196_length_404_cov_40.937705	93	173	0	80	80	1.0000000
NODE_75197_length_404_cov_32.940984	46	126	2	80	80	1.0000000
NODE_75197_length_404_cov_32.940984	99	179	2	58	80	0.7250000
NODE_75197_length_404_cov_32.940984	99	179	4	22	80	0.2750000
NODE_75197_length_404_cov_32.940984	175	255	2	34	80	0.4250000
NODE_75197_length_404_cov_32.940984	175	255	4	46	80	0.5750000
NODE_75197_length_404_cov_32.940984	228	308	2	26	80	0.3250000
NODE_75197_length_404_cov_32.940984	228	308	4	54	80	0.6750000
NODE_75198_length_404_cov_11.731148	130	210	0	65	80	0.8125000
NODE_75198_length_404_cov_11.731148	130	210	2	15	80	0.1875000
NODE_75198_length_404_cov_11.731148	183	263	0	80	80	1.0000000
NODE_75200_length_404_cov_9.170492	201	257	0	13	56	0.2321429
NODE_75200_length_404_cov_9.170492	201	257	2	43	56	0.7678571
NODE_75236_length_404_cov_3.613115	323	385	0	2	62	0.0322581
NODE_75236_length_404_cov_3.613115	323	385	2	60	62	0.9677419
NODE_75259_length_404_cov_2.914754	181	261	0	59	80	0.7375000
NODE_75259_length_404_cov_2.914754	181	261	1	21	80	0.2625000
NODE_75345_length_404_cov_2.085246	245	325	0	74	80	0.9250000
NODE_75345_length_404_cov_2.085246	245	325	1	6	80	0.0750000
NODE_75357_length_404_cov_1.993443	95	148	0	1	53	0.0188679
NODE_75357_length_404_cov_1.993443	95	148	2	52	53	0.9811321
NODE_75399_length_404_cov_1.672131	32	106	0	63	74	0.8513514
NODE_75399_length_404_cov_1.672131	32	106	1	11	74	0.1486486
NODE_75440_length_404_cov_1.498361	94	174	0	67	80	0.8375000
NODE_75440_length_404_cov_1.498361	94	174	1	13	80	0.1625000
NODE_75446_length_404_cov_1.485246	234	282	0	22	48	0.4583333
NODE_75446_length_404_cov_1.485246	234	282	2	26	48	0.5416667
NODE_75545_length_404_cov_1.121311	114	194	4	24	80	0.3000000
NODE_75545_length_404_cov_1.121311	114	194	6	56	80	0.7000000
NODE_75750_length_403_cov_7.325658	80	146	0	66	66	1.0000000
NODE_75750_length_403_cov_7.325658	165	234	0	50	69	0.7246377
NODE_75750_length_403_cov_7.325658	165	234	1	19	69	0.2753623
NODE_75750_length_403_cov_7.325658	215	255	1	38	40	0.9500000
NODE_75750_length_403_cov_7.325658	215	255	2	2	40	0.0500000
NODE_75751_length_403_cov_7.217105	207	284	0	63	77	0.8181818
NODE_75751_length_403_cov_7.217105	207	284	2	14	77	0.1818182
NODE_75751_length_403_cov_7.217105	257	334	0	77	77	1.0000000
NODE_75752_length_403_cov_6.776316	192	250	6	1	58	0.0172414
NODE_75752_length_403_cov_6.776316	192	250	7	6	58	0.1034483
NODE_75752_length_403_cov_6.776316	192	250	8	7	58	0.1206897
NODE_75752_length_403_cov_6.776316	192	250	9	30	58	0.5172414
NODE_75752_length_403_cov_6.776316	192	250	10	13	58	0.2241379
NODE_75752_length_403_cov_6.776316	192	250	11	1	58	0.0172414
NODE_75788_length_403_cov_3.710526	327	373	0	46	46	1.0000000
NODE_75788_length_403_cov_3.710526	346	403	0	57	57	1.0000000
NODE_75793_length_403_cov_3.611842	283	363	9	23	80	0.2875000
NODE_75793_length_403_cov_3.611842	283	363	10	57	80	0.7125000
NODE_75824_length_403_cov_2.822368	201	282	2	81	81	1.0000000
NODE_75871_length_403_cov_2.082237	102	145	0	43	43	1.0000000
NODE_75908_length_403_cov_1.871711	130	166	0	36	36	1.0000000
NODE_75993_length_403_cov_1.398026	79	116	0	37	37	1.0000000
NODE_76029_length_403_cov_1.269737	82	111	0	29	29	1.0000000
NODE_76239_length_402_cov_6.293729	217	297	0	4	80	0.0500000
NODE_76239_length_402_cov_6.293729	217	297	1	25	80	0.3125000
NODE_76239_length_402_cov_6.293729	217	297	2	51	80	0.6375000
NODE_76239_length_402_cov_6.293729	270	350	0	57	80	0.7125000
NODE_76239_length_402_cov_6.293729	270	350	1	23	80	0.2875000
NODE_76246_length_402_cov_5.227723	176	236	4	21	60	0.3500000
NODE_76246_length_402_cov_5.227723	176	236	5	18	60	0.3000000
NODE_76246_length_402_cov_5.227723	176	236	7	21	60	0.3500000
NODE_76261_length_402_cov_4.356436	44	123	0	79	79	1.0000000
NODE_76261_length_402_cov_4.356436	119	199	0	45	80	0.5625000
NODE_76261_length_402_cov_4.356436	119	199	2	35	80	0.4375000
NODE_76261_length_402_cov_4.356436	172	252	2	80	80	1.0000000
NODE_76276_length_402_cov_3.564356	197	257	0	60	60	1.0000000
NODE_76276_length_402_cov_3.564356	230	310	0	80	80	1.0000000
NODE_76328_length_402_cov_2.633663	335	402	0	67	67	1.0000000
NODE_76336_length_402_cov_2.514851	82	162	0	31	80	0.3875000
NODE_76336_length_402_cov_2.514851	82	162	2	49	80	0.6125000
NODE_76336_length_402_cov_2.514851	135	200	0	60	65	0.9230769
NODE_76336_length_402_cov_2.514851	135	200	1	5	65	0.0769231
NODE_76380_length_402_cov_2.102310	114	165	1	22	51	0.4313726
NODE_76380_length_402_cov_2.102310	114	165	3	15	51	0.2941177
NODE_76380_length_402_cov_2.102310	114	165	4	14	51	0.2745098
NODE_76380_length_402_cov_2.102310	138	195	3	13	57	0.2280702
NODE_76380_length_402_cov_2.102310	138	195	4	44	57	0.7719298
NODE_76560_length_402_cov_1.214521	0	33	0	33	33	1.0000000
NODE_76646_length_402_cov_1.000000	119	188	0	12	69	0.1739130
NODE_76646_length_402_cov_1.000000	119	188	2	57	69	0.8260869
NODE_76752_length_402_cov_0.663366	0	46	0	46	46	1.0000000
NODE_76780_length_401_cov_43.675497	285	343	2	1	58	0.0172414
NODE_76780_length_401_cov_43.675497	285	343	3	9	58	0.1551724
NODE_76780_length_401_cov_43.675497	285	343	4	17	58	0.2931035
NODE_76780_length_401_cov_43.675497	285	343	5	31	58	0.5344828
NODE_76801_length_401_cov_4.377483	309	389	1	80	80	1.0000000
NODE_76804_length_401_cov_4.241722	125	180	0	55	55	1.0000000
NODE_76808_length_401_cov_4.132450	195	275	0	68	80	0.8500000
NODE_76808_length_401_cov_4.132450	195	275	1	12	80	0.1500000
NODE_76811_length_401_cov_3.973510	138	181	2	43	43	1.0000000
NODE_76828_length_401_cov_3.370861	141	221	1	35	80	0.4375000
NODE_76828_length_401_cov_3.370861	141	221	2	19	80	0.2375000
NODE_76828_length_401_cov_3.370861	141	221	3	26	80	0.3250000
NODE_76828_length_401_cov_3.370861	194	273	0	41	79	0.5189874
NODE_76828_length_401_cov_3.370861	194	273	1	38	79	0.4810127
NODE_76830_length_401_cov_3.317881	67	147	0	80	80	1.0000000
NODE_76918_length_401_cov_1.937086	160	239	2	28	79	0.3544304
NODE_76918_length_401_cov_1.937086	160	239	4	18	79	0.2278481
NODE_76918_length_401_cov_1.937086	160	239	7	17	79	0.2151899
NODE_76918_length_401_cov_1.937086	160	239	8	16	79	0.2025317
NODE_76978_length_401_cov_1.615894	205	269	7	6	64	0.0937500
NODE_76978_length_401_cov_1.615894	205	269	9	6	64	0.0937500
NODE_76978_length_401_cov_1.615894	205	269	11	2	64	0.0312500
NODE_76978_length_401_cov_1.615894	205	269	12	1	64	0.0156250
NODE_76978_length_401_cov_1.615894	205	269	14	1	64	0.0156250
NODE_76978_length_401_cov_1.615894	205	269	15	1	64	0.0156250
NODE_76978_length_401_cov_1.615894	205	269	17	1	64	0.0156250
NODE_76978_length_401_cov_1.615894	205	269	19	1	64	0.0156250
NODE_76978_length_401_cov_1.615894	205	269	23	1	64	0.0156250
NODE_76978_length_401_cov_1.615894	205	269	25	1	64	0.0156250
NODE_76978_length_401_cov_1.615894	205	269	29	1	64	0.0156250
NODE_76978_length_401_cov_1.615894	205	269	31	2	64	0.0312500
NODE_76978_length_401_cov_1.615894	205	269	33	2	64	0.0312500
NODE_76978_length_401_cov_1.615894	205	269	45	2	64	0.0312500
NODE_76978_length_401_cov_1.615894	205	269	47	2	64	0.0312500
NODE_76978_length_401_cov_1.615894	205	269	49	1	64	0.0156250
NODE_76978_length_401_cov_1.615894	205	269	51	1	64	0.0156250
NODE_76978_length_401_cov_1.615894	205	269	55	2	64	0.0312500
NODE_76978_length_401_cov_1.615894	205	269	59	1	64	0.0156250
NODE_76978_length_401_cov_1.615894	205	269	61	7	64	0.1093750
NODE_76978_length_401_cov_1.615894	205	269	63	6	64	0.0937500
NODE_76978_length_401_cov_1.615894	205	269	66	3	64	0.0468750
NODE_76978_length_401_cov_1.615894	205	269	67	2	64	0.0312500
NODE_76978_length_401_cov_1.615894	205	269	68	1	64	0.0156250
NODE_76978_length_401_cov_1.615894	205	269	70	2	64	0.0312500
NODE_76978_length_401_cov_1.615894	205	269	72	8	64	0.1250000
NODE_77017_length_401_cov_1.407285	23	92	0	69	69	1.0000000
NODE_77017_length_401_cov_1.407285	76	122	0	46	46	1.0000000
NODE_77236_length_401_cov_0.675497	292	372	0	80	80	1.0000000
NODE_77236_length_401_cov_0.675497	345	401	0	56	56	1.0000000
NODE_77284_length_400_cov_40.584718	205	281	0	76	76	1.0000000
NODE_77284_length_400_cov_40.584718	254	334	0	80	80	1.0000000
NODE_77289_length_400_cov_8.631229	307	372	0	65	65	1.0000000
NODE_77292_length_400_cov_6.850498	281	329	0	34	48	0.7083333
NODE_77292_length_400_cov_6.850498	281	329	1	14	48	0.2916667
NODE_77322_length_400_cov_4.000000	82	140	0	58	58	1.0000000
NODE_77358_length_400_cov_3.029900	204	284	0	80	80	1.0000000
NODE_77358_length_400_cov_3.029900	205	231	0	26	26	1.0000000
NODE_77362_length_400_cov_3.009967	146	220	8	24	74	0.3243243
NODE_77362_length_400_cov_3.009967	146	220	9	28	74	0.3783784
NODE_77362_length_400_cov_3.009967	146	220	10	22	74	0.2972973
NODE_77362_length_400_cov_3.009967	195	261	8	5	66	0.0757576
NODE_77362_length_400_cov_3.009967	195	261	9	8	66	0.1212121
NODE_77362_length_400_cov_3.009967	195	261	10	53	66	0.8030303
NODE_77363_length_400_cov_2.990033	253	332	26	1	79	0.0126582
NODE_77363_length_400_cov_2.990033	253	332	27	4	79	0.0506329
NODE_77363_length_400_cov_2.990033	253	332	29	1	79	0.0126582
NODE_77363_length_400_cov_2.990033	253	332	31	3	79	0.0379747
NODE_77363_length_400_cov_2.990033	253	332	32	3	79	0.0379747
NODE_77363_length_400_cov_2.990033	253	332	33	2	79	0.0253165
NODE_77363_length_400_cov_2.990033	253	332	34	5	79	0.0632911
NODE_77363_length_400_cov_2.990033	253	332	35	1	79	0.0126582
NODE_77363_length_400_cov_2.990033	253	332	38	1	79	0.0126582
NODE_77363_length_400_cov_2.990033	253	332	39	6	79	0.0759494
NODE_77363_length_400_cov_2.990033	253	332	40	1	79	0.0126582
NODE_77363_length_400_cov_2.990033	253	332	41	5	79	0.0632911
NODE_77363_length_400_cov_2.990033	253	332	42	8	79	0.1012658
NODE_77363_length_400_cov_2.990033	253	332	43	4	79	0.0506329
NODE_77363_length_400_cov_2.990033	253	332	47	15	79	0.1898734
NODE_77363_length_400_cov_2.990033	253	332	49	10	79	0.1265823
NODE_77363_length_400_cov_2.990033	253	332	50	3	79	0.0379747
NODE_77363_length_400_cov_2.990033	253	332	51	6	79	0.0759494
NODE_77363_length_400_cov_2.990033	306	385	4	12	79	0.1518987
NODE_77363_length_400_cov_2.990033	306	385	5	7	79	0.0886076
NODE_77363_length_400_cov_2.990033	306	385	7	2	79	0.0253165
NODE_77363_length_400_cov_2.990033	306	385	8	2	79	0.0253165
NODE_77363_length_400_cov_2.990033	306	385	9	1	79	0.0126582
NODE_77363_length_400_cov_2.990033	306	385	10	4	79	0.0506329
NODE_77363_length_400_cov_2.990033	306	385	11	6	79	0.0759494
NODE_77363_length_400_cov_2.990033	306	385	18	6	79	0.0759494
NODE_77363_length_400_cov_2.990033	306	385	19	2	79	0.0253165
NODE_77363_length_400_cov_2.990033	306	385	20	1	79	0.0126582
NODE_77363_length_400_cov_2.990033	306	385	21	4	79	0.0506329
NODE_77363_length_400_cov_2.990033	306	385	23	2	79	0.0253165
NODE_77363_length_400_cov_2.990033	306	385	25	3	79	0.0379747
NODE_77363_length_400_cov_2.990033	306	385	26	2	79	0.0253165
NODE_77363_length_400_cov_2.990033	306	385	27	4	79	0.0506329
NODE_77363_length_400_cov_2.990033	306	385	29	1	79	0.0126582
NODE_77363_length_400_cov_2.990033	306	385	31	3	79	0.0379747
NODE_77363_length_400_cov_2.990033	306	385	32	3	79	0.0379747
NODE_77363_length_400_cov_2.990033	306	385	33	2	79	0.0253165
NODE_77363_length_400_cov_2.990033	306	385	34	5	79	0.0632911
NODE_77363_length_400_cov_2.990033	306	385	35	1	79	0.0126582
NODE_77363_length_400_cov_2.990033	306	385	38	1	79	0.0126582
NODE_77363_length_400_cov_2.990033	306	385	39	5	79	0.0632911
NODE_77368_length_400_cov_2.860465	365	400	0	35	35	1.0000000
NODE_77371_length_400_cov_2.797342	324	372	0	48	48	1.0000000
NODE_77380_length_400_cov_2.581395	192	254	0	37	62	0.5967742
NODE_77380_length_400_cov_2.581395	192	254	2	25	62	0.4032258
NODE_77460_length_400_cov_1.940199	225	268	0	2	43	0.0465116
NODE_77460_length_400_cov_1.940199	225	268	1	26	43	0.6046512
NODE_77460_length_400_cov_1.940199	225	268	3	15	43	0.3488372
NODE_77460_length_400_cov_1.940199	293	374	0	81	81	1.0000000
NODE_77821_length_399_cov_71.493333	215	295	3	37	80	0.4625000
NODE_77821_length_399_cov_71.493333	215	295	4	43	80	0.5375000
NODE_77821_length_399_cov_71.493333	268	348	3	9	80	0.1125000
NODE_77821_length_399_cov_71.493333	268	348	4	71	80	0.8875000
NODE_77823_length_399_cov_7.510000	229	309	0	80	80	1.0000000
NODE_77823_length_399_cov_7.510000	282	362	0	80	80	1.0000000
NODE_77825_length_399_cov_7.310000	125	187	0	62	62	1.0000000
NODE_77854_length_399_cov_4.293333	86	164	0	11	78	0.1410256
NODE_77854_length_399_cov_4.293333	86	164	2	67	78	0.8589743
NODE_77877_length_399_cov_3.406667	51	124	0	73	73	1.0000000
NODE_77933_length_399_cov_2.286667	310	390	0	80	80	1.0000000
NODE_77966_length_399_cov_1.916667	76	136	0	21	60	0.3500000
NODE_77966_length_399_cov_1.916667	76	136	2	39	60	0.6500000
NODE_77966_length_399_cov_1.916667	123	189	0	12	66	0.1818182
NODE_77966_length_399_cov_1.916667	123	189	2	54	66	0.8181818
NODE_78276_length_399_cov_0.710000	313	392	1	21	79	0.2658228
NODE_78276_length_399_cov_0.710000	313	392	2	19	79	0.2405063
NODE_78276_length_399_cov_0.710000	313	392	3	39	79	0.4936709
NODE_78354_length_398_cov_9.688963	1	81	0	80	80	1.0000000
NODE_78354_length_398_cov_9.688963	247	327	0	8	80	0.1000000
NODE_78354_length_398_cov_9.688963	247	327	2	27	80	0.3375000
NODE_78354_length_398_cov_9.688963	247	327	4	45	80	0.5625000
NODE_78354_length_398_cov_9.688963	300	380	0	61	80	0.7625000
NODE_78354_length_398_cov_9.688963	300	380	2	19	80	0.2375000
NODE_78360_length_398_cov_6.488294	130	210	0	80	80	1.0000000
NODE_78364_length_398_cov_5.765886	253	333	0	28	80	0.3500000
NODE_78364_length_398_cov_5.765886	253	333	1	13	80	0.1625000
NODE_78364_length_398_cov_5.765886	253	333	3	39	80	0.4875000
NODE_78372_length_398_cov_5.244147	248	312	2	64	64	1.0000000
NODE_78376_length_398_cov_5.006689	116	196	0	80	80	1.0000000
NODE_78376_length_398_cov_5.006689	169	251	0	82	82	1.0000000
NODE_78383_length_398_cov_4.284281	63	117	0	54	54	1.0000000
NODE_78383_length_398_cov_4.284281	135	160	0	25	25	1.0000000
NODE_78420_length_398_cov_2.993311	229	309	0	28	80	0.3500000
NODE_78420_length_398_cov_2.993311	229	309	1	15	80	0.1875000
NODE_78420_length_398_cov_2.993311	229	309	2	7	80	0.0875000
NODE_78420_length_398_cov_2.993311	229	309	4	11	80	0.1375000
NODE_78420_length_398_cov_2.993311	229	309	5	4	80	0.0500000
NODE_78420_length_398_cov_2.993311	229	309	6	5	80	0.0625000
NODE_78420_length_398_cov_2.993311	229	309	7	2	80	0.0250000
NODE_78420_length_398_cov_2.993311	229	309	8	8	80	0.1000000
NODE_78429_length_398_cov_2.822742	236	271	0	35	35	1.0000000
NODE_78891_length_397_cov_52.855705	124	204	9	12	80	0.1500000
NODE_78891_length_397_cov_52.855705	124	204	10	12	80	0.1500000
NODE_78891_length_397_cov_52.855705	124	204	12	56	80	0.7000000
NODE_78891_length_397_cov_52.855705	177	257	5	4	80	0.0500000
NODE_78891_length_397_cov_52.855705	177	257	7	1	80	0.0125000
NODE_78891_length_397_cov_52.855705	177	257	9	24	80	0.3000000
NODE_78891_length_397_cov_52.855705	177	257	11	3	80	0.0375000
NODE_78891_length_397_cov_52.855705	177	257	12	48	80	0.6000000
NODE_78894_length_397_cov_35.036913	173	253	1	31	80	0.3875000
NODE_78894_length_397_cov_35.036913	173	253	2	49	80	0.6125000
NODE_78895_length_397_cov_13.667785	94	174	1	80	80	1.0000000
NODE_78895_length_397_cov_13.667785	147	227	0	48	80	0.6000000
NODE_78895_length_397_cov_13.667785	147	227	1	32	80	0.4000000
NODE_78897_length_397_cov_7.496644	192	272	0	80	80	1.0000000
NODE_78897_length_397_cov_7.496644	245	325	0	80	80	1.0000000
NODE_78898_length_397_cov_6.828859	127	173	0	19	46	0.4130435
NODE_78898_length_397_cov_6.828859	127	173	2	27	46	0.5869565
NODE_78913_length_397_cov_4.902685	293	364	0	71	71	1.0000000
NODE_78933_length_397_cov_3.765101	164	244	3	80	80	1.0000000
NODE_78951_length_397_cov_3.325503	107	187	0	47	80	0.5875000
NODE_78951_length_397_cov_3.325503	107	187	1	9	80	0.1125000
NODE_78951_length_397_cov_3.325503	107	187	2	10	80	0.1250000
NODE_78951_length_397_cov_3.325503	107	187	4	12	80	0.1500000
NODE_78951_length_397_cov_3.325503	107	187	6	2	80	0.0250000
NODE_78951_length_397_cov_3.325503	163	236	2	10	73	0.1369863
NODE_78951_length_397_cov_3.325503	163	236	4	12	73	0.1643836
NODE_78951_length_397_cov_3.325503	163	236	6	26	73	0.3561644
NODE_78951_length_397_cov_3.325503	163	236	7	3	73	0.0410959
NODE_78951_length_397_cov_3.325503	163	236	8	2	73	0.0273973
NODE_78951_length_397_cov_3.325503	163	236	9	13	73	0.1780822
NODE_78951_length_397_cov_3.325503	163	236	10	7	73	0.0958904
NODE_78999_length_397_cov_2.530201	269	312	0	43	43	1.0000000
NODE_79047_length_397_cov_1.959732	154	193	0	39	39	1.0000000
NODE_79072_length_397_cov_1.791946	218	283	3	6	65	0.0923077
NODE_79072_length_397_cov_1.791946	218	283	4	18	65	0.2769231
NODE_79072_length_397_cov_1.791946	218	283	5	6	65	0.0923077
NODE_79072_length_397_cov_1.791946	218	283	7	19	65	0.2923077
NODE_79072_length_397_cov_1.791946	218	283	8	16	65	0.2461538
NODE_79127_length_397_cov_1.560403	183	240	0	57	57	1.0000000
NODE_79456_length_396_cov_11.632997	162	242	0	27	80	0.3375000
NODE_79456_length_396_cov_11.632997	162	242	1	43	80	0.5375000
NODE_79456_length_396_cov_11.632997	162	242	2	10	80	0.1250000
NODE_79456_length_396_cov_11.632997	215	295	0	80	80	1.0000000
NODE_79460_length_396_cov_7.053872	71	101	1	7	30	0.2333333
NODE_79460_length_396_cov_7.053872	71	101	2	23	30	0.7666667
NODE_79464_length_396_cov_6.097643	229	309	0	80	80	1.0000000
NODE_79464_length_396_cov_6.097643	282	362	0	80	80	1.0000000
NODE_79471_length_396_cov_5.484848	125	205	0	11	80	0.1375000
NODE_79471_length_396_cov_5.484848	125	205	1	62	80	0.7750000
NODE_79471_length_396_cov_5.484848	125	205	2	7	80	0.0875000
NODE_79471_length_396_cov_5.484848	178	259	0	65	81	0.8024691
NODE_79471_length_396_cov_5.484848	178	259	1	16	81	0.1975309
NODE_79473_length_396_cov_5.434343	224	275	0	4	51	0.0784314
NODE_79473_length_396_cov_5.434343	224	275	1	11	51	0.2156863
NODE_79473_length_396_cov_5.434343	224	275	2	5	51	0.0980392
NODE_79473_length_396_cov_5.434343	224	275	3	31	51	0.6078432
NODE_79473_length_396_cov_5.434343	272	331	3	59	59	1.0000000
NODE_79483_length_396_cov_4.414141	189	264	0	3	75	0.0400000
NODE_79483_length_396_cov_4.414141	189	264	1	72	75	0.9600000
NODE_79483_length_396_cov_4.414141	241	317	0	56	76	0.7368421
NODE_79483_length_396_cov_4.414141	241	317	1	20	76	0.2631579
NODE_79493_length_396_cov_4.010101	163	205	1	8	42	0.1904762
NODE_79493_length_396_cov_4.010101	163	205	2	3	42	0.0714286
NODE_79493_length_396_cov_4.010101	163	205	3	20	42	0.4761905
NODE_79493_length_396_cov_4.010101	163	205	4	11	42	0.2619048
NODE_79522_length_396_cov_3.080808	95	161	0	3	66	0.0454545
NODE_79522_length_396_cov_3.080808	95	161	2	1	66	0.0151515
NODE_79522_length_396_cov_3.080808	95	161	3	62	66	0.9393939
NODE_79524_length_396_cov_3.067340	252	316	0	37	64	0.5781250
NODE_79524_length_396_cov_3.067340	252	316	1	25	64	0.3906250
NODE_79524_length_396_cov_3.067340	252	316	2	2	64	0.0312500
NODE_79535_length_396_cov_2.892256	136	217	0	22	81	0.2716049
NODE_79535_length_396_cov_2.892256	136	217	2	59	81	0.7283950
NODE_79557_length_396_cov_2.710438	88	168	1	2	80	0.0250000
NODE_79557_length_396_cov_2.710438	88	168	2	18	80	0.2250000
NODE_79557_length_396_cov_2.710438	88	168	3	48	80	0.6000000
NODE_79557_length_396_cov_2.710438	88	168	5	12	80	0.1500000
NODE_79561_length_396_cov_2.680135	297	335	0	38	38	1.0000000
NODE_79562_length_396_cov_2.659933	68	148	0	80	80	1.0000000
NODE_79562_length_396_cov_2.659933	121	168	0	47	47	1.0000000
NODE_79616_length_396_cov_2.060606	308	388	0	80	80	1.0000000
NODE_79643_length_396_cov_1.939394	63	142	0	22	79	0.2784810
NODE_79643_length_396_cov_1.939394	63	142	4	57	79	0.7215190
NODE_79643_length_396_cov_1.939394	115	164	4	30	49	0.6122449
NODE_79643_length_396_cov_1.939394	115	164	6	19	49	0.3877551
NODE_79683_length_396_cov_1.811448	82	162	0	46	80	0.5750000
NODE_79683_length_396_cov_1.811448	82	162	1	34	80	0.4250000
NODE_79692_length_396_cov_1.734007	88	119	1	31	31	1.0000000
NODE_79930_length_396_cov_0.905724	101	151	33	8	50	0.1600000
NODE_79930_length_396_cov_0.905724	101	151	34	1	50	0.0200000
NODE_79930_length_396_cov_0.905724	101	151	35	13	50	0.2600000
NODE_79930_length_396_cov_0.905724	101	151	37	1	50	0.0200000
NODE_79930_length_396_cov_0.905724	101	151	38	14	50	0.2800000
NODE_79930_length_396_cov_0.905724	101	151	39	13	50	0.2600000
NODE_80057_length_395_cov_449.327703	0	79	54	1	79	0.0126582
NODE_80057_length_395_cov_449.327703	0	79	60	1	79	0.0126582
NODE_80057_length_395_cov_449.327703	0	79	62	1	79	0.0126582
NODE_80057_length_395_cov_449.327703	0	79	68	1	79	0.0126582
NODE_80057_length_395_cov_449.327703	0	79	71	1	79	0.0126582
NODE_80057_length_395_cov_449.327703	0	79	79	1	79	0.0126582
NODE_80057_length_395_cov_449.327703	0	79	81	1	79	0.0126582
NODE_80057_length_395_cov_449.327703	0	79	84	1	79	0.0126582
NODE_80057_length_395_cov_449.327703	0	79	89	1	79	0.0126582
NODE_80057_length_395_cov_449.327703	0	79	95	1	79	0.0126582
NODE_80057_length_395_cov_449.327703	0	79	99	1	79	0.0126582
NODE_80057_length_395_cov_449.327703	0	79	100	1	79	0.0126582
NODE_80057_length_395_cov_449.327703	0	79	108	1	79	0.0126582
NODE_80057_length_395_cov_449.327703	0	79	109	1	79	0.0126582
NODE_80057_length_395_cov_449.327703	0	79	112	1	79	0.0126582
NODE_80057_length_395_cov_449.327703	0	79	114	1	79	0.0126582
NODE_80057_length_395_cov_449.327703	0	79	120	1	79	0.0126582
NODE_80057_length_395_cov_449.327703	0	79	121	1	79	0.0126582
NODE_80057_length_395_cov_449.327703	0	79	130	1	79	0.0126582
NODE_80057_length_395_cov_449.327703	0	79	135	1	79	0.0126582
NODE_80057_length_395_cov_449.327703	0	79	136	1	79	0.0126582
NODE_80057_length_395_cov_449.327703	0	79	146	1	79	0.0126582
NODE_80057_length_395_cov_449.327703	0	79	149	1	79	0.0126582
NODE_80057_length_395_cov_449.327703	0	79	152	1	79	0.0126582
NODE_80057_length_395_cov_449.327703	0	79	155	1	79	0.0126582
NODE_80057_length_395_cov_449.327703	0	79	158	1	79	0.0126582
NODE_80057_length_395_cov_449.327703	0	79	166	1	79	0.0126582
NODE_80057_length_395_cov_449.327703	0	79	174	1	79	0.0126582
NODE_80057_length_395_cov_449.327703	0	79	175	1	79	0.0126582
NODE_80057_length_395_cov_449.327703	0	79	178	2	79	0.0253165
NODE_80057_length_395_cov_449.327703	0	79	185	1	79	0.0126582
NODE_80057_length_395_cov_449.327703	0	79	194	1	79	0.0126582
NODE_80057_length_395_cov_449.327703	0	79	201	1	79	0.0126582
NODE_80057_length_395_cov_449.327703	0	79	202	1	79	0.0126582
NODE_80057_length_395_cov_449.327703	0	79	207	1	79	0.0126582
NODE_80057_length_395_cov_449.327703	0	79	212	1	79	0.0126582
NODE_80057_length_395_cov_449.327703	0	79	222	1	79	0.0126582
NODE_80057_length_395_cov_449.327703	0	79	223	1	79	0.0126582
NODE_80057_length_395_cov_449.327703	0	79	236	1	79	0.0126582
NODE_80057_length_395_cov_449.327703	0	79	238	1	79	0.0126582
NODE_80057_length_395_cov_449.327703	0	79	254	2	79	0.0253165
NODE_80057_length_395_cov_449.327703	0	79	268	1	79	0.0126582
NODE_80057_length_395_cov_449.327703	0	79	273	1	79	0.0126582
NODE_80057_length_395_cov_449.327703	0	79	277	1	79	0.0126582
NODE_80057_length_395_cov_449.327703	0	79	291	1	79	0.0126582
NODE_80057_length_395_cov_449.327703	0	79	303	1	79	0.0126582
NODE_80057_length_395_cov_449.327703	0	79	305	1	79	0.0126582
NODE_80057_length_395_cov_449.327703	0	79	309	1	79	0.0126582
NODE_80057_length_395_cov_449.327703	0	79	314	1	79	0.0126582
NODE_80057_length_395_cov_449.327703	0	79	318	1	79	0.0126582
NODE_80057_length_395_cov_449.327703	0	79	323	1	79	0.0126582
NODE_80057_length_395_cov_449.327703	0	79	335	1	79	0.0126582
NODE_80057_length_395_cov_449.327703	0	79	338	1	79	0.0126582
NODE_80057_length_395_cov_449.327703	0	79	350	1	79	0.0126582
NODE_80057_length_395_cov_449.327703	0	79	358	1	79	0.0126582
NODE_80057_length_395_cov_449.327703	0	79	360	1	79	0.0126582
NODE_80057_length_395_cov_449.327703	0	79	364	1	79	0.0126582
NODE_80057_length_395_cov_449.327703	0	79	365	1	79	0.0126582
NODE_80057_length_395_cov_449.327703	0	79	373	1	79	0.0126582
NODE_80057_length_395_cov_449.327703	0	79	374	1	79	0.0126582
NODE_80057_length_395_cov_449.327703	0	79	378	1	79	0.0126582
NODE_80057_length_395_cov_449.327703	0	79	387	1	79	0.0126582
NODE_80057_length_395_cov_449.327703	0	79	391	1	79	0.0126582
NODE_80057_length_395_cov_449.327703	0	79	400	1	79	0.0126582
NODE_80057_length_395_cov_449.327703	0	79	409	1	79	0.0126582
NODE_80057_length_395_cov_449.327703	0	79	421	1	79	0.0126582
NODE_80057_length_395_cov_449.327703	0	79	425	1	79	0.0126582
NODE_80057_length_395_cov_449.327703	0	79	433	2	79	0.0253165
NODE_80057_length_395_cov_449.327703	0	79	436	1	79	0.0126582
NODE_80057_length_395_cov_449.327703	0	79	439	1	79	0.0126582
NODE_80057_length_395_cov_449.327703	0	79	444	1	79	0.0126582
NODE_80057_length_395_cov_449.327703	0	79	447	1	79	0.0126582
NODE_80057_length_395_cov_449.327703	0	79	450	1	79	0.0126582
NODE_80057_length_395_cov_449.327703	0	79	459	1	79	0.0126582
NODE_80057_length_395_cov_449.327703	0	79	469	1	79	0.0126582
NODE_80057_length_395_cov_449.327703	0	79	472	1	79	0.0126582
NODE_80058_length_395_cov_13.695946	113	193	0	80	80	1.0000000
NODE_80058_length_395_cov_13.695946	166	246	0	80	80	1.0000000
NODE_80086_length_395_cov_4.179054	152	232	2	3	80	0.0375000
NODE_80086_length_395_cov_4.179054	152	232	3	16	80	0.2000000
NODE_80086_length_395_cov_4.179054	152	232	4	56	80	0.7000000
NODE_80086_length_395_cov_4.179054	152	232	5	5	80	0.0625000
NODE_80116_length_395_cov_2.962838	118	198	6	3	80	0.0375000
NODE_80116_length_395_cov_2.962838	118	198	7	22	80	0.2750000
NODE_80116_length_395_cov_2.962838	118	198	8	5	80	0.0625000
NODE_80116_length_395_cov_2.962838	118	198	9	23	80	0.2875000
NODE_80116_length_395_cov_2.962838	118	198	10	27	80	0.3375000
NODE_80116_length_395_cov_2.962838	171	237	2	1	66	0.0151515
NODE_80116_length_395_cov_2.962838	171	237	6	41	66	0.6212121
NODE_80116_length_395_cov_2.962838	171	237	7	22	66	0.3333333
NODE_80116_length_395_cov_2.962838	171	237	9	2	66	0.0303030
NODE_80121_length_395_cov_2.878378	261	301	0	40	40	1.0000000
NODE_80139_length_395_cov_2.587838	111	188	3	11	77	0.1428571
NODE_80139_length_395_cov_2.587838	111	188	4	66	77	0.8571429
NODE_80139_length_395_cov_2.587838	232	301	4	37	69	0.5362319
NODE_80139_length_395_cov_2.587838	232	301	5	32	69	0.4637681
NODE_80139_length_395_cov_2.587838	258	302	4	32	44	0.7272727
NODE_80139_length_395_cov_2.587838	258	302	5	12	44	0.2727273
NODE_80141_length_395_cov_2.560811	123	187	3	64	64	1.0000000
NODE_80146_length_395_cov_2.527027	194	274	0	80	80	1.0000000
NODE_80146_length_395_cov_2.527027	247	327	0	80	80	1.0000000
NODE_80439_length_395_cov_1.033784	103	151	0	48	48	1.0000000
NODE_80448_length_395_cov_1.010135	85	105	0	20	20	1.0000000
NODE_80639_length_394_cov_9.464407	211	291	2	80	80	1.0000000
NODE_80639_length_394_cov_9.464407	264	344	1	47	80	0.5875000
NODE_80639_length_394_cov_9.464407	264	344	2	33	80	0.4125000
NODE_80643_length_394_cov_7.437288	221	301	2	21	80	0.2625000
NODE_80643_length_394_cov_7.437288	221	301	3	8	80	0.1000000
NODE_80643_length_394_cov_7.437288	221	301	4	51	80	0.6375000
NODE_80643_length_394_cov_7.437288	274	331	2	3	57	0.0526316
NODE_80643_length_394_cov_7.437288	274	331	3	21	57	0.3684210
NODE_80643_length_394_cov_7.437288	274	331	4	33	57	0.5789474
NODE_80647_length_394_cov_6.444068	187	267	0	80	80	1.0000000
NODE_80647_length_394_cov_6.444068	240	320	0	80	80	1.0000000
NODE_80709_length_394_cov_2.932203	119	140	0	21	21	1.0000000
NODE_80710_length_394_cov_2.894915	79	135	2	23	56	0.4107143
NODE_80710_length_394_cov_2.894915	79	135	4	17	56	0.3035714
NODE_80710_length_394_cov_2.894915	79	135	6	16	56	0.2857143
NODE_80710_length_394_cov_2.894915	166	202	2	17	36	0.4722222
NODE_80710_length_394_cov_2.894915	166	202	4	19	36	0.5277778
NODE_81216_length_393_cov_4.261905	201	267	1	66	66	1.0000000
NODE_81216_length_393_cov_4.261905	240	282	1	42	42	1.0000000
NODE_81240_length_393_cov_3.503401	121	201	0	80	80	1.0000000
NODE_81240_length_393_cov_3.503401	174	246	0	72	72	1.0000000
NODE_81277_length_393_cov_2.704082	198	271	0	73	73	1.0000000
NODE_81289_length_393_cov_2.493197	136	216	0	80	80	1.0000000
NODE_81289_length_393_cov_2.493197	189	269	0	80	80	1.0000000
NODE_81296_length_393_cov_2.360544	195	252	0	57	57	1.0000000
NODE_81416_length_393_cov_1.608844	207	270	0	63	63	1.0000000
NODE_81778_length_392_cov_7.873720	161	241	0	80	80	1.0000000
NODE_81778_length_392_cov_7.873720	214	294	0	80	80	1.0000000
NODE_81790_length_392_cov_5.262799	218	248	0	30	30	1.0000000
NODE_81805_length_392_cov_3.655290	109	157	0	48	48	1.0000000
NODE_81805_length_392_cov_3.655290	306	386	0	80	80	1.0000000
NODE_81823_length_392_cov_3.197952	102	171	0	69	69	1.0000000
NODE_81823_length_392_cov_3.197952	233	314	0	81	81	1.0000000
NODE_81857_length_392_cov_2.511945	67	133	63	7	66	0.1060606
NODE_81857_length_392_cov_2.511945	67	133	64	3	66	0.0454545
NODE_81857_length_392_cov_2.511945	67	133	65	1	66	0.0151515
NODE_81857_length_392_cov_2.511945	67	133	68	1	66	0.0151515
NODE_81857_length_392_cov_2.511945	67	133	69	3	66	0.0454545
NODE_81857_length_392_cov_2.511945	67	133	70	8	66	0.1212121
NODE_81857_length_392_cov_2.511945	67	133	72	2	66	0.0303030
NODE_81857_length_392_cov_2.511945	67	133	73	2	66	0.0303030
NODE_81857_length_392_cov_2.511945	67	133	74	2	66	0.0303030
NODE_81857_length_392_cov_2.511945	67	133	77	3	66	0.0454545
NODE_81857_length_392_cov_2.511945	67	133	81	1	66	0.0151515
NODE_81857_length_392_cov_2.511945	67	133	82	1	66	0.0151515
NODE_81857_length_392_cov_2.511945	67	133	83	1	66	0.0151515
NODE_81857_length_392_cov_2.511945	67	133	87	1	66	0.0151515
NODE_81857_length_392_cov_2.511945	67	133	89	2	66	0.0303030
NODE_81857_length_392_cov_2.511945	67	133	91	4	66	0.0606061
NODE_81857_length_392_cov_2.511945	67	133	92	1	66	0.0151515
NODE_81857_length_392_cov_2.511945	67	133	93	3	66	0.0454545
NODE_81857_length_392_cov_2.511945	67	133	95	1	66	0.0151515
NODE_81857_length_392_cov_2.511945	67	133	97	1	66	0.0151515
NODE_81857_length_392_cov_2.511945	67	133	99	1	66	0.0151515
NODE_81857_length_392_cov_2.511945	67	133	101	3	66	0.0454545
NODE_81857_length_392_cov_2.511945	67	133	103	4	66	0.0606061
NODE_81857_length_392_cov_2.511945	67	133	107	2	66	0.0303030
NODE_81857_length_392_cov_2.511945	67	133	109	3	66	0.0454545
NODE_81857_length_392_cov_2.511945	67	133	111	1	66	0.0151515
NODE_81857_length_392_cov_2.511945	67	133	112	3	66	0.0454545
NODE_81857_length_392_cov_2.511945	67	133	113	1	66	0.0151515
NODE_81857_length_392_cov_2.511945	120	206	61	1	86	0.0116279
NODE_81857_length_392_cov_2.511945	120	206	62	6	86	0.0697674
NODE_81857_length_392_cov_2.511945	120	206	67	1	86	0.0116279
NODE_81857_length_392_cov_2.511945	120	206	69	1	86	0.0116279
NODE_81857_length_392_cov_2.511945	120	206	72	1	86	0.0116279
NODE_81857_length_392_cov_2.511945	120	206	73	3	86	0.0348837
NODE_81857_length_392_cov_2.511945	120	206	74	1	86	0.0116279
NODE_81857_length_392_cov_2.511945	120	206	79	1	86	0.0116279
NODE_81857_length_392_cov_2.511945	120	206	80	1	86	0.0116279
NODE_81857_length_392_cov_2.511945	120	206	82	4	86	0.0465116
NODE_81857_length_392_cov_2.511945	120	206	84	3	86	0.0348837
NODE_81857_length_392_cov_2.511945	120	206	85	1	86	0.0116279
NODE_81857_length_392_cov_2.511945	120	206	87	1	86	0.0116279
NODE_81857_length_392_cov_2.511945	120	206	88	3	86	0.0348837
NODE_81857_length_392_cov_2.511945	120	206	89	1	86	0.0116279
NODE_81857_length_392_cov_2.511945	120	206	93	1	86	0.0116279
NODE_81857_length_392_cov_2.511945	120	206	94	2	86	0.0232558
NODE_81857_length_392_cov_2.511945	120	206	95	1	86	0.0116279
NODE_81857_length_392_cov_2.511945	120	206	96	3	86	0.0348837
NODE_81857_length_392_cov_2.511945	120	206	97	2	86	0.0232558
NODE_81857_length_392_cov_2.511945	120	206	98	1	86	0.0116279
NODE_81857_length_392_cov_2.511945	120	206	100	3	86	0.0348837
NODE_81857_length_392_cov_2.511945	120	206	102	2	86	0.0232558
NODE_81857_length_392_cov_2.511945	120	206	103	9	86	0.1046512
NODE_81857_length_392_cov_2.511945	120	206	107	2	86	0.0232558
NODE_81857_length_392_cov_2.511945	120	206	108	4	86	0.0465116
NODE_81857_length_392_cov_2.511945	120	206	109	3	86	0.0348837
NODE_81857_length_392_cov_2.511945	120	206	111	8	86	0.0930233
NODE_81857_length_392_cov_2.511945	120	206	112	5	86	0.0581395
NODE_81857_length_392_cov_2.511945	120	206	113	11	86	0.1279070
NODE_81914_length_392_cov_2.075085	268	349	1	43	81	0.5308642
NODE_81914_length_392_cov_2.075085	268	349	2	34	81	0.4197531
NODE_81914_length_392_cov_2.075085	268	349	4	4	81	0.0493827
NODE_81914_length_392_cov_2.075085	322	387	1	65	65	1.0000000
NODE_81928_length_392_cov_1.955631	11	56	0	45	45	1.0000000
NODE_81929_length_392_cov_1.952218	40	59	0	19	19	1.0000000
NODE_81940_length_392_cov_1.911263	238	315	1	77	77	1.0000000
NODE_81994_length_392_cov_1.631399	114	139	15	6	25	0.2400000
NODE_81994_length_392_cov_1.631399	114	139	16	3	25	0.1200000
NODE_81994_length_392_cov_1.631399	114	139	17	15	25	0.6000000
NODE_81994_length_392_cov_1.631399	114	139	18	1	25	0.0400000
NODE_82008_length_392_cov_1.559727	83	163	1	67	80	0.8375000
NODE_82008_length_392_cov_1.559727	83	163	3	13	80	0.1625000
NODE_82015_length_392_cov_1.552901	32	52	0	20	20	1.0000000
NODE_82390_length_391_cov_69.510274	9	89	97	1	80	0.0125000
NODE_82390_length_391_cov_69.510274	9	89	101	1	80	0.0125000
NODE_82390_length_391_cov_69.510274	9	89	104	1	80	0.0125000
NODE_82390_length_391_cov_69.510274	9	89	112	1	80	0.0125000
NODE_82390_length_391_cov_69.510274	9	89	114	1	80	0.0125000
NODE_82390_length_391_cov_69.510274	9	89	116	1	80	0.0125000
NODE_82390_length_391_cov_69.510274	9	89	121	1	80	0.0125000
NODE_82390_length_391_cov_69.510274	9	89	123	1	80	0.0125000
NODE_82390_length_391_cov_69.510274	9	89	125	1	80	0.0125000
NODE_82390_length_391_cov_69.510274	9	89	126	1	80	0.0125000
NODE_82390_length_391_cov_69.510274	9	89	128	1	80	0.0125000
NODE_82390_length_391_cov_69.510274	9	89	138	1	80	0.0125000
NODE_82390_length_391_cov_69.510274	9	89	142	1	80	0.0125000
NODE_82390_length_391_cov_69.510274	9	89	147	1	80	0.0125000
NODE_82390_length_391_cov_69.510274	9	89	154	2	80	0.0250000
NODE_82390_length_391_cov_69.510274	9	89	155	1	80	0.0125000
NODE_82390_length_391_cov_69.510274	9	89	160	1	80	0.0125000
NODE_82390_length_391_cov_69.510274	9	89	163	1	80	0.0125000
NODE_82390_length_391_cov_69.510274	9	89	167	1	80	0.0125000
NODE_82390_length_391_cov_69.510274	9	89	169	2	80	0.0250000
NODE_82390_length_391_cov_69.510274	9	89	173	3	80	0.0375000
NODE_82390_length_391_cov_69.510274	9	89	178	2	80	0.0250000
NODE_82390_length_391_cov_69.510274	9	89	183	1	80	0.0125000
NODE_82390_length_391_cov_69.510274	9	89	185	2	80	0.0250000
NODE_82390_length_391_cov_69.510274	9	89	186	3	80	0.0375000
NODE_82390_length_391_cov_69.510274	9	89	188	1	80	0.0125000
NODE_82390_length_391_cov_69.510274	9	89	192	1	80	0.0125000
NODE_82390_length_391_cov_69.510274	9	89	193	1	80	0.0125000
NODE_82390_length_391_cov_69.510274	9	89	194	1	80	0.0125000
NODE_82390_length_391_cov_69.510274	9	89	195	1	80	0.0125000
NODE_82390_length_391_cov_69.510274	9	89	201	1	80	0.0125000
NODE_82390_length_391_cov_69.510274	9	89	202	1	80	0.0125000
NODE_82390_length_391_cov_69.510274	9	89	203	1	80	0.0125000
NODE_82390_length_391_cov_69.510274	9	89	205	1	80	0.0125000
NODE_82390_length_391_cov_69.510274	9	89	214	1	80	0.0125000
NODE_82390_length_391_cov_69.510274	9	89	217	1	80	0.0125000
NODE_82390_length_391_cov_69.510274	9	89	224	1	80	0.0125000
NODE_82390_length_391_cov_69.510274	9	89	225	1	80	0.0125000
NODE_82390_length_391_cov_69.510274	9	89	231	1	80	0.0125000
NODE_82390_length_391_cov_69.510274	9	89	233	1	80	0.0125000
NODE_82390_length_391_cov_69.510274	9	89	237	1	80	0.0125000
NODE_82390_length_391_cov_69.510274	9	89	242	1	80	0.0125000
NODE_82390_length_391_cov_69.510274	9	89	243	1	80	0.0125000
NODE_82390_length_391_cov_69.510274	9	89	246	3	80	0.0375000
NODE_82390_length_391_cov_69.510274	9	89	249	1	80	0.0125000
NODE_82390_length_391_cov_69.510274	9	89	251	1	80	0.0125000
NODE_82390_length_391_cov_69.510274	9	89	260	1	80	0.0125000
NODE_82390_length_391_cov_69.510274	9	89	267	1	80	0.0125000
NODE_82390_length_391_cov_69.510274	9	89	268	2	80	0.0250000
NODE_82390_length_391_cov_69.510274	9	89	269	1	80	0.0125000
NODE_82390_length_391_cov_69.510274	9	89	279	1	80	0.0125000
NODE_82390_length_391_cov_69.510274	9	89	282	1	80	0.0125000
NODE_82390_length_391_cov_69.510274	9	89	290	1	80	0.0125000
NODE_82390_length_391_cov_69.510274	9	89	291	1	80	0.0125000
NODE_82390_length_391_cov_69.510274	9	89	292	1	80	0.0125000
NODE_82390_length_391_cov_69.510274	9	89	293	1	80	0.0125000
NODE_82390_length_391_cov_69.510274	9	89	294	1	80	0.0125000
NODE_82390_length_391_cov_69.510274	9	89	299	2	80	0.0250000
NODE_82390_length_391_cov_69.510274	9	89	304	2	80	0.0250000
NODE_82390_length_391_cov_69.510274	9	89	306	1	80	0.0125000
NODE_82390_length_391_cov_69.510274	9	89	307	2	80	0.0250000
NODE_82390_length_391_cov_69.510274	9	89	309	1	80	0.0125000
NODE_82390_length_391_cov_69.510274	9	89	313	1	80	0.0125000
NODE_82390_length_391_cov_69.510274	9	89	315	1	80	0.0125000
NODE_82390_length_391_cov_69.510274	9	89	317	1	80	0.0125000
NODE_82390_length_391_cov_69.510274	9	89	319	1	80	0.0125000
NODE_82391_length_391_cov_39.414384	0	66	0	9	66	0.1363636
NODE_82391_length_391_cov_39.414384	0	66	2	6	66	0.0909091
NODE_82391_length_391_cov_39.414384	0	66	3	8	66	0.1212121
NODE_82391_length_391_cov_39.414384	0	66	5	5	66	0.0757576
NODE_82391_length_391_cov_39.414384	0	66	7	38	66	0.5757576
NODE_82391_length_391_cov_39.414384	0	71	0	9	71	0.1267606
NODE_82391_length_391_cov_39.414384	0	71	2	6	71	0.0845070
NODE_82391_length_391_cov_39.414384	0	71	3	8	71	0.1126761
NODE_82391_length_391_cov_39.414384	0	71	5	5	71	0.0704225
NODE_82391_length_391_cov_39.414384	0	71	7	43	71	0.6056338
NODE_82391_length_391_cov_39.414384	44	124	2	4	80	0.0500000
NODE_82391_length_391_cov_39.414384	44	124	6	13	80	0.1625000
NODE_82391_length_391_cov_39.414384	44	124	7	33	80	0.4125000
NODE_82391_length_391_cov_39.414384	44	124	8	30	80	0.3750000
NODE_82394_length_391_cov_10.352740	156	235	0	79	79	1.0000000
NODE_82415_length_391_cov_5.030822	85	166	0	3	81	0.0370370
NODE_82415_length_391_cov_5.030822	85	166	2	15	81	0.1851852
NODE_82415_length_391_cov_5.030822	85	166	3	45	81	0.5555556
NODE_82415_length_391_cov_5.030822	85	166	4	18	81	0.2222222
NODE_82498_length_391_cov_2.660959	267	343	0	70	76	0.9210526
NODE_82498_length_391_cov_2.660959	267	343	1	6	76	0.0789474
NODE_82552_length_391_cov_2.089041	176	256	6	41	80	0.5125000
NODE_82552_length_391_cov_2.089041	176	256	8	29	80	0.3625000
NODE_82552_length_391_cov_2.089041	176	256	9	10	80	0.1250000
NODE_82552_length_391_cov_2.089041	229	280	6	1	51	0.0196078
NODE_82552_length_391_cov_2.089041	229	280	7	8	51	0.1568628
NODE_82552_length_391_cov_2.089041	229	280	8	17	51	0.3333333
NODE_82552_length_391_cov_2.089041	229	280	9	25	51	0.4901961
NODE_82574_length_391_cov_1.907534	200	257	3	18	57	0.3157895
NODE_82574_length_391_cov_1.907534	200	257	4	26	57	0.4561403
NODE_82574_length_391_cov_1.907534	200	257	6	13	57	0.2280702
NODE_82597_length_391_cov_1.773973	160	190	0	30	30	1.0000000
NODE_82632_length_391_cov_1.647260	298	378	2	80	80	1.0000000
NODE_82662_length_391_cov_1.561644	241	261	0	20	20	1.0000000
NODE_83015_length_390_cov_29.030928	86	166	2	15	80	0.1875000
NODE_83015_length_390_cov_29.030928	86	166	3	21	80	0.2625000
NODE_83015_length_390_cov_29.030928	86	166	4	44	80	0.5500000
NODE_83015_length_390_cov_29.030928	139	219	2	33	80	0.4125000
NODE_83015_length_390_cov_29.030928	139	219	4	47	80	0.5875000
NODE_83016_length_390_cov_22.319588	118	198	2	80	80	1.0000000
NODE_83016_length_390_cov_22.319588	171	251	0	21	80	0.2625000
NODE_83016_length_390_cov_22.319588	171	251	1	25	80	0.3125000
NODE_83016_length_390_cov_22.319588	171	251	2	34	80	0.4250000
NODE_83044_length_390_cov_4.481100	208	277	3	48	69	0.6956522
NODE_83044_length_390_cov_4.481100	208	277	4	14	69	0.2028985
NODE_83044_length_390_cov_4.481100	208	277	5	7	69	0.1014493
NODE_83044_length_390_cov_4.481100	286	327	0	20	41	0.4878049
NODE_83044_length_390_cov_4.481100	286	327	1	3	41	0.0731707
NODE_83044_length_390_cov_4.481100	286	327	2	12	41	0.2926829
NODE_83044_length_390_cov_4.481100	286	327	3	6	41	0.1463415
NODE_83045_length_390_cov_4.481100	93	171	1	55	78	0.7051282
NODE_83045_length_390_cov_4.481100	93	171	2	23	78	0.2948718
NODE_83045_length_390_cov_4.481100	144	210	1	62	66	0.9393939
NODE_83045_length_390_cov_4.481100	144	210	2	4	66	0.0606061
NODE_83060_length_390_cov_3.814433	66	99	3	33	33	1.0000000
NODE_83061_length_390_cov_3.783505	188	268	0	80	80	1.0000000
NODE_83061_length_390_cov_3.783505	241	321	0	80	80	1.0000000
NODE_83066_length_390_cov_3.560137	304	367	0	63	63	1.0000000
NODE_83066_length_390_cov_3.560137	340	381	0	41	41	1.0000000
NODE_83169_length_390_cov_2.127148	242	322	6	3	80	0.0375000
NODE_83169_length_390_cov_2.127148	242	322	8	14	80	0.1750000
NODE_83169_length_390_cov_2.127148	242	322	9	1	80	0.0125000
NODE_83169_length_390_cov_2.127148	242	322	10	3	80	0.0375000
NODE_83169_length_390_cov_2.127148	242	322	11	59	80	0.7375000
NODE_83171_length_390_cov_2.123711	133	177	0	6	44	0.1363636
NODE_83171_length_390_cov_2.123711	133	177	2	7	44	0.1590909
NODE_83171_length_390_cov_2.123711	133	177	3	17	44	0.3863636
NODE_83171_length_390_cov_2.123711	133	177	4	9	44	0.2045455
NODE_83171_length_390_cov_2.123711	133	177	5	5	44	0.1136364
NODE_83171_length_390_cov_2.123711	157	237	3	6	80	0.0750000
NODE_83171_length_390_cov_2.123711	157	237	4	9	80	0.1125000
NODE_83171_length_390_cov_2.123711	157	237	5	19	80	0.2375000
NODE_83171_length_390_cov_2.123711	157	237	6	46	80	0.5750000
NODE_83288_length_390_cov_1.536082	223	276	0	53	53	1.0000000
NODE_83338_length_390_cov_1.398625	49	110	8	5	61	0.0819672
NODE_83338_length_390_cov_1.398625	49	110	10	4	61	0.0655738
NODE_83338_length_390_cov_1.398625	49	110	12	6	61	0.0983607
NODE_83338_length_390_cov_1.398625	49	110	14	46	61	0.7540984
NODE_83463_length_390_cov_1.034364	78	158	3	17	80	0.2125000
NODE_83463_length_390_cov_1.034364	78	158	4	63	80	0.7875000
NODE_83633_length_389_cov_63.710345	32	112	0	80	80	1.0000000
NODE_83633_length_389_cov_63.710345	85	165	0	80	80	1.0000000
NODE_83633_length_389_cov_63.710345	161	241	0	80	80	1.0000000
NODE_83633_length_389_cov_63.710345	214	294	0	80	80	1.0000000
NODE_83650_length_389_cov_5.382759	154	234	6	8	80	0.1000000
NODE_83650_length_389_cov_5.382759	154	234	7	8	80	0.1000000
NODE_83650_length_389_cov_5.382759	154	234	8	10	80	0.1250000
NODE_83650_length_389_cov_5.382759	154	234	9	11	80	0.1375000
NODE_83650_length_389_cov_5.382759	154	234	10	26	80	0.3250000
NODE_83650_length_389_cov_5.382759	154	234	11	10	80	0.1250000
NODE_83650_length_389_cov_5.382759	154	234	12	7	80	0.0875000
NODE_83662_length_389_cov_4.468966	199	269	4	14	70	0.2000000
NODE_83662_length_389_cov_4.468966	199	269	5	24	70	0.3428572
NODE_83662_length_389_cov_4.468966	199	269	6	9	70	0.1285714
NODE_83662_length_389_cov_4.468966	199	269	7	23	70	0.3285714
NODE_83663_length_389_cov_4.424138	68	148	39	4	80	0.0500000
NODE_83663_length_389_cov_4.424138	68	148	41	1	80	0.0125000
NODE_83663_length_389_cov_4.424138	68	148	42	15	80	0.1875000
NODE_83663_length_389_cov_4.424138	68	148	43	3	80	0.0375000
NODE_83663_length_389_cov_4.424138	68	148	44	1	80	0.0125000
NODE_83663_length_389_cov_4.424138	68	148	45	1	80	0.0125000
NODE_83663_length_389_cov_4.424138	68	148	46	4	80	0.0500000
NODE_83663_length_389_cov_4.424138	68	148	47	51	80	0.6375000
NODE_83685_length_389_cov_3.782759	194	225	0	31	31	1.0000000
NODE_83689_length_389_cov_3.555172	107	153	2	14	46	0.3043478
NODE_83689_length_389_cov_3.555172	107	153	4	11	46	0.2391304
NODE_83689_length_389_cov_3.555172	107	153	6	21	46	0.4565217
NODE_83695_length_389_cov_3.251724	120	163	0	43	43	1.0000000
NODE_83695_length_389_cov_3.251724	136	206	0	55	70	0.7857143
NODE_83695_length_389_cov_3.251724	136	206	1	15	70	0.2142857
NODE_83816_length_389_cov_1.951724	68	148	0	22	80	0.2750000
NODE_83816_length_389_cov_1.951724	68	148	1	58	80	0.7250000
NODE_83819_length_389_cov_1.937931	53	82	0	29	29	1.0000000
NODE_83819_length_389_cov_1.937931	153	233	6	15	80	0.1875000
NODE_83819_length_389_cov_1.937931	153	233	7	19	80	0.2375000
NODE_83819_length_389_cov_1.937931	153	233	8	42	80	0.5250000
NODE_83819_length_389_cov_1.937931	153	233	9	4	80	0.0500000
NODE_83829_length_389_cov_1.920690	296	365	2	2	69	0.0289855
NODE_83829_length_389_cov_1.920690	296	365	4	67	69	0.9710145
NODE_84182_length_389_cov_0.720690	294	374	0	80	80	1.0000000
NODE_84267_length_388_cov_9.179931	47	127	0	80	80	1.0000000
NODE_84267_length_388_cov_9.179931	100	180	0	52	80	0.6500000
NODE_84267_length_388_cov_9.179931	100	180	1	28	80	0.3500000
NODE_84270_length_388_cov_7.249135	171	251	0	80	80	1.0000000
NODE_84270_length_388_cov_7.249135	224	304	0	80	80	1.0000000
NODE_84305_length_388_cov_3.913495	151	231	1	7	80	0.0875000
NODE_84305_length_388_cov_3.913495	151	231	2	50	80	0.6250000
NODE_84305_length_388_cov_3.913495	151	231	4	23	80	0.2875000
NODE_84308_length_388_cov_3.809689	233	277	0	30	44	0.6818182
NODE_84308_length_388_cov_3.809689	233	277	2	14	44	0.3181818
NODE_84332_length_388_cov_3.103806	101	166	1	65	65	1.0000000
NODE_84332_length_388_cov_3.103806	147	227	0	24	80	0.3000000
NODE_84332_length_388_cov_3.103806	147	227	1	56	80	0.7000000
NODE_84334_length_388_cov_3.041522	48	128	1	16	80	0.2000000
NODE_84334_length_388_cov_3.041522	48	128	2	64	80	0.8000000
NODE_84410_length_388_cov_2.114187	82	141	0	59	59	1.0000000
NODE_84410_length_388_cov_2.114187	135	194	0	59	59	1.0000000
NODE_84423_length_388_cov_2.017301	99	151	0	52	52	1.0000000
NODE_84427_length_388_cov_1.989619	0	76	0	59	76	0.7763158
NODE_84427_length_388_cov_1.989619	0	76	1	17	76	0.2236842
NODE_84427_length_388_cov_1.989619	49	114	0	10	65	0.1538462
NODE_84427_length_388_cov_1.989619	49	114	1	55	65	0.8461539
NODE_84587_length_388_cov_1.352941	172	247	0	75	75	1.0000000
NODE_84631_length_388_cov_1.228374	308	339	0	31	31	1.0000000
NODE_84885_length_387_cov_33.052083	194	274	0	80	80	1.0000000
NODE_84885_length_387_cov_33.052083	247	327	0	80	80	1.0000000
NODE_84890_length_387_cov_6.871528	26	106	0	80	80	1.0000000
NODE_84890_length_387_cov_6.871528	79	159	0	80	80	1.0000000
NODE_84902_length_387_cov_5.420139	286	341	2	55	55	1.0000000
NODE_84946_length_387_cov_3.364583	287	367	0	4	80	0.0500000
NODE_84946_length_387_cov_3.364583	287	367	2	76	80	0.9500000
NODE_85007_length_387_cov_2.260417	140	210	0	70	70	1.0000000
NODE_85019_length_387_cov_2.128472	220	286	1	66	66	1.0000000
NODE_85019_length_387_cov_2.128472	273	329	1	56	56	1.0000000
NODE_85032_length_387_cov_2.090278	318	352	0	34	34	1.0000000
NODE_85037_length_387_cov_2.055556	23	45	0	22	22	1.0000000
NODE_85047_length_387_cov_1.979167	259	316	0	57	57	1.0000000
NODE_85047_length_387_cov_1.979167	312	369	0	57	57	1.0000000
NODE_85091_length_387_cov_1.770833	315	361	0	34	46	0.7391304
NODE_85091_length_387_cov_1.770833	315	361	1	6	46	0.1304348
NODE_85091_length_387_cov_1.770833	315	361	2	6	46	0.1304348
NODE_85528_length_386_cov_9.979094	38	118	0	80	80	1.0000000
NODE_85528_length_386_cov_9.979094	91	174	0	83	83	1.0000000
NODE_85546_length_386_cov_4.428571	197	249	0	20	52	0.3846154
NODE_85546_length_386_cov_4.428571	197	249	2	32	52	0.6153846
NODE_85570_length_386_cov_3.355401	151	231	0	80	80	1.0000000
NODE_85570_length_386_cov_3.355401	204	265	0	61	61	1.0000000
NODE_85602_length_386_cov_2.686411	293	325	1	12	32	0.3750000
NODE_85602_length_386_cov_2.686411	293	325	2	20	32	0.6250000
NODE_85602_length_386_cov_2.686411	349	379	1	30	30	1.0000000
NODE_85629_length_386_cov_2.442509	55	135	0	80	80	1.0000000
NODE_85629_length_386_cov_2.442509	108	164	0	56	56	1.0000000
NODE_85793_length_386_cov_1.494774	79	121	5	33	42	0.7857143
NODE_85793_length_386_cov_1.494774	79	121	7	9	42	0.2142857
NODE_85793_length_386_cov_1.494774	93	156	5	19	63	0.3015873
NODE_85793_length_386_cov_1.494774	93	156	7	42	63	0.6666667
NODE_85793_length_386_cov_1.494774	93	156	9	2	63	0.0317460
NODE_85816_length_386_cov_1.421603	160	236	0	76	76	1.0000000
NODE_85845_length_386_cov_1.372822	62	142	0	80	80	1.0000000
NODE_85845_length_386_cov_1.372822	115	195	0	29	80	0.3625000
NODE_85845_length_386_cov_1.372822	115	195	2	15	80	0.1875000
NODE_85845_length_386_cov_1.372822	115	195	3	35	80	0.4375000
NODE_85845_length_386_cov_1.372822	115	195	4	1	80	0.0125000
NODE_85858_length_386_cov_1.317073	124	161	10	30	37	0.8108108
NODE_85858_length_386_cov_1.317073	124	161	12	7	37	0.1891892
NODE_85902_length_386_cov_1.170732	260	308	3	15	48	0.3125000
NODE_85902_length_386_cov_1.170732	260	308	5	10	48	0.2083333
NODE_85902_length_386_cov_1.170732	260	308	7	23	48	0.4791667
NODE_86143_length_385_cov_167.877622	103	164	216	1	61	0.0163934
NODE_86143_length_385_cov_167.877622	103	164	218	3	61	0.0491803
NODE_86143_length_385_cov_167.877622	103	164	219	1	61	0.0163934
NODE_86143_length_385_cov_167.877622	103	164	221	3	61	0.0491803
NODE_86143_length_385_cov_167.877622	103	164	222	3	61	0.0491803
NODE_86143_length_385_cov_167.877622	103	164	223	2	61	0.0327869
NODE_86143_length_385_cov_167.877622	103	164	224	1	61	0.0163934
NODE_86143_length_385_cov_167.877622	103	164	225	1	61	0.0163934
NODE_86143_length_385_cov_167.877622	103	164	226	2	61	0.0327869
NODE_86143_length_385_cov_167.877622	103	164	229	1	61	0.0163934
NODE_86143_length_385_cov_167.877622	103	164	230	6	61	0.0983607
NODE_86143_length_385_cov_167.877622	103	164	231	3	61	0.0491803
NODE_86143_length_385_cov_167.877622	103	164	232	8	61	0.1311475
NODE_86143_length_385_cov_167.877622	103	164	233	1	61	0.0163934
NODE_86143_length_385_cov_167.877622	103	164	234	4	61	0.0655738
NODE_86143_length_385_cov_167.877622	103	164	235	12	61	0.1967213
NODE_86143_length_385_cov_167.877622	103	164	236	3	61	0.0491803
NODE_86143_length_385_cov_167.877622	103	164	237	4	61	0.0655738
NODE_86143_length_385_cov_167.877622	103	164	238	2	61	0.0327869
NODE_86144_length_385_cov_38.695804	164	244	2	80	80	1.0000000
NODE_86144_length_385_cov_38.695804	217	297	0	35	80	0.4375000
NODE_86144_length_385_cov_38.695804	217	297	2	45	80	0.5625000
NODE_86169_length_385_cov_4.335664	173	250	0	36	77	0.4675325
NODE_86169_length_385_cov_4.335664	173	250	1	41	77	0.5324675
NODE_86185_length_385_cov_3.793706	215	297	0	25	82	0.3048781
NODE_86185_length_385_cov_3.793706	215	297	2	57	82	0.6951219
NODE_86230_length_385_cov_2.786713	99	179	1	5	80	0.0625000
NODE_86230_length_385_cov_2.786713	99	179	2	73	80	0.9125000
NODE_86230_length_385_cov_2.786713	99	179	3	2	80	0.0250000
NODE_86230_length_385_cov_2.786713	152	232	1	4	80	0.0500000
NODE_86230_length_385_cov_2.786713	152	232	2	39	80	0.4875000
NODE_86230_length_385_cov_2.786713	152	232	4	37	80	0.4625000
NODE_86230_length_385_cov_2.786713	281	362	0	56	81	0.6913580
NODE_86230_length_385_cov_2.786713	281	362	1	1	81	0.0123457
NODE_86230_length_385_cov_2.786713	281	362	3	6	81	0.0740741
NODE_86230_length_385_cov_2.786713	281	362	4	18	81	0.2222222
NODE_86448_length_385_cov_1.381119	71	145	1	15	74	0.2027027
NODE_86448_length_385_cov_1.381119	71	145	2	23	74	0.3108108
NODE_86448_length_385_cov_1.381119	71	145	3	36	74	0.4864865
NODE_86448_length_385_cov_1.381119	118	198	3	75	80	0.9375000
NODE_86448_length_385_cov_1.381119	118	198	4	5	80	0.0625000
NODE_86798_length_384_cov_3.996491	135	217	4	1	82	0.0121951
NODE_86798_length_384_cov_3.996491	135	217	5	21	82	0.2560976
NODE_86798_length_384_cov_3.996491	135	217	6	1	82	0.0121951
NODE_86798_length_384_cov_3.996491	135	217	7	1	82	0.0121951
NODE_86798_length_384_cov_3.996491	135	217	8	13	82	0.1585366
NODE_86798_length_384_cov_3.996491	135	217	9	20	82	0.2439024
NODE_86798_length_384_cov_3.996491	135	217	10	25	82	0.3048781
NODE_86809_length_384_cov_3.729825	181	228	0	47	47	1.0000000
NODE_86812_length_384_cov_3.715789	145	221	0	76	76	1.0000000
NODE_86841_length_384_cov_2.996491	147	227	6	2	80	0.0250000
NODE_86841_length_384_cov_2.996491	147	227	7	2	80	0.0250000
NODE_86841_length_384_cov_2.996491	147	227	8	6	80	0.0750000
NODE_86841_length_384_cov_2.996491	147	227	9	12	80	0.1500000
NODE_86841_length_384_cov_2.996491	147	227	10	1	80	0.0125000
NODE_86841_length_384_cov_2.996491	147	227	11	2	80	0.0250000
NODE_86841_length_384_cov_2.996491	147	227	12	2	80	0.0250000
NODE_86841_length_384_cov_2.996491	147	227	13	5	80	0.0625000
NODE_86841_length_384_cov_2.996491	147	227	14	3	80	0.0375000
NODE_86841_length_384_cov_2.996491	147	227	16	9	80	0.1125000
NODE_86841_length_384_cov_2.996491	147	227	17	4	80	0.0500000
NODE_86841_length_384_cov_2.996491	147	227	18	8	80	0.1000000
NODE_86841_length_384_cov_2.996491	147	227	20	13	80	0.1625000
NODE_86841_length_384_cov_2.996491	147	227	22	11	80	0.1375000
NODE_86847_length_384_cov_2.835088	65	145	8	10	80	0.1250000
NODE_86847_length_384_cov_2.835088	65	145	9	57	80	0.7125000
NODE_86847_length_384_cov_2.835088	65	145	10	13	80	0.1625000
NODE_86866_length_384_cov_2.575439	151	224	19	13	73	0.1780822
NODE_86866_length_384_cov_2.575439	151	224	20	25	73	0.3424658
NODE_86866_length_384_cov_2.575439	151	224	21	31	73	0.4246575
NODE_86866_length_384_cov_2.575439	151	224	22	3	73	0.0410959
NODE_86866_length_384_cov_2.575439	151	224	23	1	73	0.0136986
NODE_86866_length_384_cov_2.575439	197	281	4	5	84	0.0595238
NODE_86866_length_384_cov_2.575439	197	281	6	10	84	0.1190476
NODE_86866_length_384_cov_2.575439	197	281	8	12	84	0.1428571
NODE_86866_length_384_cov_2.575439	197	281	10	9	84	0.1071429
NODE_86866_length_384_cov_2.575439	197	281	12	4	84	0.0476190
NODE_86866_length_384_cov_2.575439	197	281	15	4	84	0.0476190
NODE_86866_length_384_cov_2.575439	197	281	17	3	84	0.0357143
NODE_86866_length_384_cov_2.575439	197	281	19	21	84	0.2500000
NODE_86866_length_384_cov_2.575439	197	281	21	16	84	0.1904762
NODE_86907_length_384_cov_2.231579	78	153	0	75	75	1.0000000
NODE_86942_length_384_cov_1.940351	73	153	0	31	80	0.3875000
NODE_86942_length_384_cov_1.940351	73	153	3	15	80	0.1875000
NODE_86942_length_384_cov_1.940351	73	153	4	34	80	0.4250000
NODE_87431_length_383_cov_4.869718	117	197	0	36	80	0.4500000
NODE_87431_length_383_cov_4.869718	117	197	1	44	80	0.5500000
NODE_87431_length_383_cov_4.869718	170	250	1	80	80	1.0000000
NODE_87432_length_383_cov_4.841549	121	180	4	9	59	0.1525424
NODE_87432_length_383_cov_4.841549	121	180	5	26	59	0.4406780
NODE_87432_length_383_cov_4.841549	121	180	6	24	59	0.4067796
NODE_87438_length_383_cov_4.559859	33	109	0	1	76	0.0131579
NODE_87438_length_383_cov_4.559859	33	109	1	38	76	0.5000000
NODE_87438_length_383_cov_4.559859	33	109	2	37	76	0.4868421
NODE_87487_length_383_cov_2.940141	185	265	0	80	80	1.0000000
NODE_87495_length_383_cov_2.760563	123	203	49	2	80	0.0250000
NODE_87495_length_383_cov_2.760563	123	203	51	1	80	0.0125000
NODE_87495_length_383_cov_2.760563	123	203	54	3	80	0.0375000
NODE_87495_length_383_cov_2.760563	123	203	55	3	80	0.0375000
NODE_87495_length_383_cov_2.760563	123	203	57	1	80	0.0125000
NODE_87495_length_383_cov_2.760563	123	203	58	5	80	0.0625000
NODE_87495_length_383_cov_2.760563	123	203	60	3	80	0.0375000
NODE_87495_length_383_cov_2.760563	123	203	61	1	80	0.0125000
NODE_87495_length_383_cov_2.760563	123	203	62	3	80	0.0375000
NODE_87495_length_383_cov_2.760563	123	203	63	1	80	0.0125000
NODE_87495_length_383_cov_2.760563	123	203	65	3	80	0.0375000
NODE_87495_length_383_cov_2.760563	123	203	67	1	80	0.0125000
NODE_87495_length_383_cov_2.760563	123	203	69	1	80	0.0125000
NODE_87495_length_383_cov_2.760563	123	203	71	2	80	0.0250000
NODE_87495_length_383_cov_2.760563	123	203	72	2	80	0.0250000
NODE_87495_length_383_cov_2.760563	123	203	73	2	80	0.0250000
NODE_87495_length_383_cov_2.760563	123	203	74	5	80	0.0625000
NODE_87495_length_383_cov_2.760563	123	203	77	2	80	0.0250000
NODE_87495_length_383_cov_2.760563	123	203	78	5	80	0.0625000
NODE_87495_length_383_cov_2.760563	123	203	80	2	80	0.0250000
NODE_87495_length_383_cov_2.760563	123	203	81	5	80	0.0625000
NODE_87495_length_383_cov_2.760563	123	203	82	8	80	0.1000000
NODE_87495_length_383_cov_2.760563	123	203	83	1	80	0.0125000
NODE_87495_length_383_cov_2.760563	123	203	84	6	80	0.0750000
NODE_87495_length_383_cov_2.760563	123	203	85	6	80	0.0750000
NODE_87495_length_383_cov_2.760563	123	203	86	5	80	0.0625000
NODE_87495_length_383_cov_2.760563	123	203	87	1	80	0.0125000
NODE_87495_length_383_cov_2.760563	169	249	24	3	80	0.0375000
NODE_87495_length_383_cov_2.760563	169	249	25	1	80	0.0125000
NODE_87495_length_383_cov_2.760563	169	249	28	1	80	0.0125000
NODE_87495_length_383_cov_2.760563	169	249	30	1	80	0.0125000
NODE_87495_length_383_cov_2.760563	169	249	31	1	80	0.0125000
NODE_87495_length_383_cov_2.760563	169	249	32	1	80	0.0125000
NODE_87495_length_383_cov_2.760563	169	249	34	6	80	0.0750000
NODE_87495_length_383_cov_2.760563	169	249	35	2	80	0.0250000
NODE_87495_length_383_cov_2.760563	169	249	36	4	80	0.0500000
NODE_87495_length_383_cov_2.760563	169	249	37	5	80	0.0625000
NODE_87495_length_383_cov_2.760563	169	249	38	1	80	0.0125000
NODE_87495_length_383_cov_2.760563	169	249	40	12	80	0.1500000
NODE_87495_length_383_cov_2.760563	169	249	43	3	80	0.0375000
NODE_87495_length_383_cov_2.760563	169	249	45	1	80	0.0125000
NODE_87495_length_383_cov_2.760563	169	249	46	1	80	0.0125000
NODE_87495_length_383_cov_2.760563	169	249	48	1	80	0.0125000
NODE_87495_length_383_cov_2.760563	169	249	49	4	80	0.0500000
NODE_87495_length_383_cov_2.760563	169	249	51	1	80	0.0125000
NODE_87495_length_383_cov_2.760563	169	249	54	3	80	0.0375000
NODE_87495_length_383_cov_2.760563	169	249	55	3	80	0.0375000
NODE_87495_length_383_cov_2.760563	169	249	57	1	80	0.0125000
NODE_87495_length_383_cov_2.760563	169	249	58	5	80	0.0625000
NODE_87495_length_383_cov_2.760563	169	249	60	3	80	0.0375000
NODE_87495_length_383_cov_2.760563	169	249	61	1	80	0.0125000
NODE_87495_length_383_cov_2.760563	169	249	62	3	80	0.0375000
NODE_87495_length_383_cov_2.760563	169	249	63	1	80	0.0125000
NODE_87495_length_383_cov_2.760563	169	249	65	3	80	0.0375000
NODE_87495_length_383_cov_2.760563	169	249	67	1	80	0.0125000
NODE_87495_length_383_cov_2.760563	169	249	69	1	80	0.0125000
NODE_87495_length_383_cov_2.760563	169	249	71	2	80	0.0250000
NODE_87495_length_383_cov_2.760563	169	249	73	2	80	0.0250000
NODE_87495_length_383_cov_2.760563	169	249	74	2	80	0.0250000
NODE_87495_length_383_cov_2.760563	222	302	1	4	80	0.0500000
NODE_87495_length_383_cov_2.760563	222	302	2	16	80	0.2000000
NODE_87495_length_383_cov_2.760563	222	302	3	13	80	0.1625000
NODE_87495_length_383_cov_2.760563	222	302	4	1	80	0.0125000
NODE_87495_length_383_cov_2.760563	222	302	6	6	80	0.0750000
NODE_87495_length_383_cov_2.760563	222	302	8	2	80	0.0250000
NODE_87495_length_383_cov_2.760563	222	302	10	1	80	0.0125000
NODE_87495_length_383_cov_2.760563	222	302	12	1	80	0.0125000
NODE_87495_length_383_cov_2.760563	222	302	13	3	80	0.0375000
NODE_87495_length_383_cov_2.760563	222	302	16	1	80	0.0125000
NODE_87495_length_383_cov_2.760563	222	302	18	1	80	0.0125000
NODE_87495_length_383_cov_2.760563	222	302	20	1	80	0.0125000
NODE_87495_length_383_cov_2.760563	222	302	22	3	80	0.0375000
NODE_87495_length_383_cov_2.760563	222	302	24	3	80	0.0375000
NODE_87495_length_383_cov_2.760563	222	302	25	1	80	0.0125000
NODE_87495_length_383_cov_2.760563	222	302	28	1	80	0.0125000
NODE_87495_length_383_cov_2.760563	222	302	30	1	80	0.0125000
NODE_87495_length_383_cov_2.760563	222	302	31	1	80	0.0125000
NODE_87495_length_383_cov_2.760563	222	302	32	1	80	0.0125000
NODE_87495_length_383_cov_2.760563	222	302	34	6	80	0.0750000
NODE_87495_length_383_cov_2.760563	222	302	35	2	80	0.0250000
NODE_87495_length_383_cov_2.760563	222	302	36	4	80	0.0500000
NODE_87495_length_383_cov_2.760563	222	302	37	5	80	0.0625000
NODE_87495_length_383_cov_2.760563	222	302	38	1	80	0.0125000
NODE_87495_length_383_cov_2.760563	222	302	40	1	80	0.0125000
NODE_87566_length_383_cov_2.123239	29	94	2	65	65	1.0000000
NODE_87566_length_383_cov_2.123239	93	173	1	66	80	0.8250000
NODE_87566_length_383_cov_2.123239	93	173	2	14	80	0.1750000
NODE_87566_length_383_cov_2.123239	146	193	0	20	47	0.4255319
NODE_87566_length_383_cov_2.123239	146	193	1	27	47	0.5744681
NODE_87634_length_383_cov_1.728873	196	257	9	8	61	0.1311475
NODE_87634_length_383_cov_1.728873	196	257	10	7	61	0.1147541
NODE_87634_length_383_cov_1.728873	196	257	11	2	61	0.0327869
NODE_87634_length_383_cov_1.728873	196	257	12	3	61	0.0491803
NODE_87634_length_383_cov_1.728873	196	257	14	8	61	0.1311475
NODE_87634_length_383_cov_1.728873	196	257	15	5	61	0.0819672
NODE_87634_length_383_cov_1.728873	196	257	16	19	61	0.3114754
NODE_87634_length_383_cov_1.728873	196	257	18	9	61	0.1475410
NODE_87634_length_383_cov_1.728873	239	310	12	20	71	0.2816902
NODE_87634_length_383_cov_1.728873	239	310	14	3	71	0.0422535
NODE_87634_length_383_cov_1.728873	239	310	16	21	71	0.2957746
NODE_87634_length_383_cov_1.728873	239	310	17	1	71	0.0140845
NODE_87634_length_383_cov_1.728873	239	310	18	26	71	0.3661972
NODE_88039_length_382_cov_43.724382	245	325	0	5	80	0.0625000
NODE_88039_length_382_cov_43.724382	245	325	2	75	80	0.9375000
NODE_88039_length_382_cov_43.724382	298	378	0	58	80	0.7250000
NODE_88039_length_382_cov_43.724382	298	378	2	22	80	0.2750000
NODE_88040_length_382_cov_35.908127	163	243	2	80	80	1.0000000
NODE_88040_length_382_cov_35.908127	216	296	0	22	80	0.2750000
NODE_88040_length_382_cov_35.908127	216	296	2	58	80	0.7250000
NODE_88040_length_382_cov_35.908127	292	372	0	80	80	1.0000000
NODE_88041_length_382_cov_26.240283	57	137	0	80	80	1.0000000
NODE_88041_length_382_cov_26.240283	110	190	0	80	80	1.0000000
NODE_88054_length_382_cov_5.583039	63	143	0	80	80	1.0000000
NODE_88054_length_382_cov_5.583039	116	196	0	80	80	1.0000000
NODE_88063_length_382_cov_4.837456	19	78	0	59	59	1.0000000
NODE_88067_length_382_cov_4.618375	0	55	0	25	55	0.4545455
NODE_88067_length_382_cov_4.618375	0	55	1	30	55	0.5454546
NODE_88067_length_382_cov_4.618375	104	184	4	9	80	0.1125000
NODE_88067_length_382_cov_4.618375	104	184	5	71	80	0.8875000
NODE_88067_length_382_cov_4.618375	157	237	2	4	80	0.0500000
NODE_88067_length_382_cov_4.618375	157	237	4	43	80	0.5375000
NODE_88067_length_382_cov_4.618375	157	237	5	18	80	0.2250000
NODE_88067_length_382_cov_4.618375	157	237	6	15	80	0.1875000
NODE_88075_length_382_cov_4.268551	71	152	0	9	81	0.1111111
NODE_88075_length_382_cov_4.268551	71	152	2	72	81	0.8888889
NODE_88075_length_382_cov_4.268551	124	205	0	1	81	0.0123457
NODE_88075_length_382_cov_4.268551	124	205	2	80	81	0.9876543
NODE_88080_length_382_cov_4.091873	30	92	0	62	62	1.0000000
NODE_88121_length_382_cov_3.031802	173	253	1	5	80	0.0625000
NODE_88121_length_382_cov_3.031802	173	253	2	5	80	0.0625000
NODE_88121_length_382_cov_3.031802	173	253	4	12	80	0.1500000
NODE_88121_length_382_cov_3.031802	173	253	6	12	80	0.1500000
NODE_88121_length_382_cov_3.031802	173	253	9	15	80	0.1875000
NODE_88121_length_382_cov_3.031802	173	253	11	24	80	0.3000000
NODE_88121_length_382_cov_3.031802	173	253	12	7	80	0.0875000
NODE_88121_length_382_cov_3.031802	226	295	11	32	69	0.4637681
NODE_88121_length_382_cov_3.031802	226	295	12	37	69	0.5362319
NODE_88135_length_382_cov_2.798587	231	293	2	62	62	1.0000000
NODE_88136_length_382_cov_2.791519	195	244	5	49	49	1.0000000
NODE_88136_length_382_cov_2.791519	217	297	2	24	80	0.3000000
NODE_88136_length_382_cov_2.791519	217	297	3	6	80	0.0750000
NODE_88136_length_382_cov_2.791519	217	297	5	50	80	0.6250000
NODE_88164_length_382_cov_2.611307	301	368	0	29	67	0.4328358
NODE_88164_length_382_cov_2.611307	301	368	1	36	67	0.5373135
NODE_88164_length_382_cov_2.611307	301	368	3	2	67	0.0298507
NODE_88276_length_382_cov_1.802120	0	60	0	60	60	1.0000000
NODE_88660_length_382_cov_0.738516	48	95	8	1	47	0.0212766
NODE_88660_length_382_cov_0.738516	48	95	10	46	47	0.9787234
NODE_88660_length_382_cov_0.738516	68	148	9	7	80	0.0875000
NODE_88660_length_382_cov_0.738516	68	148	10	73	80	0.9125000
NODE_88758_length_381_cov_12.010638	195	274	0	77	79	0.9746835
NODE_88758_length_381_cov_12.010638	195	274	2	2	79	0.0253165
NODE_88865_length_381_cov_2.606383	68	98	6	30	30	1.0000000
NODE_88867_length_381_cov_2.570922	115	175	1	16	60	0.2666667
NODE_88867_length_381_cov_2.570922	115	175	2	44	60	0.7333333
NODE_88872_length_381_cov_2.514184	225	307	0	23	82	0.2804878
NODE_88872_length_381_cov_2.514184	225	307	2	59	82	0.7195122
NODE_88900_length_381_cov_2.198582	193	276	0	36	83	0.4337350
NODE_88900_length_381_cov_2.198582	193	276	1	47	83	0.5662650
NODE_88935_length_381_cov_1.989362	279	325	0	46	46	1.0000000
NODE_89009_length_381_cov_1.663121	51	128	1	2	77	0.0259740
NODE_89009_length_381_cov_1.663121	51	128	2	27	77	0.3506494
NODE_89009_length_381_cov_1.663121	51	128	4	48	77	0.6233766
NODE_89009_length_381_cov_1.663121	101	181	3	41	80	0.5125000
NODE_89009_length_381_cov_1.663121	101	181	4	39	80	0.4875000
NODE_89090_length_381_cov_1.400709	254	334	0	80	80	1.0000000
NODE_89090_length_381_cov_1.400709	254	334	0	80	80	1.0000000
NODE_89090_length_381_cov_1.400709	309	373	0	64	64	1.0000000
NODE_89482_length_380_cov_57.604982	196	276	0	64	80	0.8000000
NODE_89482_length_380_cov_57.604982	196	276	2	16	80	0.2000000
NODE_89482_length_380_cov_57.604982	249	329	0	11	80	0.1375000
NODE_89482_length_380_cov_57.604982	249	329	2	69	80	0.8625000
NODE_89482_length_380_cov_57.604982	325	359	2	34	34	1.0000000
NODE_89483_length_380_cov_11.185053	79	161	1	37	82	0.4512195
NODE_89483_length_380_cov_11.185053	79	161	2	45	82	0.5487805
NODE_89483_length_380_cov_11.185053	134	214	1	56	80	0.7000000
NODE_89483_length_380_cov_11.185053	134	214	2	24	80	0.3000000
NODE_89491_length_380_cov_5.811388	100	156	1	56	56	1.0000000
NODE_89491_length_380_cov_5.811388	177	213	0	6	36	0.1666667
NODE_89491_length_380_cov_5.811388	177	213	1	30	36	0.8333333
NODE_89495_length_380_cov_5.377224	242	271	48	1	29	0.0344828
NODE_89495_length_380_cov_5.377224	242	271	49	18	29	0.6206896
NODE_89495_length_380_cov_5.377224	242	271	51	10	29	0.3448276
NODE_89508_length_380_cov_4.185053	158	230	0	72	72	1.0000000
NODE_89508_length_380_cov_4.185053	159	229	0	70	70	1.0000000
NODE_89508_length_380_cov_4.185053	203	283	0	80	80	1.0000000
NODE_89508_length_380_cov_4.185053	203	283	0	80	80	1.0000000
NODE_89527_length_380_cov_3.423488	164	233	0	57	69	0.8260869
NODE_89527_length_380_cov_3.423488	164	233	2	12	69	0.1739130
NODE_89540_length_380_cov_3.153025	188	260	1	18	72	0.2500000
NODE_89540_length_380_cov_3.153025	188	260	2	14	72	0.1944444
NODE_89540_length_380_cov_3.153025	188	260	3	25	72	0.3472222
NODE_89540_length_380_cov_3.153025	188	260	4	15	72	0.2083333
NODE_89568_length_380_cov_2.718861	51	131	0	80	80	1.0000000
NODE_89568_length_380_cov_2.718861	104	184	0	80	80	1.0000000
NODE_89658_length_380_cov_1.943060	22	56	1	34	34	1.0000000
NODE_89750_length_380_cov_1.601423	292	332	22	1	40	0.0250000
NODE_89750_length_380_cov_1.601423	292	332	23	8	40	0.2000000
NODE_89750_length_380_cov_1.601423	292	332	25	3	40	0.0750000
NODE_89750_length_380_cov_1.601423	292	332	28	2	40	0.0500000
NODE_89750_length_380_cov_1.601423	292	332	29	1	40	0.0250000
NODE_89750_length_380_cov_1.601423	292	332	30	2	40	0.0500000
NODE_89750_length_380_cov_1.601423	292	332	31	2	40	0.0500000
NODE_89750_length_380_cov_1.601423	292	332	32	2	40	0.0500000
NODE_89750_length_380_cov_1.601423	292	332	33	4	40	0.1000000
NODE_89750_length_380_cov_1.601423	292	332	37	2	40	0.0500000
NODE_89750_length_380_cov_1.601423	292	332	40	1	40	0.0250000
NODE_89750_length_380_cov_1.601423	292	332	41	1	40	0.0250000
NODE_89750_length_380_cov_1.601423	292	332	44	2	40	0.0500000
NODE_89750_length_380_cov_1.601423	292	332	45	3	40	0.0750000
NODE_89750_length_380_cov_1.601423	292	332	47	1	40	0.0250000
NODE_89750_length_380_cov_1.601423	292	332	49	1	40	0.0250000
NODE_89750_length_380_cov_1.601423	292	332	51	2	40	0.0500000
NODE_89750_length_380_cov_1.601423	292	332	52	2	40	0.0500000
NODE_89911_length_380_cov_1.088968	312	353	0	41	41	1.0000000
NODE_89911_length_380_cov_1.088968	326	380	0	54	54	1.0000000
NODE_90152_length_379_cov_42.339286	10	90	0	80	80	1.0000000
NODE_90152_length_379_cov_42.339286	86	166	0	80	80	1.0000000
NODE_90152_length_379_cov_42.339286	139	219	0	80	80	1.0000000
NODE_90153_length_379_cov_32.075000	0	62	0	62	62	1.0000000
NODE_90165_length_379_cov_5.607143	279	338	0	59	59	1.0000000
NODE_90180_length_379_cov_4.432143	219	243	0	24	24	1.0000000
NODE_90193_length_379_cov_3.778571	271	300	1	5	29	0.1724138
NODE_90193_length_379_cov_3.778571	271	300	2	24	29	0.8275862
NODE_90198_length_379_cov_3.585714	128	152	0	8	24	0.3333333
NODE_90198_length_379_cov_3.585714	128	152	2	16	24	0.6666667
NODE_90198_length_379_cov_3.585714	169	249	0	39	80	0.4875000
NODE_90198_length_379_cov_3.585714	169	249	2	41	80	0.5125000
NODE_90203_length_379_cov_3.375000	19	43	0	24	24	1.0000000
NODE_90247_length_379_cov_2.692857	121	201	3	35	80	0.4375000
NODE_90247_length_379_cov_2.692857	121	201	4	45	80	0.5625000
NODE_90247_length_379_cov_2.692857	174	221	3	40	47	0.8510638
NODE_90247_length_379_cov_2.692857	174	221	4	7	47	0.1489362
NODE_90789_length_378_cov_53.039427	147	227	0	80	80	1.0000000
NODE_90789_length_378_cov_53.039427	200	280	0	80	80	1.0000000
NODE_90789_length_378_cov_53.039427	276	356	0	80	80	1.0000000
NODE_90789_length_378_cov_53.039427	329	378	0	49	49	1.0000000
NODE_90794_length_378_cov_6.569892	223	304	7	31	81	0.3827161
NODE_90794_length_378_cov_6.569892	223	304	8	50	81	0.6172839
NODE_90795_length_378_cov_6.444444	217	297	0	80	80	1.0000000
NODE_90795_length_378_cov_6.444444	270	350	0	80	80	1.0000000
NODE_90808_length_378_cov_4.899642	135	191	0	42	56	0.7500000
NODE_90808_length_378_cov_4.899642	135	191	2	14	56	0.2500000
NODE_90855_length_378_cov_3.236559	143	212	2	69	69	1.0000000
NODE_90859_length_378_cov_3.132616	238	280	1	42	42	1.0000000
NODE_90898_length_378_cov_2.534050	203	243	0	40	40	1.0000000
NODE_90898_length_378_cov_2.534050	271	347	0	6	76	0.0789474
NODE_90898_length_378_cov_2.534050	271	347	1	70	76	0.9210526
NODE_90898_length_378_cov_2.534050	331	360	1	29	29	1.0000000
NODE_90948_length_378_cov_2.093190	179	250	0	36	71	0.5070422
NODE_90948_length_378_cov_2.093190	179	250	1	35	71	0.4929577
NODE_90948_length_378_cov_2.093190	183	219	0	32	36	0.8888889
NODE_90948_length_378_cov_2.093190	183	219	1	4	36	0.1111111
NODE_91002_length_378_cov_1.813620	36	89	0	53	53	1.0000000
NODE_91475_length_377_cov_71.723022	19	99	4	5	80	0.0625000
NODE_91475_length_377_cov_71.723022	19	99	6	14	80	0.1750000
NODE_91475_length_377_cov_71.723022	19	99	7	7	80	0.0875000
NODE_91475_length_377_cov_71.723022	19	99	8	8	80	0.1000000
NODE_91475_length_377_cov_71.723022	19	99	9	46	80	0.5750000
NODE_91475_length_377_cov_71.723022	72	152	9	53	80	0.6625000
NODE_91475_length_377_cov_71.723022	72	152	10	2	80	0.0250000
NODE_91475_length_377_cov_71.723022	72	152	11	24	80	0.3000000
NODE_91475_length_377_cov_71.723022	72	152	12	1	80	0.0125000
NODE_91475_length_377_cov_71.723022	148	228	8	25	80	0.3125000
NODE_91475_length_377_cov_71.723022	148	228	9	16	80	0.2000000
NODE_91475_length_377_cov_71.723022	148	228	10	16	80	0.2000000
NODE_91475_length_377_cov_71.723022	148	228	11	18	80	0.2250000
NODE_91475_length_377_cov_71.723022	148	228	12	5	80	0.0625000
NODE_91475_length_377_cov_71.723022	201	281	4	2	80	0.0250000
NODE_91475_length_377_cov_71.723022	201	281	5	9	80	0.1125000
NODE_91475_length_377_cov_71.723022	201	281	7	4	80	0.0500000
NODE_91475_length_377_cov_71.723022	201	281	8	28	80	0.3500000
NODE_91475_length_377_cov_71.723022	201	281	9	37	80	0.4625000
NODE_91477_length_377_cov_41.787770	210	290	15	1	80	0.0125000
NODE_91477_length_377_cov_41.787770	210	290	16	26	80	0.3250000
NODE_91477_length_377_cov_41.787770	210	290	17	9	80	0.1125000
NODE_91477_length_377_cov_41.787770	210	290	18	15	80	0.1875000
NODE_91477_length_377_cov_41.787770	210	290	19	29	80	0.3625000
NODE_91477_length_377_cov_41.787770	263	343	6	6	80	0.0750000
NODE_91477_length_377_cov_41.787770	263	343	7	2	80	0.0250000
NODE_91477_length_377_cov_41.787770	263	343	9	11	80	0.1375000
NODE_91477_length_377_cov_41.787770	263	343	11	17	80	0.2125000
NODE_91477_length_377_cov_41.787770	263	343	12	1	80	0.0125000
NODE_91477_length_377_cov_41.787770	263	343	14	6	80	0.0750000
NODE_91477_length_377_cov_41.787770	263	343	16	6	80	0.0750000
NODE_91477_length_377_cov_41.787770	263	343	17	10	80	0.1250000
NODE_91477_length_377_cov_41.787770	263	343	19	21	80	0.2625000
NODE_91478_length_377_cov_9.982014	32	83	0	5	51	0.0980392
NODE_91478_length_377_cov_9.982014	32	83	1	12	51	0.2352941
NODE_91478_length_377_cov_9.982014	32	83	3	23	51	0.4509804
NODE_91478_length_377_cov_9.982014	32	83	4	11	51	0.2156863
NODE_91486_length_377_cov_6.244604	101	177	1	76	76	1.0000000
NODE_91494_length_377_cov_5.183453	169	224	0	55	55	1.0000000
NODE_91499_length_377_cov_4.586331	186	266	0	18	80	0.2250000
NODE_91499_length_377_cov_4.586331	186	266	1	62	80	0.7750000
NODE_91499_length_377_cov_4.586331	239	319	0	44	80	0.5500000
NODE_91499_length_377_cov_4.586331	239	319	1	36	80	0.4500000
NODE_91500_length_377_cov_4.431655	139	216	0	77	77	1.0000000
NODE_91502_length_377_cov_4.330935	134	214	1	6	80	0.0750000
NODE_91502_length_377_cov_4.330935	134	214	2	25	80	0.3125000
NODE_91502_length_377_cov_4.330935	134	214	3	49	80	0.6125000
NODE_91502_length_377_cov_4.330935	187	267	1	8	80	0.1000000
NODE_91502_length_377_cov_4.330935	187	267	2	63	80	0.7875000
NODE_91502_length_377_cov_4.330935	187	267	3	9	80	0.1125000
NODE_91506_length_377_cov_4.032374	124	181	0	23	57	0.4035088
NODE_91506_length_377_cov_4.032374	124	181	2	34	57	0.5964912
NODE_91506_length_377_cov_4.032374	154	201	2	45	47	0.9574468
NODE_91506_length_377_cov_4.032374	154	201	3	2	47	0.0425532
NODE_91526_length_377_cov_3.615108	82	140	0	58	58	1.0000000
NODE_91526_length_377_cov_3.615108	82	140	0	58	58	1.0000000
NODE_91526_length_377_cov_3.615108	113	193	0	80	80	1.0000000
NODE_91526_length_377_cov_3.615108	113	193	0	80	80	1.0000000
NODE_91526_length_377_cov_3.615108	189	258	0	69	69	1.0000000
NODE_91526_length_377_cov_3.615108	243	313	0	70	70	1.0000000
NODE_91553_length_377_cov_2.913669	38	61	0	23	23	1.0000000
NODE_91553_length_377_cov_2.913669	167	228	1	6	61	0.0983607
NODE_91553_length_377_cov_2.913669	167	228	2	55	61	0.9016393
NODE_91619_length_377_cov_2.104317	137	188	0	51	51	1.0000000
NODE_91619_length_377_cov_2.104317	168	211	0	43	43	1.0000000
NODE_91619_length_377_cov_2.104317	190	241	0	51	51	1.0000000
NODE_91727_length_377_cov_1.622302	123	181	0	12	58	0.2068966
NODE_91727_length_377_cov_1.622302	123	181	1	46	58	0.7931035
NODE_91727_length_377_cov_1.622302	176	234	1	57	58	0.9827586
NODE_91727_length_377_cov_1.622302	176	234	2	1	58	0.0172414
NODE_91749_length_377_cov_1.539568	230	310	3	80	80	1.0000000
NODE_91749_length_377_cov_1.539568	230	310	3	80	80	1.0000000
NODE_91749_length_377_cov_1.539568	306	377	0	52	71	0.7323943
NODE_91749_length_377_cov_1.539568	306	377	1	9	71	0.1267606
NODE_91749_length_377_cov_1.539568	306	377	3	10	71	0.1408451
NODE_91749_length_377_cov_1.539568	327	351	0	24	24	1.0000000
NODE_91765_length_377_cov_1.471223	118	198	0	24	80	0.3000000
NODE_91765_length_377_cov_1.471223	118	198	2	5	80	0.0625000
NODE_91765_length_377_cov_1.471223	118	198	4	22	80	0.2750000
NODE_91765_length_377_cov_1.471223	118	198	6	29	80	0.3625000
NODE_91790_length_377_cov_1.456835	177	257	0	68	80	0.8500000
NODE_91790_length_377_cov_1.456835	177	257	2	12	80	0.1500000
NODE_91790_length_377_cov_1.456835	230	310	0	15	80	0.1875000
NODE_91790_length_377_cov_1.456835	230	310	2	65	80	0.8125000
NODE_91817_length_377_cov_1.330935	0	44	0	44	44	1.0000000
NODE_91817_length_377_cov_1.330935	45	117	0	72	72	1.0000000
NODE_92046_length_377_cov_0.762590	299	330	0	31	31	1.0000000
NODE_92166_length_376_cov_6.938628	0	63	3	1	63	0.0158730
NODE_92166_length_376_cov_6.938628	0	63	4	3	63	0.0476190
NODE_92166_length_376_cov_6.938628	0	63	5	13	63	0.2063492
NODE_92166_length_376_cov_6.938628	0	63	7	9	63	0.1428571
NODE_92166_length_376_cov_6.938628	0	63	8	1	63	0.0158730
NODE_92166_length_376_cov_6.938628	0	63	11	4	63	0.0634921
NODE_92166_length_376_cov_6.938628	0	63	15	6	63	0.0952381
NODE_92166_length_376_cov_6.938628	0	63	17	11	63	0.1746032
NODE_92166_length_376_cov_6.938628	0	63	20	1	63	0.0158730
NODE_92166_length_376_cov_6.938628	0	63	23	6	63	0.0952381
NODE_92166_length_376_cov_6.938628	0	63	24	1	63	0.0158730
NODE_92166_length_376_cov_6.938628	0	63	25	1	63	0.0158730
NODE_92166_length_376_cov_6.938628	0	63	26	1	63	0.0158730
NODE_92166_length_376_cov_6.938628	0	63	30	2	63	0.0317460
NODE_92166_length_376_cov_6.938628	0	63	32	2	63	0.0317460
NODE_92166_length_376_cov_6.938628	0	63	33	1	63	0.0158730
NODE_92166_length_376_cov_6.938628	269	340	7	18	71	0.2535211
NODE_92166_length_376_cov_6.938628	269	340	9	48	71	0.6760563
NODE_92166_length_376_cov_6.938628	269	340	10	5	71	0.0704225
NODE_92168_length_376_cov_6.415162	177	257	2	21	80	0.2625000
NODE_92168_length_376_cov_6.415162	177	257	3	11	80	0.1375000
NODE_92168_length_376_cov_6.415162	177	257	4	48	80	0.6000000
NODE_92168_length_376_cov_6.415162	230	310	2	32	80	0.4000000
NODE_92168_length_376_cov_6.415162	230	310	4	48	80	0.6000000
NODE_92173_length_376_cov_5.722022	100	171	1	43	71	0.6056338
NODE_92173_length_376_cov_5.722022	100	171	2	28	71	0.3943662
NODE_92173_length_376_cov_5.722022	155	192	1	11	37	0.2972973
NODE_92173_length_376_cov_5.722022	155	192	2	26	37	0.7027027
NODE_92191_length_376_cov_4.148014	300	330	4	6	30	0.2000000
NODE_92191_length_376_cov_4.148014	300	330	6	24	30	0.8000000
NODE_92196_length_376_cov_3.859206	168	236	2	64	68	0.9411765
NODE_92196_length_376_cov_3.859206	168	236	3	4	68	0.0588235
NODE_92219_length_376_cov_3.140794	122	188	0	66	66	1.0000000
NODE_92442_length_376_cov_1.516245	57	106	2	49	49	1.0000000
NODE_92879_length_375_cov_4.217391	321	350	0	29	29	1.0000000
NODE_92897_length_375_cov_3.699275	287	367	0	80	80	1.0000000
NODE_92911_length_375_cov_3.376812	70	136	0	66	66	1.0000000
NODE_93031_length_375_cov_2.032609	162	224	0	2	62	0.0322581
NODE_93031_length_375_cov_2.032609	162	224	2	7	62	0.1129032
NODE_93031_length_375_cov_2.032609	162	224	3	21	62	0.3387097
NODE_93031_length_375_cov_2.032609	162	224	4	32	62	0.5161290
NODE_93031_length_375_cov_2.032609	215	272	4	57	57	1.0000000
NODE_93050_length_375_cov_1.967391	131	190	6	27	59	0.4576271
NODE_93050_length_375_cov_1.967391	131	190	7	12	59	0.2033898
NODE_93050_length_375_cov_1.967391	131	190	8	20	59	0.3389831
NODE_93050_length_375_cov_1.967391	184	235	6	3	51	0.0588235
NODE_93050_length_375_cov_1.967391	184	235	7	41	51	0.8039216
NODE_93050_length_375_cov_1.967391	184	235	8	7	51	0.1372549
NODE_93081_length_375_cov_1.840580	195	276	0	19	81	0.2345679
NODE_93081_length_375_cov_1.840580	195	276	1	62	81	0.7654321
NODE_93386_length_375_cov_1.000000	320	375	0	55	55	1.0000000
NODE_93609_length_374_cov_4.563636	93	160	0	10	67	0.1492537
NODE_93609_length_374_cov_4.563636	93	160	2	57	67	0.8507463
NODE_93609_length_374_cov_4.563636	146	213	2	67	67	1.0000000
NODE_93612_length_374_cov_4.523636	23	101	0	30	78	0.3846154
NODE_93612_length_374_cov_4.523636	23	101	2	48	78	0.6153846
NODE_93612_length_374_cov_4.523636	81	154	2	45	73	0.6164383
NODE_93612_length_374_cov_4.523636	81	154	4	28	73	0.3835616
NODE_93628_length_374_cov_3.810909	130	189	0	34	59	0.5762712
NODE_93628_length_374_cov_3.810909	130	189	2	25	59	0.4237288
NODE_93628_length_374_cov_3.810909	162	242	0	2	80	0.0250000
NODE_93628_length_374_cov_3.810909	162	242	2	78	80	0.9750000
NODE_93630_length_374_cov_3.789091	236	271	1	35	35	1.0000000
NODE_93630_length_374_cov_3.789091	238	280	0	3	42	0.0714286
NODE_93630_length_374_cov_3.789091	238	280	1	39	42	0.9285714
NODE_93637_length_374_cov_3.458182	190	248	1	12	58	0.2068966
NODE_93637_length_374_cov_3.458182	190	248	2	46	58	0.7931035
NODE_93688_length_374_cov_2.600000	142	217	4	1	75	0.0133333
NODE_93688_length_374_cov_2.600000	142	217	6	1	75	0.0133333
NODE_93688_length_374_cov_2.600000	142	217	7	35	75	0.4666667
NODE_93688_length_374_cov_2.600000	142	217	8	30	75	0.4000000
NODE_93688_length_374_cov_2.600000	142	217	9	4	75	0.0533333
NODE_93688_length_374_cov_2.600000	142	217	10	4	75	0.0533333
NODE_93688_length_374_cov_2.600000	190	270	6	14	80	0.1750000
NODE_93688_length_374_cov_2.600000	190	270	8	44	80	0.5500000
NODE_93688_length_374_cov_2.600000	190	270	9	4	80	0.0500000
NODE_93688_length_374_cov_2.600000	190	270	10	18	80	0.2250000
NODE_93718_length_374_cov_2.330909	40	120	0	80	80	1.0000000
NODE_93769_length_374_cov_2.010909	40	105	1	35	65	0.5384616
NODE_93769_length_374_cov_2.010909	40	105	3	30	65	0.4615385
NODE_93821_length_374_cov_1.796364	254	288	0	12	34	0.3529412
NODE_93821_length_374_cov_1.796364	254	288	1	22	34	0.6470588
NODE_93852_length_374_cov_1.661818	95	157	5	62	62	1.0000000
NODE_93859_length_374_cov_1.621818	202	254	0	52	52	1.0000000
NODE_93936_length_374_cov_1.360000	211	291	7	26	80	0.3250000
NODE_93936_length_374_cov_1.360000	211	291	8	2	80	0.0250000
NODE_93936_length_374_cov_1.360000	211	291	9	10	80	0.1250000
NODE_93936_length_374_cov_1.360000	211	291	11	21	80	0.2625000
NODE_93936_length_374_cov_1.360000	211	291	13	13	80	0.1625000
NODE_93936_length_374_cov_1.360000	211	291	14	2	80	0.0250000
NODE_93936_length_374_cov_1.360000	211	291	15	6	80	0.0750000
NODE_93981_length_374_cov_1.236364	263	336	0	16	73	0.2191781
NODE_93981_length_374_cov_1.236364	263	336	2	57	73	0.7808219
NODE_94321_length_373_cov_31.302920	0	53	0	1	53	0.0188679
NODE_94321_length_373_cov_31.302920	0	53	1	3	53	0.0566038
NODE_94321_length_373_cov_31.302920	0	53	2	12	53	0.2264151
NODE_94321_length_373_cov_31.302920	0	53	3	10	53	0.1886792
NODE_94321_length_373_cov_31.302920	0	53	4	15	53	0.2830189
NODE_94321_length_373_cov_31.302920	0	53	6	12	53	0.2264151
NODE_94321_length_373_cov_31.302920	0	53	0	1	53	0.0188679
NODE_94321_length_373_cov_31.302920	0	53	1	3	53	0.0566038
NODE_94321_length_373_cov_31.302920	0	53	2	12	53	0.2264151
NODE_94321_length_373_cov_31.302920	0	53	3	10	53	0.1886792
NODE_94321_length_373_cov_31.302920	0	53	4	15	53	0.2830189
NODE_94321_length_373_cov_31.302920	0	53	6	12	53	0.2264151
NODE_94321_length_373_cov_31.302920	0	53	0	1	53	0.0188679
NODE_94321_length_373_cov_31.302920	0	53	1	3	53	0.0566038
NODE_94321_length_373_cov_31.302920	0	53	2	12	53	0.2264151
NODE_94321_length_373_cov_31.302920	0	53	3	10	53	0.1886792
NODE_94321_length_373_cov_31.302920	0	53	4	15	53	0.2830189
NODE_94321_length_373_cov_31.302920	0	53	6	12	53	0.2264151
NODE_94321_length_373_cov_31.302920	26	106	4	15	80	0.1875000
NODE_94321_length_373_cov_31.302920	26	106	6	39	80	0.4875000
NODE_94321_length_373_cov_31.302920	26	106	7	26	80	0.3250000
NODE_94340_length_373_cov_4.671533	76	142	1	66	66	1.0000000
NODE_94340_length_373_cov_4.671533	115	195	0	7	80	0.0875000
NODE_94340_length_373_cov_4.671533	115	195	1	73	80	0.9125000
NODE_94340_length_373_cov_4.671533	115	195	0	7	80	0.0875000
NODE_94340_length_373_cov_4.671533	115	195	1	73	80	0.9125000
NODE_94340_length_373_cov_4.671533	288	368	1	80	80	1.0000000
NODE_94352_length_373_cov_4.080292	109	189	0	31	80	0.3875000
NODE_94352_length_373_cov_4.080292	109	189	2	49	80	0.6125000
NODE_94352_length_373_cov_4.080292	162	220	2	58	58	1.0000000
NODE_94380_length_373_cov_3.167883	131	210	0	79	79	1.0000000
NODE_94414_length_373_cov_2.751825	80	151	0	71	71	1.0000000
NODE_94414_length_373_cov_2.751825	124	162	0	31	38	0.8157895
NODE_94414_length_373_cov_2.751825	124	162	1	7	38	0.1842105
NODE_94493_length_373_cov_2.036496	248	326	0	59	78	0.7564102
NODE_94493_length_373_cov_2.036496	248	326	2	2	78	0.0256410
NODE_94493_length_373_cov_2.036496	248	326	3	2	78	0.0256410
NODE_94493_length_373_cov_2.036496	248	326	5	15	78	0.1923077
NODE_94493_length_373_cov_2.036496	299	359	0	60	60	1.0000000
NODE_94500_length_373_cov_2.003650	150	194	0	44	44	1.0000000
NODE_94937_length_373_cov_0.759124	62	114	1	27	52	0.5192308
NODE_94937_length_373_cov_0.759124	62	114	2	25	52	0.4807692
NODE_95051_length_372_cov_30.135531	111	191	0	62	80	0.7750000
NODE_95051_length_372_cov_30.135531	111	191	1	3	80	0.0375000
NODE_95051_length_372_cov_30.135531	111	191	2	15	80	0.1875000
NODE_95051_length_372_cov_30.135531	159	222	0	14	63	0.2222222
NODE_95051_length_372_cov_30.135531	159	222	1	3	63	0.0476190
NODE_95051_length_372_cov_30.135531	159	222	2	46	63	0.7301587
NODE_95051_length_372_cov_30.135531	164	239	0	9	75	0.1200000
NODE_95051_length_372_cov_30.135531	164	239	1	3	75	0.0400000
NODE_95051_length_372_cov_30.135531	164	239	2	63	75	0.8400000
NODE_95051_length_372_cov_30.135531	182	253	2	71	71	1.0000000
NODE_95051_length_372_cov_30.135531	195	275	2	80	80	1.0000000
NODE_95051_length_372_cov_30.135531	213	276	2	63	63	1.0000000
NODE_95053_length_372_cov_9.091575	150	230	0	80	80	1.0000000
NODE_95053_length_372_cov_9.091575	203	283	0	80	80	1.0000000
NODE_95063_length_372_cov_5.706960	168	208	0	40	40	1.0000000
NODE_95067_length_372_cov_5.124542	146	211	4	17	65	0.2615385
NODE_95067_length_372_cov_5.124542	146	211	5	2	65	0.0307692
NODE_95067_length_372_cov_5.124542	146	211	6	46	65	0.7076923
NODE_95067_length_372_cov_5.124542	189	264	6	75	75	1.0000000
NODE_95090_length_372_cov_3.761905	177	221	0	44	44	1.0000000
NODE_95109_length_372_cov_3.186813	137	218	0	81	81	1.0000000
NODE_95159_length_372_cov_2.582418	167	239	17	6	72	0.0833333
NODE_95159_length_372_cov_2.582418	167	239	19	4	72	0.0555556
NODE_95159_length_372_cov_2.582418	167	239	21	1	72	0.0138889
NODE_95159_length_372_cov_2.582418	167	239	22	16	72	0.2222222
NODE_95159_length_372_cov_2.582418	167	239	23	45	72	0.6250000
NODE_95159_length_372_cov_2.582418	212	292	7	4	80	0.0500000
NODE_95159_length_372_cov_2.582418	212	292	9	4	80	0.0500000
NODE_95159_length_372_cov_2.582418	212	292	11	6	80	0.0750000
NODE_95159_length_372_cov_2.582418	212	292	12	3	80	0.0375000
NODE_95159_length_372_cov_2.582418	212	292	13	3	80	0.0375000
NODE_95159_length_372_cov_2.582418	212	292	15	2	80	0.0250000
NODE_95159_length_372_cov_2.582418	212	292	19	2	80	0.0250000
NODE_95159_length_372_cov_2.582418	212	292	21	17	80	0.2125000
NODE_95159_length_372_cov_2.582418	212	292	23	39	80	0.4875000
NODE_95183_length_372_cov_2.347985	97	141	4	44	44	1.0000000
NODE_95183_length_372_cov_2.347985	98	133	4	35	35	1.0000000
NODE_95183_length_372_cov_2.347985	178	243	2	51	65	0.7846154
NODE_95183_length_372_cov_2.347985	178	243	3	14	65	0.2153846
NODE_95303_length_372_cov_1.699634	195	276	1	2	81	0.0246914
NODE_95303_length_372_cov_1.699634	195	276	3	79	81	0.9753087
NODE_95453_length_372_cov_1.223443	264	334	2	70	70	1.0000000
NODE_95784_length_371_cov_52.040441	104	184	6	42	80	0.5250000
NODE_95784_length_371_cov_52.040441	104	184	8	8	80	0.1000000
NODE_95784_length_371_cov_52.040441	104	184	9	26	80	0.3250000
NODE_95784_length_371_cov_52.040441	104	184	11	4	80	0.0500000
NODE_95784_length_371_cov_52.040441	157	237	9	23	80	0.2875000
NODE_95784_length_371_cov_52.040441	157	237	11	5	80	0.0625000
NODE_95784_length_371_cov_52.040441	157	237	12	9	80	0.1125000
NODE_95784_length_371_cov_52.040441	157	237	13	10	80	0.1250000
NODE_95784_length_371_cov_52.040441	157	237	15	8	80	0.1000000
NODE_95784_length_371_cov_52.040441	157	237	16	10	80	0.1250000
NODE_95784_length_371_cov_52.040441	157	237	17	13	80	0.1625000
NODE_95784_length_371_cov_52.040441	157	237	18	2	80	0.0250000
NODE_95784_length_371_cov_52.040441	180	232	11	5	52	0.0961538
NODE_95784_length_371_cov_52.040441	180	232	12	9	52	0.1730769
NODE_95784_length_371_cov_52.040441	180	232	13	10	52	0.1923077
NODE_95784_length_371_cov_52.040441	180	232	15	8	52	0.1538462
NODE_95784_length_371_cov_52.040441	180	232	16	10	52	0.1923077
NODE_95784_length_371_cov_52.040441	180	232	17	10	52	0.1923077
NODE_95785_length_371_cov_24.878676	91	171	0	80	80	1.0000000
NODE_95785_length_371_cov_24.878676	144	224	0	80	80	1.0000000
NODE_95797_length_371_cov_5.738971	170	245	0	1	75	0.0133333
NODE_95797_length_371_cov_5.738971	170	245	2	74	75	0.9866667
NODE_95797_length_371_cov_5.738971	218	298	0	54	80	0.6750000
NODE_95797_length_371_cov_5.738971	218	298	2	26	80	0.3250000
NODE_95807_length_371_cov_4.452206	65	145	0	80	80	1.0000000
NODE_95807_length_371_cov_4.452206	118	198	0	80	80	1.0000000
NODE_95863_length_371_cov_2.841912	288	350	0	60	62	0.9677419
NODE_95863_length_371_cov_2.841912	288	350	5	2	62	0.0322581
NODE_96013_length_371_cov_1.790441	188	235	0	13	47	0.2765957
NODE_96013_length_371_cov_1.790441	188	235	1	34	47	0.7234042
NODE_96105_length_371_cov_1.422794	199	287	0	88	88	1.0000000
NODE_96500_length_370_cov_50.380074	144	224	0	80	80	1.0000000
NODE_96500_length_370_cov_50.380074	197	277	0	80	80	1.0000000
NODE_96504_length_370_cov_7.553506	105	162	3	57	57	1.0000000
NODE_96510_length_370_cov_5.811808	153	221	0	68	68	1.0000000
NODE_96510_length_370_cov_5.811808	206	286	0	80	80	1.0000000
NODE_96522_length_370_cov_4.915129	157	207	2	50	50	1.0000000
NODE_96528_length_370_cov_4.535055	141	221	0	80	80	1.0000000
NODE_96528_length_370_cov_4.535055	194	274	0	80	80	1.0000000
NODE_96532_length_370_cov_4.199262	230	275	1	14	45	0.3111111
NODE_96532_length_370_cov_4.199262	230	275	2	31	45	0.6888889
NODE_96533_length_370_cov_4.151292	142	209	3	67	67	1.0000000
NODE_96542_length_370_cov_3.719557	214	251	18	20	37	0.5405405
NODE_96542_length_370_cov_3.719557	214	251	20	17	37	0.4594595
NODE_96581_length_370_cov_2.822878	126	173	0	47	47	1.0000000
NODE_96668_length_370_cov_2.081181	0	52	0	12	52	0.2307692
NODE_96668_length_370_cov_2.081181	0	52	2	5	52	0.0961538
NODE_96668_length_370_cov_2.081181	0	52	5	1	52	0.0192308
NODE_96668_length_370_cov_2.081181	0	52	7	5	52	0.0961538
NODE_96668_length_370_cov_2.081181	0	52	8	3	52	0.0576923
NODE_96668_length_370_cov_2.081181	0	52	9	6	52	0.1153846
NODE_96668_length_370_cov_2.081181	0	52	10	1	52	0.0192308
NODE_96668_length_370_cov_2.081181	0	52	12	7	52	0.1346154
NODE_96668_length_370_cov_2.081181	0	52	14	4	52	0.0769231
NODE_96668_length_370_cov_2.081181	0	52	16	2	52	0.0384615
NODE_96668_length_370_cov_2.081181	0	52	17	1	52	0.0192308
NODE_96668_length_370_cov_2.081181	0	52	18	2	52	0.0384615
NODE_96668_length_370_cov_2.081181	0	52	21	3	52	0.0576923
NODE_97207_length_369_cov_36.811111	273	358	0	85	85	1.0000000
NODE_97207_length_369_cov_36.811111	273	358	0	85	85	1.0000000
NODE_97207_length_369_cov_36.811111	273	358	0	85	85	1.0000000
NODE_97211_length_369_cov_8.751852	107	187	8	36	80	0.4500000
NODE_97211_length_369_cov_8.751852	107	187	9	30	80	0.3750000
NODE_97211_length_369_cov_8.751852	107	187	10	14	80	0.1750000
NODE_97226_length_369_cov_6.677778	189	269	1	72	80	0.9000000
NODE_97226_length_369_cov_6.677778	189	269	2	8	80	0.1000000
NODE_97226_length_369_cov_6.677778	242	323	1	81	81	1.0000000
NODE_97236_length_369_cov_5.337037	199	264	2	65	65	1.0000000
NODE_97249_length_369_cov_4.459259	89	157	0	68	68	1.0000000
NODE_97249_length_369_cov_4.459259	130	210	0	80	80	1.0000000
NODE_97255_length_369_cov_4.111111	216	279	1	63	63	1.0000000
NODE_97265_length_369_cov_3.837037	205	238	4	3	33	0.0909091
NODE_97265_length_369_cov_3.837037	205	238	5	30	33	0.9090909
NODE_97265_length_369_cov_3.837037	211	291	3	30	80	0.3750000
NODE_97265_length_369_cov_3.837037	211	291	5	50	80	0.6250000
NODE_97265_length_369_cov_3.837037	287	316	0	5	29	0.1724138
NODE_97265_length_369_cov_3.837037	287	316	1	7	29	0.2413793
NODE_97265_length_369_cov_3.837037	287	316	2	1	29	0.0344828
NODE_97265_length_369_cov_3.837037	287	316	3	16	29	0.5517241
NODE_97346_length_369_cov_2.355556	62	142	1	60	80	0.7500000
NODE_97346_length_369_cov_2.355556	62	142	2	12	80	0.1500000
NODE_97346_length_369_cov_2.355556	62	142	3	8	80	0.1000000
NODE_97346_length_369_cov_2.355556	114	195	1	16	81	0.1975309
NODE_97346_length_369_cov_2.355556	114	195	2	65	81	0.8024691
NODE_97440_length_369_cov_1.803704	170	235	0	65	65	1.0000000
NODE_97936_length_368_cov_42.208178	231	311	0	4	80	0.0500000
NODE_97936_length_368_cov_42.208178	231	311	2	76	80	0.9500000
NODE_97936_length_368_cov_42.208178	284	364	0	9	80	0.1125000
NODE_97936_length_368_cov_42.208178	284	364	2	71	80	0.8875000
NODE_97939_length_368_cov_11.988848	47	127	0	80	80	1.0000000
NODE_97939_length_368_cov_11.988848	100	180	0	80	80	1.0000000
NODE_97945_length_368_cov_6.267658	133	213	0	80	80	1.0000000
NODE_97945_length_368_cov_6.267658	186	266	0	80	80	1.0000000
NODE_97997_length_368_cov_3.486989	127	207	0	80	80	1.0000000
NODE_98008_length_368_cov_3.282528	182	255	0	1	73	0.0136986
NODE_98008_length_368_cov_3.282528	182	255	2	72	73	0.9863014
NODE_98058_length_368_cov_2.605948	192	246	3	9	54	0.1666667
NODE_98058_length_368_cov_2.605948	192	246	4	6	54	0.1111111
NODE_98058_length_368_cov_2.605948	192	246	5	1	54	0.0185185
NODE_98058_length_368_cov_2.605948	192	246	7	9	54	0.1666667
NODE_98058_length_368_cov_2.605948	192	246	8	14	54	0.2592593
NODE_98058_length_368_cov_2.605948	192	246	10	1	54	0.0185185
NODE_98058_length_368_cov_2.605948	192	246	11	14	54	0.2592593
NODE_98123_length_368_cov_2.182156	85	145	1	60	60	1.0000000
NODE_98129_length_368_cov_2.137546	66	107	0	41	41	1.0000000
NODE_98157_length_368_cov_1.944238	192	272	3	2	80	0.0250000
NODE_98157_length_368_cov_1.944238	192	272	4	74	80	0.9250000
NODE_98157_length_368_cov_1.944238	192	272	6	4	80	0.0500000
NODE_98723_length_367_cov_7.156716	174	254	1	7	80	0.0875000
NODE_98723_length_367_cov_7.156716	174	254	2	73	80	0.9125000
NODE_98723_length_367_cov_7.156716	227	307	0	21	80	0.2625000
NODE_98723_length_367_cov_7.156716	227	307	1	39	80	0.4875000
NODE_98723_length_367_cov_7.156716	227	307	2	20	80	0.2500000
NODE_98734_length_367_cov_5.313433	148	206	0	7	58	0.1206897
NODE_98734_length_367_cov_5.313433	148	206	1	24	58	0.4137931
NODE_98734_length_367_cov_5.313433	148	206	3	13	58	0.2241379
NODE_98734_length_367_cov_5.313433	148	206	4	14	58	0.2413793
NODE_98737_length_367_cov_5.138060	58	138	0	80	80	1.0000000
NODE_98737_length_367_cov_5.138060	111	191	0	80	80	1.0000000
NODE_98796_length_367_cov_3.059701	110	154	3	37	44	0.8409091
NODE_98796_length_367_cov_3.059701	110	154	4	7	44	0.1590909
NODE_98796_length_367_cov_3.059701	111	146	3	35	35	1.0000000
NODE_98843_length_367_cov_2.384328	246	326	3	35	80	0.4375000
NODE_98843_length_367_cov_2.384328	246	326	5	34	80	0.4250000
NODE_98843_length_367_cov_2.384328	246	326	6	11	80	0.1375000
NODE_98843_length_367_cov_2.384328	299	367	0	5	68	0.0735294
NODE_98843_length_367_cov_2.384328	299	367	1	3	68	0.0441176
NODE_98843_length_367_cov_2.384328	299	367	2	10	68	0.1470588
NODE_98843_length_367_cov_2.384328	299	367	3	50	68	0.7352941
NODE_98849_length_367_cov_2.332090	127	207	1	3	80	0.0375000
NODE_98849_length_367_cov_2.332090	127	207	2	77	80	0.9625000
NODE_98909_length_367_cov_1.944030	91	156	0	65	65	1.0000000
NODE_98980_length_367_cov_1.679104	173	252	7	10	79	0.1265823
NODE_98980_length_367_cov_1.679104	173	252	8	34	79	0.4303797
NODE_98980_length_367_cov_1.679104	173	252	9	26	79	0.3291139
NODE_98980_length_367_cov_1.679104	173	252	11	3	79	0.0379747
NODE_98980_length_367_cov_1.679104	173	252	12	6	79	0.0759494
NODE_99005_length_367_cov_1.552239	148	200	3	4	52	0.0769231
NODE_99005_length_367_cov_1.552239	148	200	4	34	52	0.6538461
NODE_99005_length_367_cov_1.552239	148	200	5	10	52	0.1923077
NODE_99005_length_367_cov_1.552239	148	200	6	4	52	0.0769231
NODE_99138_length_367_cov_1.201493	79	159	1	6	80	0.0750000
NODE_99138_length_367_cov_1.201493	79	159	2	50	80	0.6250000
NODE_99138_length_367_cov_1.201493	79	159	4	24	80	0.3000000
NODE_99138_length_367_cov_1.201493	136	179	4	43	43	1.0000000
NODE_99318_length_367_cov_0.761194	288	357	0	69	69	1.0000000
NODE_99451_length_366_cov_5.239700	193	253	3	60	60	1.0000000
NODE_99472_length_366_cov_4.168539	302	355	0	51	53	0.9622642
NODE_99472_length_366_cov_4.168539	302	355	1	2	53	0.0377358
NODE_99478_length_366_cov_3.913858	183	229	0	46	46	1.0000000
NODE_99478_length_366_cov_3.913858	203	282	0	79	79	1.0000000
NODE_99496_length_366_cov_3.168539	88	160	0	54	72	0.7500000
NODE_99496_length_366_cov_3.168539	88	160	1	18	72	0.2500000
NODE_99496_length_366_cov_3.168539	133	193	0	9	60	0.1500000
NODE_99496_length_366_cov_3.168539	133	193	1	51	60	0.8500000
NODE_100137_length_365_cov_140.101504	40	107	125	1	67	0.0149254
NODE_100137_length_365_cov_140.101504	40	107	128	2	67	0.0298507
NODE_100137_length_365_cov_140.101504	40	107	129	1	67	0.0149254
NODE_100137_length_365_cov_140.101504	40	107	130	1	67	0.0149254
NODE_100137_length_365_cov_140.101504	40	107	135	1	67	0.0149254
NODE_100137_length_365_cov_140.101504	40	107	138	1	67	0.0149254
NODE_100137_length_365_cov_140.101504	40	107	141	2	67	0.0298507
NODE_100137_length_365_cov_140.101504	40	107	147	3	67	0.0447761
NODE_100137_length_365_cov_140.101504	40	107	149	1	67	0.0149254
NODE_100137_length_365_cov_140.101504	40	107	153	1	67	0.0149254
NODE_100137_length_365_cov_140.101504	40	107	155	1	67	0.0149254
NODE_100137_length_365_cov_140.101504	40	107	156	1	67	0.0149254
NODE_100137_length_365_cov_140.101504	40	107	161	2	67	0.0298507
NODE_100137_length_365_cov_140.101504	40	107	162	1	67	0.0149254
NODE_100137_length_365_cov_140.101504	40	107	168	1	67	0.0149254
NODE_100137_length_365_cov_140.101504	40	107	173	2	67	0.0298507
NODE_100137_length_365_cov_140.101504	40	107	174	1	67	0.0149254
NODE_100137_length_365_cov_140.101504	40	107	175	1	67	0.0149254
NODE_100137_length_365_cov_140.101504	40	107	176	1	67	0.0149254
NODE_100137_length_365_cov_140.101504	40	107	179	1	67	0.0149254
NODE_100137_length_365_cov_140.101504	40	107	181	1	67	0.0149254
NODE_100137_length_365_cov_140.101504	40	107	183	1	67	0.0149254
NODE_100137_length_365_cov_140.101504	40	107	186	1	67	0.0149254
NODE_100137_length_365_cov_140.101504	40	107	188	1	67	0.0149254
NODE_100137_length_365_cov_140.101504	40	107	190	2	67	0.0298507
NODE_100137_length_365_cov_140.101504	40	107	191	1	67	0.0149254
NODE_100137_length_365_cov_140.101504	40	107	192	1	67	0.0149254
NODE_100137_length_365_cov_140.101504	40	107	194	1	67	0.0149254
NODE_100137_length_365_cov_140.101504	40	107	195	2	67	0.0298507
NODE_100137_length_365_cov_140.101504	40	107	196	1	67	0.0149254
NODE_100137_length_365_cov_140.101504	40	107	197	3	67	0.0447761
NODE_100137_length_365_cov_140.101504	40	107	199	3	67	0.0447761
NODE_100137_length_365_cov_140.101504	40	107	200	2	67	0.0298507
NODE_100137_length_365_cov_140.101504	40	107	203	1	67	0.0149254
NODE_100137_length_365_cov_140.101504	40	107	210	1	67	0.0149254
NODE_100137_length_365_cov_140.101504	40	107	211	2	67	0.0298507
NODE_100137_length_365_cov_140.101504	40	107	215	2	67	0.0298507
NODE_100137_length_365_cov_140.101504	40	107	218	3	67	0.0447761
NODE_100137_length_365_cov_140.101504	40	107	233	1	67	0.0149254
NODE_100137_length_365_cov_140.101504	40	107	234	2	67	0.0298507
NODE_100137_length_365_cov_140.101504	40	107	237	2	67	0.0298507
NODE_100137_length_365_cov_140.101504	40	107	241	4	67	0.0597015
NODE_100137_length_365_cov_140.101504	40	107	245	3	67	0.0447761
NODE_100138_length_365_cov_45.815789	0	38	0	38	38	1.0000000
NODE_100138_length_365_cov_45.815789	11	91	0	80	80	1.0000000
NODE_100140_length_365_cov_8.169173	191	244	2	53	53	1.0000000
NODE_100140_length_365_cov_8.169173	217	297	0	16	80	0.2000000
NODE_100140_length_365_cov_8.169173	217	297	2	64	80	0.8000000
NODE_100145_length_365_cov_5.954887	136	216	1	28	80	0.3500000
NODE_100145_length_365_cov_5.954887	136	216	2	29	80	0.3625000
NODE_100145_length_365_cov_5.954887	136	216	3	23	80	0.2875000
NODE_100145_length_365_cov_5.954887	189	269	2	14	80	0.1750000
NODE_100145_length_365_cov_5.954887	189	269	3	66	80	0.8250000
NODE_100147_length_365_cov_5.721805	37	78	1	41	41	1.0000000
NODE_100168_length_365_cov_4.195489	269	329	2	45	60	0.7500000
NODE_100168_length_365_cov_4.195489	269	329	4	15	60	0.2500000
NODE_100172_length_365_cov_4.071429	106	186	1	15	80	0.1875000
NODE_100172_length_365_cov_4.071429	106	186	2	65	80	0.8125000
NODE_100172_length_365_cov_4.071429	159	239	0	2	80	0.0250000
NODE_100172_length_365_cov_4.071429	159	239	1	66	80	0.8250000
NODE_100172_length_365_cov_4.071429	159	239	2	12	80	0.1500000
NODE_100180_length_365_cov_3.879699	131	187	4	56	56	1.0000000
NODE_100206_length_365_cov_3.270677	211	280	2	27	69	0.3913043
NODE_100206_length_365_cov_3.270677	211	280	4	8	69	0.1159420
NODE_100206_length_365_cov_3.270677	211	280	6	34	69	0.4927536
NODE_100253_length_365_cov_2.601504	189	265	4	62	76	0.8157895
NODE_100253_length_365_cov_2.601504	189	265	5	14	76	0.1842105
NODE_100293_length_365_cov_2.289474	169	249	2	15	80	0.1875000
NODE_100293_length_365_cov_2.289474	169	249	3	9	80	0.1125000
NODE_100293_length_365_cov_2.289474	169	249	4	14	80	0.1750000
NODE_100293_length_365_cov_2.289474	169	249	6	2	80	0.0250000
NODE_100293_length_365_cov_2.289474	169	249	7	40	80	0.5000000
NODE_100407_length_365_cov_1.635338	156	235	0	25	79	0.3164557
NODE_100407_length_365_cov_1.635338	156	235	2	16	79	0.2025317
NODE_100407_length_365_cov_1.635338	156	235	3	10	79	0.1265823
NODE_100407_length_365_cov_1.635338	156	235	4	27	79	0.3417721
NODE_100407_length_365_cov_1.635338	156	235	5	1	79	0.0126582
NODE_100485_length_365_cov_1.421053	228	309	0	81	81	1.0000000
NODE_100570_length_365_cov_1.169173	57	137	0	16	80	0.2000000
NODE_100570_length_365_cov_1.169173	57	137	1	57	80	0.7125000
NODE_100570_length_365_cov_1.169173	57	137	2	7	80	0.0875000
NODE_100570_length_365_cov_1.169173	65	145	0	8	80	0.1000000
NODE_100570_length_365_cov_1.169173	65	145	1	57	80	0.7125000
NODE_100570_length_365_cov_1.169173	65	145	2	15	80	0.1875000
NODE_100570_length_365_cov_1.169173	194	274	5	3	80	0.0375000
NODE_100570_length_365_cov_1.169173	194	274	6	5	80	0.0625000
NODE_100570_length_365_cov_1.169173	194	274	8	4	80	0.0500000
NODE_100570_length_365_cov_1.169173	194	274	11	9	80	0.1125000
NODE_100570_length_365_cov_1.169173	194	274	12	11	80	0.1375000
NODE_100570_length_365_cov_1.169173	194	274	13	37	80	0.4625000
NODE_100570_length_365_cov_1.169173	194	274	15	11	80	0.1375000
NODE_100893_length_364_cov_24.600000	101	181	0	80	80	1.0000000
NODE_100893_length_364_cov_24.600000	154	234	0	80	80	1.0000000
NODE_100896_length_364_cov_7.377358	0	50	0	50	50	1.0000000
NODE_100933_length_364_cov_3.988679	122	168	0	46	46	1.0000000
NODE_100935_length_364_cov_3.913208	151	208	1	36	57	0.6315789
NODE_100935_length_364_cov_3.913208	151	208	3	8	57	0.1403509
NODE_100935_length_364_cov_3.913208	151	208	4	13	57	0.2280702
NODE_100959_length_364_cov_3.305660	296	358	0	62	62	1.0000000
NODE_100966_length_364_cov_3.181132	78	138	0	18	60	0.3000000
NODE_100966_length_364_cov_3.181132	78	138	1	42	60	0.7000000
NODE_100975_length_364_cov_3.041509	264	321	0	57	57	1.0000000
NODE_100975_length_364_cov_3.041509	294	359	0	65	65	1.0000000
NODE_100978_length_364_cov_3.015094	238	274	2	36	36	1.0000000
NODE_101087_length_364_cov_1.977358	126	201	3	46	75	0.6133333
NODE_101087_length_364_cov_1.977358	126	201	5	29	75	0.3866667
NODE_101141_length_364_cov_1.811321	209	256	0	47	47	1.0000000
NODE_101148_length_364_cov_1.781132	130	203	2	4	73	0.0547945
NODE_101148_length_364_cov_1.781132	130	203	7	6	73	0.0821918
NODE_101148_length_364_cov_1.781132	130	203	8	21	73	0.2876712
NODE_101148_length_364_cov_1.781132	130	203	9	10	73	0.1369863
NODE_101148_length_364_cov_1.781132	130	203	10	11	73	0.1506849
NODE_101148_length_364_cov_1.781132	130	203	11	21	73	0.2876712
NODE_101148_length_364_cov_1.781132	183	203	2	4	20	0.2000000
NODE_101148_length_364_cov_1.781132	183	203	7	2	20	0.1000000
NODE_101148_length_364_cov_1.781132	183	203	8	14	20	0.7000000
NODE_101720_length_363_cov_7.791667	121	200	2	59	79	0.7468355
NODE_101720_length_363_cov_7.791667	121	200	3	20	79	0.2531646
NODE_101725_length_363_cov_6.484848	33	90	11	57	57	1.0000000
NODE_101725_length_363_cov_6.484848	93	146	10	9	53	0.1698113
NODE_101725_length_363_cov_6.484848	93	146	11	44	53	0.8301887
NODE_101734_length_363_cov_4.825758	154	215	2	6	61	0.0983607
NODE_101734_length_363_cov_4.825758	154	215	4	55	61	0.9016393
NODE_101760_length_363_cov_3.950758	112	183	2	71	71	1.0000000
NODE_101760_length_363_cov_3.950758	156	236	0	11	80	0.1375000
NODE_101760_length_363_cov_3.950758	156	236	1	13	80	0.1625000
NODE_101760_length_363_cov_3.950758	156	236	2	56	80	0.7000000
NODE_101769_length_363_cov_3.617424	16	79	0	63	63	1.0000000
NODE_101774_length_363_cov_3.409091	241	267	0	26	26	1.0000000
NODE_101791_length_363_cov_3.087121	228	308	1	16	80	0.2000000
NODE_101791_length_363_cov_3.087121	228	308	2	54	80	0.6750000
NODE_101791_length_363_cov_3.087121	228	308	3	10	80	0.1250000
NODE_101809_length_363_cov_2.795455	240	320	3	1	80	0.0125000
NODE_101809_length_363_cov_2.795455	240	320	5	1	80	0.0125000
NODE_101809_length_363_cov_2.795455	240	320	6	2	80	0.0250000
NODE_101809_length_363_cov_2.795455	240	320	7	1	80	0.0125000
NODE_101809_length_363_cov_2.795455	240	320	8	2	80	0.0250000
NODE_101809_length_363_cov_2.795455	240	320	9	7	80	0.0875000
NODE_101809_length_363_cov_2.795455	240	320	10	5	80	0.0625000
NODE_101809_length_363_cov_2.795455	240	320	11	3	80	0.0375000
NODE_101809_length_363_cov_2.795455	240	320	14	2	80	0.0250000
NODE_101809_length_363_cov_2.795455	240	320	15	8	80	0.1000000
NODE_101809_length_363_cov_2.795455	240	320	16	4	80	0.0500000
NODE_101809_length_363_cov_2.795455	240	320	17	2	80	0.0250000
NODE_101809_length_363_cov_2.795455	240	320	18	5	80	0.0625000
NODE_101809_length_363_cov_2.795455	240	320	19	5	80	0.0625000
NODE_101809_length_363_cov_2.795455	240	320	20	22	80	0.2750000
NODE_101809_length_363_cov_2.795455	240	320	21	1	80	0.0125000
NODE_101809_length_363_cov_2.795455	240	320	22	1	80	0.0125000
NODE_101809_length_363_cov_2.795455	240	320	24	6	80	0.0750000
NODE_101809_length_363_cov_2.795455	240	320	25	1	80	0.0125000
NODE_101809_length_363_cov_2.795455	240	320	26	1	80	0.0125000
NODE_101822_length_363_cov_2.481061	86	166	0	80	80	1.0000000
NODE_101822_length_363_cov_2.481061	139	219	0	80	80	1.0000000
NODE_101879_length_363_cov_2.034091	46	126	0	80	80	1.0000000
NODE_101879_length_363_cov_2.034091	99	153	0	54	54	1.0000000
NODE_101992_length_363_cov_1.541667	235	315	0	54	80	0.6750000
NODE_101992_length_363_cov_1.541667	235	315	2	16	80	0.2000000
NODE_101992_length_363_cov_1.541667	235	315	3	7	80	0.0875000
NODE_101992_length_363_cov_1.541667	235	315	4	3	80	0.0375000
NODE_102022_length_363_cov_1.477273	141	202	0	61	61	1.0000000
NODE_102022_length_363_cov_1.477273	153	210	0	57	57	1.0000000
NODE_102187_length_363_cov_1.113636	245	316	0	71	71	1.0000000
NODE_102464_length_362_cov_54.927757	52	116	0	64	64	1.0000000
NODE_102465_length_362_cov_29.273764	86	166	0	80	80	1.0000000
NODE_102465_length_362_cov_29.273764	139	219	0	80	80	1.0000000
NODE_102467_length_362_cov_14.847909	130	210	0	32	80	0.4000000
NODE_102467_length_362_cov_14.847909	130	210	1	22	80	0.2750000
NODE_102467_length_362_cov_14.847909	130	210	2	26	80	0.3250000
NODE_102467_length_362_cov_14.847909	183	263	1	1	80	0.0125000
NODE_102467_length_362_cov_14.847909	183	263	2	79	80	0.9875000
NODE_102633_length_362_cov_2.159696	133	216	0	83	83	1.0000000
NODE_103259_length_361_cov_4.641221	249	312	2	22	63	0.3492064
NODE_103259_length_361_cov_4.641221	249	312	4	6	63	0.0952381
NODE_103259_length_361_cov_4.641221	249	312	5	7	63	0.1111111
NODE_103259_length_361_cov_4.641221	249	312	6	1	63	0.0158730
NODE_103259_length_361_cov_4.641221	249	312	7	11	63	0.1746032
NODE_103259_length_361_cov_4.641221	249	312	8	16	63	0.2539683
NODE_103280_length_361_cov_3.717557	185	265	5	4	80	0.0500000
NODE_103280_length_361_cov_3.717557	185	265	7	28	80	0.3500000
NODE_103280_length_361_cov_3.717557	185	265	8	45	80	0.5625000
NODE_103280_length_361_cov_3.717557	185	265	9	3	80	0.0375000
NODE_103280_length_361_cov_3.717557	238	265	5	4	27	0.1481481
NODE_103280_length_361_cov_3.717557	238	265	7	20	27	0.7407407
NODE_103280_length_361_cov_3.717557	238	265	8	3	27	0.1111111
NODE_103314_length_361_cov_2.988550	121	201	2	80	80	1.0000000
NODE_103314_length_361_cov_2.988550	174	216	2	42	42	1.0000000
NODE_103338_length_361_cov_2.641221	4	33	0	29	29	1.0000000
NODE_103338_length_361_cov_2.641221	101	182	0	81	81	1.0000000
NODE_103391_length_361_cov_2.137405	138	194	0	56	56	1.0000000
NODE_103396_length_361_cov_2.106870	192	256	0	64	64	1.0000000
NODE_103418_length_361_cov_1.969466	137	198	0	61	61	1.0000000
NODE_103632_length_361_cov_1.343511	171	250	0	54	79	0.6835443
NODE_103632_length_361_cov_1.343511	171	250	1	25	79	0.3164557
NODE_103802_length_361_cov_1.000000	60	123	1	63	63	1.0000000
NODE_104057_length_360_cov_8.191571	171	242	0	14	71	0.1971831
NODE_104057_length_360_cov_8.191571	171	242	2	57	71	0.8028169
NODE_104057_length_360_cov_8.191571	176	242	0	9	66	0.1363636
NODE_104057_length_360_cov_8.191571	176	242	2	57	66	0.8636364
NODE_104057_length_360_cov_8.191571	215	279	0	6	64	0.0937500
NODE_104057_length_360_cov_8.191571	215	279	2	58	64	0.9062500
NODE_104057_length_360_cov_8.191571	215	279	0	6	64	0.0937500
NODE_104057_length_360_cov_8.191571	215	279	2	58	64	0.9062500
NODE_104079_length_360_cov_5.003831	86	166	2	80	80	1.0000000
NODE_104091_length_360_cov_4.111111	158	238	18	2	80	0.0250000
NODE_104091_length_360_cov_4.111111	158	238	22	5	80	0.0625000
NODE_104091_length_360_cov_4.111111	158	238	23	13	80	0.1625000
NODE_104091_length_360_cov_4.111111	158	238	25	60	80	0.7500000
NODE_104102_length_360_cov_3.613027	123	203	0	24	80	0.3000000
NODE_104102_length_360_cov_3.613027	123	203	1	56	80	0.7000000
NODE_104102_length_360_cov_3.613027	176	256	0	77	80	0.9625000
NODE_104102_length_360_cov_3.613027	176	256	1	3	80	0.0375000
NODE_104129_length_360_cov_3.080460	48	70	0	22	22	1.0000000
NODE_104162_length_360_cov_2.689655	118	198	1	3	80	0.0375000
NODE_104162_length_360_cov_2.689655	118	198	2	1	80	0.0125000
NODE_104162_length_360_cov_2.689655	118	198	3	7	80	0.0875000
NODE_104162_length_360_cov_2.689655	118	198	5	23	80	0.2875000
NODE_104162_length_360_cov_2.689655	118	198	6	46	80	0.5750000
NODE_104261_length_360_cov_1.977011	235	286	6	11	51	0.2156863
NODE_104261_length_360_cov_1.977011	235	286	7	22	51	0.4313726
NODE_104261_length_360_cov_1.977011	235	286	8	4	51	0.0784314
NODE_104261_length_360_cov_1.977011	235	286	9	14	51	0.2745098
NODE_104572_length_360_cov_1.149425	273	353	0	64	80	0.8000000
NODE_104572_length_360_cov_1.149425	273	353	2	5	80	0.0625000
NODE_104572_length_360_cov_1.149425	273	353	4	11	80	0.1375000
NODE_104669_length_360_cov_0.965517	119	175	0	56	56	1.0000000
NODE_104671_length_360_cov_0.957854	140	186	0	46	46	1.0000000
NODE_104858_length_359_cov_45.519231	140	220	2	24	80	0.3000000
NODE_104858_length_359_cov_45.519231	140	220	3	30	80	0.3750000
NODE_104858_length_359_cov_45.519231	140	220	4	26	80	0.3250000
NODE_104858_length_359_cov_45.519231	193	273	2	8	80	0.1000000
NODE_104858_length_359_cov_45.519231	193	273	3	16	80	0.2000000
NODE_104858_length_359_cov_45.519231	193	273	4	56	80	0.7000000
NODE_104932_length_359_cov_3.296154	67	147	6	46	80	0.5750000
NODE_104932_length_359_cov_3.296154	67	147	8	34	80	0.4250000
NODE_104932_length_359_cov_3.296154	120	177	6	57	57	1.0000000
NODE_104932_length_359_cov_3.296154	201	256	0	42	55	0.7636364
NODE_104932_length_359_cov_3.296154	201	256	1	13	55	0.2363636
NODE_104936_length_359_cov_3.276923	5	95	0	90	90	1.0000000
NODE_104954_length_359_cov_3.007692	156	212	1	33	56	0.5892857
NODE_104954_length_359_cov_3.007692	156	212	2	2	56	0.0357143
NODE_104954_length_359_cov_3.007692	156	212	3	21	56	0.3750000
NODE_104998_length_359_cov_2.523077	148	228	1	4	80	0.0500000
NODE_104998_length_359_cov_2.523077	148	228	2	25	80	0.3125000
NODE_104998_length_359_cov_2.523077	148	228	3	51	80	0.6375000
NODE_104998_length_359_cov_2.523077	201	278	0	30	77	0.3896104
NODE_104998_length_359_cov_2.523077	201	278	1	12	77	0.1558442
NODE_104998_length_359_cov_2.523077	201	278	3	35	77	0.4545455
NODE_105002_length_359_cov_2.419231	106	186	9	9	80	0.1125000
NODE_105002_length_359_cov_2.419231	106	186	10	14	80	0.1750000
NODE_105002_length_359_cov_2.419231	106	186	11	32	80	0.4000000
NODE_105002_length_359_cov_2.419231	106	186	12	25	80	0.3125000
NODE_105002_length_359_cov_2.419231	159	211	5	4	52	0.0769231
NODE_105002_length_359_cov_2.419231	159	211	8	2	52	0.0384615
NODE_105002_length_359_cov_2.419231	159	211	9	10	52	0.1923077
NODE_105002_length_359_cov_2.419231	159	211	10	23	52	0.4423077
NODE_105002_length_359_cov_2.419231	159	211	12	13	52	0.2500000
NODE_105006_length_359_cov_2.353846	172	243	0	71	71	1.0000000
NODE_105006_length_359_cov_2.353846	216	296	0	80	80	1.0000000
NODE_105026_length_359_cov_2.257692	211	270	0	2	59	0.0338983
NODE_105026_length_359_cov_2.257692	211	270	1	19	59	0.3220339
NODE_105026_length_359_cov_2.257692	211	270	3	38	59	0.6440678
NODE_105063_length_359_cov_2.003846	8	88	0	80	80	1.0000000
NODE_105063_length_359_cov_2.003846	61	139	0	78	78	1.0000000
NODE_105106_length_359_cov_1.815385	126	207	0	81	81	1.0000000
NODE_105106_length_359_cov_1.815385	180	227	0	47	47	1.0000000
NODE_105142_length_359_cov_1.692308	88	116	0	28	28	1.0000000
NODE_105373_length_359_cov_1.096154	64	89	0	25	25	1.0000000
NODE_105599_length_359_cov_0.711538	222	248	1	2	26	0.0769231
NODE_105599_length_359_cov_0.711538	222	248	2	24	26	0.9230769
NODE_105600_length_359_cov_0.707692	10	90	0	80	80	1.0000000
NODE_105600_length_359_cov_0.707692	10	90	0	80	80	1.0000000
NODE_105600_length_359_cov_0.707692	63	143	0	80	80	1.0000000
NODE_105678_length_358_cov_19.760618	213	293	2	80	80	1.0000000
NODE_105678_length_358_cov_19.760618	266	346	0	22	80	0.2750000
NODE_105678_length_358_cov_19.760618	266	346	2	58	80	0.7250000
NODE_105679_length_358_cov_18.455598	303	358	2	25	55	0.4545455
NODE_105679_length_358_cov_18.455598	303	358	3	30	55	0.5454546
NODE_105680_length_358_cov_17.023166	0	63	0	63	63	1.0000000
NODE_105680_length_358_cov_17.023166	0	63	0	63	63	1.0000000
NODE_105680_length_358_cov_17.023166	0	63	0	63	63	1.0000000
NODE_105680_length_358_cov_17.023166	36	116	0	80	80	1.0000000
NODE_105680_length_358_cov_17.023166	53	115	0	62	62	1.0000000
NODE_105686_length_358_cov_6.509653	109	155	0	46	46	1.0000000
NODE_105710_length_358_cov_4.239382	114	143	6	24	29	0.8275862
NODE_105710_length_358_cov_4.239382	114	143	8	5	29	0.1724138
NODE_105710_length_358_cov_4.239382	180	245	6	11	65	0.1692308
NODE_105710_length_358_cov_4.239382	180	245	7	9	65	0.1384615
NODE_105710_length_358_cov_4.239382	180	245	8	11	65	0.1692308
NODE_105710_length_358_cov_4.239382	180	245	9	21	65	0.3230769
NODE_105710_length_358_cov_4.239382	180	245	11	13	65	0.2000000
NODE_105710_length_358_cov_4.239382	218	298	5	49	80	0.6125000
NODE_105710_length_358_cov_4.239382	218	298	6	15	80	0.1875000
NODE_105710_length_358_cov_4.239382	218	298	7	9	80	0.1125000
NODE_105710_length_358_cov_4.239382	218	298	8	1	80	0.0125000
NODE_105710_length_358_cov_4.239382	218	298	9	6	80	0.0750000
NODE_105846_length_358_cov_2.162162	229	305	2	36	76	0.4736842
NODE_105846_length_358_cov_2.162162	229	305	4	27	76	0.3552631
NODE_105846_length_358_cov_2.162162	229	305	6	1	76	0.0131579
NODE_105846_length_358_cov_2.162162	229	305	7	12	76	0.1578947
NODE_105902_length_358_cov_1.926641	290	358	2	68	68	1.0000000
NODE_105910_length_358_cov_1.884170	250	317	0	67	67	1.0000000
NODE_105923_length_358_cov_1.841699	189	269	4	2	80	0.0250000
NODE_105923_length_358_cov_1.841699	189	269	5	6	80	0.0750000
NODE_105923_length_358_cov_1.841699	189	269	6	1	80	0.0125000
NODE_105923_length_358_cov_1.841699	189	269	7	6	80	0.0750000
NODE_105923_length_358_cov_1.841699	189	269	8	65	80	0.8125000
NODE_106096_length_358_cov_1.235521	99	179	13	6	80	0.0750000
NODE_106096_length_358_cov_1.235521	99	179	14	6	80	0.0750000
NODE_106096_length_358_cov_1.235521	99	179	15	2	80	0.0250000
NODE_106096_length_358_cov_1.235521	99	179	16	17	80	0.2125000
NODE_106096_length_358_cov_1.235521	99	179	17	28	80	0.3500000
NODE_106096_length_358_cov_1.235521	99	179	19	10	80	0.1250000
NODE_106096_length_358_cov_1.235521	99	179	20	2	80	0.0250000
NODE_106096_length_358_cov_1.235521	99	179	21	9	80	0.1125000
NODE_106096_length_358_cov_1.235521	152	222	6	15	70	0.2142857
NODE_106096_length_358_cov_1.235521	152	222	8	9	70	0.1285714
NODE_106096_length_358_cov_1.235521	152	222	9	3	70	0.0428571
NODE_106096_length_358_cov_1.235521	152	222	10	1	70	0.0142857
NODE_106096_length_358_cov_1.235521	152	222	11	11	70	0.1571429
NODE_106096_length_358_cov_1.235521	152	222	12	2	70	0.0285714
NODE_106096_length_358_cov_1.235521	152	222	13	8	70	0.1142857
NODE_106096_length_358_cov_1.235521	152	222	14	6	70	0.0857143
NODE_106096_length_358_cov_1.235521	152	222	15	2	70	0.0285714
NODE_106096_length_358_cov_1.235521	152	222	16	6	70	0.0857143
NODE_106096_length_358_cov_1.235521	152	222	17	7	70	0.1000000
NODE_106189_length_358_cov_1.096525	148	228	0	80	80	1.0000000
NODE_106233_length_358_cov_0.984556	193	265	0	72	72	1.0000000
NODE_106489_length_357_cov_381.833333	244	324	27	3	80	0.0375000
NODE_106489_length_357_cov_381.833333	244	324	28	1	80	0.0125000
NODE_106489_length_357_cov_381.833333	244	324	29	2	80	0.0250000
NODE_106489_length_357_cov_381.833333	244	324	31	4	80	0.0500000
NODE_106489_length_357_cov_381.833333	244	324	33	1	80	0.0125000
NODE_106489_length_357_cov_381.833333	244	324	34	6	80	0.0750000
NODE_106489_length_357_cov_381.833333	244	324	35	12	80	0.1500000
NODE_106489_length_357_cov_381.833333	244	324	36	51	80	0.6375000
NODE_106493_length_357_cov_7.643411	45	125	0	14	80	0.1750000
NODE_106493_length_357_cov_7.643411	45	125	2	66	80	0.8250000
NODE_106493_length_357_cov_7.643411	98	178	0	45	80	0.5625000
NODE_106493_length_357_cov_7.643411	98	178	2	35	80	0.4375000
NODE_106495_length_357_cov_7.027132	157	237	0	10	80	0.1250000
NODE_106495_length_357_cov_7.027132	157	237	2	45	80	0.5625000
NODE_106495_length_357_cov_7.027132	157	237	4	25	80	0.3125000
NODE_106495_length_357_cov_7.027132	210	252	2	2	42	0.0476190
NODE_106495_length_357_cov_7.027132	210	252	4	40	42	0.9523810
NODE_106496_length_357_cov_6.732558	183	263	2	28	80	0.3500000
NODE_106496_length_357_cov_6.732558	183	263	3	52	80	0.6500000
NODE_106529_length_357_cov_4.081395	145	225	0	45	80	0.5625000
NODE_106529_length_357_cov_4.081395	145	225	1	27	80	0.3375000
NODE_106529_length_357_cov_4.081395	145	225	3	8	80	0.1000000
NODE_106529_length_357_cov_4.081395	198	271	1	19	73	0.2602740
NODE_106529_length_357_cov_4.081395	198	271	3	54	73	0.7397260
NODE_106542_length_357_cov_3.724806	192	265	0	73	73	1.0000000
NODE_106558_length_357_cov_3.341085	205	285	0	80	80	1.0000000
NODE_106558_length_357_cov_3.341085	258	338	0	80	80	1.0000000
NODE_106625_length_357_cov_2.414729	245	302	0	57	57	1.0000000
NODE_106625_length_357_cov_2.414729	275	355	0	80	80	1.0000000
NODE_106661_length_357_cov_2.174419	250	330	0	80	80	1.0000000
NODE_106666_length_357_cov_2.166667	103	133	0	30	30	1.0000000
NODE_106666_length_357_cov_2.166667	112	133	0	21	21	1.0000000
NODE_106702_length_357_cov_1.961240	150	169	0	19	19	1.0000000
NODE_106708_length_357_cov_1.918605	173	253	1	13	80	0.1625000
NODE_106708_length_357_cov_1.918605	173	253	3	6	80	0.0750000
NODE_106708_length_357_cov_1.918605	173	253	5	17	80	0.2125000
NODE_106708_length_357_cov_1.918605	173	253	6	4	80	0.0500000
NODE_106708_length_357_cov_1.918605	173	253	7	2	80	0.0250000
NODE_106708_length_357_cov_1.918605	173	253	8	9	80	0.1125000
NODE_106708_length_357_cov_1.918605	173	253	12	12	80	0.1500000
NODE_106708_length_357_cov_1.918605	173	253	13	14	80	0.1750000
NODE_106708_length_357_cov_1.918605	173	253	14	3	80	0.0375000
NODE_106737_length_357_cov_1.782946	73	142	0	15	69	0.2173913
NODE_106737_length_357_cov_1.782946	73	142	1	4	69	0.0579710
NODE_106737_length_357_cov_1.782946	73	142	2	17	69	0.2463768
NODE_106737_length_357_cov_1.782946	73	142	4	33	69	0.4782609
NODE_106737_length_357_cov_1.782946	115	195	4	80	80	1.0000000
NODE_107002_length_357_cov_1.127907	98	129	8	9	31	0.2903226
NODE_107002_length_357_cov_1.127907	98	129	10	22	31	0.7096774
NODE_107306_length_356_cov_5.299611	140	200	2	60	60	1.0000000
NODE_107347_length_356_cov_3.400778	255	317	3	30	62	0.4838710
NODE_107347_length_356_cov_3.400778	255	317	4	1	62	0.0161290
NODE_107347_length_356_cov_3.400778	255	317	5	31	62	0.5000000
NODE_107347_length_356_cov_3.400778	308	353	1	1	45	0.0222222
NODE_107347_length_356_cov_3.400778	308	353	2	2	45	0.0444444
NODE_107347_length_356_cov_3.400778	308	353	4	4	45	0.0888889
NODE_107347_length_356_cov_3.400778	308	353	5	38	45	0.8444445
NODE_107402_length_356_cov_2.657588	256	298	27	10	42	0.2380952
NODE_107402_length_356_cov_2.657588	256	298	29	3	42	0.0714286
NODE_107402_length_356_cov_2.657588	256	298	31	2	42	0.0476190
NODE_107402_length_356_cov_2.657588	256	298	32	8	42	0.1904762
NODE_107402_length_356_cov_2.657588	256	298	34	19	42	0.4523810
NODE_107402_length_356_cov_2.657588	265	338	19	6	73	0.0821918
NODE_107402_length_356_cov_2.657588	265	338	20	8	73	0.1095890
NODE_107402_length_356_cov_2.657588	265	338	21	1	73	0.0136986
NODE_107402_length_356_cov_2.657588	265	338	23	9	73	0.1232877
NODE_107402_length_356_cov_2.657588	265	338	24	7	73	0.0958904
NODE_107402_length_356_cov_2.657588	265	338	26	8	73	0.1095890
NODE_107402_length_356_cov_2.657588	265	338	27	11	73	0.1506849
NODE_107402_length_356_cov_2.657588	265	338	29	3	73	0.0410959
NODE_107402_length_356_cov_2.657588	265	338	31	2	73	0.0273973
NODE_107402_length_356_cov_2.657588	265	338	32	8	73	0.1095890
NODE_107402_length_356_cov_2.657588	265	338	34	10	73	0.1369863
NODE_107402_length_356_cov_2.657588	299	351	13	2	52	0.0384615
NODE_107402_length_356_cov_2.657588	299	351	16	3	52	0.0576923
NODE_107402_length_356_cov_2.657588	299	351	17	4	52	0.0769231
NODE_107402_length_356_cov_2.657588	299	351	19	10	52	0.1923077
NODE_107402_length_356_cov_2.657588	299	351	20	8	52	0.1538462
NODE_107402_length_356_cov_2.657588	299	351	21	1	52	0.0192308
NODE_107402_length_356_cov_2.657588	299	351	23	9	52	0.1730769
NODE_107402_length_356_cov_2.657588	299	351	24	7	52	0.1346154
NODE_107402_length_356_cov_2.657588	299	351	26	8	52	0.1538462
NODE_107452_length_356_cov_2.237354	90	135	0	45	45	1.0000000
NODE_107475_length_356_cov_1.996109	127	194	1	31	67	0.4626866
NODE_107475_length_356_cov_1.996109	127	194	2	36	67	0.5373135
NODE_107521_length_356_cov_1.813230	296	341	0	45	45	1.0000000
NODE_107606_length_356_cov_1.560311	192	272	0	80	80	1.0000000
NODE_107606_length_356_cov_1.560311	245	319	0	74	74	1.0000000
NODE_108122_length_355_cov_6.796875	127	173	0	46	46	1.0000000
NODE_108210_length_355_cov_2.734375	111	162	0	49	51	0.9607843
NODE_108210_length_355_cov_2.734375	111	162	2	2	51	0.0392157
NODE_108210_length_355_cov_2.734375	142	222	0	80	80	1.0000000
NODE_108215_length_355_cov_2.707031	277	314	0	37	37	1.0000000
NODE_108215_length_355_cov_2.707031	287	353	0	66	66	1.0000000
NODE_108239_length_355_cov_2.500000	38	82	0	1	44	0.0227273
NODE_108239_length_355_cov_2.500000	38	82	1	1	44	0.0227273
NODE_108239_length_355_cov_2.500000	38	82	2	11	44	0.2500000
NODE_108239_length_355_cov_2.500000	38	82	3	6	44	0.1363636
NODE_108239_length_355_cov_2.500000	38	82	5	8	44	0.1818182
NODE_108239_length_355_cov_2.500000	38	82	6	17	44	0.3863636
NODE_108278_length_355_cov_2.207031	258	308	0	50	50	1.0000000
NODE_108284_length_355_cov_2.179688	153	233	2	11	80	0.1375000
NODE_108284_length_355_cov_2.179688	153	233	3	1	80	0.0125000
NODE_108284_length_355_cov_2.179688	153	233	4	68	80	0.8500000
NODE_108284_length_355_cov_2.179688	206	286	2	37	80	0.4625000
NODE_108284_length_355_cov_2.179688	206	286	4	43	80	0.5375000
NODE_108291_length_355_cov_2.132812	261	334	0	73	73	1.0000000
NODE_108291_length_355_cov_2.132812	301	342	0	41	41	1.0000000
NODE_108315_length_355_cov_2.007812	281	347	0	66	66	1.0000000
NODE_108395_length_355_cov_1.765625	186	247	5	14	61	0.2295082
NODE_108395_length_355_cov_1.765625	186	247	6	12	61	0.1967213
NODE_108395_length_355_cov_1.765625	186	247	7	23	61	0.3770492
NODE_108395_length_355_cov_1.765625	186	247	8	11	61	0.1803279
NODE_108395_length_355_cov_1.765625	186	247	9	1	61	0.0163934
NODE_108395_length_355_cov_1.765625	220	300	5	2	80	0.0250000
NODE_108395_length_355_cov_1.765625	220	300	6	24	80	0.3000000
NODE_108395_length_355_cov_1.765625	220	300	7	17	80	0.2125000
NODE_108395_length_355_cov_1.765625	220	300	8	2	80	0.0250000
NODE_108395_length_355_cov_1.765625	220	300	9	35	80	0.4375000
NODE_109015_length_354_cov_6.843137	53	132	2	21	79	0.2658228
NODE_109015_length_354_cov_6.843137	53	132	3	12	79	0.1518987
NODE_109015_length_354_cov_6.843137	53	132	5	5	79	0.0632911
NODE_109015_length_354_cov_6.843137	53	132	6	41	79	0.5189874
NODE_109015_length_354_cov_6.843137	53	132	2	21	79	0.2658228
NODE_109015_length_354_cov_6.843137	53	132	3	12	79	0.1518987
NODE_109015_length_354_cov_6.843137	53	132	5	5	79	0.0632911
NODE_109015_length_354_cov_6.843137	53	132	6	41	79	0.5189874
NODE_109015_length_354_cov_6.843137	105	185	4	28	80	0.3500000
NODE_109015_length_354_cov_6.843137	105	185	6	52	80	0.6500000
NODE_109015_length_354_cov_6.843137	105	185	4	28	80	0.3500000
NODE_109015_length_354_cov_6.843137	105	185	6	52	80	0.6500000
NODE_109033_length_354_cov_4.823529	208	255	0	47	47	1.0000000
NODE_109054_length_354_cov_3.956863	145	208	0	63	63	1.0000000
NODE_109054_length_354_cov_3.956863	181	261	0	80	80	1.0000000
NODE_109057_length_354_cov_3.878431	198	244	0	46	46	1.0000000
NODE_109089_length_354_cov_3.207843	130	199	0	69	69	1.0000000
NODE_109126_length_354_cov_2.725490	179	259	1	25	80	0.3125000
NODE_109126_length_354_cov_2.725490	179	259	3	33	80	0.4125000
NODE_109126_length_354_cov_2.725490	179	259	5	22	80	0.2750000
NODE_109126_length_354_cov_2.725490	235	312	2	2	77	0.0259740
NODE_109126_length_354_cov_2.725490	235	312	3	2	77	0.0259740
NODE_109126_length_354_cov_2.725490	235	312	4	14	77	0.1818182
NODE_109126_length_354_cov_2.725490	235	312	5	59	77	0.7662337
NODE_109128_length_354_cov_2.713725	16	76	2	60	60	1.0000000
NODE_109128_length_354_cov_2.713725	90	149	0	3	59	0.0508475
NODE_109128_length_354_cov_2.713725	90	149	2	56	59	0.9491525
NODE_109140_length_354_cov_2.580392	176	234	0	58	58	1.0000000
NODE_109140_length_354_cov_2.580392	207	251	0	44	44	1.0000000
NODE_109237_length_354_cov_1.996078	79	145	0	40	66	0.6060606
NODE_109237_length_354_cov_1.996078	79	145	2	26	66	0.3939394
NODE_109237_length_354_cov_1.996078	118	200	0	1	82	0.0121951
NODE_109237_length_354_cov_1.996078	118	200	2	81	82	0.9878049
NODE_109244_length_354_cov_1.988235	7	77	0	3	70	0.0428571
NODE_109244_length_354_cov_1.988235	7	77	2	37	70	0.5285714
NODE_109244_length_354_cov_1.988235	7	77	4	30	70	0.4285714
NODE_109244_length_354_cov_1.988235	64	130	4	34	66	0.5151515
NODE_109244_length_354_cov_1.988235	64	130	6	32	66	0.4848485
NODE_109321_length_354_cov_1.682353	99	171	1	21	72	0.2916667
NODE_109321_length_354_cov_1.682353	99	171	2	17	72	0.2361111
NODE_109321_length_354_cov_1.682353	99	171	3	3	72	0.0416667
NODE_109321_length_354_cov_1.682353	99	171	4	31	72	0.4305556
NODE_109321_length_354_cov_1.682353	144	224	4	37	80	0.4625000
NODE_109321_length_354_cov_1.682353	144	224	5	43	80	0.5375000
NODE_109852_length_353_cov_11.169291	14	90	1	20	76	0.2631579
NODE_109852_length_353_cov_11.169291	14	90	2	56	76	0.7368421
NODE_109852_length_353_cov_11.169291	67	143	2	76	76	1.0000000
NODE_109911_length_353_cov_3.874016	220	256	2	36	36	1.0000000
NODE_109911_length_353_cov_3.874016	265	334	0	31	69	0.4492754
NODE_109911_length_353_cov_3.874016	265	334	1	10	69	0.1449275
NODE_109911_length_353_cov_3.874016	265	334	2	28	69	0.4057971
NODE_109928_length_353_cov_3.488189	200	282	3	5	82	0.0609756
NODE_109928_length_353_cov_3.488189	200	282	5	9	82	0.1097561
NODE_109928_length_353_cov_3.488189	200	282	6	26	82	0.3170732
NODE_109928_length_353_cov_3.488189	200	282	7	42	82	0.5121951
NODE_109976_length_353_cov_2.826772	8	88	0	80	80	1.0000000
NODE_109976_length_353_cov_2.826772	61	120	0	59	59	1.0000000
NODE_110022_length_353_cov_2.417323	260	336	0	62	76	0.8157895
NODE_110022_length_353_cov_2.417323	260	336	1	14	76	0.1842105
NODE_110610_length_353_cov_0.744094	299	318	0	19	19	1.0000000
NODE_110708_length_352_cov_34.691700	110	203	0	2	93	0.0215054
NODE_110708_length_352_cov_34.691700	110	203	1	32	93	0.3440860
NODE_110708_length_352_cov_34.691700	110	203	2	57	93	0.6129032
NODE_110708_length_352_cov_34.691700	110	203	7	1	93	0.0107527
NODE_110708_length_352_cov_34.691700	110	203	13	1	93	0.0107527
NODE_110710_length_352_cov_17.944664	20	100	0	80	80	1.0000000
NODE_110710_length_352_cov_17.944664	73	153	0	80	80	1.0000000
NODE_110710_length_352_cov_17.944664	273	352	0	79	79	1.0000000
NODE_110735_length_352_cov_4.707510	157	237	1	18	80	0.2250000
NODE_110735_length_352_cov_4.707510	157	237	2	9	80	0.1125000
NODE_110735_length_352_cov_4.707510	157	237	4	9	80	0.1125000
NODE_110735_length_352_cov_4.707510	157	237	5	27	80	0.3375000
NODE_110735_length_352_cov_4.707510	157	237	6	12	80	0.1500000
NODE_110735_length_352_cov_4.707510	157	237	7	5	80	0.0625000
NODE_110749_length_352_cov_4.221344	144	205	0	61	61	1.0000000
NODE_110749_length_352_cov_4.221344	178	259	0	81	81	1.0000000
NODE_110754_length_352_cov_4.011858	98	143	1	45	45	1.0000000
NODE_110754_length_352_cov_4.011858	151	228	2	25	77	0.3246753
NODE_110754_length_352_cov_4.011858	151	228	3	22	77	0.2857143
NODE_110754_length_352_cov_4.011858	151	228	4	30	77	0.3896104
NODE_110798_length_352_cov_2.849802	74	154	1	80	80	1.0000000
NODE_110798_length_352_cov_2.849802	127	198	0	5	71	0.0704225
NODE_110798_length_352_cov_2.849802	127	198	1	66	71	0.9295775
NODE_110820_length_352_cov_2.683794	0	77	0	22	77	0.2857143
NODE_110820_length_352_cov_2.683794	0	77	1	3	77	0.0389610
NODE_110820_length_352_cov_2.683794	0	77	3	27	77	0.3506494
NODE_110820_length_352_cov_2.683794	0	77	4	24	77	0.3116883
NODE_110820_length_352_cov_2.683794	0	77	5	1	77	0.0129870
NODE_110820_length_352_cov_2.683794	50	130	3	2	80	0.0250000
NODE_110820_length_352_cov_2.683794	50	130	4	24	80	0.3000000
NODE_110820_length_352_cov_2.683794	50	130	5	54	80	0.6750000
NODE_110832_length_352_cov_2.608696	90	136	0	29	46	0.6304348
NODE_110832_length_352_cov_2.608696	90	136	1	2	46	0.0434783
NODE_110832_length_352_cov_2.608696	90	136	3	15	46	0.3260870
NODE_110832_length_352_cov_2.608696	144	189	3	45	45	1.0000000
NODE_110838_length_352_cov_2.577075	111	191	1	26	80	0.3250000
NODE_110838_length_352_cov_2.577075	111	191	3	11	80	0.1375000
NODE_110838_length_352_cov_2.577075	111	191	4	9	80	0.1125000
NODE_110838_length_352_cov_2.577075	111	191	8	34	80	0.4250000
NODE_110876_length_352_cov_2.264822	171	251	0	3	80	0.0375000
NODE_110876_length_352_cov_2.264822	171	251	1	53	80	0.6625000
NODE_110876_length_352_cov_2.264822	171	251	5	24	80	0.3000000
NODE_110938_length_352_cov_2.007905	277	326	0	49	49	1.0000000
NODE_111439_length_352_cov_0.806324	165	238	17	3	73	0.0410959
NODE_111439_length_352_cov_0.806324	165	238	19	7	73	0.0958904
NODE_111439_length_352_cov_0.806324	165	238	22	1	73	0.0136986
NODE_111439_length_352_cov_0.806324	165	238	23	1	73	0.0136986
NODE_111439_length_352_cov_0.806324	165	238	24	1	73	0.0136986
NODE_111439_length_352_cov_0.806324	165	238	26	2	73	0.0273973
NODE_111439_length_352_cov_0.806324	165	238	28	2	73	0.0273973
NODE_111439_length_352_cov_0.806324	165	238	30	18	73	0.2465753
NODE_111439_length_352_cov_0.806324	165	238	31	9	73	0.1232877
NODE_111439_length_352_cov_0.806324	165	238	32	2	73	0.0273973
NODE_111439_length_352_cov_0.806324	165	238	33	5	73	0.0684932
NODE_111439_length_352_cov_0.806324	165	238	34	6	73	0.0821918
NODE_111439_length_352_cov_0.806324	165	238	35	1	73	0.0136986
NODE_111439_length_352_cov_0.806324	165	238	36	1	73	0.0136986
NODE_111439_length_352_cov_0.806324	165	238	38	14	73	0.1917808
NODE_111593_length_351_cov_5.003968	115	195	0	80	80	1.0000000
NODE_111662_length_351_cov_2.900794	289	320	2	8	31	0.2580645
NODE_111662_length_351_cov_2.900794	289	320	3	23	31	0.7419355
NODE_111738_length_351_cov_2.376984	79	159	3	19	80	0.2375000
NODE_111738_length_351_cov_2.376984	79	159	5	3	80	0.0375000
NODE_111738_length_351_cov_2.376984	79	159	7	35	80	0.4375000
NODE_111738_length_351_cov_2.376984	79	159	9	11	80	0.1375000
NODE_111738_length_351_cov_2.376984	79	159	13	3	80	0.0375000
NODE_111738_length_351_cov_2.376984	79	159	14	9	80	0.1125000
NODE_111759_length_351_cov_2.226190	116	170	12	13	54	0.2407407
NODE_111759_length_351_cov_2.226190	116	170	14	41	54	0.7592593
NODE_111769_length_351_cov_2.186508	198	277	1	40	79	0.5063291
NODE_111769_length_351_cov_2.186508	198	277	2	39	79	0.4936709
NODE_111861_length_351_cov_1.809524	276	309	0	33	33	1.0000000
NODE_111969_length_351_cov_1.515873	228	299	0	71	71	1.0000000
NODE_112493_length_350_cov_232.529880	25	92	50	1	67	0.0149254
NODE_112493_length_350_cov_232.529880	25	92	56	1	67	0.0149254
NODE_112493_length_350_cov_232.529880	25	92	58	2	67	0.0298507
NODE_112493_length_350_cov_232.529880	25	92	59	2	67	0.0298507
NODE_112493_length_350_cov_232.529880	25	92	60	2	67	0.0298507
NODE_112493_length_350_cov_232.529880	25	92	61	1	67	0.0149254
NODE_112493_length_350_cov_232.529880	25	92	64	3	67	0.0447761
NODE_112493_length_350_cov_232.529880	25	92	66	2	67	0.0298507
NODE_112493_length_350_cov_232.529880	25	92	68	1	67	0.0149254
NODE_112493_length_350_cov_232.529880	25	92	70	1	67	0.0149254
NODE_112493_length_350_cov_232.529880	25	92	73	2	67	0.0298507
NODE_112493_length_350_cov_232.529880	25	92	76	1	67	0.0149254
NODE_112493_length_350_cov_232.529880	25	92	77	1	67	0.0149254
NODE_112493_length_350_cov_232.529880	25	92	79	2	67	0.0298507
NODE_112493_length_350_cov_232.529880	25	92	80	1	67	0.0149254
NODE_112493_length_350_cov_232.529880	25	92	82	3	67	0.0447761
NODE_112493_length_350_cov_232.529880	25	92	84	1	67	0.0149254
NODE_112493_length_350_cov_232.529880	25	92	85	1	67	0.0149254
NODE_112493_length_350_cov_232.529880	25	92	87	1	67	0.0149254
NODE_112493_length_350_cov_232.529880	25	92	92	1	67	0.0149254
NODE_112493_length_350_cov_232.529880	25	92	93	1	67	0.0149254
NODE_112493_length_350_cov_232.529880	25	92	94	1	67	0.0149254
NODE_112493_length_350_cov_232.529880	25	92	97	3	67	0.0447761
NODE_112493_length_350_cov_232.529880	25	92	99	5	67	0.0746269
NODE_112493_length_350_cov_232.529880	25	92	100	2	67	0.0298507
NODE_112493_length_350_cov_232.529880	25	92	102	4	67	0.0597015
NODE_112493_length_350_cov_232.529880	25	92	106	1	67	0.0149254
NODE_112493_length_350_cov_232.529880	25	92	108	2	67	0.0298507
NODE_112493_length_350_cov_232.529880	25	92	110	1	67	0.0149254
NODE_112493_length_350_cov_232.529880	25	92	116	1	67	0.0149254
NODE_112493_length_350_cov_232.529880	25	92	120	4	67	0.0597015
NODE_112493_length_350_cov_232.529880	25	92	121	2	67	0.0298507
NODE_112493_length_350_cov_232.529880	25	92	124	6	67	0.0895522
NODE_112493_length_350_cov_232.529880	25	92	125	2	67	0.0298507
NODE_112493_length_350_cov_232.529880	25	92	128	2	67	0.0298507
NODE_112494_length_350_cov_40.677291	181	246	86	1	65	0.0153846
NODE_112494_length_350_cov_40.677291	181	246	90	1	65	0.0153846
NODE_112494_length_350_cov_40.677291	181	246	91	3	65	0.0461538
NODE_112494_length_350_cov_40.677291	181	246	94	2	65	0.0307692
NODE_112494_length_350_cov_40.677291	181	246	95	4	65	0.0615385
NODE_112494_length_350_cov_40.677291	181	246	96	8	65	0.1230769
NODE_112494_length_350_cov_40.677291	181	246	97	3	65	0.0461538
NODE_112494_length_350_cov_40.677291	181	246	98	2	65	0.0307692
NODE_112494_length_350_cov_40.677291	181	246	99	1	65	0.0153846
NODE_112494_length_350_cov_40.677291	181	246	100	4	65	0.0615385
NODE_112494_length_350_cov_40.677291	181	246	101	7	65	0.1076923
NODE_112494_length_350_cov_40.677291	181	246	102	3	65	0.0461538
NODE_112494_length_350_cov_40.677291	181	246	103	6	65	0.0923077
NODE_112494_length_350_cov_40.677291	181	246	104	4	65	0.0615385
NODE_112494_length_350_cov_40.677291	181	246	105	5	65	0.0769231
NODE_112494_length_350_cov_40.677291	181	246	106	2	65	0.0307692
NODE_112494_length_350_cov_40.677291	181	246	107	2	65	0.0307692
NODE_112494_length_350_cov_40.677291	181	246	109	2	65	0.0307692
NODE_112494_length_350_cov_40.677291	181	246	110	1	65	0.0153846
NODE_112494_length_350_cov_40.677291	181	246	111	3	65	0.0461538
NODE_112494_length_350_cov_40.677291	181	246	112	1	65	0.0153846
NODE_112535_length_350_cov_4.179283	114	194	2	20	80	0.2500000
NODE_112535_length_350_cov_4.179283	114	194	4	12	80	0.1500000
NODE_112535_length_350_cov_4.179283	114	194	6	1	80	0.0125000
NODE_112535_length_350_cov_4.179283	114	194	8	47	80	0.5875000
NODE_112535_length_350_cov_4.179283	167	244	6	23	77	0.2987013
NODE_112535_length_350_cov_4.179283	167	244	7	14	77	0.1818182
NODE_112535_length_350_cov_4.179283	167	244	8	40	77	0.5194805
NODE_112554_length_350_cov_3.573705	128	202	8	33	74	0.4459459
NODE_112554_length_350_cov_3.573705	128	202	11	41	74	0.5540541
NODE_112554_length_350_cov_3.573705	178	241	6	3	63	0.0476190
NODE_112554_length_350_cov_3.573705	178	241	7	13	63	0.2063492
NODE_112554_length_350_cov_3.573705	178	241	8	30	63	0.4761905
NODE_112554_length_350_cov_3.573705	178	241	9	17	63	0.2698413
NODE_112627_length_350_cov_2.478088	266	297	2	31	31	1.0000000
NODE_112647_length_350_cov_2.346614	97	148	31	1	51	0.0196078
NODE_112647_length_350_cov_2.346614	97	148	32	4	51	0.0784314
NODE_112647_length_350_cov_2.346614	97	148	33	1	51	0.0196078
NODE_112647_length_350_cov_2.346614	97	148	35	1	51	0.0196078
NODE_112647_length_350_cov_2.346614	97	148	36	2	51	0.0392157
NODE_112647_length_350_cov_2.346614	97	148	37	15	51	0.2941177
NODE_112647_length_350_cov_2.346614	97	148	38	6	51	0.1176471
NODE_112647_length_350_cov_2.346614	97	148	39	8	51	0.1568628
NODE_112647_length_350_cov_2.346614	97	148	42	1	51	0.0196078
NODE_112647_length_350_cov_2.346614	97	148	44	1	51	0.0196078
NODE_112647_length_350_cov_2.346614	97	148	46	1	51	0.0196078
NODE_112647_length_350_cov_2.346614	97	148	47	3	51	0.0588235
NODE_112647_length_350_cov_2.346614	97	148	48	1	51	0.0196078
NODE_112647_length_350_cov_2.346614	97	148	50	2	51	0.0392157
NODE_112647_length_350_cov_2.346614	97	148	51	4	51	0.0784314
NODE_112714_length_350_cov_2.031873	181	238	6	7	57	0.1228070
NODE_112714_length_350_cov_2.031873	181	238	7	1	57	0.0175439
NODE_112714_length_350_cov_2.031873	181	238	8	49	57	0.8596491
NODE_112997_length_350_cov_1.223108	202	275	0	27	73	0.3698630
NODE_112997_length_350_cov_1.223108	202	275	2	12	73	0.1643836
NODE_112997_length_350_cov_1.223108	202	275	4	12	73	0.1643836
NODE_112997_length_350_cov_1.223108	202	275	6	3	73	0.0410959
NODE_112997_length_350_cov_1.223108	202	275	8	4	73	0.0547945
NODE_112997_length_350_cov_1.223108	202	275	9	1	73	0.0136986
NODE_112997_length_350_cov_1.223108	202	275	11	3	73	0.0410959
NODE_112997_length_350_cov_1.223108	202	275	13	3	73	0.0410959
NODE_112997_length_350_cov_1.223108	202	275	14	2	73	0.0273973
NODE_112997_length_350_cov_1.223108	202	275	16	6	73	0.0821918
NODE_113450_length_349_cov_4.268000	83	163	4	9	80	0.1125000
NODE_113450_length_349_cov_4.268000	83	163	6	71	80	0.8875000
NODE_113450_length_349_cov_4.268000	83	163	4	9	80	0.1125000
NODE_113450_length_349_cov_4.268000	83	163	6	71	80	0.8875000
NODE_113450_length_349_cov_4.268000	136	216	2	22	80	0.2750000
NODE_113450_length_349_cov_4.268000	136	216	3	26	80	0.3250000
NODE_113450_length_349_cov_4.268000	136	216	4	11	80	0.1375000
NODE_113450_length_349_cov_4.268000	136	216	6	21	80	0.2625000
NODE_113450_length_349_cov_4.268000	145	180	3	12	35	0.3428572
NODE_113450_length_349_cov_4.268000	145	180	4	11	35	0.3142857
NODE_113450_length_349_cov_4.268000	145	180	6	12	35	0.3428572
NODE_113473_length_349_cov_3.648000	219	300	3	15	81	0.1851852
NODE_113473_length_349_cov_3.648000	219	300	4	4	81	0.0493827
NODE_113473_length_349_cov_3.648000	219	300	5	8	81	0.0987654
NODE_113473_length_349_cov_3.648000	219	300	6	1	81	0.0123457
NODE_113473_length_349_cov_3.648000	219	300	7	3	81	0.0370370
NODE_113473_length_349_cov_3.648000	219	300	8	5	81	0.0617284
NODE_113473_length_349_cov_3.648000	219	300	10	12	81	0.1481481
NODE_113473_length_349_cov_3.648000	219	300	12	18	81	0.2222222
NODE_113473_length_349_cov_3.648000	219	300	14	6	81	0.0740741
NODE_113473_length_349_cov_3.648000	219	300	15	4	81	0.0493827
NODE_113473_length_349_cov_3.648000	219	300	19	2	81	0.0246914
NODE_113473_length_349_cov_3.648000	219	300	20	3	81	0.0370370
NODE_113480_length_349_cov_3.484000	196	276	1	7	80	0.0875000
NODE_113480_length_349_cov_3.484000	196	276	2	39	80	0.4875000
NODE_113480_length_349_cov_3.484000	196	276	3	34	80	0.4250000
NODE_113486_length_349_cov_3.364000	219	284	1	20	65	0.3076923
NODE_113486_length_349_cov_3.364000	219	284	2	45	65	0.6923077
NODE_113511_length_349_cov_2.916000	94	189	1	17	95	0.1789474
NODE_113511_length_349_cov_2.916000	94	189	2	19	95	0.2000000
NODE_113511_length_349_cov_2.916000	94	189	3	59	95	0.6210526
NODE_113571_length_349_cov_2.420000	35	54	0	19	19	1.0000000
NODE_113647_length_349_cov_1.964000	32	63	0	31	31	1.0000000
NODE_113654_length_349_cov_1.928000	9	77	1	3	68	0.0441176
NODE_113654_length_349_cov_1.928000	9	77	2	47	68	0.6911765
NODE_113654_length_349_cov_1.928000	9	77	3	18	68	0.2647059
NODE_113654_length_349_cov_1.928000	62	115	3	53	53	1.0000000
NODE_113710_length_349_cov_1.684000	225	265	2	8	40	0.2000000
NODE_113710_length_349_cov_1.684000	225	265	4	32	40	0.8000000
NODE_113825_length_349_cov_1.392000	32	95	0	63	63	1.0000000
NODE_113961_length_349_cov_1.056000	316	339	0	23	23	1.0000000
NODE_114002_length_349_cov_1.020000	177	257	1	75	80	0.9375000
NODE_114002_length_349_cov_1.020000	177	257	2	5	80	0.0625000
NODE_114263_length_348_cov_34.867470	156	236	4	4	80	0.0500000
NODE_114263_length_348_cov_34.867470	156	236	6	8	80	0.1000000
NODE_114263_length_348_cov_34.867470	156	236	7	1	80	0.0125000
NODE_114263_length_348_cov_34.867470	156	236	8	35	80	0.4375000
NODE_114263_length_348_cov_34.867470	156	236	9	4	80	0.0500000
NODE_114263_length_348_cov_34.867470	156	236	12	4	80	0.0500000
NODE_114263_length_348_cov_34.867470	156	236	13	19	80	0.2375000
NODE_114263_length_348_cov_34.867470	156	236	14	5	80	0.0625000
NODE_114263_length_348_cov_34.867470	209	289	9	32	80	0.4000000
NODE_114263_length_348_cov_34.867470	209	289	12	4	80	0.0500000
NODE_114263_length_348_cov_34.867470	209	289	13	40	80	0.5000000
NODE_114263_length_348_cov_34.867470	209	289	14	4	80	0.0500000
NODE_114296_length_348_cov_4.180723	106	186	0	4	80	0.0500000
NODE_114296_length_348_cov_4.180723	106	186	1	24	80	0.3000000
NODE_114296_length_348_cov_4.180723	106	186	2	22	80	0.2750000
NODE_114296_length_348_cov_4.180723	106	186	4	30	80	0.3750000
NODE_114296_length_348_cov_4.180723	159	239	4	80	80	1.0000000
NODE_114330_length_348_cov_3.277108	83	137	0	8	54	0.1481481
NODE_114330_length_348_cov_3.277108	83	137	2	46	54	0.8518519
NODE_114330_length_348_cov_3.277108	145	197	0	12	52	0.2307692
NODE_114330_length_348_cov_3.277108	145	197	2	40	52	0.7692308
NODE_114424_length_348_cov_2.305221	204	273	1	23	69	0.3333333
NODE_114424_length_348_cov_2.305221	204	273	2	46	69	0.6666667
NODE_114448_length_348_cov_2.216867	103	152	0	30	49	0.6122449
NODE_114448_length_348_cov_2.216867	103	152	2	19	49	0.3877551
NODE_114505_length_348_cov_1.995984	170	239	0	69	69	1.0000000
NODE_114591_length_348_cov_1.638554	309	346	0	37	37	1.0000000
NODE_114643_length_348_cov_1.485944	9	60	0	51	51	1.0000000
NODE_115147_length_347_cov_15.100806	57	137	0	12	80	0.1500000
NODE_115147_length_347_cov_15.100806	57	137	2	22	80	0.2750000
NODE_115147_length_347_cov_15.100806	57	137	4	46	80	0.5750000
NODE_115147_length_347_cov_15.100806	110	152	4	42	42	1.0000000
NODE_115147_length_347_cov_15.100806	182	209	4	27	27	1.0000000
NODE_115147_length_347_cov_15.100806	290	317	3	27	27	1.0000000
NODE_115161_length_347_cov_5.967742	110	173	3	14	63	0.2222222
NODE_115161_length_347_cov_5.967742	110	173	4	49	63	0.7777778
NODE_115195_length_347_cov_4.028226	260	329	0	69	69	1.0000000
NODE_115321_length_347_cov_2.463710	99	141	0	42	42	1.0000000
NODE_115321_length_347_cov_2.463710	108	143	0	35	35	1.0000000
NODE_115331_length_347_cov_2.391129	35	70	2	35	35	1.0000000
NODE_115331_length_347_cov_2.391129	37	79	2	42	42	1.0000000
NODE_115331_length_347_cov_2.391129	77	105	0	6	28	0.2142857
NODE_115331_length_347_cov_2.391129	77	105	2	22	28	0.7857143
NODE_115397_length_347_cov_2.048387	15	34	0	19	19	1.0000000
NODE_115417_length_347_cov_1.967742	205	268	0	63	63	1.0000000
NODE_115450_length_347_cov_1.818548	109	156	0	47	47	1.0000000
NODE_115771_length_347_cov_1.028226	230	255	0	25	25	1.0000000
NODE_116114_length_346_cov_74.433198	10	90	0	5	80	0.0625000
NODE_116114_length_346_cov_74.433198	10	90	2	14	80	0.1750000
NODE_116114_length_346_cov_74.433198	10	90	3	18	80	0.2250000
NODE_116114_length_346_cov_74.433198	10	90	4	18	80	0.2250000
NODE_116114_length_346_cov_74.433198	10	90	5	12	80	0.1500000
NODE_116114_length_346_cov_74.433198	10	90	6	9	80	0.1125000
NODE_116114_length_346_cov_74.433198	10	90	7	4	80	0.0500000
NODE_116114_length_346_cov_74.433198	19	90	2	10	71	0.1408451
NODE_116114_length_346_cov_74.433198	19	90	3	18	71	0.2535211
NODE_116114_length_346_cov_74.433198	19	90	4	18	71	0.2535211
NODE_116114_length_346_cov_74.433198	19	90	5	12	71	0.1690141
NODE_116114_length_346_cov_74.433198	19	90	6	9	71	0.1267606
NODE_116114_length_346_cov_74.433198	19	90	7	4	71	0.0563380
NODE_116114_length_346_cov_74.433198	192	272	8	16	80	0.2000000
NODE_116114_length_346_cov_74.433198	192	272	9	20	80	0.2500000
NODE_116114_length_346_cov_74.433198	192	272	10	9	80	0.1125000
NODE_116114_length_346_cov_74.433198	192	272	11	12	80	0.1500000
NODE_116114_length_346_cov_74.433198	192	272	12	23	80	0.2875000
NODE_116115_length_346_cov_67.834008	133	213	1	62	80	0.7750000
NODE_116115_length_346_cov_67.834008	133	213	2	18	80	0.2250000
NODE_116115_length_346_cov_67.834008	186	266	0	17	80	0.2125000
NODE_116115_length_346_cov_67.834008	186	266	1	63	80	0.7875000
NODE_116117_length_346_cov_10.299595	190	270	0	80	80	1.0000000
NODE_116117_length_346_cov_10.299595	243	323	0	80	80	1.0000000
NODE_116119_length_346_cov_9.566802	159	239	0	80	80	1.0000000
NODE_116119_length_346_cov_9.566802	212	292	0	80	80	1.0000000
NODE_116134_length_346_cov_5.506073	157	238	2	17	81	0.2098765
NODE_116134_length_346_cov_5.506073	157	238	4	64	81	0.7901235
NODE_116155_length_346_cov_4.368421	205	264	0	59	59	1.0000000
NODE_116159_length_346_cov_4.032389	121	141	0	20	20	1.0000000
NODE_116184_length_346_cov_3.400810	194	253	0	59	59	1.0000000
NODE_116212_length_346_cov_3.008097	183	263	0	79	80	0.9875000
NODE_116212_length_346_cov_3.008097	183	263	1	1	80	0.0125000
NODE_116257_length_346_cov_2.538462	47	102	0	55	55	1.0000000
NODE_116257_length_346_cov_2.538462	118	173	0	55	55	1.0000000
NODE_116439_length_346_cov_1.700405	71	107	0	36	36	1.0000000
NODE_117035_length_345_cov_47.699187	0	66	0	5	66	0.0757576
NODE_117035_length_345_cov_47.699187	0	66	1	50	66	0.7575758
NODE_117035_length_345_cov_47.699187	0	66	2	11	66	0.1666667
NODE_117035_length_345_cov_47.699187	39	119	1	16	80	0.2000000
NODE_117035_length_345_cov_47.699187	39	119	2	64	80	0.8000000
NODE_117035_length_345_cov_47.699187	115	182	2	9	67	0.1343284
NODE_117035_length_345_cov_47.699187	115	182	3	28	67	0.4179105
NODE_117035_length_345_cov_47.699187	115	182	4	30	67	0.4477612
NODE_117035_length_345_cov_47.699187	246	311	0	3	65	0.0461538
NODE_117035_length_345_cov_47.699187	246	311	3	45	65	0.6923077
NODE_117035_length_345_cov_47.699187	246	311	5	17	65	0.2615385
NODE_117036_length_345_cov_13.439024	28	108	0	80	80	1.0000000
NODE_117036_length_345_cov_13.439024	81	161	0	80	80	1.0000000
NODE_117037_length_345_cov_9.906504	224	283	2	3	59	0.0508475
NODE_117037_length_345_cov_9.906504	224	283	3	32	59	0.5423729
NODE_117037_length_345_cov_9.906504	224	283	4	24	59	0.4067796
NODE_117051_length_345_cov_5.475610	52	132	2	57	80	0.7125000
NODE_117051_length_345_cov_5.475610	52	132	3	7	80	0.0875000
NODE_117051_length_345_cov_5.475610	52	132	4	16	80	0.2000000
NODE_117051_length_345_cov_5.475610	105	185	2	17	80	0.2125000
NODE_117051_length_345_cov_5.475610	105	185	4	63	80	0.7875000
NODE_117055_length_345_cov_5.321138	104	152	0	48	48	1.0000000
NODE_117065_length_345_cov_4.524390	205	269	0	64	64	1.0000000
NODE_117075_length_345_cov_4.109756	95	157	0	60	62	0.9677419
NODE_117075_length_345_cov_4.109756	95	157	1	2	62	0.0322581
NODE_117075_length_345_cov_4.109756	162	204	1	42	42	1.0000000
NODE_117076_length_345_cov_4.073171	251	326	0	75	75	1.0000000
NODE_117084_length_345_cov_3.776423	199	273	2	55	74	0.7432432
NODE_117084_length_345_cov_3.776423	199	273	4	19	74	0.2567568
NODE_117084_length_345_cov_3.776423	246	326	0	20	80	0.2500000
NODE_117084_length_345_cov_3.776423	246	326	2	60	80	0.7500000
NODE_117148_length_345_cov_2.821138	61	141	0	70	80	0.8750000
NODE_117148_length_345_cov_2.821138	61	141	1	10	80	0.1250000
NODE_117205_length_345_cov_2.333333	47	90	9	1	43	0.0232558
NODE_117205_length_345_cov_2.333333	47	90	10	2	43	0.0465116
NODE_117205_length_345_cov_2.333333	47	90	11	3	43	0.0697674
NODE_117205_length_345_cov_2.333333	47	90	12	4	43	0.0930233
NODE_117205_length_345_cov_2.333333	47	90	14	5	43	0.1162791
NODE_117205_length_345_cov_2.333333	47	90	17	28	43	0.6511628
NODE_117205_length_345_cov_2.333333	63	147	15	7	84	0.0833333
NODE_117205_length_345_cov_2.333333	63	147	17	47	84	0.5595238
NODE_117205_length_345_cov_2.333333	63	147	19	29	84	0.3452381
NODE_117205_length_345_cov_2.333333	63	147	20	1	84	0.0119048
NODE_117219_length_345_cov_2.239837	0	81	0	1	81	0.0123457
NODE_117219_length_345_cov_2.239837	0	81	1	4	81	0.0493827
NODE_117219_length_345_cov_2.239837	0	81	3	2	81	0.0246914
NODE_117219_length_345_cov_2.239837	0	81	4	2	81	0.0246914
NODE_117219_length_345_cov_2.239837	0	81	6	4	81	0.0493827
NODE_117219_length_345_cov_2.239837	0	81	8	12	81	0.1481481
NODE_117219_length_345_cov_2.239837	0	81	9	22	81	0.2716049
NODE_117219_length_345_cov_2.239837	0	81	11	3	81	0.0370370
NODE_117219_length_345_cov_2.239837	0	81	12	31	81	0.3827161
NODE_117669_length_345_cov_1.040650	6	73	2	22	67	0.3283582
NODE_117669_length_345_cov_1.040650	6	73	3	13	67	0.1940299
NODE_117669_length_345_cov_1.040650	6	73	4	2	67	0.0298507
NODE_117669_length_345_cov_1.040650	6	73	5	11	67	0.1641791
NODE_117669_length_345_cov_1.040650	6	73	6	19	67	0.2835821
NODE_117989_length_344_cov_54.020408	6	55	8	6	49	0.1224490
NODE_117989_length_344_cov_54.020408	6	55	10	10	49	0.2040816
NODE_117989_length_344_cov_54.020408	6	55	11	8	49	0.1632653
NODE_117989_length_344_cov_54.020408	6	55	12	7	49	0.1428571
NODE_117989_length_344_cov_54.020408	6	55	14	7	49	0.1428571
NODE_117989_length_344_cov_54.020408	6	55	15	11	49	0.2244898
NODE_117989_length_344_cov_54.020408	28	105	11	2	77	0.0259740
NODE_117989_length_344_cov_54.020408	28	105	12	7	77	0.0909091
NODE_117989_length_344_cov_54.020408	28	105	14	7	77	0.0909091
NODE_117989_length_344_cov_54.020408	28	105	15	21	77	0.2727273
NODE_117989_length_344_cov_54.020408	28	105	17	40	77	0.5194805
NODE_117989_length_344_cov_54.020408	28	105	11	2	77	0.0259740
NODE_117989_length_344_cov_54.020408	28	105	12	7	77	0.0909091
NODE_117989_length_344_cov_54.020408	28	105	14	7	77	0.0909091
NODE_117989_length_344_cov_54.020408	28	105	15	21	77	0.2727273
NODE_117989_length_344_cov_54.020408	28	105	17	40	77	0.5194805
NODE_117989_length_344_cov_54.020408	112	178	5	6	66	0.0909091
NODE_117989_length_344_cov_54.020408	112	178	6	10	66	0.1515152
NODE_117989_length_344_cov_54.020408	112	178	7	24	66	0.3636364
NODE_117989_length_344_cov_54.020408	112	178	10	2	66	0.0303030
NODE_117989_length_344_cov_54.020408	112	178	11	1	66	0.0151515
NODE_117989_length_344_cov_54.020408	112	178	12	20	66	0.3030303
NODE_117989_length_344_cov_54.020408	112	178	15	3	66	0.0454545
NODE_118009_length_344_cov_5.016327	72	125	4	7	53	0.1320755
NODE_118009_length_344_cov_5.016327	72	125	6	24	53	0.4528302
NODE_118009_length_344_cov_5.016327	72	125	8	22	53	0.4150943
NODE_118009_length_344_cov_5.016327	136	203	4	21	67	0.3134328
NODE_118009_length_344_cov_5.016327	136	203	6	32	67	0.4776119
NODE_118009_length_344_cov_5.016327	136	203	8	14	67	0.2089552
NODE_118017_length_344_cov_4.579592	172	254	0	82	82	1.0000000
NODE_118045_length_344_cov_3.840816	197	240	0	43	43	1.0000000
NODE_118074_length_344_cov_3.293878	149	189	0	40	40	1.0000000
NODE_118074_length_344_cov_3.293878	162	229	0	67	67	1.0000000
NODE_118111_length_344_cov_2.751020	24	87	0	61	63	0.9682540
NODE_118111_length_344_cov_2.751020	24	87	1	2	63	0.0317460
NODE_118179_length_344_cov_2.126531	274	305	4	31	31	1.0000000
NODE_118243_length_344_cov_1.914286	114	194	0	9	80	0.1125000
NODE_118243_length_344_cov_1.914286	114	194	1	59	80	0.7375000
NODE_118243_length_344_cov_1.914286	114	194	2	12	80	0.1500000
NODE_118243_length_344_cov_1.914286	167	247	0	62	80	0.7750000
NODE_118243_length_344_cov_1.914286	167	247	1	18	80	0.2250000
NODE_118297_length_344_cov_1.685714	180	220	1	40	40	1.0000000
NODE_118393_length_344_cov_1.457143	160	240	2	8	80	0.1000000
NODE_118393_length_344_cov_1.457143	160	240	4	72	80	0.9000000
NODE_118393_length_344_cov_1.457143	213	273	1	16	60	0.2666667
NODE_118393_length_344_cov_1.457143	213	273	3	1	60	0.0166667
NODE_118393_length_344_cov_1.457143	213	273	4	43	60	0.7166666
NODE_118743_length_344_cov_0.800000	123	163	0	40	40	1.0000000
NODE_118899_length_343_cov_3.770492	2	60	0	58	58	1.0000000
NODE_118905_length_343_cov_3.598361	97	170	2	6	73	0.0821918
NODE_118905_length_343_cov_3.598361	97	170	3	1	73	0.0136986
NODE_118905_length_343_cov_3.598361	97	170	5	66	73	0.9041096
NODE_118905_length_343_cov_3.598361	150	223	5	60	73	0.8219178
NODE_118905_length_343_cov_3.598361	150	223	6	13	73	0.1780822
NODE_118911_length_343_cov_3.401639	48	128	19	3	80	0.0375000
NODE_118911_length_343_cov_3.401639	48	128	20	2	80	0.0250000
NODE_118911_length_343_cov_3.401639	48	128	22	3	80	0.0375000
NODE_118911_length_343_cov_3.401639	48	128	25	1	80	0.0125000
NODE_118911_length_343_cov_3.401639	48	128	26	1	80	0.0125000
NODE_118911_length_343_cov_3.401639	48	128	27	1	80	0.0125000
NODE_118911_length_343_cov_3.401639	48	128	28	3	80	0.0375000
NODE_118911_length_343_cov_3.401639	48	128	29	2	80	0.0250000
NODE_118911_length_343_cov_3.401639	48	128	31	2	80	0.0250000
NODE_118911_length_343_cov_3.401639	48	128	33	2	80	0.0250000
NODE_118911_length_343_cov_3.401639	48	128	34	1	80	0.0125000
NODE_118911_length_343_cov_3.401639	48	128	35	1	80	0.0125000
NODE_118911_length_343_cov_3.401639	48	128	37	6	80	0.0750000
NODE_118911_length_343_cov_3.401639	48	128	38	3	80	0.0375000
NODE_118911_length_343_cov_3.401639	48	128	40	2	80	0.0250000
NODE_118911_length_343_cov_3.401639	48	128	41	12	80	0.1500000
NODE_118911_length_343_cov_3.401639	48	128	42	4	80	0.0500000
NODE_118911_length_343_cov_3.401639	48	128	44	8	80	0.1000000
NODE_118911_length_343_cov_3.401639	48	128	45	23	80	0.2875000
NODE_118941_length_343_cov_3.049180	12	62	0	10	50	0.2000000
NODE_118941_length_343_cov_3.049180	12	62	1	10	50	0.2000000
NODE_118941_length_343_cov_3.049180	12	62	2	30	50	0.6000000
NODE_118941_length_343_cov_3.049180	82	111	2	20	29	0.6896552
NODE_118941_length_343_cov_3.049180	82	111	3	9	29	0.3103448
NODE_118941_length_343_cov_3.049180	133	205	3	12	72	0.1666667
NODE_118941_length_343_cov_3.049180	133	205	4	44	72	0.6111111
NODE_118941_length_343_cov_3.049180	133	205	5	16	72	0.2222222
NODE_118957_length_343_cov_2.770492	236	316	9	19	80	0.2375000
NODE_118957_length_343_cov_2.770492	236	316	10	2	80	0.0250000
NODE_118957_length_343_cov_2.770492	236	316	12	2	80	0.0250000
NODE_118957_length_343_cov_2.770492	236	316	14	7	80	0.0875000
NODE_118957_length_343_cov_2.770492	236	316	15	20	80	0.2500000
NODE_118957_length_343_cov_2.770492	236	316	17	21	80	0.2625000
NODE_118957_length_343_cov_2.770492	236	316	18	9	80	0.1125000
NODE_118978_length_343_cov_2.590164	167	225	0	26	58	0.4482759
NODE_118978_length_343_cov_2.590164	167	225	1	9	58	0.1551724
NODE_118978_length_343_cov_2.590164	167	225	2	5	58	0.0862069
NODE_118978_length_343_cov_2.590164	167	225	4	7	58	0.1206897
NODE_118978_length_343_cov_2.590164	167	225	5	11	58	0.1896552
NODE_118998_length_343_cov_2.430328	208	274	0	44	66	0.6666667
NODE_118998_length_343_cov_2.430328	208	274	2	22	66	0.3333333
NODE_119040_length_343_cov_2.209016	32	111	0	79	79	1.0000000
NODE_119067_length_343_cov_2.081967	95	177	0	82	82	1.0000000
NODE_119067_length_343_cov_2.081967	150	199	0	49	49	1.0000000
NODE_119202_length_343_cov_1.635246	0	52	0	52	52	1.0000000
NODE_119439_length_343_cov_1.143443	60	120	0	60	60	1.0000000
NODE_119834_length_342_cov_3.872428	136	216	3	28	80	0.3500000
NODE_119834_length_342_cov_3.872428	136	216	4	10	80	0.1250000
NODE_119834_length_342_cov_3.872428	136	216	6	15	80	0.1875000
NODE_119834_length_342_cov_3.872428	136	216	8	27	80	0.3375000
NODE_119834_length_342_cov_3.872428	189	259	1	33	70	0.4714286
NODE_119834_length_342_cov_3.872428	189	259	3	37	70	0.5285714
NODE_119840_length_342_cov_3.769547	146	212	0	44	66	0.6666667
NODE_119840_length_342_cov_3.769547	146	212	2	22	66	0.3333333
NODE_119841_length_342_cov_3.740741	113	146	1	33	33	1.0000000
NODE_119846_length_342_cov_3.674897	20	100	0	80	80	1.0000000
NODE_119846_length_342_cov_3.674897	73	153	0	80	80	1.0000000
NODE_119847_length_342_cov_3.588477	117	197	0	37	80	0.4625000
NODE_119847_length_342_cov_3.588477	117	197	1	33	80	0.4125000
NODE_119847_length_342_cov_3.588477	117	197	2	10	80	0.1250000
NODE_119849_length_342_cov_3.530864	72	151	0	79	79	1.0000000
NODE_119852_length_342_cov_3.423868	172	252	6	80	80	1.0000000
NODE_119852_length_342_cov_3.423868	225	283	1	6	58	0.1034483
NODE_119852_length_342_cov_3.423868	225	283	3	8	58	0.1379310
NODE_119852_length_342_cov_3.423868	225	283	4	1	58	0.0172414
NODE_119852_length_342_cov_3.423868	225	283	5	5	58	0.0862069
NODE_119852_length_342_cov_3.423868	225	283	6	38	58	0.6551724
NODE_119922_length_342_cov_2.432099	16	81	1	65	65	1.0000000
NODE_119993_length_342_cov_2.049383	249	317	0	18	68	0.2647059
NODE_119993_length_342_cov_2.049383	249	317	1	35	68	0.5147059
NODE_119993_length_342_cov_2.049383	249	317	2	15	68	0.2205882
NODE_120047_length_342_cov_1.864198	138	190	1	25	52	0.4807692
NODE_120047_length_342_cov_1.864198	138	190	3	23	52	0.4423077
NODE_120047_length_342_cov_1.864198	138	190	5	4	52	0.0769231
NODE_120047_length_342_cov_1.864198	183	243	3	18	60	0.3000000
NODE_120047_length_342_cov_1.864198	183	243	4	2	60	0.0333333
NODE_120047_length_342_cov_1.864198	183	243	5	40	60	0.6666667
NODE_120073_length_342_cov_1.720165	91	147	0	56	56	1.0000000
NODE_120284_length_342_cov_1.271605	201	240	0	13	39	0.3333333
NODE_120284_length_342_cov_1.271605	201	240	2	26	39	0.6666667
NODE_120755_length_341_cov_15.896694	50	130	2	80	80	1.0000000
NODE_120755_length_341_cov_15.896694	103	183	0	44	80	0.5500000
NODE_120755_length_341_cov_15.896694	103	183	2	36	80	0.4500000
NODE_120757_length_341_cov_9.756198	117	196	2	32	79	0.4050633
NODE_120757_length_341_cov_9.756198	117	196	4	32	79	0.4050633
NODE_120757_length_341_cov_9.756198	117	196	5	11	79	0.1392405
NODE_120757_length_341_cov_9.756198	117	196	6	4	79	0.0506329
NODE_120770_length_341_cov_5.404959	141	220	0	21	79	0.2658228
NODE_120770_length_341_cov_5.404959	141	220	1	3	79	0.0379747
NODE_120770_length_341_cov_5.404959	141	220	3	3	79	0.0379747
NODE_120770_length_341_cov_5.404959	141	220	4	15	79	0.1898734
NODE_120770_length_341_cov_5.404959	141	220	6	11	79	0.1392405
NODE_120770_length_341_cov_5.404959	141	220	7	12	79	0.1518987
NODE_120770_length_341_cov_5.404959	141	220	8	7	79	0.0886076
NODE_120770_length_341_cov_5.404959	141	220	10	3	79	0.0379747
NODE_120770_length_341_cov_5.404959	141	220	11	3	79	0.0379747
NODE_120770_length_341_cov_5.404959	141	220	13	1	79	0.0126582
NODE_120780_length_341_cov_4.669421	301	320	0	19	19	1.0000000
NODE_120783_length_341_cov_4.438017	57	132	0	75	75	1.0000000
NODE_120783_length_341_cov_4.438017	110	185	0	74	75	0.9866667
NODE_120783_length_341_cov_4.438017	110	185	2	1	75	0.0133333
NODE_120785_length_341_cov_4.400826	164	244	2	80	80	1.0000000
NODE_120785_length_341_cov_4.400826	224	297	1	11	73	0.1506849
NODE_120785_length_341_cov_4.400826	224	297	2	62	73	0.8493150
NODE_120797_length_341_cov_3.896694	58	122	1	8	64	0.1250000
NODE_120797_length_341_cov_3.896694	58	122	2	5	64	0.0781250
NODE_120797_length_341_cov_3.896694	58	122	3	4	64	0.0625000
NODE_120797_length_341_cov_3.896694	58	122	4	6	64	0.0937500
NODE_120797_length_341_cov_3.896694	58	122	5	3	64	0.0468750
NODE_120797_length_341_cov_3.896694	58	122	6	15	64	0.2343750
NODE_120797_length_341_cov_3.896694	58	122	7	4	64	0.0625000
NODE_120797_length_341_cov_3.896694	58	122	9	2	64	0.0312500
NODE_120797_length_341_cov_3.896694	58	122	10	2	64	0.0312500
NODE_120797_length_341_cov_3.896694	58	122	12	1	64	0.0156250
NODE_120797_length_341_cov_3.896694	58	122	13	1	64	0.0156250
NODE_120797_length_341_cov_3.896694	58	122	15	1	64	0.0156250
NODE_120797_length_341_cov_3.896694	58	122	18	1	64	0.0156250
NODE_120797_length_341_cov_3.896694	58	122	19	1	64	0.0156250
NODE_120797_length_341_cov_3.896694	58	122	20	1	64	0.0156250
NODE_120797_length_341_cov_3.896694	58	122	23	2	64	0.0312500
NODE_120797_length_341_cov_3.896694	58	122	25	3	64	0.0468750
NODE_120797_length_341_cov_3.896694	58	122	26	4	64	0.0625000
NODE_120805_length_341_cov_3.727273	191	273	11	55	82	0.6707317
NODE_120805_length_341_cov_3.727273	191	273	12	20	82	0.2439024
NODE_120805_length_341_cov_3.727273	191	273	14	7	82	0.0853659
NODE_120805_length_341_cov_3.727273	253	326	4	15	73	0.2054795
NODE_120805_length_341_cov_3.727273	253	326	5	13	73	0.1780822
NODE_120805_length_341_cov_3.727273	253	326	6	9	73	0.1232877
NODE_120805_length_341_cov_3.727273	253	326	7	2	73	0.0273973
NODE_120805_length_341_cov_3.727273	253	326	8	4	73	0.0547945
NODE_120805_length_341_cov_3.727273	253	326	9	9	73	0.1232877
NODE_120805_length_341_cov_3.727273	253	326	11	21	73	0.2876712
NODE_120839_length_341_cov_3.000000	91	161	2	70	70	1.0000000
NODE_120839_length_341_cov_3.000000	146	215	0	38	69	0.5507246
NODE_120839_length_341_cov_3.000000	146	215	2	31	69	0.4492754
NODE_120840_length_341_cov_3.000000	127	207	0	11	80	0.1375000
NODE_120840_length_341_cov_3.000000	127	207	1	1	80	0.0125000
NODE_120840_length_341_cov_3.000000	127	207	2	68	80	0.8500000
NODE_120892_length_341_cov_2.533058	92	172	2	80	80	1.0000000
NODE_120901_length_341_cov_2.495868	8	89	0	21	81	0.2592593
NODE_120901_length_341_cov_2.495868	8	89	1	48	81	0.5925926
NODE_120901_length_341_cov_2.495868	8	89	2	3	81	0.0370370
NODE_120901_length_341_cov_2.495868	8	89	3	2	81	0.0246914
NODE_120901_length_341_cov_2.495868	8	89	5	2	81	0.0246914
NODE_120901_length_341_cov_2.495868	8	89	8	1	81	0.0123457
NODE_120901_length_341_cov_2.495868	8	89	9	4	81	0.0493827
NODE_120946_length_341_cov_2.235537	10	90	0	80	80	1.0000000
NODE_120972_length_341_cov_2.103306	46	125	0	22	79	0.2784810
NODE_120972_length_341_cov_2.103306	46	125	2	57	79	0.7215190
NODE_120994_length_341_cov_2.066116	147	184	5	3	37	0.0810811
NODE_120994_length_341_cov_2.066116	147	184	7	34	37	0.9189189
NODE_121052_length_341_cov_1.772727	179	250	0	71	71	1.0000000
NODE_121064_length_341_cov_1.727273	105	185	0	80	80	1.0000000
NODE_121160_length_341_cov_1.475207	120	185	1	65	65	1.0000000
NODE_121160_length_341_cov_1.475207	158	238	0	6	80	0.0750000
NODE_121160_length_341_cov_1.475207	158	238	1	74	80	0.9250000
NODE_121173_length_341_cov_1.471074	186	266	1	6	80	0.0750000
NODE_121173_length_341_cov_1.471074	186	266	2	19	80	0.2375000
NODE_121173_length_341_cov_1.471074	186	266	3	1	80	0.0125000
NODE_121173_length_341_cov_1.471074	186	266	4	2	80	0.0250000
NODE_121173_length_341_cov_1.471074	186	266	5	5	80	0.0625000
NODE_121173_length_341_cov_1.471074	186	266	6	47	80	0.5875000
NODE_121173_length_341_cov_1.471074	239	319	5	41	80	0.5125000
NODE_121173_length_341_cov_1.471074	239	319	6	39	80	0.4875000
NODE_121211_length_341_cov_1.342975	284	322	0	38	38	1.0000000
NODE_121431_length_341_cov_0.991736	36	89	3	18	53	0.3396226
NODE_121431_length_341_cov_0.991736	36	89	4	35	53	0.6603774
NODE_121693_length_340_cov_541.348548	86	144	519	2	58	0.0344828
NODE_121693_length_340_cov_541.348548	86	144	521	1	58	0.0172414
NODE_121693_length_340_cov_541.348548	86	144	526	1	58	0.0172414
NODE_121693_length_340_cov_541.348548	86	144	538	1	58	0.0172414
NODE_121693_length_340_cov_541.348548	86	144	542	1	58	0.0172414
NODE_121693_length_340_cov_541.348548	86	144	548	1	58	0.0172414
NODE_121693_length_340_cov_541.348548	86	144	554	1	58	0.0172414
NODE_121693_length_340_cov_541.348548	86	144	561	1	58	0.0172414
NODE_121693_length_340_cov_541.348548	86	144	572	1	58	0.0172414
NODE_121693_length_340_cov_541.348548	86	144	581	1	58	0.0172414
NODE_121693_length_340_cov_541.348548	86	144	591	1	58	0.0172414
NODE_121693_length_340_cov_541.348548	86	144	598	1	58	0.0172414
NODE_121693_length_340_cov_541.348548	86	144	609	1	58	0.0172414
NODE_121693_length_340_cov_541.348548	86	144	614	1	58	0.0172414
NODE_121693_length_340_cov_541.348548	86	144	623	1	58	0.0172414
NODE_121693_length_340_cov_541.348548	86	144	624	1	58	0.0172414
NODE_121693_length_340_cov_541.348548	86	144	628	1	58	0.0172414
NODE_121693_length_340_cov_541.348548	86	144	632	1	58	0.0172414
NODE_121693_length_340_cov_541.348548	86	144	643	1	58	0.0172414
NODE_121693_length_340_cov_541.348548	86	144	650	1	58	0.0172414
NODE_121693_length_340_cov_541.348548	86	144	657	1	58	0.0172414
NODE_121693_length_340_cov_541.348548	86	144	659	1	58	0.0172414
NODE_121693_length_340_cov_541.348548	86	144	669	1	58	0.0172414
NODE_121693_length_340_cov_541.348548	86	144	672	1	58	0.0172414
NODE_121693_length_340_cov_541.348548	86	144	676	1	58	0.0172414
NODE_121693_length_340_cov_541.348548	86	144	683	1	58	0.0172414
NODE_121693_length_340_cov_541.348548	86	144	684	1	58	0.0172414
NODE_121693_length_340_cov_541.348548	86	144	696	1	58	0.0172414
NODE_121693_length_340_cov_541.348548	86	144	699	1	58	0.0172414
NODE_121693_length_340_cov_541.348548	86	144	706	1	58	0.0172414
NODE_121693_length_340_cov_541.348548	86	144	715	1	58	0.0172414
NODE_121693_length_340_cov_541.348548	86	144	720	1	58	0.0172414
NODE_121693_length_340_cov_541.348548	86	144	726	1	58	0.0172414
NODE_121693_length_340_cov_541.348548	86	144	740	1	58	0.0172414
NODE_121693_length_340_cov_541.348548	86	144	742	2	58	0.0344828
NODE_121693_length_340_cov_541.348548	86	144	744	1	58	0.0172414
NODE_121693_length_340_cov_541.348548	86	144	753	1	58	0.0172414
NODE_121693_length_340_cov_541.348548	86	144	758	1	58	0.0172414
NODE_121693_length_340_cov_541.348548	86	144	761	1	58	0.0172414
NODE_121693_length_340_cov_541.348548	86	144	765	1	58	0.0172414
NODE_121693_length_340_cov_541.348548	86	144	769	1	58	0.0172414
NODE_121693_length_340_cov_541.348548	86	144	778	1	58	0.0172414
NODE_121693_length_340_cov_541.348548	86	144	780	1	58	0.0172414
NODE_121693_length_340_cov_541.348548	86	144	783	1	58	0.0172414
NODE_121693_length_340_cov_541.348548	86	144	785	1	58	0.0172414
NODE_121693_length_340_cov_541.348548	86	144	786	1	58	0.0172414
NODE_121693_length_340_cov_541.348548	86	144	787	2	58	0.0344828
NODE_121693_length_340_cov_541.348548	86	144	791	1	58	0.0172414
NODE_121693_length_340_cov_541.348548	86	144	798	1	58	0.0172414
NODE_121693_length_340_cov_541.348548	86	144	801	1	58	0.0172414
NODE_121693_length_340_cov_541.348548	86	144	804	1	58	0.0172414
NODE_121693_length_340_cov_541.348548	86	144	809	1	58	0.0172414
NODE_121693_length_340_cov_541.348548	86	144	810	1	58	0.0172414
NODE_121693_length_340_cov_541.348548	86	144	811	1	58	0.0172414
NODE_121693_length_340_cov_541.348548	86	144	813	1	58	0.0172414
NODE_121693_length_340_cov_541.348548	86	154	519	2	68	0.0294118
NODE_121693_length_340_cov_541.348548	86	154	521	1	68	0.0147059
NODE_121693_length_340_cov_541.348548	86	154	526	1	68	0.0147059
NODE_121693_length_340_cov_541.348548	86	154	538	1	68	0.0147059
NODE_121693_length_340_cov_541.348548	86	154	542	1	68	0.0147059
NODE_121693_length_340_cov_541.348548	86	154	548	1	68	0.0147059
NODE_121693_length_340_cov_541.348548	86	154	554	1	68	0.0147059
NODE_121693_length_340_cov_541.348548	86	154	561	1	68	0.0147059
NODE_121693_length_340_cov_541.348548	86	154	572	1	68	0.0147059
NODE_121693_length_340_cov_541.348548	86	154	581	1	68	0.0147059
NODE_121693_length_340_cov_541.348548	86	154	591	1	68	0.0147059
NODE_121693_length_340_cov_541.348548	86	154	598	1	68	0.0147059
NODE_121693_length_340_cov_541.348548	86	154	609	1	68	0.0147059
NODE_121693_length_340_cov_541.348548	86	154	614	1	68	0.0147059
NODE_121693_length_340_cov_541.348548	86	154	623	1	68	0.0147059
NODE_121693_length_340_cov_541.348548	86	154	624	1	68	0.0147059
NODE_121693_length_340_cov_541.348548	86	154	628	1	68	0.0147059
NODE_121693_length_340_cov_541.348548	86	154	632	1	68	0.0147059
NODE_121693_length_340_cov_541.348548	86	154	643	1	68	0.0147059
NODE_121693_length_340_cov_541.348548	86	154	650	1	68	0.0147059
NODE_121693_length_340_cov_541.348548	86	154	657	1	68	0.0147059
NODE_121693_length_340_cov_541.348548	86	154	659	1	68	0.0147059
NODE_121693_length_340_cov_541.348548	86	154	669	1	68	0.0147059
NODE_121693_length_340_cov_541.348548	86	154	672	1	68	0.0147059
NODE_121693_length_340_cov_541.348548	86	154	676	1	68	0.0147059
NODE_121693_length_340_cov_541.348548	86	154	683	1	68	0.0147059
NODE_121693_length_340_cov_541.348548	86	154	684	1	68	0.0147059
NODE_121693_length_340_cov_541.348548	86	154	696	1	68	0.0147059
NODE_121693_length_340_cov_541.348548	86	154	699	1	68	0.0147059
NODE_121693_length_340_cov_541.348548	86	154	706	1	68	0.0147059
NODE_121693_length_340_cov_541.348548	86	154	715	1	68	0.0147059
NODE_121693_length_340_cov_541.348548	86	154	720	1	68	0.0147059
NODE_121693_length_340_cov_541.348548	86	154	726	1	68	0.0147059
NODE_121693_length_340_cov_541.348548	86	154	740	1	68	0.0147059
NODE_121693_length_340_cov_541.348548	86	154	742	2	68	0.0294118
NODE_121693_length_340_cov_541.348548	86	154	744	1	68	0.0147059
NODE_121693_length_340_cov_541.348548	86	154	753	1	68	0.0147059
NODE_121693_length_340_cov_541.348548	86	154	758	1	68	0.0147059
NODE_121693_length_340_cov_541.348548	86	154	761	1	68	0.0147059
NODE_121693_length_340_cov_541.348548	86	154	765	1	68	0.0147059
NODE_121693_length_340_cov_541.348548	86	154	769	1	68	0.0147059
NODE_121693_length_340_cov_541.348548	86	154	778	1	68	0.0147059
NODE_121693_length_340_cov_541.348548	86	154	780	1	68	0.0147059
NODE_121693_length_340_cov_541.348548	86	154	783	1	68	0.0147059
NODE_121693_length_340_cov_541.348548	86	154	785	1	68	0.0147059
NODE_121693_length_340_cov_541.348548	86	154	786	1	68	0.0147059
NODE_121693_length_340_cov_541.348548	86	154	787	2	68	0.0294118
NODE_121693_length_340_cov_541.348548	86	154	791	1	68	0.0147059
NODE_121693_length_340_cov_541.348548	86	154	798	1	68	0.0147059
NODE_121693_length_340_cov_541.348548	86	154	801	1	68	0.0147059
NODE_121693_length_340_cov_541.348548	86	154	802	2	68	0.0294118
NODE_121693_length_340_cov_541.348548	86	154	803	2	68	0.0294118
NODE_121693_length_340_cov_541.348548	86	154	804	2	68	0.0294118
NODE_121693_length_340_cov_541.348548	86	154	808	2	68	0.0294118
NODE_121693_length_340_cov_541.348548	86	154	809	2	68	0.0294118
NODE_121693_length_340_cov_541.348548	86	154	810	1	68	0.0147059
NODE_121693_length_340_cov_541.348548	86	154	811	1	68	0.0147059
NODE_121693_length_340_cov_541.348548	86	154	813	2	68	0.0294118
NODE_121693_length_340_cov_541.348548	86	154	819	1	68	0.0147059
NODE_121693_length_340_cov_541.348548	86	107	519	2	21	0.0952381
NODE_121693_length_340_cov_541.348548	86	107	521	1	21	0.0476190
NODE_121693_length_340_cov_541.348548	86	107	526	1	21	0.0476190
NODE_121693_length_340_cov_541.348548	86	107	538	1	21	0.0476190
NODE_121693_length_340_cov_541.348548	86	107	542	1	21	0.0476190
NODE_121693_length_340_cov_541.348548	86	107	548	1	21	0.0476190
NODE_121693_length_340_cov_541.348548	86	107	554	1	21	0.0476190
NODE_121693_length_340_cov_541.348548	86	107	561	1	21	0.0476190
NODE_121693_length_340_cov_541.348548	86	107	572	1	21	0.0476190
NODE_121693_length_340_cov_541.348548	86	107	581	1	21	0.0476190
NODE_121693_length_340_cov_541.348548	86	107	591	1	21	0.0476190
NODE_121693_length_340_cov_541.348548	86	107	598	1	21	0.0476190
NODE_121693_length_340_cov_541.348548	86	107	609	1	21	0.0476190
NODE_121693_length_340_cov_541.348548	86	107	614	1	21	0.0476190
NODE_121693_length_340_cov_541.348548	86	107	623	1	21	0.0476190
NODE_121693_length_340_cov_541.348548	86	107	624	1	21	0.0476190
NODE_121693_length_340_cov_541.348548	86	107	628	1	21	0.0476190
NODE_121693_length_340_cov_541.348548	86	107	632	1	21	0.0476190
NODE_121693_length_340_cov_541.348548	86	107	643	1	21	0.0476190
NODE_121693_length_340_cov_541.348548	86	107	650	1	21	0.0476190
NODE_121694_length_340_cov_50.755187	196	266	24	16	70	0.2285714
NODE_121694_length_340_cov_50.755187	196	266	25	3	70	0.0428571
NODE_121694_length_340_cov_50.755187	196	266	26	4	70	0.0571429
NODE_121694_length_340_cov_50.755187	196	266	27	5	70	0.0714286
NODE_121694_length_340_cov_50.755187	196	266	28	21	70	0.3000000
NODE_121694_length_340_cov_50.755187	196	266	29	8	70	0.1142857
NODE_121694_length_340_cov_50.755187	196	266	30	3	70	0.0428571
NODE_121694_length_340_cov_50.755187	196	266	31	10	70	0.1428571
NODE_121696_length_340_cov_8.917012	240	270	5	30	30	1.0000000
NODE_121696_length_340_cov_8.917012	243	315	2	18	72	0.2500000
NODE_121696_length_340_cov_8.917012	243	315	3	1	72	0.0138889
NODE_121696_length_340_cov_8.917012	243	315	4	21	72	0.2916667
NODE_121696_length_340_cov_8.917012	243	315	5	32	72	0.4444444
NODE_121702_length_340_cov_6.439834	175	255	0	80	80	1.0000000
NODE_121702_length_340_cov_6.439834	228	310	0	82	82	1.0000000
NODE_121708_length_340_cov_5.883817	72	121	0	49	49	1.0000000
NODE_121708_length_340_cov_5.883817	82	113	0	31	31	1.0000000
NODE_121714_length_340_cov_5.228216	116	186	0	24	70	0.3428572
NODE_121714_length_340_cov_5.228216	116	186	1	36	70	0.5142857
NODE_121714_length_340_cov_5.228216	116	186	2	10	70	0.1428571
NODE_121714_length_340_cov_5.228216	159	201	1	17	42	0.4047619
NODE_121714_length_340_cov_5.228216	159	201	2	25	42	0.5952381
NODE_121730_length_340_cov_4.497925	136	184	0	48	48	1.0000000
NODE_121752_length_340_cov_3.759336	88	169	0	81	81	1.0000000
NODE_121849_length_340_cov_2.506224	68	114	0	46	46	1.0000000
NODE_121951_length_340_cov_1.995851	29	101	0	72	72	1.0000000
NODE_121951_length_340_cov_1.995851	96	143	0	19	47	0.4042553
NODE_121951_length_340_cov_1.995851	96	143	2	1	47	0.0212766
NODE_121951_length_340_cov_1.995851	96	143	3	27	47	0.5744681
NODE_122154_length_340_cov_1.427386	244	274	0	30	30	1.0000000
NODE_122218_length_340_cov_1.282158	71	135	3	13	64	0.2031250
NODE_122218_length_340_cov_1.282158	71	135	5	51	64	0.7968750
NODE_122218_length_340_cov_1.282158	128	188	2	28	60	0.4666667
NODE_122218_length_340_cov_1.282158	128	188	3	15	60	0.2500000
NODE_122218_length_340_cov_1.282158	128	188	4	9	60	0.1500000
NODE_122218_length_340_cov_1.282158	128	188	5	8	60	0.1333333
NODE_122218_length_340_cov_1.282158	142	189	2	29	47	0.6170213
NODE_122218_length_340_cov_1.282158	142	189	3	15	47	0.3191489
NODE_122218_length_340_cov_1.282158	142	189	4	3	47	0.0638298
NODE_122220_length_340_cov_1.278008	51	102	0	51	51	1.0000000
NODE_122321_length_340_cov_1.199170	98	160	1	62	62	1.0000000
NODE_122381_length_340_cov_1.070539	32	65	0	33	33	1.0000000
NODE_122429_length_340_cov_1.020747	209	228	0	4	19	0.2105263
NODE_122429_length_340_cov_1.020747	209	228	1	15	19	0.7894737
NODE_122686_length_339_cov_87.841667	149	227	246	3	78	0.0384615
NODE_122686_length_339_cov_87.841667	149	227	247	3	78	0.0384615
NODE_122686_length_339_cov_87.841667	149	227	248	1	78	0.0128205
NODE_122686_length_339_cov_87.841667	149	227	249	1	78	0.0128205
NODE_122686_length_339_cov_87.841667	149	227	250	1	78	0.0128205
NODE_122686_length_339_cov_87.841667	149	227	252	2	78	0.0256410
NODE_122686_length_339_cov_87.841667	149	227	253	1	78	0.0128205
NODE_122686_length_339_cov_87.841667	149	227	255	1	78	0.0128205
NODE_122686_length_339_cov_87.841667	149	227	256	1	78	0.0128205
NODE_122686_length_339_cov_87.841667	149	227	257	2	78	0.0256410
NODE_122686_length_339_cov_87.841667	149	227	258	2	78	0.0256410
NODE_122686_length_339_cov_87.841667	149	227	259	3	78	0.0384615
NODE_122686_length_339_cov_87.841667	149	227	260	3	78	0.0384615
NODE_122686_length_339_cov_87.841667	149	227	261	1	78	0.0128205
NODE_122686_length_339_cov_87.841667	149	227	262	1	78	0.0128205
NODE_122686_length_339_cov_87.841667	149	227	263	1	78	0.0128205
NODE_122686_length_339_cov_87.841667	149	227	264	2	78	0.0256410
NODE_122686_length_339_cov_87.841667	149	227	265	2	78	0.0256410
NODE_122686_length_339_cov_87.841667	149	227	266	2	78	0.0256410
NODE_122686_length_339_cov_87.841667	149	227	267	3	78	0.0384615
NODE_122686_length_339_cov_87.841667	149	227	268	1	78	0.0128205
NODE_122686_length_339_cov_87.841667	149	227	269	1	78	0.0128205
NODE_122686_length_339_cov_87.841667	149	227	270	2	78	0.0256410
NODE_122686_length_339_cov_87.841667	149	227	272	2	78	0.0256410
NODE_122686_length_339_cov_87.841667	149	227	273	2	78	0.0256410
NODE_122686_length_339_cov_87.841667	149	227	278	3	78	0.0384615
NODE_122686_length_339_cov_87.841667	149	227	280	1	78	0.0128205
NODE_122686_length_339_cov_87.841667	149	227	282	3	78	0.0384615
NODE_122686_length_339_cov_87.841667	149	227	283	2	78	0.0256410
NODE_122686_length_339_cov_87.841667	149	227	284	4	78	0.0512821
NODE_122686_length_339_cov_87.841667	149	227	285	3	78	0.0384615
NODE_122686_length_339_cov_87.841667	149	227	286	4	78	0.0512821
NODE_122686_length_339_cov_87.841667	149	227	287	1	78	0.0128205
NODE_122686_length_339_cov_87.841667	149	227	288	6	78	0.0769231
NODE_122686_length_339_cov_87.841667	149	227	289	3	78	0.0384615
NODE_122686_length_339_cov_87.841667	149	227	290	4	78	0.0512821
NODE_122687_length_339_cov_14.304167	69	138	0	69	69	1.0000000
NODE_122687_length_339_cov_14.304167	69	138	0	69	69	1.0000000
NODE_122687_length_339_cov_14.304167	69	138	0	69	69	1.0000000
NODE_122687_length_339_cov_14.304167	88	138	0	50	50	1.0000000
NODE_122687_length_339_cov_14.304167	111	160	0	49	49	1.0000000
NODE_122727_length_339_cov_4.320833	187	267	3	6	80	0.0750000
NODE_122727_length_339_cov_4.320833	187	267	4	74	80	0.9250000
NODE_122804_length_339_cov_2.754167	45	125	0	80	80	1.0000000
NODE_122971_length_339_cov_1.841667	265	312	2	47	47	1.0000000
NODE_123041_length_339_cov_1.662500	10	57	0	47	47	1.0000000
NODE_123182_length_339_cov_1.275000	247	312	0	65	65	1.0000000
NODE_123285_length_339_cov_1.070833	147	169	1	22	22	1.0000000
NODE_123633_length_338_cov_57.163180	59	120	0	61	61	1.0000000
NODE_123633_length_338_cov_57.163180	102	176	0	74	74	1.0000000
NODE_123674_length_338_cov_4.263598	113	165	0	52	52	1.0000000
NODE_123679_length_338_cov_4.079498	96	151	0	55	55	1.0000000
NODE_123689_length_338_cov_3.841004	122	149	0	12	27	0.4444444
NODE_123689_length_338_cov_3.841004	122	149	1	15	27	0.5555556
NODE_123793_length_338_cov_2.393305	216	288	0	72	72	1.0000000
NODE_123795_length_338_cov_2.380753	29	93	0	64	64	1.0000000
NODE_123919_length_338_cov_1.878661	146	232	0	36	86	0.4186046
NODE_123919_length_338_cov_1.878661	146	232	1	11	86	0.1279070
NODE_123919_length_338_cov_1.878661	146	232	2	8	86	0.0930233
NODE_123919_length_338_cov_1.878661	146	232	3	7	86	0.0813954
NODE_123919_length_338_cov_1.878661	146	232	4	24	86	0.2790698
NODE_123944_length_338_cov_1.740586	79	159	3	36	80	0.4500000
NODE_123944_length_338_cov_1.740586	79	159	4	44	80	0.5500000
NODE_123946_length_338_cov_1.732218	216	257	0	41	41	1.0000000
NODE_124046_length_338_cov_1.493724	14	90	0	76	76	1.0000000
NODE_124247_length_338_cov_1.100418	265	333	2	68	68	1.0000000
NODE_124456_length_338_cov_0.849372	281	338	0	57	57	1.0000000
NODE_124533_length_338_cov_0.711297	188	263	5	11	75	0.1466667
NODE_124533_length_338_cov_0.711297	188	263	7	13	75	0.1733333
NODE_124533_length_338_cov_0.711297	188	263	8	7	75	0.0933333
NODE_124533_length_338_cov_0.711297	188	263	9	28	75	0.3733333
NODE_124533_length_338_cov_0.711297	188	263	10	16	75	0.2133333
NODE_124625_length_337_cov_468.180672	107	187	66	7	80	0.0875000
NODE_124625_length_337_cov_468.180672	107	187	67	11	80	0.1375000
NODE_124625_length_337_cov_468.180672	107	187	68	11	80	0.1375000
NODE_124625_length_337_cov_468.180672	107	187	69	35	80	0.4375000
NODE_124625_length_337_cov_468.180672	107	187	70	10	80	0.1250000
NODE_124625_length_337_cov_468.180672	107	187	71	3	80	0.0375000
NODE_124625_length_337_cov_468.180672	107	187	72	3	80	0.0375000
NODE_124625_length_337_cov_468.180672	160	230	48	2	70	0.0285714
NODE_124625_length_337_cov_468.180672	160	230	49	4	70	0.0571429
NODE_124625_length_337_cov_468.180672	160	230	51	1	70	0.0142857
NODE_124625_length_337_cov_468.180672	160	230	52	1	70	0.0142857
NODE_124625_length_337_cov_468.180672	160	230	53	1	70	0.0142857
NODE_124625_length_337_cov_468.180672	160	230	54	5	70	0.0714286
NODE_124625_length_337_cov_468.180672	160	230	55	1	70	0.0142857
NODE_124625_length_337_cov_468.180672	160	230	56	11	70	0.1571429
NODE_124625_length_337_cov_468.180672	160	230	57	2	70	0.0285714
NODE_124625_length_337_cov_468.180672	160	230	58	2	70	0.0285714
NODE_124625_length_337_cov_468.180672	160	230	60	2	70	0.0285714
NODE_124625_length_337_cov_468.180672	160	230	61	4	70	0.0571429
NODE_124625_length_337_cov_468.180672	160	230	63	1	70	0.0142857
NODE_124625_length_337_cov_468.180672	160	230	64	3	70	0.0428571
NODE_124625_length_337_cov_468.180672	160	230	65	1	70	0.0142857
NODE_124625_length_337_cov_468.180672	160	230	66	7	70	0.1000000
NODE_124625_length_337_cov_468.180672	160	230	67	2	70	0.0285714
NODE_124625_length_337_cov_468.180672	160	230	68	4	70	0.0571429
NODE_124625_length_337_cov_468.180672	160	230	69	11	70	0.1571429
NODE_124625_length_337_cov_468.180672	160	230	70	3	70	0.0428571
NODE_124625_length_337_cov_468.180672	160	230	71	2	70	0.0285714
NODE_124625_length_337_cov_468.180672	226	306	37	9	80	0.1125000
NODE_124625_length_337_cov_468.180672	226	306	38	4	80	0.0500000
NODE_124625_length_337_cov_468.180672	226	306	39	1	80	0.0125000
NODE_124625_length_337_cov_468.180672	226	306	40	3	80	0.0375000
NODE_124625_length_337_cov_468.180672	226	306	41	3	80	0.0375000
NODE_124625_length_337_cov_468.180672	226	306	42	7	80	0.0875000
NODE_124625_length_337_cov_468.180672	226	306	43	11	80	0.1375000
NODE_124625_length_337_cov_468.180672	226	306	44	1	80	0.0125000
NODE_124625_length_337_cov_468.180672	226	306	45	6	80	0.0750000
NODE_124625_length_337_cov_468.180672	226	306	46	8	80	0.1000000
NODE_124625_length_337_cov_468.180672	226	306	47	1	80	0.0125000
NODE_124625_length_337_cov_468.180672	226	306	48	13	80	0.1625000
NODE_124625_length_337_cov_468.180672	226	306	50	3	80	0.0375000
NODE_124625_length_337_cov_468.180672	226	306	52	2	80	0.0250000
NODE_124625_length_337_cov_468.180672	226	306	54	7	80	0.0875000
NODE_124625_length_337_cov_468.180672	226	306	57	1	80	0.0125000
NODE_124625_length_337_cov_468.180672	279	337	16	2	58	0.0344828
NODE_124625_length_337_cov_468.180672	279	337	17	1	58	0.0172414
NODE_124625_length_337_cov_468.180672	279	337	18	2	58	0.0344828
NODE_124625_length_337_cov_468.180672	279	337	19	2	58	0.0344828
NODE_124625_length_337_cov_468.180672	279	337	20	2	58	0.0344828
NODE_124625_length_337_cov_468.180672	279	337	21	1	58	0.0172414
NODE_124625_length_337_cov_468.180672	279	337	22	1	58	0.0172414
NODE_124625_length_337_cov_468.180672	279	337	23	1	58	0.0172414
NODE_124625_length_337_cov_468.180672	279	337	24	3	58	0.0517241
NODE_124625_length_337_cov_468.180672	279	337	25	1	58	0.0172414
NODE_124625_length_337_cov_468.180672	279	337	27	1	58	0.0172414
NODE_124625_length_337_cov_468.180672	279	337	28	1	58	0.0172414
NODE_124625_length_337_cov_468.180672	279	337	30	1	58	0.0172414
NODE_124625_length_337_cov_468.180672	279	337	32	2	58	0.0344828
NODE_124625_length_337_cov_468.180672	279	337	33	1	58	0.0172414
NODE_124625_length_337_cov_468.180672	279	337	34	7	58	0.1206897
NODE_124625_length_337_cov_468.180672	279	337	36	1	58	0.0172414
NODE_124625_length_337_cov_468.180672	279	337	37	10	58	0.1724138
NODE_124625_length_337_cov_468.180672	279	337	38	4	58	0.0689655
NODE_124625_length_337_cov_468.180672	279	337	39	1	58	0.0172414
NODE_124625_length_337_cov_468.180672	279	337	40	3	58	0.0517241
NODE_124625_length_337_cov_468.180672	279	337	41	3	58	0.0517241
NODE_124625_length_337_cov_468.180672	279	337	42	7	58	0.1206897
NODE_124626_length_337_cov_91.344538	1	50	6	3	49	0.0612245
NODE_124626_length_337_cov_91.344538	1	50	7	2	49	0.0408163
NODE_124626_length_337_cov_91.344538	1	50	9	3	49	0.0612245
NODE_124626_length_337_cov_91.344538	1	50	11	3	49	0.0612245
NODE_124626_length_337_cov_91.344538	1	50	12	4	49	0.0816327
NODE_124626_length_337_cov_91.344538	1	50	13	3	49	0.0612245
NODE_124626_length_337_cov_91.344538	1	50	14	12	49	0.2448980
NODE_124626_length_337_cov_91.344538	1	50	15	7	49	0.1428571
NODE_124626_length_337_cov_91.344538	1	50	18	1	49	0.0204082
NODE_124626_length_337_cov_91.344538	1	50	19	1	49	0.0204082
NODE_124626_length_337_cov_91.344538	1	50	22	2	49	0.0408163
NODE_124626_length_337_cov_91.344538	1	50	24	1	49	0.0204082
NODE_124626_length_337_cov_91.344538	1	50	28	2	49	0.0408163
NODE_124626_length_337_cov_91.344538	1	50	29	2	49	0.0408163
NODE_124626_length_337_cov_91.344538	1	50	30	3	49	0.0612245
NODE_124626_length_337_cov_91.344538	23	103	14	8	80	0.1000000
NODE_124626_length_337_cov_91.344538	23	103	15	7	80	0.0875000
NODE_124626_length_337_cov_91.344538	23	103	18	1	80	0.0125000
NODE_124626_length_337_cov_91.344538	23	103	19	1	80	0.0125000
NODE_124626_length_337_cov_91.344538	23	103	22	2	80	0.0250000
NODE_124626_length_337_cov_91.344538	23	103	24	1	80	0.0125000
NODE_124626_length_337_cov_91.344538	23	103	28	2	80	0.0250000
NODE_124626_length_337_cov_91.344538	23	103	29	2	80	0.0250000
NODE_124626_length_337_cov_91.344538	23	103	30	6	80	0.0750000
NODE_124626_length_337_cov_91.344538	23	103	31	1	80	0.0125000
NODE_124626_length_337_cov_91.344538	23	103	32	3	80	0.0375000
NODE_124626_length_337_cov_91.344538	23	103	33	2	80	0.0250000
NODE_124626_length_337_cov_91.344538	23	103	35	1	80	0.0125000
NODE_124626_length_337_cov_91.344538	23	103	36	2	80	0.0250000
NODE_124626_length_337_cov_91.344538	23	103	37	2	80	0.0250000
NODE_124626_length_337_cov_91.344538	23	103	38	3	80	0.0375000
NODE_124626_length_337_cov_91.344538	23	103	39	3	80	0.0375000
NODE_124626_length_337_cov_91.344538	23	103	40	1	80	0.0125000
NODE_124626_length_337_cov_91.344538	23	103	43	1	80	0.0125000
NODE_124626_length_337_cov_91.344538	23	103	44	2	80	0.0250000
NODE_124626_length_337_cov_91.344538	23	103	45	2	80	0.0250000
NODE_124626_length_337_cov_91.344538	23	103	47	2	80	0.0250000
NODE_124626_length_337_cov_91.344538	23	103	48	2	80	0.0250000
NODE_124626_length_337_cov_91.344538	23	103	49	2	80	0.0250000
NODE_124626_length_337_cov_91.344538	23	103	50	3	80	0.0375000
NODE_124626_length_337_cov_91.344538	23	103	51	2	80	0.0250000
NODE_124626_length_337_cov_91.344538	23	103	53	2	80	0.0250000
NODE_124626_length_337_cov_91.344538	23	103	54	1	80	0.0125000
NODE_124626_length_337_cov_91.344538	23	103	56	1	80	0.0125000
NODE_124626_length_337_cov_91.344538	23	103	60	2	80	0.0250000
NODE_124626_length_337_cov_91.344538	23	103	62	4	80	0.0500000
NODE_124626_length_337_cov_91.344538	23	103	63	2	80	0.0250000
NODE_124626_length_337_cov_91.344538	23	103	64	1	80	0.0125000
NODE_124626_length_337_cov_91.344538	23	103	65	3	80	0.0375000
NODE_124627_length_337_cov_73.352941	71	151	0	13	80	0.1625000
NODE_124627_length_337_cov_73.352941	71	151	2	67	80	0.8375000
NODE_124627_length_337_cov_73.352941	124	204	0	66	80	0.8250000
NODE_124627_length_337_cov_73.352941	124	204	2	14	80	0.1750000
NODE_124629_length_337_cov_46.978992	220	305	4	85	85	1.0000000
NODE_124629_length_337_cov_46.978992	220	305	4	85	85	1.0000000
NODE_124629_length_337_cov_46.978992	220	305	4	85	85	1.0000000
NODE_124629_length_337_cov_46.978992	278	327	2	6	49	0.1224490
NODE_124629_length_337_cov_46.978992	278	327	4	43	49	0.8775510
NODE_124629_length_337_cov_46.978992	278	337	2	16	59	0.2711864
NODE_124629_length_337_cov_46.978992	278	337	4	43	59	0.7288136
NODE_124629_length_337_cov_46.978992	283	337	2	16	54	0.2962963
NODE_124629_length_337_cov_46.978992	283	337	4	38	54	0.7037037
NODE_124640_length_337_cov_6.214286	52	95	0	43	43	1.0000000
NODE_124669_length_337_cov_4.298319	5	58	0	53	53	1.0000000
NODE_124703_length_337_cov_3.478992	179	259	33	4	80	0.0500000
NODE_124703_length_337_cov_3.478992	179	259	35	4	80	0.0500000
NODE_124703_length_337_cov_3.478992	179	259	36	3	80	0.0375000
NODE_124703_length_337_cov_3.478992	179	259	37	16	80	0.2000000
NODE_124703_length_337_cov_3.478992	179	259	38	18	80	0.2250000
NODE_124703_length_337_cov_3.478992	179	259	39	25	80	0.3125000
NODE_124703_length_337_cov_3.478992	179	259	40	5	80	0.0625000
NODE_124703_length_337_cov_3.478992	179	259	41	5	80	0.0625000
NODE_124703_length_337_cov_3.478992	232	307	7	1	75	0.0133333
NODE_124703_length_337_cov_3.478992	232	307	13	2	75	0.0266667
NODE_124703_length_337_cov_3.478992	232	307	15	1	75	0.0133333
NODE_124703_length_337_cov_3.478992	232	307	21	6	75	0.0800000
NODE_124703_length_337_cov_3.478992	232	307	23	3	75	0.0400000
NODE_124703_length_337_cov_3.478992	232	307	24	1	75	0.0133333
NODE_124703_length_337_cov_3.478992	232	307	25	8	75	0.1066667
NODE_124703_length_337_cov_3.478992	232	307	26	1	75	0.0133333
NODE_124703_length_337_cov_3.478992	232	307	27	9	75	0.1200000
NODE_124703_length_337_cov_3.478992	232	307	28	6	75	0.0800000
NODE_124703_length_337_cov_3.478992	232	307	30	4	75	0.0533333
NODE_124703_length_337_cov_3.478992	232	307	31	1	75	0.0133333
NODE_124703_length_337_cov_3.478992	232	307	33	9	75	0.1200000
NODE_124703_length_337_cov_3.478992	232	307	35	4	75	0.0533333
NODE_124703_length_337_cov_3.478992	232	307	36	3	75	0.0400000
NODE_124703_length_337_cov_3.478992	232	307	37	6	75	0.0800000
NODE_124703_length_337_cov_3.478992	232	307	38	5	75	0.0666667
NODE_124703_length_337_cov_3.478992	232	307	39	5	75	0.0666667
NODE_124759_length_337_cov_2.647059	80	146	2	11	66	0.1666667
NODE_124759_length_337_cov_2.647059	80	146	4	55	66	0.8333333
NODE_124858_length_337_cov_2.121849	23	103	0	11	80	0.1375000
NODE_124858_length_337_cov_2.121849	23	103	2	8	80	0.1000000
NODE_124858_length_337_cov_2.121849	23	103	4	8	80	0.1000000
NODE_124858_length_337_cov_2.121849	23	103	6	53	80	0.6625000
NODE_124858_length_337_cov_2.121849	76	141	4	1	65	0.0153846
NODE_124858_length_337_cov_2.121849	76	141	6	64	65	0.9846154
NODE_125001_length_337_cov_1.689076	138	218	0	80	80	1.0000000
NODE_125024_length_337_cov_1.592437	109	151	0	42	42	1.0000000
NODE_125024_length_337_cov_1.592437	126	204	0	78	78	1.0000000
NODE_125074_length_337_cov_1.466387	266	332	0	66	66	1.0000000
NODE_125271_length_337_cov_1.071429	279	319	1	40	40	1.0000000
NODE_125332_length_337_cov_0.978992	227	272	0	45	45	1.0000000
NODE_125633_length_336_cov_7.843882	151	231	0	80	80	1.0000000
NODE_125645_length_336_cov_5.578059	159	220	4	2	61	0.0327869
NODE_125645_length_336_cov_5.578059	159	220	6	59	61	0.9672131
NODE_125645_length_336_cov_5.578059	212	273	0	7	61	0.1147541
NODE_125645_length_336_cov_5.578059	212	273	1	6	61	0.0983607
NODE_125645_length_336_cov_5.578059	212	273	3	18	61	0.2950820
NODE_125645_length_336_cov_5.578059	212	273	4	11	61	0.1803279
NODE_125645_length_336_cov_5.578059	212	273	6	19	61	0.3114754
NODE_125663_length_336_cov_4.481013	129	207	4	12	78	0.1538462
NODE_125663_length_336_cov_4.481013	129	207	6	5	78	0.0641026
NODE_125663_length_336_cov_4.481013	129	207	7	27	78	0.3461539
NODE_125663_length_336_cov_4.481013	129	207	8	19	78	0.2435897
NODE_125663_length_336_cov_4.481013	129	207	9	2	78	0.0256410
NODE_125663_length_336_cov_4.481013	129	207	10	13	78	0.1666667
NODE_125752_length_336_cov_2.755274	83	112	5	7	29	0.2413793
NODE_125752_length_336_cov_2.755274	83	112	6	22	29	0.7586207
NODE_125752_length_336_cov_2.755274	187	268	2	65	81	0.8024691
NODE_125752_length_336_cov_2.755274	187	268	3	16	81	0.1975309
NODE_125806_length_336_cov_2.358650	60	133	0	30	73	0.4109589
NODE_125806_length_336_cov_2.358650	60	133	1	13	73	0.1780822
NODE_125806_length_336_cov_2.358650	60	133	2	30	73	0.4109589
NODE_125811_length_336_cov_2.337553	93	173	0	80	80	1.0000000
NODE_125965_length_336_cov_1.729958	78	141	0	63	63	1.0000000
NODE_125965_length_336_cov_1.729958	131	194	0	63	63	1.0000000
NODE_126134_length_336_cov_1.333333	34	114	1	11	80	0.1375000
NODE_126134_length_336_cov_1.333333	34	114	2	9	80	0.1125000
NODE_126134_length_336_cov_1.333333	34	114	3	21	80	0.2625000
NODE_126134_length_336_cov_1.333333	34	114	5	12	80	0.1500000
NODE_126134_length_336_cov_1.333333	34	114	6	6	80	0.0750000
NODE_126134_length_336_cov_1.333333	34	114	8	15	80	0.1875000
NODE_126134_length_336_cov_1.333333	34	114	9	1	80	0.0125000
NODE_126134_length_336_cov_1.333333	34	114	10	3	80	0.0375000
NODE_126134_length_336_cov_1.333333	34	114	12	2	80	0.0250000
NODE_126134_length_336_cov_1.333333	87	124	6	6	37	0.1621622
NODE_126134_length_336_cov_1.333333	87	124	8	15	37	0.4054054
NODE_126134_length_336_cov_1.333333	87	124	9	1	37	0.0270270
NODE_126134_length_336_cov_1.333333	87	124	10	3	37	0.0810811
NODE_126134_length_336_cov_1.333333	87	124	12	8	37	0.2162162
NODE_126134_length_336_cov_1.333333	87	124	13	4	37	0.1081081
NODE_126134_length_336_cov_1.333333	182	213	8	2	31	0.0645161
NODE_126134_length_336_cov_1.333333	182	213	10	2	31	0.0645161
NODE_126134_length_336_cov_1.333333	182	213	12	6	31	0.1935484
NODE_126134_length_336_cov_1.333333	182	213	14	15	31	0.4838710
NODE_126134_length_336_cov_1.333333	182	213	16	5	31	0.1612903
NODE_126134_length_336_cov_1.333333	182	213	17	1	31	0.0322581
NODE_126216_length_336_cov_1.244726	222	276	0	54	54	1.0000000
NODE_126216_length_336_cov_1.244726	288	312	0	24	24	1.0000000
NODE_126260_length_336_cov_1.143460	129	154	0	25	25	1.0000000
NODE_126545_length_336_cov_0.670886	259	288	8	29	29	1.0000000
NODE_126606_length_335_cov_16.114407	162	242	0	80	80	1.0000000
NODE_126606_length_335_cov_16.114407	215	295	0	80	80	1.0000000
NODE_126609_length_335_cov_9.258475	177	250	0	73	73	1.0000000
NODE_126614_length_335_cov_7.207627	29	109	0	80	80	1.0000000
NODE_126614_length_335_cov_7.207627	82	162	0	80	80	1.0000000
NODE_126636_length_335_cov_5.046610	182	263	0	25	81	0.3086420
NODE_126636_length_335_cov_5.046610	182	263	2	56	81	0.6913580
NODE_126639_length_335_cov_4.995763	144	215	0	71	71	1.0000000
NODE_126665_length_335_cov_3.923729	163	231	0	68	68	1.0000000
NODE_126787_length_335_cov_2.411017	230	294	2	57	64	0.8906250
NODE_126787_length_335_cov_2.411017	230	294	5	7	64	0.1093750
NODE_126791_length_335_cov_2.402542	164	240	4	8	76	0.1052632
NODE_126791_length_335_cov_2.402542	164	240	5	1	76	0.0131579
NODE_126791_length_335_cov_2.402542	164	240	6	2	76	0.0263158
NODE_126791_length_335_cov_2.402542	164	240	7	3	76	0.0394737
NODE_126791_length_335_cov_2.402542	164	240	9	3	76	0.0394737
NODE_126791_length_335_cov_2.402542	164	240	12	18	76	0.2368421
NODE_126791_length_335_cov_2.402542	164	240	13	1	76	0.0131579
NODE_126791_length_335_cov_2.402542	164	240	15	2	76	0.0263158
NODE_126791_length_335_cov_2.402542	164	240	16	1	76	0.0131579
NODE_126791_length_335_cov_2.402542	164	240	17	3	76	0.0394737
NODE_126791_length_335_cov_2.402542	164	240	19	9	76	0.1184211
NODE_126791_length_335_cov_2.402542	164	240	20	1	76	0.0131579
NODE_126791_length_335_cov_2.402542	164	240	21	6	76	0.0789474
NODE_126791_length_335_cov_2.402542	164	240	22	18	76	0.2368421
NODE_126792_length_335_cov_2.398305	116	179	2	15	63	0.2380952
NODE_126792_length_335_cov_2.398305	116	179	4	48	63	0.7619048
NODE_126826_length_335_cov_2.161017	82	141	0	59	59	1.0000000
NODE_126835_length_335_cov_2.152542	61	134	0	48	73	0.6575342
NODE_126835_length_335_cov_2.152542	61	134	2	25	73	0.3424658
NODE_126835_length_335_cov_2.152542	114	134	2	20	20	1.0000000
NODE_126920_length_335_cov_1.766949	257	330	0	73	73	1.0000000
NODE_126920_length_335_cov_1.766949	297	335	0	38	38	1.0000000
NODE_127022_length_335_cov_1.529661	255	320	1	65	65	1.0000000
NODE_127023_length_335_cov_1.525424	222	266	2	9	44	0.2045455
NODE_127023_length_335_cov_1.525424	222	266	3	35	44	0.7954546
NODE_127062_length_335_cov_1.457627	38	87	0	49	49	1.0000000
NODE_127130_length_335_cov_1.296610	291	311	0	20	20	1.0000000
NODE_127130_length_335_cov_1.296610	291	311	0	20	20	1.0000000
NODE_127143_length_335_cov_1.292373	202	232	4	25	30	0.8333333
NODE_127143_length_335_cov_1.292373	202	232	5	1	30	0.0333333
NODE_127143_length_335_cov_1.292373	202	232	7	1	30	0.0333333
NODE_127143_length_335_cov_1.292373	202	232	8	3	30	0.1000000
NODE_127200_length_335_cov_1.194915	75	156	11	14	81	0.1728395
NODE_127200_length_335_cov_1.194915	75	156	12	38	81	0.4691358
NODE_127200_length_335_cov_1.194915	75	156	13	23	81	0.2839506
NODE_127200_length_335_cov_1.194915	75	156	14	6	81	0.0740741
NODE_127200_length_335_cov_1.194915	129	195	10	6	66	0.0909091
NODE_127200_length_335_cov_1.194915	129	195	11	19	66	0.2878788
NODE_127200_length_335_cov_1.194915	129	195	12	13	66	0.1969697
NODE_127200_length_335_cov_1.194915	129	195	13	2	66	0.0303030
NODE_127200_length_335_cov_1.194915	129	195	14	20	66	0.3030303
NODE_127200_length_335_cov_1.194915	129	195	15	6	66	0.0909091
NODE_127310_length_335_cov_0.983051	96	117	0	21	21	1.0000000
NODE_127585_length_334_cov_275.425532	135	215	91	3	80	0.0375000
NODE_127585_length_334_cov_275.425532	135	215	92	1	80	0.0125000
NODE_127585_length_334_cov_275.425532	135	215	94	1	80	0.0125000
NODE_127585_length_334_cov_275.425532	135	215	97	1	80	0.0125000
NODE_127585_length_334_cov_275.425532	135	215	98	2	80	0.0250000
NODE_127585_length_334_cov_275.425532	135	215	99	1	80	0.0125000
NODE_127585_length_334_cov_275.425532	135	215	100	1	80	0.0125000
NODE_127585_length_334_cov_275.425532	135	215	102	4	80	0.0500000
NODE_127585_length_334_cov_275.425532	135	215	103	4	80	0.0500000
NODE_127585_length_334_cov_275.425532	135	215	105	2	80	0.0250000
NODE_127585_length_334_cov_275.425532	135	215	106	11	80	0.1375000
NODE_127585_length_334_cov_275.425532	135	215	107	13	80	0.1625000
NODE_127585_length_334_cov_275.425532	135	215	108	10	80	0.1250000
NODE_127585_length_334_cov_275.425532	135	215	110	1	80	0.0125000
NODE_127585_length_334_cov_275.425532	135	215	111	4	80	0.0500000
NODE_127585_length_334_cov_275.425532	135	215	112	7	80	0.0875000
NODE_127585_length_334_cov_275.425532	135	215	113	5	80	0.0625000
NODE_127585_length_334_cov_275.425532	135	215	114	7	80	0.0875000
NODE_127585_length_334_cov_275.425532	135	215	115	2	80	0.0250000
NODE_127585_length_334_cov_275.425532	188	269	67	2	81	0.0246914
NODE_127585_length_334_cov_275.425532	188	269	68	2	81	0.0246914
NODE_127585_length_334_cov_275.425532	188	269	70	2	81	0.0246914
NODE_127585_length_334_cov_275.425532	188	269	71	6	81	0.0740741
NODE_127585_length_334_cov_275.425532	188	269	72	2	81	0.0246914
NODE_127585_length_334_cov_275.425532	188	269	73	3	81	0.0370370
NODE_127585_length_334_cov_275.425532	188	269	74	2	81	0.0246914
NODE_127585_length_334_cov_275.425532	188	269	76	4	81	0.0493827
NODE_127585_length_334_cov_275.425532	188	269	78	2	81	0.0246914
NODE_127585_length_334_cov_275.425532	188	269	79	2	81	0.0246914
NODE_127585_length_334_cov_275.425532	188	269	80	1	81	0.0123457
NODE_127585_length_334_cov_275.425532	188	269	81	2	81	0.0246914
NODE_127585_length_334_cov_275.425532	188	269	82	2	81	0.0246914
NODE_127585_length_334_cov_275.425532	188	269	83	1	81	0.0123457
NODE_127585_length_334_cov_275.425532	188	269	85	1	81	0.0123457
NODE_127585_length_334_cov_275.425532	188	269	88	1	81	0.0123457
NODE_127585_length_334_cov_275.425532	188	269	90	2	81	0.0246914
NODE_127585_length_334_cov_275.425532	188	269	91	4	81	0.0493827
NODE_127585_length_334_cov_275.425532	188	269	93	4	81	0.0493827
NODE_127585_length_334_cov_275.425532	188	269	94	1	81	0.0123457
NODE_127585_length_334_cov_275.425532	188	269	96	2	81	0.0246914
NODE_127585_length_334_cov_275.425532	188	269	97	1	81	0.0123457
NODE_127585_length_334_cov_275.425532	188	269	98	1	81	0.0123457
NODE_127585_length_334_cov_275.425532	188	269	102	2	81	0.0246914
NODE_127585_length_334_cov_275.425532	188	269	103	4	81	0.0493827
NODE_127585_length_334_cov_275.425532	188	269	105	2	81	0.0246914
NODE_127585_length_334_cov_275.425532	188	269	106	10	81	0.1234568
NODE_127585_length_334_cov_275.425532	188	269	107	8	81	0.0987654
NODE_127585_length_334_cov_275.425532	188	269	108	5	81	0.0617284
NODE_127586_length_334_cov_14.753191	135	215	0	80	80	1.0000000
NODE_127586_length_334_cov_14.753191	188	268	0	80	80	1.0000000
NODE_127610_length_334_cov_4.829787	92	174	0	49	82	0.5975610
NODE_127610_length_334_cov_4.829787	92	174	2	33	82	0.4024390
NODE_127610_length_334_cov_4.829787	151	237	0	16	86	0.1860465
NODE_127610_length_334_cov_4.829787	151	237	2	70	86	0.8139535
NODE_127612_length_334_cov_4.817021	179	231	0	52	52	1.0000000
NODE_127626_length_334_cov_4.438298	121	201	6	8	80	0.1000000
NODE_127626_length_334_cov_4.438298	121	201	7	7	80	0.0875000
NODE_127626_length_334_cov_4.438298	121	201	8	22	80	0.2750000
NODE_127626_length_334_cov_4.438298	121	201	9	43	80	0.5375000
NODE_127672_length_334_cov_3.604255	248	314	0	66	66	1.0000000
NODE_127672_length_334_cov_3.604255	287	334	0	47	47	1.0000000
NODE_127844_length_334_cov_2.165957	0	48	0	48	48	1.0000000
NODE_128026_length_334_cov_1.595745	253	328	0	3	75	0.0400000
NODE_128026_length_334_cov_1.595745	253	328	2	72	75	0.9600000
NODE_128258_length_334_cov_1.157447	146	177	0	31	31	1.0000000
NODE_128665_length_333_cov_5.423077	172	242	0	70	70	1.0000000
NODE_128673_length_333_cov_4.867521	122	172	0	50	50	1.0000000
NODE_128673_length_333_cov_4.867521	175	255	0	80	80	1.0000000
NODE_128673_length_333_cov_4.867521	194	219	0	25	25	1.0000000
NODE_128717_length_333_cov_3.717949	49	129	0	53	80	0.6625000
NODE_128717_length_333_cov_3.717949	49	129	1	7	80	0.0875000
NODE_128717_length_333_cov_3.717949	49	129	2	20	80	0.2500000
NODE_128717_length_333_cov_3.717949	102	182	1	7	80	0.0875000
NODE_128717_length_333_cov_3.717949	102	182	2	73	80	0.9125000
NODE_128767_length_333_cov_2.897436	59	139	1	7	80	0.0875000
NODE_128767_length_333_cov_2.897436	59	139	2	4	80	0.0500000
NODE_128767_length_333_cov_2.897436	59	139	4	3	80	0.0375000
NODE_128767_length_333_cov_2.897436	59	139	5	26	80	0.3250000
NODE_128767_length_333_cov_2.897436	59	139	6	16	80	0.2000000
NODE_128767_length_333_cov_2.897436	59	139	8	24	80	0.3000000
NODE_128850_length_333_cov_2.307692	68	148	0	80	80	1.0000000
NODE_128933_length_333_cov_1.940171	135	215	0	34	80	0.4250000
NODE_128933_length_333_cov_1.940171	135	215	1	46	80	0.5750000
NODE_129252_length_333_cov_1.200855	0	80	0	80	80	1.0000000
NODE_129263_length_333_cov_1.170940	146	193	0	1	47	0.0212766
NODE_129263_length_333_cov_1.170940	146	193	2	46	47	0.9787234
NODE_129263_length_333_cov_1.170940	203	243	2	40	40	1.0000000
NODE_129303_length_333_cov_1.089744	241	306	1	65	65	1.0000000
NODE_129310_length_333_cov_1.089744	206	226	0	20	20	1.0000000
NODE_129665_length_332_cov_5.386266	101	167	0	66	66	1.0000000
NODE_129680_length_332_cov_4.768240	221	250	2	26	29	0.8965517
NODE_129680_length_332_cov_4.768240	221	250	4	3	29	0.1034483
NODE_129695_length_332_cov_4.343348	130	179	0	49	49	1.0000000
NODE_129698_length_332_cov_4.201717	191	237	4	33	46	0.7173913
NODE_129698_length_332_cov_4.201717	191	237	5	13	46	0.2826087
NODE_129698_length_332_cov_4.201717	211	290	1	11	79	0.1392405
NODE_129698_length_332_cov_4.201717	211	290	2	3	79	0.0379747
NODE_129698_length_332_cov_4.201717	211	290	3	9	79	0.1139240
NODE_129698_length_332_cov_4.201717	211	290	4	45	79	0.5696203
NODE_129698_length_332_cov_4.201717	211	290	5	11	79	0.1392405
NODE_129879_length_332_cov_2.274678	187	227	11	1	40	0.0250000
NODE_129879_length_332_cov_2.274678	187	227	12	39	40	0.9750000
NODE_129901_length_332_cov_2.184549	194	258	0	64	64	1.0000000
NODE_130053_length_332_cov_1.682403	241	316	0	5	75	0.0666667
NODE_130053_length_332_cov_1.682403	241	316	1	70	75	0.9333333
NODE_130055_length_332_cov_1.673820	157	220	0	63	63	1.0000000
NODE_130183_length_332_cov_1.364807	132	212	0	1	80	0.0125000
NODE_130183_length_332_cov_1.364807	132	212	1	45	80	0.5625000
NODE_130183_length_332_cov_1.364807	132	212	2	34	80	0.4250000
NODE_130187_length_332_cov_1.356223	276	332	0	56	56	1.0000000
NODE_130312_length_332_cov_1.210300	120	176	4	13	56	0.2321429
NODE_130312_length_332_cov_1.210300	120	176	5	23	56	0.4107143
NODE_130312_length_332_cov_1.210300	120	176	7	5	56	0.0892857
NODE_130312_length_332_cov_1.210300	120	176	8	15	56	0.2678571
NODE_130757_length_331_cov_5.254310	141	221	0	80	80	1.0000000
NODE_130757_length_331_cov_5.254310	194	274	0	80	80	1.0000000
NODE_130781_length_331_cov_4.323276	26	108	0	9	82	0.1097561
NODE_130781_length_331_cov_4.323276	26	108	2	73	82	0.8902439
NODE_130902_length_331_cov_2.603448	128	181	0	53	53	1.0000000
NODE_131036_length_331_cov_1.965517	183	216	0	33	33	1.0000000
NODE_131054_length_331_cov_1.896552	266	331	0	5	65	0.0769231
NODE_131054_length_331_cov_1.896552	266	331	2	60	65	0.9230769
NODE_131817_length_330_cov_14.731602	209	280	0	11	71	0.1549296
NODE_131817_length_330_cov_14.731602	209	280	2	60	71	0.8450704
NODE_131840_length_330_cov_4.935065	16	97	0	1	81	0.0123457
NODE_131840_length_330_cov_4.935065	16	97	1	25	81	0.3086420
NODE_131840_length_330_cov_4.935065	16	97	2	29	81	0.3580247
NODE_131840_length_330_cov_4.935065	16	97	3	5	81	0.0617284
NODE_131840_length_330_cov_4.935065	16	97	4	21	81	0.2592593
NODE_131840_length_330_cov_4.935065	81	149	4	17	68	0.2500000
NODE_131840_length_330_cov_4.935065	81	149	6	31	68	0.4558823
NODE_131840_length_330_cov_4.935065	81	149	8	20	68	0.2941177
NODE_131841_length_330_cov_4.891775	177	255	0	21	78	0.2692308
NODE_131841_length_330_cov_4.891775	177	255	1	57	78	0.7307692
NODE_131845_length_330_cov_4.740260	134	209	0	4	75	0.0533333
NODE_131845_length_330_cov_4.740260	134	209	1	12	75	0.1600000
NODE_131845_length_330_cov_4.740260	134	209	3	25	75	0.3333333
NODE_131845_length_330_cov_4.740260	134	209	4	34	75	0.4533333
NODE_131892_length_330_cov_3.467532	161	225	0	33	64	0.5156250
NODE_131892_length_330_cov_3.467532	161	225	2	31	64	0.4843750
NODE_131969_length_330_cov_2.601732	8	88	0	80	80	1.0000000
NODE_132188_length_330_cov_1.623377	154	200	0	46	46	1.0000000
NODE_132238_length_330_cov_1.541126	98	156	0	47	58	0.8103448
NODE_132238_length_330_cov_1.541126	98	156	2	11	58	0.1896552
NODE_132268_length_330_cov_1.467532	234	287	0	53	53	1.0000000
NODE_132268_length_330_cov_1.467532	242	283	0	41	41	1.0000000
NODE_132306_length_330_cov_1.346320	230	296	0	66	66	1.0000000
NODE_132306_length_330_cov_1.346320	230	257	0	27	27	1.0000000
NODE_132410_length_330_cov_1.220779	249	272	0	23	23	1.0000000
NODE_132478_length_330_cov_1.103896	189	227	0	38	38	1.0000000
NODE_132542_length_330_cov_1.038961	219	297	13	1	78	0.0128205
NODE_132542_length_330_cov_1.038961	219	297	14	3	78	0.0384615
NODE_132542_length_330_cov_1.038961	219	297	15	1	78	0.0128205
NODE_132542_length_330_cov_1.038961	219	297	17	4	78	0.0512821
NODE_132542_length_330_cov_1.038961	219	297	18	3	78	0.0384615
NODE_132542_length_330_cov_1.038961	219	297	19	1	78	0.0128205
NODE_132542_length_330_cov_1.038961	219	297	20	4	78	0.0512821
NODE_132542_length_330_cov_1.038961	219	297	22	2	78	0.0256410
NODE_132542_length_330_cov_1.038961	219	297	27	1	78	0.0128205
NODE_132542_length_330_cov_1.038961	219	297	28	2	78	0.0256410
NODE_132542_length_330_cov_1.038961	219	297	29	2	78	0.0256410
NODE_132542_length_330_cov_1.038961	219	297	31	1	78	0.0128205
NODE_132542_length_330_cov_1.038961	219	297	32	3	78	0.0384615
NODE_132542_length_330_cov_1.038961	219	297	33	1	78	0.0128205
NODE_132542_length_330_cov_1.038961	219	297	34	4	78	0.0512821
NODE_132542_length_330_cov_1.038961	219	297	35	1	78	0.0128205
NODE_132542_length_330_cov_1.038961	219	297	36	2	78	0.0256410
NODE_132542_length_330_cov_1.038961	219	297	38	2	78	0.0256410
NODE_132542_length_330_cov_1.038961	219	297	40	2	78	0.0256410
NODE_132542_length_330_cov_1.038961	219	297	41	1	78	0.0128205
NODE_132542_length_330_cov_1.038961	219	297	43	4	78	0.0512821
NODE_132542_length_330_cov_1.038961	219	297	44	1	78	0.0128205
NODE_132542_length_330_cov_1.038961	219	297	46	7	78	0.0897436
NODE_132542_length_330_cov_1.038961	219	297	47	5	78	0.0641026
NODE_132542_length_330_cov_1.038961	219	297	48	3	78	0.0384615
NODE_132542_length_330_cov_1.038961	219	297	49	3	78	0.0384615
NODE_132542_length_330_cov_1.038961	219	297	50	1	78	0.0128205
NODE_132542_length_330_cov_1.038961	219	297	51	12	78	0.1538462
NODE_132542_length_330_cov_1.038961	219	297	52	1	78	0.0128205
NODE_132688_length_330_cov_0.883117	284	330	0	46	46	1.0000000
NODE_132873_length_329_cov_110.178261	138	167	44	2	29	0.0689655
NODE_132873_length_329_cov_110.178261	138	167	45	7	29	0.2413793
NODE_132873_length_329_cov_110.178261	138	167	46	11	29	0.3793103
NODE_132873_length_329_cov_110.178261	138	167	47	8	29	0.2758621
NODE_132873_length_329_cov_110.178261	138	167	48	1	29	0.0344828
NODE_132873_length_329_cov_110.178261	189	269	20	8	80	0.1000000
NODE_132873_length_329_cov_110.178261	189	269	23	2	80	0.0250000
NODE_132873_length_329_cov_110.178261	189	269	24	2	80	0.0250000
NODE_132873_length_329_cov_110.178261	189	269	25	2	80	0.0250000
NODE_132873_length_329_cov_110.178261	189	269	26	7	80	0.0875000
NODE_132873_length_329_cov_110.178261	189	269	28	3	80	0.0375000
NODE_132873_length_329_cov_110.178261	189	269	30	1	80	0.0125000
NODE_132873_length_329_cov_110.178261	189	269	31	2	80	0.0250000
NODE_132873_length_329_cov_110.178261	189	269	33	1	80	0.0125000
NODE_132873_length_329_cov_110.178261	189	269	34	4	80	0.0500000
NODE_132873_length_329_cov_110.178261	189	269	36	2	80	0.0250000
NODE_132873_length_329_cov_110.178261	189	269	37	3	80	0.0375000
NODE_132873_length_329_cov_110.178261	189	269	38	5	80	0.0625000
NODE_132873_length_329_cov_110.178261	189	269	39	8	80	0.1000000
NODE_132873_length_329_cov_110.178261	189	269	40	5	80	0.0625000
NODE_132873_length_329_cov_110.178261	189	269	41	10	80	0.1250000
NODE_132873_length_329_cov_110.178261	189	269	42	5	80	0.0625000
NODE_132873_length_329_cov_110.178261	189	269	43	6	80	0.0750000
NODE_132873_length_329_cov_110.178261	189	269	44	1	80	0.0125000
NODE_132873_length_329_cov_110.178261	189	269	45	3	80	0.0375000
NODE_132873_length_329_cov_110.178261	242	322	5	6	80	0.0750000
NODE_132873_length_329_cov_110.178261	242	322	6	3	80	0.0375000
NODE_132873_length_329_cov_110.178261	242	322	7	13	80	0.1625000
NODE_132873_length_329_cov_110.178261	242	322	8	6	80	0.0750000
NODE_132873_length_329_cov_110.178261	242	322	9	2	80	0.0250000
NODE_132873_length_329_cov_110.178261	242	322	10	1	80	0.0125000
NODE_132873_length_329_cov_110.178261	242	322	12	7	80	0.0875000
NODE_132873_length_329_cov_110.178261	242	322	13	1	80	0.0125000
NODE_132873_length_329_cov_110.178261	242	322	14	1	80	0.0125000
NODE_132873_length_329_cov_110.178261	242	322	15	2	80	0.0250000
NODE_132873_length_329_cov_110.178261	242	322	17	2	80	0.0250000
NODE_132873_length_329_cov_110.178261	242	322	18	2	80	0.0250000
NODE_132873_length_329_cov_110.178261	242	322	20	15	80	0.1875000
NODE_132873_length_329_cov_110.178261	242	322	23	2	80	0.0250000
NODE_132873_length_329_cov_110.178261	242	322	24	2	80	0.0250000
NODE_132873_length_329_cov_110.178261	242	322	25	2	80	0.0250000
NODE_132873_length_329_cov_110.178261	242	322	26	7	80	0.0875000
NODE_132873_length_329_cov_110.178261	242	322	28	3	80	0.0375000
NODE_132873_length_329_cov_110.178261	242	322	30	1	80	0.0125000
NODE_132873_length_329_cov_110.178261	242	322	31	2	80	0.0250000
NODE_132879_length_329_cov_8.882609	61	141	0	80	80	1.0000000
NODE_132879_length_329_cov_8.882609	114	194	0	80	80	1.0000000
NODE_132885_length_329_cov_6.586957	166	207	0	41	41	1.0000000
NODE_132908_length_329_cov_4.617391	175	229	0	54	54	1.0000000
NODE_132970_length_329_cov_3.160870	59	139	1	17	80	0.2125000
NODE_132970_length_329_cov_3.160870	59	139	2	3	80	0.0375000
NODE_132970_length_329_cov_3.160870	59	139	3	9	80	0.1125000
NODE_132970_length_329_cov_3.160870	59	139	5	49	80	0.6125000
NODE_132970_length_329_cov_3.160870	59	139	7	2	80	0.0250000
NODE_133003_length_329_cov_2.821739	164	209	0	45	45	1.0000000
NODE_133003_length_329_cov_2.821739	184	262	0	78	78	1.0000000
NODE_133033_length_329_cov_2.560870	139	201	4	3	62	0.0483871
NODE_133033_length_329_cov_2.560870	139	201	5	50	62	0.8064516
NODE_133033_length_329_cov_2.560870	139	201	6	9	62	0.1451613
NODE_133036_length_329_cov_2.543478	145	206	2	61	61	1.0000000
NODE_133123_length_329_cov_2.143478	39	119	0	46	80	0.5750000
NODE_133123_length_329_cov_2.143478	39	119	2	20	80	0.2500000
NODE_133123_length_329_cov_2.143478	39	119	4	14	80	0.1750000
NODE_133123_length_329_cov_2.143478	92	158	2	13	66	0.1969697
NODE_133123_length_329_cov_2.143478	92	158	4	25	66	0.3787879
NODE_133123_length_329_cov_2.143478	92	158	5	28	66	0.4242424
NODE_133184_length_329_cov_1.865217	182	252	2	1	70	0.0142857
NODE_133184_length_329_cov_1.865217	182	252	3	31	70	0.4428571
NODE_133184_length_329_cov_1.865217	182	252	5	1	70	0.0142857
NODE_133184_length_329_cov_1.865217	182	252	6	6	70	0.0857143
NODE_133184_length_329_cov_1.865217	182	252	8	6	70	0.0857143
NODE_133184_length_329_cov_1.865217	182	252	9	24	70	0.3428572
NODE_133184_length_329_cov_1.865217	182	252	11	1	70	0.0142857
NODE_133200_length_329_cov_1.791304	50	84	0	34	34	1.0000000
NODE_133200_length_329_cov_1.791304	92	149	1	3	57	0.0526316
NODE_133200_length_329_cov_1.791304	92	149	3	18	57	0.3157895
NODE_133200_length_329_cov_1.791304	92	149	4	4	57	0.0701754
NODE_133200_length_329_cov_1.791304	92	149	6	6	57	0.1052632
NODE_133200_length_329_cov_1.791304	92	149	7	26	57	0.4561403
NODE_133200_length_329_cov_1.791304	145	203	7	6	58	0.1034483
NODE_133200_length_329_cov_1.791304	145	203	8	52	58	0.8965517
NODE_133332_length_329_cov_1.508696	261	323	0	62	62	1.0000000
NODE_133348_length_329_cov_1.469565	168	237	2	5	69	0.0724638
NODE_133348_length_329_cov_1.469565	168	237	4	64	69	0.9275362
NODE_133376_length_329_cov_1.391304	275	307	17	6	32	0.1875000
NODE_133376_length_329_cov_1.391304	275	307	18	14	32	0.4375000
NODE_133376_length_329_cov_1.391304	275	307	19	12	32	0.3750000
NODE_133547_length_329_cov_1.165217	199	242	0	3	43	0.0697674
NODE_133547_length_329_cov_1.165217	199	242	2	40	43	0.9302326
NODE_133768_length_329_cov_0.878261	221	296	0	75	75	1.0000000
NODE_133970_length_328_cov_4.484716	95	175	6	72	80	0.9000000
NODE_133970_length_328_cov_4.484716	95	175	7	8	80	0.1000000
NODE_133989_length_328_cov_4.087336	79	159	5	14	80	0.1750000
NODE_133989_length_328_cov_4.087336	79	159	6	3	80	0.0375000
NODE_133989_length_328_cov_4.087336	79	159	7	63	80	0.7875000
NODE_133989_length_328_cov_4.087336	132	207	4	12	75	0.1600000
NODE_133989_length_328_cov_4.087336	132	207	5	23	75	0.3066667
NODE_133989_length_328_cov_4.087336	132	207	6	21	75	0.2800000
NODE_133989_length_328_cov_4.087336	132	207	7	10	75	0.1333333
NODE_133989_length_328_cov_4.087336	132	207	8	9	75	0.1200000
NODE_133993_length_328_cov_3.895197	110	190	1	80	80	1.0000000
NODE_134019_length_328_cov_3.393013	30	78	0	48	48	1.0000000
NODE_134144_length_328_cov_2.161572	103	134	4	3	31	0.0967742
NODE_134144_length_328_cov_2.161572	103	134	6	28	31	0.9032258
NODE_134247_length_328_cov_1.781659	16	44	0	28	28	1.0000000
NODE_134335_length_328_cov_1.567686	0	76	2	76	76	1.0000000
NODE_134335_length_328_cov_1.567686	49	94	2	45	45	1.0000000
NODE_134452_length_328_cov_1.336245	0	73	0	73	73	1.0000000
NODE_134508_length_328_cov_1.266376	78	158	0	39	80	0.4875000
NODE_134508_length_328_cov_1.266376	78	158	2	4	80	0.0500000
NODE_134508_length_328_cov_1.266376	78	158	4	37	80	0.4625000
NODE_135002_length_327_cov_4.934211	170	250	0	80	80	1.0000000
NODE_135009_length_327_cov_4.701754	225	305	2	4	80	0.0500000
NODE_135009_length_327_cov_4.701754	225	305	3	49	80	0.6125000
NODE_135009_length_327_cov_4.701754	225	305	4	27	80	0.3375000
NODE_135018_length_327_cov_4.241228	97	173	7	8	76	0.1052632
NODE_135018_length_327_cov_4.241228	97	173	9	14	76	0.1842105
NODE_135018_length_327_cov_4.241228	97	173	11	12	76	0.1578947
NODE_135018_length_327_cov_4.241228	97	173	12	13	76	0.1710526
NODE_135018_length_327_cov_4.241228	97	173	13	19	76	0.2500000
NODE_135018_length_327_cov_4.241228	97	173	15	10	76	0.1315790
NODE_135037_length_327_cov_3.719298	70	150	0	32	80	0.4000000
NODE_135037_length_327_cov_3.719298	70	150	3	48	80	0.6000000
NODE_135063_length_327_cov_3.350877	156	227	2	69	71	0.9718310
NODE_135063_length_327_cov_3.350877	156	227	4	2	71	0.0281690
NODE_135328_length_327_cov_1.780702	191	271	18	3	80	0.0375000
NODE_135328_length_327_cov_1.780702	191	271	19	11	80	0.1375000
NODE_135328_length_327_cov_1.780702	191	271	20	66	80	0.8250000
NODE_136081_length_326_cov_3.964758	178	228	0	50	50	1.0000000
NODE_136100_length_326_cov_3.502203	211	253	0	32	42	0.7619048
NODE_136100_length_326_cov_3.502203	211	253	2	10	42	0.2380952
NODE_136100_length_326_cov_3.502203	220	255	0	34	35	0.9714286
NODE_136100_length_326_cov_3.502203	220	255	2	1	35	0.0285714
NODE_136116_length_326_cov_3.202643	149	203	1	11	54	0.2037037
NODE_136116_length_326_cov_3.202643	149	203	2	14	54	0.2592593
NODE_136116_length_326_cov_3.202643	149	203	4	29	54	0.5370370
NODE_136130_length_326_cov_3.057269	107	126	0	19	19	1.0000000
NODE_136176_length_326_cov_2.594714	125	196	0	71	71	1.0000000
NODE_136283_length_326_cov_2.123348	184	244	0	53	60	0.8833333
NODE_136283_length_326_cov_2.123348	184	244	2	7	60	0.1166667
NODE_136496_length_326_cov_1.515419	86	166	0	80	80	1.0000000
NODE_137182_length_325_cov_4.893805	142	222	12	4	80	0.0500000
NODE_137182_length_325_cov_4.893805	142	222	13	4	80	0.0500000
NODE_137182_length_325_cov_4.893805	142	222	14	3	80	0.0375000
NODE_137182_length_325_cov_4.893805	142	222	16	2	80	0.0250000
NODE_137182_length_325_cov_4.893805	142	222	17	8	80	0.1000000
NODE_137182_length_325_cov_4.893805	142	222	18	59	80	0.7375000
NODE_137182_length_325_cov_4.893805	195	275	2	15	80	0.1875000
NODE_137182_length_325_cov_4.893805	195	275	3	12	80	0.1500000
NODE_137182_length_325_cov_4.893805	195	275	4	2	80	0.0250000
NODE_137182_length_325_cov_4.893805	195	275	5	4	80	0.0500000
NODE_137182_length_325_cov_4.893805	195	275	6	6	80	0.0750000
NODE_137182_length_325_cov_4.893805	195	275	8	2	80	0.0250000
NODE_137182_length_325_cov_4.893805	195	275	11	8	80	0.1000000
NODE_137182_length_325_cov_4.893805	195	275	12	8	80	0.1000000
NODE_137182_length_325_cov_4.893805	195	275	13	4	80	0.0500000
NODE_137182_length_325_cov_4.893805	195	275	14	3	80	0.0375000
NODE_137182_length_325_cov_4.893805	195	275	16	2	80	0.0250000
NODE_137182_length_325_cov_4.893805	195	275	17	5	80	0.0625000
NODE_137182_length_325_cov_4.893805	195	275	18	9	80	0.1125000
NODE_137199_length_325_cov_4.000000	134	198	0	3	64	0.0468750
NODE_137199_length_325_cov_4.000000	134	198	1	22	64	0.3437500
NODE_137199_length_325_cov_4.000000	134	198	2	39	64	0.6093750
NODE_137221_length_325_cov_3.513274	191	266	11	13	75	0.1733333
NODE_137221_length_325_cov_3.513274	191	266	12	4	75	0.0533333
NODE_137221_length_325_cov_3.513274	191	266	13	58	75	0.7733333
NODE_137221_length_325_cov_3.513274	240	319	5	13	79	0.1645570
NODE_137221_length_325_cov_3.513274	240	319	6	5	79	0.0632911
NODE_137221_length_325_cov_3.513274	240	319	7	4	79	0.0506329
NODE_137221_length_325_cov_3.513274	240	319	8	7	79	0.0886076
NODE_137221_length_325_cov_3.513274	240	319	10	12	79	0.1518987
NODE_137221_length_325_cov_3.513274	240	319	12	15	79	0.1898734
NODE_137221_length_325_cov_3.513274	240	319	13	23	79	0.2911392
NODE_137223_length_325_cov_3.469027	216	278	0	62	62	1.0000000
NODE_137224_length_325_cov_3.429204	178	224	2	24	46	0.5217391
NODE_137224_length_325_cov_3.429204	178	224	3	22	46	0.4782609
NODE_137243_length_325_cov_3.168142	188	274	0	54	86	0.6279070
NODE_137243_length_325_cov_3.168142	188	274	1	32	86	0.3720930
NODE_137268_length_325_cov_2.880531	72	152	2	16	80	0.2000000
NODE_137268_length_325_cov_2.880531	72	152	3	25	80	0.3125000
NODE_137268_length_325_cov_2.880531	72	152	5	14	80	0.1750000
NODE_137268_length_325_cov_2.880531	72	152	6	25	80	0.3125000
NODE_137268_length_325_cov_2.880531	125	205	5	2	80	0.0250000
NODE_137268_length_325_cov_2.880531	125	205	6	25	80	0.3125000
NODE_137268_length_325_cov_2.880531	125	205	7	1	80	0.0125000
NODE_137268_length_325_cov_2.880531	125	205	8	16	80	0.2000000
NODE_137268_length_325_cov_2.880531	125	205	9	36	80	0.4500000
NODE_137291_length_325_cov_2.707965	203	261	0	58	58	1.0000000
NODE_137296_length_325_cov_2.703540	68	148	0	80	80	1.0000000
NODE_137330_length_325_cov_2.500000	0	42	0	42	42	1.0000000
NODE_137407_length_325_cov_2.048673	122	202	9	1	80	0.0125000
NODE_137407_length_325_cov_2.048673	122	202	10	15	80	0.1875000
NODE_137407_length_325_cov_2.048673	122	202	12	4	80	0.0500000
NODE_137407_length_325_cov_2.048673	122	202	14	3	80	0.0375000
NODE_137407_length_325_cov_2.048673	122	202	16	34	80	0.4250000
NODE_137407_length_325_cov_2.048673	122	202	17	1	80	0.0125000
NODE_137407_length_325_cov_2.048673	122	202	18	22	80	0.2750000
NODE_137409_length_325_cov_2.035398	83	154	2	30	71	0.4225352
NODE_137409_length_325_cov_2.035398	83	154	3	2	71	0.0281690
NODE_137409_length_325_cov_2.035398	83	154	5	39	71	0.5492958
NODE_137642_length_325_cov_1.464602	153	224	0	71	71	1.0000000
NODE_137939_length_325_cov_1.017699	103	134	2	31	31	1.0000000
NODE_138113_length_325_cov_0.827434	258	308	0	50	50	1.0000000
NODE_138309_length_324_cov_4.737778	113	160	1	47	47	1.0000000
NODE_138309_length_324_cov_4.737778	142	213	0	5	71	0.0704225
NODE_138309_length_324_cov_4.737778	142	213	1	66	71	0.9295775
NODE_138358_length_324_cov_3.626667	218	273	0	55	55	1.0000000
NODE_138396_length_324_cov_3.124444	101	181	1	54	80	0.6750000
NODE_138396_length_324_cov_3.124444	101	181	2	26	80	0.3250000
NODE_138396_length_324_cov_3.124444	256	285	1	29	29	1.0000000
NODE_138416_length_324_cov_2.924444	114	198	0	4	84	0.0476190
NODE_138416_length_324_cov_2.924444	114	198	1	9	84	0.1071429
NODE_138416_length_324_cov_2.924444	114	198	2	71	84	0.8452381
NODE_138416_length_324_cov_2.924444	178	237	2	59	59	1.0000000
NODE_138418_length_324_cov_2.915556	141	221	1	44	80	0.5500000
NODE_138418_length_324_cov_2.915556	141	221	2	36	80	0.4500000
NODE_138434_length_324_cov_2.715556	4	51	0	47	47	1.0000000
NODE_138434_length_324_cov_2.715556	24	104	0	80	80	1.0000000
NODE_138463_length_324_cov_2.506667	270	306	0	36	36	1.0000000
NODE_138483_length_324_cov_2.448889	187	238	0	9	51	0.1764706
NODE_138483_length_324_cov_2.448889	187	238	2	42	51	0.8235294
NODE_138527_length_324_cov_2.248889	30	96	0	3	66	0.0454545
NODE_138527_length_324_cov_2.248889	30	96	2	63	66	0.9545454
NODE_138778_length_324_cov_1.502222	10	90	0	44	80	0.5500000
NODE_138778_length_324_cov_1.502222	10	90	1	4	80	0.0500000
NODE_138778_length_324_cov_1.502222	10	90	2	32	80	0.4000000
NODE_138792_length_324_cov_1.457778	0	45	0	45	45	1.0000000
NODE_138792_length_324_cov_1.457778	18	75	0	38	57	0.6666667
NODE_138792_length_324_cov_1.457778	18	75	1	19	57	0.3333333
NODE_138808_length_324_cov_1.382222	263	304	0	41	41	1.0000000
NODE_139129_length_324_cov_1.017778	0	59	0	59	59	1.0000000
NODE_139497_length_323_cov_6.669643	215	286	0	71	71	1.0000000
NODE_139497_length_323_cov_6.669643	268	315	0	47	47	1.0000000
NODE_139511_length_323_cov_5.089286	224	290	1	64	66	0.9696970
NODE_139511_length_323_cov_5.089286	224	290	2	2	66	0.0303030
NODE_139511_length_323_cov_5.089286	263	319	1	56	56	1.0000000
NODE_139572_length_323_cov_3.276786	189	269	5	4	80	0.0500000
NODE_139572_length_323_cov_3.276786	189	269	6	1	80	0.0125000
NODE_139572_length_323_cov_3.276786	189	269	8	6	80	0.0750000
NODE_139572_length_323_cov_3.276786	189	269	9	3	80	0.0375000
NODE_139572_length_323_cov_3.276786	189	269	11	19	80	0.2375000
NODE_139572_length_323_cov_3.276786	189	269	12	6	80	0.0750000
NODE_139572_length_323_cov_3.276786	189	269	14	6	80	0.0750000
NODE_139572_length_323_cov_3.276786	189	269	15	6	80	0.0750000
NODE_139572_length_323_cov_3.276786	189	269	16	1	80	0.0125000
NODE_139572_length_323_cov_3.276786	189	269	17	1	80	0.0125000
NODE_139572_length_323_cov_3.276786	189	269	18	8	80	0.1000000
NODE_139572_length_323_cov_3.276786	189	269	19	4	80	0.0500000
NODE_139572_length_323_cov_3.276786	189	269	22	3	80	0.0375000
NODE_139572_length_323_cov_3.276786	189	269	23	6	80	0.0750000
NODE_139572_length_323_cov_3.276786	189	269	24	3	80	0.0375000
NODE_139572_length_323_cov_3.276786	189	269	25	3	80	0.0375000
NODE_139575_length_323_cov_3.263393	101	181	3	14	80	0.1750000
NODE_139575_length_323_cov_3.263393	101	181	4	10	80	0.1250000
NODE_139575_length_323_cov_3.263393	101	181	5	6	80	0.0750000
NODE_139575_length_323_cov_3.263393	101	181	6	21	80	0.2625000
NODE_139575_length_323_cov_3.263393	101	181	7	9	80	0.1125000
NODE_139575_length_323_cov_3.263393	101	181	8	2	80	0.0250000
NODE_139575_length_323_cov_3.263393	101	181	12	18	80	0.2250000
NODE_139591_length_323_cov_3.089286	128	208	0	28	80	0.3500000
NODE_139591_length_323_cov_3.089286	128	208	2	52	80	0.6500000
NODE_139591_length_323_cov_3.089286	166	208	2	42	42	1.0000000
NODE_139591_length_323_cov_3.089286	181	261	2	80	80	1.0000000
NODE_139591_length_323_cov_3.089286	181	261	2	80	80	1.0000000
NODE_139629_length_323_cov_2.683036	144	215	2	13	71	0.1830986
NODE_139629_length_323_cov_2.683036	144	215	4	58	71	0.8169014
NODE_139746_length_323_cov_2.089286	64	144	1	20	80	0.2500000
NODE_139746_length_323_cov_2.089286	64	144	2	31	80	0.3875000
NODE_139746_length_323_cov_2.089286	64	144	3	29	80	0.3625000
NODE_139797_length_323_cov_1.888393	148	207	0	59	59	1.0000000
NODE_139901_length_323_cov_1.705357	195	262	0	67	67	1.0000000
NODE_139901_length_323_cov_1.705357	235	315	0	80	80	1.0000000
NODE_140651_length_322_cov_5.475336	56	136	0	80	80	1.0000000
NODE_140651_length_322_cov_5.475336	113	189	0	58	76	0.7631579
NODE_140651_length_322_cov_5.475336	113	189	1	18	76	0.2368421
NODE_140692_length_322_cov_3.753363	63	133	0	27	70	0.3857143
NODE_140692_length_322_cov_3.753363	63	133	2	43	70	0.6142857
NODE_140692_length_322_cov_3.753363	116	190	0	20	74	0.2702703
NODE_140692_length_322_cov_3.753363	116	190	2	54	74	0.7297297
NODE_140693_length_322_cov_3.735426	60	86	0	26	26	1.0000000
NODE_140693_length_322_cov_3.735426	99	139	0	40	40	1.0000000
NODE_140701_length_322_cov_3.605381	73	116	9	11	43	0.2558140
NODE_140701_length_322_cov_3.605381	73	116	10	14	43	0.3255814
NODE_140701_length_322_cov_3.605381	73	116	11	18	43	0.4186046
NODE_140702_length_322_cov_3.600897	75	145	2	70	70	1.0000000
NODE_140820_length_322_cov_2.304933	182	213	0	31	31	1.0000000
NODE_141738_length_321_cov_8.527027	176	240	0	21	64	0.3281250
NODE_141738_length_321_cov_8.527027	176	240	2	43	64	0.6718750
NODE_141786_length_321_cov_4.094595	196	266	0	35	70	0.5000000
NODE_141786_length_321_cov_4.094595	196	266	2	13	70	0.1857143
NODE_141786_length_321_cov_4.094595	196	266	6	22	70	0.3142857
NODE_141811_length_321_cov_3.563063	59	131	4	20	72	0.2777778
NODE_141811_length_321_cov_3.563063	59	131	5	15	72	0.2083333
NODE_141811_length_321_cov_3.563063	59	131	6	37	72	0.5138889
NODE_141811_length_321_cov_3.563063	112	183	2	47	71	0.6619718
NODE_141811_length_321_cov_3.563063	112	183	4	5	71	0.0704225
NODE_141811_length_321_cov_3.563063	112	183	6	19	71	0.2676056
NODE_141813_length_321_cov_3.540541	112	141	7	13	29	0.4482759
NODE_141813_length_321_cov_3.540541	112	141	9	7	29	0.2413793
NODE_141813_length_321_cov_3.540541	112	141	10	8	29	0.2758621
NODE_141813_length_321_cov_3.540541	112	141	11	1	29	0.0344828
NODE_141833_length_321_cov_3.049550	65	115	10	10	50	0.2000000
NODE_141833_length_321_cov_3.049550	65	115	11	12	50	0.2400000
NODE_141833_length_321_cov_3.049550	65	115	13	28	50	0.5600000
NODE_141833_length_321_cov_3.049550	95	138	13	43	43	1.0000000
NODE_141833_length_321_cov_3.049550	118	168	0	2	50	0.0400000
NODE_141833_length_321_cov_3.049550	118	168	2	1	50	0.0200000
NODE_141833_length_321_cov_3.049550	118	168	4	4	50	0.0800000
NODE_141833_length_321_cov_3.049550	118	168	5	4	50	0.0800000
NODE_141833_length_321_cov_3.049550	118	168	7	3	50	0.0600000
NODE_141833_length_321_cov_3.049550	118	168	12	13	50	0.2600000
NODE_141833_length_321_cov_3.049550	118	168	13	23	50	0.4600000
NODE_141837_length_321_cov_2.995495	146	220	0	74	74	1.0000000
NODE_141842_length_321_cov_2.981982	251	304	0	53	53	1.0000000
NODE_141876_length_321_cov_2.734234	239	306	0	67	67	1.0000000
NODE_141910_length_321_cov_2.427928	221	265	2	44	44	1.0000000
NODE_141922_length_321_cov_2.315315	22	65	0	33	43	0.7674419
NODE_141922_length_321_cov_2.315315	22	65	1	10	43	0.2325581
NODE_141951_length_321_cov_2.270270	43	105	0	5	62	0.0806452
NODE_141951_length_321_cov_2.270270	43	105	2	57	62	0.9193549
NODE_141951_length_321_cov_2.270270	120	203	0	16	83	0.1927711
NODE_141951_length_321_cov_2.270270	120	203	2	67	83	0.8072289
NODE_141951_length_321_cov_2.270270	127	208	0	21	81	0.2592593
NODE_141951_length_321_cov_2.270270	127	208	2	60	81	0.7407407
NODE_142200_length_321_cov_1.576577	241	321	0	80	80	1.0000000
NODE_142363_length_321_cov_1.319820	253	304	0	51	51	1.0000000
NODE_142484_length_321_cov_1.130631	0	43	0	43	43	1.0000000
NODE_142700_length_321_cov_0.869369	248	294	0	16	46	0.3478261
NODE_142700_length_321_cov_0.869369	248	294	2	30	46	0.6521739
NODE_142885_length_320_cov_200.484163	264	320	4	3	56	0.0535714
NODE_142885_length_320_cov_200.484163	264	320	6	2	56	0.0357143
NODE_142885_length_320_cov_200.484163	264	320	7	2	56	0.0357143
NODE_142885_length_320_cov_200.484163	264	320	9	5	56	0.0892857
NODE_142885_length_320_cov_200.484163	264	320	11	1	56	0.0178571
NODE_142885_length_320_cov_200.484163	264	320	13	3	56	0.0535714
NODE_142885_length_320_cov_200.484163	264	320	15	1	56	0.0178571
NODE_142885_length_320_cov_200.484163	264	320	17	4	56	0.0714286
NODE_142885_length_320_cov_200.484163	264	320	21	3	56	0.0535714
NODE_142885_length_320_cov_200.484163	264	320	23	1	56	0.0178571
NODE_142885_length_320_cov_200.484163	264	320	24	1	56	0.0178571
NODE_142885_length_320_cov_200.484163	264	320	25	8	56	0.1428571
NODE_142885_length_320_cov_200.484163	264	320	26	3	56	0.0535714
NODE_142885_length_320_cov_200.484163	264	320	28	4	56	0.0714286
NODE_142885_length_320_cov_200.484163	264	320	29	2	56	0.0357143
NODE_142885_length_320_cov_200.484163	264	320	31	12	56	0.2142857
NODE_142885_length_320_cov_200.484163	264	320	32	1	56	0.0178571
NODE_142886_length_320_cov_73.357466	51	97	0	46	46	1.0000000
NODE_142886_length_320_cov_73.357466	108	154	0	46	46	1.0000000
NODE_142886_length_320_cov_73.357466	165	245	0	80	80	1.0000000
NODE_142886_length_320_cov_73.357466	218	296	0	78	78	1.0000000
NODE_142887_length_320_cov_35.787330	212	292	4	22	80	0.2750000
NODE_142887_length_320_cov_35.787330	212	292	5	32	80	0.4000000
NODE_142887_length_320_cov_35.787330	212	292	6	26	80	0.3250000
NODE_142887_length_320_cov_35.787330	212	292	4	22	80	0.2750000
NODE_142887_length_320_cov_35.787330	212	292	5	32	80	0.4000000
NODE_142887_length_320_cov_35.787330	212	292	6	26	80	0.3250000
NODE_142887_length_320_cov_35.787330	212	292	4	22	80	0.2750000
NODE_142887_length_320_cov_35.787330	212	292	5	32	80	0.4000000
NODE_142887_length_320_cov_35.787330	212	292	6	26	80	0.3250000
NODE_142887_length_320_cov_35.787330	212	292	4	22	80	0.2750000
NODE_142887_length_320_cov_35.787330	212	292	5	32	80	0.4000000
NODE_142887_length_320_cov_35.787330	212	292	6	26	80	0.3250000
NODE_142887_length_320_cov_35.787330	212	292	4	22	80	0.2750000
NODE_142887_length_320_cov_35.787330	212	292	5	32	80	0.4000000
NODE_142887_length_320_cov_35.787330	212	292	6	26	80	0.3250000
NODE_142887_length_320_cov_35.787330	265	314	2	3	49	0.0612245
NODE_142887_length_320_cov_35.787330	265	314	3	6	49	0.1224490
NODE_142887_length_320_cov_35.787330	265	314	4	35	49	0.7142857
NODE_142887_length_320_cov_35.787330	265	314	5	5	49	0.1020408
NODE_142887_length_320_cov_35.787330	265	320	2	9	55	0.1636364
NODE_142887_length_320_cov_35.787330	265	320	3	6	55	0.1090909
NODE_142887_length_320_cov_35.787330	265	320	4	35	55	0.6363636
NODE_142887_length_320_cov_35.787330	265	320	5	5	55	0.0909091
NODE_142887_length_320_cov_35.787330	265	320	2	9	55	0.1636364
NODE_142887_length_320_cov_35.787330	265	320	3	6	55	0.1090909
NODE_142887_length_320_cov_35.787330	265	320	4	35	55	0.6363636
NODE_142887_length_320_cov_35.787330	265	320	5	5	55	0.0909091
NODE_142887_length_320_cov_35.787330	268	320	2	9	52	0.1730769
NODE_142887_length_320_cov_35.787330	268	320	3	6	52	0.1153846
NODE_142887_length_320_cov_35.787330	268	320	4	35	52	0.6730769
NODE_142887_length_320_cov_35.787330	268	320	5	2	52	0.0384615
NODE_142887_length_320_cov_35.787330	270	320	2	9	50	0.1800000
NODE_142887_length_320_cov_35.787330	270	320	3	6	50	0.1200000
NODE_142887_length_320_cov_35.787330	270	320	4	35	50	0.7000000
NODE_142900_length_320_cov_5.841629	115	172	0	57	57	1.0000000
NODE_142900_length_320_cov_5.841629	168	225	0	57	57	1.0000000
NODE_142934_length_320_cov_4.153846	134	200	0	66	66	1.0000000
NODE_142958_length_320_cov_3.733032	5	40	0	35	35	1.0000000
NODE_142985_length_320_cov_3.402715	142	222	1	17	80	0.2125000
NODE_142985_length_320_cov_3.402715	142	222	2	52	80	0.6500000
NODE_142985_length_320_cov_3.402715	142	222	3	11	80	0.1375000
NODE_143076_length_320_cov_2.475113	120	187	1	15	67	0.2238806
NODE_143076_length_320_cov_2.475113	120	187	2	1	67	0.0149254
NODE_143076_length_320_cov_2.475113	120	187	3	8	67	0.1194030
NODE_143076_length_320_cov_2.475113	120	187	4	11	67	0.1641791
NODE_143076_length_320_cov_2.475113	120	187	5	5	67	0.0746269
NODE_143076_length_320_cov_2.475113	120	187	7	1	67	0.0149254
NODE_143076_length_320_cov_2.475113	120	187	8	8	67	0.1194030
NODE_143076_length_320_cov_2.475113	120	187	10	1	67	0.0149254
NODE_143076_length_320_cov_2.475113	120	187	11	12	67	0.1791045
NODE_143076_length_320_cov_2.475113	120	187	13	5	67	0.0746269
NODE_143142_length_320_cov_2.171946	16	96	0	1	80	0.0125000
NODE_143142_length_320_cov_2.171946	16	96	1	1	80	0.0125000
NODE_143142_length_320_cov_2.171946	16	96	2	2	80	0.0250000
NODE_143142_length_320_cov_2.171946	16	96	3	27	80	0.3375000
NODE_143142_length_320_cov_2.171946	16	96	4	35	80	0.4375000
NODE_143142_length_320_cov_2.171946	16	96	6	14	80	0.1750000
NODE_143142_length_320_cov_2.171946	69	149	4	13	80	0.1625000
NODE_143142_length_320_cov_2.171946	69	149	6	14	80	0.1750000
NODE_143142_length_320_cov_2.171946	69	149	7	53	80	0.6625000
NODE_143207_length_320_cov_1.900452	37	117	0	80	80	1.0000000
NODE_143207_length_320_cov_1.900452	90	164	0	74	74	1.0000000
NODE_143230_length_320_cov_1.846154	188	220	4	2	32	0.0625000
NODE_143230_length_320_cov_1.846154	188	220	5	24	32	0.7500000
NODE_143230_length_320_cov_1.846154	188	220	7	6	32	0.1875000
NODE_143309_length_320_cov_1.665158	144	198	1	34	54	0.6296296
NODE_143309_length_320_cov_1.665158	144	198	2	20	54	0.3703704
NODE_143309_length_320_cov_1.665158	198	251	1	15	53	0.2830189
NODE_143309_length_320_cov_1.665158	198	251	2	38	53	0.7169811
NODE_143351_length_320_cov_1.601810	157	181	2	6	24	0.2500000
NODE_143351_length_320_cov_1.601810	157	181	3	1	24	0.0416667
NODE_143351_length_320_cov_1.601810	157	181	4	17	24	0.7083333
NODE_143351_length_320_cov_1.601810	231	290	2	59	59	1.0000000
NODE_143366_length_320_cov_1.556561	0	39	0	3	39	0.0769231
NODE_143366_length_320_cov_1.556561	0	39	1	1	39	0.0256410
NODE_143366_length_320_cov_1.556561	0	39	2	4	39	0.1025641
NODE_143366_length_320_cov_1.556561	0	39	3	4	39	0.1025641
NODE_143366_length_320_cov_1.556561	0	39	4	15	39	0.3846154
NODE_143366_length_320_cov_1.556561	0	39	6	12	39	0.3076923
NODE_143442_length_320_cov_1.384615	18	98	1	27	80	0.3375000
NODE_143442_length_320_cov_1.384615	18	98	2	42	80	0.5250000
NODE_143442_length_320_cov_1.384615	18	98	4	11	80	0.1375000
NODE_143442_length_320_cov_1.384615	71	145	2	16	74	0.2162162
NODE_143442_length_320_cov_1.384615	71	145	4	58	74	0.7837838
NODE_143521_length_320_cov_1.312217	117	170	0	8	53	0.1509434
NODE_143521_length_320_cov_1.312217	117	170	1	17	53	0.3207547
NODE_143521_length_320_cov_1.312217	117	170	2	28	53	0.5283019
NODE_143670_length_320_cov_1.117647	58	109	0	23	51	0.4509804
NODE_143670_length_320_cov_1.117647	58	109	2	28	51	0.5490196
NODE_144091_length_319_cov_5.940909	122	202	2	3	80	0.0375000
NODE_144091_length_319_cov_5.940909	122	202	3	8	80	0.1000000
NODE_144091_length_319_cov_5.940909	122	202	4	7	80	0.0875000
NODE_144091_length_319_cov_5.940909	122	202	5	8	80	0.1000000
NODE_144091_length_319_cov_5.940909	122	202	7	39	80	0.4875000
NODE_144091_length_319_cov_5.940909	122	202	8	15	80	0.1875000
NODE_144107_length_319_cov_4.700000	16	47	0	31	31	1.0000000
NODE_144137_length_319_cov_4.068182	5	36	0	31	31	1.0000000
NODE_144162_length_319_cov_3.568182	149	229	0	80	80	1.0000000
NODE_144206_length_319_cov_3.036364	112	174	0	62	62	1.0000000
NODE_144226_length_319_cov_2.800000	25	106	0	2	81	0.0246914
NODE_144226_length_319_cov_2.800000	25	106	2	3	81	0.0370370
NODE_144226_length_319_cov_2.800000	25	106	3	1	81	0.0123457
NODE_144226_length_319_cov_2.800000	25	106	8	2	81	0.0246914
NODE_144226_length_319_cov_2.800000	25	106	9	3	81	0.0370370
NODE_144226_length_319_cov_2.800000	25	106	12	1	81	0.0123457
NODE_144226_length_319_cov_2.800000	25	106	14	1	81	0.0123457
NODE_144226_length_319_cov_2.800000	25	106	17	1	81	0.0123457
NODE_144226_length_319_cov_2.800000	25	106	21	2	81	0.0246914
NODE_144226_length_319_cov_2.800000	25	106	22	4	81	0.0493827
NODE_144226_length_319_cov_2.800000	25	106	23	2	81	0.0246914
NODE_144226_length_319_cov_2.800000	25	106	24	1	81	0.0123457
NODE_144226_length_319_cov_2.800000	25	106	25	2	81	0.0246914
NODE_144226_length_319_cov_2.800000	25	106	26	3	81	0.0370370
NODE_144226_length_319_cov_2.800000	25	106	28	2	81	0.0246914
NODE_144226_length_319_cov_2.800000	25	106	31	2	81	0.0246914
NODE_144226_length_319_cov_2.800000	25	106	34	1	81	0.0123457
NODE_144226_length_319_cov_2.800000	25	106	37	1	81	0.0123457
NODE_144226_length_319_cov_2.800000	25	106	39	1	81	0.0123457
NODE_144226_length_319_cov_2.800000	25	106	42	2	81	0.0246914
NODE_144226_length_319_cov_2.800000	25	106	43	4	81	0.0493827
NODE_144226_length_319_cov_2.800000	25	106	45	5	81	0.0617284
NODE_144226_length_319_cov_2.800000	25	106	50	2	81	0.0246914
NODE_144226_length_319_cov_2.800000	25	106	56	1	81	0.0123457
NODE_144226_length_319_cov_2.800000	25	106	57	2	81	0.0246914
NODE_144226_length_319_cov_2.800000	25	106	58	3	81	0.0370370
NODE_144226_length_319_cov_2.800000	25	106	59	2	81	0.0246914
NODE_144226_length_319_cov_2.800000	25	106	60	3	81	0.0370370
NODE_144226_length_319_cov_2.800000	25	106	62	1	81	0.0123457
NODE_144226_length_319_cov_2.800000	25	106	64	11	81	0.1358025
NODE_144226_length_319_cov_2.800000	25	106	66	3	81	0.0370370
NODE_144226_length_319_cov_2.800000	25	106	67	7	81	0.0864198
NODE_144226_length_319_cov_2.800000	79	158	59	2	79	0.0253165
NODE_144226_length_319_cov_2.800000	79	158	60	5	79	0.0632911
NODE_144226_length_319_cov_2.800000	79	158	61	2	79	0.0253165
NODE_144226_length_319_cov_2.800000	79	158	62	8	79	0.1012658
NODE_144226_length_319_cov_2.800000	79	158	63	10	79	0.1265823
NODE_144226_length_319_cov_2.800000	79	158	64	30	79	0.3797468
NODE_144226_length_319_cov_2.800000	79	158	65	1	79	0.0126582
NODE_144226_length_319_cov_2.800000	79	158	66	3	79	0.0379747
NODE_144226_length_319_cov_2.800000	79	158	67	18	79	0.2278481
NODE_144237_length_319_cov_2.740909	67	147	0	4	80	0.0500000
NODE_144237_length_319_cov_2.740909	67	147	2	28	80	0.3500000
NODE_144237_length_319_cov_2.740909	67	147	4	48	80	0.6000000
NODE_144252_length_319_cov_2.586364	247	319	0	72	72	1.0000000
NODE_144272_length_319_cov_2.463636	90	153	0	17	63	0.2698413
NODE_144272_length_319_cov_2.463636	90	153	1	46	63	0.7301587
NODE_144272_length_319_cov_2.463636	163	216	1	53	53	1.0000000
NODE_144316_length_319_cov_2.259091	146	212	0	66	66	1.0000000
NODE_144340_length_319_cov_2.163636	213	275	0	62	62	1.0000000
NODE_144390_length_319_cov_1.968182	120	200	0	80	80	1.0000000
NODE_144616_length_319_cov_1.431818	111	157	8	38	46	0.8260869
NODE_144616_length_319_cov_1.431818	111	157	9	8	46	0.1739130
NODE_144629_length_319_cov_1.395455	129	179	0	33	50	0.6600000
NODE_144629_length_319_cov_1.395455	129	179	1	17	50	0.3400000
NODE_144788_length_319_cov_1.190909	119	182	1	49	63	0.7777778
NODE_144788_length_319_cov_1.190909	119	182	2	1	63	0.0158730
NODE_144788_length_319_cov_1.190909	119	182	3	13	63	0.2063492
NODE_144788_length_319_cov_1.190909	197	232	1	9	35	0.2571429
NODE_144788_length_319_cov_1.190909	197	232	3	26	35	0.7428572
NODE_145289_length_318_cov_232.639269	169	198	243	1	29	0.0344828
NODE_145289_length_318_cov_232.639269	169	198	244	4	29	0.1379310
NODE_145289_length_318_cov_232.639269	169	198	246	1	29	0.0344828
NODE_145289_length_318_cov_232.639269	169	198	247	3	29	0.1034483
NODE_145289_length_318_cov_232.639269	169	198	248	2	29	0.0689655
NODE_145289_length_318_cov_232.639269	169	198	249	6	29	0.2068966
NODE_145289_length_318_cov_232.639269	169	198	250	1	29	0.0344828
NODE_145289_length_318_cov_232.639269	169	198	251	1	29	0.0344828
NODE_145289_length_318_cov_232.639269	169	198	252	2	29	0.0689655
NODE_145289_length_318_cov_232.639269	169	198	254	4	29	0.1379310
NODE_145289_length_318_cov_232.639269	169	198	255	3	29	0.1034483
NODE_145289_length_318_cov_232.639269	169	198	256	1	29	0.0344828
NODE_145289_length_318_cov_232.639269	171	246	160	1	75	0.0133333
NODE_145289_length_318_cov_232.639269	171	246	161	1	75	0.0133333
NODE_145289_length_318_cov_232.639269	171	246	164	2	75	0.0266667
NODE_145289_length_318_cov_232.639269	171	246	168	1	75	0.0133333
NODE_145289_length_318_cov_232.639269	171	246	169	1	75	0.0133333
NODE_145289_length_318_cov_232.639269	171	246	173	1	75	0.0133333
NODE_145289_length_318_cov_232.639269	171	246	175	1	75	0.0133333
NODE_145289_length_318_cov_232.639269	171	246	176	3	75	0.0400000
NODE_145289_length_318_cov_232.639269	171	246	178	1	75	0.0133333
NODE_145289_length_318_cov_232.639269	171	246	182	1	75	0.0133333
NODE_145289_length_318_cov_232.639269	171	246	184	1	75	0.0133333
NODE_145289_length_318_cov_232.639269	171	246	189	2	75	0.0266667
NODE_145289_length_318_cov_232.639269	171	246	191	1	75	0.0133333
NODE_145289_length_318_cov_232.639269	171	246	192	1	75	0.0133333
NODE_145289_length_318_cov_232.639269	171	246	198	1	75	0.0133333
NODE_145289_length_318_cov_232.639269	171	246	199	2	75	0.0266667
NODE_145289_length_318_cov_232.639269	171	246	200	1	75	0.0133333
NODE_145289_length_318_cov_232.639269	171	246	202	1	75	0.0133333
NODE_145289_length_318_cov_232.639269	171	246	203	3	75	0.0400000
NODE_145289_length_318_cov_232.639269	171	246	205	1	75	0.0133333
NODE_145289_length_318_cov_232.639269	171	246	208	1	75	0.0133333
NODE_145289_length_318_cov_232.639269	171	246	209	1	75	0.0133333
NODE_145289_length_318_cov_232.639269	171	246	214	1	75	0.0133333
NODE_145289_length_318_cov_232.639269	171	246	216	2	75	0.0266667
NODE_145289_length_318_cov_232.639269	171	246	217	2	75	0.0266667
NODE_145289_length_318_cov_232.639269	171	246	219	1	75	0.0133333
NODE_145289_length_318_cov_232.639269	171	246	220	2	75	0.0266667
NODE_145289_length_318_cov_232.639269	171	246	221	1	75	0.0133333
NODE_145289_length_318_cov_232.639269	171	246	224	1	75	0.0133333
NODE_145289_length_318_cov_232.639269	171	246	225	2	75	0.0266667
NODE_145289_length_318_cov_232.639269	171	246	228	1	75	0.0133333
NODE_145289_length_318_cov_232.639269	171	246	229	2	75	0.0266667
NODE_145289_length_318_cov_232.639269	171	246	231	1	75	0.0133333
NODE_145289_length_318_cov_232.639269	171	246	233	1	75	0.0133333
NODE_145289_length_318_cov_232.639269	171	246	234	1	75	0.0133333
NODE_145289_length_318_cov_232.639269	171	246	235	1	75	0.0133333
NODE_145289_length_318_cov_232.639269	171	246	243	1	75	0.0133333
NODE_145289_length_318_cov_232.639269	171	246	244	4	75	0.0533333
NODE_145289_length_318_cov_232.639269	171	246	246	1	75	0.0133333
NODE_145289_length_318_cov_232.639269	171	246	247	3	75	0.0400000
NODE_145289_length_318_cov_232.639269	171	246	248	2	75	0.0266667
NODE_145289_length_318_cov_232.639269	171	246	249	6	75	0.0800000
NODE_145289_length_318_cov_232.639269	171	246	250	1	75	0.0133333
NODE_145289_length_318_cov_232.639269	171	246	251	1	75	0.0133333
NODE_145289_length_318_cov_232.639269	171	246	252	2	75	0.0266667
NODE_145289_length_318_cov_232.639269	171	246	254	3	75	0.0400000
NODE_145289_length_318_cov_232.639269	171	246	255	2	75	0.0266667
NODE_145289_length_318_cov_232.639269	171	246	256	1	75	0.0133333
NODE_145333_length_318_cov_4.237443	222	294	0	18	72	0.2500000
NODE_145333_length_318_cov_4.237443	222	294	2	54	72	0.7500000
NODE_145348_length_318_cov_3.721461	98	148	2	50	50	1.0000000
NODE_145362_length_318_cov_3.515982	60	129	0	69	69	1.0000000
NODE_145362_length_318_cov_3.515982	60	140	0	80	80	1.0000000
NODE_145362_length_318_cov_3.515982	60	140	0	80	80	1.0000000
NODE_145362_length_318_cov_3.515982	113	153	0	40	40	1.0000000
NODE_145362_length_318_cov_3.515982	122	153	0	31	31	1.0000000
NODE_145465_length_318_cov_2.557078	205	247	3	42	42	1.0000000
NODE_145551_length_318_cov_2.109589	70	150	6	67	80	0.8375000
NODE_145551_length_318_cov_2.109589	70	150	7	2	80	0.0250000
NODE_145551_length_318_cov_2.109589	70	150	8	1	80	0.0125000
NODE_145551_length_318_cov_2.109589	70	150	10	2	80	0.0250000
NODE_145551_length_318_cov_2.109589	70	150	13	4	80	0.0500000
NODE_145551_length_318_cov_2.109589	70	150	14	4	80	0.0500000
NODE_145619_length_318_cov_1.945205	229	286	0	57	57	1.0000000
NODE_145709_length_318_cov_1.739726	242	308	0	66	66	1.0000000
NODE_145725_length_318_cov_1.684932	49	80	0	31	31	1.0000000
NODE_145787_length_318_cov_1.561644	99	158	1	52	59	0.8813559
NODE_145787_length_318_cov_1.561644	99	158	2	7	59	0.1186441
NODE_145807_length_318_cov_1.493151	151	195	0	44	44	1.0000000
NODE_145807_length_318_cov_1.493151	199	258	0	23	59	0.3898305
NODE_145807_length_318_cov_1.493151	199	258	2	15	59	0.2542373
NODE_145807_length_318_cov_1.493151	199	258	5	9	59	0.1525424
NODE_145807_length_318_cov_1.493151	199	258	6	12	59	0.2033898
NODE_145968_length_318_cov_1.301370	91	141	0	50	50	1.0000000
NODE_146017_length_318_cov_1.173516	83	150	1	67	67	1.0000000
NODE_146065_length_318_cov_1.127854	24	51	2	27	27	1.0000000
NODE_146065_length_318_cov_1.127854	24	60	2	36	36	1.0000000
NODE_146467_length_317_cov_55.467890	172	243	50	1	71	0.0140845
NODE_146467_length_317_cov_55.467890	172	243	52	1	71	0.0140845
NODE_146467_length_317_cov_55.467890	172	243	53	2	71	0.0281690
NODE_146467_length_317_cov_55.467890	172	243	55	2	71	0.0281690
NODE_146467_length_317_cov_55.467890	172	243	57	1	71	0.0140845
NODE_146467_length_317_cov_55.467890	172	243	58	1	71	0.0140845
NODE_146467_length_317_cov_55.467890	172	243	59	1	71	0.0140845
NODE_146467_length_317_cov_55.467890	172	243	61	1	71	0.0140845
NODE_146467_length_317_cov_55.467890	172	243	63	2	71	0.0281690
NODE_146467_length_317_cov_55.467890	172	243	65	2	71	0.0281690
NODE_146467_length_317_cov_55.467890	172	243	66	1	71	0.0140845
NODE_146467_length_317_cov_55.467890	172	243	68	1	71	0.0140845
NODE_146467_length_317_cov_55.467890	172	243	69	2	71	0.0281690
NODE_146467_length_317_cov_55.467890	172	243	71	1	71	0.0140845
NODE_146467_length_317_cov_55.467890	172	243	72	5	71	0.0704225
NODE_146467_length_317_cov_55.467890	172	243	75	3	71	0.0422535
NODE_146467_length_317_cov_55.467890	172	243	79	1	71	0.0140845
NODE_146467_length_317_cov_55.467890	172	243	80	4	71	0.0563380
NODE_146467_length_317_cov_55.467890	172	243	82	6	71	0.0845070
NODE_146467_length_317_cov_55.467890	172	243	83	1	71	0.0140845
NODE_146467_length_317_cov_55.467890	172	243	86	2	71	0.0281690
NODE_146467_length_317_cov_55.467890	172	243	87	3	71	0.0422535
NODE_146467_length_317_cov_55.467890	172	243	88	3	71	0.0422535
NODE_146467_length_317_cov_55.467890	172	243	89	8	71	0.1126761
NODE_146467_length_317_cov_55.467890	172	243	90	2	71	0.0281690
NODE_146467_length_317_cov_55.467890	172	243	91	6	71	0.0845070
NODE_146467_length_317_cov_55.467890	172	243	92	7	71	0.0985916
NODE_146467_length_317_cov_55.467890	172	243	93	1	71	0.0140845
NODE_146487_length_317_cov_5.252294	247	307	1	60	60	1.0000000
NODE_146503_length_317_cov_4.467890	105	185	3	80	80	1.0000000
NODE_146503_length_317_cov_4.467890	113	193	3	80	80	1.0000000
NODE_146554_length_317_cov_3.298165	146	206	3	5	60	0.0833333
NODE_146554_length_317_cov_3.298165	146	206	4	3	60	0.0500000
NODE_146554_length_317_cov_3.298165	146	206	6	19	60	0.3166667
NODE_146554_length_317_cov_3.298165	146	206	7	33	60	0.5500000
NODE_146562_length_317_cov_3.266055	111	191	2	17	80	0.2125000
NODE_146562_length_317_cov_3.266055	111	191	4	63	80	0.7875000
NODE_146562_length_317_cov_3.266055	164	244	1	34	80	0.4250000
NODE_146562_length_317_cov_3.266055	164	244	2	33	80	0.4125000
NODE_146562_length_317_cov_3.266055	164	244	4	13	80	0.1625000
NODE_146585_length_317_cov_3.036697	3	79	0	76	76	1.0000000
NODE_146601_length_317_cov_2.825688	14	94	0	80	80	1.0000000
NODE_146601_length_317_cov_2.825688	67	147	0	80	80	1.0000000
NODE_146602_length_317_cov_2.821101	142	208	0	48	66	0.7272727
NODE_146602_length_317_cov_2.821101	142	208	2	18	66	0.2727273
NODE_146604_length_317_cov_2.816514	121	201	0	10	80	0.1250000
NODE_146604_length_317_cov_2.816514	121	201	1	70	80	0.8750000
NODE_146612_length_317_cov_2.779817	67	138	2	71	71	1.0000000
NODE_147046_length_317_cov_1.353211	166	239	10	8	73	0.1095890
NODE_147046_length_317_cov_1.353211	166	239	11	29	73	0.3972603
NODE_147046_length_317_cov_1.353211	166	239	12	36	73	0.4931507
NODE_147046_length_317_cov_1.353211	212	292	5	11	80	0.1375000
NODE_147046_length_317_cov_1.353211	212	292	6	5	80	0.0625000
NODE_147046_length_317_cov_1.353211	212	292	8	17	80	0.2125000
NODE_147046_length_317_cov_1.353211	212	292	10	25	80	0.3125000
NODE_147046_length_317_cov_1.353211	212	292	11	22	80	0.2750000
NODE_147172_length_317_cov_1.160550	58	117	1	19	59	0.3220339
NODE_147172_length_317_cov_1.160550	58	117	2	8	59	0.1355932
NODE_147172_length_317_cov_1.160550	58	117	4	1	59	0.0169492
NODE_147172_length_317_cov_1.160550	58	117	5	1	59	0.0169492
NODE_147172_length_317_cov_1.160550	58	117	7	1	59	0.0169492
NODE_147172_length_317_cov_1.160550	58	117	8	17	59	0.2881356
NODE_147172_length_317_cov_1.160550	58	117	9	12	59	0.2033898
NODE_147172_length_317_cov_1.160550	90	170	8	15	80	0.1875000
NODE_147172_length_317_cov_1.160550	90	170	9	24	80	0.3000000
NODE_147172_length_317_cov_1.160550	90	170	11	9	80	0.1125000
NODE_147172_length_317_cov_1.160550	90	170	12	32	80	0.4000000
NODE_147187_length_317_cov_1.137615	245	313	0	34	68	0.5000000
NODE_147187_length_317_cov_1.137615	245	313	1	34	68	0.5000000
NODE_147259_length_317_cov_0.967890	170	211	0	41	41	1.0000000
NODE_147373_length_317_cov_0.926606	194	232	0	14	38	0.3684210
NODE_147373_length_317_cov_0.926606	194	232	1	24	38	0.6315789
NODE_147383_length_317_cov_0.912844	186	244	0	58	58	1.0000000
NODE_147595_length_316_cov_31.502304	96	174	0	26	78	0.3333333
NODE_147595_length_316_cov_31.502304	96	174	1	4	78	0.0512821
NODE_147595_length_316_cov_31.502304	96	174	2	4	78	0.0512821
NODE_147595_length_316_cov_31.502304	96	174	4	8	78	0.1025641
NODE_147595_length_316_cov_31.502304	96	174	6	1	78	0.0128205
NODE_147595_length_316_cov_31.502304	96	174	7	5	78	0.0641026
NODE_147595_length_316_cov_31.502304	96	174	9	12	78	0.1538462
NODE_147595_length_316_cov_31.502304	96	174	10	18	78	0.2307692
NODE_147595_length_316_cov_31.502304	96	121	0	25	25	1.0000000
NODE_147609_length_316_cov_6.179724	225	278	0	53	53	1.0000000
NODE_147623_length_316_cov_5.539171	91	171	0	3	80	0.0375000
NODE_147623_length_316_cov_5.539171	91	171	2	15	80	0.1875000
NODE_147623_length_316_cov_5.539171	91	171	3	62	80	0.7750000
NODE_147668_length_316_cov_3.732719	128	208	1	80	80	1.0000000
NODE_147668_length_316_cov_3.732719	181	257	0	5	76	0.0657895
NODE_147668_length_316_cov_3.732719	181	257	1	71	76	0.9342105
NODE_147680_length_316_cov_3.589862	185	247	0	62	62	1.0000000
NODE_147684_length_316_cov_3.520737	101	143	1	42	42	1.0000000
NODE_147702_length_316_cov_3.221198	108	184	0	76	76	1.0000000
NODE_147734_length_316_cov_2.824885	274	311	0	37	37	1.0000000
NODE_147736_length_316_cov_2.820276	200	280	0	80	80	1.0000000
NODE_147757_length_316_cov_2.672811	23	80	1	57	57	1.0000000
NODE_147796_length_316_cov_2.456221	104	144	0	40	40	1.0000000
NODE_147985_length_316_cov_1.751152	73	122	13	20	49	0.4081633
NODE_147985_length_316_cov_1.751152	73	122	14	19	49	0.3877551
NODE_147985_length_316_cov_1.751152	73	122	16	10	49	0.2040816
NODE_148030_length_316_cov_1.640553	218	300	0	82	82	1.0000000
NODE_148042_length_316_cov_1.631336	180	233	0	53	53	1.0000000
NODE_148042_length_316_cov_1.631336	180	215	0	35	35	1.0000000
NODE_148080_length_316_cov_1.520737	194	275	0	81	81	1.0000000
NODE_148080_length_316_cov_1.520737	248	302	0	54	54	1.0000000
NODE_148086_length_316_cov_1.493088	64	144	4	4	80	0.0500000
NODE_148086_length_316_cov_1.493088	64	144	5	23	80	0.2875000
NODE_148086_length_316_cov_1.493088	64	144	6	53	80	0.6625000
NODE_148193_length_316_cov_1.377880	22	64	1	42	42	1.0000000
NODE_148204_length_316_cov_1.350230	74	117	2	43	43	1.0000000
NODE_148204_length_316_cov_1.350230	90	140	0	11	50	0.2200000
NODE_148204_length_316_cov_1.350230	90	140	2	39	50	0.7800000
NODE_148533_length_316_cov_0.940092	104	180	1	38	76	0.5000000
NODE_148533_length_316_cov_0.940092	104	180	2	18	76	0.2368421
NODE_148533_length_316_cov_0.940092	104	180	3	20	76	0.2631579
NODE_148533_length_316_cov_0.940092	155	234	1	37	79	0.4683544
NODE_148533_length_316_cov_0.940092	155	234	2	42	79	0.5316456
NODE_148693_length_316_cov_0.695853	232	267	0	35	35	1.0000000
NODE_148778_length_315_cov_6.967593	127	191	0	64	64	1.0000000
NODE_148786_length_315_cov_6.300926	67	147	0	80	80	1.0000000
NODE_148786_length_315_cov_6.300926	120	200	0	80	80	1.0000000
NODE_148812_length_315_cov_4.449074	125	205	1	5	80	0.0625000
NODE_148812_length_315_cov_4.449074	125	205	3	48	80	0.6000000
NODE_148812_length_315_cov_4.449074	125	205	4	10	80	0.1250000
NODE_148812_length_315_cov_4.449074	125	205	5	17	80	0.2125000
NODE_148812_length_315_cov_4.449074	178	225	1	5	47	0.1063830
NODE_148812_length_315_cov_4.449074	178	225	2	4	47	0.0851064
NODE_148812_length_315_cov_4.449074	178	225	3	38	47	0.8085107
NODE_148834_length_315_cov_4.009259	0	61	0	61	61	1.0000000
NODE_148834_length_315_cov_4.009259	42	61	0	19	19	1.0000000
NODE_148872_length_315_cov_3.421296	37	120	2	83	83	1.0000000
NODE_148915_length_315_cov_2.847222	0	74	0	74	74	1.0000000
NODE_148915_length_315_cov_2.847222	47	127	0	80	80	1.0000000
NODE_148921_length_315_cov_2.833333	186	253	0	67	67	1.0000000
NODE_148921_length_315_cov_2.833333	186	253	0	67	67	1.0000000
NODE_148991_length_315_cov_2.416667	44	117	24	1	73	0.0136986
NODE_148991_length_315_cov_2.416667	44	117	25	1	73	0.0136986
NODE_148991_length_315_cov_2.416667	44	117	26	2	73	0.0273973
NODE_148991_length_315_cov_2.416667	44	117	28	1	73	0.0136986
NODE_148991_length_315_cov_2.416667	44	117	31	1	73	0.0136986
NODE_148991_length_315_cov_2.416667	44	117	32	1	73	0.0136986
NODE_148991_length_315_cov_2.416667	44	117	33	1	73	0.0136986
NODE_148991_length_315_cov_2.416667	44	117	36	2	73	0.0273973
NODE_148991_length_315_cov_2.416667	44	117	37	1	73	0.0136986
NODE_148991_length_315_cov_2.416667	44	117	41	1	73	0.0136986
NODE_148991_length_315_cov_2.416667	44	117	42	1	73	0.0136986
NODE_148991_length_315_cov_2.416667	44	117	46	1	73	0.0136986
NODE_148991_length_315_cov_2.416667	44	117	47	1	73	0.0136986
NODE_148991_length_315_cov_2.416667	44	117	49	2	73	0.0273973
NODE_148991_length_315_cov_2.416667	44	117	51	1	73	0.0136986
NODE_148991_length_315_cov_2.416667	44	117	52	2	73	0.0273973
NODE_148991_length_315_cov_2.416667	44	117	60	2	73	0.0273973
NODE_148991_length_315_cov_2.416667	44	117	63	2	73	0.0273973
NODE_148991_length_315_cov_2.416667	44	117	64	1	73	0.0136986
NODE_148991_length_315_cov_2.416667	44	117	65	1	73	0.0136986
NODE_148991_length_315_cov_2.416667	44	117	69	1	73	0.0136986
NODE_148991_length_315_cov_2.416667	44	117	71	2	73	0.0273973
NODE_148991_length_315_cov_2.416667	44	117	73	4	73	0.0547945
NODE_148991_length_315_cov_2.416667	44	117	74	1	73	0.0136986
NODE_148991_length_315_cov_2.416667	44	117	77	1	73	0.0136986
NODE_148991_length_315_cov_2.416667	44	117	79	2	73	0.0273973
NODE_148991_length_315_cov_2.416667	44	117	80	2	73	0.0273973
NODE_148991_length_315_cov_2.416667	44	117	81	4	73	0.0547945
NODE_148991_length_315_cov_2.416667	44	117	83	1	73	0.0136986
NODE_148991_length_315_cov_2.416667	44	117	84	6	73	0.0821918
NODE_148991_length_315_cov_2.416667	44	117	85	1	73	0.0136986
NODE_148991_length_315_cov_2.416667	44	117	87	1	73	0.0136986
NODE_148991_length_315_cov_2.416667	44	117	91	1	73	0.0136986
NODE_148991_length_315_cov_2.416667	44	117	92	2	73	0.0273973
NODE_148991_length_315_cov_2.416667	44	117	100	1	73	0.0136986
NODE_148991_length_315_cov_2.416667	44	117	104	1	73	0.0136986
NODE_148991_length_315_cov_2.416667	44	117	108	1	73	0.0136986
NODE_148991_length_315_cov_2.416667	44	117	111	3	73	0.0410959
NODE_148991_length_315_cov_2.416667	44	117	112	2	73	0.0273973
NODE_148991_length_315_cov_2.416667	44	117	113	1	73	0.0136986
NODE_148991_length_315_cov_2.416667	44	117	114	4	73	0.0547945
NODE_148991_length_315_cov_2.416667	44	117	115	1	73	0.0136986
NODE_148991_length_315_cov_2.416667	44	117	116	1	73	0.0136986
NODE_148991_length_315_cov_2.416667	44	117	117	1	73	0.0136986
NODE_148991_length_315_cov_2.416667	44	117	118	1	73	0.0136986
NODE_148991_length_315_cov_2.416667	44	117	119	1	73	0.0136986
NODE_149074_length_315_cov_2.115741	128	193	0	65	65	1.0000000
NODE_149095_length_315_cov_2.004630	270	315	0	45	45	1.0000000
NODE_149201_length_315_cov_1.731481	125	202	1	21	77	0.2727273
NODE_149201_length_315_cov_1.731481	125	202	2	33	77	0.4285714
NODE_149201_length_315_cov_1.731481	125	202	4	10	77	0.1298701
NODE_149201_length_315_cov_1.731481	125	202	5	13	77	0.1688312
NODE_149391_length_315_cov_1.384259	183	233	0	50	50	1.0000000
NODE_149935_length_315_cov_0.430556	125	145	0	20	20	1.0000000
NODE_149943_length_314_cov_108.139535	151	213	13	3	62	0.0483871
NODE_149943_length_314_cov_108.139535	151	213	15	13	62	0.2096774
NODE_149943_length_314_cov_108.139535	151	213	16	27	62	0.4354839
NODE_149943_length_314_cov_108.139535	151	213	17	19	62	0.3064516
NODE_149943_length_314_cov_108.139535	160	213	13	3	53	0.0566038
NODE_149943_length_314_cov_108.139535	160	213	15	8	53	0.1509434
NODE_149943_length_314_cov_108.139535	160	213	16	23	53	0.4339623
NODE_149943_length_314_cov_108.139535	160	213	17	19	53	0.3584906
NODE_149944_length_314_cov_48.134884	245	314	0	69	69	1.0000000
NODE_149946_length_314_cov_9.097674	149	206	0	57	57	1.0000000
NODE_149967_length_314_cov_4.897674	109	189	2	80	80	1.0000000
NODE_150004_length_314_cov_3.823256	119	199	0	80	80	1.0000000
NODE_150020_length_314_cov_3.558140	32	92	2	35	60	0.5833333
NODE_150020_length_314_cov_3.558140	32	92	3	25	60	0.4166667
NODE_150035_length_314_cov_3.316279	84	126	6	42	42	1.0000000
NODE_150035_length_314_cov_3.316279	127	180	2	1	53	0.0188679
NODE_150035_length_314_cov_3.316279	127	180	4	21	53	0.3962264
NODE_150035_length_314_cov_3.316279	127	180	5	7	53	0.1320755
NODE_150035_length_314_cov_3.316279	127	180	6	24	53	0.4528302
NODE_150035_length_314_cov_3.316279	128	148	6	20	20	1.0000000
NODE_150066_length_314_cov_3.032558	252	308	0	8	56	0.1428571
NODE_150066_length_314_cov_3.032558	252	308	4	28	56	0.5000000
NODE_150066_length_314_cov_3.032558	252	308	6	20	56	0.3571429
NODE_150141_length_314_cov_2.520930	0	61	3	36	61	0.5901639
NODE_150141_length_314_cov_2.520930	0	61	5	25	61	0.4098361
NODE_150141_length_314_cov_2.520930	34	93	3	2	59	0.0338983
NODE_150141_length_314_cov_2.520930	34	93	5	47	59	0.7966102
NODE_150141_length_314_cov_2.520930	34	93	6	10	59	0.1694915
NODE_150153_length_314_cov_2.441860	48	84	0	36	36	1.0000000
NODE_150159_length_314_cov_2.395349	62	112	0	10	50	0.2000000
NODE_150159_length_314_cov_2.395349	62	112	1	40	50	0.8000000
NODE_150200_length_314_cov_2.265116	7	53	0	19	46	0.4130435
NODE_150200_length_314_cov_2.265116	7	53	2	10	46	0.2173913
NODE_150200_length_314_cov_2.265116	7	53	3	8	46	0.1739130
NODE_150200_length_314_cov_2.265116	7	53	4	3	46	0.0652174
NODE_150200_length_314_cov_2.265116	7	53	5	6	46	0.1304348
NODE_150220_length_314_cov_2.144186	224	264	0	40	40	1.0000000
NODE_150257_length_314_cov_2.004651	68	148	0	80	80	1.0000000
NODE_150257_length_314_cov_2.004651	121	201	0	80	80	1.0000000
NODE_150385_length_314_cov_1.665116	204	242	0	38	38	1.0000000
NODE_150385_length_314_cov_1.665116	215	295	0	80	80	1.0000000
NODE_150647_length_314_cov_1.223256	7	87	2	80	80	1.0000000
NODE_150709_length_314_cov_1.167442	1	69	0	68	68	1.0000000
NODE_151193_length_313_cov_156.051402	177	254	0	4	77	0.0519481
NODE_151193_length_313_cov_156.051402	177	254	2	73	77	0.9480519
NODE_151193_length_313_cov_156.051402	177	254	0	4	77	0.0519481
NODE_151193_length_313_cov_156.051402	177	254	2	73	77	0.9480519
NODE_151214_length_313_cov_5.359813	135	196	4	61	61	1.0000000
NODE_151214_length_313_cov_5.359813	169	241	4	72	72	1.0000000
NODE_151230_length_313_cov_4.794393	126	206	0	68	80	0.8500000
NODE_151230_length_313_cov_4.794393	126	206	1	12	80	0.1500000
NODE_151230_length_313_cov_4.794393	179	259	0	15	80	0.1875000
NODE_151230_length_313_cov_4.794393	179	259	1	65	80	0.8125000
NODE_151232_length_313_cov_4.761682	104	162	0	58	58	1.0000000
NODE_151232_length_313_cov_4.761682	135	215	0	80	80	1.0000000
NODE_151277_length_313_cov_3.560748	106	186	4	79	80	0.9875000
NODE_151277_length_313_cov_3.560748	106	186	6	1	80	0.0125000
NODE_151331_length_313_cov_2.953271	92	153	2	15	61	0.2459016
NODE_151331_length_313_cov_2.953271	92	153	3	46	61	0.7540984
NODE_151364_length_313_cov_2.640187	110	182	1	72	72	1.0000000
NODE_151364_length_313_cov_2.640187	113	184	1	71	71	1.0000000
NODE_151409_length_313_cov_2.383178	58	137	0	56	79	0.7088608
NODE_151409_length_313_cov_2.383178	58	137	4	23	79	0.2911392
NODE_151409_length_313_cov_2.383178	110	190	0	4	80	0.0500000
NODE_151409_length_313_cov_2.383178	110	190	4	74	80	0.9250000
NODE_151409_length_313_cov_2.383178	110	190	7	2	80	0.0250000
NODE_151474_length_313_cov_2.107477	153	221	0	68	68	1.0000000
NODE_151510_length_313_cov_1.934579	107	187	0	17	80	0.2125000
NODE_151510_length_313_cov_1.934579	107	187	2	18	80	0.2250000
NODE_151510_length_313_cov_1.934579	107	187	4	2	80	0.0250000
NODE_151510_length_313_cov_1.934579	107	187	5	2	80	0.0250000
NODE_151510_length_313_cov_1.934579	107	187	8	2	80	0.0250000
NODE_151510_length_313_cov_1.934579	107	187	9	5	80	0.0625000
NODE_151510_length_313_cov_1.934579	107	187	11	1	80	0.0125000
NODE_151510_length_313_cov_1.934579	107	187	13	2	80	0.0250000
NODE_151510_length_313_cov_1.934579	107	187	15	5	80	0.0625000
NODE_151510_length_313_cov_1.934579	107	187	17	5	80	0.0625000
NODE_151510_length_313_cov_1.934579	107	187	19	1	80	0.0125000
NODE_151510_length_313_cov_1.934579	107	187	20	1	80	0.0125000
NODE_151510_length_313_cov_1.934579	107	187	21	5	80	0.0625000
NODE_151510_length_313_cov_1.934579	107	187	23	2	80	0.0250000
NODE_151510_length_313_cov_1.934579	107	187	24	12	80	0.1500000
NODE_151510_length_313_cov_1.934579	160	240	15	1	80	0.0125000
NODE_151510_length_313_cov_1.934579	160	240	17	5	80	0.0625000
NODE_151510_length_313_cov_1.934579	160	240	19	1	80	0.0125000
NODE_151510_length_313_cov_1.934579	160	240	20	1	80	0.0125000
NODE_151510_length_313_cov_1.934579	160	240	21	5	80	0.0625000
NODE_151510_length_313_cov_1.934579	160	240	22	15	80	0.1875000
NODE_151510_length_313_cov_1.934579	160	240	23	2	80	0.0250000
NODE_151510_length_313_cov_1.934579	160	240	24	50	80	0.6250000
NODE_151576_length_313_cov_1.780374	236	296	0	60	60	1.0000000
NODE_151623_length_313_cov_1.663551	58	135	10	4	77	0.0519481
NODE_151623_length_313_cov_1.663551	58	135	11	14	77	0.1818182
NODE_151623_length_313_cov_1.663551	58	135	14	10	77	0.1298701
NODE_151623_length_313_cov_1.663551	58	135	16	10	77	0.1298701
NODE_151623_length_313_cov_1.663551	58	135	17	37	77	0.4805195
NODE_151623_length_313_cov_1.663551	58	135	19	2	77	0.0259740
NODE_151703_length_313_cov_1.439252	0	64	0	64	64	1.0000000
NODE_151703_length_313_cov_1.439252	37	82	0	45	45	1.0000000
NODE_151753_length_313_cov_1.429907	74	111	0	37	37	1.0000000
NODE_151753_length_313_cov_1.429907	109	172	0	63	63	1.0000000
NODE_151953_length_313_cov_1.172897	106	161	4	8	55	0.1454545
NODE_151953_length_313_cov_1.172897	106	161	5	5	55	0.0909091
NODE_151953_length_313_cov_1.172897	106	161	6	19	55	0.3454545
NODE_151953_length_313_cov_1.172897	106	161	7	13	55	0.2363636
NODE_151953_length_313_cov_1.172897	106	161	9	10	55	0.1818182
NODE_151953_length_313_cov_1.172897	149	214	7	2	65	0.0307692
NODE_151953_length_313_cov_1.172897	149	214	9	28	65	0.4307692
NODE_151953_length_313_cov_1.172897	149	214	10	17	65	0.2615385
NODE_151953_length_313_cov_1.172897	149	214	11	18	65	0.2769231
NODE_152525_length_312_cov_3.723005	178	238	0	60	60	1.0000000
NODE_152525_length_312_cov_3.723005	231	291	0	60	60	1.0000000
NODE_152609_length_312_cov_2.723005	34	96	0	62	62	1.0000000
NODE_152609_length_312_cov_2.723005	87	149	0	62	62	1.0000000
NODE_152680_length_312_cov_2.333333	6	70	0	64	64	1.0000000
NODE_152680_length_312_cov_2.333333	43	123	0	80	80	1.0000000
NODE_152686_length_312_cov_2.267606	176	208	5	10	32	0.3125000
NODE_152686_length_312_cov_2.267606	176	208	7	2	32	0.0625000
NODE_152686_length_312_cov_2.267606	176	208	8	10	32	0.3125000
NODE_152686_length_312_cov_2.267606	176	208	10	10	32	0.3125000
NODE_152697_length_312_cov_2.234742	108	169	0	56	61	0.9180328
NODE_152697_length_312_cov_2.234742	108	169	3	1	61	0.0163934
NODE_152697_length_312_cov_2.234742	108	169	4	1	61	0.0163934
NODE_152697_length_312_cov_2.234742	108	169	5	3	61	0.0491803
NODE_152751_length_312_cov_2.014085	141	205	6	25	64	0.3906250
NODE_152751_length_312_cov_2.014085	141	205	7	13	64	0.2031250
NODE_152751_length_312_cov_2.014085	141	205	8	19	64	0.2968750
NODE_152751_length_312_cov_2.014085	141	205	10	7	64	0.1093750
NODE_152751_length_312_cov_2.014085	178	258	5	28	80	0.3500000
NODE_152751_length_312_cov_2.014085	178	258	6	33	80	0.4125000
NODE_152751_length_312_cov_2.014085	178	258	7	13	80	0.1625000
NODE_152751_length_312_cov_2.014085	178	258	8	6	80	0.0750000
NODE_152827_length_312_cov_1.835681	176	221	0	45	45	1.0000000
NODE_152827_length_312_cov_1.835681	194	269	0	75	75	1.0000000
NODE_153222_length_312_cov_1.173709	87	133	3	4	46	0.0869565
NODE_153222_length_312_cov_1.173709	87	133	4	7	46	0.1521739
NODE_153222_length_312_cov_1.173709	87	133	5	1	46	0.0217391
NODE_153222_length_312_cov_1.173709	87	133	6	11	46	0.2391304
NODE_153222_length_312_cov_1.173709	87	133	7	1	46	0.0217391
NODE_153222_length_312_cov_1.173709	87	133	9	1	46	0.0217391
NODE_153222_length_312_cov_1.173709	87	133	10	9	46	0.1956522
NODE_153222_length_312_cov_1.173709	87	133	11	2	46	0.0434783
NODE_153222_length_312_cov_1.173709	87	133	12	10	46	0.2173913
NODE_153222_length_312_cov_1.173709	150	217	22	1	67	0.0149254
NODE_153222_length_312_cov_1.173709	150	217	23	1	67	0.0149254
NODE_153222_length_312_cov_1.173709	150	217	25	1	67	0.0149254
NODE_153222_length_312_cov_1.173709	150	217	26	4	67	0.0597015
NODE_153222_length_312_cov_1.173709	150	217	28	3	67	0.0447761
NODE_153222_length_312_cov_1.173709	150	217	30	2	67	0.0298507
NODE_153222_length_312_cov_1.173709	150	217	35	6	67	0.0895522
NODE_153222_length_312_cov_1.173709	150	217	36	10	67	0.1492537
NODE_153222_length_312_cov_1.173709	150	217	38	3	67	0.0447761
NODE_153222_length_312_cov_1.173709	150	217	40	32	67	0.4776119
NODE_153222_length_312_cov_1.173709	150	217	42	1	67	0.0149254
NODE_153222_length_312_cov_1.173709	150	217	44	3	67	0.0447761
NODE_153532_length_312_cov_0.788732	49	110	0	61	61	1.0000000
NODE_153532_length_312_cov_0.788732	102	163	0	61	61	1.0000000
NODE_153708_length_311_cov_5.179245	155	235	1	45	80	0.5625000
NODE_153708_length_311_cov_5.179245	155	235	2	35	80	0.4375000
NODE_153721_length_311_cov_4.589623	133	200	0	67	67	1.0000000
NODE_153730_length_311_cov_4.358491	199	263	2	64	64	1.0000000
NODE_153743_length_311_cov_3.929245	91	127	0	36	36	1.0000000
NODE_153755_length_311_cov_3.825472	224	304	0	40	80	0.5000000
NODE_153755_length_311_cov_3.825472	224	304	1	35	80	0.4375000
NODE_153755_length_311_cov_3.825472	224	304	2	5	80	0.0625000
NODE_153773_length_311_cov_3.466981	106	186	3	2	80	0.0250000
NODE_153773_length_311_cov_3.466981	106	186	4	9	80	0.1125000
NODE_153773_length_311_cov_3.466981	106	186	5	60	80	0.7500000
NODE_153773_length_311_cov_3.466981	106	186	6	6	80	0.0750000
NODE_153773_length_311_cov_3.466981	106	186	7	3	80	0.0375000
NODE_153796_length_311_cov_3.188679	39	96	4	23	57	0.4035088
NODE_153796_length_311_cov_3.188679	39	96	5	34	57	0.5964912
NODE_153846_length_311_cov_2.702830	144	193	0	49	49	1.0000000
NODE_153850_length_311_cov_2.665094	43	113	0	17	70	0.2428571
NODE_153850_length_311_cov_2.665094	43	113	1	53	70	0.7571428
NODE_153859_length_311_cov_2.617925	206	284	3	39	78	0.5000000
NODE_153859_length_311_cov_2.617925	206	284	4	39	78	0.5000000
NODE_153859_length_311_cov_2.617925	257	301	1	7	44	0.1590909
NODE_153859_length_311_cov_2.617925	257	301	2	7	44	0.1590909
NODE_153859_length_311_cov_2.617925	257	301	3	19	44	0.4318182
NODE_153859_length_311_cov_2.617925	257	301	4	11	44	0.2500000
NODE_153913_length_311_cov_2.349057	177	204	0	27	27	1.0000000
NODE_153919_length_311_cov_2.325472	74	138	0	64	64	1.0000000
NODE_153947_length_311_cov_2.188679	21	92	0	71	71	1.0000000
NODE_154014_length_311_cov_1.924528	46	65	0	19	19	1.0000000
NODE_154056_length_311_cov_1.891509	122	180	5	23	58	0.3965517
NODE_154056_length_311_cov_1.891509	122	180	6	35	58	0.6034483
NODE_154188_length_311_cov_1.594340	0	35	0	35	35	1.0000000
NODE_154190_length_311_cov_1.589623	96	151	1	55	55	1.0000000
NODE_154194_length_311_cov_1.570755	125	145	4	20	20	1.0000000
NODE_154957_length_311_cov_0.613208	136	216	0	80	80	1.0000000
NODE_154957_length_311_cov_0.613208	189	264	0	75	75	1.0000000
NODE_154996_length_310_cov_96.995261	211	249	95	1	38	0.0263158
NODE_154996_length_310_cov_96.995261	211	249	96	2	38	0.0526316
NODE_154996_length_310_cov_96.995261	211	249	97	3	38	0.0789474
NODE_154996_length_310_cov_96.995261	211	249	98	1	38	0.0263158
NODE_154996_length_310_cov_96.995261	211	249	99	1	38	0.0263158
NODE_154996_length_310_cov_96.995261	211	249	100	2	38	0.0526316
NODE_154996_length_310_cov_96.995261	211	249	101	1	38	0.0263158
NODE_154996_length_310_cov_96.995261	211	249	103	1	38	0.0263158
NODE_154996_length_310_cov_96.995261	211	249	104	1	38	0.0263158
NODE_154996_length_310_cov_96.995261	211	249	106	1	38	0.0263158
NODE_154996_length_310_cov_96.995261	211	249	110	3	38	0.0789474
NODE_154996_length_310_cov_96.995261	211	249	111	3	38	0.0789474
NODE_154996_length_310_cov_96.995261	211	249	112	1	38	0.0263158
NODE_154996_length_310_cov_96.995261	211	249	114	1	38	0.0263158
NODE_154996_length_310_cov_96.995261	211	249	115	2	38	0.0526316
NODE_154996_length_310_cov_96.995261	211	249	116	1	38	0.0263158
NODE_154996_length_310_cov_96.995261	211	249	117	1	38	0.0263158
NODE_154996_length_310_cov_96.995261	211	249	118	1	38	0.0263158
NODE_154996_length_310_cov_96.995261	211	249	122	2	38	0.0526316
NODE_154996_length_310_cov_96.995261	211	249	123	1	38	0.0263158
NODE_154996_length_310_cov_96.995261	211	249	125	2	38	0.0526316
NODE_154996_length_310_cov_96.995261	211	249	126	1	38	0.0263158
NODE_154996_length_310_cov_96.995261	211	249	128	1	38	0.0263158
NODE_154996_length_310_cov_96.995261	211	249	129	1	38	0.0263158
NODE_154996_length_310_cov_96.995261	211	249	131	1	38	0.0263158
NODE_154996_length_310_cov_96.995261	211	249	137	1	38	0.0263158
NODE_154996_length_310_cov_96.995261	211	249	140	1	38	0.0263158
NODE_155001_length_310_cov_7.767773	80	151	0	71	71	1.0000000
NODE_155001_length_310_cov_7.767773	134	189	0	55	55	1.0000000
NODE_155017_length_310_cov_5.914692	84	134	0	49	50	0.9800000
NODE_155017_length_310_cov_5.914692	84	134	1	1	50	0.0200000
NODE_155017_length_310_cov_5.914692	113	134	0	21	21	1.0000000
NODE_155017_length_310_cov_5.914692	113	188	0	75	75	1.0000000
NODE_155066_length_310_cov_3.777251	146	226	1	25	80	0.3125000
NODE_155066_length_310_cov_3.777251	146	226	2	55	80	0.6875000
NODE_155115_length_310_cov_3.180095	137	211	1	10	74	0.1351351
NODE_155115_length_310_cov_3.180095	137	211	2	24	74	0.3243243
NODE_155115_length_310_cov_3.180095	137	211	4	34	74	0.4594595
NODE_155115_length_310_cov_3.180095	137	211	5	6	74	0.0810811
NODE_155179_length_310_cov_2.630332	122	174	0	52	52	1.0000000
NODE_155179_length_310_cov_2.630332	175	222	0	47	47	1.0000000
NODE_155180_length_310_cov_2.625592	258	301	2	43	43	1.0000000
NODE_155195_length_310_cov_2.563981	149	196	1	4	47	0.0851064
NODE_155195_length_310_cov_2.563981	149	196	2	1	47	0.0212766
NODE_155195_length_310_cov_2.563981	149	196	3	13	47	0.2765957
NODE_155195_length_310_cov_2.563981	149	196	5	17	47	0.3617021
NODE_155195_length_310_cov_2.563981	149	196	7	10	47	0.2127660
NODE_155195_length_310_cov_2.563981	149	196	8	2	47	0.0425532
NODE_155195_length_310_cov_2.563981	169	249	0	33	80	0.4125000
NODE_155195_length_310_cov_2.563981	169	249	1	24	80	0.3000000
NODE_155195_length_310_cov_2.563981	169	249	2	1	80	0.0125000
NODE_155195_length_310_cov_2.563981	169	249	3	13	80	0.1625000
NODE_155195_length_310_cov_2.563981	169	249	5	9	80	0.1125000
NODE_155261_length_310_cov_2.298578	213	259	0	46	46	1.0000000
NODE_155334_length_310_cov_2.009479	223	303	0	80	80	1.0000000
NODE_155439_length_310_cov_1.729858	53	91	0	38	38	1.0000000
NODE_155768_length_310_cov_1.222749	181	244	1	63	63	1.0000000
NODE_155864_length_310_cov_1.142180	65	135	0	70	70	1.0000000
NODE_155937_length_310_cov_0.966825	131	212	0	24	81	0.2962963
NODE_155937_length_310_cov_0.966825	131	212	1	2	81	0.0246914
NODE_155937_length_310_cov_0.966825	131	212	2	55	81	0.6790124
NODE_155937_length_310_cov_0.966825	193	256	2	63	63	1.0000000
NODE_156078_length_310_cov_0.924171	180	222	0	42	42	1.0000000
NODE_156174_length_310_cov_0.739336	208	288	0	80	80	1.0000000
NODE_156332_length_309_cov_8.552381	154	234	2	6	80	0.0750000
NODE_156332_length_309_cov_8.552381	154	234	4	9	80	0.1125000
NODE_156332_length_309_cov_8.552381	154	234	5	65	80	0.8125000
NODE_156340_length_309_cov_6.147619	20	83	0	63	63	1.0000000
NODE_156349_length_309_cov_5.147619	213	291	0	78	78	1.0000000
NODE_156364_length_309_cov_4.585714	15	95	0	80	80	1.0000000
NODE_156472_length_309_cov_3.028571	0	47	1	47	47	1.0000000
NODE_156472_length_309_cov_3.028571	20	101	1	81	81	1.0000000
NODE_156563_length_309_cov_2.304762	179	218	0	14	39	0.3589744
NODE_156563_length_309_cov_2.304762	179	218	3	25	39	0.6410257
NODE_156615_length_309_cov_2.095238	55	85	0	30	30	1.0000000
NODE_156678_length_309_cov_1.938095	2	73	0	71	71	1.0000000
NODE_156950_length_309_cov_1.414286	189	231	0	38	42	0.9047619
NODE_156950_length_309_cov_1.414286	189	231	2	4	42	0.0952381
NODE_156978_length_309_cov_1.376190	94	168	1	18	74	0.2432432
NODE_156978_length_309_cov_1.376190	94	168	2	37	74	0.5000000
NODE_156978_length_309_cov_1.376190	94	168	4	19	74	0.2567568
NODE_157334_length_309_cov_0.966667	134	153	4	19	19	1.0000000
NODE_157469_length_309_cov_0.738095	150	215	7	11	65	0.1692308
NODE_157469_length_309_cov_0.738095	150	215	8	54	65	0.8307692
NODE_157661_length_308_cov_4.775120	137	174	0	37	37	1.0000000
NODE_157690_length_308_cov_3.966507	126	206	2	1	80	0.0125000
NODE_157690_length_308_cov_3.966507	126	206	3	8	80	0.1000000
NODE_157690_length_308_cov_3.966507	126	206	4	31	80	0.3875000
NODE_157690_length_308_cov_3.966507	126	206	5	12	80	0.1500000
NODE_157690_length_308_cov_3.966507	126	206	6	13	80	0.1625000
NODE_157690_length_308_cov_3.966507	126	206	8	15	80	0.1875000
NODE_157705_length_308_cov_3.665072	11	75	0	64	64	1.0000000
NODE_157819_length_308_cov_2.593301	137	193	0	1	56	0.0178571
NODE_157819_length_308_cov_2.593301	137	193	2	55	56	0.9821429
NODE_157852_length_308_cov_2.435407	14	58	0	44	44	1.0000000
NODE_157852_length_308_cov_2.435407	31	111	0	80	80	1.0000000
NODE_157898_length_308_cov_2.191388	14	80	0	66	66	1.0000000
NODE_157903_length_308_cov_2.191388	236	296	0	60	60	1.0000000
NODE_157969_length_308_cov_1.952153	251	296	0	45	45	1.0000000
NODE_158083_length_308_cov_1.708134	102	148	1	46	46	1.0000000
NODE_158276_length_308_cov_1.435407	196	276	0	80	80	1.0000000
NODE_158439_length_308_cov_1.162679	260	300	0	40	40	1.0000000
NODE_158439_length_308_cov_1.162679	273	307	0	34	34	1.0000000
NODE_158447_length_308_cov_1.148325	35	83	0	48	48	1.0000000
NODE_158448_length_308_cov_1.148325	253	308	0	39	55	0.7090909
NODE_158448_length_308_cov_1.148325	253	308	1	16	55	0.2909091
NODE_158510_length_308_cov_1.038278	147	202	0	55	55	1.0000000
NODE_158811_length_308_cov_0.684211	196	275	0	3	79	0.0379747
NODE_158811_length_308_cov_0.684211	196	275	1	41	79	0.5189874
NODE_158811_length_308_cov_0.684211	196	275	2	35	79	0.4430380
NODE_158821_length_308_cov_0.660287	109	157	1	48	48	1.0000000
NODE_158821_length_308_cov_0.660287	130	210	0	20	80	0.2500000
NODE_158821_length_308_cov_0.660287	130	210	1	60	80	0.7500000
NODE_158905_length_307_cov_30.725962	0	73	1	25	73	0.3424658
NODE_158905_length_307_cov_30.725962	0	73	3	37	73	0.5068493
NODE_158905_length_307_cov_30.725962	0	73	4	11	73	0.1506849
NODE_158905_length_307_cov_30.725962	46	99	3	16	53	0.3018868
NODE_158905_length_307_cov_30.725962	46	99	4	27	53	0.5094340
NODE_158905_length_307_cov_30.725962	46	99	6	10	53	0.1886792
NODE_158906_length_307_cov_25.096154	84	164	0	80	80	1.0000000
NODE_158906_length_307_cov_25.096154	137	217	0	80	80	1.0000000
NODE_158933_length_307_cov_5.524038	150	221	1	55	71	0.7746479
NODE_158933_length_307_cov_5.524038	150	221	3	16	71	0.2253521
NODE_158983_length_307_cov_3.730769	172	252	1	8	80	0.1000000
NODE_158983_length_307_cov_3.730769	172	252	2	72	80	0.9000000
NODE_158983_length_307_cov_3.730769	225	305	1	12	80	0.1500000
NODE_158983_length_307_cov_3.730769	225	305	2	68	80	0.8500000
NODE_158999_length_307_cov_3.322115	20	100	0	4	80	0.0500000
NODE_158999_length_307_cov_3.322115	20	100	1	12	80	0.1500000
NODE_158999_length_307_cov_3.322115	20	100	2	11	80	0.1375000
NODE_158999_length_307_cov_3.322115	20	100	3	53	80	0.6625000
NODE_158999_length_307_cov_3.322115	78	153	3	64	75	0.8533334
NODE_158999_length_307_cov_3.322115	78	153	5	11	75	0.1466667
NODE_159000_length_307_cov_3.317308	12	94	0	82	82	1.0000000
NODE_159000_length_307_cov_3.317308	76	134	0	58	58	1.0000000
NODE_159053_length_307_cov_2.870192	43	108	0	65	65	1.0000000
NODE_159084_length_307_cov_2.653846	117	177	13	8	60	0.1333333
NODE_159084_length_307_cov_2.653846	117	177	14	8	60	0.1333333
NODE_159084_length_307_cov_2.653846	117	177	15	4	60	0.0666667
NODE_159084_length_307_cov_2.653846	117	177	16	5	60	0.0833333
NODE_159084_length_307_cov_2.653846	117	177	18	13	60	0.2166667
NODE_159084_length_307_cov_2.653846	117	177	19	10	60	0.1666667
NODE_159084_length_307_cov_2.653846	117	177	20	12	60	0.2000000
NODE_159142_length_307_cov_2.346154	54	105	2	45	51	0.8823529
NODE_159142_length_307_cov_2.346154	54	105	4	6	51	0.1176471
NODE_159351_length_307_cov_1.716346	124	165	2	3	41	0.0731707
NODE_159351_length_307_cov_1.716346	124	165	3	38	41	0.9268293
NODE_159362_length_307_cov_1.716346	30	93	0	63	63	1.0000000
NODE_159407_length_307_cov_1.600962	221	269	4	1	48	0.0208333
NODE_159407_length_307_cov_1.600962	221	269	6	36	48	0.7500000
NODE_159407_length_307_cov_1.600962	221	269	7	11	48	0.2291667
NODE_159407_length_307_cov_1.600962	242	307	1	20	65	0.3076923
NODE_159407_length_307_cov_1.600962	242	307	2	1	65	0.0153846
NODE_159407_length_307_cov_1.600962	242	307	4	18	65	0.2769231
NODE_159407_length_307_cov_1.600962	242	307	6	26	65	0.4000000
NODE_159447_length_307_cov_1.475962	252	307	0	55	55	1.0000000
NODE_159585_length_307_cov_1.326923	96	142	1	17	46	0.3695652
NODE_159585_length_307_cov_1.326923	96	142	2	27	46	0.5869565
NODE_159585_length_307_cov_1.326923	96	142	4	2	46	0.0434783
NODE_159585_length_307_cov_1.326923	115	195	2	25	80	0.3125000
NODE_159585_length_307_cov_1.326923	115	195	4	36	80	0.4500000
NODE_159585_length_307_cov_1.326923	115	195	5	19	80	0.2375000
NODE_159618_length_307_cov_1.264423	13	61	0	48	48	1.0000000
NODE_159618_length_307_cov_1.264423	23	54	0	31	31	1.0000000
NODE_159696_length_307_cov_1.197115	92	121	2	29	29	1.0000000
NODE_159787_length_307_cov_1.000000	132	168	0	36	36	1.0000000
NODE_160213_length_306_cov_74.526570	68	136	3	4	68	0.0588235
NODE_160213_length_306_cov_74.526570	68	136	4	19	68	0.2794118
NODE_160213_length_306_cov_74.526570	68	136	5	45	68	0.6617647
NODE_160213_length_306_cov_74.526570	68	148	3	11	80	0.1375000
NODE_160213_length_306_cov_74.526570	68	148	4	19	80	0.2375000
NODE_160213_length_306_cov_74.526570	68	148	5	50	80	0.6250000
NODE_160213_length_306_cov_74.526570	121	201	3	11	80	0.1375000
NODE_160213_length_306_cov_74.526570	121	201	4	8	80	0.1000000
NODE_160213_length_306_cov_74.526570	121	201	5	61	80	0.7625000
NODE_160213_length_306_cov_74.526570	121	201	3	11	80	0.1375000
NODE_160213_length_306_cov_74.526570	121	201	4	8	80	0.1000000
NODE_160213_length_306_cov_74.526570	121	201	5	61	80	0.7625000
NODE_160213_length_306_cov_74.526570	197	277	2	41	80	0.5125000
NODE_160213_length_306_cov_74.526570	197	277	3	34	80	0.4250000
NODE_160213_length_306_cov_74.526570	197	277	4	5	80	0.0625000
NODE_160213_length_306_cov_74.526570	197	277	2	41	80	0.5125000
NODE_160213_length_306_cov_74.526570	197	277	3	34	80	0.4250000
NODE_160213_length_306_cov_74.526570	197	277	4	5	80	0.0625000
NODE_160213_length_306_cov_74.526570	197	277	2	41	80	0.5125000
NODE_160213_length_306_cov_74.526570	197	277	3	34	80	0.4250000
NODE_160213_length_306_cov_74.526570	197	277	4	5	80	0.0625000
NODE_160213_length_306_cov_74.526570	250	299	0	6	49	0.1224490
NODE_160213_length_306_cov_74.526570	250	299	2	43	49	0.8775510
NODE_160213_length_306_cov_74.526570	250	306	0	13	56	0.2321429
NODE_160213_length_306_cov_74.526570	250	306	2	43	56	0.7678571
NODE_160213_length_306_cov_74.526570	255	306	0	13	51	0.2549020
NODE_160213_length_306_cov_74.526570	255	306	2	38	51	0.7450981
NODE_160217_length_306_cov_7.396135	23	117	0	94	94	1.0000000
NODE_160217_length_306_cov_7.396135	90	170	0	80	80	1.0000000
NODE_160261_length_306_cov_4.275362	67	147	1	80	80	1.0000000
NODE_160275_length_306_cov_3.937198	104	176	3	72	72	1.0000000
NODE_160300_length_306_cov_3.444444	130	206	0	76	76	1.0000000
NODE_160323_length_306_cov_3.217391	198	278	0	80	80	1.0000000
NODE_160333_length_306_cov_3.043478	90	171	3	20	81	0.2469136
NODE_160333_length_306_cov_3.043478	90	171	4	18	81	0.2222222
NODE_160333_length_306_cov_3.043478	90	171	5	4	81	0.0493827
NODE_160333_length_306_cov_3.043478	90	171	6	39	81	0.4814815
NODE_160333_length_306_cov_3.043478	144	202	3	15	58	0.2586207
NODE_160333_length_306_cov_3.043478	144	202	5	20	58	0.3448276
NODE_160333_length_306_cov_3.043478	144	202	6	23	58	0.3965517
NODE_160340_length_306_cov_2.956522	242	273	2	31	31	1.0000000
NODE_160355_length_306_cov_2.884058	173	243	0	70	70	1.0000000
NODE_160403_length_306_cov_2.574879	122	203	2	81	81	1.0000000
NODE_160403_length_306_cov_2.574879	176	254	0	26	78	0.3333333
NODE_160403_length_306_cov_2.574879	176	254	2	52	78	0.6666667
NODE_160475_length_306_cov_2.265700	223	278	2	8	55	0.1454545
NODE_160475_length_306_cov_2.265700	223	278	4	47	55	0.8545455
NODE_160512_length_306_cov_2.106280	73	149	0	56	76	0.7368421
NODE_160512_length_306_cov_2.106280	73	149	1	8	76	0.1052632
NODE_160512_length_306_cov_2.106280	73	149	3	12	76	0.1578947
NODE_160512_length_306_cov_2.106280	125	205	0	4	80	0.0500000
NODE_160512_length_306_cov_2.106280	125	205	1	8	80	0.1000000
NODE_160512_length_306_cov_2.106280	125	205	3	68	80	0.8500000
NODE_160608_length_306_cov_1.879227	165	196	2	31	31	1.0000000
NODE_160752_length_306_cov_1.478261	206	237	2	31	31	1.0000000
NODE_160761_length_306_cov_1.478261	157	220	2	63	63	1.0000000
NODE_160833_length_306_cov_1.434783	40	88	0	48	48	1.0000000
NODE_160875_length_306_cov_1.357488	128	171	0	43	43	1.0000000
NODE_160992_length_306_cov_1.222222	216	252	0	36	36	1.0000000
NODE_160992_length_306_cov_1.222222	230	305	0	75	75	1.0000000
NODE_161018_length_306_cov_1.188406	79	159	1	61	80	0.7625000
NODE_161018_length_306_cov_1.188406	79	159	3	19	80	0.2375000
NODE_161042_length_306_cov_1.130435	122	202	0	80	80	1.0000000
NODE_161042_length_306_cov_1.130435	175	255	0	80	80	1.0000000
NODE_161078_length_306_cov_1.067633	156	188	0	32	32	1.0000000
NODE_161234_length_306_cov_0.975845	219	247	1	28	28	1.0000000
NODE_161246_length_306_cov_0.956522	206	284	0	78	78	1.0000000
NODE_161550_length_305_cov_5.718447	177	243	0	66	66	1.0000000
NODE_161566_length_305_cov_4.854369	55	135	2	80	80	1.0000000
NODE_161584_length_305_cov_4.266990	186	266	0	58	80	0.7250000
NODE_161584_length_305_cov_4.266990	186	266	1	22	80	0.2750000
NODE_161723_length_305_cov_2.616505	220	263	2	25	43	0.5813953
NODE_161723_length_305_cov_2.616505	220	263	4	18	43	0.4186046
NODE_161723_length_305_cov_2.616505	236	305	2	22	69	0.3188406
NODE_161723_length_305_cov_2.616505	236	305	3	15	69	0.2173913
NODE_161723_length_305_cov_2.616505	236	305	4	32	69	0.4637681
NODE_161726_length_305_cov_2.597087	171	256	24	2	85	0.0235294
NODE_161726_length_305_cov_2.597087	171	256	25	6	85	0.0705882
NODE_161726_length_305_cov_2.597087	171	256	26	2	85	0.0235294
NODE_161726_length_305_cov_2.597087	171	256	28	1	85	0.0117647
NODE_161726_length_305_cov_2.597087	171	256	29	13	85	0.1529412
NODE_161726_length_305_cov_2.597087	171	256	30	7	85	0.0823529
NODE_161726_length_305_cov_2.597087	171	256	32	3	85	0.0352941
NODE_161726_length_305_cov_2.597087	171	256	38	1	85	0.0117647
NODE_161726_length_305_cov_2.597087	171	256	39	2	85	0.0235294
NODE_161726_length_305_cov_2.597087	171	256	44	1	85	0.0117647
NODE_161726_length_305_cov_2.597087	171	256	46	1	85	0.0117647
NODE_161726_length_305_cov_2.597087	171	256	48	1	85	0.0117647
NODE_161726_length_305_cov_2.597087	171	256	50	2	85	0.0235294
NODE_161726_length_305_cov_2.597087	171	256	51	2	85	0.0235294
NODE_161726_length_305_cov_2.597087	171	256	52	7	85	0.0823529
NODE_161726_length_305_cov_2.597087	171	256	53	3	85	0.0352941
NODE_161726_length_305_cov_2.597087	171	256	54	1	85	0.0117647
NODE_161726_length_305_cov_2.597087	171	256	55	1	85	0.0117647
NODE_161726_length_305_cov_2.597087	171	256	57	2	85	0.0235294
NODE_161726_length_305_cov_2.597087	171	256	58	27	85	0.3176471
NODE_161732_length_305_cov_2.533981	3	57	0	54	54	1.0000000
NODE_161775_length_305_cov_2.339806	149	237	15	2	88	0.0227273
NODE_161775_length_305_cov_2.339806	149	237	16	7	88	0.0795455
NODE_161775_length_305_cov_2.339806	149	237	17	11	88	0.1250000
NODE_161775_length_305_cov_2.339806	149	237	19	2	88	0.0227273
NODE_161775_length_305_cov_2.339806	149	237	21	9	88	0.1022727
NODE_161775_length_305_cov_2.339806	149	237	22	33	88	0.3750000
NODE_161775_length_305_cov_2.339806	149	237	24	16	88	0.1818182
NODE_161775_length_305_cov_2.339806	149	237	25	3	88	0.0340909
NODE_161775_length_305_cov_2.339806	149	237	26	5	88	0.0568182
NODE_161795_length_305_cov_2.228155	194	274	0	80	80	1.0000000
NODE_161795_length_305_cov_2.228155	247	300	0	53	53	1.0000000
NODE_161877_length_305_cov_1.975728	44	116	0	72	72	1.0000000
NODE_161908_length_305_cov_1.883495	135	172	27	1	37	0.0270270
NODE_161908_length_305_cov_1.883495	135	172	28	1	37	0.0270270
NODE_161908_length_305_cov_1.883495	135	172	30	2	37	0.0540541
NODE_161908_length_305_cov_1.883495	135	172	31	1	37	0.0270270
NODE_161908_length_305_cov_1.883495	135	172	33	2	37	0.0540541
NODE_161908_length_305_cov_1.883495	135	172	34	1	37	0.0270270
NODE_161908_length_305_cov_1.883495	135	172	35	3	37	0.0810811
NODE_161908_length_305_cov_1.883495	135	172	37	1	37	0.0270270
NODE_161908_length_305_cov_1.883495	135	172	38	1	37	0.0270270
NODE_161908_length_305_cov_1.883495	135	172	39	8	37	0.2162162
NODE_161908_length_305_cov_1.883495	135	172	42	15	37	0.4054054
NODE_161908_length_305_cov_1.883495	135	172	44	1	37	0.0270270
NODE_161990_length_305_cov_1.674757	14	80	2	2	66	0.0303030
NODE_161990_length_305_cov_1.674757	14	80	4	54	66	0.8181818
NODE_161990_length_305_cov_1.674757	14	80	5	10	66	0.1515152
NODE_161990_length_305_cov_1.674757	53	133	2	11	80	0.1375000
NODE_161990_length_305_cov_1.674757	53	133	3	2	80	0.0250000
NODE_161990_length_305_cov_1.674757	53	133	4	42	80	0.5250000
NODE_161990_length_305_cov_1.674757	53	133	5	14	80	0.1750000
NODE_161990_length_305_cov_1.674757	53	133	6	11	80	0.1375000
NODE_161996_length_305_cov_1.655340	110	179	0	4	69	0.0579710
NODE_161996_length_305_cov_1.655340	110	179	2	65	69	0.9420290
NODE_162123_length_305_cov_1.466019	153	238	8	2	85	0.0235294
NODE_162123_length_305_cov_1.466019	153	238	10	2	85	0.0235294
NODE_162123_length_305_cov_1.466019	153	238	11	31	85	0.3647059
NODE_162123_length_305_cov_1.466019	153	238	12	36	85	0.4235294
NODE_162123_length_305_cov_1.466019	153	238	13	14	85	0.1647059
NODE_162123_length_305_cov_1.466019	222	284	9	10	62	0.1612903
NODE_162123_length_305_cov_1.466019	222	284	10	18	62	0.2903226
NODE_162123_length_305_cov_1.466019	222	284	12	34	62	0.5483871
NODE_162169_length_305_cov_1.398058	28	75	0	47	47	1.0000000
NODE_162198_length_305_cov_1.330097	212	292	4	9	80	0.1125000
NODE_162198_length_305_cov_1.330097	212	292	5	7	80	0.0875000
NODE_162198_length_305_cov_1.330097	212	292	7	11	80	0.1375000
NODE_162198_length_305_cov_1.330097	212	292	9	1	80	0.0125000
NODE_162198_length_305_cov_1.330097	212	292	11	6	80	0.0750000
NODE_162198_length_305_cov_1.330097	212	292	12	4	80	0.0500000
NODE_162198_length_305_cov_1.330097	212	292	14	4	80	0.0500000
NODE_162198_length_305_cov_1.330097	212	292	16	20	80	0.2500000
NODE_162198_length_305_cov_1.330097	212	292	18	18	80	0.2250000
NODE_162198_length_305_cov_1.330097	265	305	2	13	40	0.3250000
NODE_162198_length_305_cov_1.330097	265	305	4	9	40	0.2250000
NODE_162198_length_305_cov_1.330097	265	305	5	7	40	0.1750000
NODE_162198_length_305_cov_1.330097	265	305	7	11	40	0.2750000
NODE_162359_length_305_cov_1.111650	245	275	0	3	30	0.1000000
NODE_162359_length_305_cov_1.111650	245	275	1	18	30	0.6000000
NODE_162359_length_305_cov_1.111650	245	275	2	9	30	0.3000000
NODE_162411_length_305_cov_0.990291	46	126	0	80	80	1.0000000
NODE_162593_length_305_cov_0.873786	73	109	0	36	36	1.0000000
NODE_162782_length_305_cov_0.631068	86	166	1	5	80	0.0625000
NODE_162782_length_305_cov_0.631068	86	166	2	75	80	0.9375000
NODE_162782_length_305_cov_0.631068	139	186	2	47	47	1.0000000
NODE_162854_length_304_cov_44.482927	61	102	56	3	41	0.0731707
NODE_162854_length_304_cov_44.482927	61	102	57	4	41	0.0975610
NODE_162854_length_304_cov_44.482927	61	102	59	2	41	0.0487805
NODE_162854_length_304_cov_44.482927	61	102	60	1	41	0.0243902
NODE_162854_length_304_cov_44.482927	61	102	61	2	41	0.0487805
NODE_162854_length_304_cov_44.482927	61	102	62	1	41	0.0243902
NODE_162854_length_304_cov_44.482927	61	102	64	1	41	0.0243902
NODE_162854_length_304_cov_44.482927	61	102	65	3	41	0.0731707
NODE_162854_length_304_cov_44.482927	61	102	67	2	41	0.0487805
NODE_162854_length_304_cov_44.482927	61	102	69	1	41	0.0243902
NODE_162854_length_304_cov_44.482927	61	102	71	3	41	0.0731707
NODE_162854_length_304_cov_44.482927	61	102	72	1	41	0.0243902
NODE_162854_length_304_cov_44.482927	61	102	73	2	41	0.0487805
NODE_162854_length_304_cov_44.482927	61	102	74	1	41	0.0243902
NODE_162854_length_304_cov_44.482927	61	102	76	2	41	0.0487805
NODE_162854_length_304_cov_44.482927	61	102	79	1	41	0.0243902
NODE_162854_length_304_cov_44.482927	61	102	81	1	41	0.0243902
NODE_162854_length_304_cov_44.482927	61	102	83	1	41	0.0243902
NODE_162854_length_304_cov_44.482927	61	102	84	1	41	0.0243902
NODE_162854_length_304_cov_44.482927	61	102	86	1	41	0.0243902
NODE_162854_length_304_cov_44.482927	61	102	88	1	41	0.0243902
NODE_162854_length_304_cov_44.482927	61	102	89	5	41	0.1219512
NODE_162854_length_304_cov_44.482927	61	102	90	1	41	0.0243902
NODE_162855_length_304_cov_30.678049	205	281	2	33	76	0.4342105
NODE_162855_length_304_cov_30.678049	205	281	3	15	76	0.1973684
NODE_162855_length_304_cov_30.678049	205	281	4	28	76	0.3684210
NODE_162855_length_304_cov_30.678049	254	304	1	9	50	0.1800000
NODE_162855_length_304_cov_30.678049	254	304	2	41	50	0.8200000
NODE_162886_length_304_cov_4.956098	72	152	4	23	80	0.2875000
NODE_162886_length_304_cov_4.956098	72	152	5	45	80	0.5625000
NODE_162886_length_304_cov_4.956098	72	152	6	12	80	0.1500000
NODE_162919_length_304_cov_3.980488	46	126	0	80	80	1.0000000
NODE_162919_length_304_cov_3.980488	99	179	0	80	80	1.0000000
NODE_162932_length_304_cov_3.809756	108	156	1	48	48	1.0000000
NODE_162955_length_304_cov_3.424390	67	129	3	62	62	1.0000000
NODE_162955_length_304_cov_3.424390	120	182	1	13	62	0.2096774
NODE_162955_length_304_cov_3.424390	120	182	3	49	62	0.7903226
NODE_162997_length_304_cov_2.980488	105	126	0	21	21	1.0000000
NODE_163048_length_304_cov_2.629268	106	186	0	17	80	0.2125000
NODE_163048_length_304_cov_2.629268	106	186	1	63	80	0.7875000
NODE_163048_length_304_cov_2.629268	159	209	1	50	50	1.0000000
NODE_163116_length_304_cov_2.239024	57	137	0	80	80	1.0000000
NODE_163116_length_304_cov_2.239024	110	152	0	42	42	1.0000000
NODE_163148_length_304_cov_2.170732	112	145	0	17	33	0.5151515
NODE_163148_length_304_cov_2.170732	112	145	2	16	33	0.4848485
NODE_163148_length_304_cov_2.170732	146	198	4	52	52	1.0000000
NODE_163333_length_304_cov_1.687805	219	288	0	69	69	1.0000000
NODE_163432_length_304_cov_1.492683	190	238	0	48	48	1.0000000
NODE_163559_length_304_cov_1.287805	99	165	0	19	66	0.2878788
NODE_163559_length_304_cov_1.287805	99	165	1	28	66	0.4242424
NODE_163559_length_304_cov_1.287805	99	165	3	19	66	0.2878788
NODE_163670_length_304_cov_1.175610	0	30	1	30	30	1.0000000
NODE_163895_length_304_cov_0.951220	70	150	6	19	80	0.2375000
NODE_163895_length_304_cov_0.951220	70	150	8	61	80	0.7625000
NODE_164171_length_303_cov_30.843137	46	97	1	51	51	1.0000000
NODE_164194_length_303_cov_5.401961	33	79	0	46	46	1.0000000
NODE_164224_length_303_cov_4.210784	136	205	3	5	69	0.0724638
NODE_164224_length_303_cov_4.210784	136	205	5	1	69	0.0144928
NODE_164224_length_303_cov_4.210784	136	205	6	1	69	0.0144928
NODE_164224_length_303_cov_4.210784	136	205	8	2	69	0.0289855
NODE_164224_length_303_cov_4.210784	136	205	9	1	69	0.0144928
NODE_164224_length_303_cov_4.210784	136	205	10	22	69	0.3188406
NODE_164224_length_303_cov_4.210784	136	205	11	12	69	0.1739130
NODE_164224_length_303_cov_4.210784	136	205	12	8	69	0.1159420
NODE_164224_length_303_cov_4.210784	136	205	14	17	69	0.2463768
NODE_164224_length_303_cov_4.210784	178	259	2	50	81	0.6172839
NODE_164224_length_303_cov_4.210784	178	259	3	9	81	0.1111111
NODE_164224_length_303_cov_4.210784	178	259	5	1	81	0.0123457
NODE_164224_length_303_cov_4.210784	178	259	6	1	81	0.0123457
NODE_164224_length_303_cov_4.210784	178	259	8	2	81	0.0246914
NODE_164224_length_303_cov_4.210784	178	259	9	1	81	0.0123457
NODE_164224_length_303_cov_4.210784	178	259	10	17	81	0.2098765
NODE_164251_length_303_cov_3.671569	9	75	2	2	66	0.0303030
NODE_164251_length_303_cov_3.671569	9	75	4	19	66	0.2878788
NODE_164251_length_303_cov_3.671569	9	75	5	6	66	0.0909091
NODE_164251_length_303_cov_3.671569	9	75	7	5	66	0.0757576
NODE_164251_length_303_cov_3.671569	9	75	8	4	66	0.0606061
NODE_164251_length_303_cov_3.671569	9	75	9	4	66	0.0606061
NODE_164251_length_303_cov_3.671569	9	75	10	14	66	0.2121212
NODE_164251_length_303_cov_3.671569	9	75	11	5	66	0.0757576
NODE_164251_length_303_cov_3.671569	9	75	12	7	66	0.1060606
NODE_164251_length_303_cov_3.671569	48	128	9	1	80	0.0125000
NODE_164251_length_303_cov_3.671569	48	128	10	14	80	0.1750000
NODE_164251_length_303_cov_3.671569	48	128	11	5	80	0.0625000
NODE_164251_length_303_cov_3.671569	48	128	12	12	80	0.1500000
NODE_164251_length_303_cov_3.671569	48	128	14	28	80	0.3500000
NODE_164251_length_303_cov_3.671569	48	128	15	14	80	0.1750000
NODE_164251_length_303_cov_3.671569	48	128	16	6	80	0.0750000
NODE_164251_length_303_cov_3.671569	48	128	9	1	80	0.0125000
NODE_164251_length_303_cov_3.671569	48	128	10	14	80	0.1750000
NODE_164251_length_303_cov_3.671569	48	128	11	5	80	0.0625000
NODE_164251_length_303_cov_3.671569	48	128	12	12	80	0.1500000
NODE_164251_length_303_cov_3.671569	48	128	14	28	80	0.3500000
NODE_164251_length_303_cov_3.671569	48	128	15	14	80	0.1750000
NODE_164251_length_303_cov_3.671569	48	128	16	6	80	0.0750000
NODE_164251_length_303_cov_3.671569	220	300	1	20	80	0.2500000
NODE_164251_length_303_cov_3.671569	220	300	2	9	80	0.1125000
NODE_164251_length_303_cov_3.671569	220	300	3	14	80	0.1750000
NODE_164251_length_303_cov_3.671569	220	300	4	37	80	0.4625000
NODE_164267_length_303_cov_3.500000	55	123	1	68	68	1.0000000
NODE_164272_length_303_cov_3.460784	0	67	0	11	67	0.1641791
NODE_164272_length_303_cov_3.460784	0	67	1	10	67	0.1492537
NODE_164272_length_303_cov_3.460784	0	67	5	3	67	0.0447761
NODE_164272_length_303_cov_3.460784	0	67	6	3	67	0.0447761
NODE_164272_length_303_cov_3.460784	0	67	7	6	67	0.0895522
NODE_164272_length_303_cov_3.460784	0	67	10	5	67	0.0746269
NODE_164272_length_303_cov_3.460784	0	67	11	1	67	0.0149254
NODE_164272_length_303_cov_3.460784	0	67	13	3	67	0.0447761
NODE_164272_length_303_cov_3.460784	0	67	15	1	67	0.0149254
NODE_164272_length_303_cov_3.460784	0	67	17	2	67	0.0298507
NODE_164272_length_303_cov_3.460784	0	67	19	7	67	0.1044776
NODE_164272_length_303_cov_3.460784	0	67	24	2	67	0.0298507
NODE_164272_length_303_cov_3.460784	0	67	25	1	67	0.0149254
NODE_164272_length_303_cov_3.460784	0	67	30	1	67	0.0149254
NODE_164272_length_303_cov_3.460784	0	67	32	1	67	0.0149254
NODE_164272_length_303_cov_3.460784	0	67	33	1	67	0.0149254
NODE_164272_length_303_cov_3.460784	0	67	34	2	67	0.0298507
NODE_164272_length_303_cov_3.460784	0	67	37	2	67	0.0298507
NODE_164272_length_303_cov_3.460784	0	67	39	1	67	0.0149254
NODE_164272_length_303_cov_3.460784	0	67	40	1	67	0.0149254
NODE_164272_length_303_cov_3.460784	0	67	41	2	67	0.0298507
NODE_164272_length_303_cov_3.460784	0	67	48	1	67	0.0149254
NODE_164272_length_303_cov_3.460784	98	178	119	1	80	0.0125000
NODE_164272_length_303_cov_3.460784	98	178	125	1	80	0.0125000
NODE_164272_length_303_cov_3.460784	98	178	129	1	80	0.0125000
NODE_164272_length_303_cov_3.460784	98	178	134	1	80	0.0125000
NODE_164272_length_303_cov_3.460784	98	178	136	1	80	0.0125000
NODE_164272_length_303_cov_3.460784	98	178	141	2	80	0.0250000
NODE_164272_length_303_cov_3.460784	98	178	147	2	80	0.0250000
NODE_164272_length_303_cov_3.460784	98	178	151	1	80	0.0125000
NODE_164272_length_303_cov_3.460784	98	178	153	2	80	0.0250000
NODE_164272_length_303_cov_3.460784	98	178	154	1	80	0.0125000
NODE_164272_length_303_cov_3.460784	98	178	156	1	80	0.0125000
NODE_164272_length_303_cov_3.460784	98	178	157	1	80	0.0125000
NODE_164272_length_303_cov_3.460784	98	178	160	1	80	0.0125000
NODE_164272_length_303_cov_3.460784	98	178	161	1	80	0.0125000
NODE_164272_length_303_cov_3.460784	98	178	163	4	80	0.0500000
NODE_164272_length_303_cov_3.460784	98	178	165	2	80	0.0250000
NODE_164272_length_303_cov_3.460784	98	178	166	1	80	0.0125000
NODE_164272_length_303_cov_3.460784	98	178	167	2	80	0.0250000
NODE_164272_length_303_cov_3.460784	98	178	168	1	80	0.0125000
NODE_164272_length_303_cov_3.460784	98	178	169	3	80	0.0375000
NODE_164272_length_303_cov_3.460784	98	178	171	2	80	0.0250000
NODE_164272_length_303_cov_3.460784	98	178	174	1	80	0.0125000
NODE_164272_length_303_cov_3.460784	98	178	175	4	80	0.0500000
NODE_164272_length_303_cov_3.460784	98	178	178	1	80	0.0125000
NODE_164272_length_303_cov_3.460784	98	178	181	1	80	0.0125000
NODE_164272_length_303_cov_3.460784	98	178	186	2	80	0.0250000
NODE_164272_length_303_cov_3.460784	98	178	189	2	80	0.0250000
NODE_164272_length_303_cov_3.460784	98	178	190	1	80	0.0125000
NODE_164272_length_303_cov_3.460784	98	178	192	2	80	0.0250000
NODE_164272_length_303_cov_3.460784	98	178	193	1	80	0.0125000
NODE_164272_length_303_cov_3.460784	98	178	195	3	80	0.0375000
NODE_164272_length_303_cov_3.460784	98	178	196	1	80	0.0125000
NODE_164272_length_303_cov_3.460784	98	178	201	2	80	0.0250000
NODE_164272_length_303_cov_3.460784	98	178	202	1	80	0.0125000
NODE_164272_length_303_cov_3.460784	98	178	203	2	80	0.0250000
NODE_164272_length_303_cov_3.460784	98	178	206	12	80	0.1500000
NODE_164272_length_303_cov_3.460784	98	178	207	7	80	0.0875000
NODE_164272_length_303_cov_3.460784	98	178	208	1	80	0.0125000
NODE_164272_length_303_cov_3.460784	98	178	209	4	80	0.0500000
NODE_164272_length_303_cov_3.460784	151	191	202	1	40	0.0250000
NODE_164272_length_303_cov_3.460784	151	191	203	2	40	0.0500000
NODE_164272_length_303_cov_3.460784	151	191	205	3	40	0.0750000
NODE_164272_length_303_cov_3.460784	151	191	206	13	40	0.3250000
NODE_164272_length_303_cov_3.460784	151	191	207	9	40	0.2250000
NODE_164272_length_303_cov_3.460784	151	191	208	2	40	0.0500000
NODE_164272_length_303_cov_3.460784	151	191	209	6	40	0.1500000
NODE_164272_length_303_cov_3.460784	151	191	210	1	40	0.0250000
NODE_164272_length_303_cov_3.460784	151	191	211	3	40	0.0750000
NODE_164283_length_303_cov_3.352941	77	146	1	69	69	1.0000000
NODE_164433_length_303_cov_2.284314	78	158	2	80	80	1.0000000
NODE_164433_length_303_cov_2.284314	215	295	0	80	80	1.0000000
NODE_164581_length_303_cov_1.848039	90	170	0	10	80	0.1250000
NODE_164581_length_303_cov_1.848039	90	170	1	25	80	0.3125000
NODE_164581_length_303_cov_1.848039	90	170	2	45	80	0.5625000
NODE_164581_length_303_cov_1.848039	143	223	0	63	80	0.7875000
NODE_164581_length_303_cov_1.848039	143	223	1	17	80	0.2125000
NODE_164581_length_303_cov_1.848039	212	235	0	23	23	1.0000000
NODE_164668_length_303_cov_1.686275	62	88	0	26	26	1.0000000
NODE_164695_length_303_cov_1.583333	206	270	1	64	64	1.0000000
NODE_164800_length_303_cov_1.475490	155	221	0	66	66	1.0000000
NODE_164846_length_303_cov_1.392157	135	213	5	78	78	1.0000000
NODE_164878_length_303_cov_1.318627	0	75	0	75	75	1.0000000
NODE_164974_length_303_cov_1.215686	278	297	0	19	19	1.0000000
NODE_165498_length_302_cov_10.852217	266	300	0	34	34	1.0000000
NODE_165502_length_302_cov_7.896552	46	131	0	85	85	1.0000000
NODE_165502_length_302_cov_7.896552	104	160	0	56	56	1.0000000
NODE_165505_length_302_cov_7.266010	135	191	0	56	56	1.0000000
NODE_165507_length_302_cov_7.216749	93	149	2	38	56	0.6785714
NODE_165507_length_302_cov_7.216749	93	149	3	18	56	0.3214286
NODE_165507_length_302_cov_7.216749	155	226	2	71	71	1.0000000
NODE_165517_length_302_cov_6.172414	179	243	0	64	64	1.0000000
NODE_165517_length_302_cov_6.172414	232	287	0	55	55	1.0000000
NODE_165528_length_302_cov_5.586207	221	293	0	21	72	0.2916667
NODE_165528_length_302_cov_5.586207	221	293	1	13	72	0.1805556
NODE_165528_length_302_cov_5.586207	221	293	3	6	72	0.0833333
NODE_165528_length_302_cov_5.586207	221	293	4	16	72	0.2222222
NODE_165528_length_302_cov_5.586207	221	293	6	16	72	0.2222222
NODE_165641_length_302_cov_2.985222	104	186	2	12	82	0.1463415
NODE_165641_length_302_cov_2.985222	104	186	4	6	82	0.0731707
NODE_165641_length_302_cov_2.985222	104	186	6	17	82	0.2073171
NODE_165641_length_302_cov_2.985222	104	186	8	47	82	0.5731707
NODE_165848_length_302_cov_2.009852	12	34	2	22	22	1.0000000
NODE_165934_length_302_cov_1.758621	98	152	0	47	54	0.8703704
NODE_165934_length_302_cov_1.758621	98	152	1	7	54	0.1296296
NODE_165945_length_302_cov_1.758621	230	294	0	64	64	1.0000000
NODE_166007_length_302_cov_1.620690	172	232	10	55	60	0.9166667
NODE_166007_length_302_cov_1.620690	172	232	12	5	60	0.0833333
NODE_166007_length_302_cov_1.620690	225	277	2	11	52	0.2115385
NODE_166007_length_302_cov_1.620690	225	277	4	8	52	0.1538462
NODE_166007_length_302_cov_1.620690	225	277	6	21	52	0.4038461
NODE_166007_length_302_cov_1.620690	225	277	9	1	52	0.0192308
NODE_166007_length_302_cov_1.620690	225	277	10	11	52	0.2115385
NODE_166320_length_302_cov_1.172414	34	103	0	35	69	0.5072464
NODE_166320_length_302_cov_1.172414	34	103	2	34	69	0.4927536
NODE_166381_length_302_cov_1.044335	54	130	0	76	76	1.0000000
NODE_166617_length_302_cov_0.847291	94	172	0	46	78	0.5897436
NODE_166617_length_302_cov_0.847291	94	172	1	11	78	0.1410256
NODE_166617_length_302_cov_0.847291	94	172	3	4	78	0.0512821
NODE_166617_length_302_cov_0.847291	94	172	5	17	78	0.2179487
NODE_166617_length_302_cov_0.847291	94	172	0	46	78	0.5897436
NODE_166617_length_302_cov_0.847291	94	172	1	11	78	0.1410256
NODE_166617_length_302_cov_0.847291	94	172	3	4	78	0.0512821
NODE_166617_length_302_cov_0.847291	94	172	5	17	78	0.2179487
NODE_166617_length_302_cov_0.847291	103	172	0	37	69	0.5362319
NODE_166617_length_302_cov_0.847291	103	172	1	11	69	0.1594203
NODE_166617_length_302_cov_0.847291	103	172	3	4	69	0.0579710
NODE_166617_length_302_cov_0.847291	103	172	5	17	69	0.2463768
NODE_166638_length_302_cov_0.807882	97	177	0	80	80	1.0000000
NODE_166819_length_301_cov_6.960396	268	299	0	31	31	1.0000000
NODE_166827_length_301_cov_6.148515	214	283	0	69	69	1.0000000
NODE_166889_length_301_cov_3.747525	116	196	4	29	80	0.3625000
NODE_166889_length_301_cov_3.747525	116	196	5	9	80	0.1125000
NODE_166889_length_301_cov_3.747525	116	196	6	42	80	0.5250000
NODE_166904_length_301_cov_3.509901	217	277	10	6	60	0.1000000
NODE_166904_length_301_cov_3.509901	217	277	12	1	60	0.0166667
NODE_166904_length_301_cov_3.509901	217	277	14	2	60	0.0333333
NODE_166904_length_301_cov_3.509901	217	277	15	1	60	0.0166667
NODE_166904_length_301_cov_3.509901	217	277	17	2	60	0.0333333
NODE_166904_length_301_cov_3.509901	217	277	19	1	60	0.0166667
NODE_166904_length_301_cov_3.509901	217	277	21	1	60	0.0166667
NODE_166904_length_301_cov_3.509901	217	277	22	2	60	0.0333333
NODE_166904_length_301_cov_3.509901	217	277	24	4	60	0.0666667
NODE_166904_length_301_cov_3.509901	217	277	25	2	60	0.0333333
NODE_166904_length_301_cov_3.509901	217	277	26	5	60	0.0833333
NODE_166904_length_301_cov_3.509901	217	277	28	2	60	0.0333333
NODE_166904_length_301_cov_3.509901	217	277	30	1	60	0.0166667
NODE_166904_length_301_cov_3.509901	217	277	31	1	60	0.0166667
NODE_166904_length_301_cov_3.509901	217	277	33	1	60	0.0166667
NODE_166904_length_301_cov_3.509901	217	277	34	3	60	0.0500000
NODE_166904_length_301_cov_3.509901	217	277	35	3	60	0.0500000
NODE_166904_length_301_cov_3.509901	217	277	37	3	60	0.0500000
NODE_166904_length_301_cov_3.509901	217	277	39	4	60	0.0666667
NODE_166904_length_301_cov_3.509901	217	277	41	1	60	0.0166667
NODE_166904_length_301_cov_3.509901	217	277	42	3	60	0.0500000
NODE_166904_length_301_cov_3.509901	217	277	46	1	60	0.0166667
NODE_166904_length_301_cov_3.509901	217	277	47	3	60	0.0500000
NODE_166904_length_301_cov_3.509901	217	277	49	3	60	0.0500000
NODE_166904_length_301_cov_3.509901	217	277	50	1	60	0.0166667
NODE_166904_length_301_cov_3.509901	217	277	52	1	60	0.0166667
NODE_166904_length_301_cov_3.509901	217	277	59	1	60	0.0166667
NODE_166904_length_301_cov_3.509901	217	277	61	1	60	0.0166667
NODE_166993_length_301_cov_2.653465	133	213	2	36	80	0.4500000
NODE_166993_length_301_cov_2.653465	133	213	3	12	80	0.1500000
NODE_166993_length_301_cov_2.653465	133	213	4	32	80	0.4000000
NODE_167126_length_301_cov_2.084158	178	258	6	3	80	0.0375000
NODE_167126_length_301_cov_2.084158	178	258	8	14	80	0.1750000
NODE_167126_length_301_cov_2.084158	178	258	10	1	80	0.0125000
NODE_167126_length_301_cov_2.084158	178	258	12	62	80	0.7750000
NODE_167215_length_301_cov_1.831683	111	175	1	64	64	1.0000000
NODE_167215_length_301_cov_1.831683	164	228	0	22	64	0.3437500
NODE_167215_length_301_cov_1.831683	164	228	1	42	64	0.6562500
NODE_167308_length_301_cov_1.603960	173	233	4	1	60	0.0166667
NODE_167308_length_301_cov_1.603960	173	233	6	59	60	0.9833333
NODE_167313_length_301_cov_1.584158	30	108	1	78	78	1.0000000
NODE_167434_length_301_cov_1.470297	90	165	0	75	75	1.0000000
NODE_167508_length_301_cov_1.326733	175	247	0	72	72	1.0000000
NODE_167612_length_301_cov_1.247525	29	73	0	44	44	1.0000000
NODE_167642_length_301_cov_1.183168	123	203	0	32	80	0.4000000
NODE_167642_length_301_cov_1.183168	123	203	2	48	80	0.6000000
NODE_167659_length_301_cov_1.163366	10	83	0	73	73	1.0000000
NODE_167659_length_301_cov_1.163366	91	121	0	27	30	0.9000000
NODE_167659_length_301_cov_1.163366	91	121	2	3	30	0.1000000
NODE_167668_length_301_cov_1.148515	161	209	0	48	48	1.0000000
NODE_167880_length_301_cov_0.980198	242	297	0	55	55	1.0000000
NODE_167891_length_301_cov_0.960396	22	63	0	41	41	1.0000000
NODE_168253_length_300_cov_3.402985	44	124	3	5	80	0.0625000
NODE_168253_length_300_cov_3.402985	44	124	4	9	80	0.1125000
NODE_168253_length_300_cov_3.402985	44	124	5	6	80	0.0750000
NODE_168253_length_300_cov_3.402985	44	124	6	17	80	0.2125000
NODE_168253_length_300_cov_3.402985	44	124	7	42	80	0.5250000
NODE_168253_length_300_cov_3.402985	44	124	8	1	80	0.0125000
NODE_168253_length_300_cov_3.402985	97	177	7	26	80	0.3250000
NODE_168253_length_300_cov_3.402985	97	177	8	17	80	0.2125000
NODE_168253_length_300_cov_3.402985	97	177	9	6	80	0.0750000
NODE_168253_length_300_cov_3.402985	97	177	10	6	80	0.0750000
NODE_168253_length_300_cov_3.402985	97	177	11	8	80	0.1000000
NODE_168253_length_300_cov_3.402985	97	177	12	17	80	0.2125000
NODE_168253_length_300_cov_3.402985	173	254	9	31	81	0.3827161
NODE_168253_length_300_cov_3.402985	173	254	10	24	81	0.2962963
NODE_168253_length_300_cov_3.402985	173	254	11	5	81	0.0617284
NODE_168253_length_300_cov_3.402985	173	254	12	21	81	0.2592593
NODE_168253_length_300_cov_3.402985	233	300	3	4	67	0.0597015
NODE_168253_length_300_cov_3.402985	233	300	4	1	67	0.0149254
NODE_168253_length_300_cov_3.402985	233	300	5	4	67	0.0597015
NODE_168253_length_300_cov_3.402985	233	300	7	1	67	0.0149254
NODE_168253_length_300_cov_3.402985	233	300	8	17	67	0.2537313
NODE_168253_length_300_cov_3.402985	233	300	9	40	67	0.5970149
NODE_168265_length_300_cov_3.298507	18	98	0	80	80	1.0000000
NODE_168360_length_300_cov_2.597015	110	182	4	72	72	1.0000000
NODE_168363_length_300_cov_2.572139	28	102	1	7	74	0.0945946
NODE_168363_length_300_cov_2.572139	28	102	3	4	74	0.0540541
NODE_168363_length_300_cov_2.572139	28	102	4	4	74	0.0540541
NODE_168363_length_300_cov_2.572139	28	102	6	2	74	0.0270270
NODE_168363_length_300_cov_2.572139	28	102	8	1	74	0.0135135
NODE_168363_length_300_cov_2.572139	28	102	10	1	74	0.0135135
NODE_168363_length_300_cov_2.572139	28	102	11	2	74	0.0270270
NODE_168363_length_300_cov_2.572139	28	102	12	7	74	0.0945946
NODE_168363_length_300_cov_2.572139	28	102	14	5	74	0.0675676
NODE_168363_length_300_cov_2.572139	28	102	15	4	74	0.0540541
NODE_168363_length_300_cov_2.572139	28	102	16	31	74	0.4189189
NODE_168363_length_300_cov_2.572139	28	102	18	6	74	0.0810811
NODE_168363_length_300_cov_2.572139	75	141	16	21	66	0.3181818
NODE_168363_length_300_cov_2.572139	75	141	18	15	66	0.2272727
NODE_168363_length_300_cov_2.572139	75	141	19	30	66	0.4545455
NODE_168402_length_300_cov_2.417910	0	44	0	44	44	1.0000000
NODE_168459_length_300_cov_2.174129	117	197	4	4	80	0.0500000
NODE_168459_length_300_cov_2.174129	117	197	5	5	80	0.0625000
NODE_168459_length_300_cov_2.174129	117	197	6	5	80	0.0625000
NODE_168459_length_300_cov_2.174129	117	197	8	2	80	0.0250000
NODE_168459_length_300_cov_2.174129	117	197	9	5	80	0.0625000
NODE_168459_length_300_cov_2.174129	117	197	10	18	80	0.2250000
NODE_168459_length_300_cov_2.174129	117	197	11	28	80	0.3500000
NODE_168459_length_300_cov_2.174129	117	197	12	2	80	0.0250000
NODE_168459_length_300_cov_2.174129	117	197	13	10	80	0.1250000
NODE_168459_length_300_cov_2.174129	117	197	15	1	80	0.0125000
NODE_168459_length_300_cov_2.174129	170	250	9	5	80	0.0625000
NODE_168459_length_300_cov_2.174129	170	250	10	16	80	0.2000000
NODE_168459_length_300_cov_2.174129	170	250	11	24	80	0.3000000
NODE_168459_length_300_cov_2.174129	170	250	12	3	80	0.0375000
NODE_168459_length_300_cov_2.174129	170	250	14	1	80	0.0125000
NODE_168459_length_300_cov_2.174129	170	250	18	31	80	0.3875000
NODE_168459_length_300_cov_2.174129	216	296	7	1	80	0.0125000
NODE_168459_length_300_cov_2.174129	216	296	8	2	80	0.0250000
NODE_168459_length_300_cov_2.174129	216	296	10	3	80	0.0375000
NODE_168459_length_300_cov_2.174129	216	296	12	18	80	0.2250000
NODE_168459_length_300_cov_2.174129	216	296	14	21	80	0.2625000
NODE_168459_length_300_cov_2.174129	216	296	16	3	80	0.0375000
NODE_168459_length_300_cov_2.174129	216	296	18	32	80	0.4000000
NODE_168462_length_300_cov_2.164179	122	141	0	19	19	1.0000000
NODE_168479_length_300_cov_2.079602	127	207	0	80	80	1.0000000
NODE_168479_length_300_cov_2.079602	203	273	0	70	70	1.0000000
NODE_168541_length_300_cov_1.965174	15	86	0	71	71	1.0000000
NODE_168656_length_300_cov_1.731343	31	88	2	57	57	1.0000000
NODE_168906_length_300_cov_1.268657	62	98	0	36	36	1.0000000
NODE_168906_length_300_cov_1.268657	151	186	0	35	35	1.0000000
NODE_169014_length_300_cov_1.104478	86	165	2	22	79	0.2784810
NODE_169014_length_300_cov_1.104478	86	165	4	57	79	0.7215190
NODE_169053_length_300_cov_1.029851	110	177	2	24	67	0.3582090
NODE_169053_length_300_cov_1.029851	110	177	3	43	67	0.6417910
NODE_169053_length_300_cov_1.029851	120	177	2	14	57	0.2456140
NODE_169053_length_300_cov_1.029851	120	177	3	43	57	0.7543859
NODE_169378_length_300_cov_0.716418	191	210	1	19	19	1.0000000
NODE_169528_length_299_cov_4.435000	48	128	1	15	80	0.1875000
NODE_169528_length_299_cov_4.435000	48	128	3	65	80	0.8125000
NODE_169528_length_299_cov_4.435000	101	167	1	34	66	0.5151515
NODE_169528_length_299_cov_4.435000	101	167	3	32	66	0.4848485
NODE_169567_length_299_cov_3.780000	114	181	0	67	67	1.0000000
NODE_169631_length_299_cov_3.095000	0	73	0	4	73	0.0547945
NODE_169631_length_299_cov_3.095000	0	73	1	1	73	0.0136986
NODE_169631_length_299_cov_3.095000	0	73	2	10	73	0.1369863
NODE_169631_length_299_cov_3.095000	0	73	3	23	73	0.3150685
NODE_169631_length_299_cov_3.095000	0	73	4	24	73	0.3287671
NODE_169631_length_299_cov_3.095000	0	73	5	11	73	0.1506849
NODE_169631_length_299_cov_3.095000	0	20	0	4	20	0.2000000
NODE_169631_length_299_cov_3.095000	0	20	1	1	20	0.0500000
NODE_169631_length_299_cov_3.095000	0	20	2	10	20	0.5000000
NODE_169631_length_299_cov_3.095000	0	20	3	5	20	0.2500000
NODE_169725_length_299_cov_2.495000	46	126	0	80	80	1.0000000
NODE_169725_length_299_cov_2.495000	99	179	0	80	80	1.0000000
NODE_169769_length_299_cov_2.275000	127	192	2	51	65	0.7846154
NODE_169769_length_299_cov_2.275000	127	192	4	14	65	0.2153846
NODE_169781_length_299_cov_2.250000	72	135	2	63	63	1.0000000
NODE_169781_length_299_cov_2.250000	108	188	1	14	80	0.1750000
NODE_169781_length_299_cov_2.250000	108	188	2	66	80	0.8250000
NODE_169811_length_299_cov_2.090000	25	105	2	80	80	1.0000000
NODE_169888_length_299_cov_1.955000	173	214	0	36	41	0.8780488
NODE_169888_length_299_cov_1.955000	173	214	2	1	41	0.0243902
NODE_169888_length_299_cov_1.955000	173	214	4	4	41	0.0975610
NODE_169888_length_299_cov_1.955000	187	227	0	40	40	1.0000000
NODE_169916_length_299_cov_1.885000	29	109	0	80	80	1.0000000
NODE_169920_length_299_cov_1.880000	204	236	0	32	32	1.0000000
NODE_169938_length_299_cov_1.840000	154	190	1	36	36	1.0000000
NODE_169995_length_299_cov_1.710000	211	291	0	80	80	1.0000000
NODE_170048_length_299_cov_1.550000	174	205	2	22	31	0.7096774
NODE_170048_length_299_cov_1.550000	174	205	4	9	31	0.2903226
NODE_170501_length_299_cov_1.020000	42	115	0	73	73	1.0000000
NODE_170546_length_299_cov_1.020000	132	175	2	43	43	1.0000000
NODE_170620_length_299_cov_0.935000	173	216	2	13	43	0.3023256
NODE_170620_length_299_cov_0.935000	173	216	4	30	43	0.6976744
NODE_170691_length_299_cov_0.765000	86	128	0	42	42	1.0000000
NODE_170887_length_298_cov_20.894472	70	150	3	32	80	0.4000000
NODE_170887_length_298_cov_20.894472	70	150	4	48	80	0.6000000
NODE_170887_length_298_cov_20.894472	123	203	1	31	80	0.3875000
NODE_170887_length_298_cov_20.894472	123	203	3	4	80	0.0500000
NODE_170887_length_298_cov_20.894472	123	203	4	45	80	0.5625000
NODE_170888_length_298_cov_13.859296	228	298	4	4	70	0.0571429
NODE_170888_length_298_cov_13.859296	228	298	5	7	70	0.1000000
NODE_170888_length_298_cov_13.859296	228	298	9	4	70	0.0571429
NODE_170888_length_298_cov_13.859296	228	298	10	2	70	0.0285714
NODE_170888_length_298_cov_13.859296	228	298	11	1	70	0.0142857
NODE_170888_length_298_cov_13.859296	228	298	12	1	70	0.0142857
NODE_170888_length_298_cov_13.859296	228	298	16	2	70	0.0285714
NODE_170888_length_298_cov_13.859296	228	298	17	3	70	0.0428571
NODE_170888_length_298_cov_13.859296	228	298	18	3	70	0.0428571
NODE_170888_length_298_cov_13.859296	228	298	20	4	70	0.0571429
NODE_170888_length_298_cov_13.859296	228	298	21	1	70	0.0142857
NODE_170888_length_298_cov_13.859296	228	298	25	4	70	0.0571429
NODE_170888_length_298_cov_13.859296	228	298	26	11	70	0.1571429
NODE_170888_length_298_cov_13.859296	228	298	27	2	70	0.0285714
NODE_170888_length_298_cov_13.859296	228	298	29	2	70	0.0285714
NODE_170888_length_298_cov_13.859296	228	298	31	8	70	0.1142857
NODE_170888_length_298_cov_13.859296	228	298	32	2	70	0.0285714
NODE_170888_length_298_cov_13.859296	228	298	35	1	70	0.0142857
NODE_170888_length_298_cov_13.859296	228	298	36	8	70	0.1142857
NODE_170909_length_298_cov_5.859296	1	65	0	1	64	0.0156250
NODE_170909_length_298_cov_5.859296	1	65	2	1	64	0.0156250
NODE_170909_length_298_cov_5.859296	1	65	4	9	64	0.1406250
NODE_170909_length_298_cov_5.859296	1	65	5	14	64	0.2187500
NODE_170909_length_298_cov_5.859296	1	65	7	39	64	0.6093750
NODE_170909_length_298_cov_5.859296	38	118	7	34	80	0.4250000
NODE_170909_length_298_cov_5.859296	38	118	8	9	80	0.1125000
NODE_170909_length_298_cov_5.859296	38	118	9	13	80	0.1625000
NODE_170909_length_298_cov_5.859296	38	118	10	17	80	0.2125000
NODE_170909_length_298_cov_5.859296	38	118	11	7	80	0.0875000
NODE_170909_length_298_cov_5.859296	114	194	4	32	80	0.4000000
NODE_170909_length_298_cov_5.859296	114	194	5	9	80	0.1125000
NODE_170909_length_298_cov_5.859296	114	194	6	1	80	0.0125000
NODE_170909_length_298_cov_5.859296	114	194	7	7	80	0.0875000
NODE_170909_length_298_cov_5.859296	114	194	9	6	80	0.0750000
NODE_170909_length_298_cov_5.859296	114	194	11	25	80	0.3125000
NODE_170909_length_298_cov_5.859296	167	238	2	7	71	0.0985916
NODE_170909_length_298_cov_5.859296	167	238	3	9	71	0.1267606
NODE_170909_length_298_cov_5.859296	167	238	4	55	71	0.7746479
NODE_170964_length_298_cov_3.829146	80	160	18	17	80	0.2125000
NODE_170964_length_298_cov_3.829146	80	160	19	57	80	0.7125000
NODE_170964_length_298_cov_3.829146	80	160	20	6	80	0.0750000
NODE_170964_length_298_cov_3.829146	133	213	15	6	80	0.0750000
NODE_170964_length_298_cov_3.829146	133	213	16	1	80	0.0125000
NODE_170964_length_298_cov_3.829146	133	213	17	1	80	0.0125000
NODE_170964_length_298_cov_3.829146	133	213	18	21	80	0.2625000
NODE_170964_length_298_cov_3.829146	133	213	19	20	80	0.2500000
NODE_170964_length_298_cov_3.829146	133	213	20	7	80	0.0875000
NODE_170964_length_298_cov_3.829146	133	213	21	6	80	0.0750000
NODE_170964_length_298_cov_3.829146	133	213	22	15	80	0.1875000
NODE_170964_length_298_cov_3.829146	133	213	23	2	80	0.0250000
NODE_170964_length_298_cov_3.829146	133	213	24	1	80	0.0125000
NODE_170968_length_298_cov_3.733668	203	283	0	80	80	1.0000000
NODE_170972_length_298_cov_3.673367	117	175	6	58	58	1.0000000
NODE_171043_length_298_cov_2.924623	159	239	1	3	80	0.0375000
NODE_171043_length_298_cov_2.924623	159	239	2	32	80	0.4000000
NODE_171043_length_298_cov_2.924623	159	239	3	12	80	0.1500000
NODE_171043_length_298_cov_2.924623	159	239	4	13	80	0.1625000
NODE_171043_length_298_cov_2.924623	159	239	5	5	80	0.0625000
NODE_171043_length_298_cov_2.924623	159	239	6	1	80	0.0125000
NODE_171043_length_298_cov_2.924623	159	239	7	6	80	0.0750000
NODE_171043_length_298_cov_2.924623	159	239	9	5	80	0.0625000
NODE_171043_length_298_cov_2.924623	159	239	10	3	80	0.0375000
NODE_171043_length_298_cov_2.924623	212	265	1	29	53	0.5471698
NODE_171043_length_298_cov_2.924623	212	265	2	24	53	0.4528302
NODE_171047_length_298_cov_2.854271	50	120	0	70	70	1.0000000
NODE_171082_length_298_cov_2.663317	87	167	0	76	80	0.9500000
NODE_171082_length_298_cov_2.663317	87	167	2	4	80	0.0500000
NODE_171082_length_298_cov_2.663317	140	192	0	52	52	1.0000000
NODE_171191_length_298_cov_2.201005	112	166	0	54	54	1.0000000
NODE_171210_length_298_cov_2.120603	135	166	0	31	31	1.0000000
NODE_171226_length_298_cov_2.055276	69	132	0	4	63	0.0634921
NODE_171226_length_298_cov_2.055276	69	132	1	22	63	0.3492064
NODE_171226_length_298_cov_2.055276	69	132	3	36	63	0.5714286
NODE_171226_length_298_cov_2.055276	69	132	4	1	63	0.0158730
NODE_171286_length_298_cov_2.025126	21	92	0	71	71	1.0000000
NODE_171356_length_298_cov_1.798995	0	67	0	67	67	1.0000000
NODE_171356_length_298_cov_1.798995	40	106	0	66	66	1.0000000
NODE_171391_length_298_cov_1.788945	140	197	2	57	57	1.0000000
NODE_171415_length_298_cov_1.733668	56	91	13	17	35	0.4857143
NODE_171415_length_298_cov_1.733668	56	91	14	18	35	0.5142857
NODE_171415_length_298_cov_1.733668	118	172	8	7	54	0.1296296
NODE_171415_length_298_cov_1.733668	118	172	10	11	54	0.2037037
NODE_171415_length_298_cov_1.733668	118	172	12	11	54	0.2037037
NODE_171415_length_298_cov_1.733668	118	172	14	10	54	0.1851852
NODE_171415_length_298_cov_1.733668	118	172	16	14	54	0.2592593
NODE_171415_length_298_cov_1.733668	118	172	17	1	54	0.0185185
NODE_171505_length_298_cov_1.537688	101	154	1	7	53	0.1320755
NODE_171505_length_298_cov_1.537688	101	154	3	46	53	0.8679245
NODE_172083_length_298_cov_0.829146	34	96	0	62	62	1.0000000
NODE_172330_length_297_cov_6.525253	100	122	4	22	22	1.0000000
NODE_172352_length_297_cov_4.888889	150	218	2	68	68	1.0000000
NODE_172356_length_297_cov_4.671717	56	120	0	64	64	1.0000000
NODE_172422_length_297_cov_3.338384	96	176	0	79	80	0.9875000
NODE_172422_length_297_cov_3.338384	96	176	1	1	80	0.0125000
NODE_172422_length_297_cov_3.338384	149	198	0	48	49	0.9795918
NODE_172422_length_297_cov_3.338384	149	198	2	1	49	0.0204082
NODE_172447_length_297_cov_3.040404	0	55	0	55	55	1.0000000
NODE_172447_length_297_cov_3.040404	14	55	0	41	41	1.0000000
NODE_172447_length_297_cov_3.040404	65	119	0	54	54	1.0000000
NODE_172574_length_297_cov_2.308081	8	70	0	62	62	1.0000000
NODE_172606_length_297_cov_2.196970	219	259	32	7	40	0.1750000
NODE_172606_length_297_cov_2.196970	219	259	34	6	40	0.1500000
NODE_172606_length_297_cov_2.196970	219	259	36	2	40	0.0500000
NODE_172606_length_297_cov_2.196970	219	259	37	1	40	0.0250000
NODE_172606_length_297_cov_2.196970	219	259	39	1	40	0.0250000
NODE_172606_length_297_cov_2.196970	219	259	40	1	40	0.0250000
NODE_172606_length_297_cov_2.196970	219	259	41	2	40	0.0500000
NODE_172606_length_297_cov_2.196970	219	259	43	4	40	0.1000000
NODE_172606_length_297_cov_2.196970	219	259	44	2	40	0.0500000
NODE_172606_length_297_cov_2.196970	219	259	45	1	40	0.0250000
NODE_172606_length_297_cov_2.196970	219	259	49	13	40	0.3250000
NODE_172629_length_297_cov_2.106061	81	161	0	80	80	1.0000000
NODE_172629_length_297_cov_2.106061	134	178	0	44	44	1.0000000
NODE_172668_length_297_cov_2.060606	46	76	0	30	30	1.0000000
NODE_172697_length_297_cov_2.010101	9	85	3	4	76	0.0526316
NODE_172697_length_297_cov_2.010101	9	85	4	9	76	0.1184211
NODE_172697_length_297_cov_2.010101	9	85	5	2	76	0.0263158
NODE_172697_length_297_cov_2.010101	9	85	6	5	76	0.0657895
NODE_172697_length_297_cov_2.010101	9	85	7	8	76	0.1052632
NODE_172697_length_297_cov_2.010101	9	85	9	25	76	0.3289474
NODE_172697_length_297_cov_2.010101	9	85	10	23	76	0.3026316
NODE_172783_length_297_cov_1.777778	168	208	8	6	40	0.1500000
NODE_172783_length_297_cov_1.777778	168	208	10	6	40	0.1500000
NODE_172783_length_297_cov_1.777778	168	208	11	5	40	0.1250000
NODE_172783_length_297_cov_1.777778	168	208	15	5	40	0.1250000
NODE_172783_length_297_cov_1.777778	168	208	16	17	40	0.4250000
NODE_172783_length_297_cov_1.777778	168	208	17	1	40	0.0250000
NODE_172855_length_297_cov_1.595960	175	255	7	1	80	0.0125000
NODE_172855_length_297_cov_1.595960	175	255	8	1	80	0.0125000
NODE_172855_length_297_cov_1.595960	175	255	11	4	80	0.0500000
NODE_172855_length_297_cov_1.595960	175	255	13	9	80	0.1125000
NODE_172855_length_297_cov_1.595960	175	255	15	1	80	0.0125000
NODE_172855_length_297_cov_1.595960	175	255	16	1	80	0.0125000
NODE_172855_length_297_cov_1.595960	175	255	17	3	80	0.0375000
NODE_172855_length_297_cov_1.595960	175	255	19	12	80	0.1500000
NODE_172855_length_297_cov_1.595960	175	255	21	1	80	0.0125000
NODE_172855_length_297_cov_1.595960	175	255	22	2	80	0.0250000
NODE_172855_length_297_cov_1.595960	175	255	24	4	80	0.0500000
NODE_172855_length_297_cov_1.595960	175	255	26	4	80	0.0500000
NODE_172855_length_297_cov_1.595960	175	255	28	2	80	0.0250000
NODE_172855_length_297_cov_1.595960	175	255	29	5	80	0.0625000
NODE_172855_length_297_cov_1.595960	175	255	33	2	80	0.0250000
NODE_172855_length_297_cov_1.595960	175	255	34	3	80	0.0375000
NODE_172855_length_297_cov_1.595960	175	255	36	6	80	0.0750000
NODE_172855_length_297_cov_1.595960	175	255	37	19	80	0.2375000
NODE_172862_length_297_cov_1.570707	100	177	2	7	77	0.0909091
NODE_172862_length_297_cov_1.570707	100	177	3	2	77	0.0259740
NODE_172862_length_297_cov_1.570707	100	177	4	68	77	0.8831169
NODE_172863_length_297_cov_1.570707	194	275	1	81	81	1.0000000
NODE_173063_length_297_cov_1.338384	140	199	0	59	59	1.0000000
NODE_173136_length_297_cov_1.277778	39	115	0	76	76	1.0000000
NODE_173176_length_297_cov_1.196970	7	87	0	80	80	1.0000000
NODE_173176_length_297_cov_1.196970	60	116	0	56	56	1.0000000
NODE_173345_length_297_cov_1.030303	0	33	0	2	33	0.0606061
NODE_173345_length_297_cov_1.030303	0	33	1	31	33	0.9393939
NODE_173467_length_297_cov_0.888889	109	172	0	63	63	1.0000000
NODE_173520_length_297_cov_0.782828	24	104	0	80	80	1.0000000
NODE_173708_length_296_cov_41.390863	189	260	20	6	71	0.0845070
NODE_173708_length_296_cov_41.390863	189	260	21	3	71	0.0422535
NODE_173708_length_296_cov_41.390863	189	260	22	4	71	0.0563380
NODE_173708_length_296_cov_41.390863	189	260	24	2	71	0.0281690
NODE_173708_length_296_cov_41.390863	189	260	28	2	71	0.0281690
NODE_173708_length_296_cov_41.390863	189	260	29	2	71	0.0281690
NODE_173708_length_296_cov_41.390863	189	260	31	2	71	0.0281690
NODE_173708_length_296_cov_41.390863	189	260	32	2	71	0.0281690
NODE_173708_length_296_cov_41.390863	189	260	34	1	71	0.0140845
NODE_173708_length_296_cov_41.390863	189	260	36	3	71	0.0422535
NODE_173708_length_296_cov_41.390863	189	260	39	4	71	0.0563380
NODE_173708_length_296_cov_41.390863	189	260	40	2	71	0.0281690
NODE_173708_length_296_cov_41.390863	189	260	41	5	71	0.0704225
NODE_173708_length_296_cov_41.390863	189	260	42	2	71	0.0281690
NODE_173708_length_296_cov_41.390863	189	260	43	11	71	0.1549296
NODE_173708_length_296_cov_41.390863	189	260	44	1	71	0.0140845
NODE_173708_length_296_cov_41.390863	189	260	45	7	71	0.0985916
NODE_173708_length_296_cov_41.390863	189	260	47	4	71	0.0563380
NODE_173708_length_296_cov_41.390863	189	260	48	4	71	0.0563380
NODE_173708_length_296_cov_41.390863	189	260	49	1	71	0.0140845
NODE_173708_length_296_cov_41.390863	189	260	52	1	71	0.0140845
NODE_173708_length_296_cov_41.390863	189	260	53	1	71	0.0140845
NODE_173708_length_296_cov_41.390863	189	260	54	1	71	0.0140845
NODE_173709_length_296_cov_34.776650	214	294	0	80	80	1.0000000
NODE_173758_length_296_cov_4.243655	14	54	0	40	40	1.0000000
NODE_173773_length_296_cov_3.954315	120	200	0	67	80	0.8375000
NODE_173773_length_296_cov_3.954315	120	200	1	13	80	0.1625000
NODE_173787_length_296_cov_3.736041	6	46	0	40	40	1.0000000
NODE_173797_length_296_cov_3.619289	193	251	5	58	58	1.0000000
NODE_173797_length_296_cov_3.619289	246	296	0	8	50	0.1600000
NODE_173797_length_296_cov_3.619289	246	296	2	1	50	0.0200000
NODE_173797_length_296_cov_3.619289	246	296	3	22	50	0.4400000
NODE_173797_length_296_cov_3.619289	246	296	5	19	50	0.3800000
NODE_173859_length_296_cov_3.015228	177	257	1	18	80	0.2250000
NODE_173859_length_296_cov_3.015228	177	257	2	62	80	0.7750000
NODE_173992_length_296_cov_2.309645	5	77	4	2	72	0.0277778
NODE_173992_length_296_cov_2.309645	5	77	6	5	72	0.0694444
NODE_173992_length_296_cov_2.309645	5	77	8	1	72	0.0138889
NODE_173992_length_296_cov_2.309645	5	77	10	2	72	0.0277778
NODE_173992_length_296_cov_2.309645	5	77	12	14	72	0.1944444
NODE_173992_length_296_cov_2.309645	5	77	13	44	72	0.6111111
NODE_173992_length_296_cov_2.309645	5	77	15	4	72	0.0555556
NODE_173992_length_296_cov_2.309645	50	130	13	23	80	0.2875000
NODE_173992_length_296_cov_2.309645	50	130	15	11	80	0.1375000
NODE_173992_length_296_cov_2.309645	50	130	17	46	80	0.5750000
NODE_174040_length_296_cov_2.081218	90	139	1	49	49	1.0000000
NODE_174167_length_296_cov_1.807107	199	246	0	47	47	1.0000000
NODE_174167_length_296_cov_1.807107	219	296	0	77	77	1.0000000
NODE_174213_length_296_cov_1.670051	28	103	7	2	75	0.0266667
NODE_174213_length_296_cov_1.670051	28	103	10	37	75	0.4933333
NODE_174213_length_296_cov_1.670051	28	103	11	28	75	0.3733333
NODE_174213_length_296_cov_1.670051	28	103	12	2	75	0.0266667
NODE_174213_length_296_cov_1.670051	28	103	13	1	75	0.0133333
NODE_174213_length_296_cov_1.670051	28	103	14	5	75	0.0666667
NODE_174274_length_296_cov_1.553299	102	179	0	77	77	1.0000000
NODE_174274_length_296_cov_1.553299	160	179	0	19	19	1.0000000
NODE_174438_length_296_cov_1.319797	82	162	0	12	80	0.1500000
NODE_174438_length_296_cov_1.319797	82	162	1	3	80	0.0375000
NODE_174438_length_296_cov_1.319797	82	162	3	65	80	0.8125000
NODE_174438_length_296_cov_1.319797	135	205	2	1	70	0.0142857
NODE_174438_length_296_cov_1.319797	135	205	3	69	70	0.9857143
NODE_174545_length_296_cov_1.258883	222	280	0	58	58	1.0000000
NODE_174554_length_296_cov_1.238579	90	147	1	2	57	0.0350877
NODE_174554_length_296_cov_1.238579	90	147	2	48	57	0.8421053
NODE_174554_length_296_cov_1.238579	90	147	3	7	57	0.1228070
NODE_174614_length_296_cov_1.116751	130	169	7	5	39	0.1282051
NODE_174614_length_296_cov_1.116751	130	169	8	34	39	0.8717949
NODE_175210_length_295_cov_4.290816	2	70	0	68	68	1.0000000
NODE_175210_length_295_cov_4.290816	55	123	0	68	68	1.0000000
NODE_175220_length_295_cov_4.040816	119	165	1	45	46	0.9782609
NODE_175220_length_295_cov_4.040816	119	165	3	1	46	0.0217391
NODE_175258_length_295_cov_3.576531	130	198	0	26	68	0.3823529
NODE_175258_length_295_cov_3.576531	130	198	1	42	68	0.6176471
NODE_175324_length_295_cov_2.918367	0	77	0	77	77	1.0000000
NODE_175416_length_295_cov_2.454082	216	277	0	52	61	0.8524590
NODE_175416_length_295_cov_2.454082	216	277	1	8	61	0.1311475
NODE_175416_length_295_cov_2.454082	216	277	2	1	61	0.0163934
NODE_175475_length_295_cov_2.224490	11	91	0	11	80	0.1375000
NODE_175475_length_295_cov_2.224490	11	91	1	69	80	0.8625000
NODE_175483_length_295_cov_2.183673	93	151	1	9	58	0.1551724
NODE_175483_length_295_cov_2.183673	93	151	2	1	58	0.0172414
NODE_175483_length_295_cov_2.183673	93	151	3	3	58	0.0517241
NODE_175483_length_295_cov_2.183673	93	151	4	2	58	0.0344828
NODE_175483_length_295_cov_2.183673	93	151	5	2	58	0.0344828
NODE_175483_length_295_cov_2.183673	93	151	6	2	58	0.0344828
NODE_175483_length_295_cov_2.183673	93	151	8	2	58	0.0344828
NODE_175483_length_295_cov_2.183673	93	151	10	1	58	0.0172414
NODE_175483_length_295_cov_2.183673	93	151	13	1	58	0.0172414
NODE_175483_length_295_cov_2.183673	93	151	16	1	58	0.0172414
NODE_175483_length_295_cov_2.183673	93	151	17	5	58	0.0862069
NODE_175483_length_295_cov_2.183673	93	151	18	13	58	0.2241379
NODE_175483_length_295_cov_2.183673	93	151	19	9	58	0.1551724
NODE_175483_length_295_cov_2.183673	93	151	20	7	58	0.1206897
NODE_175483_length_295_cov_2.183673	124	204	18	11	80	0.1375000
NODE_175483_length_295_cov_2.183673	124	204	19	9	80	0.1125000
NODE_175483_length_295_cov_2.183673	124	204	20	11	80	0.1375000
NODE_175483_length_295_cov_2.183673	124	204	21	13	80	0.1625000
NODE_175483_length_295_cov_2.183673	124	204	22	36	80	0.4500000
NODE_175597_length_295_cov_1.867347	191	239	4	48	48	1.0000000
NODE_175598_length_295_cov_1.862245	225	285	0	60	60	1.0000000
NODE_175721_length_295_cov_1.596939	173	254	4	27	81	0.3333333
NODE_175721_length_295_cov_1.596939	173	254	5	9	81	0.1111111
NODE_175721_length_295_cov_1.596939	173	254	6	45	81	0.5555556
NODE_175804_length_295_cov_1.520408	217	282	0	4	65	0.0615385
NODE_175804_length_295_cov_1.520408	217	282	1	23	65	0.3538462
NODE_175804_length_295_cov_1.520408	217	282	2	2	65	0.0307692
NODE_175804_length_295_cov_1.520408	217	282	4	22	65	0.3384615
NODE_175804_length_295_cov_1.520408	217	282	6	9	65	0.1384615
NODE_175804_length_295_cov_1.520408	217	282	7	5	65	0.0769231
NODE_175930_length_295_cov_1.301020	99	121	0	22	22	1.0000000
NODE_176250_length_295_cov_0.938776	200	247	0	47	47	1.0000000
NODE_176367_length_295_cov_0.780612	24	44	0	20	20	1.0000000
NODE_176436_length_295_cov_0.724490	6	87	0	81	81	1.0000000
NODE_176436_length_295_cov_0.724490	83	163	0	80	80	1.0000000
NODE_176436_length_295_cov_0.724490	136	216	0	80	80	1.0000000
NODE_176547_length_294_cov_83.882051	143	173	4	28	30	0.9333333
NODE_176547_length_294_cov_83.882051	143	173	6	2	30	0.0666667
NODE_176547_length_294_cov_83.882051	209	239	2	30	30	1.0000000
NODE_176549_length_294_cov_50.589744	187	258	24	1	71	0.0140845
NODE_176549_length_294_cov_50.589744	187	258	26	3	71	0.0422535
NODE_176549_length_294_cov_50.589744	187	258	29	2	71	0.0281690
NODE_176549_length_294_cov_50.589744	187	258	30	4	71	0.0563380
NODE_176549_length_294_cov_50.589744	187	258	32	2	71	0.0281690
NODE_176549_length_294_cov_50.589744	187	258	33	2	71	0.0281690
NODE_176549_length_294_cov_50.589744	187	258	34	1	71	0.0140845
NODE_176549_length_294_cov_50.589744	187	258	39	1	71	0.0140845
NODE_176549_length_294_cov_50.589744	187	258	41	2	71	0.0281690
NODE_176549_length_294_cov_50.589744	187	258	42	4	71	0.0563380
NODE_176549_length_294_cov_50.589744	187	258	43	4	71	0.0563380
NODE_176549_length_294_cov_50.589744	187	258	45	1	71	0.0140845
NODE_176549_length_294_cov_50.589744	187	258	46	2	71	0.0281690
NODE_176549_length_294_cov_50.589744	187	258	52	6	71	0.0845070
NODE_176549_length_294_cov_50.589744	187	258	55	3	71	0.0422535
NODE_176549_length_294_cov_50.589744	187	258	56	4	71	0.0563380
NODE_176549_length_294_cov_50.589744	187	258	57	2	71	0.0281690
NODE_176549_length_294_cov_50.589744	187	258	59	2	71	0.0281690
NODE_176549_length_294_cov_50.589744	187	258	61	1	71	0.0140845
NODE_176549_length_294_cov_50.589744	187	258	64	4	71	0.0563380
NODE_176549_length_294_cov_50.589744	187	258	65	1	71	0.0140845
NODE_176549_length_294_cov_50.589744	187	258	72	1	71	0.0140845
NODE_176549_length_294_cov_50.589744	187	258	73	2	71	0.0281690
NODE_176549_length_294_cov_50.589744	187	258	74	2	71	0.0281690
NODE_176549_length_294_cov_50.589744	187	258	76	1	71	0.0140845
NODE_176549_length_294_cov_50.589744	187	258	77	2	71	0.0281690
NODE_176549_length_294_cov_50.589744	187	258	79	1	71	0.0140845
NODE_176549_length_294_cov_50.589744	187	258	81	5	71	0.0704225
NODE_176549_length_294_cov_50.589744	187	258	83	1	71	0.0140845
NODE_176549_length_294_cov_50.589744	187	258	85	1	71	0.0140845
NODE_176549_length_294_cov_50.589744	187	258	87	1	71	0.0140845
NODE_176549_length_294_cov_50.589744	187	258	89	2	71	0.0281690
NODE_176561_length_294_cov_6.676923	61	138	2	15	77	0.1948052
NODE_176561_length_294_cov_6.676923	61	138	3	5	77	0.0649351
NODE_176561_length_294_cov_6.676923	61	138	4	57	77	0.7402598
NODE_176596_length_294_cov_4.538462	127	214	4	25	87	0.2873563
NODE_176596_length_294_cov_4.538462	127	214	5	15	87	0.1724138
NODE_176596_length_294_cov_4.538462	127	214	6	47	87	0.5402299
NODE_176598_length_294_cov_4.512821	218	248	0	30	30	1.0000000
NODE_176600_length_294_cov_4.497436	159	200	0	41	41	1.0000000
NODE_176697_length_294_cov_2.953846	114	194	0	20	80	0.2500000
NODE_176697_length_294_cov_2.953846	114	194	2	60	80	0.7500000
NODE_176727_length_294_cov_2.764103	103	183	3	3	80	0.0375000
NODE_176727_length_294_cov_2.764103	103	183	4	15	80	0.1875000
NODE_176727_length_294_cov_2.764103	103	183	5	2	80	0.0250000
NODE_176727_length_294_cov_2.764103	103	183	6	60	80	0.7500000
NODE_176727_length_294_cov_2.764103	156	236	1	4	80	0.0500000
NODE_176727_length_294_cov_2.764103	156	236	3	51	80	0.6375000
NODE_176727_length_294_cov_2.764103	156	236	4	15	80	0.1875000
NODE_176727_length_294_cov_2.764103	156	236	6	10	80	0.1250000
NODE_176728_length_294_cov_2.764103	224	282	0	34	58	0.5862069
NODE_176728_length_294_cov_2.764103	224	282	1	23	58	0.3965517
NODE_176728_length_294_cov_2.764103	224	282	3	1	58	0.0172414
NODE_176728_length_294_cov_2.764103	225	277	0	29	52	0.5576923
NODE_176728_length_294_cov_2.764103	225	277	1	23	52	0.4423077
NODE_176735_length_294_cov_2.697436	204	261	0	57	57	1.0000000
NODE_176735_length_294_cov_2.697436	234	294	0	60	60	1.0000000
NODE_176779_length_294_cov_2.517949	23	85	0	62	62	1.0000000
NODE_176816_length_294_cov_2.353846	129	167	0	38	38	1.0000000
NODE_176833_length_294_cov_2.338462	133	213	0	60	80	0.7500000
NODE_176833_length_294_cov_2.338462	133	213	1	20	80	0.2500000
NODE_176943_length_294_cov_2.046154	219	269	0	50	50	1.0000000
NODE_176957_length_294_cov_2.010256	191	235	2	44	44	1.0000000
NODE_176999_length_294_cov_1.902564	52	83	1	31	31	1.0000000
NODE_177102_length_294_cov_1.692308	46	112	0	16	66	0.2424242
NODE_177102_length_294_cov_1.692308	46	112	1	24	66	0.3636364
NODE_177102_length_294_cov_1.692308	46	112	2	26	66	0.3939394
NODE_177187_length_294_cov_1.569231	49	95	0	46	46	1.0000000
NODE_177252_length_294_cov_1.482051	28	108	0	80	80	1.0000000
NODE_177252_length_294_cov_1.482051	201	281	0	80	80	1.0000000
NODE_177252_length_294_cov_1.482051	201	281	0	80	80	1.0000000
NODE_177298_length_294_cov_1.420513	216	262	0	46	46	1.0000000
NODE_177298_length_294_cov_1.420513	235	294	0	59	59	1.0000000
NODE_177972_length_294_cov_0.666667	245	293	0	48	48	1.0000000
NODE_178066_length_293_cov_6.257732	167	247	0	80	80	1.0000000
NODE_178161_length_293_cov_3.567010	50	130	0	78	80	0.9750000
NODE_178161_length_293_cov_3.567010	50	130	1	2	80	0.0250000
NODE_178226_length_293_cov_2.907216	218	281	2	63	63	1.0000000
NODE_178246_length_293_cov_2.768041	95	175	0	80	80	1.0000000
NODE_178246_length_293_cov_2.768041	148	228	0	80	80	1.0000000
NODE_178268_length_293_cov_2.628866	207	266	1	24	59	0.4067796
NODE_178268_length_293_cov_2.628866	207	266	3	35	59	0.5932204
NODE_178277_length_293_cov_2.623711	182	223	0	41	41	1.0000000
NODE_178299_length_293_cov_2.561856	139	192	1	53	53	1.0000000
NODE_178299_length_293_cov_2.561856	177	223	0	12	46	0.2608696
NODE_178299_length_293_cov_2.561856	177	223	1	34	46	0.7391304
NODE_178317_length_293_cov_2.448454	98	158	2	60	60	1.0000000
NODE_178351_length_293_cov_2.335052	62	91	1	6	29	0.2068966
NODE_178351_length_293_cov_2.335052	62	91	2	23	29	0.7931035
NODE_178357_length_293_cov_2.314433	35	89	0	54	54	1.0000000
NODE_178523_length_293_cov_1.840206	27	107	2	19	80	0.2375000
NODE_178523_length_293_cov_1.840206	27	107	3	61	80	0.7625000
NODE_178523_length_293_cov_1.840206	80	160	2	2	80	0.0250000
NODE_178523_length_293_cov_1.840206	80	160	3	60	80	0.7500000
NODE_178523_length_293_cov_1.840206	80	160	4	18	80	0.2250000
NODE_178560_length_293_cov_1.804124	144	173	8	17	29	0.5862069
NODE_178560_length_293_cov_1.804124	144	173	9	12	29	0.4137931
NODE_178570_length_293_cov_1.778351	224	258	2	23	34	0.6764706
NODE_178570_length_293_cov_1.778351	224	258	3	11	34	0.3235294
NODE_178646_length_293_cov_1.577320	158	177	0	19	19	1.0000000
NODE_178692_length_293_cov_1.577320	161	225	2	64	64	1.0000000
NODE_178693_length_293_cov_1.577320	15	55	0	40	40	1.0000000
NODE_178788_length_293_cov_1.402062	3	72	0	69	69	1.0000000
NODE_178822_length_293_cov_1.319588	202	268	0	21	66	0.3181818
NODE_178822_length_293_cov_1.319588	202	268	1	45	66	0.6818182
NODE_178927_length_293_cov_1.226804	84	141	0	57	57	1.0000000
NODE_179542_length_292_cov_4.523316	240	290	0	50	50	1.0000000
NODE_179552_length_292_cov_4.145078	106	186	0	80	80	1.0000000
NODE_179604_length_292_cov_3.502591	129	205	4	76	76	1.0000000
NODE_179613_length_292_cov_3.435233	176	200	1	6	24	0.2500000
NODE_179613_length_292_cov_3.435233	176	200	3	18	24	0.7500000
NODE_179621_length_292_cov_3.341969	70	150	0	80	80	1.0000000
NODE_179621_length_292_cov_3.341969	118	175	0	57	57	1.0000000
NODE_179627_length_292_cov_3.222798	47	127	6	80	80	1.0000000
NODE_179627_length_292_cov_3.222798	100	129	6	29	29	1.0000000
NODE_179819_length_292_cov_2.238342	211	290	1	6	79	0.0759494
NODE_179819_length_292_cov_2.238342	211	290	3	21	79	0.2658228
NODE_179819_length_292_cov_2.238342	211	290	5	52	79	0.6582279
NODE_179943_length_292_cov_1.865285	34	114	13	38	80	0.4750000
NODE_179943_length_292_cov_1.865285	34	114	14	8	80	0.1000000
NODE_179943_length_292_cov_1.865285	34	114	15	10	80	0.1250000
NODE_179943_length_292_cov_1.865285	34	114	16	4	80	0.0500000
NODE_179943_length_292_cov_1.865285	34	114	17	20	80	0.2500000
NODE_179943_length_292_cov_1.865285	87	167	13	40	80	0.5000000
NODE_179943_length_292_cov_1.865285	87	167	14	33	80	0.4125000
NODE_179943_length_292_cov_1.865285	87	167	15	7	80	0.0875000
NODE_180013_length_292_cov_1.761658	174	254	0	26	80	0.3250000
NODE_180013_length_292_cov_1.761658	174	254	2	54	80	0.6750000
NODE_180029_length_292_cov_1.699482	0	80	0	80	80	1.0000000
NODE_180068_length_292_cov_1.611399	89	157	0	68	68	1.0000000
NODE_180210_length_292_cov_1.455959	72	115	0	20	43	0.4651163
NODE_180210_length_292_cov_1.455959	72	115	2	19	43	0.4418605
NODE_180210_length_292_cov_1.455959	72	115	4	4	43	0.0930233
NODE_180210_length_292_cov_1.455959	203	265	0	19	62	0.3064516
NODE_180210_length_292_cov_1.455959	203	265	2	39	62	0.6290323
NODE_180210_length_292_cov_1.455959	203	265	4	4	62	0.0645161
NODE_180302_length_292_cov_1.321244	102	182	3	41	80	0.5125000
NODE_180302_length_292_cov_1.321244	102	182	4	1	80	0.0125000
NODE_180302_length_292_cov_1.321244	102	182	6	10	80	0.1250000
NODE_180302_length_292_cov_1.321244	102	182	8	28	80	0.3500000
NODE_180302_length_292_cov_1.321244	155	217	2	34	62	0.5483871
NODE_180302_length_292_cov_1.321244	155	217	3	28	62	0.4516129
NODE_180968_length_291_cov_45.031250	71	145	6	15	74	0.2027027
NODE_180968_length_291_cov_45.031250	71	145	8	59	74	0.7972973
NODE_180968_length_291_cov_45.031250	71	145	6	15	74	0.2027027
NODE_180968_length_291_cov_45.031250	71	145	8	59	74	0.7972973
NODE_180968_length_291_cov_45.031250	118	184	2	16	66	0.2424242
NODE_180968_length_291_cov_45.031250	118	184	4	15	66	0.2272727
NODE_180968_length_291_cov_45.031250	118	184	6	18	66	0.2727273
NODE_180968_length_291_cov_45.031250	118	184	8	17	66	0.2575758
NODE_180969_length_291_cov_14.791667	125	205	0	80	80	1.0000000
NODE_180969_length_291_cov_14.791667	178	258	0	80	80	1.0000000
NODE_180983_length_291_cov_5.536458	97	169	0	72	72	1.0000000
NODE_180986_length_291_cov_5.401042	77	130	2	18	53	0.3396226
NODE_180986_length_291_cov_5.401042	77	130	3	35	53	0.6603774
NODE_180998_length_291_cov_4.859375	185	257	5	72	72	1.0000000
NODE_181043_length_291_cov_3.723958	196	276	0	80	80	1.0000000
NODE_181057_length_291_cov_3.531250	129	152	0	23	23	1.0000000
NODE_181191_length_291_cov_2.390625	18	80	0	62	62	1.0000000
NODE_181272_length_291_cov_2.125000	70	117	0	17	47	0.3617021
NODE_181272_length_291_cov_2.125000	70	117	1	30	47	0.6382979
NODE_181391_length_291_cov_1.859375	197	228	0	31	31	1.0000000
NODE_181497_length_291_cov_1.593750	144	175	4	31	31	1.0000000
NODE_181530_length_291_cov_1.593750	206	281	1	39	75	0.5200000
NODE_181530_length_291_cov_1.593750	206	281	2	8	75	0.1066667
NODE_181530_length_291_cov_1.593750	206	281	3	28	75	0.3733333
NODE_181599_length_291_cov_1.552083	189	269	0	45	80	0.5625000
NODE_181599_length_291_cov_1.552083	189	269	2	35	80	0.4375000
NODE_181615_length_291_cov_1.520833	180	258	0	78	78	1.0000000
NODE_181623_length_291_cov_1.510417	245	291	0	46	46	1.0000000
NODE_181696_length_291_cov_1.385417	80	120	4	30	40	0.7500000
NODE_181696_length_291_cov_1.385417	80	120	5	10	40	0.2500000
NODE_181791_length_291_cov_1.322917	70	96	0	26	26	1.0000000
NODE_181799_length_291_cov_1.307292	108	188	1	13	80	0.1625000
NODE_181799_length_291_cov_1.307292	108	188	3	37	80	0.4625000
NODE_181799_length_291_cov_1.307292	108	188	5	6	80	0.0750000
NODE_181799_length_291_cov_1.307292	108	188	6	24	80	0.3000000
NODE_181907_length_291_cov_1.114583	79	174	7	2	95	0.0210526
NODE_181907_length_291_cov_1.114583	79	174	8	5	95	0.0526316
NODE_181907_length_291_cov_1.114583	79	174	10	16	95	0.1684211
NODE_181907_length_291_cov_1.114583	79	174	11	11	95	0.1157895
NODE_181907_length_291_cov_1.114583	79	174	13	61	95	0.6421053
NODE_181930_length_291_cov_1.078125	4	85	3	19	81	0.2345679
NODE_181930_length_291_cov_1.078125	4	85	4	23	81	0.2839506
NODE_181930_length_291_cov_1.078125	4	85	5	1	81	0.0123457
NODE_181930_length_291_cov_1.078125	4	85	6	2	81	0.0246914
NODE_181930_length_291_cov_1.078125	4	85	7	1	81	0.0123457
NODE_181930_length_291_cov_1.078125	4	85	9	25	81	0.3086420
NODE_181930_length_291_cov_1.078125	4	85	11	1	81	0.0123457
NODE_181930_length_291_cov_1.078125	4	85	13	9	81	0.1111111
NODE_182112_length_291_cov_1.031250	5	50	0	45	45	1.0000000
NODE_182205_length_291_cov_0.890625	0	55	0	18	55	0.3272727
NODE_182205_length_291_cov_0.890625	0	55	1	37	55	0.6727273
NODE_182252_length_291_cov_0.802083	80	160	4	1	80	0.0125000
NODE_182252_length_291_cov_0.802083	80	160	5	1	80	0.0125000
NODE_182252_length_291_cov_0.802083	80	160	7	2	80	0.0250000
NODE_182252_length_291_cov_0.802083	80	160	8	2	80	0.0250000
NODE_182252_length_291_cov_0.802083	80	160	10	2	80	0.0250000
NODE_182252_length_291_cov_0.802083	80	160	11	8	80	0.1000000
NODE_182252_length_291_cov_0.802083	80	160	14	2	80	0.0250000
NODE_182252_length_291_cov_0.802083	80	160	16	1	80	0.0125000
NODE_182252_length_291_cov_0.802083	80	160	17	7	80	0.0875000
NODE_182252_length_291_cov_0.802083	80	160	18	1	80	0.0125000
NODE_182252_length_291_cov_0.802083	80	160	19	22	80	0.2750000
NODE_182252_length_291_cov_0.802083	80	160	20	4	80	0.0500000
NODE_182252_length_291_cov_0.802083	80	160	21	6	80	0.0750000
NODE_182252_length_291_cov_0.802083	80	160	23	1	80	0.0125000
NODE_182252_length_291_cov_0.802083	80	160	24	20	80	0.2500000
NODE_182491_length_290_cov_96.963351	44	124	0	80	80	1.0000000
NODE_182491_length_290_cov_96.963351	97	177	0	80	80	1.0000000
NODE_182512_length_290_cov_5.968586	89	150	0	43	61	0.7049180
NODE_182512_length_290_cov_5.968586	89	150	1	1	61	0.0163934
NODE_182512_length_290_cov_5.968586	89	150	2	17	61	0.2786885
NODE_182512_length_290_cov_5.968586	142	203	2	61	61	1.0000000
NODE_182535_length_290_cov_4.968586	32	52	0	10	20	0.5000000
NODE_182535_length_290_cov_4.968586	32	52	2	10	20	0.5000000
NODE_182535_length_290_cov_4.968586	73	93	2	20	20	1.0000000
NODE_182547_length_290_cov_4.670157	63	139	0	34	76	0.4473684
NODE_182547_length_290_cov_4.670157	63	139	1	42	76	0.5526316
NODE_182550_length_290_cov_4.575916	110	153	2	43	43	1.0000000
NODE_182589_length_290_cov_3.816754	113	186	3	21	73	0.2876712
NODE_182589_length_290_cov_3.816754	113	186	4	19	73	0.2602740
NODE_182589_length_290_cov_3.816754	113	186	5	33	73	0.4520548
NODE_182607_length_290_cov_3.612565	114	181	0	67	67	1.0000000
NODE_182622_length_290_cov_3.445026	91	150	1	43	59	0.7288136
NODE_182622_length_290_cov_3.445026	91	150	2	16	59	0.2711864
NODE_182772_length_290_cov_2.596859	189	218	5	6	29	0.2068966
NODE_182772_length_290_cov_2.596859	189	218	6	23	29	0.7931035
NODE_182844_length_290_cov_2.319372	45	74	0	29	29	1.0000000
NODE_182973_length_290_cov_2.041885	59	139	0	1	80	0.0125000
NODE_182973_length_290_cov_2.041885	59	139	1	10	80	0.1250000
NODE_182973_length_290_cov_2.041885	59	139	2	69	80	0.8625000
NODE_182995_length_290_cov_1.979058	229	271	5	42	42	1.0000000
NODE_183288_length_290_cov_1.602094	16	68	0	52	52	1.0000000
NODE_183347_length_290_cov_1.575916	173	250	0	77	77	1.0000000
NODE_183373_length_290_cov_1.544503	151	203	0	52	52	1.0000000
NODE_183403_length_290_cov_1.513089	22	107	0	85	85	1.0000000
NODE_183436_length_290_cov_1.460733	11	91	0	78	80	0.9750000
NODE_183436_length_290_cov_1.460733	11	91	2	2	80	0.0250000
NODE_183546_length_290_cov_1.335079	91	163	2	2	72	0.0277778
NODE_183546_length_290_cov_1.335079	91	163	5	17	72	0.2361111
NODE_183546_length_290_cov_1.335079	91	163	6	52	72	0.7222222
NODE_183546_length_290_cov_1.335079	91	163	7	1	72	0.0138889
NODE_183546_length_290_cov_1.335079	144	216	5	41	72	0.5694444
NODE_183546_length_290_cov_1.335079	144	216	6	31	72	0.4305556
NODE_183642_length_290_cov_1.314136	0	80	0	21	80	0.2625000
NODE_183642_length_290_cov_1.314136	0	80	2	59	80	0.7375000
NODE_183663_length_290_cov_1.287958	17	97	1	45	80	0.5625000
NODE_183663_length_290_cov_1.287958	17	97	2	35	80	0.4375000
NODE_183946_length_290_cov_1.068063	0	60	0	60	60	1.0000000
NODE_183946_length_290_cov_1.068063	33	113	0	80	80	1.0000000
NODE_184119_length_290_cov_1.000000	198	254	24	1	56	0.0178571
NODE_184119_length_290_cov_1.000000	198	254	27	1	56	0.0178571
NODE_184119_length_290_cov_1.000000	198	254	28	5	56	0.0892857
NODE_184119_length_290_cov_1.000000	198	254	29	3	56	0.0535714
NODE_184119_length_290_cov_1.000000	198	254	30	9	56	0.1607143
NODE_184119_length_290_cov_1.000000	198	254	32	1	56	0.0178571
NODE_184119_length_290_cov_1.000000	198	254	34	3	56	0.0535714
NODE_184119_length_290_cov_1.000000	198	254	36	4	56	0.0714286
NODE_184119_length_290_cov_1.000000	198	254	37	6	56	0.1071429
NODE_184119_length_290_cov_1.000000	198	254	38	23	56	0.4107143
NODE_184326_length_290_cov_0.832461	154	236	0	82	82	1.0000000
NODE_184585_length_290_cov_0.701571	201	281	0	80	80	1.0000000
NODE_184716_length_289_cov_554.947368	45	125	64	2	80	0.0250000
NODE_184716_length_289_cov_554.947368	45	125	70	1	80	0.0125000
NODE_184716_length_289_cov_554.947368	45	125	72	1	80	0.0125000
NODE_184716_length_289_cov_554.947368	45	125	75	3	80	0.0375000
NODE_184716_length_289_cov_554.947368	45	125	76	2	80	0.0250000
NODE_184716_length_289_cov_554.947368	45	125	77	2	80	0.0250000
NODE_184716_length_289_cov_554.947368	45	125	79	5	80	0.0625000
NODE_184716_length_289_cov_554.947368	45	125	80	1	80	0.0125000
NODE_184716_length_289_cov_554.947368	45	125	81	2	80	0.0250000
NODE_184716_length_289_cov_554.947368	45	125	82	3	80	0.0375000
NODE_184716_length_289_cov_554.947368	45	125	83	5	80	0.0625000
NODE_184716_length_289_cov_554.947368	45	125	85	6	80	0.0750000
NODE_184716_length_289_cov_554.947368	45	125	87	3	80	0.0375000
NODE_184716_length_289_cov_554.947368	45	125	88	4	80	0.0500000
NODE_184716_length_289_cov_554.947368	45	125	90	1	80	0.0125000
NODE_184716_length_289_cov_554.947368	45	125	92	3	80	0.0375000
NODE_184716_length_289_cov_554.947368	45	125	94	1	80	0.0125000
NODE_184716_length_289_cov_554.947368	45	125	96	2	80	0.0250000
NODE_184716_length_289_cov_554.947368	45	125	97	1	80	0.0125000
NODE_184716_length_289_cov_554.947368	45	125	98	2	80	0.0250000
NODE_184716_length_289_cov_554.947368	45	125	99	2	80	0.0250000
NODE_184716_length_289_cov_554.947368	45	125	104	2	80	0.0250000
NODE_184716_length_289_cov_554.947368	45	125	105	6	80	0.0750000
NODE_184716_length_289_cov_554.947368	45	125	107	1	80	0.0125000
NODE_184716_length_289_cov_554.947368	45	125	108	3	80	0.0375000
NODE_184716_length_289_cov_554.947368	45	125	109	16	80	0.2000000
NODE_184729_length_289_cov_7.436842	181	229	0	48	48	1.0000000
NODE_184745_length_289_cov_5.789474	35	100	0	65	65	1.0000000
NODE_184745_length_289_cov_5.789474	85	153	0	68	68	1.0000000
NODE_184745_length_289_cov_5.789474	146	181	0	35	35	1.0000000
NODE_184781_length_289_cov_4.515789	192	254	0	62	62	1.0000000
NODE_184806_length_289_cov_4.136842	101	148	2	37	47	0.7872341
NODE_184806_length_289_cov_4.136842	101	148	3	10	47	0.2127660
NODE_184892_length_289_cov_2.973684	38	83	0	45	45	1.0000000
NODE_184960_length_289_cov_2.678947	105	168	2	26	63	0.4126984
NODE_184960_length_289_cov_2.678947	105	168	3	37	63	0.5873016
NODE_184960_length_289_cov_2.678947	158	204	0	24	46	0.5217391
NODE_184960_length_289_cov_2.678947	158	204	2	22	46	0.4782609
NODE_184963_length_289_cov_2.673684	216	263	0	47	47	1.0000000
NODE_185036_length_289_cov_2.378947	233	289	0	56	56	1.0000000
NODE_185152_length_289_cov_2.089474	26	91	0	65	65	1.0000000
NODE_185213_length_289_cov_1.921053	0	54	0	54	54	1.0000000
NODE_185383_length_289_cov_1.642105	58	123	0	65	65	1.0000000
NODE_185570_length_289_cov_1.547368	81	124	0	43	43	1.0000000
NODE_185617_length_289_cov_1.489474	192	274	0	82	82	1.0000000
NODE_185622_length_289_cov_1.484211	50	69	4	19	19	1.0000000
NODE_185708_length_289_cov_1.357895	31	74	0	43	43	1.0000000
NODE_185852_length_289_cov_1.278947	239	270	0	31	31	1.0000000
NODE_185864_length_289_cov_1.252632	23	66	1	43	43	1.0000000
NODE_185926_length_289_cov_1.168421	40	100	0	60	60	1.0000000
NODE_185937_length_289_cov_1.152632	0	50	0	50	50	1.0000000
NODE_185937_length_289_cov_1.152632	41	103	0	62	62	1.0000000
NODE_186095_length_289_cov_1.073684	152	198	0	46	46	1.0000000
NODE_186491_length_289_cov_0.878947	113	193	0	80	80	1.0000000
NODE_186491_length_289_cov_0.878947	166	246	0	80	80	1.0000000
NODE_186507_length_289_cov_0.863158	116	211	2	26	95	0.2736842
NODE_186507_length_289_cov_0.863158	116	211	4	17	95	0.1789474
NODE_186507_length_289_cov_0.863158	116	211	6	52	95	0.5473684
NODE_186515_length_289_cov_0.857895	6	75	0	69	69	1.0000000
NODE_186547_length_289_cov_0.831579	230	289	0	3	59	0.0508475
NODE_186547_length_289_cov_0.831579	230	289	2	3	59	0.0508475
NODE_186547_length_289_cov_0.831579	230	289	4	6	59	0.1016949
NODE_186547_length_289_cov_0.831579	230	289	6	9	59	0.1525424
NODE_186547_length_289_cov_0.831579	230	289	7	6	59	0.1016949
NODE_186547_length_289_cov_0.831579	230	289	8	4	59	0.0677966
NODE_186547_length_289_cov_0.831579	230	289	9	5	59	0.0847458
NODE_186547_length_289_cov_0.831579	230	289	10	2	59	0.0338983
NODE_186547_length_289_cov_0.831579	230	289	12	12	59	0.2033898
NODE_186547_length_289_cov_0.831579	230	289	13	9	59	0.1525424
NODE_186631_length_289_cov_0.805263	98	159	0	61	61	1.0000000
NODE_186865_length_289_cov_0.568421	141	213	0	72	72	1.0000000
NODE_186934_length_288_cov_11.089947	135	195	2	60	60	1.0000000
NODE_187025_length_288_cov_3.587302	108	188	4	11	80	0.1375000
NODE_187025_length_288_cov_3.587302	108	188	5	9	80	0.1125000
NODE_187025_length_288_cov_3.587302	108	188	6	15	80	0.1875000
NODE_187025_length_288_cov_3.587302	108	188	7	9	80	0.1125000
NODE_187025_length_288_cov_3.587302	108	188	8	36	80	0.4500000
NODE_187049_length_288_cov_3.296296	61	125	0	64	64	1.0000000
NODE_187049_length_288_cov_3.296296	102	178	0	76	76	1.0000000
NODE_187062_length_288_cov_3.206349	149	202	0	53	53	1.0000000
NODE_187170_length_288_cov_2.539683	4	68	6	2	64	0.0312500
NODE_187170_length_288_cov_2.539683	4	68	8	2	64	0.0312500
NODE_187170_length_288_cov_2.539683	4	68	9	6	64	0.0937500
NODE_187170_length_288_cov_2.539683	4	68	11	4	64	0.0625000
NODE_187170_length_288_cov_2.539683	4	68	13	17	64	0.2656250
NODE_187170_length_288_cov_2.539683	4	68	17	31	64	0.4843750
NODE_187170_length_288_cov_2.539683	4	68	19	2	64	0.0312500
NODE_187187_length_288_cov_2.465608	137	182	3	20	45	0.4444444
NODE_187187_length_288_cov_2.465608	137	182	4	25	45	0.5555556
NODE_187191_length_288_cov_2.449735	216	278	1	19	62	0.3064516
NODE_187191_length_288_cov_2.449735	216	278	2	43	62	0.6935484
NODE_187191_length_288_cov_2.449735	237	273	1	14	36	0.3888889
NODE_187191_length_288_cov_2.449735	237	273	2	22	36	0.6111111
NODE_187248_length_288_cov_2.275132	10	46	0	36	36	1.0000000
NODE_187248_length_288_cov_2.275132	13	86	0	73	73	1.0000000
NODE_187248_length_288_cov_2.275132	47	100	0	53	53	1.0000000
NODE_187318_length_288_cov_2.153439	50	81	1	31	31	1.0000000
NODE_187431_length_288_cov_1.915344	0	75	0	75	75	1.0000000
NODE_187443_length_288_cov_1.888889	49	125	0	58	76	0.7631579
NODE_187443_length_288_cov_1.888889	49	125	1	18	76	0.2368421
NODE_187484_length_288_cov_1.878307	0	42	0	42	42	1.0000000
NODE_187484_length_288_cov_1.878307	15	63	0	48	48	1.0000000
NODE_187810_length_288_cov_1.492063	0	42	0	42	42	1.0000000
NODE_188135_length_288_cov_1.158730	213	288	0	75	75	1.0000000
NODE_188161_length_288_cov_1.100529	256	288	0	16	32	0.5000000
NODE_188161_length_288_cov_1.100529	256	288	2	16	32	0.5000000
NODE_188169_length_288_cov_1.079365	10	74	0	64	64	1.0000000
NODE_188169_length_288_cov_1.079365	65	110	0	45	45	1.0000000
NODE_188760_length_288_cov_0.809524	141	170	0	5	29	0.1724138
NODE_188760_length_288_cov_0.809524	141	170	1	24	29	0.8275862
NODE_189068_length_287_cov_7.632979	117	184	10	5	67	0.0746269
NODE_189068_length_287_cov_7.632979	117	184	11	9	67	0.1343284
NODE_189068_length_287_cov_7.632979	117	184	12	13	67	0.1940299
NODE_189068_length_287_cov_7.632979	117	184	13	14	67	0.2089552
NODE_189068_length_287_cov_7.632979	117	184	14	26	67	0.3880597
NODE_189079_length_287_cov_6.510638	20	100	0	80	80	1.0000000
NODE_189097_length_287_cov_5.781915	164	246	2	21	82	0.2560976
NODE_189097_length_287_cov_5.781915	164	246	3	34	82	0.4146341
NODE_189097_length_287_cov_5.781915	164	246	4	27	82	0.3292683
NODE_189182_length_287_cov_3.590426	114	194	0	80	80	1.0000000
NODE_189192_length_287_cov_3.452128	0	52	0	52	52	1.0000000
NODE_189208_length_287_cov_3.281915	263	286	2	1	23	0.0434783
NODE_189208_length_287_cov_3.281915	263	286	3	6	23	0.2608696
NODE_189208_length_287_cov_3.281915	263	286	6	6	23	0.2608696
NODE_189208_length_287_cov_3.281915	263	286	7	3	23	0.1304348
NODE_189208_length_287_cov_3.281915	263	286	8	2	23	0.0869565
NODE_189208_length_287_cov_3.281915	263	286	11	2	23	0.0869565
NODE_189208_length_287_cov_3.281915	263	286	12	3	23	0.1304348
NODE_189266_length_287_cov_2.936170	41	110	0	69	69	1.0000000
NODE_189266_length_287_cov_2.936170	41	111	0	70	70	1.0000000
NODE_189266_length_287_cov_2.936170	94	167	0	73	73	1.0000000
NODE_189266_length_287_cov_2.936170	156	179	0	23	23	1.0000000
NODE_189330_length_287_cov_2.638298	22	86	0	64	64	1.0000000
NODE_189381_length_287_cov_2.436170	182	262	1	56	80	0.7000000
NODE_189381_length_287_cov_2.436170	182	262	3	24	80	0.3000000
NODE_189582_length_287_cov_1.984043	137	166	6	21	29	0.7241379
NODE_189582_length_287_cov_1.984043	137	166	7	8	29	0.2758621
NODE_189594_length_287_cov_1.941489	56	123	0	67	67	1.0000000
NODE_189614_length_287_cov_1.904255	8	51	2	18	43	0.4186046
NODE_189614_length_287_cov_1.904255	8	51	3	12	43	0.2790698
NODE_189614_length_287_cov_1.904255	8	51	4	9	43	0.2093023
NODE_189614_length_287_cov_1.904255	8	51	6	4	43	0.0930233
NODE_189710_length_287_cov_1.803191	146	217	0	71	71	1.0000000
NODE_189843_length_287_cov_1.627660	113	175	9	4	62	0.0645161
NODE_189843_length_287_cov_1.627660	113	175	12	15	62	0.2419355
NODE_189843_length_287_cov_1.627660	113	175	14	11	62	0.1774193
NODE_189843_length_287_cov_1.627660	113	175	15	22	62	0.3548387
NODE_189843_length_287_cov_1.627660	113	175	16	5	62	0.0806452
NODE_189843_length_287_cov_1.627660	113	175	18	1	62	0.0161290
NODE_189843_length_287_cov_1.627660	113	175	19	4	62	0.0645161
NODE_189843_length_287_cov_1.627660	148	228	8	21	80	0.2625000
NODE_189843_length_287_cov_1.627660	148	228	9	36	80	0.4500000
NODE_189843_length_287_cov_1.627660	148	228	12	15	80	0.1875000
NODE_189843_length_287_cov_1.627660	148	228	14	4	80	0.0500000
NODE_189843_length_287_cov_1.627660	148	228	15	4	80	0.0500000
NODE_189864_length_287_cov_1.627660	14	59	0	45	45	1.0000000
NODE_189864_length_287_cov_1.627660	41	112	0	71	71	1.0000000
NODE_189949_length_287_cov_1.574468	150	220	0	70	70	1.0000000
NODE_189985_length_287_cov_1.531915	123	154	0	31	31	1.0000000
NODE_190122_length_287_cov_1.356383	93	147	0	54	54	1.0000000
NODE_190142_length_287_cov_1.356383	135	199	0	64	64	1.0000000
NODE_190189_length_287_cov_1.335106	149	201	0	52	52	1.0000000
NODE_190654_length_287_cov_1.037234	23	44	0	21	21	1.0000000
NODE_190701_length_287_cov_0.994681	206	225	0	19	19	1.0000000
NODE_190802_length_287_cov_0.898936	0	57	0	9	57	0.1578947
NODE_190802_length_287_cov_0.898936	0	57	1	3	57	0.0526316
NODE_190802_length_287_cov_0.898936	0	57	2	4	57	0.0701754
NODE_190802_length_287_cov_0.898936	0	57	3	2	57	0.0350877
NODE_190802_length_287_cov_0.898936	0	57	4	8	57	0.1403509
NODE_190802_length_287_cov_0.898936	0	57	5	2	57	0.0350877
NODE_190802_length_287_cov_0.898936	0	57	7	2	57	0.0350877
NODE_190802_length_287_cov_0.898936	0	57	8	2	57	0.0350877
NODE_190802_length_287_cov_0.898936	0	57	12	9	57	0.1578947
NODE_190802_length_287_cov_0.898936	0	57	14	4	57	0.0701754
NODE_190802_length_287_cov_0.898936	0	57	15	2	57	0.0350877
NODE_190802_length_287_cov_0.898936	0	57	17	10	57	0.1754386
NODE_190873_length_287_cov_0.840426	46	121	2	75	75	1.0000000
NODE_191306_length_286_cov_141.540107	4	63	0	59	59	1.0000000
NODE_191389_length_286_cov_3.935829	79	123	2	6	44	0.1363636
NODE_191389_length_286_cov_3.935829	79	123	3	1	44	0.0227273
NODE_191389_length_286_cov_3.935829	79	123	4	37	44	0.8409091
NODE_191391_length_286_cov_3.871658	45	121	3	76	76	1.0000000
NODE_191391_length_286_cov_3.871658	102	169	0	24	67	0.3582090
NODE_191391_length_286_cov_3.871658	102	169	3	43	67	0.6417910
NODE_191393_length_286_cov_3.812834	62	142	0	80	80	1.0000000
NODE_191430_length_286_cov_3.352941	63	143	0	80	80	1.0000000
NODE_191430_length_286_cov_3.352941	116	196	0	80	80	1.0000000
NODE_191466_length_286_cov_3.101604	217	271	0	22	54	0.4074074
NODE_191466_length_286_cov_3.101604	217	271	1	29	54	0.5370370
NODE_191466_length_286_cov_3.101604	217	271	2	3	54	0.0555556
NODE_191509_length_286_cov_2.823529	56	122	7	3	66	0.0454545
NODE_191509_length_286_cov_2.823529	56	122	9	10	66	0.1515152
NODE_191509_length_286_cov_2.823529	56	122	11	1	66	0.0151515
NODE_191509_length_286_cov_2.823529	56	122	13	8	66	0.1212121
NODE_191509_length_286_cov_2.823529	56	122	15	2	66	0.0303030
NODE_191509_length_286_cov_2.823529	56	122	17	1	66	0.0151515
NODE_191509_length_286_cov_2.823529	56	122	21	3	66	0.0454545
NODE_191509_length_286_cov_2.823529	56	122	23	6	66	0.0909091
NODE_191509_length_286_cov_2.823529	56	122	25	10	66	0.1515152
NODE_191509_length_286_cov_2.823529	56	122	27	22	66	0.3333333
NODE_191598_length_286_cov_2.438503	151	218	0	41	67	0.6119403
NODE_191598_length_286_cov_2.438503	151	218	1	20	67	0.2985075
NODE_191598_length_286_cov_2.438503	151	218	2	6	67	0.0895522
NODE_191754_length_286_cov_2.037433	57	138	0	3	81	0.0370370
NODE_191754_length_286_cov_2.037433	57	138	2	14	81	0.1728395
NODE_191754_length_286_cov_2.037433	57	138	3	64	81	0.7901235
NODE_191892_length_286_cov_1.807487	186	232	0	46	46	1.0000000
NODE_191892_length_286_cov_1.807487	239	285	0	46	46	1.0000000
NODE_192100_length_286_cov_1.566845	112	160	2	48	48	1.0000000
NODE_192100_length_286_cov_1.566845	165	213	0	37	48	0.7708333
NODE_192100_length_286_cov_1.566845	165	213	2	11	48	0.2291667
NODE_192150_length_286_cov_1.497326	107	160	0	53	53	1.0000000
NODE_192233_length_286_cov_1.363636	20	87	0	67	67	1.0000000
NODE_192302_length_286_cov_1.358289	218	262	2	44	44	1.0000000
NODE_192357_length_286_cov_1.304813	147	205	1	6	58	0.1034483
NODE_192357_length_286_cov_1.304813	147	205	2	14	58	0.2413793
NODE_192357_length_286_cov_1.304813	147	205	3	38	58	0.6551724
NODE_192427_length_286_cov_1.203209	30	76	0	7	46	0.1521739
NODE_192427_length_286_cov_1.203209	30	76	1	39	46	0.8478261
NODE_192427_length_286_cov_1.203209	49	129	1	80	80	1.0000000
NODE_192757_length_286_cov_1.074866	160	220	2	60	60	1.0000000
NODE_193023_length_286_cov_0.871658	218	279	0	61	61	1.0000000
NODE_193038_length_286_cov_0.855615	224	281	0	18	57	0.3157895
NODE_193038_length_286_cov_0.855615	224	281	1	1	57	0.0175439
NODE_193038_length_286_cov_0.855615	224	281	2	1	57	0.0175439
NODE_193038_length_286_cov_0.855615	224	281	4	1	57	0.0175439
NODE_193038_length_286_cov_0.855615	224	281	5	4	57	0.0701754
NODE_193038_length_286_cov_0.855615	224	281	6	3	57	0.0526316
NODE_193038_length_286_cov_0.855615	224	281	8	13	57	0.2280702
NODE_193038_length_286_cov_0.855615	224	281	9	14	57	0.2456140
NODE_193038_length_286_cov_0.855615	224	281	11	2	57	0.0350877
NODE_193362_length_286_cov_0.625668	110	190	0	80	80	1.0000000
NODE_193362_length_286_cov_0.625668	163	240	0	77	77	1.0000000
NODE_193481_length_285_cov_7.392473	91	152	0	14	61	0.2295082
NODE_193481_length_285_cov_7.392473	91	152	2	47	61	0.7704918
NODE_193481_length_285_cov_7.392473	150	184	2	34	34	1.0000000
NODE_193513_length_285_cov_4.650538	0	74	0	74	74	1.0000000
NODE_193513_length_285_cov_4.650538	47	127	0	80	80	1.0000000
NODE_193513_length_285_cov_4.650538	123	203	0	80	80	1.0000000
NODE_193513_length_285_cov_4.650538	176	256	0	80	80	1.0000000
NODE_193532_length_285_cov_4.091398	91	154	0	63	63	1.0000000
NODE_193538_length_285_cov_4.010753	120	201	0	81	81	1.0000000
NODE_193547_length_285_cov_3.854839	97	151	0	54	54	1.0000000
NODE_193547_length_285_cov_3.854839	106	153	0	47	47	1.0000000
NODE_193566_length_285_cov_3.607527	197	258	0	13	61	0.2131148
NODE_193566_length_285_cov_3.607527	197	258	2	6	61	0.0983607
NODE_193566_length_285_cov_3.607527	197	258	4	3	61	0.0491803
NODE_193566_length_285_cov_3.607527	197	258	6	1	61	0.0163934
NODE_193566_length_285_cov_3.607527	197	258	8	2	61	0.0327869
NODE_193566_length_285_cov_3.607527	197	258	11	4	61	0.0655738
NODE_193566_length_285_cov_3.607527	197	258	14	1	61	0.0163934
NODE_193566_length_285_cov_3.607527	197	258	15	4	61	0.0655738
NODE_193566_length_285_cov_3.607527	197	258	18	1	61	0.0163934
NODE_193566_length_285_cov_3.607527	197	258	21	3	61	0.0491803
NODE_193566_length_285_cov_3.607527	197	258	23	2	61	0.0327869
NODE_193566_length_285_cov_3.607527	197	258	24	1	61	0.0163934
NODE_193566_length_285_cov_3.607527	197	258	26	1	61	0.0163934
NODE_193566_length_285_cov_3.607527	197	258	27	2	61	0.0327869
NODE_193566_length_285_cov_3.607527	197	258	28	1	61	0.0163934
NODE_193566_length_285_cov_3.607527	197	258	30	2	61	0.0327869
NODE_193566_length_285_cov_3.607527	197	258	31	5	61	0.0819672
NODE_193566_length_285_cov_3.607527	197	258	32	9	61	0.1475410
NODE_193624_length_285_cov_3.037634	190	272	2	4	82	0.0487805
NODE_193624_length_285_cov_3.037634	190	272	4	20	82	0.2439024
NODE_193624_length_285_cov_3.037634	190	272	5	3	82	0.0365854
NODE_193624_length_285_cov_3.037634	190	272	6	55	82	0.6707317
NODE_193660_length_285_cov_2.806452	215	279	0	64	64	1.0000000
NODE_193688_length_285_cov_2.736559	106	173	0	3	67	0.0447761
NODE_193688_length_285_cov_2.736559	106	173	1	64	67	0.9552239
NODE_193784_length_285_cov_2.311828	220	262	0	42	42	1.0000000
NODE_193883_length_285_cov_2.043011	77	150	0	73	73	1.0000000
NODE_193883_length_285_cov_2.043011	155	197	0	42	42	1.0000000
NODE_193978_length_285_cov_1.876344	67	110	1	43	43	1.0000000
NODE_194150_length_285_cov_1.645161	112	160	4	17	48	0.3541667
NODE_194150_length_285_cov_1.645161	112	160	5	31	48	0.6458333
NODE_194260_length_285_cov_1.548387	124	172	1	48	48	1.0000000
NODE_194332_length_285_cov_1.456989	210	277	0	67	67	1.0000000
NODE_194499_length_285_cov_1.327957	114	191	0	77	77	1.0000000
NODE_194865_length_285_cov_1.096774	175	229	0	25	54	0.4629630
NODE_194865_length_285_cov_1.096774	175	229	1	29	54	0.5370370
NODE_194865_length_285_cov_1.096774	230	271	0	41	41	1.0000000
NODE_195109_length_285_cov_0.924731	128	208	0	80	80	1.0000000
NODE_195115_length_285_cov_0.919355	5	65	0	60	60	1.0000000
NODE_195124_length_285_cov_0.913978	6	80	0	74	74	1.0000000
NODE_195124_length_285_cov_0.913978	58	133	0	75	75	1.0000000
NODE_195642_length_284_cov_7.967568	143	207	10	1	64	0.0156250
NODE_195642_length_284_cov_7.967568	143	207	11	11	64	0.1718750
NODE_195642_length_284_cov_7.967568	143	207	13	4	64	0.0625000
NODE_195642_length_284_cov_7.967568	143	207	14	48	64	0.7500000
NODE_195667_length_284_cov_5.016216	115	169	0	54	54	1.0000000
NODE_195715_length_284_cov_3.913514	26	82	0	56	56	1.0000000
NODE_195760_length_284_cov_3.405405	209	283	0	10	74	0.1351351
NODE_195760_length_284_cov_3.405405	209	283	2	64	74	0.8648649
NODE_195863_length_284_cov_2.718919	138	162	0	24	24	1.0000000
NODE_195863_length_284_cov_2.718919	138	215	0	77	77	1.0000000
NODE_196090_length_284_cov_2.097297	46	122	5	70	76	0.9210526
NODE_196090_length_284_cov_2.097297	46	122	6	6	76	0.0789474
NODE_196253_length_284_cov_1.756757	27	100	0	7	73	0.0958904
NODE_196253_length_284_cov_1.756757	27	100	1	25	73	0.3424658
NODE_196253_length_284_cov_1.756757	27	100	2	41	73	0.5616438
NODE_196253_length_284_cov_1.756757	97	153	2	56	56	1.0000000
NODE_196273_length_284_cov_1.713514	24	59	0	28	35	0.8000000
NODE_196273_length_284_cov_1.713514	24	59	2	7	35	0.2000000
NODE_196372_length_284_cov_1.654054	207	251	1	44	44	1.0000000
NODE_196426_length_284_cov_1.643243	180	239	0	30	59	0.5084746
NODE_196426_length_284_cov_1.643243	180	239	1	29	59	0.4915254
NODE_196505_length_284_cov_1.540541	148	186	18	6	38	0.1578947
NODE_196505_length_284_cov_1.540541	148	186	19	4	38	0.1052632
NODE_196505_length_284_cov_1.540541	148	186	21	8	38	0.2105263
NODE_196505_length_284_cov_1.540541	148	186	23	17	38	0.4473684
NODE_196505_length_284_cov_1.540541	148	186	26	3	38	0.0789474
NODE_196670_length_284_cov_1.378378	65	145	0	1	80	0.0125000
NODE_196670_length_284_cov_1.378378	65	145	1	7	80	0.0875000
NODE_196670_length_284_cov_1.378378	65	145	3	1	80	0.0125000
NODE_196670_length_284_cov_1.378378	65	145	4	2	80	0.0250000
NODE_196670_length_284_cov_1.378378	65	145	6	25	80	0.3125000
NODE_196670_length_284_cov_1.378378	65	145	9	1	80	0.0125000
NODE_196670_length_284_cov_1.378378	65	145	10	21	80	0.2625000
NODE_196670_length_284_cov_1.378378	65	145	11	10	80	0.1250000
NODE_196670_length_284_cov_1.378378	65	145	13	12	80	0.1500000
NODE_196670_length_284_cov_1.378378	118	165	10	5	47	0.1063830
NODE_196670_length_284_cov_1.378378	118	165	11	10	47	0.2127660
NODE_196670_length_284_cov_1.378378	118	165	13	21	47	0.4468085
NODE_196670_length_284_cov_1.378378	118	165	15	5	47	0.1063830
NODE_196670_length_284_cov_1.378378	118	165	16	6	47	0.1276596
NODE_196733_length_284_cov_1.329730	114	170	1	22	56	0.3928571
NODE_196733_length_284_cov_1.329730	114	170	2	34	56	0.6071429
NODE_197755_length_284_cov_0.686486	13	94	0	28	81	0.3456790
NODE_197755_length_284_cov_0.686486	13	94	2	53	81	0.6543210
NODE_197755_length_284_cov_0.686486	13	94	0	28	81	0.3456790
NODE_197755_length_284_cov_0.686486	13	94	2	53	81	0.6543210
NODE_197755_length_284_cov_0.686486	13	94	0	28	81	0.3456790
NODE_197755_length_284_cov_0.686486	13	94	2	53	81	0.6543210
NODE_197835_length_284_cov_0.551351	167	219	0	52	52	1.0000000
NODE_197936_length_283_cov_4.434783	81	137	9	13	56	0.2321429
NODE_197936_length_283_cov_4.434783	81	137	10	6	56	0.1071429
NODE_197936_length_283_cov_4.434783	81	137	12	1	56	0.0178571
NODE_197936_length_283_cov_4.434783	81	137	14	36	56	0.6428571
NODE_197936_length_283_cov_4.434783	114	190	0	2	76	0.0263158
NODE_197936_length_283_cov_4.434783	114	190	1	2	76	0.0263158
NODE_197936_length_283_cov_4.434783	114	190	2	4	76	0.0526316
NODE_197936_length_283_cov_4.434783	114	190	3	2	76	0.0263158
NODE_197936_length_283_cov_4.434783	114	190	5	4	76	0.0526316
NODE_197936_length_283_cov_4.434783	114	190	6	5	76	0.0657895
NODE_197936_length_283_cov_4.434783	114	190	8	6	76	0.0789474
NODE_197936_length_283_cov_4.434783	114	190	9	41	76	0.5394737
NODE_197936_length_283_cov_4.434783	114	190	10	6	76	0.0789474
NODE_197936_length_283_cov_4.434783	114	190	12	1	76	0.0131579
NODE_197936_length_283_cov_4.434783	114	190	14	3	76	0.0394737
NODE_197936_length_283_cov_4.434783	190	270	0	80	80	1.0000000
NODE_197937_length_283_cov_4.429348	104	168	0	64	64	1.0000000
NODE_197937_length_283_cov_4.429348	104	168	0	64	64	1.0000000
NODE_197937_length_283_cov_4.429348	141	207	0	66	66	1.0000000
NODE_197937_length_283_cov_4.429348	141	221	0	80	80	1.0000000
NODE_198007_length_283_cov_3.369565	0	35	0	35	35	1.0000000
NODE_198022_length_283_cov_3.309783	47	91	0	44	44	1.0000000
NODE_198081_length_283_cov_2.923913	95	137	0	42	42	1.0000000
NODE_198081_length_283_cov_2.923913	110	190	0	80	80	1.0000000
NODE_198098_length_283_cov_2.782609	120	200	3	41	80	0.5125000
NODE_198098_length_283_cov_2.782609	120	200	4	38	80	0.4750000
NODE_198098_length_283_cov_2.782609	120	200	5	1	80	0.0125000
NODE_198109_length_283_cov_2.771739	29	72	0	43	43	1.0000000
NODE_198171_length_283_cov_2.494565	186	229	0	43	43	1.0000000
NODE_198176_length_283_cov_2.494565	181	238	0	57	57	1.0000000
NODE_198271_length_283_cov_2.217391	222	281	0	59	59	1.0000000
NODE_198518_length_283_cov_1.777174	40	120	0	80	80	1.0000000
NODE_198745_length_283_cov_1.543478	125	161	5	3	36	0.0833333
NODE_198745_length_283_cov_1.543478	125	161	7	2	36	0.0555556
NODE_198745_length_283_cov_1.543478	125	161	8	3	36	0.0833333
NODE_198745_length_283_cov_1.543478	125	161	10	7	36	0.1944444
NODE_198745_length_283_cov_1.543478	125	161	12	21	36	0.5833333
NODE_198751_length_283_cov_1.538043	182	203	0	21	21	1.0000000
NODE_198986_length_283_cov_1.304348	208	270	0	62	62	1.0000000
NODE_199042_length_283_cov_1.211957	157	234	0	3	77	0.0389610
NODE_199042_length_283_cov_1.211957	157	234	1	31	77	0.4025974
NODE_199042_length_283_cov_1.211957	157	234	2	43	77	0.5584416
NODE_199070_length_283_cov_1.168478	183	250	15	6	67	0.0895522
NODE_199070_length_283_cov_1.168478	183	250	16	1	67	0.0149254
NODE_199070_length_283_cov_1.168478	183	250	17	28	67	0.4179105
NODE_199070_length_283_cov_1.168478	183	250	18	32	67	0.4776119
NODE_199606_length_283_cov_0.918478	146	226	2	25	80	0.3125000
NODE_199606_length_283_cov_0.918478	146	226	4	55	80	0.6875000
NODE_199606_length_283_cov_0.918478	199	279	0	44	80	0.5500000
NODE_199606_length_283_cov_0.918478	199	279	2	34	80	0.4250000
NODE_199606_length_283_cov_0.918478	199	279	4	2	80	0.0250000
NODE_199641_length_283_cov_0.885870	143	205	0	62	62	1.0000000
NODE_199958_length_283_cov_0.706522	119	159	0	40	40	1.0000000
NODE_200085_length_282_cov_51.027322	219	280	0	61	61	1.0000000
NODE_200085_length_282_cov_51.027322	219	282	0	63	63	1.0000000
NODE_200166_length_282_cov_3.901639	38	118	0	80	80	1.0000000
NODE_200166_length_282_cov_3.901639	91	171	0	80	80	1.0000000
NODE_200171_length_282_cov_3.874317	96	116	0	20	20	1.0000000
NODE_200201_length_282_cov_3.562842	224	279	0	36	55	0.6545454
NODE_200201_length_282_cov_3.562842	224	279	2	19	55	0.3454545
NODE_200270_length_282_cov_2.890710	41	123	0	82	82	1.0000000
NODE_200276_length_282_cov_2.846995	26	47	4	7	21	0.3333333
NODE_200276_length_282_cov_2.846995	26	47	6	14	21	0.6666667
NODE_200304_length_282_cov_2.770492	145	225	0	80	80	1.0000000
NODE_200304_length_282_cov_2.770492	198	278	0	80	80	1.0000000
NODE_200329_length_282_cov_2.655738	46	119	0	52	73	0.7123288
NODE_200329_length_282_cov_2.655738	46	119	1	21	73	0.2876712
NODE_200329_length_282_cov_2.655738	100	159	1	59	59	1.0000000
NODE_200335_length_282_cov_2.622951	0	36	0	36	36	1.0000000
NODE_200335_length_282_cov_2.622951	9	89	0	80	80	1.0000000
NODE_200336_length_282_cov_2.622951	38	111	0	73	73	1.0000000
NODE_200336_length_282_cov_2.622951	98	144	0	46	46	1.0000000
NODE_200367_length_282_cov_2.508197	138	186	1	48	48	1.0000000
NODE_200367_length_282_cov_2.508197	191	234	0	20	43	0.4651163
NODE_200367_length_282_cov_2.508197	191	234	1	23	43	0.5348837
NODE_200425_length_282_cov_2.289617	68	137	0	28	69	0.4057971
NODE_200425_length_282_cov_2.289617	68	137	1	25	69	0.3623188
NODE_200425_length_282_cov_2.289617	68	137	2	16	69	0.2318841
NODE_200443_length_282_cov_2.229508	169	249	0	80	80	1.0000000
NODE_200501_length_282_cov_2.163934	138	192	0	54	54	1.0000000
NODE_200634_length_282_cov_1.901639	149	216	0	67	67	1.0000000
NODE_200924_length_282_cov_1.612022	123	162	2	39	39	1.0000000
NODE_201084_length_282_cov_1.393443	158	225	0	67	67	1.0000000
NODE_201219_length_282_cov_1.273224	91	140	0	49	49	1.0000000
NODE_201413_length_282_cov_1.114754	5	53	0	48	48	1.0000000
NODE_202284_length_281_cov_7.895604	165	210	2	1	45	0.0222222
NODE_202284_length_281_cov_7.895604	165	210	4	41	45	0.9111111
NODE_202284_length_281_cov_7.895604	165	210	6	2	45	0.0444444
NODE_202284_length_281_cov_7.895604	165	210	7	1	45	0.0222222
NODE_202284_length_281_cov_7.895604	183	263	2	26	80	0.3250000
NODE_202284_length_281_cov_7.895604	183	263	4	54	80	0.6750000
NODE_202294_length_281_cov_6.379121	151	231	3	80	80	1.0000000
NODE_202333_length_281_cov_4.565934	71	127	0	56	56	1.0000000
NODE_202337_length_281_cov_4.494505	211	261	0	50	50	1.0000000
NODE_202356_length_281_cov_4.219780	85	135	0	50	50	1.0000000
NODE_202356_length_281_cov_4.219780	145	188	0	43	43	1.0000000
NODE_202401_length_281_cov_3.620879	245	281	0	36	36	1.0000000
NODE_202421_length_281_cov_3.324176	104	161	1	10	57	0.1754386
NODE_202421_length_281_cov_3.324176	104	161	2	46	57	0.8070176
NODE_202421_length_281_cov_3.324176	104	161	3	1	57	0.0175439
NODE_202421_length_281_cov_3.324176	112	192	1	41	80	0.5125000
NODE_202421_length_281_cov_3.324176	112	192	2	38	80	0.4750000
NODE_202421_length_281_cov_3.324176	112	192	3	1	80	0.0125000
NODE_202436_length_281_cov_3.197802	6	80	0	74	74	1.0000000
NODE_202473_length_281_cov_2.923077	92	150	0	50	58	0.8620690
NODE_202473_length_281_cov_2.923077	92	150	1	8	58	0.1379310
NODE_202650_length_281_cov_2.241758	5	58	0	53	53	1.0000000
NODE_202712_length_281_cov_2.120879	56	136	0	5	80	0.0625000
NODE_202712_length_281_cov_2.120879	56	136	1	17	80	0.2125000
NODE_202712_length_281_cov_2.120879	56	136	2	58	80	0.7250000
NODE_202788_length_281_cov_1.961538	199	270	1	8	71	0.1126761
NODE_202788_length_281_cov_1.961538	199	270	3	9	71	0.1267606
NODE_202788_length_281_cov_1.961538	199	270	4	54	71	0.7605634
NODE_203008_length_281_cov_1.675824	147	199	0	52	52	1.0000000
NODE_203008_length_281_cov_1.675824	178	198	0	20	20	1.0000000
NODE_203008_length_281_cov_1.675824	200	241	0	41	41	1.0000000
NODE_203065_length_281_cov_1.653846	29	65	0	33	36	0.9166667
NODE_203065_length_281_cov_1.653846	29	65	1	3	36	0.0833333
NODE_203168_length_281_cov_1.483516	85	135	2	50	50	1.0000000
NODE_203168_length_281_cov_1.483516	86	166	2	80	80	1.0000000
NODE_203168_length_281_cov_1.483516	139	184	2	45	45	1.0000000
NODE_203183_length_281_cov_1.461538	223	276	0	1	53	0.0188679
NODE_203183_length_281_cov_1.461538	223	276	1	13	53	0.2452830
NODE_203183_length_281_cov_1.461538	223	276	2	39	53	0.7358491
NODE_203262_length_281_cov_1.401099	237	281	1	6	44	0.1363636
NODE_203262_length_281_cov_1.401099	237	281	2	38	44	0.8636364
NODE_203281_length_281_cov_1.401099	150	214	2	26	64	0.4062500
NODE_203281_length_281_cov_1.401099	150	214	4	22	64	0.3437500
NODE_203281_length_281_cov_1.401099	150	214	6	16	64	0.2500000
NODE_203281_length_281_cov_1.401099	187	267	2	79	80	0.9875000
NODE_203281_length_281_cov_1.401099	187	267	4	1	80	0.0125000
NODE_203292_length_281_cov_1.401099	31	111	0	80	80	1.0000000
NODE_203440_length_281_cov_1.186813	0	79	0	45	79	0.5696203
NODE_203440_length_281_cov_1.186813	0	79	1	7	79	0.0886076
NODE_203440_length_281_cov_1.186813	0	79	2	5	79	0.0632911
NODE_203440_length_281_cov_1.186813	0	79	5	3	79	0.0379747
NODE_203440_length_281_cov_1.186813	0	79	7	5	79	0.0632911
NODE_203440_length_281_cov_1.186813	0	79	8	6	79	0.0759494
NODE_203440_length_281_cov_1.186813	0	79	9	2	79	0.0253165
NODE_203440_length_281_cov_1.186813	0	79	10	6	79	0.0759494
NODE_203440_length_281_cov_1.186813	52	132	2	5	80	0.0625000
NODE_203440_length_281_cov_1.186813	52	132	5	3	80	0.0375000
NODE_203440_length_281_cov_1.186813	52	132	7	5	80	0.0625000
NODE_203440_length_281_cov_1.186813	52	132	8	6	80	0.0750000
NODE_203440_length_281_cov_1.186813	52	132	9	2	80	0.0250000
NODE_203440_length_281_cov_1.186813	52	132	10	6	80	0.0750000
NODE_203440_length_281_cov_1.186813	52	132	12	11	80	0.1375000
NODE_203440_length_281_cov_1.186813	52	132	14	2	80	0.0250000
NODE_203440_length_281_cov_1.186813	52	132	15	40	80	0.5000000
NODE_203516_length_281_cov_1.120879	47	82	0	35	35	1.0000000
NODE_203534_length_281_cov_1.120879	243	276	0	33	33	1.0000000
NODE_203544_length_281_cov_1.120879	216	281	0	65	65	1.0000000
NODE_203785_length_281_cov_1.060440	139	179	8	16	40	0.4000000
NODE_203785_length_281_cov_1.060440	139	179	9	24	40	0.6000000
NODE_204094_length_281_cov_0.840659	72	138	0	66	66	1.0000000
NODE_204094_length_281_cov_0.840659	111	191	0	80	80	1.0000000
NODE_204467_length_280_cov_39.320442	118	198	6	21	80	0.2625000
NODE_204467_length_280_cov_39.320442	118	198	7	30	80	0.3750000
NODE_204467_length_280_cov_39.320442	118	198	8	9	80	0.1125000
NODE_204467_length_280_cov_39.320442	118	198	9	20	80	0.2500000
NODE_204467_length_280_cov_39.320442	181	251	3	18	70	0.2571429
NODE_204467_length_280_cov_39.320442	181	251	4	5	70	0.0714286
NODE_204467_length_280_cov_39.320442	181	251	6	47	70	0.6714286
NODE_204468_length_280_cov_34.259669	97	137	1	1	40	0.0250000
NODE_204468_length_280_cov_34.259669	97	137	8	1	40	0.0250000
NODE_204468_length_280_cov_34.259669	97	137	13	1	40	0.0250000
NODE_204468_length_280_cov_34.259669	97	137	15	1	40	0.0250000
NODE_204468_length_280_cov_34.259669	97	137	18	1	40	0.0250000
NODE_204468_length_280_cov_34.259669	97	137	19	1	40	0.0250000
NODE_204468_length_280_cov_34.259669	97	137	20	1	40	0.0250000
NODE_204468_length_280_cov_34.259669	97	137	25	1	40	0.0250000
NODE_204468_length_280_cov_34.259669	97	137	28	1	40	0.0250000
NODE_204468_length_280_cov_34.259669	97	137	29	1	40	0.0250000
NODE_204468_length_280_cov_34.259669	97	137	30	9	40	0.2250000
NODE_204468_length_280_cov_34.259669	97	137	31	4	40	0.1000000
NODE_204468_length_280_cov_34.259669	97	137	34	2	40	0.0500000
NODE_204468_length_280_cov_34.259669	97	137	35	1	40	0.0250000
NODE_204468_length_280_cov_34.259669	97	137	36	3	40	0.0750000
NODE_204468_length_280_cov_34.259669	97	137	38	3	40	0.0750000
NODE_204468_length_280_cov_34.259669	97	137	41	1	40	0.0250000
NODE_204468_length_280_cov_34.259669	97	137	45	1	40	0.0250000
NODE_204468_length_280_cov_34.259669	97	137	49	6	40	0.1500000
NODE_204532_length_280_cov_4.287293	53	100	0	47	47	1.0000000
NODE_204532_length_280_cov_4.287293	129	186	0	57	57	1.0000000
NODE_204596_length_280_cov_3.436464	34	103	1	15	69	0.2173913
NODE_204596_length_280_cov_3.436464	34	103	2	54	69	0.7826087
NODE_204597_length_280_cov_3.430939	17	97	2	80	80	1.0000000
NODE_204597_length_280_cov_3.430939	27	97	2	70	70	1.0000000
NODE_204674_length_280_cov_2.988950	118	164	0	46	46	1.0000000
NODE_204938_length_280_cov_2.165746	2	48	0	46	46	1.0000000
NODE_204938_length_280_cov_2.165746	6	48	0	42	42	1.0000000
NODE_204938_length_280_cov_2.165746	21	101	0	80	80	1.0000000
NODE_204938_length_280_cov_2.165746	22	101	0	79	79	1.0000000
NODE_204938_length_280_cov_2.165746	32	101	0	69	69	1.0000000
NODE_204976_length_280_cov_2.022099	105	148	0	3	43	0.0697674
NODE_204976_length_280_cov_2.022099	105	148	1	30	43	0.6976744
NODE_204976_length_280_cov_2.022099	105	148	2	10	43	0.2325581
NODE_204976_length_280_cov_2.022099	121	148	1	17	27	0.6296296
NODE_204976_length_280_cov_2.022099	121	148	2	10	27	0.3703704
NODE_205044_length_280_cov_1.889503	50	132	0	13	82	0.1585366
NODE_205044_length_280_cov_1.889503	50	132	2	69	82	0.8414634
NODE_205062_length_280_cov_1.828729	45	75	0	14	30	0.4666667
NODE_205062_length_280_cov_1.828729	45	75	2	11	30	0.3666667
NODE_205062_length_280_cov_1.828729	45	75	4	5	30	0.1666667
NODE_205410_length_280_cov_1.425414	17	50	2	33	33	1.0000000
NODE_205410_length_280_cov_1.425414	70	112	0	41	42	0.9761904
NODE_205410_length_280_cov_1.425414	70	112	2	1	42	0.0238095
NODE_205416_length_280_cov_1.414365	37	97	0	60	60	1.0000000
NODE_205633_length_280_cov_1.187845	56	136	0	80	80	1.0000000
NODE_205635_length_280_cov_1.182320	154	234	0	20	80	0.2500000
NODE_205635_length_280_cov_1.182320	154	234	2	60	80	0.7500000
NODE_205635_length_280_cov_1.182320	207	280	0	66	73	0.9041096
NODE_205635_length_280_cov_1.182320	207	280	2	7	73	0.0958904
NODE_205701_length_280_cov_1.127072	204	265	1	60	61	0.9836066
NODE_205701_length_280_cov_1.127072	204	265	3	1	61	0.0163934
NODE_205794_length_280_cov_1.127072	0	39	0	39	39	1.0000000
NODE_205801_length_280_cov_1.127072	218	253	0	35	35	1.0000000
NODE_205894_length_280_cov_1.127072	0	59	0	59	59	1.0000000
NODE_206211_length_280_cov_0.911602	176	256	0	23	80	0.2875000
NODE_206211_length_280_cov_0.911602	176	256	1	1	80	0.0125000
NODE_206211_length_280_cov_0.911602	176	256	2	26	80	0.3250000
NODE_206211_length_280_cov_0.911602	176	256	3	30	80	0.3750000
NODE_206211_length_280_cov_0.911602	229	280	0	47	51	0.9215686
NODE_206211_length_280_cov_0.911602	229	280	1	1	51	0.0196078
NODE_206211_length_280_cov_0.911602	229	280	2	3	51	0.0588235
NODE_206319_length_280_cov_0.845304	211	268	0	57	57	1.0000000
NODE_206531_length_280_cov_0.779006	129	203	2	16	74	0.2162162
NODE_206531_length_280_cov_0.779006	129	203	4	58	74	0.7837838
NODE_206721_length_279_cov_50.005556	51	130	26	1	79	0.0126582
NODE_206721_length_279_cov_50.005556	51	130	27	6	79	0.0759494
NODE_206721_length_279_cov_50.005556	51	130	28	10	79	0.1265823
NODE_206721_length_279_cov_50.005556	51	130	29	3	79	0.0379747
NODE_206721_length_279_cov_50.005556	51	130	30	23	79	0.2911392
NODE_206721_length_279_cov_50.005556	51	130	32	36	79	0.4556962
NODE_206721_length_279_cov_50.005556	103	179	8	3	76	0.0394737
NODE_206721_length_279_cov_50.005556	103	179	9	1	76	0.0131579
NODE_206721_length_279_cov_50.005556	103	179	10	6	76	0.0789474
NODE_206721_length_279_cov_50.005556	103	179	14	12	76	0.1578947
NODE_206721_length_279_cov_50.005556	103	179	15	7	76	0.0921053
NODE_206721_length_279_cov_50.005556	103	179	19	2	76	0.0263158
NODE_206721_length_279_cov_50.005556	103	179	21	1	76	0.0131579
NODE_206721_length_279_cov_50.005556	103	179	22	3	76	0.0394737
NODE_206721_length_279_cov_50.005556	103	179	24	6	76	0.0789474
NODE_206721_length_279_cov_50.005556	103	179	26	9	76	0.1184211
NODE_206721_length_279_cov_50.005556	103	179	28	10	76	0.1315790
NODE_206721_length_279_cov_50.005556	103	179	30	5	76	0.0657895
NODE_206721_length_279_cov_50.005556	103	179	32	11	76	0.1447368
NODE_206744_length_279_cov_6.055556	196	228	0	32	32	1.0000000
NODE_206762_length_279_cov_5.166667	197	277	0	80	80	1.0000000
NODE_206788_length_279_cov_4.427778	107	187	5	13	80	0.1625000
NODE_206788_length_279_cov_4.427778	107	187	7	20	80	0.2500000
NODE_206788_length_279_cov_4.427778	107	187	8	25	80	0.3125000
NODE_206788_length_279_cov_4.427778	107	187	9	21	80	0.2625000
NODE_206788_length_279_cov_4.427778	107	187	10	1	80	0.0125000
NODE_206879_length_279_cov_3.200000	205	225	0	20	20	1.0000000
NODE_206886_length_279_cov_3.116667	115	195	2	12	80	0.1500000
NODE_206886_length_279_cov_3.116667	115	195	3	68	80	0.8500000
NODE_206886_length_279_cov_3.116667	168	248	2	65	80	0.8125000
NODE_206886_length_279_cov_3.116667	168	248	3	15	80	0.1875000
NODE_206972_length_279_cov_2.600000	67	147	2	15	80	0.1875000
NODE_206972_length_279_cov_2.600000	67	147	4	65	80	0.8125000
NODE_206972_length_279_cov_2.600000	120	199	2	12	79	0.1518987
NODE_206972_length_279_cov_2.600000	120	199	4	67	79	0.8481013
NODE_207023_length_279_cov_2.427778	155	199	3	9	44	0.2045455
NODE_207023_length_279_cov_2.427778	155	199	5	35	44	0.7954546
NODE_207052_length_279_cov_2.283333	168	240	1	44	72	0.6111111
NODE_207052_length_279_cov_2.283333	168	240	2	28	72	0.3888889
NODE_207054_length_279_cov_2.277778	190	265	0	75	75	1.0000000
NODE_207086_length_279_cov_2.266667	66	109	0	43	43	1.0000000
NODE_207115_length_279_cov_2.255556	115	176	0	17	61	0.2786885
NODE_207115_length_279_cov_2.255556	115	176	1	44	61	0.7213115
NODE_207115_length_279_cov_2.255556	168	222	1	54	54	1.0000000
NODE_207155_length_279_cov_2.200000	57	104	3	47	47	1.0000000
NODE_207269_length_279_cov_1.977778	0	62	0	62	62	1.0000000
NODE_207293_length_279_cov_1.944444	63	105	0	42	42	1.0000000
NODE_207306_length_279_cov_1.916667	182	262	0	80	80	1.0000000
NODE_207318_length_279_cov_1.866667	63	143	1	17	80	0.2125000
NODE_207318_length_279_cov_1.866667	63	143	3	63	80	0.7875000
NODE_207387_length_279_cov_1.700000	8	37	0	12	29	0.4137931
NODE_207387_length_279_cov_1.700000	8	37	1	17	29	0.5862069
NODE_207389_length_279_cov_1.700000	10	42	0	32	32	1.0000000
NODE_207534_length_279_cov_1.672222	103	183	0	80	80	1.0000000
NODE_207641_length_279_cov_1.433333	51	110	1	17	59	0.2881356
NODE_207641_length_279_cov_1.433333	51	110	2	9	59	0.1525424
NODE_207641_length_279_cov_1.433333	51	110	3	33	59	0.5593221
NODE_207641_length_279_cov_1.433333	83	119	1	26	36	0.7222222
NODE_207641_length_279_cov_1.433333	83	119	2	9	36	0.2500000
NODE_207641_length_279_cov_1.433333	83	119	3	1	36	0.0277778
NODE_207929_length_279_cov_1.144444	146	211	2	65	65	1.0000000
NODE_207929_length_279_cov_1.144444	184	266	0	36	82	0.4390244
NODE_207929_length_279_cov_1.144444	184	266	2	46	82	0.5609756
NODE_207931_length_279_cov_1.138889	125	188	7	1	63	0.0158730
NODE_207931_length_279_cov_1.138889	125	188	8	3	63	0.0476190
NODE_207931_length_279_cov_1.138889	125	188	9	4	63	0.0634921
NODE_207931_length_279_cov_1.138889	125	188	10	8	63	0.1269841
NODE_207931_length_279_cov_1.138889	125	188	11	36	63	0.5714286
NODE_207931_length_279_cov_1.138889	125	188	13	11	63	0.1746032
NODE_207932_length_279_cov_1.138889	111	191	0	80	80	1.0000000
NODE_207948_length_279_cov_1.133333	231	271	0	29	40	0.7250000
NODE_207948_length_279_cov_1.133333	231	271	2	11	40	0.2750000
NODE_208183_length_279_cov_1.116667	15	92	0	77	77	1.0000000
NODE_208334_length_279_cov_0.988889	181	261	0	80	80	1.0000000
NODE_208410_length_279_cov_0.927778	50	69	0	19	19	1.0000000
NODE_208410_length_279_cov_0.927778	50	69	0	19	19	1.0000000
NODE_208664_length_279_cov_0.844444	35	70	2	35	35	1.0000000
NODE_209293_length_278_cov_44.882682	158	210	14	7	52	0.1346154
NODE_209293_length_278_cov_44.882682	158	210	15	3	52	0.0576923
NODE_209293_length_278_cov_44.882682	158	210	16	3	52	0.0576923
NODE_209293_length_278_cov_44.882682	158	210	17	2	52	0.0384615
NODE_209293_length_278_cov_44.882682	158	210	18	9	52	0.1730769
NODE_209293_length_278_cov_44.882682	158	210	19	1	52	0.0192308
NODE_209293_length_278_cov_44.882682	158	210	20	5	52	0.0961538
NODE_209293_length_278_cov_44.882682	158	210	21	2	52	0.0384615
NODE_209293_length_278_cov_44.882682	158	210	24	3	52	0.0576923
NODE_209293_length_278_cov_44.882682	158	210	26	1	52	0.0192308
NODE_209293_length_278_cov_44.882682	158	210	27	4	52	0.0769231
NODE_209293_length_278_cov_44.882682	158	210	28	1	52	0.0192308
NODE_209293_length_278_cov_44.882682	158	210	30	1	52	0.0192308
NODE_209293_length_278_cov_44.882682	158	210	32	1	52	0.0192308
NODE_209293_length_278_cov_44.882682	158	210	33	1	52	0.0192308
NODE_209293_length_278_cov_44.882682	158	210	35	2	52	0.0384615
NODE_209293_length_278_cov_44.882682	158	210	36	1	52	0.0192308
NODE_209293_length_278_cov_44.882682	158	210	37	1	52	0.0192308
NODE_209293_length_278_cov_44.882682	158	210	38	1	52	0.0192308
NODE_209293_length_278_cov_44.882682	158	210	39	1	52	0.0192308
NODE_209293_length_278_cov_44.882682	158	210	42	1	52	0.0192308
NODE_209293_length_278_cov_44.882682	158	210	43	1	52	0.0192308
NODE_209293_length_278_cov_44.882682	206	232	9	4	26	0.1538462
NODE_209293_length_278_cov_44.882682	206	232	11	3	26	0.1153846
NODE_209293_length_278_cov_44.882682	206	232	12	3	26	0.1153846
NODE_209293_length_278_cov_44.882682	206	232	14	16	26	0.6153846
NODE_209293_length_278_cov_44.882682	206	265	3	7	59	0.1186441
NODE_209293_length_278_cov_44.882682	206	265	4	4	59	0.0677966
NODE_209293_length_278_cov_44.882682	206	265	5	1	59	0.0169492
NODE_209293_length_278_cov_44.882682	206	265	6	2	59	0.0338983
NODE_209293_length_278_cov_44.882682	206	265	7	2	59	0.0338983
NODE_209293_length_278_cov_44.882682	206	265	8	13	59	0.2203390
NODE_209293_length_278_cov_44.882682	206	265	9	8	59	0.1355932
NODE_209293_length_278_cov_44.882682	206	265	11	3	59	0.0508475
NODE_209293_length_278_cov_44.882682	206	265	12	3	59	0.0508475
NODE_209293_length_278_cov_44.882682	206	265	14	16	59	0.2711864
NODE_209294_length_278_cov_37.474860	0	52	0	14	52	0.2692308
NODE_209294_length_278_cov_37.474860	0	52	1	38	52	0.7307692
NODE_209294_length_278_cov_37.474860	48	128	1	4	80	0.0500000
NODE_209294_length_278_cov_37.474860	48	128	3	11	80	0.1375000
NODE_209294_length_278_cov_37.474860	48	128	4	9	80	0.1125000
NODE_209294_length_278_cov_37.474860	48	128	6	56	80	0.7000000
NODE_209294_length_278_cov_37.474860	101	181	5	17	80	0.2125000
NODE_209294_length_278_cov_37.474860	101	181	6	63	80	0.7875000
NODE_209295_length_278_cov_21.340782	84	164	2	1	80	0.0125000
NODE_209295_length_278_cov_21.340782	84	164	6	79	80	0.9875000
NODE_209295_length_278_cov_21.340782	137	217	2	3	80	0.0375000
NODE_209295_length_278_cov_21.340782	137	217	4	48	80	0.6000000
NODE_209295_length_278_cov_21.340782	137	217	6	29	80	0.3625000
NODE_209360_length_278_cov_4.156425	132	210	2	7	78	0.0897436
NODE_209360_length_278_cov_4.156425	132	210	3	17	78	0.2179487
NODE_209360_length_278_cov_4.156425	132	210	4	44	78	0.5641026
NODE_209360_length_278_cov_4.156425	132	210	5	10	78	0.1282051
NODE_209360_length_278_cov_4.156425	193	263	2	33	70	0.4714286
NODE_209360_length_278_cov_4.156425	193	263	3	37	70	0.5285714
NODE_209372_length_278_cov_3.977654	142	221	5	60	79	0.7594936
NODE_209372_length_278_cov_3.977654	142	221	7	19	79	0.2405063
NODE_209378_length_278_cov_3.865922	168	210	0	42	42	1.0000000
NODE_209552_length_278_cov_2.558659	93	123	1	18	30	0.6000000
NODE_209552_length_278_cov_2.558659	93	123	2	12	30	0.4000000
NODE_209565_length_278_cov_2.513966	54	106	0	17	52	0.3269231
NODE_209565_length_278_cov_2.513966	54	106	2	9	52	0.1730769
NODE_209565_length_278_cov_2.513966	54	106	3	26	52	0.5000000
NODE_209565_length_278_cov_2.513966	79	158	2	1	79	0.0126582
NODE_209565_length_278_cov_2.513966	79	158	3	35	79	0.4430380
NODE_209565_length_278_cov_2.513966	79	158	4	43	79	0.5443038
NODE_209605_length_278_cov_2.296089	127	207	0	80	80	1.0000000
NODE_209883_length_278_cov_1.731844	145	194	5	4	49	0.0816327
NODE_209883_length_278_cov_1.731844	145	194	7	7	49	0.1428571
NODE_209883_length_278_cov_1.731844	145	194	8	1	49	0.0204082
NODE_209883_length_278_cov_1.731844	145	194	10	3	49	0.0612245
NODE_209883_length_278_cov_1.731844	145	194	11	8	49	0.1632653
NODE_209883_length_278_cov_1.731844	145	194	12	8	49	0.1632653
NODE_209883_length_278_cov_1.731844	145	194	13	18	49	0.3673469
NODE_210038_length_278_cov_1.681564	129	184	0	55	55	1.0000000
NODE_210068_length_278_cov_1.636872	13	41	2	2	28	0.0714286
NODE_210068_length_278_cov_1.636872	13	41	4	26	28	0.9285714
NODE_210373_length_278_cov_1.290503	3	67	1	3	64	0.0468750
NODE_210373_length_278_cov_1.290503	3	67	2	3	64	0.0468750
NODE_210373_length_278_cov_1.290503	3	67	3	2	64	0.0312500
NODE_210373_length_278_cov_1.290503	3	67	5	8	64	0.1250000
NODE_210373_length_278_cov_1.290503	3	67	7	1	64	0.0156250
NODE_210373_length_278_cov_1.290503	3	67	8	1	64	0.0156250
NODE_210373_length_278_cov_1.290503	3	67	9	8	64	0.1250000
NODE_210373_length_278_cov_1.290503	3	67	10	7	64	0.1093750
NODE_210373_length_278_cov_1.290503	3	67	11	2	64	0.0312500
NODE_210373_length_278_cov_1.290503	3	67	12	4	64	0.0625000
NODE_210373_length_278_cov_1.290503	3	67	14	6	64	0.0937500
NODE_210373_length_278_cov_1.290503	3	67	15	19	64	0.2968750
NODE_210373_length_278_cov_1.290503	3	67	1	3	64	0.0468750
NODE_210373_length_278_cov_1.290503	3	67	2	3	64	0.0468750
NODE_210373_length_278_cov_1.290503	3	67	3	2	64	0.0312500
NODE_210373_length_278_cov_1.290503	3	67	5	8	64	0.1250000
NODE_210373_length_278_cov_1.290503	3	67	7	1	64	0.0156250
NODE_210373_length_278_cov_1.290503	3	67	8	1	64	0.0156250
NODE_210373_length_278_cov_1.290503	3	67	9	8	64	0.1250000
NODE_210373_length_278_cov_1.290503	3	67	10	7	64	0.1093750
NODE_210373_length_278_cov_1.290503	3	67	11	2	64	0.0312500
NODE_210373_length_278_cov_1.290503	3	67	12	4	64	0.0625000
NODE_210373_length_278_cov_1.290503	3	67	14	6	64	0.0937500
NODE_210373_length_278_cov_1.290503	3	67	15	19	64	0.2968750
NODE_210373_length_278_cov_1.290503	3	67	1	3	64	0.0468750
NODE_210373_length_278_cov_1.290503	3	67	2	3	64	0.0468750
NODE_210373_length_278_cov_1.290503	3	67	3	2	64	0.0312500
NODE_210373_length_278_cov_1.290503	3	67	5	8	64	0.1250000
NODE_210373_length_278_cov_1.290503	3	67	7	1	64	0.0156250
NODE_210373_length_278_cov_1.290503	3	67	8	1	64	0.0156250
NODE_210373_length_278_cov_1.290503	3	67	9	8	64	0.1250000
NODE_210373_length_278_cov_1.290503	3	67	10	7	64	0.1093750
NODE_210373_length_278_cov_1.290503	3	67	11	2	64	0.0312500
NODE_210373_length_278_cov_1.290503	3	67	12	4	64	0.0625000
NODE_210373_length_278_cov_1.290503	3	67	14	6	64	0.0937500
NODE_210373_length_278_cov_1.290503	3	67	15	19	64	0.2968750
NODE_210463_length_278_cov_1.150838	52	76	3	24	24	1.0000000
NODE_210463_length_278_cov_1.150838	58	84	3	26	26	1.0000000
NODE_210559_length_278_cov_1.139665	108	187	1	28	79	0.3544304
NODE_210559_length_278_cov_1.139665	108	187	2	8	79	0.1012658
NODE_210559_length_278_cov_1.139665	108	187	3	43	79	0.5443038
NODE_210612_length_278_cov_1.139665	232	278	0	46	46	1.0000000
NODE_210691_length_278_cov_1.139665	210	278	0	34	68	0.5000000
NODE_210691_length_278_cov_1.139665	210	278	1	34	68	0.5000000
NODE_212166_length_277_cov_2.691011	0	60	0	60	60	1.0000000
NODE_212166_length_277_cov_2.691011	33	113	0	80	80	1.0000000
NODE_212175_length_277_cov_2.617978	85	127	0	42	42	1.0000000
NODE_212233_length_277_cov_2.438202	137	218	3	25	81	0.3086420
NODE_212233_length_277_cov_2.438202	137	218	5	35	81	0.4320988
NODE_212233_length_277_cov_2.438202	137	218	7	12	81	0.1481481
NODE_212233_length_277_cov_2.438202	137	218	8	9	81	0.1111111
NODE_212357_length_277_cov_2.140449	234	276	1	42	42	1.0000000
NODE_212377_length_277_cov_2.095506	41	114	0	73	73	1.0000000
NODE_212377_length_277_cov_2.095506	41	114	0	73	73	1.0000000
NODE_212377_length_277_cov_2.095506	94	161	0	67	67	1.0000000
NODE_212525_length_277_cov_1.837079	92	172	0	11	80	0.1375000
NODE_212525_length_277_cov_1.837079	92	172	1	27	80	0.3375000
NODE_212525_length_277_cov_1.837079	92	172	2	42	80	0.5250000
NODE_212558_length_277_cov_1.764045	115	155	1	24	40	0.6000000
NODE_212558_length_277_cov_1.764045	115	155	2	16	40	0.4000000
NODE_212605_length_277_cov_1.719101	150	215	0	12	65	0.1846154
NODE_212605_length_277_cov_1.719101	150	215	2	38	65	0.5846154
NODE_212605_length_277_cov_1.719101	150	215	3	15	65	0.2307692
NODE_212845_length_277_cov_1.505618	0	47	0	47	47	1.0000000
NODE_212845_length_277_cov_1.505618	20	100	0	80	80	1.0000000
NODE_212970_length_277_cov_1.426966	113	191	0	78	78	1.0000000
NODE_213057_length_277_cov_1.314607	127	176	2	16	49	0.3265306
NODE_213057_length_277_cov_1.314607	127	176	4	33	49	0.6734694
NODE_213091_length_277_cov_1.258427	141	222	0	81	81	1.0000000
NODE_213223_length_277_cov_1.146067	19	95	2	1	76	0.0131579
NODE_213223_length_277_cov_1.146067	19	95	4	47	76	0.6184211
NODE_213223_length_277_cov_1.146067	19	95	6	19	76	0.2500000
NODE_213223_length_277_cov_1.146067	19	95	8	2	76	0.0263158
NODE_213223_length_277_cov_1.146067	19	95	9	7	76	0.0921053
NODE_213490_length_277_cov_1.061798	67	105	7	38	38	1.0000000
NODE_213505_length_277_cov_1.044944	19	77	1	58	58	1.0000000
NODE_214572_length_276_cov_31.774011	91	153	6	8	62	0.1290323
NODE_214572_length_276_cov_31.774011	91	153	9	3	62	0.0483871
NODE_214572_length_276_cov_31.774011	91	153	11	6	62	0.0967742
NODE_214572_length_276_cov_31.774011	91	153	12	1	62	0.0161290
NODE_214572_length_276_cov_31.774011	91	153	13	6	62	0.0967742
NODE_214572_length_276_cov_31.774011	91	153	14	3	62	0.0483871
NODE_214572_length_276_cov_31.774011	91	153	15	5	62	0.0806452
NODE_214572_length_276_cov_31.774011	91	153	17	2	62	0.0322581
NODE_214572_length_276_cov_31.774011	91	153	18	1	62	0.0161290
NODE_214572_length_276_cov_31.774011	91	153	20	2	62	0.0322581
NODE_214572_length_276_cov_31.774011	91	153	21	1	62	0.0161290
NODE_214572_length_276_cov_31.774011	91	153	23	4	62	0.0645161
NODE_214572_length_276_cov_31.774011	91	153	24	3	62	0.0483871
NODE_214572_length_276_cov_31.774011	91	153	26	1	62	0.0161290
NODE_214572_length_276_cov_31.774011	91	153	28	7	62	0.1129032
NODE_214572_length_276_cov_31.774011	91	153	29	9	62	0.1451613
NODE_214576_length_276_cov_10.056497	66	146	0	80	80	1.0000000
NODE_214698_length_276_cov_3.564972	176	256	2	80	80	1.0000000
NODE_214785_length_276_cov_2.920904	203	260	0	48	57	0.8421053
NODE_214785_length_276_cov_2.920904	203	260	1	9	57	0.1578947
NODE_214785_length_276_cov_2.920904	233	276	0	43	43	1.0000000
NODE_214883_length_276_cov_2.542373	164	204	5	8	40	0.2000000
NODE_214883_length_276_cov_2.542373	164	204	6	11	40	0.2750000
NODE_214883_length_276_cov_2.542373	164	204	7	21	40	0.5250000
NODE_215016_length_276_cov_2.197740	64	144	2	26	80	0.3250000
NODE_215016_length_276_cov_2.197740	64	144	3	54	80	0.6750000
NODE_215086_length_276_cov_2.022599	136	193	0	57	57	1.0000000
NODE_215105_length_276_cov_2.016949	97	138	0	41	41	1.0000000
NODE_215139_length_276_cov_2.005650	82	153	0	7	71	0.0985916
NODE_215139_length_276_cov_2.005650	82	153	1	64	71	0.9014084
NODE_215234_length_276_cov_1.734463	102	182	3	3	80	0.0375000
NODE_215234_length_276_cov_1.734463	102	182	5	6	80	0.0750000
NODE_215234_length_276_cov_1.734463	102	182	6	7	80	0.0875000
NODE_215234_length_276_cov_1.734463	102	182	8	3	80	0.0375000
NODE_215234_length_276_cov_1.734463	102	182	9	8	80	0.1000000
NODE_215234_length_276_cov_1.734463	102	182	10	1	80	0.0125000
NODE_215234_length_276_cov_1.734463	102	182	12	5	80	0.0625000
NODE_215234_length_276_cov_1.734463	102	182	14	2	80	0.0250000
NODE_215234_length_276_cov_1.734463	102	182	16	4	80	0.0500000
NODE_215234_length_276_cov_1.734463	102	182	19	16	80	0.2000000
NODE_215234_length_276_cov_1.734463	102	182	20	13	80	0.1625000
NODE_215234_length_276_cov_1.734463	102	182	21	12	80	0.1500000
NODE_215516_length_276_cov_1.525424	70	116	0	46	46	1.0000000
NODE_215516_length_276_cov_1.525424	123	169	0	46	46	1.0000000
NODE_215519_length_276_cov_1.514124	115	155	6	40	40	1.0000000
NODE_215748_length_276_cov_1.288136	114	154	3	32	40	0.8000000
NODE_215748_length_276_cov_1.288136	114	154	4	8	40	0.2000000
NODE_216141_length_276_cov_1.124294	122	170	2	48	48	1.0000000
NODE_216141_length_276_cov_1.124294	132	163	2	31	31	1.0000000
NODE_216220_length_276_cov_1.039548	7	68	0	10	61	0.1639344
NODE_216220_length_276_cov_1.039548	7	68	1	24	61	0.3934426
NODE_216220_length_276_cov_1.039548	7	68	2	27	61	0.4426230
NODE_216220_length_276_cov_1.039548	7	70	0	10	63	0.1587302
NODE_216220_length_276_cov_1.039548	7	70	1	24	63	0.3809524
NODE_216220_length_276_cov_1.039548	7	70	2	29	63	0.4603175
NODE_216220_length_276_cov_1.039548	7	70	0	10	63	0.1587302
NODE_216220_length_276_cov_1.039548	7	70	1	24	63	0.3809524
NODE_216220_length_276_cov_1.039548	7	70	2	29	63	0.4603175
NODE_216220_length_276_cov_1.039548	7	70	0	10	63	0.1587302
NODE_216220_length_276_cov_1.039548	7	70	1	24	63	0.3809524
NODE_216220_length_276_cov_1.039548	7	70	2	29	63	0.4603175
NODE_216269_length_276_cov_1.000000	48	89	3	19	41	0.4634146
NODE_216269_length_276_cov_1.000000	48	89	5	22	41	0.5365854
NODE_216269_length_276_cov_1.000000	62	106	2	17	44	0.3863636
NODE_216269_length_276_cov_1.000000	62	106	3	19	44	0.4318182
NODE_216269_length_276_cov_1.000000	62	106	5	8	44	0.1818182
NODE_216414_length_276_cov_0.898305	54	105	1	51	51	1.0000000
NODE_217265_length_275_cov_85.085227	94	174	1	80	80	1.0000000
NODE_217265_length_275_cov_85.085227	147	227	0	2	80	0.0250000
NODE_217265_length_275_cov_85.085227	147	227	1	78	80	0.9750000
NODE_217287_length_275_cov_5.818182	0	44	1	44	44	1.0000000
NODE_217355_length_275_cov_3.857955	0	67	0	23	67	0.3432836
NODE_217355_length_275_cov_3.857955	0	67	1	44	67	0.6567164
NODE_217396_length_275_cov_3.306818	199	275	0	76	76	1.0000000
NODE_217402_length_275_cov_3.284091	127	175	0	48	48	1.0000000
NODE_217433_length_275_cov_2.977273	95	145	2	50	50	1.0000000
NODE_217531_length_275_cov_2.585227	85	122	15	37	37	1.0000000
NODE_217714_length_275_cov_2.090909	0	47	0	47	47	1.0000000
NODE_217714_length_275_cov_2.090909	20	91	0	71	71	1.0000000
NODE_217801_length_275_cov_1.960227	198	251	1	53	53	1.0000000
NODE_217835_length_275_cov_1.875000	190	247	0	57	57	1.0000000
NODE_217839_length_275_cov_1.857955	52	119	0	60	67	0.8955224
NODE_217839_length_275_cov_1.857955	52	119	1	7	67	0.1044776
NODE_217839_length_275_cov_1.857955	136	182	1	46	46	1.0000000
NODE_217885_length_275_cov_1.755682	21	76	2	15	55	0.2727273
NODE_217885_length_275_cov_1.755682	21	76	6	26	55	0.4727273
NODE_217885_length_275_cov_1.755682	21	76	7	14	55	0.2545455
NODE_217912_length_275_cov_1.738636	225	256	0	31	31	1.0000000
NODE_217967_length_275_cov_1.738636	161	241	0	80	80	1.0000000
NODE_218257_length_275_cov_1.448864	123	155	10	14	32	0.4375000
NODE_218257_length_275_cov_1.448864	123	155	12	18	32	0.5625000
NODE_218402_length_275_cov_1.301136	132	196	5	33	64	0.5156250
NODE_218402_length_275_cov_1.301136	132	196	6	25	64	0.3906250
NODE_218402_length_275_cov_1.301136	132	196	7	6	64	0.0937500
NODE_218706_length_275_cov_1.159091	13	93	0	3	80	0.0375000
NODE_218706_length_275_cov_1.159091	13	93	2	19	80	0.2375000
NODE_218706_length_275_cov_1.159091	13	93	4	58	80	0.7250000
NODE_218734_length_275_cov_1.153409	11	91	0	80	80	1.0000000
NODE_219031_length_275_cov_0.937500	13	49	11	2	36	0.0555556
NODE_219031_length_275_cov_0.937500	13	49	15	1	36	0.0277778
NODE_219031_length_275_cov_0.937500	13	49	16	3	36	0.0833333
NODE_219031_length_275_cov_0.937500	13	49	18	4	36	0.1111111
NODE_219031_length_275_cov_0.937500	13	49	22	2	36	0.0555556
NODE_219031_length_275_cov_0.937500	13	49	23	3	36	0.0833333
NODE_219031_length_275_cov_0.937500	13	49	24	1	36	0.0277778
NODE_219031_length_275_cov_0.937500	13	49	25	2	36	0.0555556
NODE_219031_length_275_cov_0.937500	13	49	27	1	36	0.0277778
NODE_219031_length_275_cov_0.937500	13	49	29	1	36	0.0277778
NODE_219031_length_275_cov_0.937500	13	49	30	3	36	0.0833333
NODE_219031_length_275_cov_0.937500	13	49	31	1	36	0.0277778
NODE_219031_length_275_cov_0.937500	13	49	34	1	36	0.0277778
NODE_219031_length_275_cov_0.937500	13	49	36	2	36	0.0555556
NODE_219031_length_275_cov_0.937500	13	49	38	2	36	0.0555556
NODE_219031_length_275_cov_0.937500	13	49	41	2	36	0.0555556
NODE_219031_length_275_cov_0.937500	13	49	42	1	36	0.0277778
NODE_219031_length_275_cov_0.937500	13	49	45	4	36	0.1111111
NODE_219031_length_275_cov_0.937500	22	86	18	1	64	0.0156250
NODE_219031_length_275_cov_0.937500	22	86	22	2	64	0.0312500
NODE_219031_length_275_cov_0.937500	22	86	23	3	64	0.0468750
NODE_219031_length_275_cov_0.937500	22	86	24	1	64	0.0156250
NODE_219031_length_275_cov_0.937500	22	86	25	2	64	0.0312500
NODE_219031_length_275_cov_0.937500	22	86	27	1	64	0.0156250
NODE_219031_length_275_cov_0.937500	22	86	29	1	64	0.0156250
NODE_219031_length_275_cov_0.937500	22	86	30	3	64	0.0468750
NODE_219031_length_275_cov_0.937500	22	86	31	1	64	0.0156250
NODE_219031_length_275_cov_0.937500	22	86	34	1	64	0.0156250
NODE_219031_length_275_cov_0.937500	22	86	36	2	64	0.0312500
NODE_219031_length_275_cov_0.937500	22	86	38	2	64	0.0312500
NODE_219031_length_275_cov_0.937500	22	86	41	2	64	0.0312500
NODE_219031_length_275_cov_0.937500	22	86	42	1	64	0.0156250
NODE_219031_length_275_cov_0.937500	22	86	45	6	64	0.0937500
NODE_219031_length_275_cov_0.937500	22	86	47	1	64	0.0156250
NODE_219031_length_275_cov_0.937500	22	86	51	1	64	0.0156250
NODE_219031_length_275_cov_0.937500	22	86	55	1	64	0.0156250
NODE_219031_length_275_cov_0.937500	22	86	57	3	64	0.0468750
NODE_219031_length_275_cov_0.937500	22	86	58	1	64	0.0156250
NODE_219031_length_275_cov_0.937500	22	86	59	1	64	0.0156250
NODE_219031_length_275_cov_0.937500	22	86	60	1	64	0.0156250
NODE_219031_length_275_cov_0.937500	22	86	61	4	64	0.0625000
NODE_219031_length_275_cov_0.937500	22	86	66	5	64	0.0781250
NODE_219031_length_275_cov_0.937500	22	86	67	1	64	0.0156250
NODE_219031_length_275_cov_0.937500	22	86	68	3	64	0.0468750
NODE_219031_length_275_cov_0.937500	22	86	69	1	64	0.0156250
NODE_219031_length_275_cov_0.937500	22	86	70	2	64	0.0312500
NODE_219031_length_275_cov_0.937500	22	86	71	1	64	0.0156250
NODE_219031_length_275_cov_0.937500	22	86	75	1	64	0.0156250
NODE_219031_length_275_cov_0.937500	22	86	76	1	64	0.0156250
NODE_219031_length_275_cov_0.937500	22	86	77	1	64	0.0156250
NODE_219031_length_275_cov_0.937500	22	86	80	1	64	0.0156250
NODE_219031_length_275_cov_0.937500	22	86	81	1	64	0.0156250
NODE_219031_length_275_cov_0.937500	22	86	84	1	64	0.0156250
NODE_219031_length_275_cov_0.937500	22	86	85	1	64	0.0156250
NODE_219031_length_275_cov_0.937500	22	86	89	1	64	0.0156250
NODE_219031_length_275_cov_0.937500	22	86	90	1	64	0.0156250
NODE_219220_length_275_cov_0.869318	67	126	0	59	59	1.0000000
NODE_219655_length_275_cov_0.579545	40	70	1	30	30	1.0000000
NODE_220021_length_274_cov_6.074286	141	175	0	34	34	1.0000000
NODE_220047_length_274_cov_4.845714	48	105	0	2	57	0.0350877
NODE_220047_length_274_cov_4.845714	48	105	1	55	57	0.9649123
NODE_220047_length_274_cov_4.845714	113	175	0	22	62	0.3548387
NODE_220047_length_274_cov_4.845714	113	175	1	30	62	0.4838710
NODE_220047_length_274_cov_4.845714	113	175	2	10	62	0.1612903
NODE_220078_length_274_cov_4.080000	210	274	0	16	64	0.2500000
NODE_220078_length_274_cov_4.080000	210	274	1	2	64	0.0312500
NODE_220078_length_274_cov_4.080000	210	274	2	46	64	0.7187500
NODE_220215_length_274_cov_2.988571	104	161	0	57	57	1.0000000
NODE_220221_length_274_cov_2.937143	199	234	1	35	35	1.0000000
NODE_220293_length_274_cov_2.622857	29	76	2	47	47	1.0000000
NODE_220293_length_274_cov_2.622857	82	157	0	75	75	1.0000000
NODE_220413_length_274_cov_2.308571	51	130	12	1	79	0.0126582
NODE_220413_length_274_cov_2.308571	51	130	13	17	79	0.2151899
NODE_220413_length_274_cov_2.308571	51	130	15	2	79	0.0253165
NODE_220413_length_274_cov_2.308571	51	130	19	4	79	0.0506329
NODE_220413_length_274_cov_2.308571	51	130	21	5	79	0.0632911
NODE_220413_length_274_cov_2.308571	51	130	22	3	79	0.0379747
NODE_220413_length_274_cov_2.308571	51	130	24	1	79	0.0126582
NODE_220413_length_274_cov_2.308571	51	130	29	2	79	0.0253165
NODE_220413_length_274_cov_2.308571	51	130	30	5	79	0.0632911
NODE_220413_length_274_cov_2.308571	51	130	31	8	79	0.1012658
NODE_220413_length_274_cov_2.308571	51	130	32	2	79	0.0253165
NODE_220413_length_274_cov_2.308571	51	130	33	1	79	0.0126582
NODE_220413_length_274_cov_2.308571	51	130	35	4	79	0.0506329
NODE_220413_length_274_cov_2.308571	51	130	37	2	79	0.0253165
NODE_220413_length_274_cov_2.308571	51	130	38	1	79	0.0126582
NODE_220413_length_274_cov_2.308571	51	130	39	2	79	0.0253165
NODE_220413_length_274_cov_2.308571	51	130	40	5	79	0.0632911
NODE_220413_length_274_cov_2.308571	51	130	41	1	79	0.0126582
NODE_220413_length_274_cov_2.308571	51	130	42	1	79	0.0126582
NODE_220413_length_274_cov_2.308571	51	130	44	3	79	0.0379747
NODE_220413_length_274_cov_2.308571	51	130	45	4	79	0.0506329
NODE_220413_length_274_cov_2.308571	51	130	47	5	79	0.0632911
NODE_220504_length_274_cov_2.062857	172	242	0	70	70	1.0000000
NODE_220504_length_274_cov_2.062857	215	256	0	41	41	1.0000000
NODE_220662_length_274_cov_1.754286	219	259	0	40	40	1.0000000
NODE_220681_length_274_cov_1.748571	168	231	2	16	63	0.2539683
NODE_220681_length_274_cov_1.748571	168	231	4	47	63	0.7460318
NODE_220806_length_274_cov_1.737143	134	172	0	15	38	0.3947369
NODE_220806_length_274_cov_1.737143	134	172	2	23	38	0.6052632
NODE_220847_length_274_cov_1.685714	132	189	0	57	57	1.0000000
NODE_220847_length_274_cov_1.685714	141	199	0	58	58	1.0000000
NODE_220966_length_274_cov_1.502857	170	232	0	62	62	1.0000000
NODE_220966_length_274_cov_1.502857	223	274	0	51	51	1.0000000
NODE_221005_length_274_cov_1.457143	118	147	0	29	29	1.0000000
NODE_221101_length_274_cov_1.434286	25	69	2	44	44	1.0000000
NODE_221211_length_274_cov_1.285714	84	156	1	72	72	1.0000000
NODE_221612_length_274_cov_1.131429	205	251	0	46	46	1.0000000
NODE_221764_length_274_cov_0.994286	219	260	0	41	41	1.0000000
NODE_222849_length_273_cov_4.948276	204	262	1	4	58	0.0689655
NODE_222849_length_273_cov_4.948276	204	262	2	35	58	0.6034483
NODE_222849_length_273_cov_4.948276	204	262	3	19	58	0.3275862
NODE_222849_length_273_cov_4.948276	204	258	2	35	54	0.6481481
NODE_222849_length_273_cov_4.948276	204	258	3	19	54	0.3518519
NODE_222914_length_273_cov_3.712644	103	183	2	1	80	0.0125000
NODE_222914_length_273_cov_3.712644	103	183	5	1	80	0.0125000
NODE_222914_length_273_cov_3.712644	103	183	7	8	80	0.1000000
NODE_222914_length_273_cov_3.712644	103	183	9	3	80	0.0375000
NODE_222914_length_273_cov_3.712644	103	183	13	19	80	0.2375000
NODE_222914_length_273_cov_3.712644	103	183	15	4	80	0.0500000
NODE_222914_length_273_cov_3.712644	103	183	17	44	80	0.5500000
NODE_222955_length_273_cov_3.298851	69	100	0	27	31	0.8709677
NODE_222955_length_273_cov_3.298851	69	100	2	4	31	0.1290323
NODE_222955_length_273_cov_3.298851	73	153	0	23	80	0.2875000
NODE_222955_length_273_cov_3.298851	73	153	2	57	80	0.7125000
NODE_222974_length_273_cov_3.195402	122	189	0	67	67	1.0000000
NODE_222991_length_273_cov_3.063218	76	151	24	1	75	0.0133333
NODE_222991_length_273_cov_3.063218	76	151	25	1	75	0.0133333
NODE_222991_length_273_cov_3.063218	76	151	26	3	75	0.0400000
NODE_222991_length_273_cov_3.063218	76	151	27	5	75	0.0666667
NODE_222991_length_273_cov_3.063218	76	151	28	1	75	0.0133333
NODE_222991_length_273_cov_3.063218	76	151	30	30	75	0.4000000
NODE_222991_length_273_cov_3.063218	76	151	31	2	75	0.0266667
NODE_222991_length_273_cov_3.063218	76	151	32	31	75	0.4133333
NODE_222991_length_273_cov_3.063218	76	151	33	1	75	0.0133333
NODE_222991_length_273_cov_3.063218	135	191	14	10	56	0.1785714
NODE_222991_length_273_cov_3.063218	135	191	15	6	56	0.1071429
NODE_222991_length_273_cov_3.063218	135	191	17	1	56	0.0178571
NODE_222991_length_273_cov_3.063218	135	191	18	3	56	0.0535714
NODE_222991_length_273_cov_3.063218	135	191	19	4	56	0.0714286
NODE_222991_length_273_cov_3.063218	135	191	20	2	56	0.0357143
NODE_222991_length_273_cov_3.063218	135	191	21	3	56	0.0535714
NODE_222991_length_273_cov_3.063218	135	191	22	5	56	0.0892857
NODE_222991_length_273_cov_3.063218	135	191	23	3	56	0.0535714
NODE_222991_length_273_cov_3.063218	135	191	24	4	56	0.0714286
NODE_222991_length_273_cov_3.063218	135	191	25	1	56	0.0178571
NODE_222991_length_273_cov_3.063218	135	191	26	3	56	0.0535714
NODE_222991_length_273_cov_3.063218	135	191	27	5	56	0.0892857
NODE_222991_length_273_cov_3.063218	135	191	28	1	56	0.0178571
NODE_222991_length_273_cov_3.063218	135	191	30	5	56	0.0892857
NODE_223066_length_273_cov_2.706897	11	45	0	34	34	1.0000000
NODE_223203_length_273_cov_2.339080	69	145	13	2	76	0.0263158
NODE_223203_length_273_cov_2.339080	69	145	14	38	76	0.5000000
NODE_223203_length_273_cov_2.339080	69	145	16	1	76	0.0131579
NODE_223203_length_273_cov_2.339080	69	145	18	35	76	0.4605263
NODE_223353_length_273_cov_2.051724	31	74	0	11	43	0.2558140
NODE_223353_length_273_cov_2.051724	31	74	1	26	43	0.6046512
NODE_223353_length_273_cov_2.051724	31	74	2	6	43	0.1395349
NODE_223377_length_273_cov_2.034483	81	161	1	3	80	0.0375000
NODE_223377_length_273_cov_2.034483	81	161	3	3	80	0.0375000
NODE_223377_length_273_cov_2.034483	81	161	5	7	80	0.0875000
NODE_223377_length_273_cov_2.034483	81	161	6	15	80	0.1875000
NODE_223377_length_273_cov_2.034483	81	161	7	34	80	0.4250000
NODE_223377_length_273_cov_2.034483	81	161	8	18	80	0.2250000
NODE_223377_length_273_cov_2.034483	213	263	3	12	50	0.2400000
NODE_223377_length_273_cov_2.034483	213	263	4	9	50	0.1800000
NODE_223377_length_273_cov_2.034483	213	263	5	7	50	0.1400000
NODE_223377_length_273_cov_2.034483	213	263	7	22	50	0.4400000
NODE_223680_length_273_cov_1.706897	181	238	2	21	57	0.3684210
NODE_223680_length_273_cov_1.706897	181	238	3	16	57	0.2807018
NODE_223680_length_273_cov_1.706897	181	238	4	20	57	0.3508772
NODE_223913_length_273_cov_1.442529	5	47	2	42	42	1.0000000
NODE_224023_length_273_cov_1.281609	167	247	0	80	80	1.0000000
NODE_224082_length_273_cov_1.189655	120	156	0	36	36	1.0000000
NODE_224082_length_273_cov_1.189655	129	160	0	31	31	1.0000000
NODE_224165_length_273_cov_1.172414	94	130	1	4	36	0.1111111
NODE_224165_length_273_cov_1.172414	94	130	2	32	36	0.8888889
NODE_224254_length_273_cov_1.172414	8	58	0	50	50	1.0000000
NODE_224367_length_273_cov_1.166667	74	93	0	19	19	1.0000000
NODE_224441_length_273_cov_1.091954	6	42	2	36	36	1.0000000
NODE_224441_length_273_cov_1.091954	43	95	0	6	52	0.1153846
NODE_224441_length_273_cov_1.091954	43	95	2	46	52	0.8846154
NODE_224587_length_273_cov_0.971264	188	235	0	36	47	0.7659575
NODE_224587_length_273_cov_0.971264	188	235	1	11	47	0.2340426
NODE_225303_length_273_cov_0.586207	27	88	0	61	61	1.0000000
NODE_225344_length_273_cov_0.586207	24	79	1	48	55	0.8727273
NODE_225344_length_273_cov_0.586207	24	79	3	7	55	0.1272727
NODE_225344_length_273_cov_0.586207	81	113	3	5	32	0.1562500
NODE_225344_length_273_cov_0.586207	81	113	5	6	32	0.1875000
NODE_225344_length_273_cov_0.586207	81	113	6	21	32	0.6562500
NODE_225592_length_272_cov_6.190751	172	236	0	64	64	1.0000000
NODE_225607_length_272_cov_5.335260	193	272	0	57	79	0.7215190
NODE_225607_length_272_cov_5.335260	193	272	1	22	79	0.2784810
NODE_225633_length_272_cov_4.716763	228	257	1	29	29	1.0000000
NODE_225656_length_272_cov_4.219653	93	166	0	73	73	1.0000000
NODE_225656_length_272_cov_4.219653	146	219	0	73	73	1.0000000
NODE_225658_length_272_cov_4.184971	75	128	1	48	53	0.9056604
NODE_225658_length_272_cov_4.184971	75	128	2	5	53	0.0943396
NODE_225739_length_272_cov_3.352601	154	199	0	45	45	1.0000000
NODE_225872_length_272_cov_2.664740	106	186	0	38	80	0.4750000
NODE_225872_length_272_cov_2.664740	106	186	1	42	80	0.5250000
NODE_226010_length_272_cov_2.335260	33	103	0	63	70	0.9000000
NODE_226010_length_272_cov_2.335260	33	103	1	7	70	0.1000000
NODE_226029_length_272_cov_2.277457	219	256	0	37	37	1.0000000
NODE_226045_length_272_cov_2.236994	104	184	2	80	80	1.0000000
NODE_226169_length_272_cov_1.982659	172	252	0	75	80	0.9375000
NODE_226169_length_272_cov_1.982659	172	252	2	5	80	0.0625000
NODE_226245_length_272_cov_1.780347	37	99	2	62	62	1.0000000
NODE_226245_length_272_cov_1.780347	90	152	0	21	62	0.3387097
NODE_226245_length_272_cov_1.780347	90	152	2	41	62	0.6612903
NODE_226248_length_272_cov_1.768786	12	45	0	33	33	1.0000000
NODE_226461_length_272_cov_1.618497	97	160	4	7	63	0.1111111
NODE_226461_length_272_cov_1.618497	97	160	5	1	63	0.0158730
NODE_226461_length_272_cov_1.618497	97	160	7	1	63	0.0158730
NODE_226461_length_272_cov_1.618497	97	160	8	1	63	0.0158730
NODE_226461_length_272_cov_1.618497	97	160	11	3	63	0.0476190
NODE_226461_length_272_cov_1.618497	97	160	12	2	63	0.0317460
NODE_226461_length_272_cov_1.618497	97	160	14	1	63	0.0158730
NODE_226461_length_272_cov_1.618497	97	160	15	7	63	0.1111111
NODE_226461_length_272_cov_1.618497	97	160	17	2	63	0.0317460
NODE_226461_length_272_cov_1.618497	97	160	18	1	63	0.0158730
NODE_226461_length_272_cov_1.618497	97	160	19	6	63	0.0952381
NODE_226461_length_272_cov_1.618497	97	160	20	6	63	0.0952381
NODE_226461_length_272_cov_1.618497	97	160	21	4	63	0.0634921
NODE_226461_length_272_cov_1.618497	97	160	23	10	63	0.1587302
NODE_226461_length_272_cov_1.618497	97	160	25	11	63	0.1746032
NODE_226508_length_272_cov_1.543353	69	137	0	62	68	0.9117647
NODE_226508_length_272_cov_1.543353	69	137	1	6	68	0.0882353
NODE_227037_length_272_cov_1.173410	147	203	2	17	56	0.3035714
NODE_227037_length_272_cov_1.173410	147	203	3	39	56	0.6964286
NODE_227265_length_272_cov_0.988439	169	215	0	46	46	1.0000000
NODE_227444_length_272_cov_0.884393	126	163	0	37	37	1.0000000
NODE_228332_length_271_cov_5.238372	103	183	0	30	80	0.3750000
NODE_228332_length_271_cov_5.238372	103	183	1	50	80	0.6250000
NODE_228423_length_271_cov_3.546512	102	165	0	63	63	1.0000000
NODE_228429_length_271_cov_3.476744	62	93	0	31	31	1.0000000
NODE_228494_length_271_cov_2.959302	96	176	2	64	80	0.8000000
NODE_228494_length_271_cov_2.959302	96	176	4	2	80	0.0250000
NODE_228494_length_271_cov_2.959302	96	176	6	14	80	0.1750000
NODE_228494_length_271_cov_2.959302	149	229	2	11	80	0.1375000
NODE_228494_length_271_cov_2.959302	149	229	4	11	80	0.1375000
NODE_228494_length_271_cov_2.959302	149	229	5	32	80	0.4000000
NODE_228494_length_271_cov_2.959302	149	229	6	26	80	0.3250000
NODE_228554_length_271_cov_2.715116	160	241	0	81	81	1.0000000
NODE_228593_length_271_cov_2.622093	180	253	0	73	73	1.0000000
NODE_228623_length_271_cov_2.465116	45	75	2	30	30	1.0000000
NODE_228731_length_271_cov_2.284884	95	158	2	40	63	0.6349207
NODE_228731_length_271_cov_2.284884	95	158	4	23	63	0.3650794
NODE_228731_length_271_cov_2.284884	131	211	0	12	80	0.1500000
NODE_228731_length_271_cov_2.284884	131	211	2	68	80	0.8500000
NODE_228737_length_271_cov_2.273256	163	219	3	4	56	0.0714286
NODE_228737_length_271_cov_2.273256	163	219	4	52	56	0.9285714
NODE_228830_length_271_cov_2.069767	130	212	0	82	82	1.0000000
NODE_228932_length_271_cov_1.784884	135	183	0	48	48	1.0000000
NODE_228937_length_271_cov_1.779070	204	268	0	64	64	1.0000000
NODE_229085_length_271_cov_1.755814	119	199	0	80	80	1.0000000
NODE_229242_length_271_cov_1.523256	122	183	0	25	61	0.4098361
NODE_229242_length_271_cov_1.523256	122	183	2	36	61	0.5901639
NODE_229254_length_271_cov_1.511628	106	186	40	2	80	0.0250000
NODE_229254_length_271_cov_1.511628	106	186	42	2	80	0.0250000
NODE_229254_length_271_cov_1.511628	106	186	44	6	80	0.0750000
NODE_229254_length_271_cov_1.511628	106	186	45	2	80	0.0250000
NODE_229254_length_271_cov_1.511628	106	186	46	3	80	0.0375000
NODE_229254_length_271_cov_1.511628	106	186	47	1	80	0.0125000
NODE_229254_length_271_cov_1.511628	106	186	49	3	80	0.0375000
NODE_229254_length_271_cov_1.511628	106	186	51	2	80	0.0250000
NODE_229254_length_271_cov_1.511628	106	186	52	2	80	0.0250000
NODE_229254_length_271_cov_1.511628	106	186	54	4	80	0.0500000
NODE_229254_length_271_cov_1.511628	106	186	55	2	80	0.0250000
NODE_229254_length_271_cov_1.511628	106	186	59	2	80	0.0250000
NODE_229254_length_271_cov_1.511628	106	186	61	4	80	0.0500000
NODE_229254_length_271_cov_1.511628	106	186	62	1	80	0.0125000
NODE_229254_length_271_cov_1.511628	106	186	66	1	80	0.0125000
NODE_229254_length_271_cov_1.511628	106	186	68	7	80	0.0875000
NODE_229254_length_271_cov_1.511628	106	186	70	4	80	0.0500000
NODE_229254_length_271_cov_1.511628	106	186	71	10	80	0.1250000
NODE_229254_length_271_cov_1.511628	106	186	72	6	80	0.0750000
NODE_229254_length_271_cov_1.511628	106	186	73	10	80	0.1250000
NODE_229254_length_271_cov_1.511628	106	186	74	4	80	0.0500000
NODE_229254_length_271_cov_1.511628	106	186	75	1	80	0.0125000
NODE_229254_length_271_cov_1.511628	106	186	76	1	80	0.0125000
NODE_229525_length_271_cov_1.226744	119	184	0	65	65	1.0000000
NODE_229541_length_271_cov_1.197674	88	145	0	57	57	1.0000000
NODE_229541_length_271_cov_1.197674	118	192	0	74	74	1.0000000
NODE_230154_length_271_cov_0.918605	155	227	0	72	72	1.0000000
NODE_230255_length_271_cov_0.889535	101	148	0	46	47	0.9787234
NODE_230255_length_271_cov_0.889535	101	148	1	1	47	0.0212766
NODE_230318_length_271_cov_0.889535	127	188	0	61	61	1.0000000
NODE_231165_length_270_cov_4.818713	72	118	0	36	46	0.7826087
NODE_231165_length_270_cov_4.818713	72	118	2	10	46	0.2173913
NODE_231187_length_270_cov_4.327485	5	82	0	38	77	0.4935065
NODE_231187_length_270_cov_4.327485	5	82	2	39	77	0.5064935
NODE_231240_length_270_cov_3.666667	87	154	1	67	67	1.0000000
NODE_231240_length_270_cov_3.666667	140	207	0	17	67	0.2537313
NODE_231240_length_270_cov_3.666667	140	207	1	50	67	0.7462686
NODE_231263_length_270_cov_3.491228	186	270	0	31	84	0.3690476
NODE_231263_length_270_cov_3.491228	186	270	1	39	84	0.4642857
NODE_231263_length_270_cov_3.491228	186	270	3	14	84	0.1666667
NODE_231310_length_270_cov_3.105263	43	90	2	47	47	1.0000000
NODE_231316_length_270_cov_3.046784	64	135	0	71	71	1.0000000
NODE_231439_length_270_cov_2.649123	210	270	0	14	60	0.2333333
NODE_231439_length_270_cov_2.649123	210	270	1	46	60	0.7666667
NODE_231655_length_270_cov_2.087719	16	55	0	8	39	0.2051282
NODE_231655_length_270_cov_2.087719	16	55	2	31	39	0.7948718
NODE_231655_length_270_cov_2.087719	78	108	0	30	30	1.0000000
NODE_231714_length_270_cov_2.040936	103	159	0	1	56	0.0178571
NODE_231714_length_270_cov_2.040936	103	159	3	1	56	0.0178571
NODE_231714_length_270_cov_2.040936	103	159	5	1	56	0.0178571
NODE_231714_length_270_cov_2.040936	103	159	7	3	56	0.0535714
NODE_231714_length_270_cov_2.040936	103	159	8	6	56	0.1071429
NODE_231714_length_270_cov_2.040936	103	159	10	3	56	0.0535714
NODE_231714_length_270_cov_2.040936	103	159	12	4	56	0.0714286
NODE_231714_length_270_cov_2.040936	103	159	13	4	56	0.0714286
NODE_231714_length_270_cov_2.040936	103	159	15	1	56	0.0178571
NODE_231714_length_270_cov_2.040936	103	159	17	9	56	0.1607143
NODE_231714_length_270_cov_2.040936	103	159	19	19	56	0.3392857
NODE_231714_length_270_cov_2.040936	103	159	21	4	56	0.0714286
NODE_231726_length_270_cov_2.017544	1	48	0	47	47	1.0000000
NODE_231820_length_270_cov_1.789474	146	228	1	82	82	1.0000000
NODE_232008_length_270_cov_1.678363	178	246	0	68	68	1.0000000
NODE_232021_length_270_cov_1.666667	127	191	31	6	64	0.0937500
NODE_232021_length_270_cov_1.666667	127	191	32	2	64	0.0312500
NODE_232021_length_270_cov_1.666667	127	191	34	10	64	0.1562500
NODE_232021_length_270_cov_1.666667	127	191	36	1	64	0.0156250
NODE_232021_length_270_cov_1.666667	127	191	38	3	64	0.0468750
NODE_232021_length_270_cov_1.666667	127	191	39	7	64	0.1093750
NODE_232021_length_270_cov_1.666667	127	191	43	7	64	0.1093750
NODE_232021_length_270_cov_1.666667	127	191	44	1	64	0.0156250
NODE_232021_length_270_cov_1.666667	127	191	45	5	64	0.0781250
NODE_232021_length_270_cov_1.666667	127	191	47	3	64	0.0468750
NODE_232021_length_270_cov_1.666667	127	191	49	11	64	0.1718750
NODE_232021_length_270_cov_1.666667	127	191	50	8	64	0.1250000
NODE_232021_length_270_cov_1.666667	180	227	16	1	47	0.0212766
NODE_232021_length_270_cov_1.666667	180	227	17	1	47	0.0212766
NODE_232021_length_270_cov_1.666667	180	227	18	3	47	0.0638298
NODE_232021_length_270_cov_1.666667	180	227	20	3	47	0.0638298
NODE_232021_length_270_cov_1.666667	180	227	22	4	47	0.0851064
NODE_232021_length_270_cov_1.666667	180	227	26	1	47	0.0212766
NODE_232021_length_270_cov_1.666667	180	227	27	2	47	0.0425532
NODE_232021_length_270_cov_1.666667	180	227	28	2	47	0.0425532
NODE_232021_length_270_cov_1.666667	180	227	29	3	47	0.0638298
NODE_232021_length_270_cov_1.666667	180	227	30	12	47	0.2553191
NODE_232021_length_270_cov_1.666667	180	227	31	10	47	0.2127660
NODE_232021_length_270_cov_1.666667	180	227	32	2	47	0.0425532
NODE_232021_length_270_cov_1.666667	180	227	34	3	47	0.0638298
NODE_232087_length_270_cov_1.555556	138	218	7	61	80	0.7625000
NODE_232087_length_270_cov_1.555556	138	218	8	19	80	0.2375000
NODE_232331_length_270_cov_1.280702	4	75	0	36	71	0.5070422
NODE_232331_length_270_cov_1.280702	4	75	1	35	71	0.4929577
NODE_232331_length_270_cov_1.280702	57	137	1	80	80	1.0000000
NODE_232331_length_270_cov_1.280702	65	120	1	55	55	1.0000000
NODE_232331_length_270_cov_1.280702	125	198	1	73	73	1.0000000
NODE_232440_length_270_cov_1.192982	146	194	0	1	48	0.0208333
NODE_232440_length_270_cov_1.192982	146	194	2	47	48	0.9791667
NODE_232583_length_270_cov_1.192982	61	141	0	80	80	1.0000000
NODE_233290_length_270_cov_0.847953	53	128	0	3	75	0.0400000
NODE_233290_length_270_cov_0.847953	53	128	2	72	75	0.9600000
NODE_234072_length_269_cov_3.894118	30	110	0	80	80	1.0000000
NODE_234072_length_269_cov_3.894118	83	163	0	80	80	1.0000000
NODE_234100_length_269_cov_3.605882	175	205	0	30	30	1.0000000
NODE_234116_length_269_cov_3.523529	192	233	1	41	41	1.0000000
NODE_234116_length_269_cov_3.523529	206	268	0	35	62	0.5645161
NODE_234116_length_269_cov_3.523529	206	268	1	27	62	0.4354839
NODE_234118_length_269_cov_3.505882	13	93	0	80	80	1.0000000
NODE_234118_length_269_cov_3.505882	66	145	0	79	79	1.0000000
NODE_234162_length_269_cov_3.147059	134	174	2	40	40	1.0000000
NODE_234167_length_269_cov_3.111765	39	119	0	80	80	1.0000000
NODE_234167_length_269_cov_3.111765	92	169	0	77	77	1.0000000
NODE_234178_length_269_cov_3.000000	166	233	1	21	67	0.3134328
NODE_234178_length_269_cov_3.000000	166	233	2	10	67	0.1492537
NODE_234178_length_269_cov_3.000000	166	233	4	36	67	0.5373135
NODE_234205_length_269_cov_2.947059	55	123	0	68	68	1.0000000
NODE_234224_length_269_cov_2.858824	9	89	0	80	80	1.0000000
NODE_234224_length_269_cov_2.858824	62	91	0	29	29	1.0000000
NODE_234228_length_269_cov_2.823529	0	73	0	3	73	0.0410959
NODE_234228_length_269_cov_2.823529	0	73	2	11	73	0.1506849
NODE_234228_length_269_cov_2.823529	0	73	3	7	73	0.0958904
NODE_234228_length_269_cov_2.823529	0	73	5	8	73	0.1095890
NODE_234228_length_269_cov_2.823529	0	73	6	24	73	0.3287671
NODE_234228_length_269_cov_2.823529	0	73	8	20	73	0.2739726
NODE_234228_length_269_cov_2.823529	46	77	6	7	31	0.2258064
NODE_234228_length_269_cov_2.823529	46	77	8	24	31	0.7741935
NODE_234431_length_269_cov_2.311765	111	157	0	46	46	1.0000000
NODE_234431_length_269_cov_2.311765	130	209	0	79	79	1.0000000
NODE_234606_length_269_cov_1.958824	176	248	3	24	72	0.3333333
NODE_234606_length_269_cov_1.958824	176	248	4	48	72	0.6666667
NODE_234647_length_269_cov_1.847059	72	99	3	27	27	1.0000000
NODE_234657_length_269_cov_1.823529	30	81	2	41	51	0.8039216
NODE_234657_length_269_cov_1.823529	30	81	4	10	51	0.1960784
NODE_234758_length_269_cov_1.800000	0	42	0	42	42	1.0000000
NODE_234978_length_269_cov_1.552941	90	170	1	33	80	0.4125000
NODE_234978_length_269_cov_1.552941	90	170	2	3	80	0.0375000
NODE_234978_length_269_cov_1.552941	90	170	3	44	80	0.5500000
NODE_235157_length_269_cov_1.400000	139	219	2	29	80	0.3625000
NODE_235157_length_269_cov_1.400000	139	219	4	51	80	0.6375000
NODE_235168_length_269_cov_1.388235	185	252	0	67	67	1.0000000
NODE_235239_length_269_cov_1.288235	150	179	0	2	29	0.0689655
NODE_235239_length_269_cov_1.288235	150	179	2	27	29	0.9310345
NODE_235292_length_269_cov_1.217647	141	221	0	80	80	1.0000000
NODE_235561_length_269_cov_1.194118	107	170	0	63	63	1.0000000
NODE_235561_length_269_cov_1.194118	143	221	0	78	78	1.0000000
NODE_235714_length_269_cov_1.094118	38	72	0	34	34	1.0000000
NODE_235780_length_269_cov_1.035294	6	36	0	30	30	1.0000000
NODE_235780_length_269_cov_1.035294	96	150	0	5	54	0.0925926
NODE_235780_length_269_cov_1.035294	96	150	2	49	54	0.9074074
NODE_235930_length_269_cov_0.917647	4	79	1	75	75	1.0000000
NODE_235930_length_269_cov_0.917647	57	93	1	36	36	1.0000000
NODE_236243_length_269_cov_0.782353	2	52	0	50	50	1.0000000
NODE_236243_length_269_cov_0.782353	76	132	0	56	56	1.0000000
NODE_236856_length_268_cov_223.165680	161	188	5	3	27	0.1111111
NODE_236856_length_268_cov_223.165680	161	188	7	1	27	0.0370370
NODE_236856_length_268_cov_223.165680	161	188	9	23	27	0.8518519
NODE_236856_length_268_cov_223.165680	161	241	5	4	80	0.0500000
NODE_236856_length_268_cov_223.165680	161	241	7	7	80	0.0875000
NODE_236856_length_268_cov_223.165680	161	241	9	69	80	0.8625000
NODE_236878_length_268_cov_6.266272	29	111	0	74	82	0.9024390
NODE_236878_length_268_cov_6.266272	29	111	1	8	82	0.0975610
NODE_236909_length_268_cov_5.053254	137	217	0	80	80	1.0000000
NODE_236909_length_268_cov_5.053254	190	253	0	63	63	1.0000000
NODE_236911_length_268_cov_4.994083	92	168	3	34	76	0.4473684
NODE_236911_length_268_cov_4.994083	92	168	4	42	76	0.5526316
NODE_236972_length_268_cov_3.905325	1	61	2	13	60	0.2166667
NODE_236972_length_268_cov_3.905325	1	61	3	13	60	0.2166667
NODE_236972_length_268_cov_3.905325	1	61	4	34	60	0.5666667
NODE_237107_length_268_cov_2.982249	95	175	11	31	80	0.3875000
NODE_237107_length_268_cov_2.982249	95	175	12	32	80	0.4000000
NODE_237107_length_268_cov_2.982249	95	175	14	6	80	0.0750000
NODE_237107_length_268_cov_2.982249	95	175	16	8	80	0.1000000
NODE_237107_length_268_cov_2.982249	95	175	18	3	80	0.0375000
NODE_237115_length_268_cov_2.940828	28	97	2	69	69	1.0000000
NODE_237185_length_268_cov_2.668639	57	110	1	53	53	1.0000000
NODE_237190_length_268_cov_2.621302	149	176	0	27	27	1.0000000
NODE_237325_length_268_cov_2.289941	87	127	28	19	40	0.4750000
NODE_237325_length_268_cov_2.289941	87	127	30	21	40	0.5250000
NODE_237345_length_268_cov_2.224852	96	176	8	18	80	0.2250000
NODE_237345_length_268_cov_2.224852	96	176	9	62	80	0.7750000
NODE_237345_length_268_cov_2.224852	149	229	0	2	80	0.0250000
NODE_237345_length_268_cov_2.224852	149	229	1	1	80	0.0125000
NODE_237345_length_268_cov_2.224852	149	229	2	1	80	0.0125000
NODE_237345_length_268_cov_2.224852	149	229	3	21	80	0.2625000
NODE_237345_length_268_cov_2.224852	149	229	4	3	80	0.0375000
NODE_237345_length_268_cov_2.224852	149	229	5	2	80	0.0250000
NODE_237345_length_268_cov_2.224852	149	229	6	4	80	0.0500000
NODE_237345_length_268_cov_2.224852	149	229	8	37	80	0.4625000
NODE_237345_length_268_cov_2.224852	149	229	9	9	80	0.1125000
NODE_237457_length_268_cov_2.005917	97	162	3	41	65	0.6307693
NODE_237457_length_268_cov_2.005917	97	162	4	24	65	0.3692308
NODE_237502_length_268_cov_1.840237	80	155	1	12	75	0.1600000
NODE_237502_length_268_cov_1.840237	80	155	3	4	75	0.0533333
NODE_237502_length_268_cov_1.840237	80	155	4	59	75	0.7866667
NODE_237572_length_268_cov_1.810651	8	84	0	76	76	1.0000000
NODE_237831_length_268_cov_1.532544	186	257	3	6	71	0.0845070
NODE_237831_length_268_cov_1.532544	186	257	5	10	71	0.1408451
NODE_237831_length_268_cov_1.532544	186	257	7	22	71	0.3098592
NODE_237831_length_268_cov_1.532544	186	257	8	12	71	0.1690141
NODE_237831_length_268_cov_1.532544	186	257	11	6	71	0.0845070
NODE_237831_length_268_cov_1.532544	186	257	13	15	71	0.2112676
NODE_237906_length_268_cov_1.508876	52	131	2	73	79	0.9240506
NODE_237906_length_268_cov_1.508876	52	131	3	6	79	0.0759494
NODE_238009_length_268_cov_1.384615	0	46	2	36	46	0.7826087
NODE_238009_length_268_cov_1.384615	0	46	3	10	46	0.2173913
NODE_238070_length_268_cov_1.278107	100	175	0	75	75	1.0000000
NODE_238153_length_268_cov_1.207101	187	209	0	22	22	1.0000000
NODE_238478_length_268_cov_1.153846	135	195	0	60	60	1.0000000
NODE_239018_length_268_cov_0.852071	59	119	1	60	60	1.0000000
NODE_239805_length_267_cov_4.297619	0	52	0	1	52	0.0192308
NODE_239805_length_267_cov_4.297619	0	52	3	51	52	0.9807692
NODE_239817_length_267_cov_4.119048	41	87	0	46	46	1.0000000
NODE_239845_length_267_cov_3.785714	96	163	1	17	67	0.2537313
NODE_239845_length_267_cov_3.785714	96	163	3	6	67	0.0895522
NODE_239845_length_267_cov_3.785714	96	163	5	44	67	0.6567164
NODE_239845_length_267_cov_3.785714	136	178	1	32	42	0.7619048
NODE_239845_length_267_cov_3.785714	136	178	3	6	42	0.1428571
NODE_239845_length_267_cov_3.785714	136	178	5	4	42	0.0952381
NODE_239873_length_267_cov_3.535714	40	101	0	30	61	0.4918033
NODE_239873_length_267_cov_3.535714	40	101	2	31	61	0.5081967
NODE_239873_length_267_cov_3.535714	74	154	2	80	80	1.0000000
NODE_239958_length_267_cov_3.005952	216	267	1	3	51	0.0588235
NODE_239958_length_267_cov_3.005952	216	267	2	18	51	0.3529412
NODE_239958_length_267_cov_3.005952	216	267	4	16	51	0.3137255
NODE_239958_length_267_cov_3.005952	216	267	5	14	51	0.2745098
NODE_239959_length_267_cov_3.000000	87	144	1	2	57	0.0350877
NODE_239959_length_267_cov_3.000000	87	144	2	3	57	0.0526316
NODE_239959_length_267_cov_3.000000	87	144	3	6	57	0.1052632
NODE_239959_length_267_cov_3.000000	87	144	4	11	57	0.1929825
NODE_239959_length_267_cov_3.000000	87	144	5	1	57	0.0175439
NODE_239959_length_267_cov_3.000000	87	144	8	34	57	0.5964912
NODE_240007_length_267_cov_2.726190	177	220	5	6	43	0.1395349
NODE_240007_length_267_cov_2.726190	177	220	6	37	43	0.8604651
NODE_240024_length_267_cov_2.690476	117	170	7	19	53	0.3584906
NODE_240024_length_267_cov_2.690476	117	170	8	24	53	0.4528302
NODE_240024_length_267_cov_2.690476	117	170	9	10	53	0.1886792
NODE_240029_length_267_cov_2.666667	198	267	0	69	69	1.0000000
NODE_240114_length_267_cov_2.428571	189	254	0	63	65	0.9692308
NODE_240114_length_267_cov_2.428571	189	254	2	2	65	0.0307692
NODE_240207_length_267_cov_2.208333	45	103	2	58	58	1.0000000
NODE_240246_length_267_cov_2.125000	124	175	0	51	51	1.0000000
NODE_240303_length_267_cov_2.077381	65	146	1	19	81	0.2345679
NODE_240303_length_267_cov_2.077381	65	146	2	33	81	0.4074074
NODE_240303_length_267_cov_2.077381	65	146	4	29	81	0.3580247
NODE_240303_length_267_cov_2.077381	229	264	0	9	35	0.2571429
NODE_240303_length_267_cov_2.077381	229	264	2	21	35	0.6000000
NODE_240303_length_267_cov_2.077381	229	264	3	5	35	0.1428571
NODE_240331_length_267_cov_2.005952	147	228	4	49	81	0.6049383
NODE_240331_length_267_cov_2.005952	147	228	5	16	81	0.1975309
NODE_240331_length_267_cov_2.005952	147	228	7	4	81	0.0493827
NODE_240331_length_267_cov_2.005952	147	228	9	6	81	0.0740741
NODE_240331_length_267_cov_2.005952	147	228	11	4	81	0.0493827
NODE_240331_length_267_cov_2.005952	147	228	13	2	81	0.0246914
NODE_240331_length_267_cov_2.005952	201	267	3	26	66	0.3939394
NODE_240331_length_267_cov_2.005952	201	267	4	40	66	0.6060606
NODE_240336_length_267_cov_1.988095	77	157	0	80	80	1.0000000
NODE_240336_length_267_cov_1.988095	130	210	0	80	80	1.0000000
NODE_240620_length_267_cov_1.755952	119	199	0	80	80	1.0000000
NODE_240624_length_267_cov_1.750000	23	104	7	2	81	0.0246914
NODE_240624_length_267_cov_1.750000	23	104	9	3	81	0.0370370
NODE_240624_length_267_cov_1.750000	23	104	11	5	81	0.0617284
NODE_240624_length_267_cov_1.750000	23	104	13	6	81	0.0740741
NODE_240624_length_267_cov_1.750000	23	104	14	22	81	0.2716049
NODE_240624_length_267_cov_1.750000	23	104	16	43	81	0.5308642
NODE_240624_length_267_cov_1.750000	179	208	1	19	29	0.6551724
NODE_240624_length_267_cov_1.750000	179	208	2	10	29	0.3448276
NODE_240653_length_267_cov_1.690476	18	90	0	72	72	1.0000000
NODE_240790_length_267_cov_1.517857	6	43	0	37	37	1.0000000
NODE_241075_length_267_cov_1.214286	37	91	0	54	54	1.0000000
NODE_241240_length_267_cov_1.214286	89	126	0	37	37	1.0000000
NODE_241352_length_267_cov_1.208333	124	164	0	40	40	1.0000000
NODE_241484_length_267_cov_1.125000	57	103	3	46	46	1.0000000
NODE_241512_length_267_cov_1.089286	119	196	0	77	77	1.0000000
NODE_241512_length_267_cov_1.089286	169	249	0	80	80	1.0000000
NODE_241517_length_267_cov_1.083333	133	152	10	7	19	0.3684210
NODE_241517_length_267_cov_1.083333	133	152	11	12	19	0.6315789
NODE_241517_length_267_cov_1.083333	183	264	1	1	81	0.0123457
NODE_241517_length_267_cov_1.083333	183	264	2	6	81	0.0740741
NODE_241517_length_267_cov_1.083333	183	264	3	15	81	0.1851852
NODE_241517_length_267_cov_1.083333	183	264	4	5	81	0.0617284
NODE_241517_length_267_cov_1.083333	183	264	5	17	81	0.2098765
NODE_241517_length_267_cov_1.083333	183	264	6	8	81	0.0987654
NODE_241517_length_267_cov_1.083333	183	264	7	1	81	0.0123457
NODE_241517_length_267_cov_1.083333	183	264	8	25	81	0.3086420
NODE_241517_length_267_cov_1.083333	183	264	10	3	81	0.0370370
NODE_241588_length_267_cov_1.017857	205	267	0	43	62	0.6935484
NODE_241588_length_267_cov_1.017857	205	267	2	15	62	0.2419355
NODE_241588_length_267_cov_1.017857	205	267	3	4	62	0.0645161
NODE_241633_length_267_cov_0.982143	4	75	0	41	71	0.5774648
NODE_241633_length_267_cov_0.982143	4	75	1	30	71	0.4225352
NODE_242999_length_266_cov_5.706587	120	199	0	79	79	1.0000000
NODE_242999_length_266_cov_5.706587	172	239	0	67	67	1.0000000
NODE_243010_length_266_cov_5.107784	68	150	2	23	82	0.2804878
NODE_243010_length_266_cov_5.107784	68	150	3	4	82	0.0487805
NODE_243010_length_266_cov_5.107784	68	150	4	55	82	0.6707317
NODE_243064_length_266_cov_4.125749	99	168	0	7	69	0.1014493
NODE_243064_length_266_cov_4.125749	99	168	2	62	69	0.8985507
NODE_243079_length_266_cov_3.958084	40	120	0	80	80	1.0000000
NODE_243079_length_266_cov_3.958084	93	159	0	66	66	1.0000000
NODE_243136_length_266_cov_3.419162	68	130	2	60	62	0.9677419
NODE_243136_length_266_cov_3.419162	68	130	3	2	62	0.0322581
NODE_243136_length_266_cov_3.419162	116	183	2	12	67	0.1791045
NODE_243136_length_266_cov_3.419162	116	183	3	55	67	0.8208955
NODE_243168_length_266_cov_3.137725	6	86	0	80	80	1.0000000
NODE_243168_length_266_cov_3.137725	59	120	0	61	61	1.0000000
NODE_243174_length_266_cov_3.107784	166	232	1	33	66	0.5000000
NODE_243174_length_266_cov_3.107784	166	232	3	9	66	0.1363636
NODE_243174_length_266_cov_3.107784	166	232	5	4	66	0.0606061
NODE_243174_length_266_cov_3.107784	166	232	7	1	66	0.0151515
NODE_243174_length_266_cov_3.107784	166	232	8	5	66	0.0757576
NODE_243174_length_266_cov_3.107784	166	232	10	14	66	0.2121212
NODE_243475_length_266_cov_2.179641	110	191	2	8	81	0.0987654
NODE_243475_length_266_cov_2.179641	110	191	4	73	81	0.9012346
NODE_243497_length_266_cov_2.137725	156	236	2	7	80	0.0875000
NODE_243497_length_266_cov_2.137725	156	236	4	10	80	0.1250000
NODE_243497_length_266_cov_2.137725	156	236	5	60	80	0.7500000
NODE_243497_length_266_cov_2.137725	156	236	6	3	80	0.0375000
NODE_243570_length_266_cov_2.023952	47	123	0	76	76	1.0000000
NODE_243972_length_266_cov_1.532934	155	235	0	7	80	0.0875000
NODE_243972_length_266_cov_1.532934	155	235	1	18	80	0.2250000
NODE_243972_length_266_cov_1.532934	155	235	2	17	80	0.2125000
NODE_243972_length_266_cov_1.532934	155	235	4	2	80	0.0250000
NODE_243972_length_266_cov_1.532934	155	235	6	25	80	0.3125000
NODE_243972_length_266_cov_1.532934	155	235	7	11	80	0.1375000
NODE_244681_length_266_cov_1.113772	70	97	0	27	27	1.0000000
NODE_244760_length_266_cov_1.023952	144	201	4	7	57	0.1228070
NODE_244760_length_266_cov_1.023952	144	201	6	50	57	0.8771930
NODE_244760_length_266_cov_1.023952	199	265	0	10	66	0.1515152
NODE_244760_length_266_cov_1.023952	199	265	1	3	66	0.0454545
NODE_244760_length_266_cov_1.023952	199	265	3	16	66	0.2424242
NODE_244760_length_266_cov_1.023952	199	265	4	18	66	0.2727273
NODE_244760_length_266_cov_1.023952	199	265	6	19	66	0.2878788
NODE_245049_length_266_cov_0.916168	51	122	0	42	71	0.5915493
NODE_245049_length_266_cov_0.916168	51	122	1	29	71	0.4084507
NODE_245280_length_266_cov_0.730539	132	158	0	26	26	1.0000000
NODE_245538_length_266_cov_0.610778	99	139	0	40	40	1.0000000
NODE_245538_length_266_cov_0.610778	112	156	0	44	44	1.0000000
NODE_246087_length_265_cov_7.843373	128	208	0	47	80	0.5875000
NODE_246087_length_265_cov_7.843373	128	208	2	33	80	0.4125000
NODE_246192_length_265_cov_4.054217	65	145	0	80	80	1.0000000
NODE_246192_length_265_cov_4.054217	118	198	0	80	80	1.0000000
NODE_246198_length_265_cov_3.993976	195	231	0	36	36	1.0000000
NODE_246284_length_265_cov_3.150602	183	263	0	80	80	1.0000000
NODE_246374_length_265_cov_2.789157	177	238	0	61	61	1.0000000
NODE_246409_length_265_cov_2.734940	167	247	0	80	80	1.0000000
NODE_246432_length_265_cov_2.608434	188	259	0	40	71	0.5633803
NODE_246432_length_265_cov_2.608434	188	259	1	11	71	0.1549296
NODE_246432_length_265_cov_2.608434	188	259	2	20	71	0.2816902
NODE_246606_length_265_cov_2.156627	197	237	8	9	40	0.2250000
NODE_246606_length_265_cov_2.156627	197	237	9	11	40	0.2750000
NODE_246606_length_265_cov_2.156627	197	237	11	20	40	0.5000000
NODE_246624_length_265_cov_2.150602	169	218	0	49	49	1.0000000
NODE_246692_length_265_cov_1.975904	15	44	1	29	29	1.0000000
NODE_246811_length_265_cov_1.843373	195	265	0	70	70	1.0000000
NODE_247028_length_265_cov_1.620482	115	186	1	18	71	0.2535211
NODE_247028_length_265_cov_1.620482	115	186	2	53	71	0.7464789
NODE_247028_length_265_cov_1.620482	117	171	1	4	54	0.0740741
NODE_247028_length_265_cov_1.620482	117	171	2	50	54	0.9259259
NODE_247031_length_265_cov_1.614458	53	113	4	3	60	0.0500000
NODE_247031_length_265_cov_1.614458	53	113	6	3	60	0.0500000
NODE_247031_length_265_cov_1.614458	53	113	7	2	60	0.0333333
NODE_247031_length_265_cov_1.614458	53	113	8	5	60	0.0833333
NODE_247031_length_265_cov_1.614458	53	113	9	12	60	0.2000000
NODE_247031_length_265_cov_1.614458	53	113	10	3	60	0.0500000
NODE_247031_length_265_cov_1.614458	53	113	12	12	60	0.2000000
NODE_247031_length_265_cov_1.614458	53	113	14	18	60	0.3000000
NODE_247031_length_265_cov_1.614458	53	113	15	1	60	0.0166667
NODE_247031_length_265_cov_1.614458	53	113	17	1	60	0.0166667
NODE_247031_length_265_cov_1.614458	86	166	12	7	80	0.0875000
NODE_247031_length_265_cov_1.614458	86	166	14	18	80	0.2250000
NODE_247031_length_265_cov_1.614458	86	166	15	1	80	0.0125000
NODE_247031_length_265_cov_1.614458	86	166	17	13	80	0.1625000
NODE_247031_length_265_cov_1.614458	86	166	18	12	80	0.1500000
NODE_247031_length_265_cov_1.614458	86	166	19	20	80	0.2500000
NODE_247031_length_265_cov_1.614458	86	166	20	9	80	0.1125000
NODE_247314_length_265_cov_1.337349	107	168	0	8	61	0.1311475
NODE_247314_length_265_cov_1.337349	107	168	4	53	61	0.8688524
NODE_247952_length_265_cov_1.000000	187	251	0	64	64	1.0000000
NODE_247972_length_265_cov_0.987952	44	63	0	19	19	1.0000000
NODE_249395_length_264_cov_4.018182	141	178	0	37	37	1.0000000
NODE_249404_length_264_cov_3.957576	59	132	0	15	73	0.2054795
NODE_249404_length_264_cov_3.957576	59	132	2	58	73	0.7945206
NODE_249404_length_264_cov_3.957576	112	192	0	75	80	0.9375000
NODE_249404_length_264_cov_3.957576	112	192	2	5	80	0.0625000
NODE_249415_length_264_cov_3.824242	178	220	0	42	42	1.0000000
NODE_249452_length_264_cov_3.400000	73	125	4	9	52	0.1730769
NODE_249452_length_264_cov_3.400000	73	125	5	8	52	0.1538462
NODE_249452_length_264_cov_3.400000	73	125	6	35	52	0.6730769
NODE_249452_length_264_cov_3.400000	124	165	6	22	41	0.5365854
NODE_249452_length_264_cov_3.400000	124	165	8	19	41	0.4634146
NODE_249485_length_264_cov_3.133333	119	186	0	67	67	1.0000000
NODE_249530_length_264_cov_3.012121	122	198	0	17	76	0.2236842
NODE_249530_length_264_cov_3.012121	122	198	2	59	76	0.7763158
NODE_249904_length_264_cov_2.048485	32	98	0	49	66	0.7424242
NODE_249904_length_264_cov_2.048485	32	98	2	6	66	0.0909091
NODE_249904_length_264_cov_2.048485	32	98	3	11	66	0.1666667
NODE_249905_length_264_cov_2.048485	133	176	1	43	43	1.0000000
NODE_249912_length_264_cov_2.012121	20	84	0	64	64	1.0000000
NODE_249931_length_264_cov_1.951515	178	211	0	33	33	1.0000000
NODE_249982_length_264_cov_1.854545	130	161	0	31	31	1.0000000
NODE_250202_length_264_cov_1.745455	26	81	0	55	55	1.0000000
NODE_250202_length_264_cov_1.745455	86	153	0	67	67	1.0000000
NODE_250203_length_264_cov_1.745455	90	169	9	12	79	0.1518987
NODE_250203_length_264_cov_1.745455	90	169	10	4	79	0.0506329
NODE_250203_length_264_cov_1.745455	90	169	11	14	79	0.1772152
NODE_250203_length_264_cov_1.745455	90	169	13	49	79	0.6202531
NODE_250203_length_264_cov_1.745455	143	207	10	6	64	0.0937500
NODE_250203_length_264_cov_1.745455	143	207	11	11	64	0.1718750
NODE_250203_length_264_cov_1.745455	143	207	13	47	64	0.7343750
NODE_250297_length_264_cov_1.569697	173	236	0	63	63	1.0000000
NODE_250314_length_264_cov_1.545455	206	255	0	49	49	1.0000000
NODE_250381_length_264_cov_1.545455	35	66	0	31	31	1.0000000
NODE_250446_length_264_cov_1.503030	0	63	0	63	63	1.0000000
NODE_250513_length_264_cov_1.406061	149	230	0	81	81	1.0000000
NODE_250513_length_264_cov_1.406061	225	260	0	35	35	1.0000000
NODE_250635_length_264_cov_1.236364	2	63	0	61	61	1.0000000
NODE_251015_length_264_cov_1.151515	11	68	0	57	57	1.0000000
NODE_251529_length_264_cov_0.921212	49	85	1	3	36	0.0833333
NODE_251529_length_264_cov_0.921212	49	85	2	33	36	0.9166667
NODE_251703_length_264_cov_0.721212	233	252	0	19	19	1.0000000
NODE_252559_length_263_cov_5.115854	132	219	13	3	87	0.0344828
NODE_252559_length_263_cov_5.115854	132	219	15	22	87	0.2528736
NODE_252559_length_263_cov_5.115854	132	219	17	62	87	0.7126437
NODE_252563_length_263_cov_4.914634	45	117	10	7	72	0.0972222
NODE_252563_length_263_cov_4.914634	45	117	12	1	72	0.0138889
NODE_252563_length_263_cov_4.914634	45	117	13	1	72	0.0138889
NODE_252563_length_263_cov_4.914634	45	117	14	5	72	0.0694444
NODE_252563_length_263_cov_4.914634	45	117	15	15	72	0.2083333
NODE_252563_length_263_cov_4.914634	45	117	17	7	72	0.0972222
NODE_252563_length_263_cov_4.914634	45	117	19	17	72	0.2361111
NODE_252563_length_263_cov_4.914634	45	117	21	5	72	0.0694444
NODE_252563_length_263_cov_4.914634	45	117	22	14	72	0.1944444
NODE_252595_length_263_cov_4.225610	67	124	3	57	57	1.0000000
NODE_252663_length_263_cov_3.518293	104	176	2	17	72	0.2361111
NODE_252663_length_263_cov_3.518293	104	176	3	55	72	0.7638889
NODE_252766_length_263_cov_2.908537	7	93	2	77	86	0.8953488
NODE_252766_length_263_cov_2.908537	7	93	4	9	86	0.1046512
NODE_252778_length_263_cov_2.798780	67	146	1	79	79	1.0000000
NODE_252932_length_263_cov_2.396341	207	238	0	31	31	1.0000000
NODE_253261_length_263_cov_1.865854	51	81	8	1	30	0.0333333
NODE_253261_length_263_cov_1.865854	51	81	9	15	30	0.5000000
NODE_253261_length_263_cov_1.865854	51	81	11	5	30	0.1666667
NODE_253261_length_263_cov_1.865854	51	81	12	9	30	0.3000000
NODE_253310_length_263_cov_1.847561	113	189	1	76	76	1.0000000
NODE_253379_length_263_cov_1.750000	151	231	3	38	80	0.4750000
NODE_253379_length_263_cov_1.750000	151	231	5	8	80	0.1000000
NODE_253379_length_263_cov_1.750000	151	231	6	34	80	0.4250000
NODE_253468_length_263_cov_1.579268	32	95	10	3	63	0.0476190
NODE_253468_length_263_cov_1.579268	32	95	11	9	63	0.1428571
NODE_253468_length_263_cov_1.579268	32	95	13	3	63	0.0476190
NODE_253468_length_263_cov_1.579268	32	95	15	9	63	0.1428571
NODE_253468_length_263_cov_1.579268	32	95	17	1	63	0.0158730
NODE_253468_length_263_cov_1.579268	32	95	19	24	63	0.3809524
NODE_253468_length_263_cov_1.579268	32	95	21	14	63	0.2222222
NODE_253477_length_263_cov_1.567073	98	155	2	47	57	0.8245614
NODE_253477_length_263_cov_1.567073	98	155	4	10	57	0.1754386
NODE_253619_length_263_cov_1.506098	157	217	4	1	60	0.0166667
NODE_253619_length_263_cov_1.506098	157	217	6	54	60	0.9000000
NODE_253619_length_263_cov_1.506098	157	217	8	5	60	0.0833333
NODE_253620_length_263_cov_1.506098	84	113	2	11	29	0.3793103
NODE_253620_length_263_cov_1.506098	84	113	4	18	29	0.6206896
NODE_253753_length_263_cov_1.286585	143	223	2	2	80	0.0250000
NODE_253753_length_263_cov_1.286585	143	223	3	1	80	0.0125000
NODE_253753_length_263_cov_1.286585	143	223	9	7	80	0.0875000
NODE_253753_length_263_cov_1.286585	143	223	10	2	80	0.0250000
NODE_253753_length_263_cov_1.286585	143	223	12	3	80	0.0375000
NODE_253753_length_263_cov_1.286585	143	223	14	1	80	0.0125000
NODE_253753_length_263_cov_1.286585	143	223	16	4	80	0.0500000
NODE_253753_length_263_cov_1.286585	143	223	18	1	80	0.0125000
NODE_253753_length_263_cov_1.286585	143	223	19	1	80	0.0125000
NODE_253753_length_263_cov_1.286585	143	223	20	3	80	0.0375000
NODE_253753_length_263_cov_1.286585	143	223	21	9	80	0.1125000
NODE_253753_length_263_cov_1.286585	143	223	22	4	80	0.0500000
NODE_253753_length_263_cov_1.286585	143	223	24	2	80	0.0250000
NODE_253753_length_263_cov_1.286585	143	223	27	4	80	0.0500000
NODE_253753_length_263_cov_1.286585	143	223	29	1	80	0.0125000
NODE_253753_length_263_cov_1.286585	143	223	30	3	80	0.0375000
NODE_253753_length_263_cov_1.286585	143	223	32	32	80	0.4000000
NODE_253788_length_263_cov_1.243902	206	263	0	57	57	1.0000000
NODE_254174_length_263_cov_1.170732	12	66	0	54	54	1.0000000
NODE_254174_length_263_cov_1.170732	39	119	0	80	80	1.0000000
NODE_254301_length_263_cov_1.067073	137	202	0	65	65	1.0000000
NODE_254301_length_263_cov_1.067073	175	255	0	80	80	1.0000000
NODE_254783_length_263_cov_0.810976	163	245	61	2	82	0.0243902
NODE_254783_length_263_cov_0.810976	163	245	63	1	82	0.0121951
NODE_254783_length_263_cov_0.810976	163	245	66	1	82	0.0121951
NODE_254783_length_263_cov_0.810976	163	245	68	1	82	0.0121951
NODE_254783_length_263_cov_0.810976	163	245	71	2	82	0.0243902
NODE_254783_length_263_cov_0.810976	163	245	73	1	82	0.0121951
NODE_254783_length_263_cov_0.810976	163	245	74	1	82	0.0121951
NODE_254783_length_263_cov_0.810976	163	245	80	3	82	0.0365854
NODE_254783_length_263_cov_0.810976	163	245	81	1	82	0.0121951
NODE_254783_length_263_cov_0.810976	163	245	85	1	82	0.0121951
NODE_254783_length_263_cov_0.810976	163	245	88	2	82	0.0243902
NODE_254783_length_263_cov_0.810976	163	245	91	1	82	0.0121951
NODE_254783_length_263_cov_0.810976	163	245	94	1	82	0.0121951
NODE_254783_length_263_cov_0.810976	163	245	96	2	82	0.0243902
NODE_254783_length_263_cov_0.810976	163	245	97	2	82	0.0243902
NODE_254783_length_263_cov_0.810976	163	245	101	1	82	0.0121951
NODE_254783_length_263_cov_0.810976	163	245	104	1	82	0.0121951
NODE_254783_length_263_cov_0.810976	163	245	106	1	82	0.0121951
NODE_254783_length_263_cov_0.810976	163	245	109	3	82	0.0365854
NODE_254783_length_263_cov_0.810976	163	245	111	1	82	0.0121951
NODE_254783_length_263_cov_0.810976	163	245	112	5	82	0.0609756
NODE_254783_length_263_cov_0.810976	163	245	113	1	82	0.0121951
NODE_254783_length_263_cov_0.810976	163	245	115	3	82	0.0365854
NODE_254783_length_263_cov_0.810976	163	245	116	1	82	0.0121951
NODE_254783_length_263_cov_0.810976	163	245	119	2	82	0.0243902
NODE_254783_length_263_cov_0.810976	163	245	123	1	82	0.0121951
NODE_254783_length_263_cov_0.810976	163	245	126	1	82	0.0121951
NODE_254783_length_263_cov_0.810976	163	245	127	1	82	0.0121951
NODE_254783_length_263_cov_0.810976	163	245	129	1	82	0.0121951
NODE_254783_length_263_cov_0.810976	163	245	131	1	82	0.0121951
NODE_254783_length_263_cov_0.810976	163	245	132	4	82	0.0487805
NODE_254783_length_263_cov_0.810976	163	245	133	2	82	0.0243902
NODE_254783_length_263_cov_0.810976	163	245	135	1	82	0.0121951
NODE_254783_length_263_cov_0.810976	163	245	141	3	82	0.0365854
NODE_254783_length_263_cov_0.810976	163	245	143	1	82	0.0121951
NODE_254783_length_263_cov_0.810976	163	245	145	3	82	0.0365854
NODE_254783_length_263_cov_0.810976	163	245	147	4	82	0.0487805
NODE_254783_length_263_cov_0.810976	163	245	148	1	82	0.0121951
NODE_254783_length_263_cov_0.810976	163	245	149	2	82	0.0243902
NODE_254783_length_263_cov_0.810976	163	245	151	4	82	0.0487805
NODE_254783_length_263_cov_0.810976	163	245	152	3	82	0.0365854
NODE_254783_length_263_cov_0.810976	163	245	153	6	82	0.0731707
NODE_254783_length_263_cov_0.810976	163	245	154	2	82	0.0243902
NODE_255446_length_263_cov_0.621951	212	258	0	46	46	1.0000000
NODE_255524_length_263_cov_0.621951	131	151	0	20	20	1.0000000
NODE_255559_length_263_cov_0.621951	67	86	0	19	19	1.0000000
NODE_255727_length_262_cov_5.312883	20	82	0	62	62	1.0000000
NODE_255769_length_262_cov_4.447853	102	155	0	53	53	1.0000000
NODE_255821_length_262_cov_3.766871	48	89	0	40	41	0.9756098
NODE_255821_length_262_cov_3.766871	48	89	1	1	41	0.0243902
NODE_255860_length_262_cov_3.435583	158	235	0	77	77	1.0000000
NODE_255945_length_262_cov_2.938650	142	222	1	80	80	1.0000000
NODE_256009_length_262_cov_2.723926	103	183	0	4	80	0.0500000
NODE_256009_length_262_cov_2.723926	103	183	2	76	80	0.9500000
NODE_256049_length_262_cov_2.509202	88	148	0	8	60	0.1333333
NODE_256049_length_262_cov_2.509202	88	148	2	52	60	0.8666667
NODE_256050_length_262_cov_2.509202	0	61	0	61	61	1.0000000
NODE_256050_length_262_cov_2.509202	107	171	0	64	64	1.0000000
NODE_256050_length_262_cov_2.509202	144	224	0	80	80	1.0000000
NODE_256129_length_262_cov_2.429448	14	87	0	73	73	1.0000000
NODE_256129_length_262_cov_2.429448	62	149	0	87	87	1.0000000
NODE_256176_length_262_cov_2.226994	2	79	0	77	77	1.0000000
NODE_256187_length_262_cov_2.202454	61	81	0	20	20	1.0000000
NODE_256199_length_262_cov_2.190184	172	235	0	24	63	0.3809524
NODE_256199_length_262_cov_2.190184	172	235	2	39	63	0.6190476
NODE_256239_length_262_cov_2.177914	133	189	0	56	56	1.0000000
NODE_256265_length_262_cov_2.122699	96	157	0	2	61	0.0327869
NODE_256265_length_262_cov_2.122699	96	157	2	40	61	0.6557377
NODE_256265_length_262_cov_2.122699	96	157	4	19	61	0.3114754
NODE_256386_length_262_cov_1.877301	0	77	0	2	77	0.0259740
NODE_256386_length_262_cov_1.877301	0	77	4	75	77	0.9740260
NODE_256390_length_262_cov_1.877301	77	124	6	2	47	0.0425532
NODE_256390_length_262_cov_1.877301	77	124	8	45	47	0.9574468
NODE_256481_length_262_cov_1.871166	192	252	1	20	60	0.3333333
NODE_256481_length_262_cov_1.871166	192	252	2	32	60	0.5333334
NODE_256481_length_262_cov_1.871166	192	252	3	8	60	0.1333333
NODE_256596_length_262_cov_1.736196	149	208	0	59	59	1.0000000
NODE_256630_length_262_cov_1.680982	2	82	0	80	80	1.0000000
NODE_256650_length_262_cov_1.656442	135	166	2	31	31	1.0000000
NODE_256659_length_262_cov_1.638037	111	142	6	9	31	0.2903226
NODE_256659_length_262_cov_1.638037	111	142	8	22	31	0.7096774
NODE_256704_length_262_cov_1.576687	102	182	0	80	80	1.0000000
NODE_256704_length_262_cov_1.576687	155	221	0	66	66	1.0000000
NODE_256742_length_262_cov_1.564417	69	124	0	55	55	1.0000000
NODE_256742_length_262_cov_1.564417	106	177	0	71	71	1.0000000
NODE_256933_length_262_cov_1.349693	52	102	0	50	50	1.0000000
NODE_256933_length_262_cov_1.349693	83	149	0	66	66	1.0000000
NODE_257199_length_262_cov_1.251534	44	124	0	35	80	0.4375000
NODE_257199_length_262_cov_1.251534	44	124	1	2	80	0.0250000
NODE_257199_length_262_cov_1.251534	44	124	3	43	80	0.5375000
NODE_257199_length_262_cov_1.251534	97	171	3	74	74	1.0000000
NODE_258876_length_261_cov_31.913580	32	112	2	56	80	0.7000000
NODE_258876_length_261_cov_31.913580	32	112	3	24	80	0.3000000
NODE_258876_length_261_cov_31.913580	85	171	1	21	86	0.2441860
NODE_258876_length_261_cov_31.913580	85	171	2	16	86	0.1860465
NODE_258876_length_261_cov_31.913580	85	171	3	49	86	0.5697674
NODE_258901_length_261_cov_6.376543	126	201	0	75	75	1.0000000
NODE_258901_length_261_cov_6.376543	179	254	0	75	75	1.0000000
NODE_258929_length_261_cov_5.469136	56	132	0	76	76	1.0000000
NODE_259329_length_261_cov_2.425926	53	134	0	81	81	1.0000000
NODE_259361_length_261_cov_2.333333	41	136	0	95	95	1.0000000
NODE_259435_length_261_cov_2.191358	86	122	0	36	36	1.0000000
NODE_259495_length_261_cov_1.993827	134	214	0	80	80	1.0000000
NODE_259672_length_261_cov_1.882716	51	105	4	7	54	0.1296296
NODE_259672_length_261_cov_1.882716	51	105	6	9	54	0.1666667
NODE_259672_length_261_cov_1.882716	51	105	7	5	54	0.0925926
NODE_259672_length_261_cov_1.882716	51	105	9	33	54	0.6111111
NODE_259740_length_261_cov_1.839506	118	197	0	72	79	0.9113924
NODE_259740_length_261_cov_1.839506	118	197	2	7	79	0.0886076
NODE_259769_length_261_cov_1.783951	69	141	3	6	72	0.0833333
NODE_259769_length_261_cov_1.783951	69	141	5	35	72	0.4861111
NODE_259769_length_261_cov_1.783951	69	141	7	31	72	0.4305556
NODE_260089_length_261_cov_1.388889	202	247	0	45	45	1.0000000
NODE_260090_length_261_cov_1.382716	14	61	0	47	47	1.0000000
NODE_260428_length_261_cov_1.253086	100	138	28	1	38	0.0263158
NODE_260428_length_261_cov_1.253086	100	138	30	11	38	0.2894737
NODE_260428_length_261_cov_1.253086	100	138	31	23	38	0.6052632
NODE_260428_length_261_cov_1.253086	100	138	35	3	38	0.0789474
NODE_260738_length_261_cov_1.030864	122	205	0	83	83	1.0000000
NODE_260738_length_261_cov_1.030864	129	210	0	81	81	1.0000000
NODE_260738_length_261_cov_1.030864	129	184	0	55	55	1.0000000
NODE_260738_length_261_cov_1.030864	187	248	0	61	61	1.0000000
NODE_260767_length_261_cov_1.006173	3	45	0	42	42	1.0000000
NODE_260767_length_261_cov_1.006173	46	98	0	52	52	1.0000000
NODE_262062_length_261_cov_0.580247	11	31	0	20	20	1.0000000
NODE_262121_length_260_cov_8.844720	74	138	2	64	64	1.0000000
NODE_262123_length_260_cov_8.447205	30	110	0	80	80	1.0000000
NODE_262123_length_260_cov_8.447205	83	167	0	84	84	1.0000000
NODE_262123_length_260_cov_8.447205	163	243	0	80	80	1.0000000
NODE_262149_length_260_cov_5.807453	38	118	0	80	80	1.0000000
NODE_262149_length_260_cov_5.807453	91	171	0	80	80	1.0000000
NODE_262264_length_260_cov_3.645963	5	57	0	52	52	1.0000000
NODE_262329_length_260_cov_3.167702	91	163	0	72	72	1.0000000
NODE_262378_length_260_cov_2.981366	58	127	0	69	69	1.0000000
NODE_262384_length_260_cov_2.913043	10	90	0	80	80	1.0000000
NODE_262708_length_260_cov_2.161491	174	251	0	77	77	1.0000000
NODE_262733_length_260_cov_2.080745	188	258	0	70	70	1.0000000
NODE_262788_length_260_cov_1.950311	27	85	3	10	58	0.1724138
NODE_262788_length_260_cov_1.950311	27	85	4	13	58	0.2241379
NODE_262788_length_260_cov_1.950311	27	85	5	3	58	0.0517241
NODE_262788_length_260_cov_1.950311	27	85	6	16	58	0.2758621
NODE_262788_length_260_cov_1.950311	27	85	8	3	58	0.0517241
NODE_262788_length_260_cov_1.950311	27	85	9	2	58	0.0344828
NODE_262788_length_260_cov_1.950311	27	85	10	1	58	0.0172414
NODE_262788_length_260_cov_1.950311	27	85	11	10	58	0.1724138
NODE_262930_length_260_cov_1.900621	14	50	0	36	36	1.0000000
NODE_263117_length_260_cov_1.683230	50	130	4	56	80	0.7000000
NODE_263117_length_260_cov_1.683230	50	130	5	4	80	0.0500000
NODE_263117_length_260_cov_1.683230	50	130	6	20	80	0.2500000
NODE_263428_length_260_cov_1.347826	38	118	0	41	80	0.5125000
NODE_263428_length_260_cov_1.347826	38	118	2	39	80	0.4875000
NODE_263533_length_260_cov_1.267081	114	199	0	85	85	1.0000000
NODE_263556_length_260_cov_1.267081	198	244	0	46	46	1.0000000
NODE_263568_length_260_cov_1.267081	145	189	2	23	44	0.5227273
NODE_263568_length_260_cov_1.267081	145	189	3	4	44	0.0909091
NODE_263568_length_260_cov_1.267081	145	189	4	17	44	0.3863636
NODE_265483_length_259_cov_4.800000	35	95	2	60	60	1.0000000
NODE_265584_length_259_cov_3.675000	119	161	0	42	42	1.0000000
NODE_265584_length_259_cov_3.675000	134	214	0	80	80	1.0000000
NODE_265592_length_259_cov_3.593750	100	143	1	31	43	0.7209302
NODE_265592_length_259_cov_3.593750	100	143	2	12	43	0.2790698
NODE_265611_length_259_cov_3.475000	198	259	3	61	61	1.0000000
NODE_265625_length_259_cov_3.331250	72	118	0	4	46	0.0869565
NODE_265625_length_259_cov_3.331250	72	118	1	1	46	0.0217391
NODE_265625_length_259_cov_3.331250	72	118	2	41	46	0.8913044
NODE_265636_length_259_cov_3.237500	103	160	0	57	57	1.0000000
NODE_265704_length_259_cov_2.937500	209	233	7	24	24	1.0000000
NODE_265735_length_259_cov_2.850000	0	41	0	41	41	1.0000000
NODE_265735_length_259_cov_2.850000	14	94	0	80	80	1.0000000
NODE_265818_length_259_cov_2.550000	9	82	0	73	73	1.0000000
NODE_265942_length_259_cov_2.287500	147	225	1	4	78	0.0512821
NODE_265942_length_259_cov_2.287500	147	225	2	74	78	0.9487180
NODE_265942_length_259_cov_2.287500	198	241	2	43	43	1.0000000
NODE_266032_length_259_cov_2.156250	0	72	0	72	72	1.0000000
NODE_266080_length_259_cov_2.012500	8	73	2	65	65	1.0000000
NODE_266080_length_259_cov_2.012500	53	126	0	21	73	0.2876712
NODE_266080_length_259_cov_2.012500	53	126	2	52	73	0.7123288
NODE_266101_length_259_cov_1.962500	108	189	2	9	81	0.1111111
NODE_266101_length_259_cov_1.962500	108	189	3	4	81	0.0493827
NODE_266101_length_259_cov_1.962500	108	189	4	68	81	0.8395061
NODE_266117_length_259_cov_1.918750	49	120	0	71	71	1.0000000
NODE_266183_length_259_cov_1.912500	114	177	0	56	63	0.8888889
NODE_266183_length_259_cov_1.912500	114	177	2	7	63	0.1111111
NODE_266365_length_259_cov_1.837500	180	252	0	37	72	0.5138889
NODE_266365_length_259_cov_1.837500	180	252	1	9	72	0.1250000
NODE_266365_length_259_cov_1.837500	180	252	2	2	72	0.0277778
NODE_266365_length_259_cov_1.837500	180	252	4	24	72	0.3333333
NODE_266609_length_259_cov_1.593750	27	67	0	5	40	0.1250000
NODE_266609_length_259_cov_1.593750	27	67	1	11	40	0.2750000
NODE_266609_length_259_cov_1.593750	27	67	2	12	40	0.3000000
NODE_266609_length_259_cov_1.593750	27	67	3	12	40	0.3000000
NODE_266746_length_259_cov_1.400000	117	164	3	25	47	0.5319149
NODE_266746_length_259_cov_1.400000	117	164	4	22	47	0.4680851
NODE_266746_length_259_cov_1.400000	137	217	0	6	80	0.0750000
NODE_266746_length_259_cov_1.400000	137	217	1	26	80	0.3250000
NODE_266746_length_259_cov_1.400000	137	217	2	5	80	0.0625000
NODE_266746_length_259_cov_1.400000	137	217	3	41	80	0.5125000
NODE_266746_length_259_cov_1.400000	137	217	4	2	80	0.0250000
NODE_268816_length_258_cov_6.415094	129	209	0	80	80	1.0000000
NODE_268816_length_258_cov_6.415094	182	258	0	76	76	1.0000000
NODE_268823_length_258_cov_6.157233	1	81	0	80	80	1.0000000
NODE_268823_length_258_cov_6.157233	9	64	0	55	55	1.0000000
NODE_268852_length_258_cov_4.798742	83	163	1	37	80	0.4625000
NODE_268852_length_258_cov_4.798742	83	163	2	43	80	0.5375000
NODE_268870_length_258_cov_4.396226	0	44	1	44	44	1.0000000
NODE_268870_length_258_cov_4.396226	24	97	1	73	73	1.0000000
NODE_268880_length_258_cov_4.301887	0	54	0	54	54	1.0000000
NODE_268942_length_258_cov_3.616352	29	58	0	29	29	1.0000000
NODE_268982_length_258_cov_3.352201	47	127	0	3	80	0.0375000
NODE_268982_length_258_cov_3.352201	47	127	4	64	80	0.8000000
NODE_268982_length_258_cov_3.352201	47	127	6	13	80	0.1625000
NODE_269086_length_258_cov_2.886792	102	121	0	19	19	1.0000000
NODE_269091_length_258_cov_2.880503	92	172	0	80	80	1.0000000
NODE_269102_length_258_cov_2.855346	96	138	12	23	42	0.5476190
NODE_269102_length_258_cov_2.855346	96	138	14	19	42	0.4523810
NODE_269102_length_258_cov_2.855346	148	191	3	8	43	0.1860465
NODE_269102_length_258_cov_2.855346	148	191	5	1	43	0.0232558
NODE_269102_length_258_cov_2.855346	148	191	6	21	43	0.4883721
NODE_269102_length_258_cov_2.855346	148	191	7	5	43	0.1162791
NODE_269102_length_258_cov_2.855346	148	191	9	1	43	0.0232558
NODE_269102_length_258_cov_2.855346	148	191	10	7	43	0.1627907
NODE_269113_length_258_cov_2.817610	10	58	0	48	48	1.0000000
NODE_269264_length_258_cov_2.383648	48	128	0	80	80	1.0000000
NODE_269264_length_258_cov_2.383648	101	182	0	81	81	1.0000000
NODE_269338_length_258_cov_2.238994	61	141	0	80	80	1.0000000
NODE_269615_length_258_cov_1.918239	0	51	0	51	51	1.0000000
NODE_269682_length_258_cov_1.855346	26	47	1	9	21	0.4285714
NODE_269682_length_258_cov_1.855346	26	47	2	12	21	0.5714286
NODE_269682_length_258_cov_1.855346	71	104	2	33	33	1.0000000
NODE_269682_length_258_cov_1.855346	81	156	1	49	75	0.6533333
NODE_269682_length_258_cov_1.855346	81	156	2	26	75	0.3466667
NODE_269749_length_258_cov_1.735849	105	176	2	2	71	0.0281690
NODE_269749_length_258_cov_1.735849	105	176	3	8	71	0.1126761
NODE_269749_length_258_cov_1.735849	105	176	5	1	71	0.0140845
NODE_269749_length_258_cov_1.735849	105	176	7	10	71	0.1408451
NODE_269749_length_258_cov_1.735849	105	176	8	15	71	0.2112676
NODE_269749_length_258_cov_1.735849	105	176	9	2	71	0.0281690
NODE_269749_length_258_cov_1.735849	105	176	10	33	71	0.4647887
NODE_269767_length_258_cov_1.710692	8	49	0	21	41	0.5121951
NODE_269767_length_258_cov_1.710692	8	49	1	20	41	0.4878049
NODE_270191_length_258_cov_1.283019	127	191	6	28	64	0.4375000
NODE_270191_length_258_cov_1.283019	127	191	8	36	64	0.5625000
NODE_270191_length_258_cov_1.283019	164	227	2	34	63	0.5396826
NODE_270191_length_258_cov_1.283019	164	227	5	1	63	0.0158730
NODE_270191_length_258_cov_1.283019	164	227	6	28	63	0.4444444
NODE_270465_length_258_cov_1.270440	4	55	0	51	51	1.0000000
NODE_270504_length_258_cov_1.232704	90	166	0	42	76	0.5526316
NODE_270504_length_258_cov_1.232704	90	166	2	34	76	0.4473684
NODE_270547_length_258_cov_1.201258	49	98	0	49	49	1.0000000
NODE_270876_length_258_cov_0.962264	186	258	0	72	72	1.0000000
NODE_270970_length_258_cov_0.962264	69	124	2	55	55	1.0000000
NODE_272169_length_257_cov_71.158228	81	165	31	3	84	0.0357143
NODE_272169_length_257_cov_71.158228	81	165	32	6	84	0.0714286
NODE_272169_length_257_cov_71.158228	81	165	33	8	84	0.0952381
NODE_272169_length_257_cov_71.158228	81	165	34	3	84	0.0357143
NODE_272169_length_257_cov_71.158228	81	165	35	9	84	0.1071429
NODE_272169_length_257_cov_71.158228	81	165	36	3	84	0.0357143
NODE_272169_length_257_cov_71.158228	81	165	37	9	84	0.1071429
NODE_272169_length_257_cov_71.158228	81	165	38	4	84	0.0476190
NODE_272169_length_257_cov_71.158228	81	165	39	22	84	0.2619048
NODE_272169_length_257_cov_71.158228	81	165	40	12	84	0.1428571
NODE_272169_length_257_cov_71.158228	81	165	41	5	84	0.0595238
NODE_272169_length_257_cov_71.158228	145	218	17	8	73	0.1095890
NODE_272169_length_257_cov_71.158228	145	218	19	2	73	0.0273973
NODE_272169_length_257_cov_71.158228	145	218	20	3	73	0.0410959
NODE_272169_length_257_cov_71.158228	145	218	21	1	73	0.0136986
NODE_272169_length_257_cov_71.158228	145	218	22	9	73	0.1232877
NODE_272169_length_257_cov_71.158228	145	218	24	2	73	0.0273973
NODE_272169_length_257_cov_71.158228	145	218	29	17	73	0.2328767
NODE_272169_length_257_cov_71.158228	145	218	30	2	73	0.0273973
NODE_272169_length_257_cov_71.158228	145	218	31	4	73	0.0547945
NODE_272169_length_257_cov_71.158228	145	218	32	8	73	0.1095890
NODE_272169_length_257_cov_71.158228	145	218	33	8	73	0.1095890
NODE_272169_length_257_cov_71.158228	145	218	35	9	73	0.1232877
NODE_272194_length_257_cov_6.329114	15	93	0	78	78	1.0000000
NODE_272275_length_257_cov_4.177215	25	86	0	61	61	1.0000000
NODE_272291_length_257_cov_3.987342	55	107	0	52	52	1.0000000
NODE_272304_length_257_cov_3.873418	145	225	0	80	80	1.0000000
NODE_272304_length_257_cov_3.873418	198	254	0	56	56	1.0000000
NODE_272322_length_257_cov_3.740506	133	199	3	9	66	0.1363636
NODE_272322_length_257_cov_3.740506	133	199	4	10	66	0.1515152
NODE_272322_length_257_cov_3.740506	133	199	5	12	66	0.1818182
NODE_272322_length_257_cov_3.740506	133	199	6	9	66	0.1363636
NODE_272322_length_257_cov_3.740506	133	199	8	16	66	0.2424242
NODE_272322_length_257_cov_3.740506	133	199	10	7	66	0.1060606
NODE_272322_length_257_cov_3.740506	133	199	12	3	66	0.0454545
NODE_272322_length_257_cov_3.740506	177	256	0	19	79	0.2405063
NODE_272322_length_257_cov_3.740506	177	256	2	33	79	0.4177215
NODE_272322_length_257_cov_3.740506	177	256	3	14	79	0.1772152
NODE_272322_length_257_cov_3.740506	177	256	4	10	79	0.1265823
NODE_272322_length_257_cov_3.740506	177	256	5	3	79	0.0379747
NODE_272486_length_257_cov_2.734177	1	65	0	64	64	1.0000000
NODE_272491_length_257_cov_2.677215	170	250	0	9	80	0.1125000
NODE_272491_length_257_cov_2.677215	170	250	1	1	80	0.0125000
NODE_272491_length_257_cov_2.677215	170	250	2	30	80	0.3750000
NODE_272491_length_257_cov_2.677215	170	250	3	1	80	0.0125000
NODE_272491_length_257_cov_2.677215	170	250	4	2	80	0.0250000
NODE_272491_length_257_cov_2.677215	170	250	6	1	80	0.0125000
NODE_272491_length_257_cov_2.677215	170	250	9	1	80	0.0125000
NODE_272491_length_257_cov_2.677215	170	250	10	8	80	0.1000000
NODE_272491_length_257_cov_2.677215	170	250	12	5	80	0.0625000
NODE_272491_length_257_cov_2.677215	170	250	13	6	80	0.0750000
NODE_272491_length_257_cov_2.677215	170	250	14	2	80	0.0250000
NODE_272491_length_257_cov_2.677215	170	250	17	2	80	0.0250000
NODE_272491_length_257_cov_2.677215	170	250	18	1	80	0.0125000
NODE_272491_length_257_cov_2.677215	170	250	19	3	80	0.0375000
NODE_272491_length_257_cov_2.677215	170	250	20	2	80	0.0250000
NODE_272491_length_257_cov_2.677215	170	250	24	4	80	0.0500000
NODE_272491_length_257_cov_2.677215	170	250	25	1	80	0.0125000
NODE_272491_length_257_cov_2.677215	170	250	26	1	80	0.0125000
NODE_272580_length_257_cov_2.537975	60	137	2	3	77	0.0389610
NODE_272580_length_257_cov_2.537975	60	137	4	6	77	0.0779221
NODE_272580_length_257_cov_2.537975	60	137	6	68	77	0.8831169
NODE_272596_length_257_cov_2.487342	95	172	0	1	77	0.0129870
NODE_272596_length_257_cov_2.487342	95	172	1	9	77	0.1168831
NODE_272596_length_257_cov_2.487342	95	172	2	9	77	0.1168831
NODE_272596_length_257_cov_2.487342	95	172	4	11	77	0.1428571
NODE_272596_length_257_cov_2.487342	95	172	6	47	77	0.6103896
NODE_272625_length_257_cov_2.379747	106	186	5	1	80	0.0125000
NODE_272625_length_257_cov_2.379747	106	186	6	15	80	0.1875000
NODE_272625_length_257_cov_2.379747	106	186	8	24	80	0.3000000
NODE_272625_length_257_cov_2.379747	106	186	10	40	80	0.5000000
NODE_272625_length_257_cov_2.379747	159	207	8	16	48	0.3333333
NODE_272625_length_257_cov_2.379747	159	207	10	32	48	0.6666667
NODE_272724_length_257_cov_2.221519	163	240	0	74	77	0.9610389
NODE_272724_length_257_cov_2.221519	163	240	2	3	77	0.0389610
NODE_272729_length_257_cov_2.202532	16	97	0	81	81	1.0000000
NODE_273151_length_257_cov_1.664557	220	239	0	19	19	1.0000000
NODE_273357_length_257_cov_1.500000	85	166	4	2	81	0.0246914
NODE_273357_length_257_cov_1.500000	85	166	5	7	81	0.0864198
NODE_273357_length_257_cov_1.500000	85	166	6	9	81	0.1111111
NODE_273357_length_257_cov_1.500000	85	166	7	10	81	0.1234568
NODE_273357_length_257_cov_1.500000	85	166	8	14	81	0.1728395
NODE_273357_length_257_cov_1.500000	85	166	9	39	81	0.4814815
NODE_273462_length_257_cov_1.329114	120	186	0	66	66	1.0000000
NODE_273533_length_257_cov_1.291139	13	53	0	40	40	1.0000000
NODE_273697_length_257_cov_1.291139	205	257	0	52	52	1.0000000
NODE_273894_length_257_cov_1.221519	10	74	0	10	64	0.1562500
NODE_273894_length_257_cov_1.221519	10	74	2	54	64	0.8437500
NODE_273917_length_257_cov_1.196203	70	150	0	17	80	0.2125000
NODE_273917_length_257_cov_1.196203	70	150	2	63	80	0.7875000
NODE_273917_length_257_cov_1.196203	123	204	0	4	81	0.0493827
NODE_273917_length_257_cov_1.196203	123	204	2	77	81	0.9506173
NODE_275399_length_257_cov_0.645570	138	158	0	20	20	1.0000000
NODE_275419_length_257_cov_0.645570	181	241	1	58	60	0.9666666
NODE_275419_length_257_cov_0.645570	181	241	3	2	60	0.0333333
NODE_275598_length_256_cov_5.235669	30	77	0	47	47	1.0000000
NODE_275624_length_256_cov_4.598726	100	180	0	80	80	1.0000000
NODE_275624_length_256_cov_4.598726	160	211	0	51	51	1.0000000
NODE_275682_length_256_cov_3.866242	112	166	0	54	54	1.0000000
NODE_275840_length_256_cov_2.878981	79	159	0	80	80	1.0000000
NODE_275840_length_256_cov_2.878981	132	212	0	80	80	1.0000000
NODE_275909_length_256_cov_2.598726	157	222	2	15	65	0.2307692
NODE_275909_length_256_cov_2.598726	157	222	3	50	65	0.7692308
NODE_275909_length_256_cov_2.598726	195	249	1	7	54	0.1296296
NODE_275909_length_256_cov_2.598726	195	249	2	35	54	0.6481481
NODE_275909_length_256_cov_2.598726	195	249	3	12	54	0.2222222
NODE_275981_length_256_cov_2.445860	104	183	1	5	79	0.0632911
NODE_275981_length_256_cov_2.445860	104	183	2	7	79	0.0886076
NODE_275981_length_256_cov_2.445860	104	183	3	67	79	0.8481013
NODE_276082_length_256_cov_2.229299	0	58	0	58	58	1.0000000
NODE_276082_length_256_cov_2.229299	17	68	0	51	51	1.0000000
NODE_276082_length_256_cov_2.229299	41	88	0	47	47	1.0000000
NODE_276082_length_256_cov_2.229299	42	122	0	80	80	1.0000000
NODE_276098_length_256_cov_2.184713	192	246	0	54	54	1.0000000
NODE_276119_length_256_cov_2.121019	150	236	0	38	86	0.4418605
NODE_276119_length_256_cov_2.121019	150	236	1	19	86	0.2209302
NODE_276119_length_256_cov_2.121019	150	236	2	29	86	0.3372093
NODE_276174_length_256_cov_1.974522	130	174	2	44	44	1.0000000
NODE_276471_length_256_cov_1.707006	39	92	0	1	53	0.0188679
NODE_276471_length_256_cov_1.707006	39	92	2	4	53	0.0754717
NODE_276471_length_256_cov_1.707006	39	92	3	6	53	0.1132075
NODE_276471_length_256_cov_1.707006	39	92	4	25	53	0.4716981
NODE_276471_length_256_cov_1.707006	39	92	5	17	53	0.3207547
NODE_276471_length_256_cov_1.707006	93	135	5	5	42	0.1190476
NODE_276471_length_256_cov_1.707006	93	135	6	15	42	0.3571429
NODE_276471_length_256_cov_1.707006	93	135	8	22	42	0.5238096
NODE_276484_length_256_cov_1.700637	107	129	0	22	22	1.0000000
NODE_276495_length_256_cov_1.675159	52	98	2	46	46	1.0000000
NODE_276654_length_256_cov_1.598726	125	202	0	42	77	0.5454546
NODE_276654_length_256_cov_1.598726	125	202	2	35	77	0.4545455
NODE_276654_length_256_cov_1.598726	178	256	0	78	78	1.0000000
NODE_276672_length_256_cov_1.579618	110	172	0	62	62	1.0000000
NODE_276672_length_256_cov_1.579618	194	239	0	45	45	1.0000000
NODE_276742_length_256_cov_1.464968	112	135	0	23	23	1.0000000
NODE_276826_length_256_cov_1.331210	138	209	2	71	71	1.0000000
NODE_276826_length_256_cov_1.331210	182	240	0	6	58	0.1034483
NODE_276826_length_256_cov_1.331210	182	240	2	52	58	0.8965517
NODE_277113_length_256_cov_1.299363	88	160	2	72	72	1.0000000
NODE_277305_length_256_cov_1.203822	3	43	1	11	40	0.2750000
NODE_277305_length_256_cov_1.203822	3	43	3	6	40	0.1500000
NODE_277305_length_256_cov_1.203822	3	43	4	3	40	0.0750000
NODE_277305_length_256_cov_1.203822	3	43	5	2	40	0.0500000
NODE_277305_length_256_cov_1.203822	3	43	6	1	40	0.0250000
NODE_277305_length_256_cov_1.203822	3	43	8	17	40	0.4250000
NODE_277305_length_256_cov_1.203822	16	96	3	4	80	0.0500000
NODE_277305_length_256_cov_1.203822	16	96	4	3	80	0.0375000
NODE_277305_length_256_cov_1.203822	16	96	5	2	80	0.0250000
NODE_277305_length_256_cov_1.203822	16	96	6	1	80	0.0125000
NODE_277305_length_256_cov_1.203822	16	96	8	19	80	0.2375000
NODE_277305_length_256_cov_1.203822	16	96	10	9	80	0.1125000
NODE_277305_length_256_cov_1.203822	16	96	11	12	80	0.1500000
NODE_277305_length_256_cov_1.203822	16	96	12	30	80	0.3750000
NODE_278934_length_255_cov_73.756410	52	99	4	3	47	0.0638298
NODE_278934_length_255_cov_73.756410	52	99	6	20	47	0.4255319
NODE_278934_length_255_cov_73.756410	52	99	7	7	47	0.1489362
NODE_278934_length_255_cov_73.756410	52	99	8	3	47	0.0638298
NODE_278934_length_255_cov_73.756410	52	99	10	5	47	0.1063830
NODE_278934_length_255_cov_73.756410	52	99	12	1	47	0.0212766
NODE_278934_length_255_cov_73.756410	52	99	13	8	47	0.1702128
NODE_278934_length_255_cov_73.756410	133	184	15	5	51	0.0980392
NODE_278934_length_255_cov_73.756410	133	184	16	23	51	0.4509804
NODE_278934_length_255_cov_73.756410	133	184	17	23	51	0.4509804
NODE_278934_length_255_cov_73.756410	157	237	3	5	80	0.0625000
NODE_278934_length_255_cov_73.756410	157	237	4	7	80	0.0875000
NODE_278934_length_255_cov_73.756410	157	237	5	9	80	0.1125000
NODE_278934_length_255_cov_73.756410	157	237	7	1	80	0.0125000
NODE_278934_length_255_cov_73.756410	157	237	9	19	80	0.2375000
NODE_278934_length_255_cov_73.756410	157	237	10	1	80	0.0125000
NODE_278934_length_255_cov_73.756410	157	237	11	6	80	0.0750000
NODE_278934_length_255_cov_73.756410	157	237	14	3	80	0.0375000
NODE_278934_length_255_cov_73.756410	157	237	15	2	80	0.0250000
NODE_278934_length_255_cov_73.756410	157	237	16	23	80	0.2875000
NODE_278934_length_255_cov_73.756410	157	237	17	4	80	0.0500000
NODE_278937_length_255_cov_15.538462	219	255	0	36	36	1.0000000
NODE_279003_length_255_cov_4.884615	157	230	0	71	73	0.9726027
NODE_279003_length_255_cov_4.884615	157	230	1	2	73	0.0273973
NODE_279003_length_255_cov_4.884615	203	248	0	45	45	1.0000000
NODE_279058_length_255_cov_4.012821	68	148	3	12	80	0.1500000
NODE_279058_length_255_cov_4.012821	68	148	4	54	80	0.6750000
NODE_279058_length_255_cov_4.012821	68	148	5	14	80	0.1750000
NODE_279075_length_255_cov_3.826923	16	80	8	14	64	0.2187500
NODE_279075_length_255_cov_3.826923	16	80	10	2	64	0.0312500
NODE_279075_length_255_cov_3.826923	16	80	12	32	64	0.5000000
NODE_279075_length_255_cov_3.826923	16	80	13	14	64	0.2187500
NODE_279075_length_255_cov_3.826923	16	80	14	2	64	0.0312500
NODE_279102_length_255_cov_3.596154	30	60	0	3	30	0.1000000
NODE_279102_length_255_cov_3.596154	30	60	2	27	30	0.9000000
NODE_279134_length_255_cov_3.423077	64	109	0	7	45	0.1555556
NODE_279134_length_255_cov_3.423077	64	109	2	38	45	0.8444445
NODE_279166_length_255_cov_3.262821	0	48	0	4	48	0.0833333
NODE_279166_length_255_cov_3.262821	0	48	2	17	48	0.3541667
NODE_279166_length_255_cov_3.262821	0	48	3	27	48	0.5625000
NODE_279166_length_255_cov_3.262821	66	113	3	40	47	0.8510638
NODE_279166_length_255_cov_3.262821	66	113	4	7	47	0.1489362
NODE_279241_length_255_cov_2.942308	157	176	0	19	19	1.0000000
NODE_279320_length_255_cov_2.621795	227	254	0	19	27	0.7037037
NODE_279320_length_255_cov_2.621795	227	254	1	8	27	0.2962963
NODE_279379_length_255_cov_2.602564	131	185	4	5	54	0.0925926
NODE_279379_length_255_cov_2.602564	131	185	5	49	54	0.9074074
NODE_279427_length_255_cov_2.487179	43	119	0	46	76	0.6052632
NODE_279427_length_255_cov_2.487179	43	119	2	30	76	0.3947369
NODE_279447_length_255_cov_2.435897	0	58	0	28	58	0.4827586
NODE_279447_length_255_cov_2.435897	0	58	2	30	58	0.5172414
NODE_279462_length_255_cov_2.391026	189	255	0	15	66	0.2272727
NODE_279462_length_255_cov_2.391026	189	255	2	51	66	0.7727273
NODE_279507_length_255_cov_2.288462	0	60	0	60	60	1.0000000
NODE_279510_length_255_cov_2.288462	0	74	0	74	74	1.0000000
NODE_279620_length_255_cov_2.089744	105	145	0	40	40	1.0000000
NODE_279649_length_255_cov_1.987179	0	72	5	72	72	1.0000000
NODE_279842_length_255_cov_1.910256	198	255	0	57	57	1.0000000
NODE_279871_length_255_cov_1.871795	16	68	0	52	52	1.0000000
NODE_279892_length_255_cov_1.826923	146	218	0	7	72	0.0972222
NODE_279892_length_255_cov_1.826923	146	218	1	11	72	0.1527778
NODE_279892_length_255_cov_1.826923	146	218	2	54	72	0.7500000
NODE_279956_length_255_cov_1.705128	0	45	1	5	45	0.1111111
NODE_279956_length_255_cov_1.705128	0	45	2	11	45	0.2444444
NODE_279956_length_255_cov_1.705128	0	45	3	5	45	0.1111111
NODE_279956_length_255_cov_1.705128	0	45	4	24	45	0.5333334
NODE_279956_length_255_cov_1.705128	41	121	4	12	80	0.1500000
NODE_279956_length_255_cov_1.705128	41	121	6	33	80	0.4125000
NODE_279956_length_255_cov_1.705128	41	121	7	35	80	0.4375000
NODE_279956_length_255_cov_1.705128	94	174	3	3	80	0.0375000
NODE_279956_length_255_cov_1.705128	94	174	4	3	80	0.0375000
NODE_279956_length_255_cov_1.705128	94	174	5	11	80	0.1375000
NODE_279956_length_255_cov_1.705128	94	174	6	38	80	0.4750000
NODE_279956_length_255_cov_1.705128	94	174	7	25	80	0.3125000
NODE_280153_length_255_cov_1.576923	43	117	0	46	74	0.6216216
NODE_280153_length_255_cov_1.576923	43	117	2	28	74	0.3783784
NODE_280153_length_255_cov_1.576923	90	175	0	47	85	0.5529412
NODE_280153_length_255_cov_1.576923	90	175	1	38	85	0.4470588
NODE_280168_length_255_cov_1.557692	62	125	0	63	63	1.0000000
NODE_280297_length_255_cov_1.358974	178	246	0	68	68	1.0000000
NODE_280904_length_255_cov_1.128205	183	219	0	36	36	1.0000000
NODE_281094_length_255_cov_0.987179	220	241	0	21	21	1.0000000
NODE_281380_length_255_cov_0.955128	119	171	0	52	52	1.0000000
NODE_281384_length_255_cov_0.955128	12	92	7	2	80	0.0250000
NODE_281384_length_255_cov_0.955128	12	92	9	78	80	0.9750000
NODE_282137_length_255_cov_0.653846	87	106	0	19	19	1.0000000
NODE_282534_length_254_cov_4.935484	144	189	0	45	45	1.0000000
NODE_282534_length_254_cov_4.935484	164	242	0	78	78	1.0000000
NODE_282548_length_254_cov_4.722581	44	85	9	41	41	1.0000000
NODE_282576_length_254_cov_4.296774	149	174	0	25	25	1.0000000
NODE_282576_length_254_cov_4.296774	149	223	0	74	74	1.0000000
NODE_282590_length_254_cov_4.206452	57	86	6	12	29	0.4137931
NODE_282590_length_254_cov_4.206452	57	86	7	17	29	0.5862069
NODE_282626_length_254_cov_3.677419	7	64	0	2	57	0.0350877
NODE_282626_length_254_cov_3.677419	7	64	2	55	57	0.9649123
NODE_282626_length_254_cov_3.677419	60	117	2	26	57	0.4561403
NODE_282626_length_254_cov_3.677419	60	117	4	31	57	0.5438597
NODE_282642_length_254_cov_3.593548	154	197	0	43	43	1.0000000
NODE_282659_length_254_cov_3.438710	82	129	0	47	47	1.0000000
NODE_282659_length_254_cov_3.438710	102	182	0	80	80	1.0000000
NODE_282736_length_254_cov_2.961290	5	79	0	18	74	0.2432432
NODE_282736_length_254_cov_2.961290	5	79	2	56	74	0.7567568
NODE_282736_length_254_cov_2.961290	52	118	0	13	66	0.1969697
NODE_282736_length_254_cov_2.961290	52	118	2	53	66	0.8030303
NODE_282771_length_254_cov_2.780645	169	252	1	4	83	0.0481928
NODE_282771_length_254_cov_2.780645	169	252	2	33	83	0.3975904
NODE_282771_length_254_cov_2.780645	169	252	4	9	83	0.1084337
NODE_282771_length_254_cov_2.780645	169	252	6	5	83	0.0602410
NODE_282771_length_254_cov_2.780645	169	252	8	1	83	0.0120482
NODE_282771_length_254_cov_2.780645	169	252	10	6	83	0.0722892
NODE_282771_length_254_cov_2.780645	169	252	12	3	83	0.0361446
NODE_282771_length_254_cov_2.780645	169	252	14	6	83	0.0722892
NODE_282771_length_254_cov_2.780645	169	252	16	16	83	0.1927711
NODE_282947_length_254_cov_2.341935	167	201	1	11	34	0.3235294
NODE_282947_length_254_cov_2.341935	167	201	3	20	34	0.5882353
NODE_282947_length_254_cov_2.341935	167	201	4	3	34	0.0882353
NODE_283082_length_254_cov_2.161290	14	74	0	60	60	1.0000000
NODE_283244_length_254_cov_1.974194	156	204	0	48	48	1.0000000
NODE_283440_length_254_cov_1.780645	79	126	2	47	47	1.0000000
NODE_283952_length_254_cov_1.316129	23	87	0	64	64	1.0000000
NODE_284013_length_254_cov_1.316129	193	215	0	22	22	1.0000000
NODE_284256_length_254_cov_1.258065	181	249	0	68	68	1.0000000
NODE_284275_length_254_cov_1.238710	9	82	0	73	73	1.0000000
NODE_284275_length_254_cov_1.238710	62	82	0	20	20	1.0000000
NODE_284277_length_254_cov_1.238710	54	73	2	19	19	1.0000000
NODE_284301_length_254_cov_1.219355	98	157	0	59	59	1.0000000
NODE_284638_length_254_cov_0.987097	139	193	0	54	54	1.0000000
NODE_284638_length_254_cov_0.987097	205	254	0	49	49	1.0000000
NODE_284796_length_254_cov_0.987097	121	152	0	12	31	0.3870968
NODE_284796_length_254_cov_0.987097	121	152	1	7	31	0.2258064
NODE_284796_length_254_cov_0.987097	121	152	2	12	31	0.3870968
NODE_285963_length_253_cov_60.311688	137	202	0	1	65	0.0153846
NODE_285963_length_253_cov_60.311688	137	202	4	5	65	0.0769231
NODE_285963_length_253_cov_60.311688	137	202	6	3	65	0.0461538
NODE_285963_length_253_cov_60.311688	137	202	8	3	65	0.0461538
NODE_285963_length_253_cov_60.311688	137	202	10	2	65	0.0307692
NODE_285963_length_253_cov_60.311688	137	202	12	2	65	0.0307692
NODE_285963_length_253_cov_60.311688	137	202	14	49	65	0.7538462
NODE_285963_length_253_cov_60.311688	175	253	4	5	78	0.0641026
NODE_285963_length_253_cov_60.311688	175	253	6	1	78	0.0128205
NODE_285963_length_253_cov_60.311688	175	253	8	2	78	0.0256410
NODE_285963_length_253_cov_60.311688	175	253	11	1	78	0.0128205
NODE_285963_length_253_cov_60.311688	175	253	12	8	78	0.1025641
NODE_285963_length_253_cov_60.311688	175	253	14	61	78	0.7820513
NODE_285965_length_253_cov_41.519481	0	68	0	29	68	0.4264706
NODE_285965_length_253_cov_41.519481	0	68	2	2	68	0.0294118
NODE_285965_length_253_cov_41.519481	0	68	3	37	68	0.5441176
NODE_285965_length_253_cov_41.519481	0	70	0	29	70	0.4142857
NODE_285965_length_253_cov_41.519481	0	70	2	2	70	0.0285714
NODE_285965_length_253_cov_41.519481	0	70	3	39	70	0.5571429
NODE_285965_length_253_cov_41.519481	2	73	0	27	71	0.3802817
NODE_285965_length_253_cov_41.519481	2	73	2	2	71	0.0281690
NODE_285965_length_253_cov_41.519481	2	73	3	42	71	0.5915493
NODE_285965_length_253_cov_41.519481	7	73	0	22	66	0.3333333
NODE_285965_length_253_cov_41.519481	7	73	2	2	66	0.0303030
NODE_285965_length_253_cov_41.519481	7	73	3	42	66	0.6363636
NODE_285965_length_253_cov_41.519481	46	123	1	12	77	0.1558442
NODE_285965_length_253_cov_41.519481	46	123	3	65	77	0.8441558
NODE_285965_length_253_cov_41.519481	46	123	1	12	77	0.1558442
NODE_285965_length_253_cov_41.519481	46	123	3	65	77	0.8441558
NODE_285965_length_253_cov_41.519481	46	123	1	12	77	0.1558442
NODE_285965_length_253_cov_41.519481	46	123	3	65	77	0.8441558
NODE_285967_length_253_cov_13.967532	25	105	2	22	80	0.2750000
NODE_285967_length_253_cov_13.967532	25	105	3	12	80	0.1500000
NODE_285967_length_253_cov_13.967532	25	105	4	29	80	0.3625000
NODE_285967_length_253_cov_13.967532	25	105	6	17	80	0.2125000
NODE_285967_length_253_cov_13.967532	78	158	4	62	80	0.7750000
NODE_285967_length_253_cov_13.967532	78	158	6	18	80	0.2250000
NODE_285969_length_253_cov_12.259740	0	54	0	54	54	1.0000000
NODE_285969_length_253_cov_12.259740	27	62	0	35	35	1.0000000
NODE_285969_length_253_cov_12.259740	51	131	0	80	80	1.0000000
NODE_285969_length_253_cov_12.259740	104	139	0	35	35	1.0000000
NODE_285969_length_253_cov_12.259740	128	208	0	80	80	1.0000000
NODE_285969_length_253_cov_12.259740	181	216	0	35	35	1.0000000
NODE_285987_length_253_cov_7.279221	184	250	2	4	66	0.0606061
NODE_285987_length_253_cov_7.279221	184	250	3	11	66	0.1666667
NODE_285987_length_253_cov_7.279221	184	250	5	23	66	0.3484848
NODE_285987_length_253_cov_7.279221	184	250	6	23	66	0.3484848
NODE_285987_length_253_cov_7.279221	184	250	8	5	66	0.0757576
NODE_286022_length_253_cov_5.376623	66	147	4	81	81	1.0000000
NODE_286022_length_253_cov_5.376623	120	185	0	6	65	0.0923077
NODE_286022_length_253_cov_5.376623	120	185	1	9	65	0.1384615
NODE_286022_length_253_cov_5.376623	120	185	2	21	65	0.3230769
NODE_286022_length_253_cov_5.376623	120	185	3	1	65	0.0153846
NODE_286022_length_253_cov_5.376623	120	185	4	28	65	0.4307692
NODE_286042_length_253_cov_4.896104	102	182	5	1	80	0.0125000
NODE_286042_length_253_cov_4.896104	102	182	6	1	80	0.0125000
NODE_286042_length_253_cov_4.896104	102	182	8	1	80	0.0125000
NODE_286042_length_253_cov_4.896104	102	182	9	6	80	0.0750000
NODE_286042_length_253_cov_4.896104	102	182	11	4	80	0.0500000
NODE_286042_length_253_cov_4.896104	102	182	13	29	80	0.3625000
NODE_286042_length_253_cov_4.896104	102	182	15	6	80	0.0750000
NODE_286042_length_253_cov_4.896104	102	182	16	30	80	0.3750000
NODE_286042_length_253_cov_4.896104	102	182	17	2	80	0.0250000
NODE_286046_length_253_cov_4.798701	199	253	0	26	54	0.4814815
NODE_286046_length_253_cov_4.798701	199	253	1	28	54	0.5185185
NODE_286069_length_253_cov_4.487013	85	126	0	41	41	1.0000000
NODE_286151_length_253_cov_3.500000	44	105	7	5	61	0.0819672
NODE_286151_length_253_cov_3.500000	44	105	9	4	61	0.0655738
NODE_286151_length_253_cov_3.500000	44	105	11	52	61	0.8524590
NODE_286151_length_253_cov_3.500000	90	158	1	10	68	0.1470588
NODE_286151_length_253_cov_3.500000	90	158	2	20	68	0.2941177
NODE_286151_length_253_cov_3.500000	90	158	3	10	68	0.1470588
NODE_286151_length_253_cov_3.500000	90	158	4	5	68	0.0735294
NODE_286151_length_253_cov_3.500000	90	158	5	6	68	0.0882353
NODE_286151_length_253_cov_3.500000	90	158	7	7	68	0.1029412
NODE_286151_length_253_cov_3.500000	90	158	9	4	68	0.0588235
NODE_286151_length_253_cov_3.500000	90	158	11	6	68	0.0882353
NODE_286259_length_253_cov_2.987013	85	165	0	80	80	1.0000000
NODE_286259_length_253_cov_2.987013	138	169	0	31	31	1.0000000
NODE_286275_length_253_cov_2.954545	100	148	0	37	48	0.7708333
NODE_286275_length_253_cov_2.954545	100	148	2	11	48	0.2291667
NODE_286281_length_253_cov_2.909091	34	99	0	15	65	0.2307692
NODE_286281_length_253_cov_2.909091	34	99	2	4	65	0.0615385
NODE_286281_length_253_cov_2.909091	34	99	4	46	65	0.7076923
NODE_286288_length_253_cov_2.889610	129	200	4	3	71	0.0422535
NODE_286288_length_253_cov_2.889610	129	200	5	4	71	0.0563380
NODE_286288_length_253_cov_2.889610	129	200	6	41	71	0.5774648
NODE_286288_length_253_cov_2.889610	129	200	7	23	71	0.3239437
NODE_286288_length_253_cov_2.889610	173	253	1	16	80	0.2000000
NODE_286288_length_253_cov_2.889610	173	253	2	1	80	0.0125000
NODE_286288_length_253_cov_2.889610	173	253	3	31	80	0.3875000
NODE_286288_length_253_cov_2.889610	173	253	4	3	80	0.0375000
NODE_286288_length_253_cov_2.889610	173	253	5	9	80	0.1125000
NODE_286288_length_253_cov_2.889610	173	253	6	20	80	0.2500000
NODE_286289_length_253_cov_2.889610	21	76	2	55	55	1.0000000
NODE_286289_length_253_cov_2.889610	149	229	0	80	80	1.0000000
NODE_286379_length_253_cov_2.610390	113	193	0	80	80	1.0000000
NODE_286386_length_253_cov_2.584416	97	154	2	57	57	1.0000000
NODE_286545_length_253_cov_2.240260	185	250	0	65	65	1.0000000
NODE_286667_length_253_cov_1.987013	157	237	0	80	80	1.0000000
NODE_286667_length_253_cov_1.987013	210	253	0	43	43	1.0000000
NODE_286685_length_253_cov_1.987013	18	60	2	42	42	1.0000000
NODE_286829_length_253_cov_1.961039	186	232	0	46	46	1.0000000
NODE_286837_length_253_cov_1.948052	68	120	0	52	52	1.0000000
NODE_286838_length_253_cov_1.948052	63	114	0	33	51	0.6470588
NODE_286838_length_253_cov_1.948052	63	114	2	18	51	0.3529412
NODE_286947_length_253_cov_1.746753	164	193	0	29	29	1.0000000
NODE_287031_length_253_cov_1.655844	40	120	0	45	80	0.5625000
NODE_287031_length_253_cov_1.655844	40	120	2	35	80	0.4375000
NODE_287031_length_253_cov_1.655844	93	152	1	1	59	0.0169492
NODE_287031_length_253_cov_1.655844	93	152	2	48	59	0.8135593
NODE_287031_length_253_cov_1.655844	93	152	3	10	59	0.1694915
NODE_287133_length_253_cov_1.590909	102	148	2	46	46	1.0000000
NODE_287156_length_253_cov_1.558442	67	149	1	82	82	1.0000000
NODE_287230_length_253_cov_1.441558	49	113	0	64	64	1.0000000
NODE_287230_length_253_cov_1.441558	102	166	0	64	64	1.0000000
NODE_287232_length_253_cov_1.441558	121	185	0	64	64	1.0000000
NODE_287234_length_253_cov_1.435065	50	81	0	31	31	1.0000000
NODE_287584_length_253_cov_1.324675	193	239	0	11	46	0.2391304
NODE_287584_length_253_cov_1.324675	193	239	1	35	46	0.7608696
NODE_287599_length_253_cov_1.324675	90	132	4	42	42	1.0000000
NODE_287599_length_253_cov_1.324675	133	185	3	6	52	0.1153846
NODE_287599_length_253_cov_1.324675	133	185	4	46	52	0.8846154
NODE_287721_length_253_cov_1.285714	87	125	0	38	38	1.0000000
NODE_287794_length_253_cov_1.214286	99	148	0	49	49	1.0000000
NODE_287845_length_253_cov_1.181818	185	247	0	62	62	1.0000000
NODE_287845_length_253_cov_1.181818	185	247	0	62	62	1.0000000
NODE_287989_length_253_cov_1.064935	83	159	4	1	76	0.0131579
NODE_287989_length_253_cov_1.064935	83	159	6	8	76	0.1052632
NODE_287989_length_253_cov_1.064935	83	159	8	6	76	0.0789474
NODE_287989_length_253_cov_1.064935	83	159	9	50	76	0.6578947
NODE_287989_length_253_cov_1.064935	83	159	10	11	76	0.1447368
NODE_288099_length_253_cov_0.993506	0	44	0	44	44	1.0000000
NODE_288465_length_253_cov_0.870130	17	46	0	29	29	1.0000000
NODE_288478_length_253_cov_0.850649	0	89	0	89	89	1.0000000
NODE_289563_length_252_cov_4.771242	94	148	2	54	54	1.0000000
NODE_289574_length_252_cov_4.614379	16	37	0	21	21	1.0000000
NODE_289624_length_252_cov_3.960784	7	85	0	78	78	1.0000000
NODE_289624_length_252_cov_3.960784	63	136	0	73	73	1.0000000
NODE_289663_length_252_cov_3.549020	89	157	1	24	68	0.3529412
NODE_289663_length_252_cov_3.549020	89	157	2	44	68	0.6470588
NODE_289672_length_252_cov_3.405229	26	107	1	8	81	0.0987654
NODE_289672_length_252_cov_3.405229	26	107	2	1	81	0.0123457
NODE_289672_length_252_cov_3.405229	26	107	3	4	81	0.0493827
NODE_289672_length_252_cov_3.405229	26	107	5	48	81	0.5925926
NODE_289672_length_252_cov_3.405229	26	107	6	20	81	0.2469136
NODE_289705_length_252_cov_3.307190	91	141	0	50	50	1.0000000
NODE_289742_length_252_cov_3.032680	135	212	4	9	77	0.1168831
NODE_289742_length_252_cov_3.032680	135	212	5	24	77	0.3116883
NODE_289742_length_252_cov_3.032680	135	212	7	44	77	0.5714286
NODE_289775_length_252_cov_2.928105	0	57	0	57	57	1.0000000
NODE_289799_length_252_cov_2.803922	41	121	0	80	80	1.0000000
NODE_290032_length_252_cov_2.320261	0	64	0	64	64	1.0000000
NODE_290046_length_252_cov_2.281046	120	170	0	50	50	1.0000000
NODE_290066_length_252_cov_2.215686	137	175	56	1	38	0.0263158
NODE_290066_length_252_cov_2.215686	137	175	57	2	38	0.0526316
NODE_290066_length_252_cov_2.215686	137	175	59	1	38	0.0263158
NODE_290066_length_252_cov_2.215686	137	175	61	4	38	0.1052632
NODE_290066_length_252_cov_2.215686	137	175	65	3	38	0.0789474
NODE_290066_length_252_cov_2.215686	137	175	66	2	38	0.0526316
NODE_290066_length_252_cov_2.215686	137	175	67	2	38	0.0526316
NODE_290066_length_252_cov_2.215686	137	175	68	3	38	0.0789474
NODE_290066_length_252_cov_2.215686	137	175	70	1	38	0.0263158
NODE_290066_length_252_cov_2.215686	137	175	72	5	38	0.1315790
NODE_290066_length_252_cov_2.215686	137	175	74	4	38	0.1052632
NODE_290066_length_252_cov_2.215686	137	175	76	2	38	0.0526316
NODE_290066_length_252_cov_2.215686	137	175	77	7	38	0.1842105
NODE_290066_length_252_cov_2.215686	137	175	78	1	38	0.0263158
NODE_290103_length_252_cov_2.052288	18	39	0	21	21	1.0000000
NODE_290238_length_252_cov_1.993464	80	139	0	59	59	1.0000000
NODE_290385_length_252_cov_1.810458	3	49	0	46	46	1.0000000
NODE_290623_length_252_cov_1.594771	103	156	0	53	53	1.0000000
NODE_290623_length_252_cov_1.594771	152	192	0	40	40	1.0000000
NODE_290638_length_252_cov_1.568627	1	68	1	67	67	1.0000000
NODE_290767_length_252_cov_1.359477	26	93	0	67	67	1.0000000
NODE_290790_length_252_cov_1.333333	179	232	0	53	53	1.0000000
NODE_290850_length_252_cov_1.333333	187	222	0	35	35	1.0000000
NODE_291072_length_252_cov_1.333333	31	111	0	80	80	1.0000000
NODE_291076_length_252_cov_1.333333	90	140	1	6	50	0.1200000
NODE_291076_length_252_cov_1.333333	90	140	2	44	50	0.8800000
NODE_291118_length_252_cov_1.326797	112	143	0	31	31	1.0000000
NODE_291351_length_252_cov_1.156863	1	32	0	31	31	1.0000000
NODE_291650_length_252_cov_1.000000	49	79	0	30	30	1.0000000
NODE_291911_length_252_cov_0.836601	125	172	0	28	47	0.5957447
NODE_291911_length_252_cov_0.836601	125	172	2	19	47	0.4042553
NODE_293004_length_251_cov_5.032895	0	62	0	3	62	0.0483871
NODE_293004_length_251_cov_5.032895	0	62	2	59	62	0.9516129
NODE_293005_length_251_cov_5.026316	84	164	1	7	80	0.0875000
NODE_293005_length_251_cov_5.026316	84	164	4	73	80	0.9125000
NODE_293165_length_251_cov_3.302632	187	249	0	62	62	1.0000000
NODE_293195_length_251_cov_3.131579	96	148	0	52	52	1.0000000
NODE_293238_length_251_cov_2.980263	11	38	2	4	27	0.1481481
NODE_293238_length_251_cov_2.980263	11	38	4	2	27	0.0740741
NODE_293238_length_251_cov_2.980263	11	38	6	7	27	0.2592593
NODE_293238_length_251_cov_2.980263	11	38	7	3	27	0.1111111
NODE_293238_length_251_cov_2.980263	11	38	8	2	27	0.0740741
NODE_293238_length_251_cov_2.980263	11	38	9	9	27	0.3333333
NODE_293238_length_251_cov_2.980263	11	91	2	4	80	0.0500000
NODE_293238_length_251_cov_2.980263	11	91	4	2	80	0.0250000
NODE_293238_length_251_cov_2.980263	11	91	6	7	80	0.0875000
NODE_293238_length_251_cov_2.980263	11	91	7	3	80	0.0375000
NODE_293238_length_251_cov_2.980263	11	91	8	2	80	0.0250000
NODE_293238_length_251_cov_2.980263	11	91	9	17	80	0.2125000
NODE_293238_length_251_cov_2.980263	11	91	10	45	80	0.5625000
NODE_293259_length_251_cov_2.842105	170	198	1	23	28	0.8214286
NODE_293259_length_251_cov_2.842105	170	198	3	5	28	0.1785714
NODE_293279_length_251_cov_2.743421	181	232	0	51	51	1.0000000
NODE_293335_length_251_cov_2.677632	35	54	0	19	19	1.0000000
NODE_293454_length_251_cov_2.348684	196	251	0	55	55	1.0000000
NODE_293502_length_251_cov_2.328947	86	149	2	58	63	0.9206349
NODE_293502_length_251_cov_2.328947	86	149	4	5	63	0.0793651
NODE_293516_length_251_cov_2.296053	91	171	0	80	80	1.0000000
NODE_293516_length_251_cov_2.296053	144	224	0	80	80	1.0000000
NODE_293591_length_251_cov_2.065789	7	52	0	43	45	0.9555556
NODE_293591_length_251_cov_2.065789	7	52	1	2	45	0.0444444
NODE_293698_length_251_cov_2.013158	96	179	0	83	83	1.0000000
NODE_293698_length_251_cov_2.013158	96	179	0	83	83	1.0000000
NODE_293698_length_251_cov_2.013158	152	203	0	51	51	1.0000000
NODE_293698_length_251_cov_2.013158	152	201	0	49	49	1.0000000
NODE_293919_length_251_cov_1.710526	135	194	0	59	59	1.0000000
NODE_294028_length_251_cov_1.671053	94	127	0	33	33	1.0000000
NODE_294063_length_251_cov_1.644737	135	164	2	29	29	1.0000000
NODE_294147_length_251_cov_1.473684	137	202	0	24	65	0.3692308
NODE_294147_length_251_cov_1.473684	137	202	2	41	65	0.6307693
NODE_294153_length_251_cov_1.460526	17	78	0	61	61	1.0000000
NODE_294190_length_251_cov_1.407895	182	246	1	8	64	0.1250000
NODE_294190_length_251_cov_1.407895	182	246	3	12	64	0.1875000
NODE_294190_length_251_cov_1.407895	182	246	4	44	64	0.6875000
NODE_294393_length_251_cov_1.342105	9	89	0	80	80	1.0000000
NODE_294393_length_251_cov_1.342105	62	91	0	29	29	1.0000000
NODE_294624_length_251_cov_1.296053	7	47	0	40	40	1.0000000
NODE_294624_length_251_cov_1.296053	24	47	0	23	23	1.0000000
NODE_295165_length_251_cov_1.006579	4	50	0	46	46	1.0000000
NODE_296033_length_251_cov_0.671053	184	204	0	20	20	1.0000000
NODE_296386_length_251_cov_0.572368	54	74	0	20	20	1.0000000
NODE_296437_length_250_cov_35.662252	33	99	0	66	66	1.0000000
NODE_296437_length_250_cov_35.662252	143	223	0	80	80	1.0000000
NODE_296456_length_250_cov_6.503311	186	250	0	64	64	1.0000000
NODE_296467_length_250_cov_5.867550	99	120	1	21	21	1.0000000
NODE_296520_length_250_cov_4.662252	143	187	0	44	44	1.0000000
NODE_296520_length_250_cov_4.662252	160	227	0	67	67	1.0000000
NODE_296598_length_250_cov_3.715232	37	90	0	53	53	1.0000000
NODE_296633_length_250_cov_3.417219	113	193	0	75	80	0.9375000
NODE_296633_length_250_cov_3.417219	113	193	1	5	80	0.0625000
NODE_296633_length_250_cov_3.417219	166	246	0	80	80	1.0000000
NODE_296653_length_250_cov_3.364238	0	61	0	61	61	1.0000000
NODE_296653_length_250_cov_3.364238	34	94	0	60	60	1.0000000
NODE_296680_length_250_cov_3.225166	157	209	0	52	52	1.0000000
NODE_296680_length_250_cov_3.225166	182	250	0	68	68	1.0000000
NODE_296699_length_250_cov_3.086093	33	67	2	1	34	0.0294118
NODE_296699_length_250_cov_3.086093	33	67	4	33	34	0.9705882
NODE_296703_length_250_cov_3.052980	29	94	0	15	65	0.2307692
NODE_296703_length_250_cov_3.052980	29	94	1	50	65	0.7692308
NODE_296707_length_250_cov_3.039735	51	106	0	55	55	1.0000000
NODE_296737_length_250_cov_2.986755	124	185	2	41	61	0.6721311
NODE_296737_length_250_cov_2.986755	124	185	4	20	61	0.3278688
NODE_296737_length_250_cov_2.986755	172	243	0	15	71	0.2112676
NODE_296737_length_250_cov_2.986755	172	243	2	45	71	0.6338028
NODE_296737_length_250_cov_2.986755	172	243	4	11	71	0.1549296
NODE_296885_length_250_cov_2.516556	0	49	0	49	49	1.0000000
NODE_296893_length_250_cov_2.476821	94	174	0	80	80	1.0000000
NODE_296893_length_250_cov_2.476821	147	227	0	80	80	1.0000000
NODE_296897_length_250_cov_2.470199	166	212	0	46	46	1.0000000
NODE_297070_length_250_cov_2.059603	150	207	2	57	57	1.0000000
NODE_297211_length_250_cov_2.019868	74	141	3	10	67	0.1492537
NODE_297211_length_250_cov_2.019868	74	141	5	4	67	0.0597015
NODE_297211_length_250_cov_2.019868	74	141	7	53	67	0.7910448
NODE_297211_length_250_cov_2.019868	158	204	0	10	46	0.2173913
NODE_297211_length_250_cov_2.019868	158	204	2	11	46	0.2391304
NODE_297211_length_250_cov_2.019868	158	204	3	25	46	0.5434783
NODE_297550_length_250_cov_1.688742	6	42	0	36	36	1.0000000
NODE_297624_length_250_cov_1.635762	150	191	2	41	41	1.0000000
NODE_297679_length_250_cov_1.529801	59	108	0	49	49	1.0000000
NODE_297679_length_250_cov_1.529801	81	161	0	80	80	1.0000000
NODE_297693_length_250_cov_1.516556	124	184	0	54	60	0.9000000
NODE_297693_length_250_cov_1.516556	124	184	2	6	60	0.1000000
NODE_297693_length_250_cov_1.516556	166	237	0	71	71	1.0000000
NODE_297762_length_250_cov_1.377483	0	80	0	80	80	1.0000000
NODE_297963_length_250_cov_1.350993	40	98	0	58	58	1.0000000
NODE_298213_length_250_cov_1.291391	116	196	5	15	80	0.1875000
NODE_298213_length_250_cov_1.291391	116	196	7	17	80	0.2125000
NODE_298213_length_250_cov_1.291391	116	196	8	17	80	0.2125000
NODE_298213_length_250_cov_1.291391	116	196	10	31	80	0.3875000
NODE_298719_length_250_cov_1.013245	126	163	0	37	37	1.0000000
NODE_298794_length_250_cov_1.006623	129	148	0	19	19	1.0000000
NODE_298900_length_250_cov_0.920530	126	178	6	52	52	1.0000000
NODE_299979_length_249_cov_55.413333	97	172	0	75	75	1.0000000
NODE_299979_length_249_cov_55.413333	150	225	0	75	75	1.0000000
NODE_300012_length_247_cov_51.243243	172	247	0	75	75	1.0000000
NODE_300014_length_247_cov_37.614865	156	239	4	2	83	0.0240964
NODE_300014_length_247_cov_37.614865	156	239	5	1	83	0.0120482
NODE_300014_length_247_cov_37.614865	156	239	6	13	83	0.1566265
NODE_300014_length_247_cov_37.614865	156	239	8	3	83	0.0361446
NODE_300014_length_247_cov_37.614865	156	239	9	6	83	0.0722892
NODE_300014_length_247_cov_37.614865	156	239	10	14	83	0.1686747
NODE_300014_length_247_cov_37.614865	156	239	11	3	83	0.0361446
NODE_300014_length_247_cov_37.614865	156	239	12	6	83	0.0722892
NODE_300014_length_247_cov_37.614865	156	239	14	4	83	0.0481928
NODE_300014_length_247_cov_37.614865	156	239	15	3	83	0.0361446
NODE_300014_length_247_cov_37.614865	156	239	16	28	83	0.3373494
NODE_300056_length_245_cov_40.876712	138	202	12	8	64	0.1250000
NODE_300056_length_245_cov_40.876712	138	202	13	4	64	0.0625000
NODE_300056_length_245_cov_40.876712	138	202	16	2	64	0.0312500
NODE_300056_length_245_cov_40.876712	138	202	17	1	64	0.0156250
NODE_300056_length_245_cov_40.876712	138	202	18	6	64	0.0937500
NODE_300056_length_245_cov_40.876712	138	202	19	1	64	0.0156250
NODE_300056_length_245_cov_40.876712	138	202	20	5	64	0.0781250
NODE_300056_length_245_cov_40.876712	138	202	21	1	64	0.0156250
NODE_300056_length_245_cov_40.876712	138	202	22	5	64	0.0781250
NODE_300056_length_245_cov_40.876712	138	202	24	8	64	0.1250000
NODE_300056_length_245_cov_40.876712	138	202	25	7	64	0.1093750
NODE_300056_length_245_cov_40.876712	138	202	26	1	64	0.0156250
NODE_300056_length_245_cov_40.876712	138	202	27	1	64	0.0156250
NODE_300056_length_245_cov_40.876712	138	202	28	1	64	0.0156250
NODE_300056_length_245_cov_40.876712	138	202	29	3	64	0.0468750
NODE_300056_length_245_cov_40.876712	138	202	31	6	64	0.0937500
NODE_300056_length_245_cov_40.876712	138	202	32	2	64	0.0312500
NODE_300056_length_245_cov_40.876712	138	202	33	2	64	0.0312500
NODE_300056_length_245_cov_40.876712	138	202	12	8	64	0.1250000
NODE_300056_length_245_cov_40.876712	138	202	13	4	64	0.0625000
NODE_300056_length_245_cov_40.876712	138	202	16	2	64	0.0312500
NODE_300056_length_245_cov_40.876712	138	202	17	1	64	0.0156250
NODE_300056_length_245_cov_40.876712	138	202	18	6	64	0.0937500
NODE_300056_length_245_cov_40.876712	138	202	19	1	64	0.0156250
NODE_300056_length_245_cov_40.876712	138	202	20	5	64	0.0781250
NODE_300056_length_245_cov_40.876712	138	202	21	1	64	0.0156250
NODE_300056_length_245_cov_40.876712	138	202	22	5	64	0.0781250
NODE_300056_length_245_cov_40.876712	138	202	24	8	64	0.1250000
NODE_300056_length_245_cov_40.876712	138	202	25	7	64	0.1093750
NODE_300056_length_245_cov_40.876712	138	202	26	1	64	0.0156250
NODE_300056_length_245_cov_40.876712	138	202	27	1	64	0.0156250
NODE_300056_length_245_cov_40.876712	138	202	28	1	64	0.0156250
NODE_300056_length_245_cov_40.876712	138	202	29	3	64	0.0468750
NODE_300056_length_245_cov_40.876712	138	202	31	6	64	0.0937500
NODE_300056_length_245_cov_40.876712	138	202	32	2	64	0.0312500
NODE_300056_length_245_cov_40.876712	138	202	33	2	64	0.0312500
NODE_300056_length_245_cov_40.876712	138	202	12	8	64	0.1250000
NODE_300056_length_245_cov_40.876712	138	202	13	4	64	0.0625000
NODE_300056_length_245_cov_40.876712	138	202	16	2	64	0.0312500
NODE_300056_length_245_cov_40.876712	138	202	17	1	64	0.0156250
NODE_300056_length_245_cov_40.876712	138	202	18	6	64	0.0937500
NODE_300056_length_245_cov_40.876712	138	202	19	1	64	0.0156250
NODE_300056_length_245_cov_40.876712	138	202	20	5	64	0.0781250
NODE_300056_length_245_cov_40.876712	138	202	21	1	64	0.0156250
NODE_300056_length_245_cov_40.876712	138	202	22	5	64	0.0781250
NODE_300056_length_245_cov_40.876712	138	202	24	8	64	0.1250000
NODE_300056_length_245_cov_40.876712	138	202	25	7	64	0.1093750
NODE_300056_length_245_cov_40.876712	138	202	26	1	64	0.0156250
NODE_300056_length_245_cov_40.876712	138	202	27	1	64	0.0156250
NODE_300056_length_245_cov_40.876712	138	202	28	1	64	0.0156250
NODE_300056_length_245_cov_40.876712	138	202	29	3	64	0.0468750
NODE_300056_length_245_cov_40.876712	138	202	31	6	64	0.0937500
NODE_300056_length_245_cov_40.876712	138	202	32	2	64	0.0312500
NODE_300056_length_245_cov_40.876712	138	202	33	2	64	0.0312500
NODE_300056_length_245_cov_40.876712	175	241	5	5	66	0.0757576
NODE_300056_length_245_cov_40.876712	175	241	6	7	66	0.1060606
NODE_300056_length_245_cov_40.876712	175	241	7	1	66	0.0151515
NODE_300056_length_245_cov_40.876712	175	241	8	1	66	0.0151515
NODE_300056_length_245_cov_40.876712	175	241	9	9	66	0.1363636
NODE_300056_length_245_cov_40.876712	175	241	10	4	66	0.0606061
NODE_300056_length_245_cov_40.876712	175	241	11	6	66	0.0909091
NODE_300056_length_245_cov_40.876712	175	241	12	14	66	0.2121212
NODE_300056_length_245_cov_40.876712	175	241	13	4	66	0.0606061
NODE_300056_length_245_cov_40.876712	175	241	16	2	66	0.0303030
NODE_300056_length_245_cov_40.876712	175	241	17	1	66	0.0151515
NODE_300056_length_245_cov_40.876712	175	241	18	6	66	0.0909091
NODE_300056_length_245_cov_40.876712	175	241	19	1	66	0.0151515
NODE_300056_length_245_cov_40.876712	175	241	20	5	66	0.0757576
NODE_300147_length_240_cov_80.744681	167	238	0	21	71	0.2957746
NODE_300147_length_240_cov_80.744681	167	238	2	27	71	0.3802817
NODE_300147_length_240_cov_80.744681	167	238	3	8	71	0.1126761
NODE_300147_length_240_cov_80.744681	167	238	5	15	71	0.2112676
NODE_300148_length_240_cov_38.035461	31	82	2	26	51	0.5098040
NODE_300148_length_240_cov_38.035461	31	82	4	25	51	0.4901961
NODE_300165_length_239_cov_72.878571	0	48	1	25	48	0.5208333
NODE_300165_length_239_cov_72.878571	0	48	2	8	48	0.1666667
NODE_300165_length_239_cov_72.878571	0	48	3	1	48	0.0208333
NODE_300165_length_239_cov_72.878571	0	48	5	14	48	0.2916667
NODE_300165_length_239_cov_72.878571	21	101	1	4	80	0.0500000
NODE_300165_length_239_cov_72.878571	21	101	2	8	80	0.1000000
NODE_300165_length_239_cov_72.878571	21	101	3	1	80	0.0125000
NODE_300165_length_239_cov_72.878571	21	101	5	15	80	0.1875000
NODE_300165_length_239_cov_72.878571	21	101	6	8	80	0.1000000
NODE_300165_length_239_cov_72.878571	21	101	8	14	80	0.1750000
NODE_300165_length_239_cov_72.878571	21	101	10	7	80	0.0875000
NODE_300165_length_239_cov_72.878571	21	101	12	4	80	0.0500000
NODE_300165_length_239_cov_72.878571	21	101	13	1	80	0.0125000
NODE_300165_length_239_cov_72.878571	21	101	14	18	80	0.2250000
NODE_300165_length_239_cov_72.878571	150	230	2	21	80	0.2625000
NODE_300165_length_239_cov_72.878571	150	230	4	10	80	0.1250000
NODE_300165_length_239_cov_72.878571	150	230	5	7	80	0.0875000
NODE_300165_length_239_cov_72.878571	150	230	7	1	80	0.0125000
NODE_300165_length_239_cov_72.878571	150	230	9	8	80	0.1000000
NODE_300165_length_239_cov_72.878571	150	230	10	8	80	0.1000000
NODE_300165_length_239_cov_72.878571	150	230	11	25	80	0.3125000
NODE_300165_length_239_cov_72.878571	150	230	2	21	80	0.2625000
NODE_300165_length_239_cov_72.878571	150	230	4	10	80	0.1250000
NODE_300165_length_239_cov_72.878571	150	230	5	7	80	0.0875000
NODE_300165_length_239_cov_72.878571	150	230	7	1	80	0.0125000
NODE_300165_length_239_cov_72.878571	150	230	9	8	80	0.1000000
NODE_300165_length_239_cov_72.878571	150	230	10	8	80	0.1000000
NODE_300165_length_239_cov_72.878571	150	230	11	25	80	0.3125000
NODE_300165_length_239_cov_72.878571	150	212	2	3	62	0.0483871
NODE_300165_length_239_cov_72.878571	150	212	4	10	62	0.1612903
NODE_300165_length_239_cov_72.878571	150	212	5	7	62	0.1129032
NODE_300165_length_239_cov_72.878571	150	212	7	1	62	0.0161290
NODE_300165_length_239_cov_72.878571	150	212	9	8	62	0.1290323
NODE_300165_length_239_cov_72.878571	150	212	10	8	62	0.1290323
NODE_300165_length_239_cov_72.878571	150	212	11	25	62	0.4032258
NODE_300165_length_239_cov_72.878571	150	221	2	12	71	0.1690141
NODE_300165_length_239_cov_72.878571	150	221	4	10	71	0.1408451
NODE_300165_length_239_cov_72.878571	150	221	5	7	71	0.0985916
NODE_300165_length_239_cov_72.878571	150	221	7	1	71	0.0140845
NODE_300165_length_239_cov_72.878571	150	221	9	8	71	0.1126761
NODE_300165_length_239_cov_72.878571	150	221	10	8	71	0.1126761
NODE_300165_length_239_cov_72.878571	150	221	11	25	71	0.3521127
NODE_300208_length_238_cov_385.683453	35	104	49	1	69	0.0144928
NODE_300208_length_238_cov_385.683453	35	104	50	1	69	0.0144928
NODE_300208_length_238_cov_385.683453	35	104	55	2	69	0.0289855
NODE_300208_length_238_cov_385.683453	35	104	58	2	69	0.0289855
NODE_300208_length_238_cov_385.683453	35	104	61	4	69	0.0579710
NODE_300208_length_238_cov_385.683453	35	104	64	2	69	0.0289855
NODE_300208_length_238_cov_385.683453	35	104	66	2	69	0.0289855
NODE_300208_length_238_cov_385.683453	35	104	69	6	69	0.0869565
NODE_300208_length_238_cov_385.683453	35	104	71	1	69	0.0144928
NODE_300208_length_238_cov_385.683453	35	104	72	1	69	0.0144928
NODE_300208_length_238_cov_385.683453	35	104	73	1	69	0.0144928
NODE_300208_length_238_cov_385.683453	35	104	74	1	69	0.0144928
NODE_300208_length_238_cov_385.683453	35	104	75	2	69	0.0289855
NODE_300208_length_238_cov_385.683453	35	104	76	3	69	0.0434783
NODE_300208_length_238_cov_385.683453	35	104	77	1	69	0.0144928
NODE_300208_length_238_cov_385.683453	35	104	81	2	69	0.0289855
NODE_300208_length_238_cov_385.683453	35	104	83	4	69	0.0579710
NODE_300208_length_238_cov_385.683453	35	104	84	1	69	0.0144928
NODE_300208_length_238_cov_385.683453	35	104	86	1	69	0.0144928
NODE_300208_length_238_cov_385.683453	35	104	87	2	69	0.0289855
NODE_300208_length_238_cov_385.683453	35	104	89	3	69	0.0434783
NODE_300208_length_238_cov_385.683453	35	104	90	2	69	0.0289855
NODE_300208_length_238_cov_385.683453	35	104	92	1	69	0.0144928
NODE_300208_length_238_cov_385.683453	35	104	93	9	69	0.1304348
NODE_300208_length_238_cov_385.683453	35	104	94	14	69	0.2028985
NODE_300225_length_237_cov_101.543478	83	163	11	1	80	0.0125000
NODE_300225_length_237_cov_101.543478	83	163	12	1	80	0.0125000
NODE_300225_length_237_cov_101.543478	83	163	13	18	80	0.2250000
NODE_300225_length_237_cov_101.543478	83	163	14	7	80	0.0875000
NODE_300225_length_237_cov_101.543478	83	163	15	53	80	0.6625000
NODE_300225_length_237_cov_101.543478	83	163	11	1	80	0.0125000
NODE_300225_length_237_cov_101.543478	83	163	12	1	80	0.0125000
NODE_300225_length_237_cov_101.543478	83	163	13	18	80	0.2250000
NODE_300225_length_237_cov_101.543478	83	163	14	7	80	0.0875000
NODE_300225_length_237_cov_101.543478	83	163	15	53	80	0.6625000
NODE_300225_length_237_cov_101.543478	83	163	11	1	80	0.0125000
NODE_300225_length_237_cov_101.543478	83	163	12	1	80	0.0125000
NODE_300225_length_237_cov_101.543478	83	163	13	18	80	0.2250000
NODE_300225_length_237_cov_101.543478	83	163	14	7	80	0.0875000
NODE_300225_length_237_cov_101.543478	83	163	15	53	80	0.6625000
NODE_300225_length_237_cov_101.543478	83	163	11	1	80	0.0125000
NODE_300225_length_237_cov_101.543478	83	163	12	1	80	0.0125000
NODE_300225_length_237_cov_101.543478	83	163	13	18	80	0.2250000
NODE_300225_length_237_cov_101.543478	83	163	14	7	80	0.0875000
NODE_300225_length_237_cov_101.543478	83	163	15	53	80	0.6625000
NODE_300225_length_237_cov_101.543478	136	216	8	9	80	0.1125000
NODE_300225_length_237_cov_101.543478	136	216	9	8	80	0.1000000
NODE_300225_length_237_cov_101.543478	136	216	10	20	80	0.2500000
NODE_300225_length_237_cov_101.543478	136	216	11	10	80	0.1250000
NODE_300225_length_237_cov_101.543478	136	216	12	4	80	0.0500000
NODE_300225_length_237_cov_101.543478	136	216	13	2	80	0.0250000
NODE_300225_length_237_cov_101.543478	136	216	14	5	80	0.0625000
NODE_300225_length_237_cov_101.543478	136	216	15	22	80	0.2750000
NODE_300225_length_237_cov_101.543478	136	216	8	9	80	0.1125000
NODE_300225_length_237_cov_101.543478	136	216	9	8	80	0.1000000
NODE_300225_length_237_cov_101.543478	136	216	10	20	80	0.2500000
NODE_300225_length_237_cov_101.543478	136	216	11	10	80	0.1250000
NODE_300225_length_237_cov_101.543478	136	216	12	4	80	0.0500000
NODE_300225_length_237_cov_101.543478	136	216	13	2	80	0.0250000
NODE_300225_length_237_cov_101.543478	136	216	14	5	80	0.0625000
NODE_300225_length_237_cov_101.543478	136	216	15	22	80	0.2750000
NODE_300225_length_237_cov_101.543478	136	216	8	9	80	0.1125000
NODE_300225_length_237_cov_101.543478	136	216	9	8	80	0.1000000
NODE_300225_length_237_cov_101.543478	136	216	10	20	80	0.2500000
NODE_300225_length_237_cov_101.543478	136	216	11	10	80	0.1250000
NODE_300225_length_237_cov_101.543478	136	216	12	4	80	0.0500000
NODE_300225_length_237_cov_101.543478	136	216	13	2	80	0.0250000
NODE_300225_length_237_cov_101.543478	136	216	14	5	80	0.0625000
NODE_300225_length_237_cov_101.543478	136	216	15	22	80	0.2750000
NODE_300225_length_237_cov_101.543478	138	216	8	9	78	0.1153846
NODE_300225_length_237_cov_101.543478	138	216	9	8	78	0.1025641
NODE_300225_length_237_cov_101.543478	138	216	10	20	78	0.2564103
NODE_300225_length_237_cov_101.543478	138	216	11	10	78	0.1282051
NODE_300225_length_237_cov_101.543478	138	216	12	4	78	0.0512821
NODE_300225_length_237_cov_101.543478	138	216	13	2	78	0.0256410
NODE_300225_length_237_cov_101.543478	138	216	14	5	78	0.0641026
NODE_300225_length_237_cov_101.543478	138	216	15	20	78	0.2564103
NODE_300225_length_237_cov_101.543478	138	216	8	9	78	0.1153846
NODE_300225_length_237_cov_101.543478	138	216	9	8	78	0.1025641
NODE_300225_length_237_cov_101.543478	138	216	10	20	78	0.2564103
NODE_300225_length_237_cov_101.543478	138	216	11	10	78	0.1282051
NODE_300225_length_237_cov_101.543478	138	216	12	4	78	0.0512821
NODE_300225_length_237_cov_101.543478	138	216	13	2	78	0.0256410
NODE_300225_length_237_cov_101.543478	138	216	14	5	78	0.0641026
NODE_300225_length_237_cov_101.543478	138	216	15	20	78	0.2564103
NODE_300227_length_237_cov_49.623188	13	88	0	75	75	1.0000000
NODE_300227_length_237_cov_49.623188	73	153	0	80	80	1.0000000
NODE_300227_length_237_cov_49.623188	126	206	0	80	80	1.0000000
NODE_300289_length_235_cov_67.904412	0	62	0	4	62	0.0645161
NODE_300289_length_235_cov_67.904412	0	62	1	6	62	0.0967742
NODE_300289_length_235_cov_67.904412	0	62	2	36	62	0.5806451
NODE_300289_length_235_cov_67.904412	0	62	3	10	62	0.1612903
NODE_300289_length_235_cov_67.904412	0	62	4	6	62	0.0967742
NODE_300289_length_235_cov_67.904412	25	111	2	21	86	0.2441860
NODE_300289_length_235_cov_67.904412	25	111	3	10	86	0.1162791
NODE_300289_length_235_cov_67.904412	25	111	4	9	86	0.1046512
NODE_300289_length_235_cov_67.904412	25	111	5	46	86	0.5348837
NODE_300289_length_235_cov_67.904412	69	150	4	4	81	0.0493827
NODE_300289_length_235_cov_67.904412	69	150	5	77	81	0.9506173
NODE_300289_length_235_cov_67.904412	113	194	3	34	81	0.4197531
NODE_300289_length_235_cov_67.904412	113	194	4	14	81	0.1728395
NODE_300289_length_235_cov_67.904412	113	194	5	33	81	0.4074074
NODE_300289_length_235_cov_67.904412	157	235	0	23	78	0.2948718
NODE_300289_length_235_cov_67.904412	157	235	1	6	78	0.0769231
NODE_300289_length_235_cov_67.904412	157	235	2	10	78	0.1282051
NODE_300289_length_235_cov_67.904412	157	235	3	36	78	0.4615385
NODE_300289_length_235_cov_67.904412	157	235	4	3	78	0.0384615
NODE_300322_length_234_cov_76.496296	0	76	0	8	76	0.1052632
NODE_300322_length_234_cov_76.496296	0	76	2	2	76	0.0263158
NODE_300322_length_234_cov_76.496296	0	76	3	14	76	0.1842105
NODE_300322_length_234_cov_76.496296	0	76	4	15	76	0.1973684
NODE_300322_length_234_cov_76.496296	0	76	5	5	76	0.0657895
NODE_300322_length_234_cov_76.496296	0	76	6	12	76	0.1578947
NODE_300322_length_234_cov_76.496296	0	76	8	7	76	0.0921053
NODE_300322_length_234_cov_76.496296	0	76	11	10	76	0.1315790
NODE_300322_length_234_cov_76.496296	0	76	12	3	76	0.0394737
NODE_300322_length_234_cov_76.496296	0	76	0	8	76	0.1052632
NODE_300322_length_234_cov_76.496296	0	76	2	2	76	0.0263158
NODE_300322_length_234_cov_76.496296	0	76	3	14	76	0.1842105
NODE_300322_length_234_cov_76.496296	0	76	4	15	76	0.1973684
NODE_300322_length_234_cov_76.496296	0	76	5	5	76	0.0657895
NODE_300322_length_234_cov_76.496296	0	76	6	12	76	0.1578947
NODE_300322_length_234_cov_76.496296	0	76	8	7	76	0.0921053
NODE_300322_length_234_cov_76.496296	0	76	11	10	76	0.1315790
NODE_300322_length_234_cov_76.496296	0	76	12	3	76	0.0394737
NODE_300322_length_234_cov_76.496296	0	76	0	8	76	0.1052632
NODE_300322_length_234_cov_76.496296	0	76	2	2	76	0.0263158
NODE_300322_length_234_cov_76.496296	0	76	3	14	76	0.1842105
NODE_300322_length_234_cov_76.496296	0	76	4	15	76	0.1973684
NODE_300322_length_234_cov_76.496296	0	76	5	5	76	0.0657895
NODE_300322_length_234_cov_76.496296	0	76	6	12	76	0.1578947
NODE_300322_length_234_cov_76.496296	0	76	8	7	76	0.0921053
NODE_300322_length_234_cov_76.496296	0	76	11	10	76	0.1315790
NODE_300322_length_234_cov_76.496296	0	76	12	3	76	0.0394737
NODE_300322_length_234_cov_76.496296	0	76	0	8	76	0.1052632
NODE_300322_length_234_cov_76.496296	0	76	2	2	76	0.0263158
NODE_300322_length_234_cov_76.496296	0	76	3	14	76	0.1842105
NODE_300322_length_234_cov_76.496296	0	76	4	15	76	0.1973684
NODE_300322_length_234_cov_76.496296	0	76	5	5	76	0.0657895
NODE_300322_length_234_cov_76.496296	0	76	6	12	76	0.1578947
NODE_300322_length_234_cov_76.496296	0	76	8	7	76	0.0921053
NODE_300322_length_234_cov_76.496296	0	76	11	10	76	0.1315790
NODE_300322_length_234_cov_76.496296	0	76	12	3	76	0.0394737
NODE_300322_length_234_cov_76.496296	49	128	6	7	79	0.0886076
NODE_300322_length_234_cov_76.496296	49	128	8	7	79	0.0886076
NODE_300322_length_234_cov_76.496296	49	128	11	10	79	0.1265823
NODE_300322_length_234_cov_76.496296	49	128	12	3	79	0.0379747
NODE_300322_length_234_cov_76.496296	49	128	13	12	79	0.1518987
NODE_300322_length_234_cov_76.496296	49	128	15	34	79	0.4303797
NODE_300322_length_234_cov_76.496296	49	128	17	6	79	0.0759494
NODE_300322_length_234_cov_76.496296	49	128	6	7	79	0.0886076
NODE_300322_length_234_cov_76.496296	49	128	8	7	79	0.0886076
NODE_300322_length_234_cov_76.496296	49	128	11	10	79	0.1265823
NODE_300322_length_234_cov_76.496296	49	128	12	3	79	0.0379747
NODE_300322_length_234_cov_76.496296	49	128	13	12	79	0.1518987
NODE_300322_length_234_cov_76.496296	49	128	15	34	79	0.4303797
NODE_300322_length_234_cov_76.496296	49	128	17	6	79	0.0759494
NODE_300322_length_234_cov_76.496296	124	204	11	10	80	0.1250000
NODE_300322_length_234_cov_76.496296	124	204	12	5	80	0.0625000
NODE_300322_length_234_cov_76.496296	124	204	13	15	80	0.1875000
NODE_300322_length_234_cov_76.496296	124	204	14	14	80	0.1750000
NODE_300322_length_234_cov_76.496296	124	204	15	11	80	0.1375000
NODE_300322_length_234_cov_76.496296	124	204	17	10	80	0.1250000
NODE_300322_length_234_cov_76.496296	124	204	19	15	80	0.1875000
NODE_300322_length_234_cov_76.496296	124	204	11	10	80	0.1250000
NODE_300322_length_234_cov_76.496296	124	204	12	5	80	0.0625000
NODE_300322_length_234_cov_76.496296	124	204	13	15	80	0.1875000
NODE_300322_length_234_cov_76.496296	124	204	14	14	80	0.1750000
NODE_300322_length_234_cov_76.496296	124	204	15	11	80	0.1375000
NODE_300322_length_234_cov_76.496296	124	204	17	10	80	0.1250000
NODE_300322_length_234_cov_76.496296	124	204	19	15	80	0.1875000
NODE_300322_length_234_cov_76.496296	124	204	11	10	80	0.1250000
NODE_300322_length_234_cov_76.496296	124	204	12	5	80	0.0625000
NODE_300322_length_234_cov_76.496296	124	204	13	15	80	0.1875000
NODE_300322_length_234_cov_76.496296	124	204	14	14	80	0.1750000
NODE_300322_length_234_cov_76.496296	124	204	15	11	80	0.1375000
NODE_300322_length_234_cov_76.496296	124	204	17	10	80	0.1250000
NODE_300322_length_234_cov_76.496296	124	204	19	15	80	0.1875000
NODE_300322_length_234_cov_76.496296	177	226	1	3	49	0.0612245
NODE_300322_length_234_cov_76.496296	177	226	2	1	49	0.0204082
NODE_300322_length_234_cov_76.496296	177	226	4	9	49	0.1836735
NODE_300322_length_234_cov_76.496296	177	226	5	5	49	0.1020408
NODE_300322_length_234_cov_76.496296	177	226	7	2	49	0.0408163
NODE_300322_length_234_cov_76.496296	177	226	11	12	49	0.2448980
NODE_300322_length_234_cov_76.496296	177	226	12	5	49	0.1020408
NODE_300322_length_234_cov_76.496296	177	226	13	12	49	0.2448980
NODE_300322_length_234_cov_76.496296	177	234	0	8	57	0.1403509
NODE_300322_length_234_cov_76.496296	177	234	1	3	57	0.0526316
NODE_300322_length_234_cov_76.496296	177	234	2	1	57	0.0175439
NODE_300322_length_234_cov_76.496296	177	234	4	9	57	0.1578947
NODE_300322_length_234_cov_76.496296	177	234	5	5	57	0.0877193
NODE_300322_length_234_cov_76.496296	177	234	7	2	57	0.0350877
NODE_300322_length_234_cov_76.496296	177	234	11	12	57	0.2105263
NODE_300322_length_234_cov_76.496296	177	234	12	5	57	0.0877193
NODE_300322_length_234_cov_76.496296	177	234	13	12	57	0.2105263
NODE_300322_length_234_cov_76.496296	182	234	0	8	52	0.1538462
NODE_300322_length_234_cov_76.496296	182	234	1	3	52	0.0576923
NODE_300322_length_234_cov_76.496296	182	234	2	1	52	0.0192308
NODE_300322_length_234_cov_76.496296	182	234	4	9	52	0.1730769
NODE_300322_length_234_cov_76.496296	182	234	5	5	52	0.0961538
NODE_300322_length_234_cov_76.496296	182	234	7	2	52	0.0384615
NODE_300322_length_234_cov_76.496296	182	234	11	12	52	0.2307692
NODE_300322_length_234_cov_76.496296	182	234	12	5	52	0.0961538
NODE_300322_length_234_cov_76.496296	182	234	13	7	52	0.1346154
NODE_300323_length_234_cov_71.548148	90	162	0	72	72	1.0000000
NODE_300323_length_234_cov_71.548148	90	162	0	72	72	1.0000000
NODE_300323_length_234_cov_71.548148	135	215	0	80	80	1.0000000
NODE_300323_length_234_cov_71.548148	135	215	0	80	80	1.0000000
NODE_300357_length_233_cov_180.701493	0	65	4	12	65	0.1846154
NODE_300357_length_233_cov_180.701493	0	65	5	10	65	0.1538462
NODE_300357_length_233_cov_180.701493	0	65	7	28	65	0.4307692
NODE_300357_length_233_cov_180.701493	0	65	8	13	65	0.2000000
NODE_300357_length_233_cov_180.701493	0	65	9	2	65	0.0307692
NODE_300357_length_233_cov_180.701493	38	118	7	12	80	0.1500000
NODE_300357_length_233_cov_180.701493	38	118	8	13	80	0.1625000
NODE_300357_length_233_cov_180.701493	38	118	9	2	80	0.0250000
NODE_300357_length_233_cov_180.701493	38	118	10	53	80	0.6625000
NODE_300392_length_232_cov_132.045113	53	133	1	2	80	0.0250000
NODE_300392_length_232_cov_132.045113	53	133	2	16	80	0.2000000
NODE_300392_length_232_cov_132.045113	53	133	3	24	80	0.3000000
NODE_300392_length_232_cov_132.045113	53	133	8	4	80	0.0500000
NODE_300392_length_232_cov_132.045113	53	133	9	34	80	0.4250000
NODE_300392_length_232_cov_132.045113	106	186	7	4	80	0.0500000
NODE_300392_length_232_cov_132.045113	106	186	9	76	80	0.9500000
NODE_300471_length_230_cov_34.427481	0	59	0	59	59	1.0000000
NODE_300471_length_230_cov_34.427481	0	59	0	59	59	1.0000000
NODE_300471_length_230_cov_34.427481	10	59	0	49	49	1.0000000
NODE_300487_length_229_cov_76.907692	94	176	37	2	82	0.0243902
NODE_300487_length_229_cov_76.907692	94	176	38	6	82	0.0731707
NODE_300487_length_229_cov_76.907692	94	176	39	1	82	0.0121951
NODE_300487_length_229_cov_76.907692	94	176	41	4	82	0.0487805
NODE_300487_length_229_cov_76.907692	94	176	45	1	82	0.0121951
NODE_300487_length_229_cov_76.907692	94	176	47	1	82	0.0121951
NODE_300487_length_229_cov_76.907692	94	176	48	1	82	0.0121951
NODE_300487_length_229_cov_76.907692	94	176	51	3	82	0.0365854
NODE_300487_length_229_cov_76.907692	94	176	52	4	82	0.0487805
NODE_300487_length_229_cov_76.907692	94	176	54	4	82	0.0487805
NODE_300487_length_229_cov_76.907692	94	176	56	5	82	0.0609756
NODE_300487_length_229_cov_76.907692	94	176	58	2	82	0.0243902
NODE_300487_length_229_cov_76.907692	94	176	60	7	82	0.0853659
NODE_300487_length_229_cov_76.907692	94	176	64	3	82	0.0365854
NODE_300487_length_229_cov_76.907692	94	176	65	3	82	0.0365854
NODE_300487_length_229_cov_76.907692	94	176	67	3	82	0.0365854
NODE_300487_length_229_cov_76.907692	94	176	68	3	82	0.0365854
NODE_300487_length_229_cov_76.907692	94	176	70	1	82	0.0121951
NODE_300487_length_229_cov_76.907692	94	176	71	1	82	0.0121951
NODE_300487_length_229_cov_76.907692	94	176	72	1	82	0.0121951
NODE_300487_length_229_cov_76.907692	94	176	73	22	82	0.2682927
NODE_300487_length_229_cov_76.907692	94	176	75	4	82	0.0487805
NODE_300523_length_228_cov_127.131783	0	76	1	6	76	0.0789474
NODE_300523_length_228_cov_127.131783	0	76	2	17	76	0.2236842
NODE_300523_length_228_cov_127.131783	0	76	4	4	76	0.0526316
NODE_300523_length_228_cov_127.131783	0	76	6	8	76	0.1052632
NODE_300523_length_228_cov_127.131783	0	76	7	4	76	0.0526316
NODE_300523_length_228_cov_127.131783	0	76	9	1	76	0.0131579
NODE_300523_length_228_cov_127.131783	0	76	10	23	76	0.3026316
NODE_300523_length_228_cov_127.131783	0	76	14	6	76	0.0789474
NODE_300523_length_228_cov_127.131783	0	76	15	7	76	0.0921053
NODE_300523_length_228_cov_127.131783	5	76	1	1	71	0.0140845
NODE_300523_length_228_cov_127.131783	5	76	2	17	71	0.2394366
NODE_300523_length_228_cov_127.131783	5	76	4	4	71	0.0563380
NODE_300523_length_228_cov_127.131783	5	76	6	8	71	0.1126761
NODE_300523_length_228_cov_127.131783	5	76	7	4	71	0.0563380
NODE_300523_length_228_cov_127.131783	5	76	9	1	71	0.0140845
NODE_300523_length_228_cov_127.131783	5	76	10	23	71	0.3239437
NODE_300523_length_228_cov_127.131783	5	76	14	6	71	0.0845070
NODE_300523_length_228_cov_127.131783	5	76	15	7	71	0.0985916
NODE_300523_length_228_cov_127.131783	10	76	2	13	66	0.1969697
NODE_300523_length_228_cov_127.131783	10	76	4	4	66	0.0606061
NODE_300523_length_228_cov_127.131783	10	76	6	8	66	0.1212121
NODE_300523_length_228_cov_127.131783	10	76	7	4	66	0.0606061
NODE_300523_length_228_cov_127.131783	10	76	9	1	66	0.0151515
NODE_300523_length_228_cov_127.131783	10	76	10	23	66	0.3484848
NODE_300523_length_228_cov_127.131783	10	76	14	6	66	0.0909091
NODE_300523_length_228_cov_127.131783	10	76	15	7	66	0.1060606
NODE_300523_length_228_cov_127.131783	49	129	10	14	80	0.1750000
NODE_300523_length_228_cov_127.131783	49	129	14	6	80	0.0750000
NODE_300523_length_228_cov_127.131783	49	129	15	15	80	0.1875000
NODE_300523_length_228_cov_127.131783	49	129	18	20	80	0.2500000
NODE_300523_length_228_cov_127.131783	49	129	20	15	80	0.1875000
NODE_300523_length_228_cov_127.131783	49	129	24	10	80	0.1250000
NODE_300523_length_228_cov_127.131783	49	129	10	14	80	0.1750000
NODE_300523_length_228_cov_127.131783	49	129	14	6	80	0.0750000
NODE_300523_length_228_cov_127.131783	49	129	15	15	80	0.1875000
NODE_300523_length_228_cov_127.131783	49	129	18	20	80	0.2500000
NODE_300523_length_228_cov_127.131783	49	129	20	15	80	0.1875000
NODE_300523_length_228_cov_127.131783	49	129	24	10	80	0.1250000
NODE_300523_length_228_cov_127.131783	49	129	10	14	80	0.1750000
NODE_300523_length_228_cov_127.131783	49	129	14	6	80	0.0750000
NODE_300523_length_228_cov_127.131783	49	129	15	15	80	0.1875000
NODE_300523_length_228_cov_127.131783	49	129	18	20	80	0.2500000
NODE_300523_length_228_cov_127.131783	49	129	20	15	80	0.1875000
NODE_300523_length_228_cov_127.131783	49	129	24	10	80	0.1250000
NODE_300523_length_228_cov_127.131783	125	205	8	15	80	0.1875000
NODE_300523_length_228_cov_127.131783	125	205	9	1	80	0.0125000
NODE_300523_length_228_cov_127.131783	125	205	11	3	80	0.0375000
NODE_300523_length_228_cov_127.131783	125	205	12	1	80	0.0125000
NODE_300523_length_228_cov_127.131783	125	205	14	8	80	0.1000000
NODE_300523_length_228_cov_127.131783	125	205	16	22	80	0.2750000
NODE_300523_length_228_cov_127.131783	125	205	17	11	80	0.1375000
NODE_300523_length_228_cov_127.131783	125	205	18	19	80	0.2375000
NODE_300523_length_228_cov_127.131783	125	205	8	15	80	0.1875000
NODE_300523_length_228_cov_127.131783	125	205	9	1	80	0.0125000
NODE_300523_length_228_cov_127.131783	125	205	11	3	80	0.0375000
NODE_300523_length_228_cov_127.131783	125	205	12	1	80	0.0125000
NODE_300523_length_228_cov_127.131783	125	205	14	8	80	0.1000000
NODE_300523_length_228_cov_127.131783	125	205	16	22	80	0.2750000
NODE_300523_length_228_cov_127.131783	125	205	17	11	80	0.1375000
NODE_300523_length_228_cov_127.131783	125	205	18	19	80	0.2375000
NODE_300523_length_228_cov_127.131783	125	205	8	15	80	0.1875000
NODE_300523_length_228_cov_127.131783	125	205	9	1	80	0.0125000
NODE_300523_length_228_cov_127.131783	125	205	11	3	80	0.0375000
NODE_300523_length_228_cov_127.131783	125	205	12	1	80	0.0125000
NODE_300523_length_228_cov_127.131783	125	205	14	8	80	0.1000000
NODE_300523_length_228_cov_127.131783	125	205	16	22	80	0.2750000
NODE_300523_length_228_cov_127.131783	125	205	17	11	80	0.1375000
NODE_300523_length_228_cov_127.131783	125	205	18	19	80	0.2375000
NODE_300523_length_228_cov_127.131783	178	228	7	9	50	0.1800000
NODE_300523_length_228_cov_127.131783	178	228	8	29	50	0.5800000
NODE_300523_length_228_cov_127.131783	178	228	9	1	50	0.0200000
NODE_300523_length_228_cov_127.131783	178	228	11	3	50	0.0600000
NODE_300523_length_228_cov_127.131783	178	228	12	1	50	0.0200000
NODE_300523_length_228_cov_127.131783	178	228	14	7	50	0.1400000
NODE_300523_length_228_cov_127.131783	178	228	7	9	50	0.1800000
NODE_300523_length_228_cov_127.131783	178	228	8	29	50	0.5800000
NODE_300523_length_228_cov_127.131783	178	228	9	1	50	0.0200000
NODE_300523_length_228_cov_127.131783	178	228	11	3	50	0.0600000
NODE_300523_length_228_cov_127.131783	178	228	12	1	50	0.0200000
NODE_300523_length_228_cov_127.131783	178	228	14	7	50	0.1400000
NODE_300523_length_228_cov_127.131783	178	228	7	9	50	0.1800000
NODE_300523_length_228_cov_127.131783	178	228	8	29	50	0.5800000
NODE_300523_length_228_cov_127.131783	178	228	9	1	50	0.0200000
NODE_300523_length_228_cov_127.131783	178	228	11	3	50	0.0600000
NODE_300523_length_228_cov_127.131783	178	228	12	1	50	0.0200000
NODE_300523_length_228_cov_127.131783	178	228	14	7	50	0.1400000
NODE_300524_length_228_cov_94.255814	34	99	0	7	65	0.1076923
NODE_300524_length_228_cov_94.255814	34	99	2	20	65	0.3076923
NODE_300524_length_228_cov_94.255814	34	99	3	6	65	0.0923077
NODE_300524_length_228_cov_94.255814	34	99	5	15	65	0.2307692
NODE_300524_length_228_cov_94.255814	34	99	6	12	65	0.1846154
NODE_300524_length_228_cov_94.255814	34	99	8	1	65	0.0153846
NODE_300524_length_228_cov_94.255814	34	99	10	4	65	0.0615385
NODE_300524_length_228_cov_94.255814	34	114	0	7	80	0.0875000
NODE_300524_length_228_cov_94.255814	34	114	2	20	80	0.2500000
NODE_300524_length_228_cov_94.255814	34	114	3	6	80	0.0750000
NODE_300524_length_228_cov_94.255814	34	114	5	15	80	0.1875000
NODE_300524_length_228_cov_94.255814	34	114	6	12	80	0.1500000
NODE_300524_length_228_cov_94.255814	34	114	8	1	80	0.0125000
NODE_300524_length_228_cov_94.255814	34	114	10	6	80	0.0750000
NODE_300524_length_228_cov_94.255814	34	114	12	13	80	0.1625000
NODE_300524_length_228_cov_94.255814	41	111	2	20	70	0.2857143
NODE_300524_length_228_cov_94.255814	41	111	3	6	70	0.0857143
NODE_300524_length_228_cov_94.255814	41	111	5	15	70	0.2142857
NODE_300524_length_228_cov_94.255814	41	111	6	12	70	0.1714286
NODE_300524_length_228_cov_94.255814	41	111	8	1	70	0.0142857
NODE_300524_length_228_cov_94.255814	41	111	10	6	70	0.0857143
NODE_300524_length_228_cov_94.255814	41	111	12	10	70	0.1428571
NODE_300524_length_228_cov_94.255814	43	114	2	18	71	0.2535211
NODE_300524_length_228_cov_94.255814	43	114	3	6	71	0.0845070
NODE_300524_length_228_cov_94.255814	43	114	5	15	71	0.2112676
NODE_300524_length_228_cov_94.255814	43	114	6	12	71	0.1690141
NODE_300524_length_228_cov_94.255814	43	114	8	1	71	0.0140845
NODE_300524_length_228_cov_94.255814	43	114	10	6	71	0.0845070
NODE_300524_length_228_cov_94.255814	43	114	12	13	71	0.1830986
NODE_300524_length_228_cov_94.255814	87	167	6	7	80	0.0875000
NODE_300524_length_228_cov_94.255814	87	167	8	1	80	0.0125000
NODE_300524_length_228_cov_94.255814	87	167	10	19	80	0.2375000
NODE_300524_length_228_cov_94.255814	87	167	12	53	80	0.6625000
NODE_300524_length_228_cov_94.255814	87	167	6	7	80	0.0875000
NODE_300524_length_228_cov_94.255814	87	167	8	1	80	0.0125000
NODE_300524_length_228_cov_94.255814	87	167	10	19	80	0.2375000
NODE_300524_length_228_cov_94.255814	87	167	12	53	80	0.6625000
NODE_300524_length_228_cov_94.255814	87	167	6	7	80	0.0875000
NODE_300524_length_228_cov_94.255814	87	167	8	1	80	0.0125000
NODE_300524_length_228_cov_94.255814	87	167	10	19	80	0.2375000
NODE_300524_length_228_cov_94.255814	87	167	12	53	80	0.6625000
NODE_300524_length_228_cov_94.255814	87	167	6	7	80	0.0875000
NODE_300524_length_228_cov_94.255814	87	167	8	1	80	0.0125000
NODE_300524_length_228_cov_94.255814	87	167	10	19	80	0.2375000
NODE_300524_length_228_cov_94.255814	87	167	12	53	80	0.6625000
NODE_300547_length_228_cov_0.395349	27	107	0	80	80	1.0000000
NODE_300547_length_228_cov_0.395349	70	150	0	80	80	1.0000000
NODE_300556_length_227_cov_37.429688	40	111	1	7	71	0.0985916
NODE_300556_length_227_cov_37.429688	40	111	2	53	71	0.7464789
NODE_300556_length_227_cov_37.429688	40	111	3	6	71	0.0845070
NODE_300556_length_227_cov_37.429688	40	111	4	5	71	0.0704225
NODE_300556_length_227_cov_37.429688	49	112	2	51	63	0.8095238
NODE_300556_length_227_cov_37.429688	49	112	3	6	63	0.0952381
NODE_300556_length_227_cov_37.429688	49	112	4	6	63	0.0952381
NODE_300556_length_227_cov_37.429688	93	172	2	7	79	0.0886076
NODE_300556_length_227_cov_37.429688	93	172	3	6	79	0.0759494
NODE_300556_length_227_cov_37.429688	93	172	4	66	79	0.8354430
NODE_300556_length_227_cov_37.429688	168	227	2	30	59	0.5084746
NODE_300556_length_227_cov_37.429688	168	227	3	12	59	0.2033898
NODE_300556_length_227_cov_37.429688	168	227	4	17	59	0.2881356
NODE_300556_length_227_cov_37.429688	168	227	2	30	59	0.5084746
NODE_300556_length_227_cov_37.429688	168	227	3	12	59	0.2033898
NODE_300556_length_227_cov_37.429688	168	227	4	17	59	0.2881356
NODE_300595_length_226_cov_547.629921	82	162	339	1	80	0.0125000
NODE_300595_length_226_cov_547.629921	82	162	341	1	80	0.0125000
NODE_300595_length_226_cov_547.629921	82	162	342	1	80	0.0125000
NODE_300595_length_226_cov_547.629921	82	162	343	1	80	0.0125000
NODE_300595_length_226_cov_547.629921	82	162	348	1	80	0.0125000
NODE_300595_length_226_cov_547.629921	82	162	353	1	80	0.0125000
NODE_300595_length_226_cov_547.629921	82	162	357	1	80	0.0125000
NODE_300595_length_226_cov_547.629921	82	162	360	1	80	0.0125000
NODE_300595_length_226_cov_547.629921	82	162	361	1	80	0.0125000
NODE_300595_length_226_cov_547.629921	82	162	364	1	80	0.0125000
NODE_300595_length_226_cov_547.629921	82	162	366	2	80	0.0250000
NODE_300595_length_226_cov_547.629921	82	162	367	1	80	0.0125000
NODE_300595_length_226_cov_547.629921	82	162	368	3	80	0.0375000
NODE_300595_length_226_cov_547.629921	82	162	370	3	80	0.0375000
NODE_300595_length_226_cov_547.629921	82	162	371	3	80	0.0375000
NODE_300595_length_226_cov_547.629921	82	162	373	1	80	0.0125000
NODE_300595_length_226_cov_547.629921	82	162	374	1	80	0.0125000
NODE_300595_length_226_cov_547.629921	82	162	375	2	80	0.0250000
NODE_300595_length_226_cov_547.629921	82	162	376	2	80	0.0250000
NODE_300595_length_226_cov_547.629921	82	162	379	1	80	0.0125000
NODE_300595_length_226_cov_547.629921	82	162	381	1	80	0.0125000
NODE_300595_length_226_cov_547.629921	82	162	382	1	80	0.0125000
NODE_300595_length_226_cov_547.629921	82	162	384	1	80	0.0125000
NODE_300595_length_226_cov_547.629921	82	162	385	1	80	0.0125000
NODE_300595_length_226_cov_547.629921	82	162	388	1	80	0.0125000
NODE_300595_length_226_cov_547.629921	82	162	390	1	80	0.0125000
NODE_300595_length_226_cov_547.629921	82	162	391	1	80	0.0125000
NODE_300595_length_226_cov_547.629921	82	162	392	1	80	0.0125000
NODE_300595_length_226_cov_547.629921	82	162	393	1	80	0.0125000
NODE_300595_length_226_cov_547.629921	82	162	394	3	80	0.0375000
NODE_300595_length_226_cov_547.629921	82	162	395	1	80	0.0125000
NODE_300595_length_226_cov_547.629921	82	162	396	1	80	0.0125000
NODE_300595_length_226_cov_547.629921	82	162	400	1	80	0.0125000
NODE_300595_length_226_cov_547.629921	82	162	401	2	80	0.0250000
NODE_300595_length_226_cov_547.629921	82	162	402	1	80	0.0125000
NODE_300595_length_226_cov_547.629921	82	162	403	1	80	0.0125000
NODE_300595_length_226_cov_547.629921	82	162	404	1	80	0.0125000
NODE_300595_length_226_cov_547.629921	82	162	405	2	80	0.0250000
NODE_300595_length_226_cov_547.629921	82	162	407	2	80	0.0250000
NODE_300595_length_226_cov_547.629921	82	162	408	3	80	0.0375000
NODE_300595_length_226_cov_547.629921	82	162	409	2	80	0.0250000
NODE_300595_length_226_cov_547.629921	82	162	410	3	80	0.0375000
NODE_300595_length_226_cov_547.629921	82	162	411	4	80	0.0500000
NODE_300595_length_226_cov_547.629921	82	162	413	5	80	0.0625000
NODE_300595_length_226_cov_547.629921	82	162	414	2	80	0.0250000
NODE_300595_length_226_cov_547.629921	82	162	415	5	80	0.0625000
NODE_300595_length_226_cov_547.629921	82	162	416	3	80	0.0375000
NODE_300617_length_225_cov_41.269841	81	165	1	4	84	0.0476190
NODE_300617_length_225_cov_41.269841	81	165	3	5	84	0.0595238
NODE_300617_length_225_cov_41.269841	81	165	4	3	84	0.0357143
NODE_300617_length_225_cov_41.269841	81	165	6	4	84	0.0476190
NODE_300617_length_225_cov_41.269841	81	165	7	5	84	0.0595238
NODE_300617_length_225_cov_41.269841	81	165	8	63	84	0.7500000
NODE_300617_length_225_cov_41.269841	134	218	1	57	84	0.6785714
NODE_300617_length_225_cov_41.269841	134	218	3	5	84	0.0595238
NODE_300617_length_225_cov_41.269841	134	218	4	3	84	0.0357143
NODE_300617_length_225_cov_41.269841	134	218	6	4	84	0.0476190
NODE_300617_length_225_cov_41.269841	134	218	7	5	84	0.0595238
NODE_300617_length_225_cov_41.269841	134	218	8	10	84	0.1190476
NODE_300661_length_224_cov_209.528000	12	84	35	5	72	0.0694444
NODE_300661_length_224_cov_209.528000	12	84	38	1	72	0.0138889
NODE_300661_length_224_cov_209.528000	12	84	41	2	72	0.0277778
NODE_300661_length_224_cov_209.528000	12	84	45	1	72	0.0138889
NODE_300661_length_224_cov_209.528000	12	84	46	1	72	0.0138889
NODE_300661_length_224_cov_209.528000	12	84	47	1	72	0.0138889
NODE_300661_length_224_cov_209.528000	12	84	50	1	72	0.0138889
NODE_300661_length_224_cov_209.528000	12	84	51	2	72	0.0277778
NODE_300661_length_224_cov_209.528000	12	84	54	1	72	0.0138889
NODE_300661_length_224_cov_209.528000	12	84	55	1	72	0.0138889
NODE_300661_length_224_cov_209.528000	12	84	58	1	72	0.0138889
NODE_300661_length_224_cov_209.528000	12	84	60	3	72	0.0416667
NODE_300661_length_224_cov_209.528000	12	84	63	2	72	0.0277778
NODE_300661_length_224_cov_209.528000	12	84	64	2	72	0.0277778
NODE_300661_length_224_cov_209.528000	12	84	66	1	72	0.0138889
NODE_300661_length_224_cov_209.528000	12	84	67	2	72	0.0277778
NODE_300661_length_224_cov_209.528000	12	84	69	2	72	0.0277778
NODE_300661_length_224_cov_209.528000	12	84	71	2	72	0.0277778
NODE_300661_length_224_cov_209.528000	12	84	73	1	72	0.0138889
NODE_300661_length_224_cov_209.528000	12	84	74	2	72	0.0277778
NODE_300661_length_224_cov_209.528000	12	84	75	1	72	0.0138889
NODE_300661_length_224_cov_209.528000	12	84	78	1	72	0.0138889
NODE_300661_length_224_cov_209.528000	12	84	80	2	72	0.0277778
NODE_300661_length_224_cov_209.528000	12	84	84	4	72	0.0555556
NODE_300661_length_224_cov_209.528000	12	84	85	4	72	0.0555556
NODE_300661_length_224_cov_209.528000	12	84	86	2	72	0.0277778
NODE_300661_length_224_cov_209.528000	12	84	89	1	72	0.0138889
NODE_300661_length_224_cov_209.528000	12	84	93	1	72	0.0138889
NODE_300661_length_224_cov_209.528000	12	84	95	1	72	0.0138889
NODE_300661_length_224_cov_209.528000	12	84	98	1	72	0.0138889
NODE_300661_length_224_cov_209.528000	12	84	99	2	72	0.0277778
NODE_300661_length_224_cov_209.528000	12	84	100	1	72	0.0138889
NODE_300661_length_224_cov_209.528000	12	84	109	1	72	0.0138889
NODE_300661_length_224_cov_209.528000	12	84	110	1	72	0.0138889
NODE_300661_length_224_cov_209.528000	12	84	111	1	72	0.0138889
NODE_300661_length_224_cov_209.528000	12	84	113	1	72	0.0138889
NODE_300661_length_224_cov_209.528000	12	84	117	1	72	0.0138889
NODE_300661_length_224_cov_209.528000	12	84	119	1	72	0.0138889
NODE_300661_length_224_cov_209.528000	12	84	120	1	72	0.0138889
NODE_300661_length_224_cov_209.528000	12	84	121	1	72	0.0138889
NODE_300661_length_224_cov_209.528000	12	84	123	4	72	0.0555556
NODE_300661_length_224_cov_209.528000	12	84	125	2	72	0.0277778
NODE_300661_length_224_cov_209.528000	12	84	127	3	72	0.0416667
NODE_300663_length_224_cov_146.568000	13	72	34	2	59	0.0338983
NODE_300663_length_224_cov_146.568000	13	72	35	1	59	0.0169492
NODE_300663_length_224_cov_146.568000	13	72	37	2	59	0.0338983
NODE_300663_length_224_cov_146.568000	13	72	38	1	59	0.0169492
NODE_300663_length_224_cov_146.568000	13	72	39	1	59	0.0169492
NODE_300663_length_224_cov_146.568000	13	72	40	1	59	0.0169492
NODE_300663_length_224_cov_146.568000	13	72	44	1	59	0.0169492
NODE_300663_length_224_cov_146.568000	13	72	47	2	59	0.0338983
NODE_300663_length_224_cov_146.568000	13	72	48	2	59	0.0338983
NODE_300663_length_224_cov_146.568000	13	72	50	1	59	0.0169492
NODE_300663_length_224_cov_146.568000	13	72	51	2	59	0.0338983
NODE_300663_length_224_cov_146.568000	13	72	52	6	59	0.1016949
NODE_300663_length_224_cov_146.568000	13	72	53	1	59	0.0169492
NODE_300663_length_224_cov_146.568000	13	72	58	1	59	0.0169492
NODE_300663_length_224_cov_146.568000	13	72	61	1	59	0.0169492
NODE_300663_length_224_cov_146.568000	13	72	65	2	59	0.0338983
NODE_300663_length_224_cov_146.568000	13	72	66	1	59	0.0169492
NODE_300663_length_224_cov_146.568000	13	72	67	1	59	0.0169492
NODE_300663_length_224_cov_146.568000	13	72	69	3	59	0.0508475
NODE_300663_length_224_cov_146.568000	13	72	71	1	59	0.0169492
NODE_300663_length_224_cov_146.568000	13	72	72	2	59	0.0338983
NODE_300663_length_224_cov_146.568000	13	72	75	1	59	0.0169492
NODE_300663_length_224_cov_146.568000	13	72	76	3	59	0.0508475
NODE_300663_length_224_cov_146.568000	13	72	78	1	59	0.0169492
NODE_300663_length_224_cov_146.568000	13	72	81	4	59	0.0677966
NODE_300663_length_224_cov_146.568000	13	72	82	2	59	0.0338983
NODE_300663_length_224_cov_146.568000	13	72	84	2	59	0.0338983
NODE_300663_length_224_cov_146.568000	13	72	86	1	59	0.0169492
NODE_300663_length_224_cov_146.568000	13	72	87	1	59	0.0169492
NODE_300663_length_224_cov_146.568000	13	72	91	1	59	0.0169492
NODE_300663_length_224_cov_146.568000	13	72	92	1	59	0.0169492
NODE_300663_length_224_cov_146.568000	13	72	93	2	59	0.0338983
NODE_300663_length_224_cov_146.568000	13	72	98	2	59	0.0338983
NODE_300663_length_224_cov_146.568000	13	72	99	2	59	0.0338983
NODE_300663_length_224_cov_146.568000	13	72	100	1	59	0.0169492
NODE_300663_length_224_cov_146.568000	46	72	72	2	26	0.0769231
NODE_300663_length_224_cov_146.568000	46	72	75	1	26	0.0384615
NODE_300663_length_224_cov_146.568000	46	72	76	3	26	0.1153846
NODE_300663_length_224_cov_146.568000	46	72	78	1	26	0.0384615
NODE_300663_length_224_cov_146.568000	46	72	81	4	26	0.1538462
NODE_300663_length_224_cov_146.568000	46	72	82	2	26	0.0769231
NODE_300663_length_224_cov_146.568000	46	72	84	2	26	0.0769231
NODE_300663_length_224_cov_146.568000	46	72	86	1	26	0.0384615
NODE_300663_length_224_cov_146.568000	46	72	87	1	26	0.0384615
NODE_300663_length_224_cov_146.568000	46	72	91	1	26	0.0384615
NODE_300663_length_224_cov_146.568000	46	72	92	1	26	0.0384615
NODE_300663_length_224_cov_146.568000	46	72	93	2	26	0.0769231
NODE_300663_length_224_cov_146.568000	46	72	98	2	26	0.0769231
NODE_300663_length_224_cov_146.568000	46	72	99	2	26	0.0769231
NODE_300663_length_224_cov_146.568000	46	72	100	1	26	0.0384615
NODE_300663_length_224_cov_146.568000	68	120	98	1	52	0.0192308
NODE_300663_length_224_cov_146.568000	68	120	99	2	52	0.0384615
NODE_300663_length_224_cov_146.568000	68	120	100	2	52	0.0384615
NODE_300663_length_224_cov_146.568000	68	120	102	1	52	0.0192308
NODE_300663_length_224_cov_146.568000	68	120	103	1	52	0.0192308
NODE_300663_length_224_cov_146.568000	68	120	105	3	52	0.0576923
NODE_300663_length_224_cov_146.568000	68	120	111	4	52	0.0769231
NODE_300663_length_224_cov_146.568000	68	120	115	4	52	0.0769231
NODE_300663_length_224_cov_146.568000	68	120	117	1	52	0.0192308
NODE_300663_length_224_cov_146.568000	68	120	120	6	52	0.1153846
NODE_300663_length_224_cov_146.568000	68	120	122	6	52	0.1153846
NODE_300663_length_224_cov_146.568000	68	120	124	1	52	0.0192308
NODE_300663_length_224_cov_146.568000	68	120	125	4	52	0.0769231
NODE_300663_length_224_cov_146.568000	68	120	126	12	52	0.2307692
NODE_300663_length_224_cov_146.568000	68	120	128	4	52	0.0769231
NODE_300665_length_224_cov_59.088000	98	178	6	5	80	0.0625000
NODE_300665_length_224_cov_59.088000	98	178	7	12	80	0.1500000
NODE_300665_length_224_cov_59.088000	98	178	9	2	80	0.0250000
NODE_300665_length_224_cov_59.088000	98	178	11	10	80	0.1250000
NODE_300665_length_224_cov_59.088000	98	178	13	51	80	0.6375000
NODE_300665_length_224_cov_59.088000	98	178	6	5	80	0.0625000
NODE_300665_length_224_cov_59.088000	98	178	7	12	80	0.1500000
NODE_300665_length_224_cov_59.088000	98	178	9	2	80	0.0250000
NODE_300665_length_224_cov_59.088000	98	178	11	10	80	0.1250000
NODE_300665_length_224_cov_59.088000	98	178	13	51	80	0.6375000
NODE_300665_length_224_cov_59.088000	98	178	6	5	80	0.0625000
NODE_300665_length_224_cov_59.088000	98	178	7	12	80	0.1500000
NODE_300665_length_224_cov_59.088000	98	178	9	2	80	0.0250000
NODE_300665_length_224_cov_59.088000	98	178	11	10	80	0.1250000
NODE_300665_length_224_cov_59.088000	98	178	13	51	80	0.6375000
NODE_300665_length_224_cov_59.088000	151	217	1	2	66	0.0303030
NODE_300665_length_224_cov_59.088000	151	217	2	3	66	0.0454545
NODE_300665_length_224_cov_59.088000	151	217	4	28	66	0.4242424
NODE_300665_length_224_cov_59.088000	151	217	6	11	66	0.1666667
NODE_300665_length_224_cov_59.088000	151	217	7	12	66	0.1818182
NODE_300665_length_224_cov_59.088000	151	217	9	2	66	0.0303030
NODE_300665_length_224_cov_59.088000	151	217	11	8	66	0.1212121
NODE_300665_length_224_cov_59.088000	151	224	0	2	73	0.0273973
NODE_300665_length_224_cov_59.088000	151	224	1	7	73	0.0958904
NODE_300665_length_224_cov_59.088000	151	224	2	3	73	0.0410959
NODE_300665_length_224_cov_59.088000	151	224	4	28	73	0.3835616
NODE_300665_length_224_cov_59.088000	151	224	6	11	73	0.1506849
NODE_300665_length_224_cov_59.088000	151	224	7	12	73	0.1643836
NODE_300665_length_224_cov_59.088000	151	224	9	2	73	0.0273973
NODE_300665_length_224_cov_59.088000	151	224	11	8	73	0.1095890
NODE_300667_length_224_cov_43.640000	98	157	0	59	59	1.0000000
NODE_300667_length_224_cov_43.640000	98	157	0	59	59	1.0000000
NODE_300667_length_224_cov_43.640000	106	157	0	51	51	1.0000000
NODE_300669_length_224_cov_36.224000	100	171	13	71	71	1.0000000
NODE_300669_length_224_cov_36.224000	151	224	1	3	73	0.0410959
NODE_300669_length_224_cov_36.224000	151	224	2	1	73	0.0136986
NODE_300669_length_224_cov_36.224000	151	224	5	4	73	0.0547945
NODE_300669_length_224_cov_36.224000	151	224	6	1	73	0.0136986
NODE_300669_length_224_cov_36.224000	151	224	7	1	73	0.0136986
NODE_300669_length_224_cov_36.224000	151	224	8	3	73	0.0410959
NODE_300669_length_224_cov_36.224000	151	224	10	10	73	0.1369863
NODE_300669_length_224_cov_36.224000	151	224	11	2	73	0.0273973
NODE_300669_length_224_cov_36.224000	151	224	13	48	73	0.6575342
NODE_300696_length_223_cov_35.814516	0	54	4	17	54	0.3148148
NODE_300696_length_223_cov_35.814516	0	54	6	3	54	0.0555556
NODE_300696_length_223_cov_35.814516	0	54	8	4	54	0.0740741
NODE_300696_length_223_cov_35.814516	0	54	9	14	54	0.2592593
NODE_300696_length_223_cov_35.814516	0	54	10	1	54	0.0185185
NODE_300696_length_223_cov_35.814516	0	54	11	3	54	0.0555556
NODE_300696_length_223_cov_35.814516	0	54	12	5	54	0.0925926
NODE_300696_length_223_cov_35.814516	0	54	14	5	54	0.0925926
NODE_300696_length_223_cov_35.814516	0	54	15	2	54	0.0370370
NODE_300696_length_223_cov_35.814516	30	107	9	8	77	0.1038961
NODE_300696_length_223_cov_35.814516	30	107	10	1	77	0.0129870
NODE_300696_length_223_cov_35.814516	30	107	11	3	77	0.0389610
NODE_300696_length_223_cov_35.814516	30	107	12	5	77	0.0649351
NODE_300696_length_223_cov_35.814516	30	107	14	5	77	0.0649351
NODE_300696_length_223_cov_35.814516	30	107	15	6	77	0.0779221
NODE_300696_length_223_cov_35.814516	30	107	16	3	77	0.0389610
NODE_300696_length_223_cov_35.814516	30	107	17	7	77	0.0909091
NODE_300696_length_223_cov_35.814516	30	107	18	11	77	0.1428571
NODE_300696_length_223_cov_35.814516	30	107	19	6	77	0.0779221
NODE_300696_length_223_cov_35.814516	30	107	20	4	77	0.0519481
NODE_300696_length_223_cov_35.814516	30	107	21	18	77	0.2337662
NODE_300768_length_221_cov_71.319672	14	94	8	4	80	0.0500000
NODE_300768_length_221_cov_71.319672	14	94	10	4	80	0.0500000
NODE_300768_length_221_cov_71.319672	14	94	12	11	80	0.1375000
NODE_300768_length_221_cov_71.319672	14	94	14	61	80	0.7625000
NODE_300800_length_220_cov_42.206612	3	74	2	3	71	0.0422535
NODE_300800_length_220_cov_42.206612	3	74	3	29	71	0.4084507
NODE_300800_length_220_cov_42.206612	3	74	5	5	71	0.0704225
NODE_300800_length_220_cov_42.206612	3	74	6	34	71	0.4788733
NODE_300800_length_220_cov_42.206612	8	74	3	27	66	0.4090909
NODE_300800_length_220_cov_42.206612	8	74	5	5	66	0.0757576
NODE_300800_length_220_cov_42.206612	8	74	6	34	66	0.5151515
NODE_300800_length_220_cov_42.206612	47	98	6	51	51	1.0000000
NODE_300800_length_220_cov_42.206612	47	98	6	51	51	1.0000000
NODE_300800_length_220_cov_42.206612	47	98	6	51	51	1.0000000
NODE_300874_length_218_cov_244.773109	128	203	35	3	75	0.0400000
NODE_300874_length_218_cov_244.773109	128	203	36	2	75	0.0266667
NODE_300874_length_218_cov_244.773109	128	203	37	1	75	0.0133333
NODE_300874_length_218_cov_244.773109	128	203	39	1	75	0.0133333
NODE_300874_length_218_cov_244.773109	128	203	40	4	75	0.0533333
NODE_300874_length_218_cov_244.773109	128	203	41	1	75	0.0133333
NODE_300874_length_218_cov_244.773109	128	203	42	2	75	0.0266667
NODE_300874_length_218_cov_244.773109	128	203	43	1	75	0.0133333
NODE_300874_length_218_cov_244.773109	128	203	44	5	75	0.0666667
NODE_300874_length_218_cov_244.773109	128	203	50	4	75	0.0533333
NODE_300874_length_218_cov_244.773109	128	203	51	4	75	0.0533333
NODE_300874_length_218_cov_244.773109	128	203	54	4	75	0.0533333
NODE_300874_length_218_cov_244.773109	128	203	56	3	75	0.0400000
NODE_300874_length_218_cov_244.773109	128	203	57	3	75	0.0400000
NODE_300874_length_218_cov_244.773109	128	203	58	3	75	0.0400000
NODE_300874_length_218_cov_244.773109	128	203	62	1	75	0.0133333
NODE_300874_length_218_cov_244.773109	128	203	63	5	75	0.0666667
NODE_300874_length_218_cov_244.773109	128	203	65	1	75	0.0133333
NODE_300874_length_218_cov_244.773109	128	203	66	1	75	0.0133333
NODE_300874_length_218_cov_244.773109	128	203	68	1	75	0.0133333
NODE_300874_length_218_cov_244.773109	128	203	69	5	75	0.0666667
NODE_300874_length_218_cov_244.773109	128	203	70	8	75	0.1066667
NODE_300874_length_218_cov_244.773109	128	203	71	1	75	0.0133333
NODE_300874_length_218_cov_244.773109	128	203	72	11	75	0.1466667
NODE_300874_length_218_cov_244.773109	176	218	9	1	42	0.0238095
NODE_300874_length_218_cov_244.773109	176	218	13	1	42	0.0238095
NODE_300874_length_218_cov_244.773109	176	218	17	2	42	0.0476190
NODE_300874_length_218_cov_244.773109	176	218	18	1	42	0.0238095
NODE_300874_length_218_cov_244.773109	176	218	19	1	42	0.0238095
NODE_300874_length_218_cov_244.773109	176	218	21	1	42	0.0238095
NODE_300874_length_218_cov_244.773109	176	218	24	1	42	0.0238095
NODE_300874_length_218_cov_244.773109	176	218	27	2	42	0.0476190
NODE_300874_length_218_cov_244.773109	176	218	30	1	42	0.0238095
NODE_300874_length_218_cov_244.773109	176	218	31	1	42	0.0238095
NODE_300874_length_218_cov_244.773109	176	218	32	1	42	0.0238095
NODE_300874_length_218_cov_244.773109	176	218	34	2	42	0.0476190
NODE_300874_length_218_cov_244.773109	176	218	35	3	42	0.0714286
NODE_300874_length_218_cov_244.773109	176	218	36	2	42	0.0476190
NODE_300874_length_218_cov_244.773109	176	218	37	1	42	0.0238095
NODE_300874_length_218_cov_244.773109	176	218	39	1	42	0.0238095
NODE_300874_length_218_cov_244.773109	176	218	40	4	42	0.0952381
NODE_300874_length_218_cov_244.773109	176	218	41	1	42	0.0238095
NODE_300874_length_218_cov_244.773109	176	218	42	2	42	0.0476190
NODE_300874_length_218_cov_244.773109	176	218	43	1	42	0.0238095
NODE_300874_length_218_cov_244.773109	176	218	44	5	42	0.1190476
NODE_300874_length_218_cov_244.773109	176	218	50	4	42	0.0952381
NODE_300874_length_218_cov_244.773109	176	218	51	3	42	0.0714286
NODE_300915_length_217_cov_2.144068	14	49	0	35	35	1.0000000
NODE_300915_length_217_cov_2.144068	132	167	0	35	35	1.0000000
NODE_300924_length_216_cov_215.410256	0	63	5	4	63	0.0634921
NODE_300924_length_216_cov_215.410256	0	63	6	6	63	0.0952381
NODE_300924_length_216_cov_215.410256	0	63	7	7	63	0.1111111
NODE_300924_length_216_cov_215.410256	0	63	8	12	63	0.1904762
NODE_300924_length_216_cov_215.410256	0	63	10	15	63	0.2380952
NODE_300924_length_216_cov_215.410256	0	63	12	6	63	0.0952381
NODE_300924_length_216_cov_215.410256	0	63	13	13	63	0.2063492
NODE_300924_length_216_cov_215.410256	36	102	10	8	66	0.1212121
NODE_300924_length_216_cov_215.410256	36	102	12	6	66	0.0909091
NODE_300924_length_216_cov_215.410256	36	102	13	52	66	0.7878788
NODE_300925_length_216_cov_51.940171	164	216	0	52	52	1.0000000
NODE_300953_length_215_cov_14.784483	0	50	0	50	50	1.0000000
NODE_300953_length_215_cov_14.784483	23	103	0	80	80	1.0000000
NODE_300984_length_214_cov_144.165217	0	62	2	3	62	0.0483871
NODE_300984_length_214_cov_144.165217	0	62	3	31	62	0.5000000
NODE_300984_length_214_cov_144.165217	0	62	4	1	62	0.0161290
NODE_300984_length_214_cov_144.165217	0	62	5	12	62	0.1935484
NODE_300984_length_214_cov_144.165217	0	62	6	10	62	0.1612903
NODE_300984_length_214_cov_144.165217	0	62	7	4	62	0.0645161
NODE_300984_length_214_cov_144.165217	0	62	8	1	62	0.0161290
NODE_300984_length_214_cov_144.165217	0	62	2	3	62	0.0483871
NODE_300984_length_214_cov_144.165217	0	62	3	31	62	0.5000000
NODE_300984_length_214_cov_144.165217	0	62	4	1	62	0.0161290
NODE_300984_length_214_cov_144.165217	0	62	5	12	62	0.1935484
NODE_300984_length_214_cov_144.165217	0	62	6	10	62	0.1612903
NODE_300984_length_214_cov_144.165217	0	62	7	4	62	0.0645161
NODE_300984_length_214_cov_144.165217	0	62	8	1	62	0.0161290
NODE_300984_length_214_cov_144.165217	35	115	5	12	80	0.1500000
NODE_300984_length_214_cov_144.165217	35	115	6	10	80	0.1250000
NODE_300984_length_214_cov_144.165217	35	115	7	4	80	0.0500000
NODE_300984_length_214_cov_144.165217	35	115	8	13	80	0.1625000
NODE_300984_length_214_cov_144.165217	35	115	9	2	80	0.0250000
NODE_300984_length_214_cov_144.165217	35	115	10	3	80	0.0375000
NODE_300984_length_214_cov_144.165217	35	115	12	13	80	0.1625000
NODE_300984_length_214_cov_144.165217	35	115	13	23	80	0.2875000
NODE_300984_length_214_cov_144.165217	35	115	5	12	80	0.1500000
NODE_300984_length_214_cov_144.165217	35	115	6	10	80	0.1250000
NODE_300984_length_214_cov_144.165217	35	115	7	4	80	0.0500000
NODE_300984_length_214_cov_144.165217	35	115	8	13	80	0.1625000
NODE_300984_length_214_cov_144.165217	35	115	9	2	80	0.0250000
NODE_300984_length_214_cov_144.165217	35	115	10	3	80	0.0375000
NODE_300984_length_214_cov_144.165217	35	115	12	13	80	0.1625000
NODE_300984_length_214_cov_144.165217	35	115	13	23	80	0.2875000
NODE_300984_length_214_cov_144.165217	35	115	5	12	80	0.1500000
NODE_300984_length_214_cov_144.165217	35	115	6	10	80	0.1250000
NODE_300984_length_214_cov_144.165217	35	115	7	4	80	0.0500000
NODE_300984_length_214_cov_144.165217	35	115	8	13	80	0.1625000
NODE_300984_length_214_cov_144.165217	35	115	9	2	80	0.0250000
NODE_300984_length_214_cov_144.165217	35	115	10	3	80	0.0375000
NODE_300984_length_214_cov_144.165217	35	115	12	13	80	0.1625000
NODE_300984_length_214_cov_144.165217	35	115	13	23	80	0.2875000
NODE_300984_length_214_cov_144.165217	111	191	7	6	80	0.0750000
NODE_300984_length_214_cov_144.165217	111	191	8	1	80	0.0125000
NODE_300984_length_214_cov_144.165217	111	191	9	31	80	0.3875000
NODE_300984_length_214_cov_144.165217	111	191	11	15	80	0.1875000
NODE_300984_length_214_cov_144.165217	111	191	12	13	80	0.1625000
NODE_300984_length_214_cov_144.165217	111	191	13	14	80	0.1750000
NODE_300984_length_214_cov_144.165217	111	191	7	6	80	0.0750000
NODE_300984_length_214_cov_144.165217	111	191	8	1	80	0.0125000
NODE_300984_length_214_cov_144.165217	111	191	9	31	80	0.3875000
NODE_300984_length_214_cov_144.165217	111	191	11	15	80	0.1875000
NODE_300984_length_214_cov_144.165217	111	191	12	13	80	0.1625000
NODE_300984_length_214_cov_144.165217	111	191	13	14	80	0.1750000
NODE_300984_length_214_cov_144.165217	111	191	7	6	80	0.0750000
NODE_300984_length_214_cov_144.165217	111	191	8	1	80	0.0125000
NODE_300984_length_214_cov_144.165217	111	191	9	31	80	0.3875000
NODE_300984_length_214_cov_144.165217	111	191	11	15	80	0.1875000
NODE_300984_length_214_cov_144.165217	111	191	12	13	80	0.1625000
NODE_300984_length_214_cov_144.165217	111	191	13	14	80	0.1750000
NODE_300984_length_214_cov_144.165217	164	214	4	3	50	0.0600000
NODE_300984_length_214_cov_144.165217	164	214	5	4	50	0.0800000
NODE_300984_length_214_cov_144.165217	164	214	6	10	50	0.2000000
NODE_300984_length_214_cov_144.165217	164	214	7	12	50	0.2400000
NODE_300984_length_214_cov_144.165217	164	214	8	1	50	0.0200000
NODE_300984_length_214_cov_144.165217	164	214	9	20	50	0.4000000
NODE_300984_length_214_cov_144.165217	164	214	4	3	50	0.0600000
NODE_300984_length_214_cov_144.165217	164	214	5	4	50	0.0800000
NODE_300984_length_214_cov_144.165217	164	214	6	10	50	0.2000000
NODE_300984_length_214_cov_144.165217	164	214	7	12	50	0.2400000
NODE_300984_length_214_cov_144.165217	164	214	8	1	50	0.0200000
NODE_300984_length_214_cov_144.165217	164	214	9	20	50	0.4000000
NODE_300984_length_214_cov_144.165217	164	214	4	3	50	0.0600000
NODE_300984_length_214_cov_144.165217	164	214	5	4	50	0.0800000
NODE_300984_length_214_cov_144.165217	164	214	6	10	50	0.2000000
NODE_300984_length_214_cov_144.165217	164	214	7	12	50	0.2400000
NODE_300984_length_214_cov_144.165217	164	214	8	1	50	0.0200000
NODE_300984_length_214_cov_144.165217	164	214	9	20	50	0.4000000
NODE_301068_length_211_cov_39.571429	4	84	0	80	80	1.0000000
NODE_301169_length_208_cov_45.238532	3	59	0	16	56	0.2857143
NODE_301169_length_208_cov_45.238532	3	59	1	6	56	0.1071429
NODE_301169_length_208_cov_45.238532	3	59	3	1	56	0.0178571
NODE_301169_length_208_cov_45.238532	3	59	4	5	56	0.0892857
NODE_301169_length_208_cov_45.238532	3	59	5	7	56	0.1250000
NODE_301169_length_208_cov_45.238532	3	59	6	21	56	0.3750000
NODE_301169_length_208_cov_45.238532	35	112	5	3	77	0.0389610
NODE_301169_length_208_cov_45.238532	35	112	6	74	77	0.9610389
NODE_301170_length_208_cov_35.229358	76	156	0	1	80	0.0125000
NODE_301170_length_208_cov_35.229358	76	156	2	79	80	0.9875000
NODE_301179_length_207_cov_341.324074	33	113	3	80	80	1.0000000
NODE_301179_length_207_cov_341.324074	86	166	1	30	80	0.3750000
NODE_301179_length_207_cov_341.324074	86	166	2	10	80	0.1250000
NODE_301179_length_207_cov_341.324074	86	166	3	40	80	0.5000000
NODE_301248_length_205_cov_64.179245	6	77	2	1	71	0.0140845
NODE_301248_length_205_cov_64.179245	6	77	4	10	71	0.1408451
NODE_301248_length_205_cov_64.179245	6	77	5	2	71	0.0281690
NODE_301248_length_205_cov_64.179245	6	77	7	32	71	0.4507042
NODE_301248_length_205_cov_64.179245	6	77	9	2	71	0.0281690
NODE_301248_length_205_cov_64.179245	6	77	10	11	71	0.1549296
NODE_301248_length_205_cov_64.179245	6	77	11	13	71	0.1830986
NODE_301248_length_205_cov_64.179245	11	77	4	6	66	0.0909091
NODE_301248_length_205_cov_64.179245	11	77	5	2	66	0.0303030
NODE_301248_length_205_cov_64.179245	11	77	7	32	66	0.4848485
NODE_301248_length_205_cov_64.179245	11	77	9	2	66	0.0303030
NODE_301248_length_205_cov_64.179245	11	77	10	11	66	0.1666667
NODE_301248_length_205_cov_64.179245	11	77	11	13	66	0.1969697
NODE_301248_length_205_cov_64.179245	50	98	7	1	48	0.0208333
NODE_301248_length_205_cov_64.179245	50	98	9	2	48	0.0416667
NODE_301248_length_205_cov_64.179245	50	98	10	32	48	0.6666667
NODE_301248_length_205_cov_64.179245	50	98	11	13	48	0.2708333
NODE_301248_length_205_cov_64.179245	50	98	7	1	48	0.0208333
NODE_301248_length_205_cov_64.179245	50	98	9	2	48	0.0416667
NODE_301248_length_205_cov_64.179245	50	98	10	32	48	0.6666667
NODE_301248_length_205_cov_64.179245	50	98	11	13	48	0.2708333
NODE_301248_length_205_cov_64.179245	50	98	7	1	48	0.0208333
NODE_301248_length_205_cov_64.179245	50	98	9	2	48	0.0416667
NODE_301248_length_205_cov_64.179245	50	98	10	32	48	0.6666667
NODE_301248_length_205_cov_64.179245	50	98	11	13	48	0.2708333
NODE_301281_length_204_cov_183.390476	119	199	5	4	80	0.0500000
NODE_301281_length_204_cov_183.390476	119	199	7	5	80	0.0625000
NODE_301281_length_204_cov_183.390476	119	199	8	2	80	0.0250000
NODE_301281_length_204_cov_183.390476	119	199	9	2	80	0.0250000
NODE_301281_length_204_cov_183.390476	119	199	10	1	80	0.0125000
NODE_301281_length_204_cov_183.390476	119	199	14	15	80	0.1875000
NODE_301281_length_204_cov_183.390476	119	199	16	6	80	0.0750000
NODE_301281_length_204_cov_183.390476	119	199	17	4	80	0.0500000
NODE_301281_length_204_cov_183.390476	119	199	18	2	80	0.0250000
NODE_301281_length_204_cov_183.390476	119	199	20	6	80	0.0750000
NODE_301281_length_204_cov_183.390476	119	199	21	2	80	0.0250000
NODE_301281_length_204_cov_183.390476	119	199	22	13	80	0.1625000
NODE_301281_length_204_cov_183.390476	119	199	23	5	80	0.0625000
NODE_301281_length_204_cov_183.390476	119	199	27	2	80	0.0250000
NODE_301281_length_204_cov_183.390476	119	199	28	8	80	0.1000000
NODE_301281_length_204_cov_183.390476	119	199	30	3	80	0.0375000
NODE_301281_length_204_cov_183.390476	172	194	7	4	22	0.1818182
NODE_301281_length_204_cov_183.390476	172	194	8	2	22	0.0909091
NODE_301281_length_204_cov_183.390476	172	194	9	2	22	0.0909091
NODE_301281_length_204_cov_183.390476	172	194	10	1	22	0.0454545
NODE_301281_length_204_cov_183.390476	172	194	14	13	22	0.5909091
NODE_301283_length_204_cov_80.095238	10	90	3	45	80	0.5625000
NODE_301283_length_204_cov_80.095238	10	90	4	35	80	0.4375000
NODE_301283_length_204_cov_80.095238	63	143	2	7	80	0.0875000
NODE_301283_length_204_cov_80.095238	63	143	4	73	80	0.9125000
NODE_301345_length_202_cov_123.184466	0	64	0	1	64	0.0156250
NODE_301345_length_202_cov_123.184466	0	64	2	4	64	0.0625000
NODE_301345_length_202_cov_123.184466	0	64	3	1	64	0.0156250
NODE_301345_length_202_cov_123.184466	0	64	4	1	64	0.0156250
NODE_301345_length_202_cov_123.184466	0	64	5	1	64	0.0156250
NODE_301345_length_202_cov_123.184466	0	64	6	1	64	0.0156250
NODE_301345_length_202_cov_123.184466	0	64	10	1	64	0.0156250
NODE_301345_length_202_cov_123.184466	0	64	11	1	64	0.0156250
NODE_301345_length_202_cov_123.184466	0	64	14	1	64	0.0156250
NODE_301345_length_202_cov_123.184466	0	64	16	2	64	0.0312500
NODE_301345_length_202_cov_123.184466	0	64	19	2	64	0.0312500
NODE_301345_length_202_cov_123.184466	0	64	21	4	64	0.0625000
NODE_301345_length_202_cov_123.184466	0	64	22	2	64	0.0312500
NODE_301345_length_202_cov_123.184466	0	64	26	1	64	0.0156250
NODE_301345_length_202_cov_123.184466	0	64	28	1	64	0.0156250
NODE_301345_length_202_cov_123.184466	0	64	30	3	64	0.0468750
NODE_301345_length_202_cov_123.184466	0	64	32	6	64	0.0937500
NODE_301345_length_202_cov_123.184466	0	64	33	1	64	0.0156250
NODE_301345_length_202_cov_123.184466	0	64	34	2	64	0.0312500
NODE_301345_length_202_cov_123.184466	0	64	39	1	64	0.0156250
NODE_301345_length_202_cov_123.184466	0	64	44	1	64	0.0156250
NODE_301345_length_202_cov_123.184466	0	64	47	1	64	0.0156250
NODE_301345_length_202_cov_123.184466	0	64	48	5	64	0.0781250
NODE_301345_length_202_cov_123.184466	0	64	49	3	64	0.0468750
NODE_301345_length_202_cov_123.184466	0	64	52	1	64	0.0156250
NODE_301345_length_202_cov_123.184466	0	64	53	2	64	0.0312500
NODE_301345_length_202_cov_123.184466	0	64	55	2	64	0.0312500
NODE_301345_length_202_cov_123.184466	0	64	59	2	64	0.0312500
NODE_301345_length_202_cov_123.184466	0	64	71	2	64	0.0312500
NODE_301345_length_202_cov_123.184466	0	64	73	1	64	0.0156250
NODE_301345_length_202_cov_123.184466	0	64	75	1	64	0.0156250
NODE_301345_length_202_cov_123.184466	0	64	78	3	64	0.0468750
NODE_301345_length_202_cov_123.184466	0	64	80	3	64	0.0468750
NODE_301345_length_202_cov_123.184466	31	72	32	2	41	0.0487805
NODE_301345_length_202_cov_123.184466	31	72	33	1	41	0.0243902
NODE_301345_length_202_cov_123.184466	31	72	34	2	41	0.0487805
NODE_301345_length_202_cov_123.184466	31	72	39	1	41	0.0243902
NODE_301345_length_202_cov_123.184466	31	72	44	1	41	0.0243902
NODE_301345_length_202_cov_123.184466	31	72	47	1	41	0.0243902
NODE_301345_length_202_cov_123.184466	31	72	48	5	41	0.1219512
NODE_301345_length_202_cov_123.184466	31	72	49	3	41	0.0731707
NODE_301345_length_202_cov_123.184466	31	72	52	1	41	0.0243902
NODE_301345_length_202_cov_123.184466	31	72	53	2	41	0.0487805
NODE_301345_length_202_cov_123.184466	31	72	55	2	41	0.0487805
NODE_301345_length_202_cov_123.184466	31	72	59	2	41	0.0487805
NODE_301345_length_202_cov_123.184466	31	72	71	2	41	0.0487805
NODE_301345_length_202_cov_123.184466	31	72	73	1	41	0.0243902
NODE_301345_length_202_cov_123.184466	31	72	75	1	41	0.0243902
NODE_301345_length_202_cov_123.184466	31	72	78	3	41	0.0731707
NODE_301345_length_202_cov_123.184466	31	72	80	4	41	0.0975610
NODE_301345_length_202_cov_123.184466	31	72	82	1	41	0.0243902
NODE_301345_length_202_cov_123.184466	31	72	84	1	41	0.0243902
NODE_301345_length_202_cov_123.184466	31	72	88	1	41	0.0243902
NODE_301345_length_202_cov_123.184466	31	72	90	1	41	0.0243902
NODE_301345_length_202_cov_123.184466	31	72	92	3	41	0.0731707
NODE_301370_length_201_cov_56.323529	133	201	2	13	68	0.1911765
NODE_301370_length_201_cov_56.323529	133	201	3	8	68	0.1176471
NODE_301370_length_201_cov_56.323529	133	201	4	5	68	0.0735294
NODE_301370_length_201_cov_56.323529	133	201	5	31	68	0.4558823
NODE_301370_length_201_cov_56.323529	133	201	6	11	68	0.1617647
NODE_301371_length_201_cov_50.647059	44	99	11	2	55	0.0363636
NODE_301371_length_201_cov_50.647059	44	99	12	2	55	0.0363636
NODE_301371_length_201_cov_50.647059	44	99	13	3	55	0.0545455
NODE_301371_length_201_cov_50.647059	44	99	14	7	55	0.1272727
NODE_301371_length_201_cov_50.647059	44	99	15	8	55	0.1454545
NODE_301371_length_201_cov_50.647059	44	99	16	21	55	0.3818182
NODE_301371_length_201_cov_50.647059	44	99	20	12	55	0.2181818
NODE_301371_length_201_cov_50.647059	136	201	6	2	65	0.0307692
NODE_301371_length_201_cov_50.647059	136	201	7	5	65	0.0769231
NODE_301371_length_201_cov_50.647059	136	201	8	4	65	0.0615385
NODE_301371_length_201_cov_50.647059	136	201	10	2	65	0.0307692
NODE_301371_length_201_cov_50.647059	136	201	11	6	65	0.0923077
NODE_301371_length_201_cov_50.647059	136	201	12	1	65	0.0153846
NODE_301371_length_201_cov_50.647059	136	201	13	22	65	0.3384615
NODE_301371_length_201_cov_50.647059	136	201	14	12	65	0.1846154
NODE_301371_length_201_cov_50.647059	136	201	15	4	65	0.0615385
NODE_301371_length_201_cov_50.647059	136	201	16	5	65	0.0769231
NODE_301371_length_201_cov_50.647059	136	201	18	2	65	0.0307692
NODE_301371_length_201_cov_50.647059	136	201	6	2	65	0.0307692
NODE_301371_length_201_cov_50.647059	136	201	7	5	65	0.0769231
NODE_301371_length_201_cov_50.647059	136	201	8	4	65	0.0615385
NODE_301371_length_201_cov_50.647059	136	201	10	2	65	0.0307692
NODE_301371_length_201_cov_50.647059	136	201	11	6	65	0.0923077
NODE_301371_length_201_cov_50.647059	136	201	12	1	65	0.0153846
NODE_301371_length_201_cov_50.647059	136	201	13	22	65	0.3384615
NODE_301371_length_201_cov_50.647059	136	201	14	12	65	0.1846154
NODE_301371_length_201_cov_50.647059	136	201	15	4	65	0.0615385
NODE_301371_length_201_cov_50.647059	136	201	16	5	65	0.0769231
NODE_301371_length_201_cov_50.647059	136	201	18	2	65	0.0307692
NODE_301371_length_201_cov_50.647059	136	201	6	2	65	0.0307692
NODE_301371_length_201_cov_50.647059	136	201	7	5	65	0.0769231
NODE_301371_length_201_cov_50.647059	136	201	8	4	65	0.0615385
NODE_301371_length_201_cov_50.647059	136	201	10	2	65	0.0307692
NODE_301371_length_201_cov_50.647059	136	201	11	6	65	0.0923077
NODE_301371_length_201_cov_50.647059	136	201	12	1	65	0.0153846
NODE_301371_length_201_cov_50.647059	136	201	13	22	65	0.3384615
NODE_301371_length_201_cov_50.647059	136	201	14	12	65	0.1846154
NODE_301371_length_201_cov_50.647059	136	201	15	4	65	0.0615385
NODE_301371_length_201_cov_50.647059	136	201	16	5	65	0.0769231
NODE_301371_length_201_cov_50.647059	136	201	18	2	65	0.0307692
NODE_301371_length_201_cov_50.647059	136	201	6	2	65	0.0307692
NODE_301371_length_201_cov_50.647059	136	201	7	5	65	0.0769231
NODE_301371_length_201_cov_50.647059	136	201	8	4	65	0.0615385
NODE_301371_length_201_cov_50.647059	136	201	10	2	65	0.0307692
NODE_301371_length_201_cov_50.647059	136	201	11	6	65	0.0923077
NODE_301371_length_201_cov_50.647059	136	201	12	1	65	0.0153846
NODE_301371_length_201_cov_50.647059	136	201	13	22	65	0.3384615
NODE_301371_length_201_cov_50.647059	136	201	14	12	65	0.1846154
NODE_301371_length_201_cov_50.647059	136	201	15	4	65	0.0615385
NODE_301371_length_201_cov_50.647059	136	201	16	5	65	0.0769231
NODE_301371_length_201_cov_50.647059	136	201	18	2	65	0.0307692
NODE_301405_length_200_cov_29.118812	0	73	9	2	73	0.0273973
NODE_301405_length_200_cov_29.118812	0	73	10	2	73	0.0273973
NODE_301405_length_200_cov_29.118812	0	73	12	1	73	0.0136986
NODE_301405_length_200_cov_29.118812	0	73	13	1	73	0.0136986
NODE_301405_length_200_cov_29.118812	0	73	15	3	73	0.0410959
NODE_301405_length_200_cov_29.118812	0	73	16	1	73	0.0136986
NODE_301405_length_200_cov_29.118812	0	73	17	1	73	0.0136986
NODE_301405_length_200_cov_29.118812	0	73	18	7	73	0.0958904
NODE_301405_length_200_cov_29.118812	0	73	19	1	73	0.0136986
NODE_301405_length_200_cov_29.118812	0	73	20	1	73	0.0136986
NODE_301405_length_200_cov_29.118812	0	73	21	9	73	0.1232877
NODE_301405_length_200_cov_29.118812	0	73	22	2	73	0.0273973
NODE_301405_length_200_cov_29.118812	0	73	23	7	73	0.0958904
NODE_301405_length_200_cov_29.118812	0	73	25	12	73	0.1643836
NODE_301405_length_200_cov_29.118812	0	73	26	17	73	0.2328767
NODE_301405_length_200_cov_29.118812	0	73	28	6	73	0.0821918
NODE_301419_length_199_cov_768.700000	94	142	118	48	48	1.0000000
NODE_301419_length_199_cov_768.700000	115	186	45	1	71	0.0140845
NODE_301419_length_199_cov_768.700000	115	186	47	1	71	0.0140845
NODE_301419_length_199_cov_768.700000	115	186	48	2	71	0.0281690
NODE_301419_length_199_cov_768.700000	115	186	51	1	71	0.0140845
NODE_301419_length_199_cov_768.700000	115	186	53	1	71	0.0140845
NODE_301419_length_199_cov_768.700000	115	186	54	1	71	0.0140845
NODE_301419_length_199_cov_768.700000	115	186	57	1	71	0.0140845
NODE_301419_length_199_cov_768.700000	115	186	61	2	71	0.0281690
NODE_301419_length_199_cov_768.700000	115	186	64	1	71	0.0140845
NODE_301419_length_199_cov_768.700000	115	186	68	1	71	0.0140845
NODE_301419_length_199_cov_768.700000	115	186	70	2	71	0.0281690
NODE_301419_length_199_cov_768.700000	115	186	74	2	71	0.0281690
NODE_301419_length_199_cov_768.700000	115	186	75	1	71	0.0140845
NODE_301419_length_199_cov_768.700000	115	186	82	1	71	0.0140845
NODE_301419_length_199_cov_768.700000	115	186	84	1	71	0.0140845
NODE_301419_length_199_cov_768.700000	115	186	88	1	71	0.0140845
NODE_301419_length_199_cov_768.700000	115	186	90	4	71	0.0563380
NODE_301419_length_199_cov_768.700000	115	186	91	1	71	0.0140845
NODE_301419_length_199_cov_768.700000	115	186	92	1	71	0.0140845
NODE_301419_length_199_cov_768.700000	115	186	93	1	71	0.0140845
NODE_301419_length_199_cov_768.700000	115	186	95	2	71	0.0281690
NODE_301419_length_199_cov_768.700000	115	186	97	1	71	0.0140845
NODE_301419_length_199_cov_768.700000	115	186	101	3	71	0.0422535
NODE_301419_length_199_cov_768.700000	115	186	102	1	71	0.0140845
NODE_301419_length_199_cov_768.700000	115	186	103	1	71	0.0140845
NODE_301419_length_199_cov_768.700000	115	186	104	1	71	0.0140845
NODE_301419_length_199_cov_768.700000	115	186	105	1	71	0.0140845
NODE_301419_length_199_cov_768.700000	115	186	111	2	71	0.0281690
NODE_301419_length_199_cov_768.700000	115	186	115	1	71	0.0140845
NODE_301419_length_199_cov_768.700000	115	186	116	1	71	0.0140845
NODE_301419_length_199_cov_768.700000	115	186	117	1	71	0.0140845
NODE_301419_length_199_cov_768.700000	115	186	118	29	71	0.4084507
NODE_301420_length_199_cov_702.860000	3	78	19	1	75	0.0133333
NODE_301420_length_199_cov_702.860000	3	78	26	2	75	0.0266667
NODE_301420_length_199_cov_702.860000	3	78	28	1	75	0.0133333
NODE_301420_length_199_cov_702.860000	3	78	33	1	75	0.0133333
NODE_301420_length_199_cov_702.860000	3	78	35	3	75	0.0400000
NODE_301420_length_199_cov_702.860000	3	78	37	1	75	0.0133333
NODE_301420_length_199_cov_702.860000	3	78	41	3	75	0.0400000
NODE_301420_length_199_cov_702.860000	3	78	45	1	75	0.0133333
NODE_301420_length_199_cov_702.860000	3	78	51	2	75	0.0266667
NODE_301420_length_199_cov_702.860000	3	78	52	2	75	0.0266667
NODE_301420_length_199_cov_702.860000	3	78	56	1	75	0.0133333
NODE_301420_length_199_cov_702.860000	3	78	59	3	75	0.0400000
NODE_301420_length_199_cov_702.860000	3	78	62	1	75	0.0133333
NODE_301420_length_199_cov_702.860000	3	78	63	1	75	0.0133333
NODE_301420_length_199_cov_702.860000	3	78	66	1	75	0.0133333
NODE_301420_length_199_cov_702.860000	3	78	71	1	75	0.0133333
NODE_301420_length_199_cov_702.860000	3	78	72	1	75	0.0133333
NODE_301420_length_199_cov_702.860000	3	78	76	1	75	0.0133333
NODE_301420_length_199_cov_702.860000	3	78	81	1	75	0.0133333
NODE_301420_length_199_cov_702.860000	3	78	82	3	75	0.0400000
NODE_301420_length_199_cov_702.860000	3	78	87	1	75	0.0133333
NODE_301420_length_199_cov_702.860000	3	78	90	5	75	0.0666667
NODE_301420_length_199_cov_702.860000	3	78	93	1	75	0.0133333
NODE_301420_length_199_cov_702.860000	3	78	96	1	75	0.0133333
NODE_301420_length_199_cov_702.860000	3	78	98	2	75	0.0266667
NODE_301420_length_199_cov_702.860000	3	78	101	1	75	0.0133333
NODE_301420_length_199_cov_702.860000	3	78	107	1	75	0.0133333
NODE_301420_length_199_cov_702.860000	3	78	108	1	75	0.0133333
NODE_301420_length_199_cov_702.860000	3	78	110	1	75	0.0133333
NODE_301420_length_199_cov_702.860000	3	78	112	1	75	0.0133333
NODE_301420_length_199_cov_702.860000	3	78	115	5	75	0.0666667
NODE_301420_length_199_cov_702.860000	3	78	122	1	75	0.0133333
NODE_301420_length_199_cov_702.860000	3	78	123	2	75	0.0266667
NODE_301420_length_199_cov_702.860000	3	78	128	2	75	0.0266667
NODE_301420_length_199_cov_702.860000	3	78	129	1	75	0.0133333
NODE_301420_length_199_cov_702.860000	3	78	131	1	75	0.0133333
NODE_301420_length_199_cov_702.860000	3	78	132	1	75	0.0133333
NODE_301420_length_199_cov_702.860000	3	78	135	1	75	0.0133333
NODE_301420_length_199_cov_702.860000	3	78	136	3	75	0.0400000
NODE_301420_length_199_cov_702.860000	3	78	138	2	75	0.0266667
NODE_301420_length_199_cov_702.860000	3	78	142	1	75	0.0133333
NODE_301420_length_199_cov_702.860000	3	78	144	3	75	0.0400000
NODE_301420_length_199_cov_702.860000	3	78	146	1	75	0.0133333
NODE_301420_length_199_cov_702.860000	3	78	150	1	75	0.0133333
NODE_301420_length_199_cov_702.860000	3	78	152	1	75	0.0133333
NODE_301420_length_199_cov_702.860000	3	78	154	1	75	0.0133333
NODE_301420_length_199_cov_702.860000	3	78	158	1	75	0.0133333
NODE_301420_length_199_cov_702.860000	3	78	160	1	75	0.0133333
NODE_301420_length_199_cov_702.860000	51	131	115	3	80	0.0375000
NODE_301420_length_199_cov_702.860000	51	131	122	1	80	0.0125000
NODE_301420_length_199_cov_702.860000	51	131	123	2	80	0.0250000
NODE_301420_length_199_cov_702.860000	51	131	128	2	80	0.0250000
NODE_301420_length_199_cov_702.860000	51	131	129	1	80	0.0125000
NODE_301420_length_199_cov_702.860000	51	131	131	1	80	0.0125000
NODE_301420_length_199_cov_702.860000	51	131	132	1	80	0.0125000
NODE_301420_length_199_cov_702.860000	51	131	135	1	80	0.0125000
NODE_301420_length_199_cov_702.860000	51	131	136	3	80	0.0375000
NODE_301420_length_199_cov_702.860000	51	131	138	2	80	0.0250000
NODE_301420_length_199_cov_702.860000	51	131	142	3	80	0.0375000
NODE_301420_length_199_cov_702.860000	51	131	144	6	80	0.0750000
NODE_301420_length_199_cov_702.860000	51	131	146	4	80	0.0500000
NODE_301420_length_199_cov_702.860000	51	131	148	1	80	0.0125000
NODE_301420_length_199_cov_702.860000	51	131	150	1	80	0.0125000
NODE_301420_length_199_cov_702.860000	51	131	152	1	80	0.0125000
NODE_301420_length_199_cov_702.860000	51	131	154	2	80	0.0250000
NODE_301420_length_199_cov_702.860000	51	131	158	2	80	0.0250000
NODE_301420_length_199_cov_702.860000	51	131	160	2	80	0.0250000
NODE_301420_length_199_cov_702.860000	51	131	166	4	80	0.0500000
NODE_301420_length_199_cov_702.860000	51	131	168	5	80	0.0625000
NODE_301420_length_199_cov_702.860000	51	131	170	5	80	0.0625000
NODE_301420_length_199_cov_702.860000	51	131	172	2	80	0.0250000
NODE_301420_length_199_cov_702.860000	51	131	174	2	80	0.0250000
NODE_301420_length_199_cov_702.860000	51	131	177	6	80	0.0750000
NODE_301420_length_199_cov_702.860000	51	131	178	3	80	0.0375000
NODE_301420_length_199_cov_702.860000	51	131	179	1	80	0.0125000
NODE_301420_length_199_cov_702.860000	51	131	180	10	80	0.1250000
NODE_301420_length_199_cov_702.860000	51	131	181	3	80	0.0375000
NODE_301421_length_199_cov_670.570000	22	52	50	1	30	0.0333333
NODE_301421_length_199_cov_670.570000	22	52	52	1	30	0.0333333
NODE_301421_length_199_cov_670.570000	22	52	54	1	30	0.0333333
NODE_301421_length_199_cov_670.570000	22	52	55	1	30	0.0333333
NODE_301421_length_199_cov_670.570000	22	52	59	3	30	0.1000000
NODE_301421_length_199_cov_670.570000	22	52	65	2	30	0.0666667
NODE_301421_length_199_cov_670.570000	22	52	67	2	30	0.0666667
NODE_301421_length_199_cov_670.570000	22	52	69	1	30	0.0333333
NODE_301421_length_199_cov_670.570000	22	52	71	1	30	0.0333333
NODE_301421_length_199_cov_670.570000	22	52	73	1	30	0.0333333
NODE_301421_length_199_cov_670.570000	22	52	77	1	30	0.0333333
NODE_301421_length_199_cov_670.570000	22	52	78	1	30	0.0333333
NODE_301421_length_199_cov_670.570000	22	52	80	2	30	0.0666667
NODE_301421_length_199_cov_670.570000	22	52	82	4	30	0.1333333
NODE_301421_length_199_cov_670.570000	22	52	83	3	30	0.1000000
NODE_301421_length_199_cov_670.570000	22	52	85	1	30	0.0333333
NODE_301421_length_199_cov_670.570000	22	52	86	1	30	0.0333333
NODE_301421_length_199_cov_670.570000	22	52	90	1	30	0.0333333
NODE_301421_length_199_cov_670.570000	22	52	91	1	30	0.0333333
NODE_301421_length_199_cov_670.570000	22	52	93	1	30	0.0333333
NODE_301421_length_199_cov_670.570000	25	105	55	1	80	0.0125000
NODE_301421_length_199_cov_670.570000	25	105	59	3	80	0.0375000
NODE_301421_length_199_cov_670.570000	25	105	65	2	80	0.0250000
NODE_301421_length_199_cov_670.570000	25	105	67	2	80	0.0250000
NODE_301421_length_199_cov_670.570000	25	105	69	1	80	0.0125000
NODE_301421_length_199_cov_670.570000	25	105	71	1	80	0.0125000
NODE_301421_length_199_cov_670.570000	25	105	73	1	80	0.0125000
NODE_301421_length_199_cov_670.570000	25	105	77	1	80	0.0125000
NODE_301421_length_199_cov_670.570000	25	105	78	1	80	0.0125000
NODE_301421_length_199_cov_670.570000	25	105	80	2	80	0.0250000
NODE_301421_length_199_cov_670.570000	25	105	82	4	80	0.0500000
NODE_301421_length_199_cov_670.570000	25	105	83	3	80	0.0375000
NODE_301421_length_199_cov_670.570000	25	105	85	1	80	0.0125000
NODE_301421_length_199_cov_670.570000	25	105	86	1	80	0.0125000
NODE_301421_length_199_cov_670.570000	25	105	90	1	80	0.0125000
NODE_301421_length_199_cov_670.570000	25	105	91	1	80	0.0125000
NODE_301421_length_199_cov_670.570000	25	105	93	2	80	0.0250000
NODE_301421_length_199_cov_670.570000	25	105	94	1	80	0.0125000
NODE_301421_length_199_cov_670.570000	25	105	95	2	80	0.0250000
NODE_301421_length_199_cov_670.570000	25	105	96	2	80	0.0250000
NODE_301421_length_199_cov_670.570000	25	105	100	1	80	0.0125000
NODE_301421_length_199_cov_670.570000	25	105	102	1	80	0.0125000
NODE_301421_length_199_cov_670.570000	25	105	103	2	80	0.0250000
NODE_301421_length_199_cov_670.570000	25	105	105	1	80	0.0125000
NODE_301421_length_199_cov_670.570000	25	105	106	4	80	0.0500000
NODE_301421_length_199_cov_670.570000	25	105	108	2	80	0.0250000
NODE_301421_length_199_cov_670.570000	25	105	110	3	80	0.0375000
NODE_301421_length_199_cov_670.570000	25	105	112	3	80	0.0375000
NODE_301421_length_199_cov_670.570000	25	105	114	2	80	0.0250000
NODE_301421_length_199_cov_670.570000	25	105	116	2	80	0.0250000
NODE_301421_length_199_cov_670.570000	25	105	117	1	80	0.0125000
NODE_301421_length_199_cov_670.570000	25	105	118	5	80	0.0625000
NODE_301421_length_199_cov_670.570000	25	105	122	4	80	0.0500000
NODE_301421_length_199_cov_670.570000	25	105	124	3	80	0.0375000
NODE_301421_length_199_cov_670.570000	25	105	125	3	80	0.0375000
NODE_301421_length_199_cov_670.570000	25	105	126	10	80	0.1250000
NODE_301430_length_199_cov_215.860000	3	75	4	7	72	0.0972222
NODE_301430_length_199_cov_215.860000	3	75	6	7	72	0.0972222
NODE_301430_length_199_cov_215.860000	3	75	8	5	72	0.0694444
NODE_301430_length_199_cov_215.860000	3	75	10	7	72	0.0972222
NODE_301430_length_199_cov_215.860000	3	75	12	3	72	0.0416667
NODE_301430_length_199_cov_215.860000	3	75	13	1	72	0.0138889
NODE_301430_length_199_cov_215.860000	3	75	15	1	72	0.0138889
NODE_301430_length_199_cov_215.860000	3	75	17	2	72	0.0277778
NODE_301430_length_199_cov_215.860000	3	75	18	1	72	0.0138889
NODE_301430_length_199_cov_215.860000	3	75	22	1	72	0.0138889
NODE_301430_length_199_cov_215.860000	3	75	23	1	72	0.0138889
NODE_301430_length_199_cov_215.860000	3	75	24	2	72	0.0277778
NODE_301430_length_199_cov_215.860000	3	75	26	7	72	0.0972222
NODE_301430_length_199_cov_215.860000	3	75	28	18	72	0.2500000
NODE_301430_length_199_cov_215.860000	3	75	30	8	72	0.1111111
NODE_301430_length_199_cov_215.860000	3	75	32	1	72	0.0138889
NODE_301430_length_199_cov_215.860000	48	128	28	22	80	0.2750000
NODE_301430_length_199_cov_215.860000	48	128	30	17	80	0.2125000
NODE_301430_length_199_cov_215.860000	48	128	32	4	80	0.0500000
NODE_301430_length_199_cov_215.860000	48	128	34	37	80	0.4625000
NODE_301432_length_199_cov_206.800000	120	199	0	79	79	1.0000000
NODE_301441_length_199_cov_131.120000	97	177	0	1	80	0.0125000
NODE_301441_length_199_cov_131.120000	97	177	2	79	80	0.9875000
NODE_301448_length_199_cov_97.490000	4	77	0	44	73	0.6027398
NODE_301448_length_199_cov_97.490000	4	77	1	1	73	0.0136986
NODE_301448_length_199_cov_97.490000	4	77	2	4	73	0.0547945
NODE_301448_length_199_cov_97.490000	4	77	4	24	73	0.3287671
NODE_301449_length_199_cov_96.090000	91	171	4	9	80	0.1125000
NODE_301449_length_199_cov_96.090000	91	171	6	26	80	0.3250000
NODE_301449_length_199_cov_96.090000	91	171	8	5	80	0.0625000
NODE_301449_length_199_cov_96.090000	91	171	10	12	80	0.1500000
NODE_301449_length_199_cov_96.090000	91	171	12	3	80	0.0375000
NODE_301449_length_199_cov_96.090000	91	171	14	1	80	0.0125000
NODE_301449_length_199_cov_96.090000	91	171	16	24	80	0.3000000
NODE_301455_length_199_cov_84.060000	44	75	42	1	31	0.0322581
NODE_301455_length_199_cov_84.060000	44	75	44	11	31	0.3548387
NODE_301455_length_199_cov_84.060000	44	75	45	2	31	0.0645161
NODE_301455_length_199_cov_84.060000	44	75	48	1	31	0.0322581
NODE_301455_length_199_cov_84.060000	44	75	50	1	31	0.0322581
NODE_301455_length_199_cov_84.060000	44	75	51	2	31	0.0645161
NODE_301455_length_199_cov_84.060000	44	75	52	13	31	0.4193548
NODE_301456_length_199_cov_83.220000	0	64	2	9	64	0.1406250
NODE_301456_length_199_cov_83.220000	0	64	4	2	64	0.0312500
NODE_301456_length_199_cov_83.220000	0	64	6	7	64	0.1093750
NODE_301456_length_199_cov_83.220000	0	64	8	46	64	0.7187500
NODE_301459_length_199_cov_80.390000	15	98	3	1	83	0.0120482
NODE_301459_length_199_cov_80.390000	15	98	4	6	83	0.0722892
NODE_301459_length_199_cov_80.390000	15	98	5	37	83	0.4457831
NODE_301459_length_199_cov_80.390000	15	98	6	3	83	0.0361446
NODE_301459_length_199_cov_80.390000	15	98	8	36	83	0.4337350
NODE_301469_length_199_cov_63.420000	128	194	13	1	66	0.0151515
NODE_301469_length_199_cov_63.420000	128	194	14	5	66	0.0757576
NODE_301469_length_199_cov_63.420000	128	194	16	1	66	0.0151515
NODE_301469_length_199_cov_63.420000	128	194	17	3	66	0.0454545
NODE_301469_length_199_cov_63.420000	128	194	19	9	66	0.1363636
NODE_301469_length_199_cov_63.420000	128	194	21	1	66	0.0151515
NODE_301469_length_199_cov_63.420000	128	194	23	4	66	0.0606061
NODE_301469_length_199_cov_63.420000	128	194	24	4	66	0.0606061
NODE_301469_length_199_cov_63.420000	128	194	26	2	66	0.0303030
NODE_301469_length_199_cov_63.420000	128	194	28	1	66	0.0151515
NODE_301469_length_199_cov_63.420000	128	194	30	1	66	0.0151515
NODE_301469_length_199_cov_63.420000	128	194	32	1	66	0.0151515
NODE_301469_length_199_cov_63.420000	128	194	34	3	66	0.0454545
NODE_301469_length_199_cov_63.420000	128	194	36	4	66	0.0606061
NODE_301469_length_199_cov_63.420000	128	194	38	2	66	0.0303030
NODE_301469_length_199_cov_63.420000	128	194	39	8	66	0.1212121
NODE_301469_length_199_cov_63.420000	128	194	41	2	66	0.0303030
NODE_301469_length_199_cov_63.420000	128	194	42	1	66	0.0151515
NODE_301469_length_199_cov_63.420000	128	194	43	1	66	0.0151515
NODE_301469_length_199_cov_63.420000	128	194	44	1	66	0.0151515
NODE_301469_length_199_cov_63.420000	128	194	45	10	66	0.1515152
NODE_301469_length_199_cov_63.420000	128	194	47	1	66	0.0151515
NODE_301477_length_199_cov_58.660000	18	85	0	67	67	1.0000000
NODE_301484_length_199_cov_50.350000	102	183	5	7	81	0.0864198
NODE_301484_length_199_cov_50.350000	102	183	6	1	81	0.0123457
NODE_301484_length_199_cov_50.350000	102	183	7	73	81	0.9012346
NODE_301485_length_199_cov_49.630000	5	47	0	42	42	1.0000000
NODE_301485_length_199_cov_49.630000	100	163	1	63	63	1.0000000
NODE_301485_length_199_cov_49.630000	100	163	1	63	63	1.0000000
NODE_301485_length_199_cov_49.630000	100	163	1	63	63	1.0000000
NODE_301485_length_199_cov_49.630000	136	185	1	49	49	1.0000000
NODE_301485_length_199_cov_49.630000	153	199	1	46	46	1.0000000
NODE_301491_length_199_cov_40.000000	0	66	0	33	66	0.5000000
NODE_301491_length_199_cov_40.000000	0	66	1	1	66	0.0151515
NODE_301491_length_199_cov_40.000000	0	66	2	2	66	0.0303030
NODE_301491_length_199_cov_40.000000	0	66	3	5	66	0.0757576
NODE_301491_length_199_cov_40.000000	0	66	4	11	66	0.1666667
NODE_301491_length_199_cov_40.000000	0	66	5	14	66	0.2121212
NODE_301491_length_199_cov_40.000000	34	114	2	2	80	0.0250000
NODE_301491_length_199_cov_40.000000	34	114	3	5	80	0.0625000
NODE_301491_length_199_cov_40.000000	34	114	4	11	80	0.1375000
NODE_301491_length_199_cov_40.000000	34	114	5	62	80	0.7750000
NODE_301491_length_199_cov_40.000000	39	61	3	2	22	0.0909091
NODE_301491_length_199_cov_40.000000	39	61	4	11	22	0.5000000
NODE_301491_length_199_cov_40.000000	39	61	5	9	22	0.4090909
NODE_301498_length_199_cov_31.400000	3	77	2	28	74	0.3783784
NODE_301498_length_199_cov_31.400000	3	77	4	19	74	0.2567568
NODE_301498_length_199_cov_31.400000	3	77	6	8	74	0.1081081
NODE_301498_length_199_cov_31.400000	3	77	8	2	74	0.0270270
NODE_301498_length_199_cov_31.400000	3	77	10	5	74	0.0675676
NODE_301498_length_199_cov_31.400000	3	77	12	12	74	0.1621622
NODE_301498_length_199_cov_31.400000	76	153	6	3	77	0.0389610
NODE_301498_length_199_cov_31.400000	76	153	8	3	77	0.0389610
NODE_301498_length_199_cov_31.400000	76	153	9	2	77	0.0259740
NODE_301498_length_199_cov_31.400000	76	153	11	4	77	0.0519481
NODE_301498_length_199_cov_31.400000	76	153	12	65	77	0.8441558
NODE_301498_length_199_cov_31.400000	76	153	6	3	77	0.0389610
NODE_301498_length_199_cov_31.400000	76	153	8	3	77	0.0389610
NODE_301498_length_199_cov_31.400000	76	153	9	2	77	0.0259740
NODE_301498_length_199_cov_31.400000	76	153	11	4	77	0.0519481
NODE_301498_length_199_cov_31.400000	76	153	12	65	77	0.8441558
NODE_301498_length_199_cov_31.400000	76	153	6	3	77	0.0389610
NODE_301498_length_199_cov_31.400000	76	153	8	3	77	0.0389610
NODE_301498_length_199_cov_31.400000	76	153	9	2	77	0.0259740
NODE_301498_length_199_cov_31.400000	76	153	11	4	77	0.0519481
NODE_301498_length_199_cov_31.400000	76	153	12	65	77	0.8441558
NODE_301498_length_199_cov_31.400000	126	192	0	1	66	0.0151515
NODE_301498_length_199_cov_31.400000	126	192	2	20	66	0.3030303
NODE_301498_length_199_cov_31.400000	126	192	4	11	66	0.1666667
NODE_301498_length_199_cov_31.400000	126	192	6	10	66	0.1515152
NODE_301498_length_199_cov_31.400000	126	192	8	3	66	0.0454545
NODE_301498_length_199_cov_31.400000	126	192	9	2	66	0.0303030
NODE_301498_length_199_cov_31.400000	126	192	11	4	66	0.0606061
NODE_301498_length_199_cov_31.400000	126	192	12	15	66	0.2272727
NODE_301498_length_199_cov_31.400000	129	199	0	8	70	0.1142857
NODE_301498_length_199_cov_31.400000	129	199	2	20	70	0.2857143
NODE_301498_length_199_cov_31.400000	129	199	4	11	70	0.1571429
NODE_301498_length_199_cov_31.400000	129	199	6	10	70	0.1428571
NODE_301498_length_199_cov_31.400000	129	199	8	3	70	0.0428571
NODE_301498_length_199_cov_31.400000	129	199	9	2	70	0.0285714
NODE_301498_length_199_cov_31.400000	129	199	11	4	70	0.0571429
NODE_301498_length_199_cov_31.400000	129	199	12	12	70	0.1714286
NODE_301498_length_199_cov_31.400000	131	199	0	8	68	0.1176471
NODE_301498_length_199_cov_31.400000	131	199	2	20	68	0.2941177
NODE_301498_length_199_cov_31.400000	131	199	4	11	68	0.1617647
NODE_301498_length_199_cov_31.400000	131	199	6	10	68	0.1470588
NODE_301498_length_199_cov_31.400000	131	199	8	3	68	0.0441176
NODE_301498_length_199_cov_31.400000	131	199	9	2	68	0.0294118
NODE_301498_length_199_cov_31.400000	131	199	11	4	68	0.0588235
NODE_301498_length_199_cov_31.400000	131	199	12	10	68	0.1470588
NODE_301500_length_199_cov_30.140000	118	198	0	25	80	0.3125000
NODE_301500_length_199_cov_30.140000	118	198	1	20	80	0.2500000
NODE_301500_length_199_cov_30.140000	118	198	2	35	80	0.4375000
NODE_301500_length_199_cov_30.140000	118	198	0	25	80	0.3125000
NODE_301500_length_199_cov_30.140000	118	198	1	20	80	0.2500000
NODE_301500_length_199_cov_30.140000	118	198	2	35	80	0.4375000
NODE_301500_length_199_cov_30.140000	118	198	0	25	80	0.3125000
NODE_301500_length_199_cov_30.140000	118	198	1	20	80	0.2500000
NODE_301500_length_199_cov_30.140000	118	198	2	35	80	0.4375000
NODE_301500_length_199_cov_30.140000	118	198	0	25	80	0.3125000
NODE_301500_length_199_cov_30.140000	118	198	1	20	80	0.2500000
NODE_301500_length_199_cov_30.140000	118	198	2	35	80	0.4375000
NODE_301500_length_199_cov_30.140000	118	198	0	25	80	0.3125000
NODE_301500_length_199_cov_30.140000	118	198	1	20	80	0.2500000
NODE_301500_length_199_cov_30.140000	118	198	2	35	80	0.4375000
NODE_301500_length_199_cov_30.140000	127	198	0	25	71	0.3521127
NODE_301500_length_199_cov_30.140000	127	198	1	20	71	0.2816902
NODE_301500_length_199_cov_30.140000	127	198	2	26	71	0.3661972
NODE_301581_length_197_cov_41.265306	0	70	0	70	70	1.0000000
NODE_301611_length_196_cov_101.855670	72	136	18	21	64	0.3281250
NODE_301611_length_196_cov_101.855670	72	136	20	43	64	0.6718750
NODE_301611_length_196_cov_101.855670	72	136	18	21	64	0.3281250
NODE_301611_length_196_cov_101.855670	72	136	20	43	64	0.6718750
NODE_301611_length_196_cov_101.855670	109	169	10	9	60	0.1500000
NODE_301611_length_196_cov_101.855670	109	169	12	10	60	0.1666667
NODE_301611_length_196_cov_101.855670	109	169	13	1	60	0.0166667
NODE_301611_length_196_cov_101.855670	109	169	14	7	60	0.1166667
NODE_301611_length_196_cov_101.855670	109	169	18	16	60	0.2666667
NODE_301611_length_196_cov_101.855670	109	169	20	17	60	0.2833333
NODE_301613_length_196_cov_100.618557	129	196	0	2	67	0.0298507
NODE_301613_length_196_cov_100.618557	129	196	1	18	67	0.2686567
NODE_301613_length_196_cov_100.618557	129	196	2	15	67	0.2238806
NODE_301613_length_196_cov_100.618557	129	196	4	6	67	0.0895522
NODE_301613_length_196_cov_100.618557	129	196	6	24	67	0.3582090
NODE_301613_length_196_cov_100.618557	129	196	8	2	67	0.0298507
NODE_301618_length_196_cov_67.268041	8	88	4	10	80	0.1250000
NODE_301618_length_196_cov_67.268041	8	88	5	9	80	0.1125000
NODE_301618_length_196_cov_67.268041	8	88	6	1	80	0.0125000
NODE_301618_length_196_cov_67.268041	8	88	12	2	80	0.0250000
NODE_301618_length_196_cov_67.268041	8	88	13	27	80	0.3375000
NODE_301618_length_196_cov_67.268041	8	88	14	12	80	0.1500000
NODE_301618_length_196_cov_67.268041	8	88	15	8	80	0.1000000
NODE_301618_length_196_cov_67.268041	8	88	17	11	80	0.1375000
NODE_301618_length_196_cov_67.268041	61	124	14	8	63	0.1269841
NODE_301618_length_196_cov_67.268041	61	124	15	18	63	0.2857143
NODE_301618_length_196_cov_67.268041	61	124	17	37	63	0.5873016
NODE_301629_length_196_cov_40.195876	101	184	4	5	83	0.0602410
NODE_301629_length_196_cov_40.195876	101	184	6	2	83	0.0240964
NODE_301629_length_196_cov_40.195876	101	184	8	1	83	0.0120482
NODE_301629_length_196_cov_40.195876	101	184	9	19	83	0.2289157
NODE_301629_length_196_cov_40.195876	101	184	10	7	83	0.0843373
NODE_301629_length_196_cov_40.195876	101	184	11	17	83	0.2048193
NODE_301629_length_196_cov_40.195876	101	184	13	3	83	0.0361446
NODE_301629_length_196_cov_40.195876	101	184	14	2	83	0.0240964
NODE_301629_length_196_cov_40.195876	101	184	16	27	83	0.3253012
NODE_301704_length_194_cov_63.252632	12	78	0	10	66	0.1515152
NODE_301704_length_194_cov_63.252632	12	78	2	2	66	0.0303030
NODE_301704_length_194_cov_63.252632	12	78	4	11	66	0.1666667
NODE_301704_length_194_cov_63.252632	12	78	5	7	66	0.1060606
NODE_301704_length_194_cov_63.252632	12	78	6	3	66	0.0454545
NODE_301704_length_194_cov_63.252632	12	78	10	9	66	0.1363636
NODE_301704_length_194_cov_63.252632	12	78	12	24	66	0.3636364
NODE_301704_length_194_cov_63.252632	51	112	10	3	61	0.0491803
NODE_301704_length_194_cov_63.252632	51	112	12	58	61	0.9508197
NODE_301704_length_194_cov_63.252632	51	99	10	3	48	0.0625000
NODE_301704_length_194_cov_63.252632	51	99	12	45	48	0.9375000
NODE_301704_length_194_cov_63.252632	51	112	10	3	61	0.0491803
NODE_301704_length_194_cov_63.252632	51	112	12	58	61	0.9508197
NODE_301708_length_194_cov_35.010526	95	162	0	67	67	1.0000000
NODE_301708_length_194_cov_35.010526	95	162	0	67	67	1.0000000
NODE_301708_length_194_cov_35.010526	135	184	0	49	49	1.0000000
NODE_301714_length_194_cov_9.978947	153	194	0	41	41	1.0000000
NODE_301727_length_193_cov_117.170213	21	93	6	4	72	0.0555556
NODE_301727_length_193_cov_117.170213	21	93	8	5	72	0.0694444
NODE_301727_length_193_cov_117.170213	21	93	10	36	72	0.5000000
NODE_301727_length_193_cov_117.170213	21	93	11	7	72	0.0972222
NODE_301727_length_193_cov_117.170213	21	93	12	20	72	0.2777778
NODE_301727_length_193_cov_117.170213	41	121	10	25	80	0.3125000
NODE_301727_length_193_cov_117.170213	41	121	11	10	80	0.1250000
NODE_301727_length_193_cov_117.170213	41	121	12	45	80	0.5625000
NODE_301729_length_193_cov_54.734043	108	188	0	39	80	0.4875000
NODE_301729_length_193_cov_54.734043	108	188	1	1	80	0.0125000
NODE_301729_length_193_cov_54.734043	108	188	2	40	80	0.5000000
NODE_301729_length_193_cov_54.734043	161	183	0	22	22	1.0000000
NODE_301735_length_193_cov_30.638298	108	188	0	4	80	0.0500000
NODE_301735_length_193_cov_30.638298	108	188	1	10	80	0.1250000
NODE_301735_length_193_cov_30.638298	108	188	3	4	80	0.0500000
NODE_301735_length_193_cov_30.638298	108	188	4	62	80	0.7750000
NODE_301735_length_193_cov_30.638298	161	183	1	9	22	0.4090909
NODE_301735_length_193_cov_30.638298	161	183	3	4	22	0.1818182
NODE_301735_length_193_cov_30.638298	161	183	4	9	22	0.4090909
NODE_301737_length_193_cov_29.968085	0	45	5	5	45	0.1111111
NODE_301737_length_193_cov_29.968085	0	45	6	4	45	0.0888889
NODE_301737_length_193_cov_29.968085	0	45	7	1	45	0.0222222
NODE_301737_length_193_cov_29.968085	0	45	9	1	45	0.0222222
NODE_301737_length_193_cov_29.968085	0	45	10	4	45	0.0888889
NODE_301737_length_193_cov_29.968085	0	45	11	1	45	0.0222222
NODE_301737_length_193_cov_29.968085	0	45	12	4	45	0.0888889
NODE_301737_length_193_cov_29.968085	0	45	13	3	45	0.0666667
NODE_301737_length_193_cov_29.968085	0	45	15	1	45	0.0222222
NODE_301737_length_193_cov_29.968085	0	45	16	3	45	0.0666667
NODE_301737_length_193_cov_29.968085	0	45	19	3	45	0.0666667
NODE_301737_length_193_cov_29.968085	0	45	20	4	45	0.0888889
NODE_301737_length_193_cov_29.968085	0	45	22	4	45	0.0888889
NODE_301737_length_193_cov_29.968085	0	45	24	1	45	0.0222222
NODE_301737_length_193_cov_29.968085	0	45	27	1	45	0.0222222
NODE_301737_length_193_cov_29.968085	0	45	29	5	45	0.1111111
NODE_301737_length_193_cov_29.968085	8	57	6	1	49	0.0204082
NODE_301737_length_193_cov_29.968085	8	57	7	1	49	0.0204082
NODE_301737_length_193_cov_29.968085	8	57	9	1	49	0.0204082
NODE_301737_length_193_cov_29.968085	8	57	10	4	49	0.0816327
NODE_301737_length_193_cov_29.968085	8	57	11	1	49	0.0204082
NODE_301737_length_193_cov_29.968085	8	57	12	4	49	0.0816327
NODE_301737_length_193_cov_29.968085	8	57	13	3	49	0.0612245
NODE_301737_length_193_cov_29.968085	8	57	15	1	49	0.0204082
NODE_301737_length_193_cov_29.968085	8	57	16	3	49	0.0612245
NODE_301737_length_193_cov_29.968085	8	57	19	3	49	0.0612245
NODE_301737_length_193_cov_29.968085	8	57	20	4	49	0.0816327
NODE_301737_length_193_cov_29.968085	8	57	22	4	49	0.0816327
NODE_301737_length_193_cov_29.968085	8	57	24	1	49	0.0204082
NODE_301737_length_193_cov_29.968085	8	57	27	1	49	0.0204082
NODE_301737_length_193_cov_29.968085	8	57	29	5	49	0.1020408
NODE_301737_length_193_cov_29.968085	8	57	30	2	49	0.0408163
NODE_301737_length_193_cov_29.968085	8	57	32	3	49	0.0612245
NODE_301737_length_193_cov_29.968085	8	57	34	7	49	0.1428571
NODE_301737_length_193_cov_29.968085	30	98	20	4	68	0.0588235
NODE_301737_length_193_cov_29.968085	30	98	22	4	68	0.0588235
NODE_301737_length_193_cov_29.968085	30	98	24	1	68	0.0147059
NODE_301737_length_193_cov_29.968085	30	98	27	1	68	0.0147059
NODE_301737_length_193_cov_29.968085	30	98	29	5	68	0.0735294
NODE_301737_length_193_cov_29.968085	30	98	30	2	68	0.0294118
NODE_301737_length_193_cov_29.968085	30	98	32	3	68	0.0441176
NODE_301737_length_193_cov_29.968085	30	98	34	48	68	0.7058824
NODE_301737_length_193_cov_29.968085	30	98	20	4	68	0.0588235
NODE_301737_length_193_cov_29.968085	30	98	22	4	68	0.0588235
NODE_301737_length_193_cov_29.968085	30	98	24	1	68	0.0147059
NODE_301737_length_193_cov_29.968085	30	98	27	1	68	0.0147059
NODE_301737_length_193_cov_29.968085	30	98	29	5	68	0.0735294
NODE_301737_length_193_cov_29.968085	30	98	30	2	68	0.0294118
NODE_301737_length_193_cov_29.968085	30	98	32	3	68	0.0441176
NODE_301737_length_193_cov_29.968085	30	98	34	48	68	0.7058824
NODE_301737_length_193_cov_29.968085	30	98	20	4	68	0.0588235
NODE_301737_length_193_cov_29.968085	30	98	22	4	68	0.0588235
NODE_301737_length_193_cov_29.968085	30	98	24	1	68	0.0147059
NODE_301737_length_193_cov_29.968085	30	98	27	1	68	0.0147059
NODE_301737_length_193_cov_29.968085	30	98	29	5	68	0.0735294
NODE_301737_length_193_cov_29.968085	30	98	30	2	68	0.0294118
NODE_301737_length_193_cov_29.968085	30	98	32	3	68	0.0441176
NODE_301737_length_193_cov_29.968085	30	98	34	48	68	0.7058824
NODE_301737_length_193_cov_29.968085	146	188	2	2	42	0.0476190
NODE_301737_length_193_cov_29.968085	146	188	4	10	42	0.2380952
NODE_301737_length_193_cov_29.968085	146	188	5	2	42	0.0476190
NODE_301737_length_193_cov_29.968085	146	188	6	3	42	0.0714286
NODE_301737_length_193_cov_29.968085	146	188	10	1	42	0.0238095
NODE_301737_length_193_cov_29.968085	146	188	11	4	42	0.0952381
NODE_301737_length_193_cov_29.968085	146	188	16	1	42	0.0238095
NODE_301737_length_193_cov_29.968085	146	188	17	4	42	0.0952381
NODE_301737_length_193_cov_29.968085	146	188	18	2	42	0.0476190
NODE_301737_length_193_cov_29.968085	146	188	19	4	42	0.0952381
NODE_301737_length_193_cov_29.968085	146	188	20	4	42	0.0952381
NODE_301737_length_193_cov_29.968085	146	188	21	4	42	0.0952381
NODE_301737_length_193_cov_29.968085	146	188	22	1	42	0.0238095
NODE_301776_length_192_cov_160.258065	0	76	15	1	76	0.0131579
NODE_301776_length_192_cov_160.258065	0	76	17	4	76	0.0526316
NODE_301776_length_192_cov_160.258065	0	76	21	1	76	0.0131579
NODE_301776_length_192_cov_160.258065	0	76	24	1	76	0.0131579
NODE_301776_length_192_cov_160.258065	0	76	29	1	76	0.0131579
NODE_301776_length_192_cov_160.258065	0	76	33	1	76	0.0131579
NODE_301776_length_192_cov_160.258065	0	76	34	1	76	0.0131579
NODE_301776_length_192_cov_160.258065	0	76	38	1	76	0.0131579
NODE_301776_length_192_cov_160.258065	0	76	43	1	76	0.0131579
NODE_301776_length_192_cov_160.258065	0	76	47	3	76	0.0394737
NODE_301776_length_192_cov_160.258065	0	76	48	1	76	0.0131579
NODE_301776_length_192_cov_160.258065	0	76	51	1	76	0.0131579
NODE_301776_length_192_cov_160.258065	0	76	55	1	76	0.0131579
NODE_301776_length_192_cov_160.258065	0	76	58	1	76	0.0131579
NODE_301776_length_192_cov_160.258065	0	76	60	2	76	0.0263158
NODE_301776_length_192_cov_160.258065	0	76	63	1	76	0.0131579
NODE_301776_length_192_cov_160.258065	0	76	64	1	76	0.0131579
NODE_301776_length_192_cov_160.258065	0	76	67	1	76	0.0131579
NODE_301776_length_192_cov_160.258065	0	76	69	1	76	0.0131579
NODE_301776_length_192_cov_160.258065	0	76	73	1	76	0.0131579
NODE_301776_length_192_cov_160.258065	0	76	75	2	76	0.0263158
NODE_301776_length_192_cov_160.258065	0	76	76	1	76	0.0131579
NODE_301776_length_192_cov_160.258065	0	76	77	1	76	0.0131579
NODE_301776_length_192_cov_160.258065	0	76	79	1	76	0.0131579
NODE_301776_length_192_cov_160.258065	0	76	81	1	76	0.0131579
NODE_301776_length_192_cov_160.258065	0	76	82	1	76	0.0131579
NODE_301776_length_192_cov_160.258065	0	76	87	4	76	0.0526316
NODE_301776_length_192_cov_160.258065	0	76	88	2	76	0.0263158
NODE_301776_length_192_cov_160.258065	0	76	94	2	76	0.0263158
NODE_301776_length_192_cov_160.258065	0	76	95	1	76	0.0131579
NODE_301776_length_192_cov_160.258065	0	76	97	1	76	0.0131579
NODE_301776_length_192_cov_160.258065	0	76	102	1	76	0.0131579
NODE_301776_length_192_cov_160.258065	0	76	104	1	76	0.0131579
NODE_301776_length_192_cov_160.258065	0	76	105	4	76	0.0526316
NODE_301776_length_192_cov_160.258065	0	76	107	1	76	0.0131579
NODE_301776_length_192_cov_160.258065	0	76	108	1	76	0.0131579
NODE_301776_length_192_cov_160.258065	0	76	109	2	76	0.0263158
NODE_301776_length_192_cov_160.258065	0	76	115	3	76	0.0394737
NODE_301776_length_192_cov_160.258065	0	76	116	1	76	0.0131579
NODE_301776_length_192_cov_160.258065	0	76	122	4	76	0.0526316
NODE_301776_length_192_cov_160.258065	0	76	123	2	76	0.0263158
NODE_301776_length_192_cov_160.258065	0	76	125	2	76	0.0263158
NODE_301776_length_192_cov_160.258065	0	76	127	1	76	0.0131579
NODE_301776_length_192_cov_160.258065	0	76	129	1	76	0.0131579
NODE_301776_length_192_cov_160.258065	0	76	130	1	76	0.0131579
NODE_301776_length_192_cov_160.258065	0	76	133	2	76	0.0263158
NODE_301776_length_192_cov_160.258065	0	76	139	3	76	0.0394737
NODE_301776_length_192_cov_160.258065	0	76	141	3	76	0.0394737
NODE_301825_length_191_cov_92.913043	81	144	9	11	63	0.1746032
NODE_301825_length_191_cov_92.913043	81	144	11	23	63	0.3650794
NODE_301825_length_191_cov_92.913043	81	144	13	29	63	0.4603175
NODE_301855_length_190_cov_112.285714	8	91	2	6	83	0.0722892
NODE_301855_length_190_cov_112.285714	8	91	3	13	83	0.1566265
NODE_301855_length_190_cov_112.285714	8	91	4	64	83	0.7710843
NODE_301859_length_190_cov_41.373626	92	172	2	80	80	1.0000000
NODE_301859_length_190_cov_41.373626	145	190	0	16	45	0.3555556
NODE_301859_length_190_cov_41.373626	145	190	2	29	45	0.6444445
NODE_301880_length_189_cov_234.500000	19	88	0	69	69	1.0000000
NODE_301882_length_189_cov_192.211111	134	186	0	9	52	0.1730769
NODE_301882_length_189_cov_192.211111	134	186	2	43	52	0.8269231
NODE_301885_length_189_cov_70.600000	19	88	1	4	69	0.0579710
NODE_301885_length_189_cov_70.600000	19	88	3	8	69	0.1159420
NODE_301885_length_189_cov_70.600000	19	88	4	3	69	0.0434783
NODE_301885_length_189_cov_70.600000	19	88	5	12	69	0.1739130
NODE_301885_length_189_cov_70.600000	19	88	6	42	69	0.6086956
NODE_301885_length_189_cov_70.600000	72	156	6	84	84	1.0000000
NODE_301886_length_189_cov_63.455556	70	150	12	1	80	0.0125000
NODE_301886_length_189_cov_63.455556	70	150	14	2	80	0.0250000
NODE_301886_length_189_cov_63.455556	70	150	16	2	80	0.0250000
NODE_301886_length_189_cov_63.455556	70	150	17	2	80	0.0250000
NODE_301886_length_189_cov_63.455556	70	150	19	3	80	0.0375000
NODE_301886_length_189_cov_63.455556	70	150	21	8	80	0.1000000
NODE_301886_length_189_cov_63.455556	70	150	23	1	80	0.0125000
NODE_301886_length_189_cov_63.455556	70	150	25	13	80	0.1625000
NODE_301886_length_189_cov_63.455556	70	150	27	3	80	0.0375000
NODE_301886_length_189_cov_63.455556	70	150	29	8	80	0.1000000
NODE_301886_length_189_cov_63.455556	70	150	31	10	80	0.1250000
NODE_301886_length_189_cov_63.455556	70	150	33	27	80	0.3375000
NODE_301886_length_189_cov_63.455556	70	141	19	1	71	0.0140845
NODE_301886_length_189_cov_63.455556	70	141	21	8	71	0.1126761
NODE_301886_length_189_cov_63.455556	70	141	23	1	71	0.0140845
NODE_301886_length_189_cov_63.455556	70	141	25	13	71	0.1830986
NODE_301886_length_189_cov_63.455556	70	141	27	3	71	0.0422535
NODE_301886_length_189_cov_63.455556	70	141	29	8	71	0.1126761
NODE_301886_length_189_cov_63.455556	70	141	31	10	71	0.1408451
NODE_301886_length_189_cov_63.455556	70	141	33	27	71	0.3802817
NODE_301891_length_189_cov_43.600000	0	73	2	1	73	0.0136986
NODE_301891_length_189_cov_43.600000	0	73	3	1	73	0.0136986
NODE_301891_length_189_cov_43.600000	0	73	4	2	73	0.0273973
NODE_301891_length_189_cov_43.600000	0	73	8	2	73	0.0273973
NODE_301891_length_189_cov_43.600000	0	73	9	5	73	0.0684932
NODE_301891_length_189_cov_43.600000	0	73	11	2	73	0.0273973
NODE_301891_length_189_cov_43.600000	0	73	12	1	73	0.0136986
NODE_301891_length_189_cov_43.600000	0	73	13	3	73	0.0410959
NODE_301891_length_189_cov_43.600000	0	73	15	1	73	0.0136986
NODE_301891_length_189_cov_43.600000	0	73	18	2	73	0.0273973
NODE_301891_length_189_cov_43.600000	0	73	19	2	73	0.0273973
NODE_301891_length_189_cov_43.600000	0	73	21	7	73	0.0958904
NODE_301891_length_189_cov_43.600000	0	73	22	1	73	0.0136986
NODE_301891_length_189_cov_43.600000	0	73	25	6	73	0.0821918
NODE_301891_length_189_cov_43.600000	0	73	26	5	73	0.0684932
NODE_301891_length_189_cov_43.600000	0	73	27	2	73	0.0273973
NODE_301891_length_189_cov_43.600000	0	73	28	5	73	0.0684932
NODE_301891_length_189_cov_43.600000	0	73	32	4	73	0.0547945
NODE_301891_length_189_cov_43.600000	0	73	34	17	73	0.2328767
NODE_301891_length_189_cov_43.600000	0	73	36	4	73	0.0547945
NODE_301940_length_188_cov_2021.561798	108	188	1	1	80	0.0125000
NODE_301940_length_188_cov_2021.561798	108	188	5	1	80	0.0125000
NODE_301940_length_188_cov_2021.561798	108	188	6	2	80	0.0250000
NODE_301940_length_188_cov_2021.561798	108	188	7	1	80	0.0125000
NODE_301940_length_188_cov_2021.561798	108	188	9	1	80	0.0125000
NODE_301940_length_188_cov_2021.561798	108	188	11	1	80	0.0125000
NODE_301940_length_188_cov_2021.561798	108	188	13	3	80	0.0375000
NODE_301940_length_188_cov_2021.561798	108	188	14	2	80	0.0250000
NODE_301940_length_188_cov_2021.561798	108	188	18	1	80	0.0125000
NODE_301940_length_188_cov_2021.561798	108	188	20	1	80	0.0125000
NODE_301940_length_188_cov_2021.561798	108	188	21	8	80	0.1000000
NODE_301940_length_188_cov_2021.561798	108	188	22	2	80	0.0250000
NODE_301940_length_188_cov_2021.561798	108	188	24	2	80	0.0250000
NODE_301940_length_188_cov_2021.561798	108	188	25	1	80	0.0125000
NODE_301940_length_188_cov_2021.561798	108	188	27	2	80	0.0250000
NODE_301940_length_188_cov_2021.561798	108	188	35	1	80	0.0125000
NODE_301940_length_188_cov_2021.561798	108	188	37	1	80	0.0125000
NODE_301940_length_188_cov_2021.561798	108	188	41	1	80	0.0125000
NODE_301940_length_188_cov_2021.561798	108	188	45	3	80	0.0375000
NODE_301940_length_188_cov_2021.561798	108	188	47	1	80	0.0125000
NODE_301940_length_188_cov_2021.561798	108	188	48	1	80	0.0125000
NODE_301940_length_188_cov_2021.561798	108	188	50	6	80	0.0750000
NODE_301940_length_188_cov_2021.561798	108	188	51	1	80	0.0125000
NODE_301940_length_188_cov_2021.561798	108	188	52	2	80	0.0250000
NODE_301940_length_188_cov_2021.561798	108	188	56	3	80	0.0375000
NODE_301940_length_188_cov_2021.561798	108	188	58	6	80	0.0750000
NODE_301940_length_188_cov_2021.561798	108	188	60	25	80	0.3125000
NODE_301940_length_188_cov_2021.561798	161	183	9	1	22	0.0454545
NODE_301940_length_188_cov_2021.561798	161	183	11	1	22	0.0454545
NODE_301940_length_188_cov_2021.561798	161	183	13	3	22	0.1363636
NODE_301940_length_188_cov_2021.561798	161	183	14	2	22	0.0909091
NODE_301940_length_188_cov_2021.561798	161	183	18	1	22	0.0454545
NODE_301940_length_188_cov_2021.561798	161	183	20	1	22	0.0454545
NODE_301940_length_188_cov_2021.561798	161	183	21	8	22	0.3636364
NODE_301940_length_188_cov_2021.561798	161	183	22	2	22	0.0909091
NODE_301940_length_188_cov_2021.561798	161	183	24	2	22	0.0909091
NODE_301940_length_188_cov_2021.561798	161	183	25	1	22	0.0454545
NODE_301952_length_188_cov_37.988764	0	50	0	9	50	0.1800000
NODE_301952_length_188_cov_37.988764	0	50	1	33	50	0.6600000
NODE_301952_length_188_cov_37.988764	0	50	2	8	50	0.1600000
NODE_301980_length_187_cov_71.170455	124	155	16	1	31	0.0322581
NODE_301980_length_187_cov_71.170455	124	155	18	1	31	0.0322581
NODE_301980_length_187_cov_71.170455	124	155	19	2	31	0.0645161
NODE_301980_length_187_cov_71.170455	124	155	20	3	31	0.0967742
NODE_301980_length_187_cov_71.170455	124	155	21	3	31	0.0967742
NODE_301980_length_187_cov_71.170455	124	155	22	1	31	0.0322581
NODE_301980_length_187_cov_71.170455	124	155	23	9	31	0.2903226
NODE_301980_length_187_cov_71.170455	124	155	25	1	31	0.0322581
NODE_301980_length_187_cov_71.170455	124	155	26	5	31	0.1612903
NODE_301980_length_187_cov_71.170455	124	155	27	5	31	0.1612903
NODE_301981_length_187_cov_56.000000	72	136	28	64	64	1.0000000
NODE_301981_length_187_cov_56.000000	72	136	28	64	64	1.0000000
NODE_301981_length_187_cov_56.000000	109	175	15	5	66	0.0757576
NODE_301981_length_187_cov_56.000000	109	175	17	2	66	0.0303030
NODE_301981_length_187_cov_56.000000	109	175	18	1	66	0.0151515
NODE_301981_length_187_cov_56.000000	109	175	20	8	66	0.1212121
NODE_301981_length_187_cov_56.000000	109	175	22	1	66	0.0151515
NODE_301981_length_187_cov_56.000000	109	175	24	1	66	0.0151515
NODE_301981_length_187_cov_56.000000	109	175	26	18	66	0.2727273
NODE_301981_length_187_cov_56.000000	109	175	28	30	66	0.4545455
NODE_301981_length_187_cov_56.000000	109	180	11	1	71	0.0140845
NODE_301981_length_187_cov_56.000000	109	180	12	2	71	0.0281690
NODE_301981_length_187_cov_56.000000	109	180	13	1	71	0.0140845
NODE_301981_length_187_cov_56.000000	109	180	14	1	71	0.0140845
NODE_301981_length_187_cov_56.000000	109	180	15	5	71	0.0704225
NODE_301981_length_187_cov_56.000000	109	180	17	2	71	0.0281690
NODE_301981_length_187_cov_56.000000	109	180	18	1	71	0.0140845
NODE_301981_length_187_cov_56.000000	109	180	20	8	71	0.1126761
NODE_301981_length_187_cov_56.000000	109	180	22	1	71	0.0140845
NODE_301981_length_187_cov_56.000000	109	180	24	1	71	0.0140845
NODE_301981_length_187_cov_56.000000	109	180	26	18	71	0.2535211
NODE_301981_length_187_cov_56.000000	109	180	28	30	71	0.4225352
NODE_301986_length_187_cov_37.397727	4	57	0	34	53	0.6415094
NODE_301986_length_187_cov_37.397727	4	57	2	19	53	0.3584906
NODE_301986_length_187_cov_37.397727	12	78	0	26	66	0.3939394
NODE_301986_length_187_cov_37.397727	12	78	2	20	66	0.3030303
NODE_301986_length_187_cov_37.397727	12	78	4	9	66	0.1363636
NODE_301986_length_187_cov_37.397727	12	78	6	11	66	0.1666667
NODE_301986_length_187_cov_37.397727	51	112	2	7	61	0.1147541
NODE_301986_length_187_cov_37.397727	51	112	4	9	61	0.1475410
NODE_301986_length_187_cov_37.397727	51	112	6	45	61	0.7377049
NODE_301986_length_187_cov_37.397727	51	114	2	7	63	0.1111111
NODE_301986_length_187_cov_37.397727	51	114	4	9	63	0.1428571
NODE_301986_length_187_cov_37.397727	51	114	6	47	63	0.7460318
NODE_302020_length_186_cov_309.620690	20	104	7	2	84	0.0238095
NODE_302020_length_186_cov_309.620690	20	104	8	15	84	0.1785714
NODE_302020_length_186_cov_309.620690	20	104	9	11	84	0.1309524
NODE_302020_length_186_cov_309.620690	20	104	11	10	84	0.1190476
NODE_302020_length_186_cov_309.620690	20	104	13	5	84	0.0595238
NODE_302020_length_186_cov_309.620690	20	104	15	41	84	0.4880952
NODE_302021_length_186_cov_295.505747	57	115	37	6	58	0.1034483
NODE_302021_length_186_cov_295.505747	57	115	39	2	58	0.0344828
NODE_302021_length_186_cov_295.505747	57	115	41	3	58	0.0517241
NODE_302021_length_186_cov_295.505747	57	115	43	4	58	0.0689655
NODE_302021_length_186_cov_295.505747	57	115	45	16	58	0.2758621
NODE_302021_length_186_cov_295.505747	57	115	47	27	58	0.4655173
NODE_302021_length_186_cov_295.505747	101	168	18	3	67	0.0447761
NODE_302021_length_186_cov_295.505747	101	168	19	3	67	0.0447761
NODE_302021_length_186_cov_295.505747	101	168	21	9	67	0.1343284
NODE_302021_length_186_cov_295.505747	101	168	22	4	67	0.0597015
NODE_302021_length_186_cov_295.505747	101	168	24	2	67	0.0298507
NODE_302021_length_186_cov_295.505747	101	168	26	1	67	0.0149254
NODE_302021_length_186_cov_295.505747	101	168	29	1	67	0.0149254
NODE_302021_length_186_cov_295.505747	101	168	30	1	67	0.0149254
NODE_302021_length_186_cov_295.505747	101	168	31	4	67	0.0597015
NODE_302021_length_186_cov_295.505747	101	168	33	1	67	0.0149254
NODE_302021_length_186_cov_295.505747	101	168	35	1	67	0.0149254
NODE_302021_length_186_cov_295.505747	101	168	36	1	67	0.0149254
NODE_302021_length_186_cov_295.505747	101	168	38	1	67	0.0149254
NODE_302021_length_186_cov_295.505747	101	168	40	7	67	0.1044776
NODE_302021_length_186_cov_295.505747	101	168	41	8	67	0.1194030
NODE_302021_length_186_cov_295.505747	101	168	43	7	67	0.1044776
NODE_302021_length_186_cov_295.505747	101	168	45	8	67	0.1194030
NODE_302021_length_186_cov_295.505747	101	168	47	5	67	0.0746269
NODE_302025_length_186_cov_61.344828	38	118	8	8	80	0.1000000
NODE_302025_length_186_cov_61.344828	38	118	10	23	80	0.2875000
NODE_302025_length_186_cov_61.344828	38	118	12	49	80	0.6125000
NODE_302025_length_186_cov_61.344828	91	171	12	80	80	1.0000000
NODE_302201_length_182_cov_127.759036	6	52	48	3	46	0.0652174
NODE_302201_length_182_cov_127.759036	6	52	51	1	46	0.0217391
NODE_302201_length_182_cov_127.759036	6	52	53	1	46	0.0217391
NODE_302201_length_182_cov_127.759036	6	52	55	1	46	0.0217391
NODE_302201_length_182_cov_127.759036	6	52	56	1	46	0.0217391
NODE_302201_length_182_cov_127.759036	6	52	57	1	46	0.0217391
NODE_302201_length_182_cov_127.759036	6	52	58	1	46	0.0217391
NODE_302201_length_182_cov_127.759036	6	52	63	1	46	0.0217391
NODE_302201_length_182_cov_127.759036	6	52	64	1	46	0.0217391
NODE_302201_length_182_cov_127.759036	6	52	71	2	46	0.0434783
NODE_302201_length_182_cov_127.759036	6	52	73	1	46	0.0217391
NODE_302201_length_182_cov_127.759036	6	52	76	1	46	0.0217391
NODE_302201_length_182_cov_127.759036	6	52	78	2	46	0.0434783
NODE_302201_length_182_cov_127.759036	6	52	79	1	46	0.0217391
NODE_302201_length_182_cov_127.759036	6	52	86	1	46	0.0217391
NODE_302201_length_182_cov_127.759036	6	52	90	1	46	0.0217391
NODE_302201_length_182_cov_127.759036	6	52	93	1	46	0.0217391
NODE_302201_length_182_cov_127.759036	6	52	97	1	46	0.0217391
NODE_302201_length_182_cov_127.759036	6	52	104	1	46	0.0217391
NODE_302201_length_182_cov_127.759036	6	52	106	1	46	0.0217391
NODE_302201_length_182_cov_127.759036	6	52	110	1	46	0.0217391
NODE_302201_length_182_cov_127.759036	6	52	119	1	46	0.0217391
NODE_302201_length_182_cov_127.759036	6	52	125	1	46	0.0217391
NODE_302201_length_182_cov_127.759036	6	52	126	1	46	0.0217391
NODE_302201_length_182_cov_127.759036	6	52	129	1	46	0.0217391
NODE_302201_length_182_cov_127.759036	6	52	137	1	46	0.0217391
NODE_302201_length_182_cov_127.759036	6	52	138	2	46	0.0434783
NODE_302201_length_182_cov_127.759036	6	52	139	1	46	0.0217391
NODE_302201_length_182_cov_127.759036	6	52	140	2	46	0.0434783
NODE_302201_length_182_cov_127.759036	6	52	143	2	46	0.0434783
NODE_302201_length_182_cov_127.759036	6	52	145	1	46	0.0217391
NODE_302201_length_182_cov_127.759036	6	52	147	1	46	0.0217391
NODE_302201_length_182_cov_127.759036	6	52	150	3	46	0.0652174
NODE_302201_length_182_cov_127.759036	6	52	153	4	46	0.0869565
NODE_302201_length_182_cov_127.759036	59	105	178	3	46	0.0652174
NODE_302201_length_182_cov_127.759036	59	105	180	1	46	0.0217391
NODE_302201_length_182_cov_127.759036	59	105	182	14	46	0.3043478
NODE_302201_length_182_cov_127.759036	59	105	184	28	46	0.6086956
NODE_302214_length_182_cov_29.421687	5	35	0	30	30	1.0000000
NODE_302214_length_182_cov_29.421687	8	88	0	36	80	0.4500000
NODE_302214_length_182_cov_29.421687	8	88	2	2	80	0.0250000
NODE_302214_length_182_cov_29.421687	8	88	4	42	80	0.5250000
NODE_302236_length_181_cov_141.195122	1	60	10	7	59	0.1186441
NODE_302236_length_181_cov_141.195122	1	60	20	1	59	0.0169492
NODE_302236_length_181_cov_141.195122	1	60	21	1	59	0.0169492
NODE_302236_length_181_cov_141.195122	1	60	22	2	59	0.0338983
NODE_302236_length_181_cov_141.195122	1	60	25	2	59	0.0338983
NODE_302236_length_181_cov_141.195122	1	60	26	1	59	0.0169492
NODE_302236_length_181_cov_141.195122	1	60	27	3	59	0.0508475
NODE_302236_length_181_cov_141.195122	1	60	28	5	59	0.0847458
NODE_302236_length_181_cov_141.195122	1	60	29	1	59	0.0169492
NODE_302236_length_181_cov_141.195122	1	60	30	2	59	0.0338983
NODE_302236_length_181_cov_141.195122	1	60	31	2	59	0.0338983
NODE_302236_length_181_cov_141.195122	1	60	32	3	59	0.0508475
NODE_302236_length_181_cov_141.195122	1	60	33	5	59	0.0847458
NODE_302236_length_181_cov_141.195122	1	60	40	3	59	0.0508475
NODE_302236_length_181_cov_141.195122	1	60	41	2	59	0.0338983
NODE_302236_length_181_cov_141.195122	1	60	43	2	59	0.0338983
NODE_302236_length_181_cov_141.195122	1	60	44	1	59	0.0169492
NODE_302236_length_181_cov_141.195122	1	60	45	3	59	0.0508475
NODE_302236_length_181_cov_141.195122	1	60	47	2	59	0.0338983
NODE_302236_length_181_cov_141.195122	1	60	48	1	59	0.0169492
NODE_302236_length_181_cov_141.195122	1	60	49	10	59	0.1694915
NODE_302236_length_181_cov_141.195122	34	60	33	2	26	0.0769231
NODE_302236_length_181_cov_141.195122	34	60	40	3	26	0.1153846
NODE_302236_length_181_cov_141.195122	34	60	41	2	26	0.0769231
NODE_302236_length_181_cov_141.195122	34	60	43	2	26	0.0769231
NODE_302236_length_181_cov_141.195122	34	60	44	1	26	0.0384615
NODE_302236_length_181_cov_141.195122	34	60	45	3	26	0.1153846
NODE_302236_length_181_cov_141.195122	34	60	47	2	26	0.0769231
NODE_302236_length_181_cov_141.195122	34	60	48	1	26	0.0384615
NODE_302236_length_181_cov_141.195122	34	60	49	10	26	0.3846154
NODE_302236_length_181_cov_141.195122	114	145	37	5	31	0.1612903
NODE_302236_length_181_cov_141.195122	114	145	39	1	31	0.0322581
NODE_302236_length_181_cov_141.195122	114	145	42	1	31	0.0322581
NODE_302236_length_181_cov_141.195122	114	145	44	7	31	0.2258064
NODE_302236_length_181_cov_141.195122	114	145	45	4	31	0.1290323
NODE_302236_length_181_cov_141.195122	114	145	46	2	31	0.0645161
NODE_302236_length_181_cov_141.195122	114	145	47	4	31	0.1290323
NODE_302236_length_181_cov_141.195122	114	145	48	4	31	0.1290323
NODE_302236_length_181_cov_141.195122	114	145	49	3	31	0.0967742
NODE_302285_length_180_cov_102.567901	6	75	4	1	69	0.0144928
NODE_302285_length_180_cov_102.567901	6	75	6	37	69	0.5362319
NODE_302285_length_180_cov_102.567901	6	75	8	1	69	0.0144928
NODE_302285_length_180_cov_102.567901	6	75	9	1	69	0.0144928
NODE_302285_length_180_cov_102.567901	6	75	10	2	69	0.0289855
NODE_302285_length_180_cov_102.567901	6	75	12	22	69	0.3188406
NODE_302285_length_180_cov_102.567901	6	75	14	5	69	0.0724638
NODE_302363_length_178_cov_93.620253	81	112	21	31	31	1.0000000
NODE_302365_length_178_cov_62.696203	0	78	3	1	78	0.0128205
NODE_302365_length_178_cov_62.696203	0	78	4	1	78	0.0128205
NODE_302365_length_178_cov_62.696203	0	78	7	1	78	0.0128205
NODE_302365_length_178_cov_62.696203	0	78	8	10	78	0.1282051
NODE_302365_length_178_cov_62.696203	0	78	9	2	78	0.0256410
NODE_302365_length_178_cov_62.696203	0	78	11	9	78	0.1153846
NODE_302365_length_178_cov_62.696203	0	78	14	1	78	0.0128205
NODE_302365_length_178_cov_62.696203	0	78	15	1	78	0.0128205
NODE_302365_length_178_cov_62.696203	0	78	18	1	78	0.0128205
NODE_302365_length_178_cov_62.696203	0	78	19	11	78	0.1410256
NODE_302365_length_178_cov_62.696203	0	78	20	18	78	0.2307692
NODE_302365_length_178_cov_62.696203	0	78	22	22	78	0.2820513
NODE_302365_length_178_cov_62.696203	51	131	18	5	80	0.0625000
NODE_302365_length_178_cov_62.696203	51	131	20	8	80	0.1000000
NODE_302365_length_178_cov_62.696203	51	131	22	67	80	0.8375000
NODE_302477_length_175_cov_116.684211	42	122	9	14	80	0.1750000
NODE_302477_length_175_cov_116.684211	42	122	11	8	80	0.1000000
NODE_302477_length_175_cov_116.684211	42	122	12	58	80	0.7250000
NODE_302477_length_175_cov_116.684211	95	175	0	8	80	0.1000000
NODE_302477_length_175_cov_116.684211	95	175	2	2	80	0.0250000
NODE_302477_length_175_cov_116.684211	95	175	3	10	80	0.1250000
NODE_302477_length_175_cov_116.684211	95	175	5	4	80	0.0500000
NODE_302477_length_175_cov_116.684211	95	175	6	1	80	0.0125000
NODE_302477_length_175_cov_116.684211	95	175	8	2	80	0.0250000
NODE_302477_length_175_cov_116.684211	95	175	10	2	80	0.0250000
NODE_302477_length_175_cov_116.684211	95	175	12	51	80	0.6375000
NODE_302482_length_175_cov_61.000000	81	121	63	2	40	0.0500000
NODE_302482_length_175_cov_61.000000	81	121	64	7	40	0.1750000
NODE_302482_length_175_cov_61.000000	81	121	66	1	40	0.0250000
NODE_302482_length_175_cov_61.000000	81	121	68	5	40	0.1250000
NODE_302482_length_175_cov_61.000000	81	121	70	25	40	0.6250000
NODE_302538_length_174_cov_173.893333	53	93	110	2	40	0.0500000
NODE_302538_length_174_cov_173.893333	53	93	116	1	40	0.0250000
NODE_302538_length_174_cov_173.893333	53	93	118	2	40	0.0500000
NODE_302538_length_174_cov_173.893333	53	93	122	3	40	0.0750000
NODE_302538_length_174_cov_173.893333	53	93	124	3	40	0.0750000
NODE_302538_length_174_cov_173.893333	53	93	125	1	40	0.0250000
NODE_302538_length_174_cov_173.893333	53	93	126	6	40	0.1500000
NODE_302538_length_174_cov_173.893333	53	93	128	22	40	0.5500000
NODE_302543_length_174_cov_50.346667	91	161	4	3	70	0.0428571
NODE_302543_length_174_cov_50.346667	91	161	5	2	70	0.0285714
NODE_302543_length_174_cov_50.346667	91	161	6	1	70	0.0142857
NODE_302543_length_174_cov_50.346667	91	161	7	1	70	0.0142857
NODE_302543_length_174_cov_50.346667	91	161	8	9	70	0.1285714
NODE_302543_length_174_cov_50.346667	91	161	12	1	70	0.0142857
NODE_302543_length_174_cov_50.346667	91	161	14	2	70	0.0285714
NODE_302543_length_174_cov_50.346667	91	161	16	3	70	0.0428571
NODE_302543_length_174_cov_50.346667	91	161	20	2	70	0.0285714
NODE_302543_length_174_cov_50.346667	91	161	22	4	70	0.0571429
NODE_302543_length_174_cov_50.346667	91	161	24	8	70	0.1142857
NODE_302543_length_174_cov_50.346667	91	161	26	10	70	0.1428571
NODE_302543_length_174_cov_50.346667	91	161	28	24	70	0.3428572
NODE_302590_length_173_cov_184.351351	62	126	47	8	64	0.1250000
NODE_302590_length_173_cov_184.351351	62	126	50	2	64	0.0312500
NODE_302590_length_173_cov_184.351351	62	126	52	4	64	0.0625000
NODE_302590_length_173_cov_184.351351	62	126	54	50	64	0.7812500
NODE_302590_length_173_cov_184.351351	62	126	47	8	64	0.1250000
NODE_302590_length_173_cov_184.351351	62	126	50	2	64	0.0312500
NODE_302590_length_173_cov_184.351351	62	126	52	4	64	0.0625000
NODE_302590_length_173_cov_184.351351	62	126	54	50	64	0.7812500
NODE_302590_length_173_cov_184.351351	62	126	47	8	64	0.1250000
NODE_302590_length_173_cov_184.351351	62	126	50	2	64	0.0312500
NODE_302590_length_173_cov_184.351351	62	126	52	4	64	0.0625000
NODE_302590_length_173_cov_184.351351	62	126	54	50	64	0.7812500
NODE_302590_length_173_cov_184.351351	62	126	47	8	64	0.1250000
NODE_302590_length_173_cov_184.351351	62	126	50	2	64	0.0312500
NODE_302590_length_173_cov_184.351351	62	126	52	4	64	0.0625000
NODE_302590_length_173_cov_184.351351	62	126	54	50	64	0.7812500
NODE_302590_length_173_cov_184.351351	99	165	19	3	66	0.0454545
NODE_302590_length_173_cov_184.351351	99	165	21	2	66	0.0303030
NODE_302590_length_173_cov_184.351351	99	165	23	1	66	0.0151515
NODE_302590_length_173_cov_184.351351	99	165	25	1	66	0.0151515
NODE_302590_length_173_cov_184.351351	99	165	26	7	66	0.1060606
NODE_302590_length_173_cov_184.351351	99	165	28	3	66	0.0454545
NODE_302590_length_173_cov_184.351351	99	165	29	3	66	0.0454545
NODE_302590_length_173_cov_184.351351	99	165	31	4	66	0.0606061
NODE_302590_length_173_cov_184.351351	99	165	32	2	66	0.0303030
NODE_302590_length_173_cov_184.351351	99	165	35	3	66	0.0454545
NODE_302590_length_173_cov_184.351351	99	165	36	3	66	0.0454545
NODE_302590_length_173_cov_184.351351	99	165	41	2	66	0.0303030
NODE_302590_length_173_cov_184.351351	99	165	45	1	66	0.0151515
NODE_302590_length_173_cov_184.351351	99	165	47	12	66	0.1818182
NODE_302590_length_173_cov_184.351351	99	165	50	2	66	0.0303030
NODE_302590_length_173_cov_184.351351	99	165	52	4	66	0.0606061
NODE_302590_length_173_cov_184.351351	99	165	54	13	66	0.1969697
NODE_302590_length_173_cov_184.351351	99	170	16	1	71	0.0140845
NODE_302590_length_173_cov_184.351351	99	170	17	3	71	0.0422535
NODE_302590_length_173_cov_184.351351	99	170	19	4	71	0.0563380
NODE_302590_length_173_cov_184.351351	99	170	21	2	71	0.0281690
NODE_302590_length_173_cov_184.351351	99	170	23	1	71	0.0140845
NODE_302590_length_173_cov_184.351351	99	170	25	1	71	0.0140845
NODE_302590_length_173_cov_184.351351	99	170	26	7	71	0.0985916
NODE_302590_length_173_cov_184.351351	99	170	28	3	71	0.0422535
NODE_302590_length_173_cov_184.351351	99	170	29	3	71	0.0422535
NODE_302590_length_173_cov_184.351351	99	170	31	4	71	0.0563380
NODE_302590_length_173_cov_184.351351	99	170	32	2	71	0.0281690
NODE_302590_length_173_cov_184.351351	99	170	35	3	71	0.0422535
NODE_302590_length_173_cov_184.351351	99	170	36	3	71	0.0422535
NODE_302590_length_173_cov_184.351351	99	170	41	2	71	0.0281690
NODE_302590_length_173_cov_184.351351	99	170	45	1	71	0.0140845
NODE_302590_length_173_cov_184.351351	99	170	47	12	71	0.1690141
NODE_302590_length_173_cov_184.351351	99	170	50	2	71	0.0281690
NODE_302590_length_173_cov_184.351351	99	170	52	4	71	0.0563380
NODE_302590_length_173_cov_184.351351	99	170	54	13	71	0.1830986
NODE_302590_length_173_cov_184.351351	115	173	14	1	58	0.0172414
NODE_302590_length_173_cov_184.351351	115	173	16	3	58	0.0517241
NODE_302590_length_173_cov_184.351351	115	173	17	3	58	0.0517241
NODE_302590_length_173_cov_184.351351	115	173	19	4	58	0.0689655
NODE_302590_length_173_cov_184.351351	115	173	21	2	58	0.0344828
NODE_302590_length_173_cov_184.351351	115	173	23	1	58	0.0172414
NODE_302590_length_173_cov_184.351351	115	173	25	1	58	0.0172414
NODE_302590_length_173_cov_184.351351	115	173	26	7	58	0.1206897
NODE_302590_length_173_cov_184.351351	115	173	28	3	58	0.0517241
NODE_302590_length_173_cov_184.351351	115	173	29	3	58	0.0517241
NODE_302590_length_173_cov_184.351351	115	173	31	4	58	0.0689655
NODE_302590_length_173_cov_184.351351	115	173	32	2	58	0.0344828
NODE_302590_length_173_cov_184.351351	115	173	35	3	58	0.0517241
NODE_302590_length_173_cov_184.351351	115	173	36	3	58	0.0517241
NODE_302590_length_173_cov_184.351351	115	173	41	2	58	0.0344828
NODE_302590_length_173_cov_184.351351	115	173	45	1	58	0.0172414
NODE_302590_length_173_cov_184.351351	115	173	47	12	58	0.2068966
NODE_302590_length_173_cov_184.351351	115	173	50	2	58	0.0344828
NODE_302590_length_173_cov_184.351351	115	173	52	1	58	0.0172414
NODE_302596_length_173_cov_58.472973	0	78	0	78	78	1.0000000
NODE_302597_length_173_cov_57.148649	101	142	8	16	41	0.3902439
NODE_302597_length_173_cov_57.148649	101	142	10	25	41	0.6097561
NODE_302597_length_173_cov_57.148649	109	173	3	1	64	0.0156250
NODE_302597_length_173_cov_57.148649	109	173	4	29	64	0.4531250
NODE_302597_length_173_cov_57.148649	109	173	8	17	64	0.2656250
NODE_302597_length_173_cov_57.148649	109	173	10	17	64	0.2656250
NODE_302686_length_171_cov_218.666667	12	90	4	5	78	0.0641026
NODE_302686_length_171_cov_218.666667	12	90	7	3	78	0.0384615
NODE_302686_length_171_cov_218.666667	12	90	8	1	78	0.0128205
NODE_302686_length_171_cov_218.666667	12	90	10	44	78	0.5641026
NODE_302686_length_171_cov_218.666667	12	90	12	25	78	0.3205128
NODE_302686_length_171_cov_218.666667	12	90	4	5	78	0.0641026
NODE_302686_length_171_cov_218.666667	12	90	7	3	78	0.0384615
NODE_302686_length_171_cov_218.666667	12	90	8	1	78	0.0128205
NODE_302686_length_171_cov_218.666667	12	90	10	44	78	0.5641026
NODE_302686_length_171_cov_218.666667	12	90	12	25	78	0.3205128
NODE_302686_length_171_cov_218.666667	21	90	10	44	69	0.6376812
NODE_302686_length_171_cov_218.666667	21	90	12	25	69	0.3623188
NODE_302689_length_171_cov_110.194444	81	161	1	4	80	0.0500000
NODE_302689_length_171_cov_110.194444	81	161	3	2	80	0.0250000
NODE_302689_length_171_cov_110.194444	81	161	5	14	80	0.1750000
NODE_302689_length_171_cov_110.194444	81	161	6	60	80	0.7500000
NODE_302689_length_171_cov_110.194444	81	152	5	11	71	0.1549296
NODE_302689_length_171_cov_110.194444	81	152	6	60	71	0.8450704
NODE_302691_length_171_cov_86.013889	106	171	0	10	65	0.1538462
NODE_302691_length_171_cov_86.013889	106	171	2	5	65	0.0769231
NODE_302691_length_171_cov_86.013889	106	171	3	7	65	0.1076923
NODE_302691_length_171_cov_86.013889	106	171	4	43	65	0.6615385
NODE_302697_length_171_cov_46.430556	0	59	2	1	59	0.0169492
NODE_302697_length_171_cov_46.430556	0	59	3	3	59	0.0508475
NODE_302697_length_171_cov_46.430556	0	59	7	1	59	0.0169492
NODE_302697_length_171_cov_46.430556	0	59	9	1	59	0.0169492
NODE_302697_length_171_cov_46.430556	0	59	11	1	59	0.0169492
NODE_302697_length_171_cov_46.430556	0	59	13	3	59	0.0508475
NODE_302697_length_171_cov_46.430556	0	59	14	3	59	0.0508475
NODE_302697_length_171_cov_46.430556	0	59	15	4	59	0.0677966
NODE_302697_length_171_cov_46.430556	0	59	21	3	59	0.0508475
NODE_302697_length_171_cov_46.430556	0	59	23	1	59	0.0169492
NODE_302697_length_171_cov_46.430556	0	59	25	3	59	0.0508475
NODE_302697_length_171_cov_46.430556	0	59	26	1	59	0.0169492
NODE_302697_length_171_cov_46.430556	0	59	28	1	59	0.0169492
NODE_302697_length_171_cov_46.430556	0	59	32	12	59	0.2033898
NODE_302697_length_171_cov_46.430556	0	59	34	10	59	0.1694915
NODE_302697_length_171_cov_46.430556	0	59	36	11	59	0.1864407
NODE_302697_length_171_cov_46.430556	32	98	32	6	66	0.0909091
NODE_302697_length_171_cov_46.430556	32	98	34	10	66	0.1515152
NODE_302697_length_171_cov_46.430556	32	98	36	50	66	0.7575758
NODE_302700_length_171_cov_40.069444	13	87	0	74	74	1.0000000
NODE_302702_length_171_cov_33.319444	84	158	2	16	74	0.2162162
NODE_302702_length_171_cov_33.319444	84	158	4	7	74	0.0945946
NODE_302702_length_171_cov_33.319444	84	158	6	32	74	0.4324324
NODE_302702_length_171_cov_33.319444	84	158	8	19	74	0.2567568
NODE_302764_length_170_cov_217.422535	10	90	8	1	80	0.0125000
NODE_302764_length_170_cov_217.422535	10	90	9	1	80	0.0125000
NODE_302764_length_170_cov_217.422535	10	90	10	2	80	0.0250000
NODE_302764_length_170_cov_217.422535	10	90	12	3	80	0.0375000
NODE_302764_length_170_cov_217.422535	10	90	14	2	80	0.0250000
NODE_302764_length_170_cov_217.422535	10	90	15	8	80	0.1000000
NODE_302764_length_170_cov_217.422535	10	90	17	3	80	0.0375000
NODE_302764_length_170_cov_217.422535	10	90	19	2	80	0.0250000
NODE_302764_length_170_cov_217.422535	10	90	21	25	80	0.3125000
NODE_302764_length_170_cov_217.422535	10	90	23	6	80	0.0750000
NODE_302764_length_170_cov_217.422535	10	90	25	27	80	0.3375000
NODE_302764_length_170_cov_217.422535	10	90	8	1	80	0.0125000
NODE_302764_length_170_cov_217.422535	10	90	9	1	80	0.0125000
NODE_302764_length_170_cov_217.422535	10	90	10	2	80	0.0250000
NODE_302764_length_170_cov_217.422535	10	90	12	3	80	0.0375000
NODE_302764_length_170_cov_217.422535	10	90	14	2	80	0.0250000
NODE_302764_length_170_cov_217.422535	10	90	15	8	80	0.1000000
NODE_302764_length_170_cov_217.422535	10	90	17	3	80	0.0375000
NODE_302764_length_170_cov_217.422535	10	90	19	2	80	0.0250000
NODE_302764_length_170_cov_217.422535	10	90	21	25	80	0.3125000
NODE_302764_length_170_cov_217.422535	10	90	23	6	80	0.0750000
NODE_302764_length_170_cov_217.422535	10	90	25	27	80	0.3375000
NODE_302764_length_170_cov_217.422535	10	90	8	1	80	0.0125000
NODE_302764_length_170_cov_217.422535	10	90	9	1	80	0.0125000
NODE_302764_length_170_cov_217.422535	10	90	10	2	80	0.0250000
NODE_302764_length_170_cov_217.422535	10	90	12	3	80	0.0375000
NODE_302764_length_170_cov_217.422535	10	90	14	2	80	0.0250000
NODE_302764_length_170_cov_217.422535	10	90	15	8	80	0.1000000
NODE_302764_length_170_cov_217.422535	10	90	17	3	80	0.0375000
NODE_302764_length_170_cov_217.422535	10	90	19	2	80	0.0250000
NODE_302764_length_170_cov_217.422535	10	90	21	25	80	0.3125000
NODE_302764_length_170_cov_217.422535	10	90	23	6	80	0.0750000
NODE_302764_length_170_cov_217.422535	10	90	25	27	80	0.3375000
NODE_302764_length_170_cov_217.422535	10	90	8	1	80	0.0125000
NODE_302764_length_170_cov_217.422535	10	90	9	1	80	0.0125000
NODE_302764_length_170_cov_217.422535	10	90	10	2	80	0.0250000
NODE_302764_length_170_cov_217.422535	10	90	12	3	80	0.0375000
NODE_302764_length_170_cov_217.422535	10	90	14	2	80	0.0250000
NODE_302764_length_170_cov_217.422535	10	90	15	8	80	0.1000000
NODE_302764_length_170_cov_217.422535	10	90	17	3	80	0.0375000
NODE_302764_length_170_cov_217.422535	10	90	19	2	80	0.0250000
NODE_302764_length_170_cov_217.422535	10	90	21	25	80	0.3125000
NODE_302764_length_170_cov_217.422535	10	90	23	6	80	0.0750000
NODE_302764_length_170_cov_217.422535	10	90	25	27	80	0.3375000
NODE_302764_length_170_cov_217.422535	10	90	8	1	80	0.0125000
NODE_302764_length_170_cov_217.422535	10	90	9	1	80	0.0125000
NODE_302764_length_170_cov_217.422535	10	90	10	2	80	0.0250000
NODE_302764_length_170_cov_217.422535	10	90	12	3	80	0.0375000
NODE_302764_length_170_cov_217.422535	10	90	14	2	80	0.0250000
NODE_302764_length_170_cov_217.422535	10	90	15	8	80	0.1000000
NODE_302764_length_170_cov_217.422535	10	90	17	3	80	0.0375000
NODE_302764_length_170_cov_217.422535	10	90	19	2	80	0.0250000
NODE_302764_length_170_cov_217.422535	10	90	21	25	80	0.3125000
NODE_302764_length_170_cov_217.422535	10	90	23	6	80	0.0750000
NODE_302764_length_170_cov_217.422535	10	90	25	27	80	0.3375000
NODE_302764_length_170_cov_217.422535	19	90	15	8	71	0.1126761
NODE_302764_length_170_cov_217.422535	19	90	17	3	71	0.0422535
NODE_302764_length_170_cov_217.422535	19	90	19	2	71	0.0281690
NODE_302764_length_170_cov_217.422535	19	90	21	25	71	0.3521127
NODE_302764_length_170_cov_217.422535	19	90	23	6	71	0.0845070
NODE_302764_length_170_cov_217.422535	19	90	25	27	71	0.3802817
NODE_302764_length_170_cov_217.422535	63	126	21	1	63	0.0158730
NODE_302764_length_170_cov_217.422535	63	126	23	4	63	0.0634921
NODE_302764_length_170_cov_217.422535	63	126	25	58	63	0.9206349
NODE_302764_length_170_cov_217.422535	63	126	21	1	63	0.0158730
NODE_302764_length_170_cov_217.422535	63	126	23	4	63	0.0634921
NODE_302764_length_170_cov_217.422535	63	126	25	58	63	0.9206349
NODE_302768_length_170_cov_102.816901	23	86	13	6	63	0.0952381
NODE_302768_length_170_cov_102.816901	23	86	15	7	63	0.1111111
NODE_302768_length_170_cov_102.816901	23	86	17	12	63	0.1904762
NODE_302768_length_170_cov_102.816901	23	86	19	5	63	0.0793651
NODE_302768_length_170_cov_102.816901	23	86	20	6	63	0.0952381
NODE_302768_length_170_cov_102.816901	23	86	24	3	63	0.0476190
NODE_302768_length_170_cov_102.816901	23	86	26	24	63	0.3809524
NODE_302806_length_169_cov_47.757143	70	150	5	3	80	0.0375000
NODE_302806_length_169_cov_47.757143	70	150	9	77	80	0.9625000
NODE_302869_length_168_cov_10.391304	66	99	0	33	33	1.0000000
NODE_302869_length_168_cov_10.391304	135	168	0	33	33	1.0000000
NODE_302966_length_166_cov_401.149254	31	109	27	2	78	0.0256410
NODE_302966_length_166_cov_401.149254	31	109	29	3	78	0.0384615
NODE_302966_length_166_cov_401.149254	31	109	32	4	78	0.0512821
NODE_302966_length_166_cov_401.149254	31	109	34	1	78	0.0128205
NODE_302966_length_166_cov_401.149254	31	109	38	2	78	0.0256410
NODE_302966_length_166_cov_401.149254	31	109	40	2	78	0.0256410
NODE_302966_length_166_cov_401.149254	31	109	42	2	78	0.0256410
NODE_302966_length_166_cov_401.149254	31	109	43	1	78	0.0128205
NODE_302966_length_166_cov_401.149254	31	109	45	2	78	0.0256410
NODE_302966_length_166_cov_401.149254	31	109	47	13	78	0.1666667
NODE_302966_length_166_cov_401.149254	31	109	49	46	78	0.5897436
NODE_302966_length_166_cov_401.149254	82	157	10	2	75	0.0266667
NODE_302966_length_166_cov_401.149254	82	157	12	5	75	0.0666667
NODE_302966_length_166_cov_401.149254	82	157	14	5	75	0.0666667
NODE_302966_length_166_cov_401.149254	82	157	20	2	75	0.0266667
NODE_302966_length_166_cov_401.149254	82	157	21	1	75	0.0133333
NODE_302966_length_166_cov_401.149254	82	157	22	2	75	0.0266667
NODE_302966_length_166_cov_401.149254	82	157	24	3	75	0.0400000
NODE_302966_length_166_cov_401.149254	82	157	28	2	75	0.0266667
NODE_302966_length_166_cov_401.149254	82	157	30	2	75	0.0266667
NODE_302966_length_166_cov_401.149254	82	157	33	1	75	0.0133333
NODE_302966_length_166_cov_401.149254	82	157	35	7	75	0.0933333
NODE_302966_length_166_cov_401.149254	82	157	37	4	75	0.0533333
NODE_302966_length_166_cov_401.149254	82	157	39	1	75	0.0133333
NODE_302966_length_166_cov_401.149254	82	157	41	1	75	0.0133333
NODE_302966_length_166_cov_401.149254	82	157	43	9	75	0.1200000
NODE_302966_length_166_cov_401.149254	82	157	47	4	75	0.0533333
NODE_302966_length_166_cov_401.149254	82	157	49	24	75	0.3200000
NODE_302974_length_166_cov_123.223881	46	97	4	51	51	1.0000000
NODE_303071_length_164_cov_154.076923	0	75	0	2	75	0.0266667
NODE_303071_length_164_cov_154.076923	0	75	1	3	75	0.0400000
NODE_303071_length_164_cov_154.076923	0	75	2	19	75	0.2533333
NODE_303071_length_164_cov_154.076923	0	75	4	9	75	0.1200000
NODE_303071_length_164_cov_154.076923	0	75	6	2	75	0.0266667
NODE_303071_length_164_cov_154.076923	0	75	7	1	75	0.0133333
NODE_303071_length_164_cov_154.076923	0	75	8	6	75	0.0800000
NODE_303071_length_164_cov_154.076923	0	75	10	19	75	0.2533333
NODE_303071_length_164_cov_154.076923	0	75	12	14	75	0.1866667
NODE_303071_length_164_cov_154.076923	48	128	10	31	80	0.3875000
NODE_303071_length_164_cov_154.076923	48	128	12	49	80	0.6125000
NODE_303074_length_164_cov_69.369231	0	64	0	64	64	1.0000000
NODE_303079_length_164_cov_43.923077	36	100	12	64	64	1.0000000
NODE_303079_length_164_cov_43.923077	36	100	12	64	64	1.0000000
NODE_303079_length_164_cov_43.923077	73	153	11	4	80	0.0500000
NODE_303079_length_164_cov_43.923077	73	153	12	76	80	0.9500000
NODE_303079_length_164_cov_43.923077	73	153	11	4	80	0.0500000
NODE_303079_length_164_cov_43.923077	73	153	12	76	80	0.9500000
NODE_303079_length_164_cov_43.923077	73	153	11	4	80	0.0500000
NODE_303079_length_164_cov_43.923077	73	153	12	76	80	0.9500000
NODE_303079_length_164_cov_43.923077	73	153	11	4	80	0.0500000
NODE_303079_length_164_cov_43.923077	73	153	12	76	80	0.9500000
NODE_303079_length_164_cov_43.923077	73	153	11	4	80	0.0500000
NODE_303079_length_164_cov_43.923077	73	153	12	76	80	0.9500000
NODE_303079_length_164_cov_43.923077	73	144	12	71	71	1.0000000
NODE_303135_length_163_cov_480.593750	0	40	3	3	40	0.0750000
NODE_303135_length_163_cov_480.593750	0	40	4	2	40	0.0500000
NODE_303135_length_163_cov_480.593750	0	40	6	3	40	0.0750000
NODE_303135_length_163_cov_480.593750	0	40	8	6	40	0.1500000
NODE_303135_length_163_cov_480.593750	0	40	10	3	40	0.0750000
NODE_303135_length_163_cov_480.593750	0	40	12	2	40	0.0500000
NODE_303135_length_163_cov_480.593750	0	40	14	1	40	0.0250000
NODE_303135_length_163_cov_480.593750	0	40	16	5	40	0.1250000
NODE_303135_length_163_cov_480.593750	0	40	18	8	40	0.2000000
NODE_303135_length_163_cov_480.593750	0	40	20	7	40	0.1750000
NODE_303136_length_163_cov_368.000000	24	96	11	1	72	0.0138889
NODE_303136_length_163_cov_368.000000	24	96	14	17	72	0.2361111
NODE_303136_length_163_cov_368.000000	24	96	16	10	72	0.1388889
NODE_303136_length_163_cov_368.000000	24	96	18	1	72	0.0138889
NODE_303136_length_163_cov_368.000000	24	96	20	43	72	0.5972222
NODE_303138_length_163_cov_319.843750	0	68	8	2	68	0.0294118
NODE_303138_length_163_cov_319.843750	0	68	10	4	68	0.0588235
NODE_303138_length_163_cov_319.843750	0	68	12	6	68	0.0882353
NODE_303138_length_163_cov_319.843750	0	68	14	39	68	0.5735294
NODE_303138_length_163_cov_319.843750	0	68	16	17	68	0.2500000
NODE_303139_length_163_cov_198.078125	34	109	8	18	75	0.2400000
NODE_303139_length_163_cov_198.078125	34	109	10	57	75	0.7600000
NODE_303139_length_163_cov_198.078125	34	114	8	18	80	0.2250000
NODE_303139_length_163_cov_198.078125	34	114	10	62	80	0.7750000
NODE_303139_length_163_cov_198.078125	35	110	8	17	75	0.2266667
NODE_303139_length_163_cov_198.078125	35	110	10	58	75	0.7733333
NODE_303139_length_163_cov_198.078125	87	163	2	1	76	0.0131579
NODE_303139_length_163_cov_198.078125	87	163	5	7	76	0.0921053
NODE_303139_length_163_cov_198.078125	87	163	6	3	76	0.0394737
NODE_303139_length_163_cov_198.078125	87	163	8	3	76	0.0394737
NODE_303139_length_163_cov_198.078125	87	163	10	62	76	0.8157895
NODE_303139_length_163_cov_198.078125	87	163	2	1	76	0.0131579
NODE_303139_length_163_cov_198.078125	87	163	5	7	76	0.0921053
NODE_303139_length_163_cov_198.078125	87	163	6	3	76	0.0394737
NODE_303139_length_163_cov_198.078125	87	163	8	3	76	0.0394737
NODE_303139_length_163_cov_198.078125	87	163	10	62	76	0.8157895
NODE_303139_length_163_cov_198.078125	87	163	2	1	76	0.0131579
NODE_303139_length_163_cov_198.078125	87	163	5	7	76	0.0921053
NODE_303139_length_163_cov_198.078125	87	163	6	3	76	0.0394737
NODE_303139_length_163_cov_198.078125	87	163	8	3	76	0.0394737
NODE_303139_length_163_cov_198.078125	87	163	10	62	76	0.8157895
NODE_303231_length_162_cov_421.047619	7	56	10	2	49	0.0408163
NODE_303231_length_162_cov_421.047619	7	56	12	1	49	0.0204082
NODE_303231_length_162_cov_421.047619	7	56	14	2	49	0.0408163
NODE_303231_length_162_cov_421.047619	7	56	16	1	49	0.0204082
NODE_303231_length_162_cov_421.047619	7	56	19	1	49	0.0204082
NODE_303231_length_162_cov_421.047619	7	56	21	3	49	0.0612245
NODE_303231_length_162_cov_421.047619	7	56	23	2	49	0.0408163
NODE_303231_length_162_cov_421.047619	7	56	25	2	49	0.0408163
NODE_303231_length_162_cov_421.047619	7	56	27	3	49	0.0612245
NODE_303231_length_162_cov_421.047619	7	56	29	1	49	0.0204082
NODE_303231_length_162_cov_421.047619	7	56	31	4	49	0.0816327
NODE_303231_length_162_cov_421.047619	7	56	33	7	49	0.1428571
NODE_303231_length_162_cov_421.047619	7	56	35	2	49	0.0408163
NODE_303231_length_162_cov_421.047619	7	56	37	1	49	0.0204082
NODE_303231_length_162_cov_421.047619	7	56	41	2	49	0.0408163
NODE_303231_length_162_cov_421.047619	7	56	43	3	49	0.0612245
NODE_303231_length_162_cov_421.047619	7	56	45	6	49	0.1224490
NODE_303231_length_162_cov_421.047619	7	56	47	1	49	0.0204082
NODE_303231_length_162_cov_421.047619	7	56	49	5	49	0.1020408
NODE_303231_length_162_cov_421.047619	29	90	33	7	61	0.1147541
NODE_303231_length_162_cov_421.047619	29	90	35	2	61	0.0327869
NODE_303231_length_162_cov_421.047619	29	90	37	1	61	0.0163934
NODE_303231_length_162_cov_421.047619	29	90	41	2	61	0.0327869
NODE_303231_length_162_cov_421.047619	29	90	43	3	61	0.0491803
NODE_303231_length_162_cov_421.047619	29	90	45	6	61	0.0983607
NODE_303231_length_162_cov_421.047619	29	90	47	1	61	0.0163934
NODE_303231_length_162_cov_421.047619	29	90	49	39	61	0.6393443
NODE_303231_length_162_cov_421.047619	29	92	33	7	63	0.1111111
NODE_303231_length_162_cov_421.047619	29	92	35	2	63	0.0317460
NODE_303231_length_162_cov_421.047619	29	92	37	1	63	0.0158730
NODE_303231_length_162_cov_421.047619	29	92	41	2	63	0.0317460
NODE_303231_length_162_cov_421.047619	29	92	43	3	63	0.0476190
NODE_303231_length_162_cov_421.047619	29	92	45	6	63	0.0952381
NODE_303231_length_162_cov_421.047619	29	92	47	1	63	0.0158730
NODE_303231_length_162_cov_421.047619	29	92	49	41	63	0.6507937
NODE_303231_length_162_cov_421.047619	29	92	33	7	63	0.1111111
NODE_303231_length_162_cov_421.047619	29	92	35	2	63	0.0317460
NODE_303231_length_162_cov_421.047619	29	92	37	1	63	0.0158730
NODE_303231_length_162_cov_421.047619	29	92	41	2	63	0.0317460
NODE_303231_length_162_cov_421.047619	29	92	43	3	63	0.0476190
NODE_303231_length_162_cov_421.047619	29	92	45	6	63	0.0952381
NODE_303231_length_162_cov_421.047619	29	92	47	1	63	0.0158730
NODE_303231_length_162_cov_421.047619	29	92	49	41	63	0.6507937
NODE_303231_length_162_cov_421.047619	29	92	33	7	63	0.1111111
NODE_303231_length_162_cov_421.047619	29	92	35	2	63	0.0317460
NODE_303231_length_162_cov_421.047619	29	92	37	1	63	0.0158730
NODE_303231_length_162_cov_421.047619	29	92	41	2	63	0.0317460
NODE_303231_length_162_cov_421.047619	29	92	43	3	63	0.0476190
NODE_303231_length_162_cov_421.047619	29	92	45	6	63	0.0952381
NODE_303231_length_162_cov_421.047619	29	92	47	1	63	0.0158730
NODE_303231_length_162_cov_421.047619	29	92	49	41	63	0.6507937
NODE_303250_length_162_cov_45.380952	63	127	4	64	64	1.0000000
NODE_303250_length_162_cov_45.380952	63	127	4	64	64	1.0000000
NODE_303250_length_162_cov_45.380952	100	162	2	24	62	0.3870968
NODE_303250_length_162_cov_45.380952	100	162	4	38	62	0.6129032
NODE_303301_length_161_cov_1483.177419	51	131	36	7	80	0.0875000
NODE_303301_length_161_cov_1483.177419	51	131	37	1	80	0.0125000
NODE_303301_length_161_cov_1483.177419	51	131	38	7	80	0.0875000
NODE_303301_length_161_cov_1483.177419	51	131	40	7	80	0.0875000
NODE_303301_length_161_cov_1483.177419	51	131	42	4	80	0.0500000
NODE_303301_length_161_cov_1483.177419	51	131	44	54	80	0.6750000
NODE_303301_length_161_cov_1483.177419	104	161	5	3	57	0.0526316
NODE_303301_length_161_cov_1483.177419	104	161	7	1	57	0.0175439
NODE_303301_length_161_cov_1483.177419	104	161	8	1	57	0.0175439
NODE_303301_length_161_cov_1483.177419	104	161	9	1	57	0.0175439
NODE_303301_length_161_cov_1483.177419	104	161	11	3	57	0.0526316
NODE_303301_length_161_cov_1483.177419	104	161	14	3	57	0.0526316
NODE_303301_length_161_cov_1483.177419	104	161	15	2	57	0.0350877
NODE_303301_length_161_cov_1483.177419	104	161	19	3	57	0.0526316
NODE_303301_length_161_cov_1483.177419	104	161	23	1	57	0.0175439
NODE_303301_length_161_cov_1483.177419	104	161	26	2	57	0.0350877
NODE_303301_length_161_cov_1483.177419	104	161	27	1	57	0.0175439
NODE_303301_length_161_cov_1483.177419	104	161	28	1	57	0.0175439
NODE_303301_length_161_cov_1483.177419	104	161	30	2	57	0.0350877
NODE_303301_length_161_cov_1483.177419	104	161	34	2	57	0.0350877
NODE_303301_length_161_cov_1483.177419	104	161	36	11	57	0.1929825
NODE_303301_length_161_cov_1483.177419	104	161	37	1	57	0.0175439
NODE_303301_length_161_cov_1483.177419	104	161	38	7	57	0.1228070
NODE_303301_length_161_cov_1483.177419	104	161	40	7	57	0.1228070
NODE_303301_length_161_cov_1483.177419	104	161	44	5	57	0.0877193
NODE_303312_length_161_cov_71.500000	33	110	5	27	77	0.3506494
NODE_303312_length_161_cov_71.500000	33	110	7	50	77	0.6493506
NODE_303312_length_161_cov_71.500000	33	110	5	27	77	0.3506494
NODE_303312_length_161_cov_71.500000	33	110	7	50	77	0.6493506
NODE_303312_length_161_cov_71.500000	33	110	5	27	77	0.3506494
NODE_303312_length_161_cov_71.500000	33	110	7	50	77	0.6493506
NODE_303312_length_161_cov_71.500000	33	110	5	27	77	0.3506494
NODE_303312_length_161_cov_71.500000	33	110	7	50	77	0.6493506
NODE_303312_length_161_cov_71.500000	83	149	4	2	66	0.0303030
NODE_303312_length_161_cov_71.500000	83	149	5	21	66	0.3181818
NODE_303312_length_161_cov_71.500000	83	149	7	43	66	0.6515151
NODE_303312_length_161_cov_71.500000	83	161	3	2	78	0.0256410
NODE_303312_length_161_cov_71.500000	83	161	4	12	78	0.1538462
NODE_303312_length_161_cov_71.500000	83	161	5	21	78	0.2692308
NODE_303312_length_161_cov_71.500000	83	161	7	43	78	0.5512820
NODE_303312_length_161_cov_71.500000	86	161	3	2	75	0.0266667
NODE_303312_length_161_cov_71.500000	86	161	4	12	75	0.1600000
NODE_303312_length_161_cov_71.500000	86	161	5	21	75	0.2800000
NODE_303312_length_161_cov_71.500000	86	161	7	40	75	0.5333334
NODE_303312_length_161_cov_71.500000	86	161	3	2	75	0.0266667
NODE_303312_length_161_cov_71.500000	86	161	4	12	75	0.1600000
NODE_303312_length_161_cov_71.500000	86	161	5	21	75	0.2800000
NODE_303312_length_161_cov_71.500000	86	161	7	40	75	0.5333334
NODE_303312_length_161_cov_71.500000	88	161	3	2	73	0.0273973
NODE_303312_length_161_cov_71.500000	88	161	4	12	73	0.1643836
NODE_303312_length_161_cov_71.500000	88	161	5	21	73	0.2876712
NODE_303312_length_161_cov_71.500000	88	161	7	38	73	0.5205479
NODE_303321_length_161_cov_29.758065	0	80	0	9	80	0.1125000
NODE_303321_length_161_cov_29.758065	0	80	2	71	80	0.8875000
NODE_303381_length_160_cov_143.573770	45	125	8	13	80	0.1625000
NODE_303381_length_160_cov_143.573770	45	125	10	67	80	0.8375000
NODE_303381_length_160_cov_143.573770	93	160	0	7	67	0.1044776
NODE_303381_length_160_cov_143.573770	93	160	1	5	67	0.0746269
NODE_303381_length_160_cov_143.573770	93	160	5	6	67	0.0895522
NODE_303381_length_160_cov_143.573770	93	160	6	7	67	0.1044776
NODE_303381_length_160_cov_143.573770	93	160	8	18	67	0.2686567
NODE_303381_length_160_cov_143.573770	93	160	10	24	67	0.3582090
NODE_303381_length_160_cov_143.573770	98	120	8	3	22	0.1363636
NODE_303381_length_160_cov_143.573770	98	120	10	19	22	0.8636364
NODE_303388_length_160_cov_58.245902	0	45	2	36	45	0.8000000
NODE_303388_length_160_cov_58.245902	0	45	4	9	45	0.2000000
NODE_303431_length_159_cov_182.016667	71	156	4	22	85	0.2588235
NODE_303431_length_159_cov_182.016667	71	156	6	63	85	0.7411765
NODE_303431_length_159_cov_182.016667	71	156	4	22	85	0.2588235
NODE_303431_length_159_cov_182.016667	71	156	6	63	85	0.7411765
NODE_303431_length_159_cov_182.016667	71	156	4	22	85	0.2588235
NODE_303431_length_159_cov_182.016667	71	156	6	63	85	0.7411765
NODE_303440_length_159_cov_85.750000	0	43	0	43	43	1.0000000
NODE_303440_length_159_cov_85.750000	16	97	0	81	81	1.0000000
NODE_303440_length_159_cov_85.750000	65	145	0	80	80	1.0000000
NODE_303440_length_159_cov_85.750000	70	92	0	22	22	1.0000000
NODE_303546_length_158_cov_119.813559	34	77	96	5	43	0.1162791
NODE_303546_length_158_cov_119.813559	34	77	97	4	43	0.0930233
NODE_303546_length_158_cov_119.813559	34	77	99	6	43	0.1395349
NODE_303546_length_158_cov_119.813559	34	77	103	8	43	0.1860465
NODE_303546_length_158_cov_119.813559	34	77	104	3	43	0.0697674
NODE_303546_length_158_cov_119.813559	34	77	105	17	43	0.3953488
NODE_303546_length_158_cov_119.813559	78	113	101	2	35	0.0571429
NODE_303546_length_158_cov_119.813559	78	113	103	2	35	0.0571429
NODE_303546_length_158_cov_119.813559	78	113	104	3	35	0.0857143
NODE_303546_length_158_cov_119.813559	78	113	105	28	35	0.8000000
NODE_303546_length_158_cov_119.813559	123	158	43	2	35	0.0571429
NODE_303546_length_158_cov_119.813559	123	158	44	1	35	0.0285714
NODE_303546_length_158_cov_119.813559	123	158	45	1	35	0.0285714
NODE_303546_length_158_cov_119.813559	123	158	48	1	35	0.0285714
NODE_303546_length_158_cov_119.813559	123	158	49	1	35	0.0285714
NODE_303546_length_158_cov_119.813559	123	158	53	1	35	0.0285714
NODE_303546_length_158_cov_119.813559	123	158	54	1	35	0.0285714
NODE_303546_length_158_cov_119.813559	123	158	56	1	35	0.0285714
NODE_303546_length_158_cov_119.813559	123	158	59	1	35	0.0285714
NODE_303546_length_158_cov_119.813559	123	158	63	1	35	0.0285714
NODE_303546_length_158_cov_119.813559	123	158	68	2	35	0.0571429
NODE_303546_length_158_cov_119.813559	123	158	71	1	35	0.0285714
NODE_303546_length_158_cov_119.813559	123	158	72	2	35	0.0571429
NODE_303546_length_158_cov_119.813559	123	158	73	2	35	0.0571429
NODE_303546_length_158_cov_119.813559	123	158	75	3	35	0.0857143
NODE_303546_length_158_cov_119.813559	123	158	76	2	35	0.0571429
NODE_303546_length_158_cov_119.813559	123	158	80	2	35	0.0571429
NODE_303546_length_158_cov_119.813559	123	158	83	1	35	0.0285714
NODE_303546_length_158_cov_119.813559	123	158	85	1	35	0.0285714
NODE_303546_length_158_cov_119.813559	123	158	87	2	35	0.0571429
NODE_303546_length_158_cov_119.813559	123	158	92	2	35	0.0571429
NODE_303546_length_158_cov_119.813559	123	158	93	4	35	0.1142857
NODE_303552_length_158_cov_70.135593	5	82	2	5	77	0.0649351
NODE_303552_length_158_cov_70.135593	5	82	4	72	77	0.9350649
NODE_303552_length_158_cov_70.135593	5	82	2	5	77	0.0649351
NODE_303552_length_158_cov_70.135593	5	82	4	72	77	0.9350649
NODE_303552_length_158_cov_70.135593	81	155	0	21	74	0.2837838
NODE_303552_length_158_cov_70.135593	81	155	2	3	74	0.0405405
NODE_303552_length_158_cov_70.135593	81	155	4	50	74	0.6756757
NODE_303555_length_158_cov_63.559322	80	151	1	1	71	0.0140845
NODE_303555_length_158_cov_63.559322	80	151	2	10	71	0.1408451
NODE_303555_length_158_cov_63.559322	80	151	4	60	71	0.8450704
NODE_303556_length_158_cov_61.203390	2	66	3	2	64	0.0312500
NODE_303556_length_158_cov_61.203390	2	66	4	3	64	0.0468750
NODE_303556_length_158_cov_61.203390	2	66	10	4	64	0.0625000
NODE_303556_length_158_cov_61.203390	2	66	12	3	64	0.0468750
NODE_303556_length_158_cov_61.203390	2	66	14	13	64	0.2031250
NODE_303556_length_158_cov_61.203390	2	66	16	5	64	0.0781250
NODE_303556_length_158_cov_61.203390	2	66	18	6	64	0.0937500
NODE_303556_length_158_cov_61.203390	2	66	20	16	64	0.2500000
NODE_303556_length_158_cov_61.203390	2	66	22	12	64	0.1875000
NODE_303556_length_158_cov_61.203390	2	66	3	2	64	0.0312500
NODE_303556_length_158_cov_61.203390	2	66	4	3	64	0.0468750
NODE_303556_length_158_cov_61.203390	2	66	10	4	64	0.0625000
NODE_303556_length_158_cov_61.203390	2	66	12	3	64	0.0468750
NODE_303556_length_158_cov_61.203390	2	66	14	13	64	0.2031250
NODE_303556_length_158_cov_61.203390	2	66	16	5	64	0.0781250
NODE_303556_length_158_cov_61.203390	2	66	18	6	64	0.0937500
NODE_303556_length_158_cov_61.203390	2	66	20	16	64	0.2500000
NODE_303556_length_158_cov_61.203390	2	66	22	12	64	0.1875000
NODE_303556_length_158_cov_61.203390	2	66	3	2	64	0.0312500
NODE_303556_length_158_cov_61.203390	2	66	4	3	64	0.0468750
NODE_303556_length_158_cov_61.203390	2	66	10	4	64	0.0625000
NODE_303556_length_158_cov_61.203390	2	66	12	3	64	0.0468750
NODE_303556_length_158_cov_61.203390	2	66	14	13	64	0.2031250
NODE_303556_length_158_cov_61.203390	2	66	16	5	64	0.0781250
NODE_303556_length_158_cov_61.203390	2	66	18	6	64	0.0937500
NODE_303556_length_158_cov_61.203390	2	66	20	16	64	0.2500000
NODE_303556_length_158_cov_61.203390	2	66	22	12	64	0.1875000
NODE_303556_length_158_cov_61.203390	39	119	16	1	80	0.0125000
NODE_303556_length_158_cov_61.203390	39	119	18	1	80	0.0125000
NODE_303556_length_158_cov_61.203390	39	119	20	19	80	0.2375000
NODE_303556_length_158_cov_61.203390	39	119	22	59	80	0.7375000
NODE_303563_length_158_cov_40.271186	43	107	4	64	64	1.0000000
NODE_303563_length_158_cov_40.271186	80	151	2	22	71	0.3098592
NODE_303563_length_158_cov_40.271186	80	151	4	49	71	0.6901408
NODE_303566_length_158_cov_29.661017	0	61	0	61	61	1.0000000
NODE_303566_length_158_cov_29.661017	34	64	0	30	30	1.0000000
NODE_303605_length_157_cov_1488.586207	57	138	22	3	81	0.0370370
NODE_303605_length_157_cov_1488.586207	57	138	23	1	81	0.0123457
NODE_303605_length_157_cov_1488.586207	57	138	26	3	81	0.0370370
NODE_303605_length_157_cov_1488.586207	57	138	28	9	81	0.1111111
NODE_303605_length_157_cov_1488.586207	57	138	30	8	81	0.0987654
NODE_303605_length_157_cov_1488.586207	57	138	32	2	81	0.0246914
NODE_303605_length_157_cov_1488.586207	57	138	34	55	81	0.6790124
NODE_303605_length_157_cov_1488.586207	111	157	6	3	46	0.0652174
NODE_303605_length_157_cov_1488.586207	111	157	8	4	46	0.0869565
NODE_303605_length_157_cov_1488.586207	111	157	9	4	46	0.0869565
NODE_303605_length_157_cov_1488.586207	111	157	10	2	46	0.0434783
NODE_303605_length_157_cov_1488.586207	111	157	13	1	46	0.0217391
NODE_303605_length_157_cov_1488.586207	111	157	15	3	46	0.0652174
NODE_303605_length_157_cov_1488.586207	111	157	16	1	46	0.0217391
NODE_303605_length_157_cov_1488.586207	111	157	20	1	46	0.0217391
NODE_303605_length_157_cov_1488.586207	111	157	22	3	46	0.0652174
NODE_303605_length_157_cov_1488.586207	111	157	23	1	46	0.0217391
NODE_303605_length_157_cov_1488.586207	111	157	26	3	46	0.0652174
NODE_303605_length_157_cov_1488.586207	111	157	28	9	46	0.1956522
NODE_303605_length_157_cov_1488.586207	111	157	30	8	46	0.1739130
NODE_303605_length_157_cov_1488.586207	111	157	32	2	46	0.0434783
NODE_303605_length_157_cov_1488.586207	111	157	34	1	46	0.0217391
NODE_303606_length_157_cov_295.896552	32	78	14	10	46	0.2173913
NODE_303606_length_157_cov_295.896552	32	78	16	9	46	0.1956522
NODE_303606_length_157_cov_295.896552	32	78	20	27	46	0.5869565
NODE_303608_length_157_cov_161.689655	0	59	0	59	59	1.0000000
NODE_303608_length_157_cov_161.689655	0	59	0	59	59	1.0000000
NODE_303608_length_157_cov_161.689655	55	135	0	80	80	1.0000000
NODE_303608_length_157_cov_161.689655	55	135	0	80	80	1.0000000
NODE_303608_length_157_cov_161.689655	108	157	0	49	49	1.0000000
NODE_303608_length_157_cov_161.689655	113	157	0	44	44	1.0000000
NODE_303677_length_156_cov_100.491228	0	41	2	10	41	0.2439024
NODE_303677_length_156_cov_100.491228	0	41	4	8	41	0.1951219
NODE_303677_length_156_cov_100.491228	0	41	6	5	41	0.1219512
NODE_303677_length_156_cov_100.491228	0	41	8	18	41	0.4390244
NODE_303677_length_156_cov_100.491228	21	94	6	2	73	0.0273973
NODE_303677_length_156_cov_100.491228	21	94	8	71	73	0.9726027
NODE_303688_length_156_cov_37.368421	24	81	2	5	57	0.0877193
NODE_303688_length_156_cov_37.368421	24	81	6	2	57	0.0350877
NODE_303688_length_156_cov_37.368421	24	81	8	3	57	0.0526316
NODE_303688_length_156_cov_37.368421	24	81	10	47	57	0.8245614
NODE_303688_length_156_cov_37.368421	54	134	9	24	80	0.3000000
NODE_303688_length_156_cov_37.368421	54	134	10	56	80	0.7000000
NODE_303700_length_156_cov_9.543860	2	48	0	46	46	1.0000000
NODE_303700_length_156_cov_9.543860	59	105	0	46	46	1.0000000
NODE_303752_length_155_cov_56.750000	27	102	0	1	75	0.0133333
NODE_303752_length_155_cov_56.750000	27	102	2	74	75	0.9866667
NODE_303752_length_155_cov_56.750000	80	155	0	37	75	0.4933333
NODE_303752_length_155_cov_56.750000	80	155	2	38	75	0.5066667
NODE_304022_length_153_cov_0.944444	5	48	0	43	43	1.0000000
NODE_304022_length_153_cov_0.944444	37	86	0	49	49	1.0000000
NODE_304022_length_153_cov_0.944444	59	102	0	43	43	1.0000000
NODE_304022_length_153_cov_0.944444	91	140	0	49	49	1.0000000
NODE_304022_length_153_cov_0.944444	113	153	0	40	40	1.0000000
NODE_304027_length_152_cov_195.396226	9	89	4	6	80	0.0750000
NODE_304027_length_152_cov_195.396226	9	89	6	7	80	0.0875000
NODE_304027_length_152_cov_195.396226	9	89	8	2	80	0.0250000
NODE_304027_length_152_cov_195.396226	9	89	10	65	80	0.8125000
NODE_304027_length_152_cov_195.396226	9	89	4	6	80	0.0750000
NODE_304027_length_152_cov_195.396226	9	89	6	7	80	0.0875000
NODE_304027_length_152_cov_195.396226	9	89	8	2	80	0.0250000
NODE_304027_length_152_cov_195.396226	9	89	10	65	80	0.8125000
NODE_304027_length_152_cov_195.396226	85	149	4	1	64	0.0156250
NODE_304027_length_152_cov_195.396226	85	149	6	1	64	0.0156250
NODE_304027_length_152_cov_195.396226	85	149	8	17	64	0.2656250
NODE_304027_length_152_cov_195.396226	85	149	10	45	64	0.7031250
NODE_304027_length_152_cov_195.396226	85	152	4	4	67	0.0597015
NODE_304027_length_152_cov_195.396226	85	152	6	1	67	0.0149254
NODE_304027_length_152_cov_195.396226	85	152	8	17	67	0.2537313
NODE_304027_length_152_cov_195.396226	85	152	10	45	67	0.6716418
NODE_304027_length_152_cov_195.396226	85	152	4	4	67	0.0597015
NODE_304027_length_152_cov_195.396226	85	152	6	1	67	0.0149254
NODE_304027_length_152_cov_195.396226	85	152	8	17	67	0.2537313
NODE_304027_length_152_cov_195.396226	85	152	10	45	67	0.6716418
NODE_304027_length_152_cov_195.396226	85	152	4	4	67	0.0597015
NODE_304027_length_152_cov_195.396226	85	152	6	1	67	0.0149254
NODE_304027_length_152_cov_195.396226	85	152	8	17	67	0.2537313
NODE_304027_length_152_cov_195.396226	85	152	10	45	67	0.6716418
NODE_304030_length_152_cov_68.094340	99	150	2	51	51	1.0000000
NODE_304112_length_151_cov_541.615385	19	88	2	12	69	0.1739130
NODE_304112_length_151_cov_541.615385	19	88	4	6	69	0.0869565
NODE_304112_length_151_cov_541.615385	19	88	6	1	69	0.0144928
NODE_304112_length_151_cov_541.615385	19	88	8	50	69	0.7246377
NODE_304112_length_151_cov_541.615385	72	149	0	12	77	0.1558442
NODE_304112_length_151_cov_541.615385	72	149	2	3	77	0.0389610
NODE_304112_length_151_cov_541.615385	72	149	4	9	77	0.1168831
NODE_304112_length_151_cov_541.615385	72	149	6	17	77	0.2207792
NODE_304112_length_151_cov_541.615385	72	149	8	36	77	0.4675325
NODE_304229_length_150_cov_88.647059	51	102	0	51	51	1.0000000
NODE_304472_length_148_cov_34.183673	23	99	14	9	76	0.1184211
NODE_304472_length_148_cov_34.183673	23	99	18	1	76	0.0131579
NODE_304472_length_148_cov_34.183673	23	99	20	3	76	0.0394737
NODE_304472_length_148_cov_34.183673	23	99	22	63	76	0.8289474
NODE_304570_length_147_cov_472.354167	0	55	0	14	55	0.2545455
NODE_304570_length_147_cov_472.354167	0	55	2	41	55	0.7454545
NODE_304570_length_147_cov_472.354167	12	89	0	2	77	0.0259740
NODE_304570_length_147_cov_472.354167	12	89	2	75	77	0.9740260
NODE_304570_length_147_cov_472.354167	65	137	2	72	72	1.0000000
NODE_304572_length_147_cov_229.729167	7	56	4	1	49	0.0204082
NODE_304572_length_147_cov_229.729167	7	56	6	3	49	0.0612245
NODE_304572_length_147_cov_229.729167	7	56	8	12	49	0.2448980
NODE_304572_length_147_cov_229.729167	7	56	10	3	49	0.0612245
NODE_304572_length_147_cov_229.729167	7	56	12	11	49	0.2244898
NODE_304572_length_147_cov_229.729167	7	56	14	19	49	0.3877551
NODE_304572_length_147_cov_229.729167	29	93	12	8	64	0.1250000
NODE_304572_length_147_cov_229.729167	29	93	14	56	64	0.8750000
NODE_304572_length_147_cov_229.729167	29	93	12	8	64	0.1250000
NODE_304572_length_147_cov_229.729167	29	93	14	56	64	0.8750000
NODE_304572_length_147_cov_229.729167	29	93	12	8	64	0.1250000
NODE_304572_length_147_cov_229.729167	29	93	14	56	64	0.8750000
NODE_304573_length_147_cov_213.770833	37	117	0	80	80	1.0000000
NODE_304573_length_147_cov_213.770833	90	146	0	56	56	1.0000000
NODE_304697_length_146_cov_182.893617	1	60	7	1	59	0.0169492
NODE_304697_length_146_cov_182.893617	1	60	9	2	59	0.0338983
NODE_304697_length_146_cov_182.893617	1	60	10	5	59	0.0847458
NODE_304697_length_146_cov_182.893617	1	60	12	14	59	0.2372881
NODE_304697_length_146_cov_182.893617	1	60	14	37	59	0.6271186
NODE_304697_length_146_cov_182.893617	34	60	14	26	26	1.0000000
NODE_304697_length_146_cov_182.893617	113	144	4	1	31	0.0322581
NODE_304697_length_146_cov_182.893617	113	144	6	2	31	0.0645161
NODE_304697_length_146_cov_182.893617	113	144	7	16	31	0.5161290
NODE_304697_length_146_cov_182.893617	113	144	9	10	31	0.3225806
NODE_304697_length_146_cov_182.893617	113	144	12	2	31	0.0645161
NODE_304698_length_146_cov_152.808511	0	69	0	39	69	0.5652174
NODE_304698_length_146_cov_152.808511	0	69	2	30	69	0.4347826
NODE_304698_length_146_cov_152.808511	42	122	2	80	80	1.0000000
NODE_304703_length_146_cov_89.808511	0	53	0	53	53	1.0000000
NODE_304703_length_146_cov_89.808511	26	106	0	80	80	1.0000000
NODE_304703_length_146_cov_89.808511	74	146	0	72	72	1.0000000
NODE_304703_length_146_cov_89.808511	79	101	0	22	22	1.0000000
NODE_304707_length_146_cov_57.446809	44	124	0	80	80	1.0000000
NODE_304708_length_146_cov_54.106383	0	69	0	69	69	1.0000000
NODE_304708_length_146_cov_54.106383	42	122	0	80	80	1.0000000
NODE_304710_length_146_cov_46.765957	3	83	0	80	80	1.0000000
NODE_304710_length_146_cov_46.765957	3	83	0	80	80	1.0000000
NODE_304710_length_146_cov_46.765957	3	83	0	80	80	1.0000000
NODE_304710_length_146_cov_46.765957	3	83	0	80	80	1.0000000
NODE_304710_length_146_cov_46.765957	3	83	0	80	80	1.0000000
NODE_304710_length_146_cov_46.765957	12	83	0	71	71	1.0000000
NODE_304710_length_146_cov_46.765957	56	136	0	80	80	1.0000000
NODE_304710_length_146_cov_46.765957	56	136	0	80	80	1.0000000
NODE_304711_length_146_cov_44.021277	0	69	0	69	69	1.0000000
NODE_304711_length_146_cov_44.021277	42	122	0	80	80	1.0000000
NODE_304798_length_145_cov_1385.413043	0	69	21	1	69	0.0144928
NODE_304798_length_145_cov_1385.413043	0	69	23	1	69	0.0144928
NODE_304798_length_145_cov_1385.413043	0	69	25	2	69	0.0289855
NODE_304798_length_145_cov_1385.413043	0	69	27	1	69	0.0144928
NODE_304798_length_145_cov_1385.413043	0	69	28	4	69	0.0579710
NODE_304798_length_145_cov_1385.413043	0	69	32	3	69	0.0434783
NODE_304798_length_145_cov_1385.413043	0	69	36	2	69	0.0289855
NODE_304798_length_145_cov_1385.413043	0	69	40	1	69	0.0144928
NODE_304798_length_145_cov_1385.413043	0	69	44	1	69	0.0144928
NODE_304798_length_145_cov_1385.413043	0	69	46	1	69	0.0144928
NODE_304798_length_145_cov_1385.413043	0	69	50	4	69	0.0579710
NODE_304798_length_145_cov_1385.413043	0	69	52	6	69	0.0869565
NODE_304798_length_145_cov_1385.413043	0	69	54	2	69	0.0289855
NODE_304798_length_145_cov_1385.413043	0	69	60	3	69	0.0434783
NODE_304798_length_145_cov_1385.413043	0	69	62	6	69	0.0869565
NODE_304798_length_145_cov_1385.413043	0	69	64	5	69	0.0724638
NODE_304798_length_145_cov_1385.413043	0	69	66	26	69	0.3768116
NODE_304798_length_145_cov_1385.413043	42	122	48	6	80	0.0750000
NODE_304798_length_145_cov_1385.413043	42	122	51	1	80	0.0125000
NODE_304798_length_145_cov_1385.413043	42	122	54	2	80	0.0250000
NODE_304798_length_145_cov_1385.413043	42	122	58	9	80	0.1125000
NODE_304798_length_145_cov_1385.413043	42	122	60	2	80	0.0250000
NODE_304798_length_145_cov_1385.413043	42	122	64	1	80	0.0125000
NODE_304798_length_145_cov_1385.413043	42	122	66	59	80	0.7375000
NODE_304799_length_145_cov_880.369565	56	120	20	10	64	0.1562500
NODE_304799_length_145_cov_880.369565	56	120	22	1	64	0.0156250
NODE_304799_length_145_cov_880.369565	56	120	24	1	64	0.0156250
NODE_304799_length_145_cov_880.369565	56	120	26	52	64	0.8125000
NODE_304799_length_145_cov_880.369565	56	120	20	10	64	0.1562500
NODE_304799_length_145_cov_880.369565	56	120	22	1	64	0.0156250
NODE_304799_length_145_cov_880.369565	56	120	24	1	64	0.0156250
NODE_304799_length_145_cov_880.369565	56	120	26	52	64	0.8125000
NODE_304799_length_145_cov_880.369565	56	120	20	10	64	0.1562500
NODE_304799_length_145_cov_880.369565	56	120	22	1	64	0.0156250
NODE_304799_length_145_cov_880.369565	56	120	24	1	64	0.0156250
NODE_304799_length_145_cov_880.369565	56	120	26	52	64	0.8125000
NODE_304799_length_145_cov_880.369565	93	142	6	1	49	0.0204082
NODE_304799_length_145_cov_880.369565	93	142	10	5	49	0.1020408
NODE_304799_length_145_cov_880.369565	93	142	12	4	49	0.0816327
NODE_304799_length_145_cov_880.369565	93	142	14	4	49	0.0816327
NODE_304799_length_145_cov_880.369565	93	142	16	2	49	0.0408163
NODE_304799_length_145_cov_880.369565	93	142	18	6	49	0.1224490
NODE_304799_length_145_cov_880.369565	93	142	20	10	49	0.2040816
NODE_304799_length_145_cov_880.369565	93	142	22	1	49	0.0204082
NODE_304799_length_145_cov_880.369565	93	142	24	1	49	0.0204082
NODE_304799_length_145_cov_880.369565	93	142	26	15	49	0.3061225
NODE_304923_length_144_cov_46.155556	1	81	0	6	80	0.0750000
NODE_304923_length_144_cov_46.155556	1	81	2	6	80	0.0750000
NODE_304923_length_144_cov_46.155556	1	81	4	68	80	0.8500000
NODE_305208_length_142_cov_244.488372	0	52	1	5	52	0.0961538
NODE_305208_length_142_cov_244.488372	0	52	3	15	52	0.2884615
NODE_305208_length_142_cov_244.488372	0	52	5	15	52	0.2884615
NODE_305208_length_142_cov_244.488372	0	52	6	17	52	0.3269231
NODE_305229_length_142_cov_46.976744	1	65	4	2	64	0.0312500
NODE_305229_length_142_cov_46.976744	1	65	6	62	64	0.9687500
NODE_305229_length_142_cov_46.976744	1	65	4	2	64	0.0312500
NODE_305229_length_142_cov_46.976744	1	65	6	62	64	0.9687500
NODE_305229_length_142_cov_46.976744	1	65	4	2	64	0.0312500
NODE_305229_length_142_cov_46.976744	1	65	6	62	64	0.9687500
NODE_305230_length_142_cov_45.000000	0	69	0	39	69	0.5652174
NODE_305230_length_142_cov_45.000000	0	69	2	30	69	0.4347826
NODE_305385_length_141_cov_178.785714	58	118	2	60	60	1.0000000
NODE_305398_length_141_cov_62.285714	26	106	0	80	80	1.0000000
NODE_305398_length_141_cov_62.285714	26	106	0	80	80	1.0000000
NODE_305398_length_141_cov_62.285714	26	97	0	71	71	1.0000000
NODE_305402_length_141_cov_41.142857	26	97	0	71	71	1.0000000
NODE_305600_length_140_cov_60.439024	8	88	2	13	80	0.1625000
NODE_305600_length_140_cov_60.439024	8	88	4	67	80	0.8375000
NODE_305600_length_140_cov_60.439024	8	88	2	13	80	0.1625000
NODE_305600_length_140_cov_60.439024	8	88	4	67	80	0.8375000
NODE_305600_length_140_cov_60.439024	8	88	2	13	80	0.1625000
NODE_305600_length_140_cov_60.439024	8	88	4	67	80	0.8375000
NODE_305600_length_140_cov_60.439024	8	88	2	13	80	0.1625000
NODE_305600_length_140_cov_60.439024	8	88	4	67	80	0.8375000
NODE_305600_length_140_cov_60.439024	8	88	2	13	80	0.1625000
NODE_305600_length_140_cov_60.439024	8	88	4	67	80	0.8375000
NODE_305616_length_140_cov_35.146341	22	102	0	80	80	1.0000000
NODE_305616_length_140_cov_35.146341	75	105	0	30	30	1.0000000
NODE_305618_length_140_cov_34.048780	0	77	0	14	77	0.1818182
NODE_305618_length_140_cov_34.048780	0	77	4	63	77	0.8181818
NODE_305618_length_140_cov_34.048780	0	77	0	14	77	0.1818182
NODE_305618_length_140_cov_34.048780	0	77	4	63	77	0.8181818
NODE_305618_length_140_cov_34.048780	50	130	0	6	80	0.0750000
NODE_305618_length_140_cov_34.048780	50	130	4	74	80	0.9250000
NODE_305618_length_140_cov_34.048780	50	130	0	6	80	0.0750000
NODE_305618_length_140_cov_34.048780	50	130	4	74	80	0.9250000
NODE_305618_length_140_cov_34.048780	55	130	0	6	75	0.0800000
NODE_305618_length_140_cov_34.048780	55	130	4	69	75	0.9200000
NODE_305619_length_140_cov_19.926829	44	118	0	74	74	1.0000000
NODE_305783_length_139_cov_29.700000	0	40	0	29	40	0.7250000
NODE_305783_length_139_cov_29.700000	0	40	1	1	40	0.0250000
NODE_305783_length_139_cov_29.700000	0	40	2	10	40	0.2500000
NODE_305783_length_139_cov_29.700000	0	40	0	29	40	0.7250000
NODE_305783_length_139_cov_29.700000	0	40	1	1	40	0.0250000
NODE_305783_length_139_cov_29.700000	0	40	2	10	40	0.2500000
NODE_305783_length_139_cov_29.700000	13	93	0	16	80	0.2000000
NODE_305783_length_139_cov_29.700000	13	93	1	1	80	0.0125000
NODE_305783_length_139_cov_29.700000	13	93	2	63	80	0.7875000
NODE_305783_length_139_cov_29.700000	13	93	0	16	80	0.2000000
NODE_305783_length_139_cov_29.700000	13	93	1	1	80	0.0125000
NODE_305783_length_139_cov_29.700000	13	93	2	63	80	0.7875000
NODE_305783_length_139_cov_29.700000	13	93	0	16	80	0.2000000
NODE_305783_length_139_cov_29.700000	13	93	1	1	80	0.0125000
NODE_305783_length_139_cov_29.700000	13	93	2	63	80	0.7875000
NODE_305783_length_139_cov_29.700000	13	93	0	16	80	0.2000000
NODE_305783_length_139_cov_29.700000	13	93	1	1	80	0.0125000
NODE_305783_length_139_cov_29.700000	13	93	2	63	80	0.7875000
NODE_305783_length_139_cov_29.700000	13	93	0	16	80	0.2000000
NODE_305783_length_139_cov_29.700000	13	93	1	1	80	0.0125000
NODE_305783_length_139_cov_29.700000	13	93	2	63	80	0.7875000
NODE_305783_length_139_cov_29.700000	13	84	0	16	71	0.2253521
NODE_305783_length_139_cov_29.700000	13	84	1	1	71	0.0140845
NODE_305783_length_139_cov_29.700000	13	84	2	54	71	0.7605634
NODE_305936_length_138_cov_1475.615385	30	97	28	67	67	1.0000000
NODE_305936_length_138_cov_1475.615385	70	138	14	1	68	0.0147059
NODE_305936_length_138_cov_1475.615385	70	138	16	1	68	0.0147059
NODE_305936_length_138_cov_1475.615385	70	138	18	3	68	0.0441176
NODE_305936_length_138_cov_1475.615385	70	138	24	23	68	0.3382353
NODE_305936_length_138_cov_1475.615385	70	138	26	5	68	0.0735294
NODE_305936_length_138_cov_1475.615385	70	138	28	35	68	0.5147059
NODE_305963_length_138_cov_29.564103	11	91	2	14	80	0.1750000
NODE_305963_length_138_cov_29.564103	11	91	4	66	80	0.8250000
NODE_305963_length_138_cov_29.564103	11	91	2	14	80	0.1750000
NODE_305963_length_138_cov_29.564103	11	91	4	66	80	0.8250000
NODE_305963_length_138_cov_29.564103	64	128	2	9	64	0.1406250
NODE_305963_length_138_cov_29.564103	64	128	4	55	64	0.8593750
NODE_305963_length_138_cov_29.564103	64	128	2	9	64	0.1406250
NODE_305963_length_138_cov_29.564103	64	128	4	55	64	0.8593750
NODE_306081_length_137_cov_185.684211	20	104	6	84	84	1.0000000
NODE_306092_length_137_cov_58.289474	76	106	14	30	30	1.0000000
NODE_306099_length_137_cov_36.473684	31	111	8	1	80	0.0125000
NODE_306099_length_137_cov_36.473684	31	111	10	79	80	0.9875000
NODE_306208_length_136_cov_1257.621622	27	107	8	3	80	0.0375000
NODE_306208_length_136_cov_1257.621622	27	107	10	77	80	0.9625000
NODE_306209_length_136_cov_769.594595	0	69	0	15	69	0.2173913
NODE_306209_length_136_cov_769.594595	0	69	2	6	69	0.0869565
NODE_306209_length_136_cov_769.594595	0	69	4	2	69	0.0289855
NODE_306209_length_136_cov_769.594595	0	69	6	46	69	0.6666667
NODE_306222_length_136_cov_128.324324	39	119	2	80	80	1.0000000
NODE_306227_length_136_cov_90.783784	10	86	0	76	76	1.0000000
NODE_306227_length_136_cov_90.783784	59	136	0	77	77	1.0000000
NODE_306368_length_135_cov_2144.166667	0	73	2	3	73	0.0410959
NODE_306368_length_135_cov_2144.166667	0	73	4	2	73	0.0273973
NODE_306368_length_135_cov_2144.166667	0	73	6	1	73	0.0136986
NODE_306368_length_135_cov_2144.166667	0	73	8	8	73	0.1095890
NODE_306368_length_135_cov_2144.166667	0	73	10	2	73	0.0273973
NODE_306368_length_135_cov_2144.166667	0	73	12	17	73	0.2328767
NODE_306368_length_135_cov_2144.166667	0	73	14	40	73	0.5479452
NODE_306368_length_135_cov_2144.166667	46	126	4	2	80	0.0250000
NODE_306368_length_135_cov_2144.166667	46	126	6	2	80	0.0250000
NODE_306368_length_135_cov_2144.166667	46	126	8	8	80	0.1000000
NODE_306368_length_135_cov_2144.166667	46	126	10	3	80	0.0375000
NODE_306368_length_135_cov_2144.166667	46	126	12	8	80	0.1000000
NODE_306368_length_135_cov_2144.166667	46	126	14	57	80	0.7125000
NODE_306368_length_135_cov_2144.166667	83	135	0	2	52	0.0384615
NODE_306368_length_135_cov_2144.166667	83	135	2	5	52	0.0961538
NODE_306368_length_135_cov_2144.166667	83	135	4	4	52	0.0769231
NODE_306368_length_135_cov_2144.166667	83	135	6	2	52	0.0384615
NODE_306368_length_135_cov_2144.166667	83	135	8	8	52	0.1538462
NODE_306368_length_135_cov_2144.166667	83	135	10	3	52	0.0576923
NODE_306368_length_135_cov_2144.166667	83	135	12	8	52	0.1538462
NODE_306368_length_135_cov_2144.166667	83	135	14	20	52	0.3846154
NODE_306370_length_135_cov_630.194444	0	76	0	13	76	0.1710526
NODE_306370_length_135_cov_630.194444	0	76	2	63	76	0.8289474
NODE_306371_length_135_cov_540.611111	0	76	0	76	76	1.0000000
NODE_306373_length_135_cov_257.416667	36	88	6	52	52	1.0000000
NODE_306374_length_135_cov_239.638889	97	135	4	1	38	0.0263158
NODE_306374_length_135_cov_239.638889	97	135	6	3	38	0.0789474
NODE_306374_length_135_cov_239.638889	97	135	9	2	38	0.0526316
NODE_306374_length_135_cov_239.638889	97	135	13	5	38	0.1315790
NODE_306374_length_135_cov_239.638889	97	135	17	4	38	0.1052632
NODE_306374_length_135_cov_239.638889	97	135	19	4	38	0.1052632
NODE_306374_length_135_cov_239.638889	97	135	21	1	38	0.0263158
NODE_306374_length_135_cov_239.638889	97	135	23	1	38	0.0263158
NODE_306374_length_135_cov_239.638889	97	135	25	2	38	0.0526316
NODE_306374_length_135_cov_239.638889	97	135	27	3	38	0.0789474
NODE_306374_length_135_cov_239.638889	97	135	29	7	38	0.1842105
NODE_306374_length_135_cov_239.638889	97	135	30	5	38	0.1315790
NODE_306400_length_135_cov_35.055556	8	88	0	6	80	0.0750000
NODE_306400_length_135_cov_35.055556	8	88	2	74	80	0.9250000
NODE_306400_length_135_cov_35.055556	61	125	0	1	64	0.0156250
NODE_306400_length_135_cov_35.055556	61	125	2	63	64	0.9843750
NODE_306400_length_135_cov_35.055556	61	125	0	1	64	0.0156250
NODE_306400_length_135_cov_35.055556	61	125	2	63	64	0.9843750
NODE_306402_length_135_cov_31.805556	0	76	0	76	76	1.0000000
NODE_306658_length_133_cov_140.411765	8	43	37	3	35	0.0857143
NODE_306658_length_133_cov_140.411765	8	43	38	1	35	0.0285714
NODE_306658_length_133_cov_140.411765	8	43	40	1	35	0.0285714
NODE_306658_length_133_cov_140.411765	8	43	41	5	35	0.1428571
NODE_306658_length_133_cov_140.411765	8	43	45	6	35	0.1714286
NODE_306658_length_133_cov_140.411765	8	43	47	2	35	0.0571429
NODE_306658_length_133_cov_140.411765	8	43	49	2	35	0.0571429
NODE_306658_length_133_cov_140.411765	8	43	53	15	35	0.4285714
NODE_306658_length_133_cov_140.411765	53	88	53	35	35	1.0000000
NODE_306658_length_133_cov_140.411765	98	133	33	2	35	0.0571429
NODE_306658_length_133_cov_140.411765	98	133	36	1	35	0.0285714
NODE_306658_length_133_cov_140.411765	98	133	40	9	35	0.2571429
NODE_306658_length_133_cov_140.411765	98	133	42	1	35	0.0285714
NODE_306658_length_133_cov_140.411765	98	133	45	1	35	0.0285714
NODE_306658_length_133_cov_140.411765	98	133	46	4	35	0.1142857
NODE_306658_length_133_cov_140.411765	98	133	48	1	35	0.0285714
NODE_306658_length_133_cov_140.411765	98	133	52	14	35	0.4000000
NODE_306658_length_133_cov_140.411765	98	133	53	2	35	0.0571429
NODE_306661_length_133_cov_109.441176	63	129	2	66	66	1.0000000
NODE_306812_length_132_cov_114.151515	2	44	0	1	42	0.0238095
NODE_306812_length_132_cov_114.151515	2	44	1	3	42	0.0714286
NODE_306812_length_132_cov_114.151515	2	44	2	38	42	0.9047619
NODE_306812_length_132_cov_114.151515	4	44	1	2	40	0.0500000
NODE_306812_length_132_cov_114.151515	4	44	2	38	40	0.9500000
NODE_306812_length_132_cov_114.151515	17	83	2	66	66	1.0000000
NODE_306812_length_132_cov_114.151515	17	88	2	71	71	1.0000000
NODE_306824_length_132_cov_61.636364	3	76	0	73	73	1.0000000
NODE_306824_length_132_cov_61.636364	49	130	0	81	81	1.0000000
NODE_306824_length_132_cov_61.636364	103	125	0	22	22	1.0000000
NODE_306834_length_132_cov_33.393939	2	83	0	81	81	1.0000000
NODE_306834_length_132_cov_33.393939	7	29	0	22	22	1.0000000
NODE_306834_length_132_cov_33.393939	56	129	0	73	73	1.0000000
NODE_306965_length_131_cov_810.000000	0	60	7	1	60	0.0166667
NODE_306965_length_131_cov_810.000000	0	60	9	7	60	0.1166667
NODE_306965_length_131_cov_810.000000	0	60	10	2	60	0.0333333
NODE_306965_length_131_cov_810.000000	0	60	12	4	60	0.0666667
NODE_306965_length_131_cov_810.000000	0	60	14	13	60	0.2166667
NODE_306965_length_131_cov_810.000000	0	60	16	33	60	0.5500000
NODE_306965_length_131_cov_810.000000	33	97	16	64	64	1.0000000
NODE_306965_length_131_cov_810.000000	33	97	16	64	64	1.0000000
NODE_306965_length_131_cov_810.000000	33	97	16	64	64	1.0000000
NODE_306985_length_131_cov_149.187500	25	105	8	80	80	1.0000000
NODE_306985_length_131_cov_149.187500	78	131	0	2	53	0.0377358
NODE_306985_length_131_cov_149.187500	78	131	2	4	53	0.0754717
NODE_306985_length_131_cov_149.187500	78	131	4	1	53	0.0188679
NODE_306985_length_131_cov_149.187500	78	131	8	46	53	0.8679245
NODE_307121_length_130_cov_319.806452	54	126	4	19	72	0.2638889
NODE_307121_length_130_cov_319.806452	54	126	6	53	72	0.7361111
NODE_307132_length_130_cov_153.516129	82	113	2	31	31	1.0000000
NODE_307140_length_130_cov_79.064516	0	53	0	28	53	0.5283019
NODE_307140_length_130_cov_79.064516	0	53	2	25	53	0.4716981
NODE_307140_length_130_cov_79.064516	26	56	0	2	30	0.0666667
NODE_307140_length_130_cov_79.064516	26	56	2	28	30	0.9333333
NODE_307270_length_129_cov_1851.133333	0	45	0	1	45	0.0222222
NODE_307270_length_129_cov_1851.133333	0	45	2	10	45	0.2222222
NODE_307270_length_129_cov_1851.133333	0	45	4	2	45	0.0444444
NODE_307270_length_129_cov_1851.133333	0	45	6	13	45	0.2888889
NODE_307270_length_129_cov_1851.133333	0	45	8	19	45	0.4222222
NODE_307270_length_129_cov_1851.133333	18	98	6	8	80	0.1000000
NODE_307270_length_129_cov_1851.133333	18	98	8	72	80	0.9000000
NODE_307285_length_129_cov_186.500000	0	78	0	20	78	0.2564103
NODE_307285_length_129_cov_186.500000	0	78	2	6	78	0.0769231
NODE_307285_length_129_cov_186.500000	0	78	4	52	78	0.6666667
NODE_307285_length_129_cov_186.500000	53	129	0	8	76	0.1052632
NODE_307285_length_129_cov_186.500000	53	129	2	17	76	0.2236842
NODE_307285_length_129_cov_186.500000	53	129	4	51	76	0.6710526
NODE_307287_length_129_cov_165.466667	36	111	2	2	75	0.0266667
NODE_307287_length_129_cov_165.466667	36	111	4	73	75	0.9733334
NODE_307287_length_129_cov_165.466667	84	113	2	4	29	0.1379310
NODE_307287_length_129_cov_165.466667	84	113	4	25	29	0.8620690
NODE_307292_length_129_cov_90.366667	0	48	0	48	48	1.0000000
NODE_307292_length_129_cov_90.366667	0	48	0	48	48	1.0000000
NODE_307292_length_129_cov_90.366667	0	48	0	48	48	1.0000000
NODE_307292_length_129_cov_90.366667	21	101	0	80	80	1.0000000
NODE_307442_length_128_cov_2621.517241	3	83	2	1	80	0.0125000
NODE_307442_length_128_cov_2621.517241	3	83	6	18	80	0.2250000
NODE_307442_length_128_cov_2621.517241	3	83	8	61	80	0.7625000
NODE_307442_length_128_cov_2621.517241	8	30	6	14	22	0.6363636
NODE_307442_length_128_cov_2621.517241	8	30	8	8	22	0.3636364
NODE_307442_length_128_cov_2621.517241	56	128	2	15	72	0.2083333
NODE_307442_length_128_cov_2621.517241	56	128	4	5	72	0.0694444
NODE_307442_length_128_cov_2621.517241	56	128	6	1	72	0.0138889
NODE_307442_length_128_cov_2621.517241	56	128	8	51	72	0.7083333
NODE_307443_length_128_cov_1604.275862	58	127	0	1	69	0.0144928
NODE_307443_length_128_cov_1604.275862	58	127	2	15	69	0.2173913
NODE_307443_length_128_cov_1604.275862	58	127	6	2	69	0.0289855
NODE_307443_length_128_cov_1604.275862	58	127	8	51	69	0.7391304
NODE_307458_length_128_cov_79.034483	43	123	0	4	80	0.0500000
NODE_307458_length_128_cov_79.034483	43	123	2	76	80	0.9500000
NODE_307464_length_128_cov_61.793103	5	85	0	80	80	1.0000000
NODE_307549_length_127_cov_1879.785714	21	101	10	80	80	1.0000000
NODE_307549_length_127_cov_1879.785714	74	127	4	3	53	0.0566038
NODE_307549_length_127_cov_1879.785714	74	127	8	4	53	0.0754717
NODE_307549_length_127_cov_1879.785714	74	127	10	46	53	0.8679245
NODE_307583_length_127_cov_66.142857	38	118	0	80	80	1.0000000
NODE_307583_length_127_cov_66.142857	47	118	0	71	71	1.0000000
NODE_307590_length_127_cov_38.285714	12	86	2	74	74	1.0000000
NODE_307596_length_127_cov_30.607143	21	93	0	72	72	1.0000000
NODE_307662_length_126_cov_936.777778	24	96	4	72	72	1.0000000
NODE_307675_length_126_cov_147.185185	2	66	0	6	64	0.0937500
NODE_307675_length_126_cov_147.185185	2	66	2	58	64	0.9062500
NODE_307675_length_126_cov_147.185185	2	66	0	6	64	0.0937500
NODE_307675_length_126_cov_147.185185	2	66	2	58	64	0.9062500
NODE_307675_length_126_cov_147.185185	2	66	0	6	64	0.0937500
NODE_307675_length_126_cov_147.185185	2	66	2	58	64	0.9062500
NODE_307675_length_126_cov_147.185185	39	99	2	60	60	1.0000000
NODE_307675_length_126_cov_147.185185	55	99	2	44	44	1.0000000
NODE_307684_length_126_cov_82.518519	44	75	2	31	31	1.0000000
NODE_307793_length_125_cov_656.807692	19	99	6	80	80	1.0000000
NODE_307806_length_125_cov_143.615385	52	125	0	73	73	1.0000000
NODE_307810_length_125_cov_131.923077	3	52	0	7	49	0.1428571
NODE_307810_length_125_cov_131.923077	3	52	2	8	49	0.1632653
NODE_307810_length_125_cov_131.923077	3	52	4	34	49	0.6938776
NODE_307810_length_125_cov_131.923077	25	89	4	64	64	1.0000000
NODE_307810_length_125_cov_131.923077	25	89	4	64	64	1.0000000
NODE_307816_length_125_cov_102.500000	0	56	0	56	56	1.0000000
NODE_307816_length_125_cov_102.500000	7	56	0	49	49	1.0000000
NODE_307816_length_125_cov_102.500000	29	114	0	85	85	1.0000000
NODE_307816_length_125_cov_102.500000	29	114	0	85	85	1.0000000
NODE_307816_length_125_cov_102.500000	29	114	0	85	85	1.0000000
NODE_307839_length_125_cov_28.115385	17	90	6	73	73	1.0000000
NODE_307839_length_125_cov_28.115385	57	98	6	41	41	1.0000000
NODE_307906_length_124_cov_945.680000	0	73	2	13	73	0.1780822
NODE_307906_length_124_cov_945.680000	0	73	4	60	73	0.8219178
NODE_307906_length_124_cov_945.680000	53	124	2	4	71	0.0563380
NODE_307906_length_124_cov_945.680000	53	124	4	67	71	0.9436620
NODE_308023_length_123_cov_1186.083333	0	76	0	6	76	0.0789474
NODE_308023_length_123_cov_1186.083333	0	76	2	7	76	0.0921053
NODE_308023_length_123_cov_1186.083333	0	76	4	3	76	0.0394737
NODE_308023_length_123_cov_1186.083333	0	76	6	60	76	0.7894737
NODE_308023_length_123_cov_1186.083333	0	76	0	6	76	0.0789474
NODE_308023_length_123_cov_1186.083333	0	76	2	7	76	0.0921053
NODE_308023_length_123_cov_1186.083333	0	76	4	3	76	0.0394737
NODE_308023_length_123_cov_1186.083333	0	76	6	60	76	0.7894737
NODE_308023_length_123_cov_1186.083333	0	76	0	6	76	0.0789474
NODE_308023_length_123_cov_1186.083333	0	76	2	7	76	0.0921053
NODE_308023_length_123_cov_1186.083333	0	76	4	3	76	0.0394737
NODE_308023_length_123_cov_1186.083333	0	76	6	60	76	0.7894737
NODE_308023_length_123_cov_1186.083333	0	76	0	6	76	0.0789474
NODE_308023_length_123_cov_1186.083333	0	76	2	7	76	0.0921053
NODE_308023_length_123_cov_1186.083333	0	76	4	3	76	0.0394737
NODE_308023_length_123_cov_1186.083333	0	76	6	60	76	0.7894737
NODE_308023_length_123_cov_1186.083333	49	123	2	3	74	0.0405405
NODE_308023_length_123_cov_1186.083333	49	123	6	71	74	0.9594595
NODE_308023_length_123_cov_1186.083333	49	123	2	3	74	0.0405405
NODE_308023_length_123_cov_1186.083333	49	123	6	71	74	0.9594595
NODE_308023_length_123_cov_1186.083333	49	123	2	3	74	0.0405405
NODE_308023_length_123_cov_1186.083333	49	123	6	71	74	0.9594595
NODE_308024_length_123_cov_963.500000	19	88	2	69	69	1.0000000
NODE_308037_length_123_cov_181.291667	0	47	2	47	47	1.0000000
NODE_308037_length_123_cov_181.291667	24	100	2	76	76	1.0000000
NODE_308057_length_123_cov_55.375000	52	123	0	71	71	1.0000000
NODE_308057_length_123_cov_55.375000	52	123	0	71	71	1.0000000
NODE_308057_length_123_cov_55.375000	61	123	0	62	62	1.0000000
NODE_308068_length_123_cov_40.958333	9	89	0	1	80	0.0125000
NODE_308068_length_123_cov_40.958333	9	89	4	79	80	0.9875000
NODE_308068_length_123_cov_40.958333	9	89	0	1	80	0.0125000
NODE_308068_length_123_cov_40.958333	9	89	4	79	80	0.9875000
NODE_308068_length_123_cov_40.958333	9	89	0	1	80	0.0125000
NODE_308068_length_123_cov_40.958333	9	89	4	79	80	0.9875000
NODE_308068_length_123_cov_40.958333	9	89	0	1	80	0.0125000
NODE_308068_length_123_cov_40.958333	9	89	4	79	80	0.9875000
NODE_308068_length_123_cov_40.958333	9	89	0	1	80	0.0125000
NODE_308068_length_123_cov_40.958333	9	89	4	79	80	0.9875000
NODE_308068_length_123_cov_40.958333	9	80	0	1	71	0.0140845
NODE_308068_length_123_cov_40.958333	9	80	4	70	71	0.9859155
NODE_308180_length_122_cov_111.043478	8	88	0	80	80	1.0000000
NODE_308180_length_122_cov_111.043478	8	88	0	80	80	1.0000000
NODE_308184_length_122_cov_67.565217	0	50	0	50	50	1.0000000
NODE_308184_length_122_cov_67.565217	0	50	0	50	50	1.0000000
NODE_308184_length_122_cov_67.565217	23	103	0	80	80	1.0000000
NODE_308184_length_122_cov_67.565217	23	103	0	80	80	1.0000000
NODE_308184_length_122_cov_67.565217	23	103	0	80	80	1.0000000
NODE_308184_length_122_cov_67.565217	23	103	0	80	80	1.0000000
NODE_308184_length_122_cov_67.565217	23	103	0	80	80	1.0000000
NODE_308184_length_122_cov_67.565217	23	94	0	71	71	1.0000000
NODE_308188_length_122_cov_58.826087	28	99	0	71	71	1.0000000
NODE_308188_length_122_cov_58.826087	33	99	0	66	66	1.0000000
NODE_308188_length_122_cov_58.826087	72	122	0	50	50	1.0000000
NODE_308188_length_122_cov_58.826087	72	122	0	50	50	1.0000000
NODE_308198_length_122_cov_38.173913	12	93	4	81	81	1.0000000
NODE_308257_length_121_cov_159.318182	24	55	4	31	31	1.0000000
NODE_308260_length_121_cov_120.181818	20	100	0	80	80	1.0000000
NODE_308260_length_121_cov_120.181818	20	95	0	75	75	1.0000000
NODE_308260_length_121_cov_120.181818	20	100	0	80	80	1.0000000
NODE_308260_length_121_cov_120.181818	29	100	0	71	71	1.0000000
NODE_308273_length_121_cov_54.181818	7	70	0	63	63	1.0000000
NODE_308273_length_121_cov_54.181818	7	70	0	63	63	1.0000000
NODE_308273_length_121_cov_54.181818	7	70	0	63	63	1.0000000
NODE_308273_length_121_cov_54.181818	9	70	0	61	61	1.0000000
NODE_308273_length_121_cov_54.181818	43	109	0	66	66	1.0000000
NODE_308273_length_121_cov_54.181818	43	121	0	78	78	1.0000000
NODE_308273_length_121_cov_54.181818	64	117	0	53	53	1.0000000
NODE_308317_length_120_cov_1404.619048	0	64	2	4	64	0.0625000
NODE_308317_length_120_cov_1404.619048	0	64	4	3	64	0.0468750
NODE_308317_length_120_cov_1404.619048	0	64	6	2	64	0.0312500
NODE_308317_length_120_cov_1404.619048	0	64	8	3	64	0.0468750
NODE_308317_length_120_cov_1404.619048	0	64	10	52	64	0.8125000
NODE_308317_length_120_cov_1404.619048	45	117	2	1	72	0.0138889
NODE_308317_length_120_cov_1404.619048	45	117	4	6	72	0.0833333
NODE_308317_length_120_cov_1404.619048	45	117	6	3	72	0.0416667
NODE_308317_length_120_cov_1404.619048	45	117	8	5	72	0.0694444
NODE_308317_length_120_cov_1404.619048	45	117	10	57	72	0.7916667
NODE_308318_length_120_cov_1138.428571	19	99	6	80	80	1.0000000
NODE_308318_length_120_cov_1138.428571	72	120	0	1	48	0.0208333
NODE_308318_length_120_cov_1138.428571	72	120	2	2	48	0.0416667
NODE_308318_length_120_cov_1138.428571	72	120	4	8	48	0.1666667
NODE_308318_length_120_cov_1138.428571	72	120	6	37	48	0.7708333
NODE_308357_length_120_cov_54.666667	0	69	0	12	69	0.1739130
NODE_308357_length_120_cov_54.666667	0	69	2	57	69	0.8260869
NODE_308357_length_120_cov_54.666667	0	69	0	12	69	0.1739130
NODE_308357_length_120_cov_54.666667	0	69	2	57	69	0.8260869
NODE_308357_length_120_cov_54.666667	0	69	0	12	69	0.1739130
NODE_308357_length_120_cov_54.666667	0	69	2	57	69	0.8260869
NODE_308357_length_120_cov_54.666667	42	108	2	66	66	1.0000000
NODE_308357_length_120_cov_54.666667	53	120	0	4	67	0.0597015
NODE_308357_length_120_cov_54.666667	53	120	2	63	67	0.9402985
NODE_308357_length_120_cov_54.666667	53	120	0	4	67	0.0597015
NODE_308357_length_120_cov_54.666667	53	120	2	63	67	0.9402985
NODE_308487_length_118_cov_1211.578947	49	116	2	67	67	1.0000000
NODE_308488_length_118_cov_1157.157895	4	70	0	66	66	1.0000000
NODE_308500_length_118_cov_218.210526	0	63	2	4	63	0.0634921
NODE_308500_length_118_cov_218.210526	0	63	4	5	63	0.0793651
NODE_308500_length_118_cov_218.210526	0	63	6	4	63	0.0634921
NODE_308500_length_118_cov_218.210526	0	63	10	2	63	0.0317460
NODE_308500_length_118_cov_218.210526	0	63	12	48	63	0.7619048
NODE_308500_length_118_cov_218.210526	35	115	6	2	80	0.0250000
NODE_308500_length_118_cov_218.210526	35	115	8	5	80	0.0625000
NODE_308500_length_118_cov_218.210526	35	115	10	2	80	0.0250000
NODE_308500_length_118_cov_218.210526	35	115	12	71	80	0.8875000
NODE_308504_length_118_cov_161.052632	4	70	0	4	66	0.0606061
NODE_308504_length_118_cov_161.052632	4	70	2	4	66	0.0606061
NODE_308504_length_118_cov_161.052632	4	70	4	58	66	0.8787879
NODE_308572_length_117_cov_338.555556	7	70	4	63	63	1.0000000
NODE_308572_length_117_cov_338.555556	7	70	4	63	63	1.0000000
NODE_308572_length_117_cov_338.555556	7	70	4	63	63	1.0000000
NODE_308572_length_117_cov_338.555556	9	70	4	61	61	1.0000000
NODE_308572_length_117_cov_338.555556	43	109	4	66	66	1.0000000
NODE_308572_length_117_cov_338.555556	43	114	2	5	71	0.0704225
NODE_308572_length_117_cov_338.555556	43	114	4	66	71	0.9295775
NODE_308572_length_117_cov_338.555556	64	117	0	1	53	0.0188679
NODE_308572_length_117_cov_338.555556	64	117	2	7	53	0.1320755
NODE_308572_length_117_cov_338.555556	64	117	4	45	53	0.8490566
NODE_308654_length_116_cov_1897.470588	0	77	2	9	77	0.1168831
NODE_308654_length_116_cov_1897.470588	0	77	3	1	77	0.0129870
NODE_308654_length_116_cov_1897.470588	0	77	4	2	77	0.0259740
NODE_308654_length_116_cov_1897.470588	0	77	6	65	77	0.8441558
NODE_308654_length_116_cov_1897.470588	34	111	4	8	77	0.1038961
NODE_308654_length_116_cov_1897.470588	34	111	6	69	77	0.8961039
NODE_308668_length_116_cov_438.529412	15	95	0	80	80	1.0000000
NODE_308668_length_116_cov_438.529412	68	116	0	48	48	1.0000000
NODE_308701_length_116_cov_93.235294	52	116	0	64	64	1.0000000
NODE_308722_length_116_cov_46.882353	6	66	2	60	60	1.0000000
NODE_308727_length_116_cov_38.352941	20	100	0	80	80	1.0000000
NODE_308746_length_115_cov_1012.625000	31	114	2	83	83	1.0000000
NODE_308750_length_115_cov_776.625000	9	92	6	83	83	1.0000000
NODE_308752_length_115_cov_623.937500	0	74	0	74	74	1.0000000
NODE_308782_length_115_cov_144.812500	4	73	0	69	69	1.0000000
NODE_308806_length_115_cov_65.187500	16	76	2	60	60	1.0000000
NODE_308846_length_114_cov_819.466667	40	114	0	74	74	1.0000000
NODE_308846_length_114_cov_819.466667	40	114	0	74	74	1.0000000
NODE_308846_length_114_cov_819.466667	49	114	0	65	65	1.0000000
NODE_308866_length_114_cov_285.666667	0	78	0	78	78	1.0000000
NODE_308866_length_114_cov_285.666667	51	114	0	63	63	1.0000000
NODE_308886_length_114_cov_83.600000	51	82	0	31	31	1.0000000
NODE_308891_length_114_cov_67.666667	40	90	0	50	50	1.0000000
NODE_308939_length_113_cov_446.214286	5	82	2	77	77	1.0000000
NODE_308939_length_113_cov_446.214286	5	82	2	77	77	1.0000000
NODE_308967_length_113_cov_160.071429	0	64	0	6	64	0.0937500
NODE_308967_length_113_cov_160.071429	0	64	2	58	64	0.9062500
NODE_308967_length_113_cov_160.071429	0	64	0	6	64	0.0937500
NODE_308967_length_113_cov_160.071429	0	64	2	58	64	0.9062500
NODE_308967_length_113_cov_160.071429	37	103	2	66	66	1.0000000
NODE_308967_length_113_cov_160.071429	37	108	0	2	71	0.0281690
NODE_308967_length_113_cov_160.071429	37	108	2	69	71	0.9718310
NODE_309037_length_112_cov_963.384615	43	112	0	69	69	1.0000000
NODE_309044_length_112_cov_653.615385	7	78	0	71	71	1.0000000
NODE_309044_length_112_cov_653.615385	12	78	0	66	66	1.0000000
NODE_309044_length_112_cov_653.615385	51	112	0	61	61	1.0000000
NODE_309044_length_112_cov_653.615385	51	112	0	61	61	1.0000000
NODE_309067_length_112_cov_219.538462	0	62	0	62	62	1.0000000
NODE_309067_length_112_cov_219.538462	0	57	0	57	57	1.0000000
NODE_309067_length_112_cov_219.538462	0	62	0	62	62	1.0000000
NODE_309067_length_112_cov_219.538462	0	59	0	59	59	1.0000000
NODE_309067_length_112_cov_219.538462	35	112	0	77	77	1.0000000
NODE_309067_length_112_cov_219.538462	35	112	0	77	77	1.0000000
NODE_309067_length_112_cov_219.538462	35	112	0	77	77	1.0000000
NODE_309078_length_112_cov_160.307692	0	69	0	69	69	1.0000000
NODE_309079_length_112_cov_134.846154	11	91	0	80	80	1.0000000
NODE_309079_length_112_cov_134.846154	11	91	0	80	80	1.0000000
NODE_309079_length_112_cov_134.846154	64	112	0	48	48	1.0000000
NODE_309079_length_112_cov_134.846154	64	112	0	48	48	1.0000000
NODE_309079_length_112_cov_134.846154	64	112	0	48	48	1.0000000
NODE_309092_length_112_cov_84.384615	10	90	4	80	80	1.0000000
NODE_309097_length_112_cov_72.769231	36	100	0	64	64	1.0000000
NODE_309106_length_112_cov_35.307692	13	76	0	63	63	1.0000000
NODE_309123_length_111_cov_1107.833333	0	52	2	52	52	1.0000000
NODE_309123_length_111_cov_1107.833333	0	52	2	52	52	1.0000000
NODE_309123_length_111_cov_1107.833333	0	52	2	52	52	1.0000000
NODE_309123_length_111_cov_1107.833333	0	52	2	52	52	1.0000000
NODE_309123_length_111_cov_1107.833333	25	105	2	80	80	1.0000000
NODE_309123_length_111_cov_1107.833333	25	105	2	80	80	1.0000000
NODE_309123_length_111_cov_1107.833333	25	105	2	80	80	1.0000000
NODE_309123_length_111_cov_1107.833333	25	105	2	80	80	1.0000000
NODE_309123_length_111_cov_1107.833333	25	105	2	80	80	1.0000000
NODE_309123_length_111_cov_1107.833333	25	105	2	80	80	1.0000000
NODE_309126_length_111_cov_827.500000	3	74	2	71	71	1.0000000
NODE_309126_length_111_cov_827.500000	8	74	2	66	66	1.0000000
NODE_309126_length_111_cov_827.500000	47	111	2	64	64	1.0000000
NODE_309126_length_111_cov_827.500000	47	111	2	64	64	1.0000000
NODE_309126_length_111_cov_827.500000	47	111	2	64	64	1.0000000
NODE_309129_length_111_cov_726.833333	12	89	0	77	77	1.0000000
NODE_309129_length_111_cov_726.833333	12	89	0	77	77	1.0000000
NODE_309129_length_111_cov_726.833333	62	111	0	49	49	1.0000000
NODE_309129_length_111_cov_726.833333	67	111	0	44	44	1.0000000
NODE_309131_length_111_cov_692.416667	31	111	0	80	80	1.0000000
NODE_309149_length_111_cov_241.750000	30	97	0	67	67	1.0000000
NODE_309160_length_111_cov_169.416667	21	102	2	81	81	1.0000000
NODE_309200_length_110_cov_554.909091	1	28	0	27	27	1.0000000
NODE_309200_length_110_cov_554.909091	1	81	0	80	80	1.0000000
NODE_309202_length_110_cov_537.545455	0	75	0	75	75	1.0000000
NODE_309202_length_110_cov_537.545455	53	107	0	54	54	1.0000000
NODE_309235_length_110_cov_91.636364	19	54	0	35	35	1.0000000
NODE_309235_length_110_cov_91.636364	64	107	0	43	43	1.0000000
NODE_309239_length_110_cov_80.272727	19	54	1	16	35	0.4571429
NODE_309239_length_110_cov_80.272727	19	54	2	19	35	0.5428572
NODE_309239_length_110_cov_80.272727	64	99	2	35	35	1.0000000
NODE_309241_length_110_cov_78.363636	19	54	0	35	35	1.0000000
NODE_309241_length_110_cov_78.363636	64	107	0	43	43	1.0000000
NODE_309245_length_110_cov_68.727273	11	46	2	35	35	1.0000000
NODE_309245_length_110_cov_68.727273	56	91	2	35	35	1.0000000
NODE_309252_length_110_cov_44.545455	5	57	0	52	52	1.0000000
NODE_309263_length_109_cov_1364.100000	29	98	0	69	69	1.0000000
NODE_309275_length_109_cov_689.800000	12	86	0	74	74	1.0000000
NODE_309309_length_109_cov_250.800000	4	66	0	62	62	1.0000000
NODE_309311_length_109_cov_242.000000	29	98	0	69	69	1.0000000
NODE_309326_length_109_cov_139.000000	26	106	0	2	80	0.0250000
NODE_309326_length_109_cov_139.000000	26	106	2	78	80	0.9750000
NODE_309345_length_109_cov_84.500000	33	93	0	60	60	1.0000000
NODE_309349_length_109_cov_75.300000	0	65	0	65	65	1.0000000
NODE_309384_length_108_cov_1542.666667	28	108	0	80	80	1.0000000
NODE_309391_length_108_cov_987.666667	5	85	4	80	80	1.0000000
NODE_309391_length_108_cov_987.666667	5	85	4	80	80	1.0000000
NODE_309391_length_108_cov_987.666667	5	85	4	80	80	1.0000000
NODE_309391_length_108_cov_987.666667	5	85	4	80	80	1.0000000
NODE_309391_length_108_cov_987.666667	5	85	4	80	80	1.0000000
NODE_309391_length_108_cov_987.666667	58	108	0	2	50	0.0400000
NODE_309391_length_108_cov_987.666667	58	108	2	1	50	0.0200000
NODE_309391_length_108_cov_987.666667	58	108	4	47	50	0.9400000
NODE_309391_length_108_cov_987.666667	58	108	0	2	50	0.0400000
NODE_309391_length_108_cov_987.666667	58	108	2	1	50	0.0200000
NODE_309391_length_108_cov_987.666667	58	108	4	47	50	0.9400000
NODE_309395_length_108_cov_841.666667	1	65	0	64	64	1.0000000
NODE_309395_length_108_cov_841.666667	1	65	0	64	64	1.0000000
NODE_309395_length_108_cov_841.666667	1	65	0	64	64	1.0000000
NODE_309433_length_108_cov_213.333333	22	81	0	59	59	1.0000000
NODE_309433_length_108_cov_213.333333	55	81	0	26	26	1.0000000
NODE_309464_length_108_cov_107.888889	11	82	0	71	71	1.0000000
NODE_309464_length_108_cov_107.888889	16	82	0	66	66	1.0000000
NODE_309464_length_108_cov_107.888889	55	108	0	53	53	1.0000000
NODE_309464_length_108_cov_107.888889	55	108	0	53	53	1.0000000
NODE_309464_length_108_cov_107.888889	55	108	0	53	53	1.0000000
NODE_309472_length_108_cov_76.444444	13	76	0	63	63	1.0000000
NODE_309479_length_108_cov_51.000000	0	53	0	53	53	1.0000000
NODE_309479_length_108_cov_51.000000	0	53	0	53	53	1.0000000
NODE_309479_length_108_cov_51.000000	0	53	0	53	53	1.0000000
NODE_309479_length_108_cov_51.000000	26	106	0	80	80	1.0000000
NODE_309479_length_108_cov_51.000000	26	106	0	80	80	1.0000000
NODE_309479_length_108_cov_51.000000	26	106	0	80	80	1.0000000
NODE_309479_length_108_cov_51.000000	26	106	0	80	80	1.0000000
NODE_309479_length_108_cov_51.000000	26	106	0	80	80	1.0000000
NODE_309479_length_108_cov_51.000000	26	97	0	71	71	1.0000000
NODE_309490_length_108_cov_31.111111	11	82	0	71	71	1.0000000
NODE_309490_length_108_cov_31.111111	16	82	0	66	66	1.0000000
NODE_309490_length_108_cov_31.111111	55	108	0	53	53	1.0000000
NODE_309490_length_108_cov_31.111111	55	108	0	53	53	1.0000000
NODE_309490_length_108_cov_31.111111	55	108	0	53	53	1.0000000
NODE_309530_length_107_cov_608.250000	0	64	0	64	64	1.0000000
NODE_309530_length_107_cov_608.250000	53	103	0	50	50	1.0000000
NODE_309551_length_107_cov_303.250000	0	56	0	2	56	0.0357143
NODE_309551_length_107_cov_303.250000	0	56	2	54	56	0.9642857
NODE_309551_length_107_cov_303.250000	29	99	2	70	70	1.0000000
NODE_309657_length_106_cov_522.571429	10	90	0	80	80	1.0000000
NODE_309657_length_106_cov_522.571429	10	90	0	80	80	1.0000000
NODE_309657_length_106_cov_522.571429	10	90	0	80	80	1.0000000
NODE_309657_length_106_cov_522.571429	10	90	0	80	80	1.0000000
NODE_309657_length_106_cov_522.571429	10	90	0	80	80	1.0000000
NODE_309657_length_106_cov_522.571429	19	90	0	71	71	1.0000000
NODE_309696_length_106_cov_161.857143	7	78	0	71	71	1.0000000
NODE_309696_length_106_cov_161.857143	51	106	0	55	55	1.0000000
NODE_309707_length_106_cov_130.714286	0	76	0	76	76	1.0000000
NODE_309714_length_106_cov_108.000000	0	76	0	76	76	1.0000000
NODE_309717_length_106_cov_102.142857	0	62	0	62	62	1.0000000
NODE_309717_length_106_cov_102.142857	35	106	0	71	71	1.0000000
NODE_309717_length_106_cov_102.142857	35	106	0	71	71	1.0000000
NODE_309747_length_106_cov_39.428571	0	76	0	76	76	1.0000000
NODE_309761_length_106_cov_30.857143	0	70	0	70	70	1.0000000
NODE_309761_length_106_cov_30.857143	0	70	0	70	70	1.0000000
NODE_309761_length_106_cov_30.857143	0	70	0	70	70	1.0000000
NODE_309761_length_106_cov_30.857143	43	92	0	49	49	1.0000000
NODE_309761_length_106_cov_30.857143	53	106	0	53	53	1.0000000
NODE_309761_length_106_cov_30.857143	53	106	0	53	53	1.0000000
NODE_309775_length_105_cov_2054.666667	31	105	0	74	74	1.0000000
NODE_309775_length_105_cov_2054.666667	31	105	0	74	74	1.0000000
NODE_309775_length_105_cov_2054.666667	31	105	0	74	74	1.0000000
NODE_309775_length_105_cov_2054.666667	31	105	0	74	74	1.0000000
NODE_309788_length_105_cov_830.833333	30	105	0	75	75	1.0000000
NODE_309789_length_105_cov_825.500000	0	77	0	77	77	1.0000000
NODE_309789_length_105_cov_825.500000	0	77	0	77	77	1.0000000
NODE_309789_length_105_cov_825.500000	50	99	0	49	49	1.0000000
NODE_309789_length_105_cov_825.500000	55	105	0	50	50	1.0000000
NODE_309815_length_105_cov_231.333333	0	54	0	54	54	1.0000000
NODE_309815_length_105_cov_231.333333	27	99	0	72	72	1.0000000
NODE_309842_length_105_cov_85.333333	14	94	0	80	80	1.0000000
NODE_309842_length_105_cov_85.333333	67	89	0	22	22	1.0000000
NODE_309855_length_105_cov_61.833333	23	103	0	80	80	1.0000000
NODE_309867_length_105_cov_40.666667	6	66	0	60	60	1.0000000
NODE_309925_length_104_cov_1016.000000	0	78	0	78	78	1.0000000
NODE_309925_length_104_cov_1016.000000	53	99	0	46	46	1.0000000
NODE_309935_length_104_cov_791.200000	0	67	0	67	67	1.0000000
NODE_309935_length_104_cov_791.200000	0	67	0	67	67	1.0000000
NODE_309935_length_104_cov_791.200000	40	104	0	64	64	1.0000000
NODE_309938_length_104_cov_574.200000	21	101	0	80	80	1.0000000
NODE_309938_length_104_cov_574.200000	21	101	0	80	80	1.0000000
NODE_309938_length_104_cov_574.200000	21	101	0	80	80	1.0000000
NODE_309938_length_104_cov_574.200000	21	101	0	80	80	1.0000000
NODE_309938_length_104_cov_574.200000	21	101	0	80	80	1.0000000
NODE_309938_length_104_cov_574.200000	21	92	0	71	71	1.0000000
NODE_309940_length_104_cov_547.400000	10	87	0	77	77	1.0000000
NODE_309940_length_104_cov_547.400000	10	87	0	77	77	1.0000000
NODE_310020_length_104_cov_46.800000	42	104	0	62	62	1.0000000
NODE_310054_length_103_cov_2267.000000	0	54	0	54	54	1.0000000
NODE_310054_length_103_cov_2267.000000	27	100	0	73	73	1.0000000
NODE_310082_length_103_cov_890.000000	6	70	0	64	64	1.0000000
NODE_310082_length_103_cov_890.000000	6	70	0	64	64	1.0000000
NODE_310082_length_103_cov_890.000000	6	70	0	64	64	1.0000000
NODE_310082_length_103_cov_890.000000	43	103	0	60	60	1.0000000
NODE_310082_length_103_cov_890.000000	59	103	0	44	44	1.0000000
NODE_310090_length_103_cov_768.500000	7	78	0	71	71	1.0000000
NODE_310090_length_103_cov_768.500000	12	78	0	66	66	1.0000000
NODE_310090_length_103_cov_768.500000	51	99	0	48	48	1.0000000
NODE_310090_length_103_cov_768.500000	51	99	0	48	48	1.0000000
NODE_310090_length_103_cov_768.500000	51	99	0	48	48	1.0000000
NODE_310091_length_103_cov_751.000000	0	71	0	71	71	1.0000000
NODE_310091_length_103_cov_751.000000	0	71	0	71	71	1.0000000
NODE_310091_length_103_cov_751.000000	44	93	0	49	49	1.0000000
NODE_310094_length_103_cov_678.000000	10	74	0	64	64	1.0000000
NODE_310094_length_103_cov_678.000000	10	74	0	64	64	1.0000000
NODE_310094_length_103_cov_678.000000	10	74	0	64	64	1.0000000
NODE_310094_length_103_cov_678.000000	47	96	0	49	49	1.0000000
NODE_310103_length_103_cov_462.750000	19	99	0	80	80	1.0000000
NODE_310116_length_103_cov_300.250000	0	63	0	63	63	1.0000000
NODE_310147_length_103_cov_103.250000	4	47	0	43	43	1.0000000
NODE_310152_length_103_cov_80.250000	36	99	0	63	63	1.0000000
NODE_310153_length_103_cov_76.500000	4	63	0	59	59	1.0000000
NODE_310160_length_103_cov_42.000000	0	78	0	78	78	1.0000000
NODE_310160_length_103_cov_42.000000	7	78	0	71	71	1.0000000
NODE_310160_length_103_cov_42.000000	12	78	0	66	66	1.0000000
NODE_310160_length_103_cov_42.000000	51	99	0	48	48	1.0000000
NODE_310160_length_103_cov_42.000000	51	99	0	48	48	1.0000000
NODE_310160_length_103_cov_42.000000	51	99	0	48	48	1.0000000
NODE_310211_length_102_cov_2033.666667	0	48	0	48	48	1.0000000
NODE_310211_length_102_cov_2033.666667	21	101	0	80	80	1.0000000
NODE_310227_length_102_cov_1028.333333	52	102	0	50	50	1.0000000
NODE_310230_length_102_cov_987.666667	15	98	0	83	83	1.0000000
NODE_310231_length_102_cov_934.000000	12	95	0	83	83	1.0000000
NODE_310246_length_102_cov_685.666667	0	73	0	73	73	1.0000000
NODE_310247_length_102_cov_646.666667	15	89	0	74	74	1.0000000
NODE_310269_length_102_cov_250.000000	12	72	0	60	60	1.0000000
NODE_310273_length_102_cov_216.333333	4	70	0	66	66	1.0000000
NODE_310273_length_102_cov_216.333333	4	70	0	66	66	1.0000000
NODE_310273_length_102_cov_216.333333	4	70	0	66	66	1.0000000
NODE_310273_length_102_cov_216.333333	43	92	0	49	49	1.0000000
NODE_310273_length_102_cov_216.333333	57	102	0	45	45	1.0000000
NODE_310287_length_102_cov_152.333333	0	63	0	63	63	1.0000000
NODE_310295_length_102_cov_124.333333	0	70	0	70	70	1.0000000
NODE_310302_length_102_cov_106.333333	0	78	0	78	78	1.0000000
NODE_310302_length_102_cov_106.333333	7	78	0	71	71	1.0000000
NODE_310302_length_102_cov_106.333333	12	78	0	66	66	1.0000000
NODE_310302_length_102_cov_106.333333	51	102	0	51	51	1.0000000
NODE_310302_length_102_cov_106.333333	51	102	0	51	51	1.0000000
NODE_310302_length_102_cov_106.333333	51	102	0	51	51	1.0000000
NODE_310316_length_102_cov_74.333333	31	99	0	68	68	1.0000000
NODE_310321_length_102_cov_71.000000	11	91	0	80	80	1.0000000
NODE_310336_length_102_cov_32.666667	0	65	0	65	65	1.0000000
NODE_310336_length_102_cov_32.666667	38	99	0	61	61	1.0000000
NODE_310405_length_101_cov_2217.000000	0	43	0	43	43	1.0000000
NODE_310405_length_101_cov_2217.000000	23	96	0	73	73	1.0000000
NODE_310464_length_101_cov_740.500000	2	66	0	64	64	1.0000000
NODE_310464_length_101_cov_740.500000	2	66	0	64	64	1.0000000
NODE_310464_length_101_cov_740.500000	2	66	0	64	64	1.0000000
NODE_310464_length_101_cov_740.500000	39	101	0	62	62	1.0000000
NODE_310464_length_101_cov_740.500000	55	101	0	46	46	1.0000000
NODE_310469_length_101_cov_701.000000	0	62	0	62	62	1.0000000
NODE_310469_length_101_cov_701.000000	35	99	0	64	64	1.0000000
NODE_310469_length_101_cov_701.000000	35	99	0	64	64	1.0000000
NODE_310469_length_101_cov_701.000000	35	99	0	64	64	1.0000000
NODE_310471_length_101_cov_679.000000	2	76	0	74	74	1.0000000
NODE_310500_length_101_cov_374.500000	2	50	0	48	48	1.0000000
NODE_310500_length_101_cov_374.500000	2	50	0	48	48	1.0000000
NODE_310500_length_101_cov_374.500000	2	50	0	48	48	1.0000000
NODE_310500_length_101_cov_374.500000	23	89	0	66	66	1.0000000
NODE_310500_length_101_cov_374.500000	23	94	0	71	71	1.0000000
NODE_310516_length_101_cov_294.000000	4	52	0	48	48	1.0000000
NODE_310516_length_101_cov_294.000000	4	52	0	48	48	1.0000000
NODE_310516_length_101_cov_294.000000	4	52	0	48	48	1.0000000
NODE_310516_length_101_cov_294.000000	25	91	0	66	66	1.0000000
NODE_310516_length_101_cov_294.000000	25	96	0	71	71	1.0000000
NODE_310529_length_101_cov_230.500000	2	76	0	74	74	1.0000000
NODE_310529_length_101_cov_230.500000	2	76	0	74	74	1.0000000
NODE_310529_length_101_cov_230.500000	2	76	0	74	74	1.0000000
NODE_310529_length_101_cov_230.500000	49	101	0	52	52	1.0000000
NODE_310529_length_101_cov_230.500000	55	101	0	46	46	1.0000000
NODE_310550_length_101_cov_157.000000	13	72	0	59	59	1.0000000
NODE_310550_length_101_cov_157.000000	46	72	0	26	26	1.0000000
NODE_310565_length_101_cov_134.500000	2	37	0	35	35	1.0000000
NODE_310685_length_100_cov_1883.000000	32	100	0	68	68	1.0000000
NODE_310685_length_100_cov_1883.000000	32	100	0	68	68	1.0000000
NODE_310685_length_100_cov_1883.000000	32	99	0	67	67	1.0000000
NODE_310685_length_100_cov_1883.000000	32	100	0	68	68	1.0000000
NODE_310704_length_100_cov_1310.000000	0	42	0	42	42	1.0000000
NODE_310704_length_100_cov_1310.000000	1	42	0	41	41	1.0000000
NODE_310704_length_100_cov_1310.000000	38	100	0	62	62	1.0000000
NODE_310704_length_100_cov_1310.000000	38	95	0	57	57	1.0000000
NODE_310704_length_100_cov_1310.000000	38	100	0	62	62	1.0000000
NODE_310704_length_100_cov_1310.000000	38	100	0	62	62	1.0000000
NODE_310708_length_100_cov_1239.000000	1	48	0	47	47	1.0000000
NODE_310740_length_100_cov_694.000000	0	62	0	62	62	1.0000000
NODE_310740_length_100_cov_694.000000	0	62	0	62	62	1.0000000
NODE_310740_length_100_cov_694.000000	35	100	0	65	65	1.0000000
NODE_310748_length_100_cov_602.000000	0	57	0	57	57	1.0000000
NODE_310750_length_100_cov_590.000000	0	58	0	58	58	1.0000000
NODE_310798_length_100_cov_274.000000	1	67	0	66	66	1.0000000
NODE_310798_length_100_cov_274.000000	1	67	0	66	66	1.0000000
NODE_310798_length_100_cov_274.000000	1	67	0	66	66	1.0000000
NODE_310798_length_100_cov_274.000000	40	100	0	60	60	1.0000000
NODE_310798_length_100_cov_274.000000	54	100	0	46	46	1.0000000
NODE_310808_length_100_cov_217.000000	4	75	0	71	71	1.0000000
NODE_310808_length_100_cov_217.000000	9	75	0	66	66	1.0000000
NODE_310808_length_100_cov_217.000000	48	99	0	51	51	1.0000000
NODE_310808_length_100_cov_217.000000	48	99	0	51	51	1.0000000
NODE_310808_length_100_cov_217.000000	48	99	0	51	51	1.0000000
NODE_310810_length_100_cov_209.000000	1	44	0	43	43	1.0000000
NODE_310810_length_100_cov_209.000000	40	100	0	60	60	1.0000000
NODE_310810_length_100_cov_209.000000	40	100	0	60	60	1.0000000
NODE_310819_length_100_cov_185.000000	0	46	0	46	46	1.0000000
NODE_310819_length_100_cov_185.000000	9	58	0	49	49	1.0000000
NODE_310819_length_100_cov_185.000000	31	99	0	68	68	1.0000000
NODE_310819_length_100_cov_185.000000	31	99	0	68	68	1.0000000
NODE_310819_length_100_cov_185.000000	31	99	0	68	68	1.0000000
NODE_310828_length_100_cov_164.000000	9	92	0	83	83	1.0000000
NODE_310837_length_100_cov_152.000000	11	91	0	80	80	1.0000000
NODE_310837_length_100_cov_152.000000	11	91	0	80	80	1.0000000
NODE_310837_length_100_cov_152.000000	11	91	0	80	80	1.0000000
NODE_310837_length_100_cov_152.000000	11	91	0	80	80	1.0000000
NODE_310837_length_100_cov_152.000000	11	91	0	80	80	1.0000000
NODE_310839_length_100_cov_150.000000	0	54	0	54	54	1.0000000
NODE_310839_length_100_cov_150.000000	0	54	0	54	54	1.0000000
NODE_310839_length_100_cov_150.000000	27	100	0	73	73	1.0000000
NODE_310839_length_100_cov_150.000000	27	100	0	73	73	1.0000000
NODE_310840_length_100_cov_148.000000	2	82	0	80	80	1.0000000
NODE_310841_length_100_cov_148.000000	0	71	0	71	71	1.0000000
NODE_310841_length_100_cov_148.000000	0	71	0	71	71	1.0000000
NODE_310841_length_100_cov_148.000000	0	62	0	62	62	1.0000000
NODE_310876_length_100_cov_71.000000	0	75	0	75	75	1.0000000
NODE_310876_length_100_cov_71.000000	4	75	0	71	71	1.0000000
NODE_310876_length_100_cov_71.000000	9	75	0	66	66	1.0000000
NODE_310876_length_100_cov_71.000000	48	100	0	52	52	1.0000000
NODE_310876_length_100_cov_71.000000	48	100	0	52	52	1.0000000
NODE_310876_length_100_cov_71.000000	48	100	0	52	52	1.0000000
NODE_310896_length_100_cov_41.000000	0	75	0	75	75	1.0000000
NODE_310896_length_100_cov_41.000000	4	75	0	71	71	1.0000000
NODE_310896_length_100_cov_41.000000	9	75	0	66	66	1.0000000
NODE_310896_length_100_cov_41.000000	48	99	0	51	51	1.0000000
NODE_310896_length_100_cov_41.000000	48	99	0	51	51	1.0000000
NODE_310896_length_100_cov_41.000000	48	99	0	51	51	1.0000000
NODE_310904_length_100_cov_30.000000	1	42	0	41	41	1.0000000
