NODE_1_length_25698_cov_36.651041	315	395	2	5	80	0.0625000
NODE_1_length_25698_cov_36.651041	315	395	7	1	80	0.0125000
NODE_1_length_25698_cov_36.651041	315	395	8	4	80	0.0500000
NODE_1_length_25698_cov_36.651041	315	395	10	25	80	0.3125000
NODE_1_length_25698_cov_36.651041	315	395	12	45	80	0.5625000
NODE_1_length_25698_cov_36.651041	368	403	10	18	35	0.5142857
NODE_1_length_25698_cov_36.651041	368	403	12	16	35	0.4571429
NODE_1_length_25698_cov_36.651041	368	403	19	1	35	0.0285714
NODE_1_length_25698_cov_36.651041	24448	24494	2	14	46	0.3043478
NODE_1_length_25698_cov_36.651041	24448	24494	4	26	46	0.5652174
NODE_1_length_25698_cov_36.651041	24448	24494	6	6	46	0.1304348
NODE_2_length_24307_cov_15.119712	2613	2689	0	76	76	1.0000000
NODE_2_length_24307_cov_15.119712	2662	2716	0	54	54	1.0000000
NODE_2_length_24307_cov_15.119712	11257	11320	0	63	63	1.0000000
NODE_2_length_24307_cov_15.119712	20621	20701	6	6	80	0.0750000
NODE_2_length_24307_cov_15.119712	20621	20701	8	26	80	0.3250000
NODE_2_length_24307_cov_15.119712	20621	20701	9	1	80	0.0125000
NODE_2_length_24307_cov_15.119712	20621	20701	10	9	80	0.1125000
NODE_2_length_24307_cov_15.119712	20621	20701	12	38	80	0.4750000
NODE_2_length_24307_cov_15.119712	20674	20754	0	14	80	0.1750000
NODE_2_length_24307_cov_15.119712	20674	20754	4	6	80	0.0750000
NODE_2_length_24307_cov_15.119712	20674	20754	6	1	80	0.0125000
NODE_2_length_24307_cov_15.119712	20674	20754	8	27	80	0.3375000
NODE_2_length_24307_cov_15.119712	20674	20754	12	32	80	0.4000000
NODE_7_length_12349_cov_28.144571	12251	12310	6	3	59	0.0508475
NODE_7_length_12349_cov_28.144571	12251	12310	8	1	59	0.0169492
NODE_7_length_12349_cov_28.144571	12251	12310	10	3	59	0.0508475
NODE_7_length_12349_cov_28.144571	12251	12310	12	1	59	0.0169492
NODE_7_length_12349_cov_28.144571	12251	12310	14	8	59	0.1355932
NODE_7_length_12349_cov_28.144571	12251	12310	18	1	59	0.0169492
NODE_7_length_12349_cov_28.144571	12251	12310	20	4	59	0.0677966
NODE_7_length_12349_cov_28.144571	12251	12310	22	4	59	0.0677966
NODE_7_length_12349_cov_28.144571	12251	12310	28	3	59	0.0508475
NODE_7_length_12349_cov_28.144571	12251	12310	30	5	59	0.0847458
NODE_7_length_12349_cov_28.144571	12251	12310	34	1	59	0.0169492
NODE_7_length_12349_cov_28.144571	12251	12310	36	2	59	0.0338983
NODE_7_length_12349_cov_28.144571	12251	12310	38	1	59	0.0169492
NODE_7_length_12349_cov_28.144571	12251	12310	40	1	59	0.0169492
NODE_7_length_12349_cov_28.144571	12251	12310	41	1	59	0.0169492
NODE_7_length_12349_cov_28.144571	12251	12310	42	1	59	0.0169492
NODE_7_length_12349_cov_28.144571	12251	12310	44	8	59	0.1355932
NODE_7_length_12349_cov_28.144571	12251	12310	48	1	59	0.0169492
NODE_7_length_12349_cov_28.144571	12251	12310	51	2	59	0.0338983
NODE_7_length_12349_cov_28.144571	12251	12310	53	2	59	0.0338983
NODE_7_length_12349_cov_28.144571	12251	12310	57	6	59	0.1016949
NODE_7_length_12349_cov_28.144571	12284	12310	6	3	26	0.1153846
NODE_7_length_12349_cov_28.144571	12284	12310	8	1	26	0.0384615
NODE_7_length_12349_cov_28.144571	12284	12310	10	3	26	0.1153846
NODE_7_length_12349_cov_28.144571	12284	12310	12	1	26	0.0384615
NODE_7_length_12349_cov_28.144571	12284	12310	14	8	26	0.3076923
NODE_7_length_12349_cov_28.144571	12284	12310	18	1	26	0.0384615
NODE_7_length_12349_cov_28.144571	12284	12310	20	4	26	0.1538462
NODE_7_length_12349_cov_28.144571	12284	12310	22	4	26	0.1538462
NODE_7_length_12349_cov_28.144571	12284	12310	28	1	26	0.0384615
NODE_10_length_11096_cov_14.154679	6455	6535	0	80	80	1.0000000
NODE_10_length_11096_cov_14.154679	6508	6588	0	80	80	1.0000000
NODE_10_length_11096_cov_14.154679	6584	6664	0	9	80	0.1125000
NODE_10_length_11096_cov_14.154679	6584	6664	2	9	80	0.1125000
NODE_10_length_11096_cov_14.154679	6584	6664	4	24	80	0.3000000
NODE_10_length_11096_cov_14.154679	6584	6664	6	38	80	0.4750000
NODE_10_length_11096_cov_14.154679	6637	6717	0	9	80	0.1125000
NODE_10_length_11096_cov_14.154679	6637	6717	2	13	80	0.1625000
NODE_10_length_11096_cov_14.154679	6637	6717	4	2	80	0.0250000
NODE_10_length_11096_cov_14.154679	6637	6717	5	1	80	0.0125000
NODE_10_length_11096_cov_14.154679	6637	6717	6	55	80	0.6875000
NODE_10_length_11096_cov_14.154679	7182	7229	77	1	47	0.0212766
NODE_10_length_11096_cov_14.154679	7182	7229	79	3	47	0.0638298
NODE_10_length_11096_cov_14.154679	7182	7229	81	1	47	0.0212766
NODE_10_length_11096_cov_14.154679	7182	7229	85	1	47	0.0212766
NODE_10_length_11096_cov_14.154679	7182	7229	86	4	47	0.0851064
NODE_10_length_11096_cov_14.154679	7182	7229	88	2	47	0.0425532
NODE_10_length_11096_cov_14.154679	7182	7229	90	1	47	0.0212766
NODE_10_length_11096_cov_14.154679	7182	7229	94	1	47	0.0212766
NODE_10_length_11096_cov_14.154679	7182	7229	97	1	47	0.0212766
NODE_10_length_11096_cov_14.154679	7182	7229	99	2	47	0.0425532
NODE_10_length_11096_cov_14.154679	7182	7229	101	2	47	0.0425532
NODE_10_length_11096_cov_14.154679	7182	7229	105	4	47	0.0851064
NODE_10_length_11096_cov_14.154679	7182	7229	106	1	47	0.0212766
NODE_10_length_11096_cov_14.154679	7182	7229	107	3	47	0.0638298
NODE_10_length_11096_cov_14.154679	7182	7229	109	2	47	0.0425532
NODE_10_length_11096_cov_14.154679	7182	7229	111	2	47	0.0425532
NODE_10_length_11096_cov_14.154679	7182	7229	113	5	47	0.1063830
NODE_10_length_11096_cov_14.154679	7182	7229	114	1	47	0.0212766
NODE_10_length_11096_cov_14.154679	7182	7229	117	6	47	0.1276596
NODE_10_length_11096_cov_14.154679	7182	7229	119	3	47	0.0638298
NODE_10_length_11096_cov_14.154679	7182	7229	121	1	47	0.0212766
NODE_10_length_11096_cov_14.154679	7218	7282	50	2	64	0.0312500
NODE_10_length_11096_cov_14.154679	7218	7282	52	2	64	0.0312500
NODE_10_length_11096_cov_14.154679	7218	7282	53	1	64	0.0156250
NODE_10_length_11096_cov_14.154679	7218	7282	54	3	64	0.0468750
NODE_10_length_11096_cov_14.154679	7218	7282	55	3	64	0.0468750
NODE_10_length_11096_cov_14.154679	7218	7282	58	6	64	0.0937500
NODE_10_length_11096_cov_14.154679	7218	7282	59	2	64	0.0312500
NODE_10_length_11096_cov_14.154679	7218	7282	60	7	64	0.1093750
NODE_10_length_11096_cov_14.154679	7218	7282	61	1	64	0.0156250
NODE_10_length_11096_cov_14.154679	7218	7282	62	2	64	0.0312500
NODE_10_length_11096_cov_14.154679	7218	7282	63	2	64	0.0312500
NODE_10_length_11096_cov_14.154679	7218	7282	64	1	64	0.0156250
NODE_10_length_11096_cov_14.154679	7218	7282	66	1	64	0.0156250
NODE_10_length_11096_cov_14.154679	7218	7282	70	4	64	0.0625000
NODE_10_length_11096_cov_14.154679	7218	7282	74	10	64	0.1562500
NODE_10_length_11096_cov_14.154679	7218	7282	76	6	64	0.0937500
NODE_10_length_11096_cov_14.154679	7218	7282	77	1	64	0.0156250
NODE_10_length_11096_cov_14.154679	7218	7282	79	3	64	0.0468750
NODE_10_length_11096_cov_14.154679	7218	7282	81	1	64	0.0156250
NODE_10_length_11096_cov_14.154679	7218	7282	85	1	64	0.0156250
NODE_10_length_11096_cov_14.154679	7218	7282	86	4	64	0.0625000
NODE_10_length_11096_cov_14.154679	7218	7282	88	1	64	0.0156250
NODE_13_length_10749_cov_34.330235	3589	3669	0	70	80	0.8750000
NODE_13_length_10749_cov_34.330235	3589	3669	4	10	80	0.1250000
NODE_13_length_10749_cov_34.330235	3642	3722	0	80	80	1.0000000
NODE_13_length_10749_cov_34.330235	3718	3798	0	16	80	0.2000000
NODE_13_length_10749_cov_34.330235	3718	3798	2	64	80	0.8000000
NODE_13_length_10749_cov_34.330235	3771	3851	0	20	80	0.2500000
NODE_13_length_10749_cov_34.330235	3771	3851	2	60	80	0.7500000
NODE_14_length_10557_cov_50.055938	423	503	0	80	80	1.0000000
NODE_14_length_10557_cov_50.055938	476	556	0	80	80	1.0000000
NODE_14_length_10557_cov_50.055938	1625	1696	12	32	71	0.4507042
NODE_14_length_10557_cov_50.055938	1625	1696	13	6	71	0.0845070
NODE_14_length_10557_cov_50.055938	1625	1696	14	3	71	0.0422535
NODE_14_length_10557_cov_50.055938	1625	1696	15	6	71	0.0845070
NODE_14_length_10557_cov_50.055938	1625	1696	17	24	71	0.3380282
NODE_14_length_10557_cov_50.055938	1678	1733	3	19	55	0.3454545
NODE_14_length_10557_cov_50.055938	1678	1733	5	6	55	0.1090909
NODE_14_length_10557_cov_50.055938	1678	1733	7	10	55	0.1818182
NODE_14_length_10557_cov_50.055938	1678	1733	8	1	55	0.0181818
NODE_14_length_10557_cov_50.055938	1678	1733	10	1	55	0.0181818
NODE_14_length_10557_cov_50.055938	1678	1733	12	18	55	0.3272727
NODE_14_length_10557_cov_50.055938	2428	2488	7	5	60	0.0833333
NODE_14_length_10557_cov_50.055938	2428	2488	8	2	60	0.0333333
NODE_14_length_10557_cov_50.055938	2428	2488	9	20	60	0.3333333
NODE_14_length_10557_cov_50.055938	2428	2488	11	2	60	0.0333333
NODE_14_length_10557_cov_50.055938	2428	2488	13	10	60	0.1666667
NODE_14_length_10557_cov_50.055938	2428	2488	14	5	60	0.0833333
NODE_14_length_10557_cov_50.055938	2428	2488	15	14	60	0.2333333
NODE_14_length_10557_cov_50.055938	2428	2488	16	2	60	0.0333333
NODE_17_length_10101_cov_12.236253	923	966	0	43	43	1.0000000
NODE_17_length_10101_cov_12.236253	943	1007	0	64	64	1.0000000
NODE_17_length_10101_cov_12.236253	1715	1795	0	80	80	1.0000000
NODE_17_length_10101_cov_12.236253	1768	1820	0	51	52	0.9807692
NODE_17_length_10101_cov_12.236253	1768	1820	6	1	52	0.0192308
NODE_20_length_9442_cov_109.961147	2108	2188	4	6	80	0.0750000
NODE_20_length_9442_cov_109.961147	2108	2188	7	1	80	0.0125000
NODE_20_length_9442_cov_109.961147	2108	2188	8	11	80	0.1375000
NODE_20_length_9442_cov_109.961147	2108	2188	10	5	80	0.0625000
NODE_20_length_9442_cov_109.961147	2108	2188	14	4	80	0.0500000
NODE_20_length_9442_cov_109.961147	2108	2188	16	36	80	0.4500000
NODE_20_length_9442_cov_109.961147	2108	2188	18	17	80	0.2125000
NODE_20_length_9442_cov_109.961147	2161	2241	6	7	80	0.0875000
NODE_20_length_9442_cov_109.961147	2161	2241	8	1	80	0.0125000
NODE_20_length_9442_cov_109.961147	2161	2241	10	6	80	0.0750000
NODE_20_length_9442_cov_109.961147	2161	2241	14	7	80	0.0875000
NODE_20_length_9442_cov_109.961147	2161	2241	16	27	80	0.3375000
NODE_20_length_9442_cov_109.961147	2161	2241	18	32	80	0.4000000
NODE_21_length_9414_cov_34.165217	2363	2443	22	4	80	0.0500000
NODE_21_length_9414_cov_34.165217	2363	2443	24	2	80	0.0250000
NODE_21_length_9414_cov_34.165217	2363	2443	26	19	80	0.2375000
NODE_21_length_9414_cov_34.165217	2363	2443	28	8	80	0.1000000
NODE_21_length_9414_cov_34.165217	2363	2443	30	15	80	0.1875000
NODE_21_length_9414_cov_34.165217	2363	2443	32	23	80	0.2875000
NODE_21_length_9414_cov_34.165217	2363	2443	34	9	80	0.1125000
NODE_21_length_9414_cov_34.165217	2416	2484	0	13	68	0.1911765
NODE_21_length_9414_cov_34.165217	2416	2484	2	3	68	0.0441176
NODE_21_length_9414_cov_34.165217	2416	2484	5	1	68	0.0147059
NODE_21_length_9414_cov_34.165217	2416	2484	6	1	68	0.0147059
NODE_21_length_9414_cov_34.165217	2416	2484	8	2	68	0.0294118
NODE_21_length_9414_cov_34.165217	2416	2484	10	11	68	0.1617647
NODE_21_length_9414_cov_34.165217	2416	2484	12	1	68	0.0147059
NODE_21_length_9414_cov_34.165217	2416	2484	14	3	68	0.0441176
NODE_21_length_9414_cov_34.165217	2416	2484	18	3	68	0.0441176
NODE_21_length_9414_cov_34.165217	2416	2484	20	2	68	0.0294118
NODE_21_length_9414_cov_34.165217	2416	2484	22	5	68	0.0735294
NODE_21_length_9414_cov_34.165217	2416	2484	26	18	68	0.2647059
NODE_21_length_9414_cov_34.165217	2416	2484	28	5	68	0.0735294
NODE_21_length_9414_cov_34.165217	5899	5975	42	1	76	0.0131579
NODE_21_length_9414_cov_34.165217	5899	5975	44	4	76	0.0526316
NODE_21_length_9414_cov_34.165217	5899	5975	46	5	76	0.0657895
NODE_21_length_9414_cov_34.165217	5899	5975	48	7	76	0.0921053
NODE_21_length_9414_cov_34.165217	5899	5975	50	9	76	0.1184211
NODE_21_length_9414_cov_34.165217	5899	5975	52	9	76	0.1184211
NODE_21_length_9414_cov_34.165217	5899	5975	55	1	76	0.0131579
NODE_21_length_9414_cov_34.165217	5899	5975	56	1	76	0.0131579
NODE_21_length_9414_cov_34.165217	5899	5975	58	1	76	0.0131579
NODE_21_length_9414_cov_34.165217	5899	5975	60	5	76	0.0657895
NODE_21_length_9414_cov_34.165217	5899	5975	62	1	76	0.0131579
NODE_21_length_9414_cov_34.165217	5899	5975	66	2	76	0.0263158
NODE_21_length_9414_cov_34.165217	5899	5975	68	4	76	0.0526316
NODE_21_length_9414_cov_34.165217	5899	5975	69	3	76	0.0394737
NODE_21_length_9414_cov_34.165217	5899	5975	70	4	76	0.0526316
NODE_21_length_9414_cov_34.165217	5899	5975	71	7	76	0.0921053
NODE_21_length_9414_cov_34.165217	5899	5975	72	3	76	0.0394737
NODE_21_length_9414_cov_34.165217	5899	5975	73	2	76	0.0263158
NODE_21_length_9414_cov_34.165217	5899	5975	74	2	76	0.0263158
NODE_21_length_9414_cov_34.165217	5899	5975	75	1	76	0.0131579
NODE_21_length_9414_cov_34.165217	5899	5975	76	4	76	0.0526316
NODE_24_length_9168_cov_47.407542	470	550	42	2	80	0.0250000
NODE_24_length_9168_cov_47.407542	470	550	43	4	80	0.0500000
NODE_24_length_9168_cov_47.407542	470	550	44	1	80	0.0125000
NODE_24_length_9168_cov_47.407542	470	550	45	2	80	0.0250000
NODE_24_length_9168_cov_47.407542	470	550	46	2	80	0.0250000
NODE_24_length_9168_cov_47.407542	470	550	47	2	80	0.0250000
NODE_24_length_9168_cov_47.407542	470	550	48	7	80	0.0875000
NODE_24_length_9168_cov_47.407542	470	550	49	1	80	0.0125000
NODE_24_length_9168_cov_47.407542	470	550	50	7	80	0.0875000
NODE_24_length_9168_cov_47.407542	470	550	52	1	80	0.0125000
NODE_24_length_9168_cov_47.407542	470	550	55	1	80	0.0125000
NODE_24_length_9168_cov_47.407542	470	550	56	6	80	0.0750000
NODE_24_length_9168_cov_47.407542	470	550	58	10	80	0.1250000
NODE_24_length_9168_cov_47.407542	470	550	60	6	80	0.0750000
NODE_24_length_9168_cov_47.407542	470	550	61	2	80	0.0250000
NODE_24_length_9168_cov_47.407542	470	550	62	1	80	0.0125000
NODE_24_length_9168_cov_47.407542	470	550	65	5	80	0.0625000
NODE_24_length_9168_cov_47.407542	470	550	66	14	80	0.1750000
NODE_24_length_9168_cov_47.407542	470	550	68	6	80	0.0750000
NODE_24_length_9168_cov_47.407542	523	603	31	5	80	0.0625000
NODE_24_length_9168_cov_47.407542	523	603	32	11	80	0.1375000
NODE_24_length_9168_cov_47.407542	523	603	34	7	80	0.0875000
NODE_24_length_9168_cov_47.407542	523	603	36	2	80	0.0250000
NODE_24_length_9168_cov_47.407542	523	603	40	1	80	0.0125000
NODE_24_length_9168_cov_47.407542	523	603	41	18	80	0.2250000
NODE_24_length_9168_cov_47.407542	523	603	42	2	80	0.0250000
NODE_24_length_9168_cov_47.407542	523	603	43	11	80	0.1375000
NODE_24_length_9168_cov_47.407542	523	603	44	1	80	0.0125000
NODE_24_length_9168_cov_47.407542	523	603	45	4	80	0.0500000
NODE_24_length_9168_cov_47.407542	523	603	46	2	80	0.0250000
NODE_24_length_9168_cov_47.407542	523	603	47	2	80	0.0250000
NODE_24_length_9168_cov_47.407542	523	603	48	6	80	0.0750000
NODE_24_length_9168_cov_47.407542	523	603	49	1	80	0.0125000
NODE_24_length_9168_cov_47.407542	523	603	50	6	80	0.0750000
NODE_24_length_9168_cov_47.407542	523	603	52	1	80	0.0125000
NODE_27_length_9108_cov_47.430347	4786	4866	113	1	80	0.0125000
NODE_27_length_9108_cov_47.430347	4786	4866	115	9	80	0.1125000
NODE_27_length_9108_cov_47.430347	4786	4866	117	1	80	0.0125000
NODE_27_length_9108_cov_47.430347	4786	4866	118	3	80	0.0375000
NODE_27_length_9108_cov_47.430347	4786	4866	121	5	80	0.0625000
NODE_27_length_9108_cov_47.430347	4786	4866	122	2	80	0.0250000
NODE_27_length_9108_cov_47.430347	4786	4866	123	1	80	0.0125000
NODE_27_length_9108_cov_47.430347	4786	4866	128	3	80	0.0375000
NODE_27_length_9108_cov_47.430347	4786	4866	132	3	80	0.0375000
NODE_27_length_9108_cov_47.430347	4786	4866	133	1	80	0.0125000
NODE_27_length_9108_cov_47.430347	4786	4866	134	7	80	0.0875000
NODE_27_length_9108_cov_47.430347	4786	4866	136	2	80	0.0250000
NODE_27_length_9108_cov_47.430347	4786	4866	138	2	80	0.0250000
NODE_27_length_9108_cov_47.430347	4786	4866	139	3	80	0.0375000
NODE_27_length_9108_cov_47.430347	4786	4866	140	10	80	0.1250000
NODE_27_length_9108_cov_47.430347	4786	4866	141	3	80	0.0375000
NODE_27_length_9108_cov_47.430347	4786	4866	142	3	80	0.0375000
NODE_27_length_9108_cov_47.430347	4786	4866	143	5	80	0.0625000
NODE_27_length_9108_cov_47.430347	4786	4866	144	3	80	0.0375000
NODE_27_length_9108_cov_47.430347	4786	4866	145	4	80	0.0500000
NODE_27_length_9108_cov_47.430347	4786	4866	146	3	80	0.0375000
NODE_27_length_9108_cov_47.430347	4786	4866	147	5	80	0.0625000
NODE_27_length_9108_cov_47.430347	4786	4866	148	1	80	0.0125000
NODE_27_length_9108_cov_47.430347	4839	4902	132	2	63	0.0317460
NODE_27_length_9108_cov_47.430347	4839	4902	134	3	63	0.0476190
NODE_27_length_9108_cov_47.430347	4839	4902	136	1	63	0.0158730
NODE_27_length_9108_cov_47.430347	4839	4902	140	3	63	0.0476190
NODE_27_length_9108_cov_47.430347	4839	4902	142	5	63	0.0793651
NODE_27_length_9108_cov_47.430347	4839	4902	143	2	63	0.0317460
NODE_27_length_9108_cov_47.430347	4839	4902	144	3	63	0.0476190
NODE_27_length_9108_cov_47.430347	4839	4902	145	5	63	0.0793651
NODE_27_length_9108_cov_47.430347	4839	4902	146	5	63	0.0793651
NODE_27_length_9108_cov_47.430347	4839	4902	147	5	63	0.0793651
NODE_27_length_9108_cov_47.430347	4839	4902	148	1	63	0.0158730
NODE_27_length_9108_cov_47.430347	4839	4902	149	1	63	0.0158730
NODE_27_length_9108_cov_47.430347	4839	4902	150	2	63	0.0317460
NODE_27_length_9108_cov_47.430347	4839	4902	151	3	63	0.0476190
NODE_27_length_9108_cov_47.430347	4839	4902	152	11	63	0.1746032
NODE_27_length_9108_cov_47.430347	4839	4902	153	3	63	0.0476190
NODE_27_length_9108_cov_47.430347	4839	4902	154	6	63	0.0952381
NODE_27_length_9108_cov_47.430347	4839	4902	155	2	63	0.0317460
NODE_27_length_9108_cov_47.430347	4895	4963	107	1	68	0.0147059
NODE_27_length_9108_cov_47.430347	4895	4963	110	2	68	0.0294118
NODE_27_length_9108_cov_47.430347	4895	4963	114	1	68	0.0147059
NODE_27_length_9108_cov_47.430347	4895	4963	116	1	68	0.0147059
NODE_27_length_9108_cov_47.430347	4895	4963	120	1	68	0.0147059
NODE_27_length_9108_cov_47.430347	4895	4963	124	1	68	0.0147059
NODE_27_length_9108_cov_47.430347	4895	4963	126	1	68	0.0147059
NODE_27_length_9108_cov_47.430347	4895	4963	128	5	68	0.0735294
NODE_27_length_9108_cov_47.430347	4895	4963	129	3	68	0.0441176
NODE_27_length_9108_cov_47.430347	4895	4963	131	1	68	0.0147059
NODE_27_length_9108_cov_47.430347	4895	4963	133	6	68	0.0882353
NODE_27_length_9108_cov_47.430347	4895	4963	135	2	68	0.0294118
NODE_27_length_9108_cov_47.430347	4895	4963	137	2	68	0.0294118
NODE_27_length_9108_cov_47.430347	4895	4963	141	3	68	0.0441176
NODE_27_length_9108_cov_47.430347	4895	4963	143	6	68	0.0882353
NODE_27_length_9108_cov_47.430347	4895	4963	145	11	68	0.1617647
NODE_27_length_9108_cov_47.430347	4895	4963	147	3	68	0.0441176
NODE_27_length_9108_cov_47.430347	4895	4963	149	8	68	0.1176471
NODE_27_length_9108_cov_47.430347	4895	4963	150	1	68	0.0147059
NODE_27_length_9108_cov_47.430347	4895	4963	151	4	68	0.0588235
NODE_27_length_9108_cov_47.430347	4895	4963	153	4	68	0.0588235
NODE_27_length_9108_cov_47.430347	4895	4963	155	1	68	0.0147059
NODE_27_length_9108_cov_47.430347	4936	5016	10	2	80	0.0250000
NODE_27_length_9108_cov_47.430347	4936	5016	12	2	80	0.0250000
NODE_27_length_9108_cov_47.430347	4936	5016	15	1	80	0.0125000
NODE_27_length_9108_cov_47.430347	4936	5016	18	2	80	0.0250000
NODE_27_length_9108_cov_47.430347	4936	5016	28	1	80	0.0125000
NODE_27_length_9108_cov_47.430347	4936	5016	29	1	80	0.0125000
NODE_27_length_9108_cov_47.430347	4936	5016	33	1	80	0.0125000
NODE_27_length_9108_cov_47.430347	4936	5016	35	1	80	0.0125000
NODE_27_length_9108_cov_47.430347	4936	5016	47	1	80	0.0125000
NODE_27_length_9108_cov_47.430347	4936	5016	51	4	80	0.0500000
NODE_27_length_9108_cov_47.430347	4936	5016	57	2	80	0.0250000
NODE_27_length_9108_cov_47.430347	4936	5016	60	1	80	0.0125000
NODE_27_length_9108_cov_47.430347	4936	5016	62	1	80	0.0125000
NODE_27_length_9108_cov_47.430347	4936	5016	64	1	80	0.0125000
NODE_27_length_9108_cov_47.430347	4936	5016	66	1	80	0.0125000
NODE_27_length_9108_cov_47.430347	4936	5016	70	2	80	0.0250000
NODE_27_length_9108_cov_47.430347	4936	5016	72	2	80	0.0250000
NODE_27_length_9108_cov_47.430347	4936	5016	74	1	80	0.0125000
NODE_27_length_9108_cov_47.430347	4936	5016	78	1	80	0.0125000
NODE_27_length_9108_cov_47.430347	4936	5016	80	8	80	0.1000000
NODE_27_length_9108_cov_47.430347	4936	5016	82	2	80	0.0250000
NODE_27_length_9108_cov_47.430347	4936	5016	86	2	80	0.0250000
NODE_27_length_9108_cov_47.430347	4936	5016	87	1	80	0.0125000
NODE_27_length_9108_cov_47.430347	4936	5016	91	1	80	0.0125000
NODE_27_length_9108_cov_47.430347	4936	5016	93	1	80	0.0125000
NODE_27_length_9108_cov_47.430347	4936	5016	95	2	80	0.0250000
NODE_27_length_9108_cov_47.430347	4936	5016	97	2	80	0.0250000
NODE_27_length_9108_cov_47.430347	4936	5016	99	1	80	0.0125000
NODE_27_length_9108_cov_47.430347	4936	5016	105	1	80	0.0125000
NODE_27_length_9108_cov_47.430347	4936	5016	106	4	80	0.0500000
NODE_27_length_9108_cov_47.430347	4936	5016	107	1	80	0.0125000
NODE_27_length_9108_cov_47.430347	4936	5016	110	2	80	0.0250000
NODE_27_length_9108_cov_47.430347	4936	5016	114	1	80	0.0125000
NODE_27_length_9108_cov_47.430347	4936	5016	116	1	80	0.0125000
NODE_27_length_9108_cov_47.430347	4936	5016	120	1	80	0.0125000
NODE_27_length_9108_cov_47.430347	4936	5016	124	1	80	0.0125000
NODE_27_length_9108_cov_47.430347	4936	5016	126	1	80	0.0125000
NODE_27_length_9108_cov_47.430347	4936	5016	128	5	80	0.0625000
NODE_27_length_9108_cov_47.430347	4936	5016	129	3	80	0.0375000
NODE_27_length_9108_cov_47.430347	4936	5016	131	1	80	0.0125000
NODE_27_length_9108_cov_47.430347	4936	5016	133	6	80	0.0750000
NODE_27_length_9108_cov_47.430347	4936	5016	135	2	80	0.0250000
NODE_27_length_9108_cov_47.430347	4936	5016	137	2	80	0.0250000
NODE_28_length_9108_cov_26.469974	44	120	0	2	76	0.0263158
NODE_28_length_9108_cov_26.469974	44	120	2	74	76	0.9736842
NODE_28_length_9108_cov_26.469974	7711	7791	0	1	80	0.0125000
NODE_28_length_9108_cov_26.469974	7711	7791	4	18	80	0.2250000
NODE_28_length_9108_cov_26.469974	7711	7791	6	12	80	0.1500000
NODE_28_length_9108_cov_26.469974	7711	7791	8	16	80	0.2000000
NODE_28_length_9108_cov_26.469974	7711	7791	10	10	80	0.1250000
NODE_28_length_9108_cov_26.469974	7711	7791	12	7	80	0.0875000
NODE_28_length_9108_cov_26.469974	7711	7791	14	16	80	0.2000000
NODE_28_length_9108_cov_26.469974	8144	8224	0	1	80	0.0125000
NODE_28_length_9108_cov_26.469974	8144	8224	2	2	80	0.0250000
NODE_28_length_9108_cov_26.469974	8144	8224	3	1	80	0.0125000
NODE_28_length_9108_cov_26.469974	8144	8224	4	4	80	0.0500000
NODE_28_length_9108_cov_26.469974	8144	8224	6	6	80	0.0750000
NODE_28_length_9108_cov_26.469974	8144	8224	10	9	80	0.1125000
NODE_28_length_9108_cov_26.469974	8144	8224	12	34	80	0.4250000
NODE_28_length_9108_cov_26.469974	8144	8224	14	11	80	0.1375000
NODE_28_length_9108_cov_26.469974	8144	8224	16	2	80	0.0250000
NODE_28_length_9108_cov_26.469974	8144	8224	18	2	80	0.0250000
NODE_28_length_9108_cov_26.469974	8144	8224	20	8	80	0.1000000
NODE_28_length_9108_cov_26.469974	8568	8648	0	3	80	0.0375000
NODE_28_length_9108_cov_26.469974	8568	8648	3	1	80	0.0125000
NODE_28_length_9108_cov_26.469974	8568	8648	4	76	80	0.9500000
NODE_28_length_9108_cov_26.469974	8621	8701	0	11	80	0.1375000
NODE_28_length_9108_cov_26.469974	8621	8701	4	69	80	0.8625000
NODE_30_length_8743_cov_14.172721	7849	7929	16	4	80	0.0500000
NODE_30_length_8743_cov_14.172721	7849	7929	18	16	80	0.2000000
NODE_30_length_8743_cov_14.172721	7849	7929	20	2	80	0.0250000
NODE_30_length_8743_cov_14.172721	7849	7929	22	14	80	0.1750000
NODE_30_length_8743_cov_14.172721	7849	7929	24	44	80	0.5500000
NODE_30_length_8743_cov_14.172721	7902	7964	2	6	62	0.0967742
NODE_30_length_8743_cov_14.172721	7902	7964	4	4	62	0.0645161
NODE_30_length_8743_cov_14.172721	7902	7964	6	3	62	0.0483871
NODE_30_length_8743_cov_14.172721	7902	7964	13	1	62	0.0161290
NODE_30_length_8743_cov_14.172721	7902	7964	14	8	62	0.1290323
NODE_30_length_8743_cov_14.172721	7902	7964	16	17	62	0.2741936
NODE_30_length_8743_cov_14.172721	7902	7964	18	16	62	0.2580645
NODE_30_length_8743_cov_14.172721	7902	7964	20	2	62	0.0322581
NODE_30_length_8743_cov_14.172721	7902	7964	22	5	62	0.0806452
NODE_32_length_8707_cov_6.353044	8541	8621	2	2	80	0.0250000
NODE_32_length_8707_cov_6.353044	8541	8621	4	2	80	0.0250000
NODE_32_length_8707_cov_6.353044	8541	8621	6	9	80	0.1125000
NODE_32_length_8707_cov_6.353044	8541	8621	10	15	80	0.1875000
NODE_32_length_8707_cov_6.353044	8541	8621	12	13	80	0.1625000
NODE_32_length_8707_cov_6.353044	8541	8621	14	39	80	0.4875000
NODE_32_length_8707_cov_6.353044	8541	8621	2	2	80	0.0250000
NODE_32_length_8707_cov_6.353044	8541	8621	4	2	80	0.0250000
NODE_32_length_8707_cov_6.353044	8541	8621	6	9	80	0.1125000
NODE_32_length_8707_cov_6.353044	8541	8621	10	15	80	0.1875000
NODE_32_length_8707_cov_6.353044	8541	8621	12	13	80	0.1625000
NODE_32_length_8707_cov_6.353044	8541	8621	14	39	80	0.4875000
NODE_32_length_8707_cov_6.353044	8541	8621	2	2	80	0.0250000
NODE_32_length_8707_cov_6.353044	8541	8621	4	2	80	0.0250000
NODE_32_length_8707_cov_6.353044	8541	8621	6	9	80	0.1125000
NODE_32_length_8707_cov_6.353044	8541	8621	10	15	80	0.1875000
NODE_32_length_8707_cov_6.353044	8541	8621	12	13	80	0.1625000
NODE_32_length_8707_cov_6.353044	8541	8621	14	39	80	0.4875000
NODE_32_length_8707_cov_6.353044	8594	8674	4	3	80	0.0375000
NODE_32_length_8707_cov_6.353044	8594	8674	6	34	80	0.4250000
NODE_32_length_8707_cov_6.353044	8594	8674	8	6	80	0.0750000
NODE_32_length_8707_cov_6.353044	8594	8674	10	5	80	0.0625000
NODE_32_length_8707_cov_6.353044	8594	8674	12	18	80	0.2250000
NODE_32_length_8707_cov_6.353044	8594	8674	14	14	80	0.1750000
NODE_32_length_8707_cov_6.353044	8594	8674	4	3	80	0.0375000
NODE_32_length_8707_cov_6.353044	8594	8674	6	34	80	0.4250000
NODE_32_length_8707_cov_6.353044	8594	8674	8	6	80	0.0750000
NODE_32_length_8707_cov_6.353044	8594	8674	10	5	80	0.0625000
NODE_32_length_8707_cov_6.353044	8594	8674	12	18	80	0.2250000
NODE_32_length_8707_cov_6.353044	8594	8674	14	14	80	0.1750000
NODE_32_length_8707_cov_6.353044	8594	8673	4	2	79	0.0253165
NODE_32_length_8707_cov_6.353044	8594	8673	6	34	79	0.4303797
NODE_32_length_8707_cov_6.353044	8594	8673	8	6	79	0.0759494
NODE_32_length_8707_cov_6.353044	8594	8673	10	5	79	0.0632911
NODE_32_length_8707_cov_6.353044	8594	8673	12	18	79	0.2278481
NODE_32_length_8707_cov_6.353044	8594	8673	14	14	79	0.1772152
NODE_32_length_8707_cov_6.353044	8599	8674	4	3	75	0.0400000
NODE_32_length_8707_cov_6.353044	8599	8674	6	34	75	0.4533333
NODE_32_length_8707_cov_6.353044	8599	8674	8	6	75	0.0800000
NODE_32_length_8707_cov_6.353044	8599	8674	10	5	75	0.0666667
NODE_32_length_8707_cov_6.353044	8599	8674	12	18	75	0.2400000
NODE_32_length_8707_cov_6.353044	8599	8674	14	9	75	0.1200000
NODE_38_length_8281_cov_13.025177	7108	7188	0	69	80	0.8625000
NODE_38_length_8281_cov_13.025177	7108	7188	1	1	80	0.0125000
NODE_38_length_8281_cov_13.025177	7108	7188	2	10	80	0.1250000
NODE_38_length_8281_cov_13.025177	7161	7199	0	38	38	1.0000000
NODE_38_length_8281_cov_13.025177	7175	7255	0	80	80	1.0000000
NODE_38_length_8281_cov_13.025177	7228	7308	0	80	80	1.0000000
NODE_38_length_8281_cov_13.025177	7749	7829	0	27	80	0.3375000
NODE_38_length_8281_cov_13.025177	7749	7829	2	51	80	0.6375000
NODE_38_length_8281_cov_13.025177	7749	7829	4	2	80	0.0250000
NODE_38_length_8281_cov_13.025177	7802	7882	0	28	80	0.3500000
NODE_38_length_8281_cov_13.025177	7802	7882	2	52	80	0.6500000
NODE_38_length_8281_cov_13.025177	7878	7958	0	5	80	0.0625000
NODE_38_length_8281_cov_13.025177	7878	7958	2	20	80	0.2500000
NODE_38_length_8281_cov_13.025177	7878	7958	4	55	80	0.6875000
NODE_38_length_8281_cov_13.025177	7931	8011	0	20	80	0.2500000
NODE_38_length_8281_cov_13.025177	7931	8011	2	22	80	0.2750000
NODE_38_length_8281_cov_13.025177	7931	8011	4	38	80	0.4750000
NODE_39_length_8259_cov_60.011152	1424	1504	0	80	80	1.0000000
NODE_39_length_8259_cov_60.011152	1477	1549	0	72	72	1.0000000
NODE_40_length_8228_cov_17.079592	314	394	0	40	80	0.5000000
NODE_40_length_8228_cov_17.079592	314	394	2	40	80	0.5000000
NODE_40_length_8228_cov_17.079592	367	447	0	80	80	1.0000000
NODE_40_length_8228_cov_17.079592	443	523	0	61	80	0.7625000
NODE_40_length_8228_cov_17.079592	443	523	2	6	80	0.0750000
NODE_40_length_8228_cov_17.079592	443	523	4	13	80	0.1625000
NODE_40_length_8228_cov_17.079592	496	576	0	8	80	0.1000000
NODE_40_length_8228_cov_17.079592	496	576	2	6	80	0.0750000
NODE_40_length_8228_cov_17.079592	496	576	4	66	80	0.8250000
NODE_40_length_8228_cov_17.079592	3154	3217	10	1	63	0.0158730
NODE_40_length_8228_cov_17.079592	3154	3217	24	1	63	0.0158730
NODE_40_length_8228_cov_17.079592	3154	3217	26	1	63	0.0158730
NODE_40_length_8228_cov_17.079592	3154	3217	30	4	63	0.0634921
NODE_40_length_8228_cov_17.079592	3154	3217	32	1	63	0.0158730
NODE_40_length_8228_cov_17.079592	3154	3217	34	1	63	0.0158730
NODE_40_length_8228_cov_17.079592	3154	3217	36	3	63	0.0476190
NODE_40_length_8228_cov_17.079592	3154	3217	37	3	63	0.0476190
NODE_40_length_8228_cov_17.079592	3154	3217	39	1	63	0.0158730
NODE_40_length_8228_cov_17.079592	3154	3217	41	6	63	0.0952381
NODE_40_length_8228_cov_17.079592	3154	3217	42	1	63	0.0158730
NODE_40_length_8228_cov_17.079592	3154	3217	44	2	63	0.0317460
NODE_40_length_8228_cov_17.079592	3154	3217	46	5	63	0.0793651
NODE_40_length_8228_cov_17.079592	3154	3217	59	2	63	0.0317460
NODE_40_length_8228_cov_17.079592	3154	3217	61	1	63	0.0158730
NODE_40_length_8228_cov_17.079592	3154	3217	69	2	63	0.0317460
NODE_40_length_8228_cov_17.079592	3154	3217	75	1	63	0.0158730
NODE_40_length_8228_cov_17.079592	3154	3217	77	1	63	0.0158730
NODE_40_length_8228_cov_17.079592	3154	3217	79	6	63	0.0952381
NODE_40_length_8228_cov_17.079592	3154	3217	82	7	63	0.1111111
NODE_40_length_8228_cov_17.079592	3154	3217	84	13	63	0.2063492
NODE_43_length_8100_cov_32.115236	501	581	6	2	80	0.0250000
NODE_43_length_8100_cov_32.115236	501	581	10	25	80	0.3125000
NODE_43_length_8100_cov_32.115236	501	581	12	27	80	0.3375000
NODE_43_length_8100_cov_32.115236	501	581	13	4	80	0.0500000
NODE_43_length_8100_cov_32.115236	501	581	14	22	80	0.2750000
NODE_43_length_8100_cov_32.115236	554	634	4	14	80	0.1750000
NODE_43_length_8100_cov_32.115236	554	634	6	23	80	0.2875000
NODE_43_length_8100_cov_32.115236	554	634	7	1	80	0.0125000
NODE_43_length_8100_cov_32.115236	554	634	8	5	80	0.0625000
NODE_43_length_8100_cov_32.115236	554	634	10	5	80	0.0625000
NODE_43_length_8100_cov_32.115236	554	634	12	16	80	0.2000000
NODE_43_length_8100_cov_32.115236	554	634	13	7	80	0.0875000
NODE_43_length_8100_cov_32.115236	554	634	14	9	80	0.1125000
NODE_43_length_8100_cov_32.115236	1383	1463	0	80	80	1.0000000
NODE_43_length_8100_cov_32.115236	1436	1516	0	80	80	1.0000000
NODE_43_length_8100_cov_32.115236	3391	3462	110	1	71	0.0140845
NODE_43_length_8100_cov_32.115236	3391	3462	120	1	71	0.0140845
NODE_43_length_8100_cov_32.115236	3391	3462	124	1	71	0.0140845
NODE_43_length_8100_cov_32.115236	3391	3462	126	1	71	0.0140845
NODE_43_length_8100_cov_32.115236	3391	3462	129	2	71	0.0281690
NODE_43_length_8100_cov_32.115236	3391	3462	138	1	71	0.0140845
NODE_43_length_8100_cov_32.115236	3391	3462	139	2	71	0.0281690
NODE_43_length_8100_cov_32.115236	3391	3462	141	3	71	0.0422535
NODE_43_length_8100_cov_32.115236	3391	3462	143	1	71	0.0140845
NODE_43_length_8100_cov_32.115236	3391	3462	146	3	71	0.0422535
NODE_43_length_8100_cov_32.115236	3391	3462	148	1	71	0.0140845
NODE_43_length_8100_cov_32.115236	3391	3462	158	1	71	0.0140845
NODE_43_length_8100_cov_32.115236	3391	3462	164	3	71	0.0422535
NODE_43_length_8100_cov_32.115236	3391	3462	166	4	71	0.0563380
NODE_43_length_8100_cov_32.115236	3391	3462	167	1	71	0.0140845
NODE_43_length_8100_cov_32.115236	3391	3462	168	11	71	0.1549296
NODE_43_length_8100_cov_32.115236	3391	3462	169	2	71	0.0281690
NODE_43_length_8100_cov_32.115236	3391	3462	170	7	71	0.0985916
NODE_43_length_8100_cov_32.115236	3391	3462	171	1	71	0.0140845
NODE_43_length_8100_cov_32.115236	3391	3462	172	2	71	0.0281690
NODE_43_length_8100_cov_32.115236	3391	3462	173	1	71	0.0140845
NODE_43_length_8100_cov_32.115236	3391	3462	174	2	71	0.0281690
NODE_43_length_8100_cov_32.115236	3391	3462	175	5	71	0.0704225
NODE_43_length_8100_cov_32.115236	3391	3462	176	3	71	0.0422535
NODE_43_length_8100_cov_32.115236	3391	3462	178	1	71	0.0140845
NODE_43_length_8100_cov_32.115236	3391	3462	180	1	71	0.0140845
NODE_43_length_8100_cov_32.115236	3391	3462	182	2	71	0.0281690
NODE_43_length_8100_cov_32.115236	3391	3462	186	3	71	0.0422535
NODE_43_length_8100_cov_32.115236	3391	3462	188	2	71	0.0281690
NODE_43_length_8100_cov_32.115236	3391	3462	190	2	71	0.0281690
NODE_43_length_8100_cov_32.115236	3435	3483	74	1	48	0.0208333
NODE_43_length_8100_cov_32.115236	3435	3483	78	1	48	0.0208333
NODE_43_length_8100_cov_32.115236	3435	3483	80	1	48	0.0208333
NODE_43_length_8100_cov_32.115236	3435	3483	84	2	48	0.0416667
NODE_43_length_8100_cov_32.115236	3435	3483	87	1	48	0.0208333
NODE_43_length_8100_cov_32.115236	3435	3483	88	1	48	0.0208333
NODE_43_length_8100_cov_32.115236	3435	3483	90	2	48	0.0416667
NODE_43_length_8100_cov_32.115236	3435	3483	96	1	48	0.0208333
NODE_43_length_8100_cov_32.115236	3435	3483	99	3	48	0.0625000
NODE_43_length_8100_cov_32.115236	3435	3483	103	3	48	0.0625000
NODE_43_length_8100_cov_32.115236	3435	3483	104	2	48	0.0416667
NODE_43_length_8100_cov_32.115236	3435	3483	107	2	48	0.0416667
NODE_43_length_8100_cov_32.115236	3435	3483	108	1	48	0.0208333
NODE_43_length_8100_cov_32.115236	3435	3483	110	1	48	0.0208333
NODE_43_length_8100_cov_32.115236	3435	3483	120	1	48	0.0208333
NODE_43_length_8100_cov_32.115236	3435	3483	124	1	48	0.0208333
NODE_43_length_8100_cov_32.115236	3435	3483	126	1	48	0.0208333
NODE_43_length_8100_cov_32.115236	3435	3483	129	2	48	0.0416667
NODE_43_length_8100_cov_32.115236	3435	3483	138	1	48	0.0208333
NODE_43_length_8100_cov_32.115236	3435	3483	139	2	48	0.0416667
NODE_43_length_8100_cov_32.115236	3435	3483	141	3	48	0.0625000
NODE_43_length_8100_cov_32.115236	3435	3483	143	1	48	0.0208333
NODE_43_length_8100_cov_32.115236	3435	3483	146	3	48	0.0625000
NODE_43_length_8100_cov_32.115236	3435	3483	148	1	48	0.0208333
NODE_43_length_8100_cov_32.115236	3435	3483	158	1	48	0.0208333
NODE_43_length_8100_cov_32.115236	3435	3483	164	1	48	0.0208333
NODE_43_length_8100_cov_32.115236	3435	3483	170	1	48	0.0208333
NODE_43_length_8100_cov_32.115236	3435	3483	172	1	48	0.0208333
NODE_43_length_8100_cov_32.115236	3435	3483	176	1	48	0.0208333
NODE_43_length_8100_cov_32.115236	3435	3483	186	2	48	0.0416667
NODE_43_length_8100_cov_32.115236	3435	3483	188	2	48	0.0416667
NODE_43_length_8100_cov_32.115236	3435	3483	190	1	48	0.0208333
NODE_46_length_7962_cov_31.622790	6281	6363	44	1	82	0.0121951
NODE_46_length_7962_cov_31.622790	6281	6363	45	1	82	0.0121951
NODE_46_length_7962_cov_31.622790	6281	6363	46	4	82	0.0487805
NODE_46_length_7962_cov_31.622790	6281	6363	48	14	82	0.1707317
NODE_46_length_7962_cov_31.622790	6281	6363	50	1	82	0.0121951
NODE_46_length_7962_cov_31.622790	6281	6363	51	1	82	0.0121951
NODE_46_length_7962_cov_31.622790	6281	6363	62	1	82	0.0121951
NODE_46_length_7962_cov_31.622790	6281	6363	64	2	82	0.0243902
NODE_46_length_7962_cov_31.622790	6281	6363	68	1	82	0.0121951
NODE_46_length_7962_cov_31.622790	6281	6363	69	1	82	0.0121951
NODE_46_length_7962_cov_31.622790	6281	6363	70	1	82	0.0121951
NODE_46_length_7962_cov_31.622790	6281	6363	72	2	82	0.0243902
NODE_46_length_7962_cov_31.622790	6281	6363	73	1	82	0.0121951
NODE_46_length_7962_cov_31.622790	6281	6363	74	7	82	0.0853659
NODE_46_length_7962_cov_31.622790	6281	6363	76	7	82	0.0853659
NODE_46_length_7962_cov_31.622790	6281	6363	78	9	82	0.1097561
NODE_46_length_7962_cov_31.622790	6281	6363	80	6	82	0.0731707
NODE_46_length_7962_cov_31.622790	6281	6363	82	3	82	0.0365854
NODE_46_length_7962_cov_31.622790	6281	6363	86	3	82	0.0365854
NODE_46_length_7962_cov_31.622790	6281	6363	90	2	82	0.0243902
NODE_46_length_7962_cov_31.622790	6281	6363	92	4	82	0.0487805
NODE_46_length_7962_cov_31.622790	6281	6363	94	10	82	0.1219512
NODE_47_length_7944_cov_12.238496	348	419	0	4	71	0.0563380
NODE_47_length_7944_cov_12.238496	348	419	2	2	71	0.0281690
NODE_47_length_7944_cov_12.238496	348	419	4	2	71	0.0281690
NODE_47_length_7944_cov_12.238496	348	419	5	20	71	0.2816902
NODE_47_length_7944_cov_12.238496	348	419	7	11	71	0.1549296
NODE_47_length_7944_cov_12.238496	348	419	9	2	71	0.0281690
NODE_47_length_7944_cov_12.238496	348	419	10	13	71	0.1830986
NODE_47_length_7944_cov_12.238496	348	419	11	4	71	0.0563380
NODE_47_length_7944_cov_12.238496	348	419	12	13	71	0.1830986
NODE_48_length_7919_cov_14.554859	2380	2460	28	3	80	0.0375000
NODE_48_length_7919_cov_14.554859	2380	2460	30	1	80	0.0125000
NODE_48_length_7919_cov_14.554859	2380	2460	32	1	80	0.0125000
NODE_48_length_7919_cov_14.554859	2380	2460	36	3	80	0.0375000
NODE_48_length_7919_cov_14.554859	2380	2460	38	3	80	0.0375000
NODE_48_length_7919_cov_14.554859	2380	2460	42	4	80	0.0500000
NODE_48_length_7919_cov_14.554859	2380	2460	44	1	80	0.0125000
NODE_48_length_7919_cov_14.554859	2380	2460	46	5	80	0.0625000
NODE_48_length_7919_cov_14.554859	2380	2460	47	1	80	0.0125000
NODE_48_length_7919_cov_14.554859	2380	2460	50	2	80	0.0250000
NODE_48_length_7919_cov_14.554859	2380	2460	52	2	80	0.0250000
NODE_48_length_7919_cov_14.554859	2380	2460	54	1	80	0.0125000
NODE_48_length_7919_cov_14.554859	2380	2460	55	1	80	0.0125000
NODE_48_length_7919_cov_14.554859	2380	2460	59	3	80	0.0375000
NODE_48_length_7919_cov_14.554859	2380	2460	61	1	80	0.0125000
NODE_48_length_7919_cov_14.554859	2380	2460	63	1	80	0.0125000
NODE_48_length_7919_cov_14.554859	2380	2460	67	3	80	0.0375000
NODE_48_length_7919_cov_14.554859	2380	2460	70	12	80	0.1500000
NODE_48_length_7919_cov_14.554859	2380	2460	71	1	80	0.0125000
NODE_48_length_7919_cov_14.554859	2380	2460	72	3	80	0.0375000
NODE_48_length_7919_cov_14.554859	2380	2460	75	3	80	0.0375000
NODE_48_length_7919_cov_14.554859	2380	2460	76	6	80	0.0750000
NODE_48_length_7919_cov_14.554859	2380	2460	78	2	80	0.0250000
NODE_48_length_7919_cov_14.554859	2380	2460	79	2	80	0.0250000
NODE_48_length_7919_cov_14.554859	2380	2460	80	5	80	0.0625000
NODE_48_length_7919_cov_14.554859	2380	2460	81	8	80	0.1000000
NODE_48_length_7919_cov_14.554859	2380	2460	82	2	80	0.0250000
NODE_50_length_7830_cov_4.211098	0	52	0	21	52	0.4038461
NODE_50_length_7830_cov_4.211098	0	52	2	31	52	0.5961539
NODE_50_length_7830_cov_4.211098	30	105	2	75	75	1.0000000
NODE_52_length_7779_cov_20.230859	7691	7771	0	65	80	0.8125000
NODE_52_length_7779_cov_20.230859	7691	7771	2	15	80	0.1875000
NODE_52_length_7779_cov_20.230859	7691	7771	0	65	80	0.8125000
NODE_52_length_7779_cov_20.230859	7691	7771	2	15	80	0.1875000
NODE_52_length_7779_cov_20.230859	7691	7761	0	55	70	0.7857143
NODE_52_length_7779_cov_20.230859	7691	7761	2	15	70	0.2142857
NODE_52_length_7779_cov_20.230859	7744	7779	0	35	35	1.0000000
NODE_53_length_7765_cov_18.871119	254	322	4	13	68	0.1911765
NODE_53_length_7765_cov_18.871119	254	322	6	10	68	0.1470588
NODE_53_length_7765_cov_18.871119	254	322	8	2	68	0.0294118
NODE_53_length_7765_cov_18.871119	254	322	10	10	68	0.1470588
NODE_53_length_7765_cov_18.871119	254	322	12	10	68	0.1470588
NODE_53_length_7765_cov_18.871119	254	322	14	2	68	0.0294118
NODE_53_length_7765_cov_18.871119	254	322	16	13	68	0.1911765
NODE_53_length_7765_cov_18.871119	254	322	18	1	68	0.0147059
NODE_53_length_7765_cov_18.871119	254	322	20	3	68	0.0441176
NODE_53_length_7765_cov_18.871119	254	322	22	1	68	0.0147059
NODE_53_length_7765_cov_18.871119	254	322	24	1	68	0.0147059
NODE_53_length_7765_cov_18.871119	254	322	26	1	68	0.0147059
NODE_53_length_7765_cov_18.871119	254	322	28	1	68	0.0147059
NODE_53_length_7765_cov_18.871119	353	433	12	2	80	0.0250000
NODE_53_length_7765_cov_18.871119	353	433	14	5	80	0.0625000
NODE_53_length_7765_cov_18.871119	353	433	16	4	80	0.0500000
NODE_53_length_7765_cov_18.871119	353	433	22	13	80	0.1625000
NODE_53_length_7765_cov_18.871119	353	433	23	12	80	0.1500000
NODE_53_length_7765_cov_18.871119	353	433	24	5	80	0.0625000
NODE_53_length_7765_cov_18.871119	353	433	25	15	80	0.1875000
NODE_53_length_7765_cov_18.871119	353	433	26	5	80	0.0625000
NODE_53_length_7765_cov_18.871119	353	433	27	1	80	0.0125000
NODE_53_length_7765_cov_18.871119	353	433	28	18	80	0.2250000
NODE_61_length_7411_cov_74.967314	2283	2347	0	64	64	1.0000000
NODE_61_length_7411_cov_74.967314	4725	4789	0	64	64	1.0000000
NODE_64_length_7305_cov_3.696087	971	1019	0	7	48	0.1458333
NODE_64_length_7305_cov_3.696087	971	1019	2	7	48	0.1458333
NODE_64_length_7305_cov_3.696087	971	1019	4	34	48	0.7083333
NODE_64_length_7305_cov_3.696087	7142	7190	0	47	48	0.9791667
NODE_64_length_7305_cov_3.696087	7142	7190	4	1	48	0.0208333
NODE_66_length_7261_cov_12.433398	2313	2395	52	8	82	0.0975610
NODE_66_length_7261_cov_12.433398	2313	2395	54	3	82	0.0365854
NODE_66_length_7261_cov_12.433398	2313	2395	55	4	82	0.0487805
NODE_66_length_7261_cov_12.433398	2313	2395	56	12	82	0.1463415
NODE_66_length_7261_cov_12.433398	2313	2395	57	2	82	0.0243902
NODE_66_length_7261_cov_12.433398	2313	2395	58	6	82	0.0731707
NODE_66_length_7261_cov_12.433398	2313	2395	59	3	82	0.0365854
NODE_66_length_7261_cov_12.433398	2313	2395	60	2	82	0.0243902
NODE_66_length_7261_cov_12.433398	2313	2395	61	8	82	0.0975610
NODE_66_length_7261_cov_12.433398	2313	2395	67	1	82	0.0121951
NODE_66_length_7261_cov_12.433398	2313	2395	69	1	82	0.0121951
NODE_66_length_7261_cov_12.433398	2313	2395	77	2	82	0.0243902
NODE_66_length_7261_cov_12.433398	2313	2395	80	2	82	0.0243902
NODE_66_length_7261_cov_12.433398	2313	2395	86	1	82	0.0121951
NODE_66_length_7261_cov_12.433398	2313	2395	88	3	82	0.0365854
NODE_66_length_7261_cov_12.433398	2313	2395	90	1	82	0.0121951
NODE_66_length_7261_cov_12.433398	2313	2395	96	1	82	0.0121951
NODE_66_length_7261_cov_12.433398	2313	2395	98	1	82	0.0121951
NODE_66_length_7261_cov_12.433398	2313	2395	102	2	82	0.0243902
NODE_66_length_7261_cov_12.433398	2313	2395	104	7	82	0.0853659
NODE_66_length_7261_cov_12.433398	2313	2395	106	1	82	0.0121951
NODE_66_length_7261_cov_12.433398	2313	2395	108	4	82	0.0487805
NODE_66_length_7261_cov_12.433398	2313	2395	114	1	82	0.0121951
NODE_66_length_7261_cov_12.433398	2313	2395	118	1	82	0.0121951
NODE_66_length_7261_cov_12.433398	2313	2395	120	1	82	0.0121951
NODE_66_length_7261_cov_12.433398	2313	2395	122	2	82	0.0243902
NODE_66_length_7261_cov_12.433398	2313	2395	126	1	82	0.0121951
NODE_66_length_7261_cov_12.433398	2313	2395	138	1	82	0.0121951
NODE_73_length_7036_cov_65.961943	4375	4455	2	38	80	0.4750000
NODE_73_length_7036_cov_65.961943	4375	4455	4	42	80	0.5250000
NODE_73_length_7036_cov_65.961943	5538	5618	140	1	80	0.0125000
NODE_73_length_7036_cov_65.961943	5538	5618	141	1	80	0.0125000
NODE_73_length_7036_cov_65.961943	5538	5618	148	1	80	0.0125000
NODE_73_length_7036_cov_65.961943	5538	5618	151	1	80	0.0125000
NODE_73_length_7036_cov_65.961943	5538	5618	157	2	80	0.0250000
NODE_73_length_7036_cov_65.961943	5538	5618	159	1	80	0.0125000
NODE_73_length_7036_cov_65.961943	5538	5618	179	1	80	0.0125000
NODE_73_length_7036_cov_65.961943	5538	5618	180	1	80	0.0125000
NODE_73_length_7036_cov_65.961943	5538	5618	184	1	80	0.0125000
NODE_73_length_7036_cov_65.961943	5538	5618	192	1	80	0.0125000
NODE_73_length_7036_cov_65.961943	5538	5618	201	1	80	0.0125000
NODE_73_length_7036_cov_65.961943	5538	5618	209	1	80	0.0125000
NODE_73_length_7036_cov_65.961943	5538	5618	212	1	80	0.0125000
NODE_73_length_7036_cov_65.961943	5538	5618	220	1	80	0.0125000
NODE_73_length_7036_cov_65.961943	5538	5618	227	1	80	0.0125000
NODE_73_length_7036_cov_65.961943	5538	5618	235	1	80	0.0125000
NODE_73_length_7036_cov_65.961943	5538	5618	238	1	80	0.0125000
NODE_73_length_7036_cov_65.961943	5538	5618	240	1	80	0.0125000
NODE_73_length_7036_cov_65.961943	5538	5618	261	1	80	0.0125000
NODE_73_length_7036_cov_65.961943	5538	5618	265	1	80	0.0125000
NODE_73_length_7036_cov_65.961943	5538	5618	271	4	80	0.0500000
NODE_73_length_7036_cov_65.961943	5538	5618	278	1	80	0.0125000
NODE_73_length_7036_cov_65.961943	5538	5618	281	1	80	0.0125000
NODE_73_length_7036_cov_65.961943	5538	5618	282	1	80	0.0125000
NODE_73_length_7036_cov_65.961943	5538	5618	292	1	80	0.0125000
NODE_73_length_7036_cov_65.961943	5538	5618	298	1	80	0.0125000
NODE_73_length_7036_cov_65.961943	5538	5618	301	2	80	0.0250000
NODE_73_length_7036_cov_65.961943	5538	5618	308	1	80	0.0125000
NODE_73_length_7036_cov_65.961943	5538	5618	310	1	80	0.0125000
NODE_73_length_7036_cov_65.961943	5538	5618	314	1	80	0.0125000
NODE_73_length_7036_cov_65.961943	5538	5618	325	1	80	0.0125000
NODE_73_length_7036_cov_65.961943	5538	5618	330	1	80	0.0125000
NODE_73_length_7036_cov_65.961943	5538	5618	336	2	80	0.0250000
NODE_73_length_7036_cov_65.961943	5538	5618	341	1	80	0.0125000
NODE_73_length_7036_cov_65.961943	5538	5618	345	1	80	0.0125000
NODE_73_length_7036_cov_65.961943	5538	5618	347	2	80	0.0250000
NODE_73_length_7036_cov_65.961943	5538	5618	348	1	80	0.0125000
NODE_73_length_7036_cov_65.961943	5538	5618	350	2	80	0.0250000
NODE_73_length_7036_cov_65.961943	5538	5618	356	1	80	0.0125000
NODE_73_length_7036_cov_65.961943	5538	5618	360	1	80	0.0125000
NODE_73_length_7036_cov_65.961943	5538	5618	362	1	80	0.0125000
NODE_73_length_7036_cov_65.961943	5538	5618	364	2	80	0.0250000
NODE_73_length_7036_cov_65.961943	5538	5618	375	1	80	0.0125000
NODE_73_length_7036_cov_65.961943	5538	5618	380	1	80	0.0125000
NODE_73_length_7036_cov_65.961943	5538	5618	384	1	80	0.0125000
NODE_73_length_7036_cov_65.961943	5538	5618	386	1	80	0.0125000
NODE_73_length_7036_cov_65.961943	5538	5618	393	1	80	0.0125000
NODE_73_length_7036_cov_65.961943	5538	5618	398	1	80	0.0125000
NODE_73_length_7036_cov_65.961943	5538	5618	401	1	80	0.0125000
NODE_73_length_7036_cov_65.961943	5538	5618	411	3	80	0.0375000
NODE_73_length_7036_cov_65.961943	5538	5618	419	1	80	0.0125000
NODE_73_length_7036_cov_65.961943	5538	5618	429	1	80	0.0125000
NODE_73_length_7036_cov_65.961943	5538	5618	441	1	80	0.0125000
NODE_73_length_7036_cov_65.961943	5538	5618	448	1	80	0.0125000
NODE_73_length_7036_cov_65.961943	5538	5618	449	1	80	0.0125000
NODE_73_length_7036_cov_65.961943	5538	5618	450	2	80	0.0250000
NODE_73_length_7036_cov_65.961943	5538	5618	457	1	80	0.0125000
NODE_73_length_7036_cov_65.961943	5538	5618	459	1	80	0.0125000
NODE_73_length_7036_cov_65.961943	5538	5618	465	2	80	0.0250000
NODE_73_length_7036_cov_65.961943	5538	5618	469	2	80	0.0250000
NODE_73_length_7036_cov_65.961943	5538	5618	471	1	80	0.0125000
NODE_73_length_7036_cov_65.961943	5538	5618	472	2	80	0.0250000
NODE_73_length_7036_cov_65.961943	5538	5618	475	1	80	0.0125000
NODE_73_length_7036_cov_65.961943	5538	5618	482	1	80	0.0125000
NODE_73_length_7036_cov_65.961943	5538	5618	488	1	80	0.0125000
NODE_73_length_7036_cov_65.961943	5591	5666	384	1	75	0.0133333
NODE_73_length_7036_cov_65.961943	5591	5666	386	1	75	0.0133333
NODE_73_length_7036_cov_65.961943	5591	5666	393	1	75	0.0133333
NODE_73_length_7036_cov_65.961943	5591	5666	398	1	75	0.0133333
NODE_73_length_7036_cov_65.961943	5591	5666	401	1	75	0.0133333
NODE_73_length_7036_cov_65.961943	5591	5666	411	3	75	0.0400000
NODE_73_length_7036_cov_65.961943	5591	5666	419	1	75	0.0133333
NODE_73_length_7036_cov_65.961943	5591	5666	429	1	75	0.0133333
NODE_73_length_7036_cov_65.961943	5591	5666	441	1	75	0.0133333
NODE_73_length_7036_cov_65.961943	5591	5666	448	1	75	0.0133333
NODE_73_length_7036_cov_65.961943	5591	5666	449	1	75	0.0133333
NODE_73_length_7036_cov_65.961943	5591	5666	450	2	75	0.0266667
NODE_73_length_7036_cov_65.961943	5591	5666	457	1	75	0.0133333
NODE_73_length_7036_cov_65.961943	5591	5666	459	1	75	0.0133333
NODE_73_length_7036_cov_65.961943	5591	5666	465	2	75	0.0266667
NODE_73_length_7036_cov_65.961943	5591	5666	469	2	75	0.0266667
NODE_73_length_7036_cov_65.961943	5591	5666	471	1	75	0.0133333
NODE_73_length_7036_cov_65.961943	5591	5666	472	2	75	0.0266667
NODE_73_length_7036_cov_65.961943	5591	5666	475	1	75	0.0133333
NODE_73_length_7036_cov_65.961943	5591	5666	482	1	75	0.0133333
NODE_73_length_7036_cov_65.961943	5591	5666	488	1	75	0.0133333
NODE_73_length_7036_cov_65.961943	5591	5666	493	1	75	0.0133333
NODE_73_length_7036_cov_65.961943	5591	5666	496	1	75	0.0133333
NODE_73_length_7036_cov_65.961943	5591	5666	507	1	75	0.0133333
NODE_73_length_7036_cov_65.961943	5591	5666	513	1	75	0.0133333
NODE_73_length_7036_cov_65.961943	5591	5666	526	1	75	0.0133333
NODE_73_length_7036_cov_65.961943	5591	5666	530	1	75	0.0133333
NODE_73_length_7036_cov_65.961943	5591	5666	540	1	75	0.0133333
NODE_73_length_7036_cov_65.961943	5591	5666	544	1	75	0.0133333
NODE_73_length_7036_cov_65.961943	5591	5666	547	1	75	0.0133333
NODE_73_length_7036_cov_65.961943	5591	5666	549	2	75	0.0266667
NODE_73_length_7036_cov_65.961943	5591	5666	552	1	75	0.0133333
NODE_73_length_7036_cov_65.961943	5591	5666	553	3	75	0.0400000
NODE_73_length_7036_cov_65.961943	5591	5666	555	1	75	0.0133333
NODE_73_length_7036_cov_65.961943	5591	5666	556	2	75	0.0266667
NODE_73_length_7036_cov_65.961943	5591	5666	557	1	75	0.0133333
NODE_73_length_7036_cov_65.961943	5591	5666	561	1	75	0.0133333
NODE_73_length_7036_cov_65.961943	5591	5666	565	1	75	0.0133333
NODE_73_length_7036_cov_65.961943	5591	5666	566	1	75	0.0133333
NODE_73_length_7036_cov_65.961943	5591	5666	567	2	75	0.0266667
NODE_73_length_7036_cov_65.961943	5591	5666	569	1	75	0.0133333
NODE_73_length_7036_cov_65.961943	5591	5666	570	1	75	0.0133333
NODE_73_length_7036_cov_65.961943	5591	5666	574	1	75	0.0133333
NODE_73_length_7036_cov_65.961943	5591	5666	576	1	75	0.0133333
NODE_73_length_7036_cov_65.961943	5591	5666	580	1	75	0.0133333
NODE_73_length_7036_cov_65.961943	5591	5666	592	1	75	0.0133333
NODE_73_length_7036_cov_65.961943	5591	5666	600	1	75	0.0133333
NODE_73_length_7036_cov_65.961943	5591	5666	610	1	75	0.0133333
NODE_73_length_7036_cov_65.961943	5591	5666	615	1	75	0.0133333
NODE_73_length_7036_cov_65.961943	5591	5666	617	1	75	0.0133333
NODE_73_length_7036_cov_65.961943	5591	5666	634	1	75	0.0133333
NODE_73_length_7036_cov_65.961943	5591	5666	644	1	75	0.0133333
NODE_73_length_7036_cov_65.961943	5591	5666	652	1	75	0.0133333
NODE_73_length_7036_cov_65.961943	5591	5666	664	1	75	0.0133333
NODE_73_length_7036_cov_65.961943	5591	5666	665	1	75	0.0133333
NODE_73_length_7036_cov_65.961943	5591	5666	682	1	75	0.0133333
NODE_73_length_7036_cov_65.961943	5591	5666	700	1	75	0.0133333
NODE_73_length_7036_cov_65.961943	5591	5666	703	1	75	0.0133333
NODE_73_length_7036_cov_65.961943	5591	5666	713	1	75	0.0133333
NODE_73_length_7036_cov_65.961943	5591	5666	720	1	75	0.0133333
NODE_73_length_7036_cov_65.961943	5591	5666	730	1	75	0.0133333
NODE_73_length_7036_cov_65.961943	5591	5666	733	1	75	0.0133333
NODE_73_length_7036_cov_65.961943	5591	5666	734	1	75	0.0133333
NODE_73_length_7036_cov_65.961943	5591	5666	738	1	75	0.0133333
NODE_73_length_7036_cov_65.961943	5690	5746	793	1	56	0.0178571
NODE_73_length_7036_cov_65.961943	5690	5746	797	1	56	0.0178571
NODE_73_length_7036_cov_65.961943	5690	5746	805	2	56	0.0357143
NODE_73_length_7036_cov_65.961943	5690	5746	811	1	56	0.0178571
NODE_73_length_7036_cov_65.961943	5690	5746	816	1	56	0.0178571
NODE_73_length_7036_cov_65.961943	5690	5746	837	1	56	0.0178571
NODE_73_length_7036_cov_65.961943	5690	5746	845	1	56	0.0178571
NODE_73_length_7036_cov_65.961943	5690	5746	852	1	56	0.0178571
NODE_73_length_7036_cov_65.961943	5690	5746	865	2	56	0.0357143
NODE_73_length_7036_cov_65.961943	5690	5746	867	1	56	0.0178571
NODE_73_length_7036_cov_65.961943	5690	5746	869	1	56	0.0178571
NODE_73_length_7036_cov_65.961943	5690	5746	874	1	56	0.0178571
NODE_73_length_7036_cov_65.961943	5690	5746	875	1	56	0.0178571
NODE_73_length_7036_cov_65.961943	5690	5746	881	1	56	0.0178571
NODE_73_length_7036_cov_65.961943	5690	5746	884	1	56	0.0178571
NODE_73_length_7036_cov_65.961943	5690	5746	885	2	56	0.0357143
NODE_73_length_7036_cov_65.961943	5690	5746	886	3	56	0.0535714
NODE_73_length_7036_cov_65.961943	5690	5746	887	2	56	0.0357143
NODE_73_length_7036_cov_65.961943	5690	5746	888	3	56	0.0535714
NODE_73_length_7036_cov_65.961943	5690	5746	889	1	56	0.0178571
NODE_73_length_7036_cov_65.961943	5690	5746	890	2	56	0.0357143
NODE_73_length_7036_cov_65.961943	5690	5746	891	3	56	0.0535714
NODE_73_length_7036_cov_65.961943	5690	5746	892	1	56	0.0178571
NODE_73_length_7036_cov_65.961943	5690	5746	893	4	56	0.0714286
NODE_73_length_7036_cov_65.961943	5690	5746	895	1	56	0.0178571
NODE_73_length_7036_cov_65.961943	5690	5746	898	1	56	0.0178571
NODE_73_length_7036_cov_65.961943	5690	5746	899	2	56	0.0357143
NODE_73_length_7036_cov_65.961943	5690	5746	900	1	56	0.0178571
NODE_73_length_7036_cov_65.961943	5690	5746	901	2	56	0.0357143
NODE_73_length_7036_cov_65.961943	5690	5746	903	2	56	0.0357143
NODE_73_length_7036_cov_65.961943	5690	5746	907	2	56	0.0357143
NODE_73_length_7036_cov_65.961943	5690	5746	909	1	56	0.0178571
NODE_73_length_7036_cov_65.961943	5690	5746	912	1	56	0.0178571
NODE_73_length_7036_cov_65.961943	5690	5746	913	1	56	0.0178571
NODE_73_length_7036_cov_65.961943	5690	5746	914	2	56	0.0357143
NODE_73_length_7036_cov_65.961943	5690	5746	915	1	56	0.0178571
NODE_73_length_7036_cov_65.961943	5690	5746	920	1	56	0.0178571
NODE_73_length_7036_cov_65.961943	6373	6453	0	80	80	1.0000000
NODE_73_length_7036_cov_65.961943	6426	6506	0	80	80	1.0000000
NODE_74_length_6974_cov_16.058327	976	1056	0	19	80	0.2375000
NODE_74_length_6974_cov_16.058327	976	1056	2	5	80	0.0625000
NODE_74_length_6974_cov_16.058327	976	1056	4	56	80	0.7000000
NODE_74_length_6974_cov_16.058327	1029	1109	2	38	80	0.4750000
NODE_74_length_6974_cov_16.058327	1029	1109	4	42	80	0.5250000
NODE_80_length_6826_cov_10.483574	4462	4542	0	9	80	0.1125000
NODE_80_length_6826_cov_10.483574	4462	4542	1	1	80	0.0125000
NODE_80_length_6826_cov_10.483574	4462	4542	3	5	80	0.0625000
NODE_80_length_6826_cov_10.483574	4462	4542	4	11	80	0.1375000
NODE_80_length_6826_cov_10.483574	4462	4542	10	4	80	0.0500000
NODE_80_length_6826_cov_10.483574	4462	4542	14	33	80	0.4125000
NODE_80_length_6826_cov_10.483574	4462	4542	16	7	80	0.0875000
NODE_80_length_6826_cov_10.483574	4462	4542	18	5	80	0.0625000
NODE_80_length_6826_cov_10.483574	4462	4542	22	2	80	0.0250000
NODE_80_length_6826_cov_10.483574	4462	4542	26	3	80	0.0375000
NODE_80_length_6826_cov_10.483574	4515	4595	14	10	80	0.1250000
NODE_80_length_6826_cov_10.483574	4515	4595	16	7	80	0.0875000
NODE_80_length_6826_cov_10.483574	4515	4595	18	5	80	0.0625000
NODE_80_length_6826_cov_10.483574	4515	4595	22	2	80	0.0250000
NODE_80_length_6826_cov_10.483574	4515	4595	26	11	80	0.1375000
NODE_80_length_6826_cov_10.483574	4515	4595	28	1	80	0.0125000
NODE_80_length_6826_cov_10.483574	4515	4595	29	2	80	0.0250000
NODE_80_length_6826_cov_10.483574	4515	4595	30	7	80	0.0875000
NODE_80_length_6826_cov_10.483574	4515	4595	31	1	80	0.0125000
NODE_80_length_6826_cov_10.483574	4515	4595	35	26	80	0.3250000
NODE_80_length_6826_cov_10.483574	4515	4595	37	8	80	0.1000000
NODE_81_length_6816_cov_2.820753	6726	6801	0	75	75	1.0000000
NODE_81_length_6816_cov_2.820753	6774	6816	0	42	42	1.0000000
NODE_84_length_6744_cov_6.222272	5	85	0	80	80	1.0000000
NODE_84_length_6744_cov_6.222272	58	138	0	63	80	0.7875000
NODE_84_length_6744_cov_6.222272	58	138	2	17	80	0.2125000
NODE_84_length_6744_cov_6.222272	6650	6730	0	25	80	0.3125000
NODE_84_length_6744_cov_6.222272	6650	6730	2	30	80	0.3750000
NODE_84_length_6744_cov_6.222272	6650	6730	4	6	80	0.0750000
NODE_84_length_6744_cov_6.222272	6650	6730	6	19	80	0.2375000
NODE_84_length_6744_cov_6.222272	6703	6744	0	39	41	0.9512195
NODE_84_length_6744_cov_6.222272	6703	6744	2	2	41	0.0487805
NODE_86_length_6733_cov_88.965029	3141	3221	0	5	80	0.0625000
NODE_86_length_6733_cov_88.965029	3141	3221	2	5	80	0.0625000
NODE_86_length_6733_cov_88.965029	3141	3221	4	16	80	0.2000000
NODE_86_length_6733_cov_88.965029	3141	3221	6	15	80	0.1875000
NODE_86_length_6733_cov_88.965029	3141	3221	8	39	80	0.4875000
NODE_86_length_6733_cov_88.965029	3194	3274	4	7	80	0.0875000
NODE_86_length_6733_cov_88.965029	3194	3274	6	20	80	0.2500000
NODE_86_length_6733_cov_88.965029	3194	3274	8	41	80	0.5125000
NODE_86_length_6733_cov_88.965029	3194	3274	10	12	80	0.1500000
NODE_86_length_6733_cov_88.965029	3270	3350	2	1	80	0.0125000
NODE_86_length_6733_cov_88.965029	3270	3350	4	31	80	0.3875000
NODE_86_length_6733_cov_88.965029	3270	3350	8	48	80	0.6000000
NODE_86_length_6733_cov_88.965029	3323	3403	0	29	80	0.3625000
NODE_86_length_6733_cov_88.965029	3323	3403	2	25	80	0.3125000
NODE_86_length_6733_cov_88.965029	3323	3403	4	26	80	0.3250000
NODE_90_length_6627_cov_9.440564	350	430	0	24	80	0.3000000
NODE_90_length_6627_cov_9.440564	350	430	2	56	80	0.7000000
NODE_90_length_6627_cov_9.440564	403	483	0	77	80	0.9625000
NODE_90_length_6627_cov_9.440564	403	483	2	3	80	0.0375000
NODE_95_length_6507_cov_95.786049	171	247	0	73	76	0.9605263
NODE_95_length_6507_cov_95.786049	171	247	6	2	76	0.0263158
NODE_95_length_6507_cov_95.786049	171	247	38	1	76	0.0131579
NODE_96_length_6497_cov_2.677399	366	436	6	12	70	0.1714286
NODE_96_length_6497_cov_2.677399	366	436	8	29	70	0.4142857
NODE_96_length_6497_cov_2.677399	366	436	10	29	70	0.4142857
NODE_96_length_6497_cov_2.677399	409	444	4	7	35	0.2000000
NODE_96_length_6497_cov_2.677399	409	444	6	13	35	0.3714286
NODE_96_length_6497_cov_2.677399	409	444	8	15	35	0.4285714
NODE_97_length_6450_cov_26.108172	5024	5104	3	21	80	0.2625000
NODE_97_length_6450_cov_26.108172	5024	5104	5	19	80	0.2375000
NODE_97_length_6450_cov_26.108172	5024	5104	7	4	80	0.0500000
NODE_97_length_6450_cov_26.108172	5024	5104	9	12	80	0.1500000
NODE_97_length_6450_cov_26.108172	5024	5104	11	24	80	0.3000000
NODE_109_length_6171_cov_36.061100	3743	3813	6	4	70	0.0571429
NODE_109_length_6171_cov_36.061100	3743	3813	8	1	70	0.0142857
NODE_109_length_6171_cov_36.061100	3743	3813	10	1	70	0.0142857
NODE_109_length_6171_cov_36.061100	3743	3813	12	3	70	0.0428571
NODE_109_length_6171_cov_36.061100	3743	3813	14	2	70	0.0285714
NODE_109_length_6171_cov_36.061100	3743	3813	16	19	70	0.2714286
NODE_109_length_6171_cov_36.061100	3743	3813	18	4	70	0.0571429
NODE_109_length_6171_cov_36.061100	3743	3813	20	14	70	0.2000000
NODE_109_length_6171_cov_36.061100	3743	3813	21	7	70	0.1000000
NODE_109_length_6171_cov_36.061100	3743	3813	23	6	70	0.0857143
NODE_109_length_6171_cov_36.061100	3743	3813	25	8	70	0.1142857
NODE_109_length_6171_cov_36.061100	3743	3813	31	1	70	0.0142857
NODE_109_length_6171_cov_36.061100	3798	3851	22	4	53	0.0754717
NODE_109_length_6171_cov_36.061100	3798	3851	23	6	53	0.1132075
NODE_109_length_6171_cov_36.061100	3798	3851	24	1	53	0.0188679
NODE_109_length_6171_cov_36.061100	3798	3851	25	10	53	0.1886792
NODE_109_length_6171_cov_36.061100	3798	3851	26	5	53	0.0943396
NODE_109_length_6171_cov_36.061100	3798	3851	27	7	53	0.1320755
NODE_109_length_6171_cov_36.061100	3798	3851	28	3	53	0.0566038
NODE_109_length_6171_cov_36.061100	3798	3851	29	2	53	0.0377358
NODE_109_length_6171_cov_36.061100	3798	3851	31	10	53	0.1886792
NODE_109_length_6171_cov_36.061100	3798	3851	32	1	53	0.0188679
NODE_109_length_6171_cov_36.061100	3798	3851	33	4	53	0.0754717
NODE_109_length_6171_cov_36.061100	4552	4596	140	1	44	0.0227273
NODE_109_length_6171_cov_36.061100	4552	4596	142	2	44	0.0454545
NODE_109_length_6171_cov_36.061100	4552	4596	143	1	44	0.0227273
NODE_109_length_6171_cov_36.061100	4552	4596	146	2	44	0.0454545
NODE_109_length_6171_cov_36.061100	4552	4596	147	1	44	0.0227273
NODE_109_length_6171_cov_36.061100	4552	4596	148	4	44	0.0909091
NODE_109_length_6171_cov_36.061100	4552	4596	149	2	44	0.0454545
NODE_109_length_6171_cov_36.061100	4552	4596	150	1	44	0.0227273
NODE_109_length_6171_cov_36.061100	4552	4596	151	3	44	0.0681818
NODE_109_length_6171_cov_36.061100	4552	4596	152	4	44	0.0909091
NODE_109_length_6171_cov_36.061100	4552	4596	153	2	44	0.0454545
NODE_109_length_6171_cov_36.061100	4552	4596	154	1	44	0.0227273
NODE_109_length_6171_cov_36.061100	4552	4596	157	2	44	0.0454545
NODE_109_length_6171_cov_36.061100	4552	4596	160	1	44	0.0227273
NODE_109_length_6171_cov_36.061100	4552	4596	161	2	44	0.0454545
NODE_109_length_6171_cov_36.061100	4552	4596	162	1	44	0.0227273
NODE_109_length_6171_cov_36.061100	4552	4596	164	2	44	0.0454545
NODE_109_length_6171_cov_36.061100	4552	4596	168	3	44	0.0681818
NODE_109_length_6171_cov_36.061100	4552	4596	169	1	44	0.0227273
NODE_109_length_6171_cov_36.061100	4552	4596	171	3	44	0.0681818
NODE_109_length_6171_cov_36.061100	4552	4596	177	3	44	0.0681818
NODE_109_length_6171_cov_36.061100	4552	4596	178	1	44	0.0227273
NODE_109_length_6171_cov_36.061100	4552	4596	181	1	44	0.0227273
NODE_109_length_6171_cov_36.061100	4569	4649	146	2	80	0.0250000
NODE_109_length_6171_cov_36.061100	4569	4649	147	1	80	0.0125000
NODE_109_length_6171_cov_36.061100	4569	4649	148	4	80	0.0500000
NODE_109_length_6171_cov_36.061100	4569	4649	149	2	80	0.0250000
NODE_109_length_6171_cov_36.061100	4569	4649	150	1	80	0.0125000
NODE_109_length_6171_cov_36.061100	4569	4649	152	2	80	0.0250000
NODE_109_length_6171_cov_36.061100	4569	4649	154	1	80	0.0125000
NODE_109_length_6171_cov_36.061100	4569	4649	157	2	80	0.0250000
NODE_109_length_6171_cov_36.061100	4569	4649	161	2	80	0.0250000
NODE_109_length_6171_cov_36.061100	4569	4649	168	1	80	0.0125000
NODE_109_length_6171_cov_36.061100	4569	4649	169	1	80	0.0125000
NODE_109_length_6171_cov_36.061100	4569	4649	171	3	80	0.0375000
NODE_109_length_6171_cov_36.061100	4569	4649	177	3	80	0.0375000
NODE_109_length_6171_cov_36.061100	4569	4649	178	1	80	0.0125000
NODE_109_length_6171_cov_36.061100	4569	4649	181	2	80	0.0250000
NODE_109_length_6171_cov_36.061100	4569	4649	185	1	80	0.0125000
NODE_109_length_6171_cov_36.061100	4569	4649	187	3	80	0.0375000
NODE_109_length_6171_cov_36.061100	4569	4649	189	1	80	0.0125000
NODE_109_length_6171_cov_36.061100	4569	4649	191	4	80	0.0500000
NODE_109_length_6171_cov_36.061100	4569	4649	193	1	80	0.0125000
NODE_109_length_6171_cov_36.061100	4569	4649	195	1	80	0.0125000
NODE_109_length_6171_cov_36.061100	4569	4649	197	1	80	0.0125000
NODE_109_length_6171_cov_36.061100	4569	4649	202	1	80	0.0125000
NODE_109_length_6171_cov_36.061100	4569	4649	209	2	80	0.0250000
NODE_109_length_6171_cov_36.061100	4569	4649	211	1	80	0.0125000
NODE_109_length_6171_cov_36.061100	4569	4649	213	2	80	0.0250000
NODE_109_length_6171_cov_36.061100	4569	4649	216	3	80	0.0375000
NODE_109_length_6171_cov_36.061100	4569	4649	220	2	80	0.0250000
NODE_109_length_6171_cov_36.061100	4569	4649	222	3	80	0.0375000
NODE_109_length_6171_cov_36.061100	4569	4649	224	1	80	0.0125000
NODE_109_length_6171_cov_36.061100	4569	4649	231	2	80	0.0250000
NODE_109_length_6171_cov_36.061100	4569	4649	233	1	80	0.0125000
NODE_109_length_6171_cov_36.061100	4569	4649	237	2	80	0.0250000
NODE_109_length_6171_cov_36.061100	4569	4649	239	1	80	0.0125000
NODE_109_length_6171_cov_36.061100	4569	4649	241	2	80	0.0250000
NODE_109_length_6171_cov_36.061100	4569	4649	243	2	80	0.0250000
NODE_109_length_6171_cov_36.061100	4569	4649	244	1	80	0.0125000
NODE_109_length_6171_cov_36.061100	4569	4649	245	2	80	0.0250000
NODE_109_length_6171_cov_36.061100	4569	4649	246	1	80	0.0125000
NODE_109_length_6171_cov_36.061100	4569	4649	247	4	80	0.0500000
NODE_109_length_6171_cov_36.061100	4569	4649	248	1	80	0.0125000
NODE_109_length_6171_cov_36.061100	4569	4649	250	4	80	0.0500000
NODE_109_length_6171_cov_36.061100	4569	4649	251	2	80	0.0250000
NODE_109_length_6171_cov_36.061100	5742	5788	0	46	46	1.0000000
NODE_109_length_6171_cov_36.061100	5761	5841	0	80	80	1.0000000
NODE_110_length_6148_cov_58.915358	5602	5682	0	80	80	1.0000000
NODE_110_length_6148_cov_58.915358	5655	5735	0	80	80	1.0000000
NODE_112_length_6026_cov_17.775772	4124	4204	0	26	80	0.3250000
NODE_112_length_6026_cov_17.775772	4124	4204	2	23	80	0.2875000
NODE_112_length_6026_cov_17.775772	4124	4204	4	31	80	0.3875000
NODE_112_length_6026_cov_17.775772	4177	4257	2	16	80	0.2000000
NODE_112_length_6026_cov_17.775772	4177	4257	4	64	80	0.8000000
NODE_112_length_6026_cov_17.775772	4253	4333	2	31	80	0.3875000
NODE_112_length_6026_cov_17.775772	4253	4333	4	20	80	0.2500000
NODE_112_length_6026_cov_17.775772	4253	4333	6	17	80	0.2125000
NODE_112_length_6026_cov_17.775772	4253	4333	8	10	80	0.1250000
NODE_112_length_6026_cov_17.775772	4253	4333	14	2	80	0.0250000
NODE_112_length_6026_cov_17.775772	4306	4386	6	15	80	0.1875000
NODE_112_length_6026_cov_17.775772	4306	4386	8	10	80	0.1250000
NODE_112_length_6026_cov_17.775772	4306	4386	12	13	80	0.1625000
NODE_112_length_6026_cov_17.775772	4306	4386	14	17	80	0.2125000
NODE_112_length_6026_cov_17.775772	4306	4386	16	25	80	0.3125000
NODE_124_length_5810_cov_24.750657	2064	2144	0	7	80	0.0875000
NODE_124_length_5810_cov_24.750657	2064	2144	2	46	80	0.5750000
NODE_124_length_5810_cov_24.750657	2064	2144	6	1	80	0.0125000
NODE_124_length_5810_cov_24.750657	2064	2144	8	3	80	0.0375000
NODE_124_length_5810_cov_24.750657	2064	2144	10	2	80	0.0250000
NODE_124_length_5810_cov_24.750657	2064	2144	12	2	80	0.0250000
NODE_124_length_5810_cov_24.750657	2064	2144	14	1	80	0.0125000
NODE_124_length_5810_cov_24.750657	2064	2144	16	8	80	0.1000000
NODE_124_length_5810_cov_24.750657	2064	2144	18	5	80	0.0625000
NODE_124_length_5810_cov_24.750657	2064	2144	22	5	80	0.0625000
NODE_124_length_5810_cov_24.750657	2117	2194	2	77	77	1.0000000
NODE_127_length_5771_cov_10.854549	2814	2883	0	30	69	0.4347826
NODE_127_length_5771_cov_10.854549	2814	2883	2	39	69	0.5652174
NODE_128_length_5769_cov_6.878483	5701	5731	0	11	30	0.3666667
NODE_128_length_5769_cov_6.878483	5701	5731	2	19	30	0.6333333
NODE_133_length_5728_cov_16.351039	63	134	0	71	71	1.0000000
NODE_133_length_5728_cov_16.351039	2960	3040	4	42	80	0.5250000
NODE_133_length_5728_cov_16.351039	2960	3040	6	17	80	0.2125000
NODE_133_length_5728_cov_16.351039	2960	3040	8	21	80	0.2625000
NODE_133_length_5728_cov_16.351039	5106	5172	35	2	66	0.0303030
NODE_133_length_5728_cov_16.351039	5106	5172	37	9	66	0.1363636
NODE_133_length_5728_cov_16.351039	5106	5172	39	2	66	0.0303030
NODE_133_length_5728_cov_16.351039	5106	5172	40	2	66	0.0303030
NODE_133_length_5728_cov_16.351039	5106	5172	42	3	66	0.0454545
NODE_133_length_5728_cov_16.351039	5106	5172	44	4	66	0.0606061
NODE_133_length_5728_cov_16.351039	5106	5172	46	5	66	0.0757576
NODE_133_length_5728_cov_16.351039	5106	5172	47	2	66	0.0303030
NODE_133_length_5728_cov_16.351039	5106	5172	48	3	66	0.0454545
NODE_133_length_5728_cov_16.351039	5106	5172	50	3	66	0.0454545
NODE_133_length_5728_cov_16.351039	5106	5172	52	1	66	0.0151515
NODE_133_length_5728_cov_16.351039	5106	5172	54	1	66	0.0151515
NODE_133_length_5728_cov_16.351039	5106	5172	56	9	66	0.1363636
NODE_133_length_5728_cov_16.351039	5106	5172	58	3	66	0.0454545
NODE_133_length_5728_cov_16.351039	5106	5172	62	1	66	0.0151515
NODE_133_length_5728_cov_16.351039	5106	5172	66	1	66	0.0151515
NODE_133_length_5728_cov_16.351039	5106	5172	72	1	66	0.0151515
NODE_133_length_5728_cov_16.351039	5106	5172	74	1	66	0.0151515
NODE_133_length_5728_cov_16.351039	5106	5172	76	1	66	0.0151515
NODE_133_length_5728_cov_16.351039	5106	5172	80	2	66	0.0303030
NODE_133_length_5728_cov_16.351039	5106	5172	82	1	66	0.0151515
NODE_133_length_5728_cov_16.351039	5106	5172	84	2	66	0.0303030
NODE_133_length_5728_cov_16.351039	5106	5172	86	1	66	0.0151515
NODE_133_length_5728_cov_16.351039	5106	5172	88	2	66	0.0303030
NODE_133_length_5728_cov_16.351039	5106	5172	90	1	66	0.0151515
NODE_133_length_5728_cov_16.351039	5106	5172	92	1	66	0.0151515
NODE_133_length_5728_cov_16.351039	5106	5172	94	2	66	0.0303030
NODE_133_length_5728_cov_16.351039	5145	5225	56	7	80	0.0875000
NODE_133_length_5728_cov_16.351039	5145	5225	58	3	80	0.0375000
NODE_133_length_5728_cov_16.351039	5145	5225	62	1	80	0.0125000
NODE_133_length_5728_cov_16.351039	5145	5225	66	1	80	0.0125000
NODE_133_length_5728_cov_16.351039	5145	5225	72	1	80	0.0125000
NODE_133_length_5728_cov_16.351039	5145	5225	74	1	80	0.0125000
NODE_133_length_5728_cov_16.351039	5145	5225	76	1	80	0.0125000
NODE_133_length_5728_cov_16.351039	5145	5225	80	2	80	0.0250000
NODE_133_length_5728_cov_16.351039	5145	5225	82	1	80	0.0125000
NODE_133_length_5728_cov_16.351039	5145	5225	84	2	80	0.0250000
NODE_133_length_5728_cov_16.351039	5145	5225	86	1	80	0.0125000
NODE_133_length_5728_cov_16.351039	5145	5225	88	2	80	0.0250000
NODE_133_length_5728_cov_16.351039	5145	5225	90	1	80	0.0125000
NODE_133_length_5728_cov_16.351039	5145	5225	92	2	80	0.0250000
NODE_133_length_5728_cov_16.351039	5145	5225	94	3	80	0.0375000
NODE_133_length_5728_cov_16.351039	5145	5225	102	2	80	0.0250000
NODE_133_length_5728_cov_16.351039	5145	5225	103	5	80	0.0625000
NODE_133_length_5728_cov_16.351039	5145	5225	104	1	80	0.0125000
NODE_133_length_5728_cov_16.351039	5145	5225	106	2	80	0.0250000
NODE_133_length_5728_cov_16.351039	5145	5225	110	1	80	0.0125000
NODE_133_length_5728_cov_16.351039	5145	5225	117	3	80	0.0375000
NODE_133_length_5728_cov_16.351039	5145	5225	120	4	80	0.0500000
NODE_133_length_5728_cov_16.351039	5145	5225	121	2	80	0.0250000
NODE_133_length_5728_cov_16.351039	5145	5225	122	3	80	0.0375000
NODE_133_length_5728_cov_16.351039	5145	5225	124	3	80	0.0375000
NODE_133_length_5728_cov_16.351039	5145	5225	125	2	80	0.0250000
NODE_133_length_5728_cov_16.351039	5145	5225	127	4	80	0.0500000
NODE_133_length_5728_cov_16.351039	5145	5225	129	4	80	0.0500000
NODE_133_length_5728_cov_16.351039	5145	5225	130	1	80	0.0125000
NODE_133_length_5728_cov_16.351039	5145	5225	131	2	80	0.0250000
NODE_133_length_5728_cov_16.351039	5145	5225	132	3	80	0.0375000
NODE_133_length_5728_cov_16.351039	5145	5225	133	6	80	0.0750000
NODE_133_length_5728_cov_16.351039	5145	5225	135	3	80	0.0375000
NODE_137_length_5696_cov_20.656244	179	258	0	23	79	0.2911392
NODE_137_length_5696_cov_20.656244	179	258	1	8	79	0.1012658
NODE_137_length_5696_cov_20.656244	179	258	2	5	79	0.0632911
NODE_137_length_5696_cov_20.656244	179	258	4	43	79	0.5443038
NODE_137_length_5696_cov_20.656244	231	311	0	19	80	0.2375000
NODE_137_length_5696_cov_20.656244	231	311	1	9	80	0.1125000
NODE_137_length_5696_cov_20.656244	231	311	2	52	80	0.6500000
NODE_137_length_5696_cov_20.656244	307	387	0	14	80	0.1750000
NODE_137_length_5696_cov_20.656244	307	387	2	26	80	0.3250000
NODE_137_length_5696_cov_20.656244	307	387	4	8	80	0.1000000
NODE_137_length_5696_cov_20.656244	307	387	6	32	80	0.4000000
NODE_137_length_5696_cov_20.656244	360	440	2	12	80	0.1500000
NODE_137_length_5696_cov_20.656244	360	440	3	1	80	0.0125000
NODE_137_length_5696_cov_20.656244	360	440	4	2	80	0.0250000
NODE_137_length_5696_cov_20.656244	360	440	6	65	80	0.8125000
NODE_137_length_5696_cov_20.656244	5100	5180	0	80	80	1.0000000
NODE_137_length_5696_cov_20.656244	5153	5233	0	80	80	1.0000000
NODE_137_length_5696_cov_20.656244	5280	5360	0	80	80	1.0000000
NODE_137_length_5696_cov_20.656244	5333	5413	0	80	80	1.0000000
NODE_139_length_5681_cov_68.065030	253	333	2	15	80	0.1875000
NODE_139_length_5681_cov_68.065030	253	333	4	65	80	0.8125000
NODE_139_length_5681_cov_68.065030	306	386	0	13	80	0.1625000
NODE_139_length_5681_cov_68.065030	306	386	2	54	80	0.6750000
NODE_139_length_5681_cov_68.065030	306	386	4	13	80	0.1625000
NODE_139_length_5681_cov_68.065030	4762	4842	37	9	80	0.1125000
NODE_139_length_5681_cov_68.065030	4762	4842	38	3	80	0.0375000
NODE_139_length_5681_cov_68.065030	4762	4842	39	4	80	0.0500000
NODE_139_length_5681_cov_68.065030	4762	4842	40	1	80	0.0125000
NODE_139_length_5681_cov_68.065030	4762	4842	41	8	80	0.1000000
NODE_139_length_5681_cov_68.065030	4762	4842	43	2	80	0.0250000
NODE_139_length_5681_cov_68.065030	4762	4842	44	7	80	0.0875000
NODE_139_length_5681_cov_68.065030	4762	4842	46	5	80	0.0625000
NODE_139_length_5681_cov_68.065030	4762	4842	47	2	80	0.0250000
NODE_139_length_5681_cov_68.065030	4762	4842	50	5	80	0.0625000
NODE_139_length_5681_cov_68.065030	4762	4842	51	2	80	0.0250000
NODE_139_length_5681_cov_68.065030	4762	4842	52	2	80	0.0250000
NODE_139_length_5681_cov_68.065030	4762	4842	54	2	80	0.0250000
NODE_139_length_5681_cov_68.065030	4762	4842	55	6	80	0.0750000
NODE_139_length_5681_cov_68.065030	4762	4842	56	3	80	0.0375000
NODE_139_length_5681_cov_68.065030	4762	4842	57	3	80	0.0375000
NODE_139_length_5681_cov_68.065030	4762	4842	58	2	80	0.0250000
NODE_139_length_5681_cov_68.065030	4762	4842	59	14	80	0.1750000
NODE_139_length_5681_cov_68.065030	4762	4842	37	9	80	0.1125000
NODE_139_length_5681_cov_68.065030	4762	4842	38	3	80	0.0375000
NODE_139_length_5681_cov_68.065030	4762	4842	39	4	80	0.0500000
NODE_139_length_5681_cov_68.065030	4762	4842	40	1	80	0.0125000
NODE_139_length_5681_cov_68.065030	4762	4842	41	8	80	0.1000000
NODE_139_length_5681_cov_68.065030	4762	4842	43	2	80	0.0250000
NODE_139_length_5681_cov_68.065030	4762	4842	44	7	80	0.0875000
NODE_139_length_5681_cov_68.065030	4762	4842	46	5	80	0.0625000
NODE_139_length_5681_cov_68.065030	4762	4842	47	2	80	0.0250000
NODE_139_length_5681_cov_68.065030	4762	4842	50	5	80	0.0625000
NODE_139_length_5681_cov_68.065030	4762	4842	51	2	80	0.0250000
NODE_139_length_5681_cov_68.065030	4762	4842	52	2	80	0.0250000
NODE_139_length_5681_cov_68.065030	4762	4842	54	2	80	0.0250000
NODE_139_length_5681_cov_68.065030	4762	4842	55	6	80	0.0750000
NODE_139_length_5681_cov_68.065030	4762	4842	56	3	80	0.0375000
NODE_139_length_5681_cov_68.065030	4762	4842	57	3	80	0.0375000
NODE_139_length_5681_cov_68.065030	4762	4842	58	2	80	0.0250000
NODE_139_length_5681_cov_68.065030	4762	4842	59	14	80	0.1750000
NODE_139_length_5681_cov_68.065030	4762	4842	37	9	80	0.1125000
NODE_139_length_5681_cov_68.065030	4762	4842	38	3	80	0.0375000
NODE_139_length_5681_cov_68.065030	4762	4842	39	4	80	0.0500000
NODE_139_length_5681_cov_68.065030	4762	4842	40	1	80	0.0125000
NODE_139_length_5681_cov_68.065030	4762	4842	41	8	80	0.1000000
NODE_139_length_5681_cov_68.065030	4762	4842	43	2	80	0.0250000
NODE_139_length_5681_cov_68.065030	4762	4842	44	7	80	0.0875000
NODE_139_length_5681_cov_68.065030	4762	4842	46	5	80	0.0625000
NODE_139_length_5681_cov_68.065030	4762	4842	47	2	80	0.0250000
NODE_139_length_5681_cov_68.065030	4762	4842	50	5	80	0.0625000
NODE_139_length_5681_cov_68.065030	4762	4842	51	2	80	0.0250000
NODE_139_length_5681_cov_68.065030	4762	4842	52	2	80	0.0250000
NODE_139_length_5681_cov_68.065030	4762	4842	54	2	80	0.0250000
NODE_139_length_5681_cov_68.065030	4762	4842	55	6	80	0.0750000
NODE_139_length_5681_cov_68.065030	4762	4842	56	3	80	0.0375000
NODE_139_length_5681_cov_68.065030	4762	4842	57	3	80	0.0375000
NODE_139_length_5681_cov_68.065030	4762	4842	58	2	80	0.0250000
NODE_139_length_5681_cov_68.065030	4762	4842	59	14	80	0.1750000
NODE_139_length_5681_cov_68.065030	4762	4842	37	9	80	0.1125000
NODE_139_length_5681_cov_68.065030	4762	4842	38	3	80	0.0375000
NODE_139_length_5681_cov_68.065030	4762	4842	39	4	80	0.0500000
NODE_139_length_5681_cov_68.065030	4762	4842	40	1	80	0.0125000
NODE_139_length_5681_cov_68.065030	4762	4842	41	8	80	0.1000000
NODE_139_length_5681_cov_68.065030	4762	4842	43	2	80	0.0250000
NODE_139_length_5681_cov_68.065030	4762	4842	44	7	80	0.0875000
NODE_139_length_5681_cov_68.065030	4762	4842	46	5	80	0.0625000
NODE_139_length_5681_cov_68.065030	4762	4842	47	2	80	0.0250000
NODE_139_length_5681_cov_68.065030	4762	4842	50	5	80	0.0625000
NODE_139_length_5681_cov_68.065030	4762	4842	51	2	80	0.0250000
NODE_139_length_5681_cov_68.065030	4762	4842	52	2	80	0.0250000
NODE_139_length_5681_cov_68.065030	4762	4842	54	2	80	0.0250000
NODE_139_length_5681_cov_68.065030	4762	4842	55	6	80	0.0750000
NODE_139_length_5681_cov_68.065030	4762	4842	56	3	80	0.0375000
NODE_139_length_5681_cov_68.065030	4762	4842	57	3	80	0.0375000
NODE_139_length_5681_cov_68.065030	4762	4842	58	2	80	0.0250000
NODE_139_length_5681_cov_68.065030	4762	4842	59	14	80	0.1750000
NODE_139_length_5681_cov_68.065030	4762	4842	37	9	80	0.1125000
NODE_139_length_5681_cov_68.065030	4762	4842	38	3	80	0.0375000
NODE_139_length_5681_cov_68.065030	4762	4842	39	4	80	0.0500000
NODE_139_length_5681_cov_68.065030	4762	4842	40	1	80	0.0125000
NODE_139_length_5681_cov_68.065030	4762	4842	41	8	80	0.1000000
NODE_139_length_5681_cov_68.065030	4762	4842	43	2	80	0.0250000
NODE_139_length_5681_cov_68.065030	4762	4842	44	7	80	0.0875000
NODE_139_length_5681_cov_68.065030	4762	4842	46	5	80	0.0625000
NODE_139_length_5681_cov_68.065030	4762	4842	47	2	80	0.0250000
NODE_139_length_5681_cov_68.065030	4762	4842	50	5	80	0.0625000
NODE_139_length_5681_cov_68.065030	4762	4842	51	2	80	0.0250000
NODE_139_length_5681_cov_68.065030	4762	4842	52	2	80	0.0250000
NODE_139_length_5681_cov_68.065030	4762	4842	54	2	80	0.0250000
NODE_139_length_5681_cov_68.065030	4762	4842	55	6	80	0.0750000
NODE_139_length_5681_cov_68.065030	4762	4842	56	3	80	0.0375000
NODE_139_length_5681_cov_68.065030	4762	4842	57	3	80	0.0375000
NODE_139_length_5681_cov_68.065030	4762	4842	58	2	80	0.0250000
NODE_139_length_5681_cov_68.065030	4762	4842	59	14	80	0.1750000
NODE_139_length_5681_cov_68.065030	4762	4842	37	9	80	0.1125000
NODE_139_length_5681_cov_68.065030	4762	4842	38	3	80	0.0375000
NODE_139_length_5681_cov_68.065030	4762	4842	39	4	80	0.0500000
NODE_139_length_5681_cov_68.065030	4762	4842	40	1	80	0.0125000
NODE_139_length_5681_cov_68.065030	4762	4842	41	8	80	0.1000000
NODE_139_length_5681_cov_68.065030	4762	4842	43	2	80	0.0250000
NODE_139_length_5681_cov_68.065030	4762	4842	44	7	80	0.0875000
NODE_139_length_5681_cov_68.065030	4762	4842	46	5	80	0.0625000
NODE_139_length_5681_cov_68.065030	4762	4842	47	2	80	0.0250000
NODE_139_length_5681_cov_68.065030	4762	4842	50	5	80	0.0625000
NODE_139_length_5681_cov_68.065030	4762	4842	51	2	80	0.0250000
NODE_139_length_5681_cov_68.065030	4762	4842	52	2	80	0.0250000
NODE_139_length_5681_cov_68.065030	4762	4842	54	2	80	0.0250000
NODE_139_length_5681_cov_68.065030	4762	4842	55	6	80	0.0750000
NODE_139_length_5681_cov_68.065030	4762	4842	56	3	80	0.0375000
NODE_139_length_5681_cov_68.065030	4762	4842	57	3	80	0.0375000
NODE_139_length_5681_cov_68.065030	4762	4842	58	2	80	0.0250000
NODE_139_length_5681_cov_68.065030	4762	4842	59	14	80	0.1750000
NODE_139_length_5681_cov_68.065030	4769	4839	38	3	70	0.0428571
NODE_139_length_5681_cov_68.065030	4769	4839	39	3	70	0.0428571
NODE_139_length_5681_cov_68.065030	4769	4839	40	1	70	0.0142857
NODE_139_length_5681_cov_68.065030	4769	4839	41	8	70	0.1142857
NODE_139_length_5681_cov_68.065030	4769	4839	43	2	70	0.0285714
NODE_139_length_5681_cov_68.065030	4769	4839	44	7	70	0.1000000
NODE_139_length_5681_cov_68.065030	4769	4839	46	5	70	0.0714286
NODE_139_length_5681_cov_68.065030	4769	4839	47	2	70	0.0285714
NODE_139_length_5681_cov_68.065030	4769	4839	50	5	70	0.0714286
NODE_139_length_5681_cov_68.065030	4769	4839	51	2	70	0.0285714
NODE_139_length_5681_cov_68.065030	4769	4839	52	2	70	0.0285714
NODE_139_length_5681_cov_68.065030	4769	4839	54	2	70	0.0285714
NODE_139_length_5681_cov_68.065030	4769	4839	55	6	70	0.0857143
NODE_139_length_5681_cov_68.065030	4769	4839	56	3	70	0.0428571
NODE_139_length_5681_cov_68.065030	4769	4839	57	3	70	0.0428571
NODE_139_length_5681_cov_68.065030	4769	4839	58	2	70	0.0285714
NODE_139_length_5681_cov_68.065030	4769	4839	59	14	70	0.2000000
NODE_139_length_5681_cov_68.065030	4771	4842	37	3	71	0.0422535
NODE_139_length_5681_cov_68.065030	4771	4842	38	3	71	0.0422535
NODE_139_length_5681_cov_68.065030	4771	4842	39	1	71	0.0140845
NODE_139_length_5681_cov_68.065030	4771	4842	40	1	71	0.0140845
NODE_139_length_5681_cov_68.065030	4771	4842	41	8	71	0.1126761
NODE_139_length_5681_cov_68.065030	4771	4842	43	2	71	0.0281690
NODE_139_length_5681_cov_68.065030	4771	4842	44	7	71	0.0985916
NODE_139_length_5681_cov_68.065030	4771	4842	46	5	71	0.0704225
NODE_139_length_5681_cov_68.065030	4771	4842	47	2	71	0.0281690
NODE_139_length_5681_cov_68.065030	4771	4842	50	5	71	0.0704225
NODE_139_length_5681_cov_68.065030	4771	4842	51	2	71	0.0281690
NODE_139_length_5681_cov_68.065030	4771	4842	52	2	71	0.0281690
NODE_139_length_5681_cov_68.065030	4771	4842	54	2	71	0.0281690
NODE_139_length_5681_cov_68.065030	4771	4842	55	6	71	0.0845070
NODE_139_length_5681_cov_68.065030	4771	4842	56	3	71	0.0422535
NODE_139_length_5681_cov_68.065030	4771	4842	57	3	71	0.0422535
NODE_139_length_5681_cov_68.065030	4771	4842	58	2	71	0.0281690
NODE_139_length_5681_cov_68.065030	4771	4842	59	14	71	0.1971831
NODE_139_length_5681_cov_68.065030	4815	4895	34	16	80	0.2000000
NODE_139_length_5681_cov_68.065030	4815	4895	35	25	80	0.3125000
NODE_139_length_5681_cov_68.065030	4815	4895	37	15	80	0.1875000
NODE_139_length_5681_cov_68.065030	4815	4895	38	3	80	0.0375000
NODE_139_length_5681_cov_68.065030	4815	4895	40	1	80	0.0125000
NODE_139_length_5681_cov_68.065030	4815	4895	43	2	80	0.0250000
NODE_139_length_5681_cov_68.065030	4815	4895	44	7	80	0.0875000
NODE_139_length_5681_cov_68.065030	4815	4895	46	5	80	0.0625000
NODE_139_length_5681_cov_68.065030	4815	4895	47	2	80	0.0250000
NODE_139_length_5681_cov_68.065030	4815	4895	50	2	80	0.0250000
NODE_139_length_5681_cov_68.065030	4815	4895	51	2	80	0.0250000
NODE_139_length_5681_cov_68.065030	4815	4895	34	16	80	0.2000000
NODE_139_length_5681_cov_68.065030	4815	4895	35	25	80	0.3125000
NODE_139_length_5681_cov_68.065030	4815	4895	37	15	80	0.1875000
NODE_139_length_5681_cov_68.065030	4815	4895	38	3	80	0.0375000
NODE_139_length_5681_cov_68.065030	4815	4895	40	1	80	0.0125000
NODE_139_length_5681_cov_68.065030	4815	4895	43	2	80	0.0250000
NODE_139_length_5681_cov_68.065030	4815	4895	44	7	80	0.0875000
NODE_139_length_5681_cov_68.065030	4815	4895	46	5	80	0.0625000
NODE_139_length_5681_cov_68.065030	4815	4895	47	2	80	0.0250000
NODE_139_length_5681_cov_68.065030	4815	4895	50	2	80	0.0250000
NODE_139_length_5681_cov_68.065030	4815	4895	51	2	80	0.0250000
NODE_139_length_5681_cov_68.065030	4815	4895	34	16	80	0.2000000
NODE_139_length_5681_cov_68.065030	4815	4895	35	25	80	0.3125000
NODE_139_length_5681_cov_68.065030	4815	4895	37	15	80	0.1875000
NODE_139_length_5681_cov_68.065030	4815	4895	38	3	80	0.0375000
NODE_139_length_5681_cov_68.065030	4815	4895	40	1	80	0.0125000
NODE_139_length_5681_cov_68.065030	4815	4895	43	2	80	0.0250000
NODE_139_length_5681_cov_68.065030	4815	4895	44	7	80	0.0875000
NODE_139_length_5681_cov_68.065030	4815	4895	46	5	80	0.0625000
NODE_139_length_5681_cov_68.065030	4815	4895	47	2	80	0.0250000
NODE_139_length_5681_cov_68.065030	4815	4895	50	2	80	0.0250000
NODE_139_length_5681_cov_68.065030	4815	4895	51	2	80	0.0250000
NODE_139_length_5681_cov_68.065030	4815	4895	34	16	80	0.2000000
NODE_139_length_5681_cov_68.065030	4815	4895	35	25	80	0.3125000
NODE_139_length_5681_cov_68.065030	4815	4895	37	15	80	0.1875000
NODE_139_length_5681_cov_68.065030	4815	4895	38	3	80	0.0375000
NODE_139_length_5681_cov_68.065030	4815	4895	40	1	80	0.0125000
NODE_139_length_5681_cov_68.065030	4815	4895	43	2	80	0.0250000
NODE_139_length_5681_cov_68.065030	4815	4895	44	7	80	0.0875000
NODE_139_length_5681_cov_68.065030	4815	4895	46	5	80	0.0625000
NODE_139_length_5681_cov_68.065030	4815	4895	47	2	80	0.0250000
NODE_139_length_5681_cov_68.065030	4815	4895	50	2	80	0.0250000
NODE_139_length_5681_cov_68.065030	4815	4895	51	2	80	0.0250000
NODE_139_length_5681_cov_68.065030	4815	4895	34	16	80	0.2000000
NODE_139_length_5681_cov_68.065030	4815	4895	35	25	80	0.3125000
NODE_139_length_5681_cov_68.065030	4815	4895	37	15	80	0.1875000
NODE_139_length_5681_cov_68.065030	4815	4895	38	3	80	0.0375000
NODE_139_length_5681_cov_68.065030	4815	4895	40	1	80	0.0125000
NODE_139_length_5681_cov_68.065030	4815	4895	43	2	80	0.0250000
NODE_139_length_5681_cov_68.065030	4815	4895	44	7	80	0.0875000
NODE_139_length_5681_cov_68.065030	4815	4895	46	5	80	0.0625000
NODE_139_length_5681_cov_68.065030	4815	4895	47	2	80	0.0250000
NODE_139_length_5681_cov_68.065030	4815	4895	50	2	80	0.0250000
NODE_139_length_5681_cov_68.065030	4815	4895	51	2	80	0.0250000
NODE_139_length_5681_cov_68.065030	4815	4895	34	16	80	0.2000000
NODE_139_length_5681_cov_68.065030	4815	4895	35	25	80	0.3125000
NODE_139_length_5681_cov_68.065030	4815	4895	37	15	80	0.1875000
NODE_139_length_5681_cov_68.065030	4815	4895	38	3	80	0.0375000
NODE_139_length_5681_cov_68.065030	4815	4895	40	1	80	0.0125000
NODE_139_length_5681_cov_68.065030	4815	4895	43	2	80	0.0250000
NODE_139_length_5681_cov_68.065030	4815	4895	44	7	80	0.0875000
NODE_139_length_5681_cov_68.065030	4815	4895	46	5	80	0.0625000
NODE_139_length_5681_cov_68.065030	4815	4895	47	2	80	0.0250000
NODE_139_length_5681_cov_68.065030	4815	4895	50	2	80	0.0250000
NODE_139_length_5681_cov_68.065030	4815	4895	51	2	80	0.0250000
NODE_139_length_5681_cov_68.065030	4891	4971	2	41	80	0.5125000
NODE_139_length_5681_cov_68.065030	4891	4971	4	8	80	0.1000000
NODE_139_length_5681_cov_68.065030	4891	4971	6	1	80	0.0125000
NODE_139_length_5681_cov_68.065030	4891	4971	18	4	80	0.0500000
NODE_139_length_5681_cov_68.065030	4891	4971	20	2	80	0.0250000
NODE_139_length_5681_cov_68.065030	4891	4971	22	4	80	0.0500000
NODE_139_length_5681_cov_68.065030	4891	4971	30	5	80	0.0625000
NODE_139_length_5681_cov_68.065030	4891	4971	34	7	80	0.0875000
NODE_139_length_5681_cov_68.065030	4891	4971	36	8	80	0.1000000
NODE_139_length_5681_cov_68.065030	4944	5007	2	63	63	1.0000000
NODE_139_length_5681_cov_68.065030	4944	5024	0	13	80	0.1625000
NODE_139_length_5681_cov_68.065030	4944	5024	2	67	80	0.8375000
NODE_140_length_5677_cov_21.613482	1792	1863	52	1	71	0.0140845
NODE_140_length_5677_cov_21.613482	1792	1863	54	6	71	0.0845070
NODE_140_length_5677_cov_21.613482	1792	1863	55	8	71	0.1126761
NODE_140_length_5677_cov_21.613482	1792	1863	56	13	71	0.1830986
NODE_140_length_5677_cov_21.613482	1792	1863	57	15	71	0.2112676
NODE_140_length_5677_cov_21.613482	1792	1863	58	12	71	0.1690141
NODE_140_length_5677_cov_21.613482	1792	1863	59	4	71	0.0563380
NODE_140_length_5677_cov_21.613482	1792	1863	60	7	71	0.0985916
NODE_140_length_5677_cov_21.613482	1792	1863	61	2	71	0.0281690
NODE_140_length_5677_cov_21.613482	1792	1863	62	2	71	0.0281690
NODE_140_length_5677_cov_21.613482	1792	1863	68	1	71	0.0140845
NODE_140_length_5677_cov_21.613482	1845	1916	28	1	71	0.0140845
NODE_140_length_5677_cov_21.613482	1845	1916	30	6	71	0.0845070
NODE_140_length_5677_cov_21.613482	1845	1916	32	11	71	0.1549296
NODE_140_length_5677_cov_21.613482	1845	1916	34	7	71	0.0985916
NODE_140_length_5677_cov_21.613482	1845	1916	36	1	71	0.0140845
NODE_140_length_5677_cov_21.613482	1845	1916	40	3	71	0.0422535
NODE_140_length_5677_cov_21.613482	1845	1916	42	11	71	0.1549296
NODE_140_length_5677_cov_21.613482	1845	1916	44	4	71	0.0563380
NODE_140_length_5677_cov_21.613482	1845	1916	46	3	71	0.0422535
NODE_140_length_5677_cov_21.613482	1845	1916	48	3	71	0.0422535
NODE_140_length_5677_cov_21.613482	1845	1916	50	1	71	0.0140845
NODE_140_length_5677_cov_21.613482	1845	1916	52	3	71	0.0422535
NODE_140_length_5677_cov_21.613482	1845	1916	54	5	71	0.0704225
NODE_140_length_5677_cov_21.613482	1845	1916	56	5	71	0.0704225
NODE_140_length_5677_cov_21.613482	1845	1916	58	7	71	0.0985916
NODE_142_length_5631_cov_25.927332	96	176	10	9	80	0.1125000
NODE_142_length_5631_cov_25.927332	96	176	12	4	80	0.0500000
NODE_142_length_5631_cov_25.927332	96	176	14	9	80	0.1125000
NODE_142_length_5631_cov_25.927332	96	176	16	5	80	0.0625000
NODE_142_length_5631_cov_25.927332	96	176	18	14	80	0.1750000
NODE_142_length_5631_cov_25.927332	96	176	20	15	80	0.1875000
NODE_142_length_5631_cov_25.927332	96	176	22	24	80	0.3000000
NODE_142_length_5631_cov_25.927332	149	229	6	19	80	0.2375000
NODE_142_length_5631_cov_25.927332	149	229	8	17	80	0.2125000
NODE_142_length_5631_cov_25.927332	149	229	10	4	80	0.0500000
NODE_142_length_5631_cov_25.927332	149	229	12	2	80	0.0250000
NODE_142_length_5631_cov_25.927332	149	229	14	13	80	0.1625000
NODE_142_length_5631_cov_25.927332	149	229	18	9	80	0.1125000
NODE_142_length_5631_cov_25.927332	149	229	20	6	80	0.0750000
NODE_142_length_5631_cov_25.927332	149	229	22	10	80	0.1250000
NODE_146_length_5588_cov_40.961377	2793	2873	2	20	80	0.2500000
NODE_146_length_5588_cov_40.961377	2793	2873	4	33	80	0.4125000
NODE_146_length_5588_cov_40.961377	2793	2873	5	20	80	0.2500000
NODE_146_length_5588_cov_40.961377	2793	2873	6	7	80	0.0875000
NODE_146_length_5588_cov_40.961377	2846	2926	2	28	80	0.3500000
NODE_146_length_5588_cov_40.961377	2846	2926	3	12	80	0.1500000
NODE_146_length_5588_cov_40.961377	2846	2926	4	6	80	0.0750000
NODE_146_length_5588_cov_40.961377	2846	2926	5	20	80	0.2500000
NODE_146_length_5588_cov_40.961377	2846	2926	6	14	80	0.1750000
NODE_146_length_5588_cov_40.961377	2922	3002	1	6	80	0.0750000
NODE_146_length_5588_cov_40.961377	2922	3002	2	74	80	0.9250000
NODE_146_length_5588_cov_40.961377	2975	3055	0	17	80	0.2125000
NODE_146_length_5588_cov_40.961377	2975	3055	1	20	80	0.2500000
NODE_146_length_5588_cov_40.961377	2975	3055	2	36	80	0.4500000
NODE_146_length_5588_cov_40.961377	2975	3055	4	7	80	0.0875000
NODE_149_length_5578_cov_5.173389	331	411	0	19	80	0.2375000
NODE_149_length_5578_cov_5.173389	331	411	2	61	80	0.7625000
NODE_149_length_5578_cov_5.173389	388	464	0	25	76	0.3289474
NODE_149_length_5578_cov_5.173389	388	464	2	51	76	0.6710526
NODE_150_length_5572_cov_79.124246	1555	1627	5	12	72	0.1666667
NODE_150_length_5572_cov_79.124246	1555	1627	7	9	72	0.1250000
NODE_150_length_5572_cov_79.124246	1555	1627	8	9	72	0.1250000
NODE_150_length_5572_cov_79.124246	1555	1627	9	2	72	0.0277778
NODE_150_length_5572_cov_79.124246	1555	1627	11	4	72	0.0555556
NODE_150_length_5572_cov_79.124246	1555	1627	13	1	72	0.0138889
NODE_150_length_5572_cov_79.124246	1555	1627	14	3	72	0.0416667
NODE_150_length_5572_cov_79.124246	1555	1627	16	2	72	0.0277778
NODE_150_length_5572_cov_79.124246	1555	1627	18	6	72	0.0833333
NODE_150_length_5572_cov_79.124246	1555	1627	22	3	72	0.0416667
NODE_150_length_5572_cov_79.124246	1555	1627	24	1	72	0.0138889
NODE_150_length_5572_cov_79.124246	1555	1627	26	1	72	0.0138889
NODE_150_length_5572_cov_79.124246	1555	1627	28	1	72	0.0138889
NODE_150_length_5572_cov_79.124246	1555	1627	34	4	72	0.0555556
NODE_150_length_5572_cov_79.124246	1555	1627	35	2	72	0.0277778
NODE_150_length_5572_cov_79.124246	1555	1627	37	1	72	0.0138889
NODE_150_length_5572_cov_79.124246	1555	1627	38	8	72	0.1111111
NODE_150_length_5572_cov_79.124246	1555	1627	44	3	72	0.0416667
NODE_150_length_5572_cov_79.124246	1603	1680	22	3	77	0.0389610
NODE_150_length_5572_cov_79.124246	1603	1680	24	1	77	0.0129870
NODE_150_length_5572_cov_79.124246	1603	1680	26	1	77	0.0129870
NODE_150_length_5572_cov_79.124246	1603	1680	28	1	77	0.0129870
NODE_150_length_5572_cov_79.124246	1603	1680	34	4	77	0.0519481
NODE_150_length_5572_cov_79.124246	1603	1680	35	2	77	0.0259740
NODE_150_length_5572_cov_79.124246	1603	1680	37	1	77	0.0129870
NODE_150_length_5572_cov_79.124246	1603	1680	38	8	77	0.1038961
NODE_150_length_5572_cov_79.124246	1603	1680	44	6	77	0.0779221
NODE_150_length_5572_cov_79.124246	1603	1680	48	1	77	0.0129870
NODE_150_length_5572_cov_79.124246	1603	1680	50	1	77	0.0129870
NODE_150_length_5572_cov_79.124246	1603	1680	62	2	77	0.0259740
NODE_150_length_5572_cov_79.124246	1603	1680	64	1	77	0.0129870
NODE_150_length_5572_cov_79.124246	1603	1680	65	1	77	0.0129870
NODE_150_length_5572_cov_79.124246	1603	1680	66	1	77	0.0129870
NODE_150_length_5572_cov_79.124246	1603	1680	67	1	77	0.0129870
NODE_150_length_5572_cov_79.124246	1603	1680	69	1	77	0.0129870
NODE_150_length_5572_cov_79.124246	1603	1680	71	2	77	0.0259740
NODE_150_length_5572_cov_79.124246	1603	1680	75	1	77	0.0129870
NODE_150_length_5572_cov_79.124246	1603	1680	80	1	77	0.0129870
NODE_150_length_5572_cov_79.124246	1603	1680	94	1	77	0.0129870
NODE_150_length_5572_cov_79.124246	1603	1680	104	1	77	0.0129870
NODE_150_length_5572_cov_79.124246	1603	1680	122	1	77	0.0129870
NODE_150_length_5572_cov_79.124246	1603	1680	128	1	77	0.0129870
NODE_150_length_5572_cov_79.124246	1603	1680	134	3	77	0.0389610
NODE_150_length_5572_cov_79.124246	1603	1680	142	1	77	0.0129870
NODE_150_length_5572_cov_79.124246	1603	1680	144	1	77	0.0129870
NODE_150_length_5572_cov_79.124246	1603	1680	150	1	77	0.0129870
NODE_150_length_5572_cov_79.124246	1603	1680	152	1	77	0.0129870
NODE_150_length_5572_cov_79.124246	1603	1680	162	1	77	0.0129870
NODE_150_length_5572_cov_79.124246	1603	1680	179	1	77	0.0129870
NODE_150_length_5572_cov_79.124246	1603	1680	182	1	77	0.0129870
NODE_150_length_5572_cov_79.124246	1603	1680	184	1	77	0.0129870
NODE_150_length_5572_cov_79.124246	1603	1680	185	2	77	0.0259740
NODE_150_length_5572_cov_79.124246	1603	1680	193	1	77	0.0129870
NODE_150_length_5572_cov_79.124246	1603	1680	195	1	77	0.0129870
NODE_150_length_5572_cov_79.124246	1603	1680	207	1	77	0.0129870
NODE_150_length_5572_cov_79.124246	1603	1680	214	1	77	0.0129870
NODE_150_length_5572_cov_79.124246	1603	1680	216	2	77	0.0259740
NODE_150_length_5572_cov_79.124246	1603	1680	218	1	77	0.0129870
NODE_150_length_5572_cov_79.124246	1603	1680	219	3	77	0.0389610
NODE_150_length_5572_cov_79.124246	1603	1680	221	1	77	0.0129870
NODE_150_length_5572_cov_79.124246	1603	1680	223	1	77	0.0129870
NODE_150_length_5572_cov_79.124246	1603	1680	225	1	77	0.0129870
NODE_150_length_5572_cov_79.124246	1603	1680	228	1	77	0.0129870
NODE_150_length_5572_cov_79.124246	1603	1680	240	1	77	0.0129870
NODE_150_length_5572_cov_79.124246	1603	1680	244	1	77	0.0129870
NODE_150_length_5572_cov_79.124246	1603	1680	251	1	77	0.0129870
NODE_150_length_5572_cov_79.124246	1603	1680	260	1	77	0.0129870
NODE_150_length_5572_cov_79.124246	1603	1680	264	1	77	0.0129870
NODE_150_length_5572_cov_79.124246	1603	1680	267	1	77	0.0129870
NODE_150_length_5572_cov_79.124246	1637	1717	67	1	80	0.0125000
NODE_150_length_5572_cov_79.124246	1637	1717	69	1	80	0.0125000
NODE_150_length_5572_cov_79.124246	1637	1717	71	2	80	0.0250000
NODE_150_length_5572_cov_79.124246	1637	1717	75	1	80	0.0125000
NODE_150_length_5572_cov_79.124246	1637	1717	80	1	80	0.0125000
NODE_150_length_5572_cov_79.124246	1637	1717	94	1	80	0.0125000
NODE_150_length_5572_cov_79.124246	1637	1717	104	1	80	0.0125000
NODE_150_length_5572_cov_79.124246	1637	1717	122	1	80	0.0125000
NODE_150_length_5572_cov_79.124246	1637	1717	128	1	80	0.0125000
NODE_150_length_5572_cov_79.124246	1637	1717	134	3	80	0.0375000
NODE_150_length_5572_cov_79.124246	1637	1717	142	1	80	0.0125000
NODE_150_length_5572_cov_79.124246	1637	1717	144	1	80	0.0125000
NODE_150_length_5572_cov_79.124246	1637	1717	150	1	80	0.0125000
NODE_150_length_5572_cov_79.124246	1637	1717	152	1	80	0.0125000
NODE_150_length_5572_cov_79.124246	1637	1717	162	1	80	0.0125000
NODE_150_length_5572_cov_79.124246	1637	1717	179	1	80	0.0125000
NODE_150_length_5572_cov_79.124246	1637	1717	182	1	80	0.0125000
NODE_150_length_5572_cov_79.124246	1637	1717	184	1	80	0.0125000
NODE_150_length_5572_cov_79.124246	1637	1717	185	2	80	0.0250000
NODE_150_length_5572_cov_79.124246	1637	1717	193	1	80	0.0125000
NODE_150_length_5572_cov_79.124246	1637	1717	195	1	80	0.0125000
NODE_150_length_5572_cov_79.124246	1637	1717	207	1	80	0.0125000
NODE_150_length_5572_cov_79.124246	1637	1717	214	1	80	0.0125000
NODE_150_length_5572_cov_79.124246	1637	1717	216	2	80	0.0250000
NODE_150_length_5572_cov_79.124246	1637	1717	218	1	80	0.0125000
NODE_150_length_5572_cov_79.124246	1637	1717	219	3	80	0.0375000
NODE_150_length_5572_cov_79.124246	1637	1717	221	1	80	0.0125000
NODE_150_length_5572_cov_79.124246	1637	1717	223	1	80	0.0125000
NODE_150_length_5572_cov_79.124246	1637	1717	225	1	80	0.0125000
NODE_150_length_5572_cov_79.124246	1637	1717	228	1	80	0.0125000
NODE_150_length_5572_cov_79.124246	1637	1717	240	1	80	0.0125000
NODE_150_length_5572_cov_79.124246	1637	1717	244	1	80	0.0125000
NODE_150_length_5572_cov_79.124246	1637	1717	251	1	80	0.0125000
NODE_150_length_5572_cov_79.124246	1637	1717	260	1	80	0.0125000
NODE_150_length_5572_cov_79.124246	1637	1717	264	1	80	0.0125000
NODE_150_length_5572_cov_79.124246	1637	1717	267	1	80	0.0125000
NODE_150_length_5572_cov_79.124246	1637	1717	269	2	80	0.0250000
NODE_150_length_5572_cov_79.124246	1637	1717	275	1	80	0.0125000
NODE_150_length_5572_cov_79.124246	1637	1717	294	1	80	0.0125000
NODE_150_length_5572_cov_79.124246	1637	1717	295	2	80	0.0250000
NODE_150_length_5572_cov_79.124246	1637	1717	300	1	80	0.0125000
NODE_150_length_5572_cov_79.124246	1637	1717	305	1	80	0.0125000
NODE_150_length_5572_cov_79.124246	1637	1717	319	1	80	0.0125000
NODE_150_length_5572_cov_79.124246	1637	1717	321	1	80	0.0125000
NODE_150_length_5572_cov_79.124246	1637	1717	326	1	80	0.0125000
NODE_150_length_5572_cov_79.124246	1637	1717	328	1	80	0.0125000
NODE_150_length_5572_cov_79.124246	1637	1717	336	1	80	0.0125000
NODE_150_length_5572_cov_79.124246	1637	1717	339	1	80	0.0125000
NODE_150_length_5572_cov_79.124246	1637	1717	343	1	80	0.0125000
NODE_150_length_5572_cov_79.124246	1637	1717	348	1	80	0.0125000
NODE_150_length_5572_cov_79.124246	1637	1717	359	1	80	0.0125000
NODE_150_length_5572_cov_79.124246	1637	1717	367	1	80	0.0125000
NODE_150_length_5572_cov_79.124246	1637	1717	377	2	80	0.0250000
NODE_150_length_5572_cov_79.124246	1637	1717	381	2	80	0.0250000
NODE_150_length_5572_cov_79.124246	1637	1717	382	1	80	0.0125000
NODE_150_length_5572_cov_79.124246	1637	1717	384	1	80	0.0125000
NODE_150_length_5572_cov_79.124246	1637	1717	386	4	80	0.0500000
NODE_150_length_5572_cov_79.124246	1637	1717	387	1	80	0.0125000
NODE_150_length_5572_cov_79.124246	1637	1717	388	1	80	0.0125000
NODE_150_length_5572_cov_79.124246	1637	1717	390	2	80	0.0250000
NODE_150_length_5572_cov_79.124246	1637	1717	396	2	80	0.0250000
NODE_150_length_5572_cov_79.124246	1637	1717	402	2	80	0.0250000
NODE_150_length_5572_cov_79.124246	1637	1717	404	1	80	0.0125000
NODE_150_length_5572_cov_79.124246	1690	1770	263	1	80	0.0125000
NODE_150_length_5572_cov_79.124246	1690	1770	273	1	80	0.0125000
NODE_150_length_5572_cov_79.124246	1690	1770	279	1	80	0.0125000
NODE_150_length_5572_cov_79.124246	1690	1770	291	1	80	0.0125000
NODE_150_length_5572_cov_79.124246	1690	1770	297	1	80	0.0125000
NODE_150_length_5572_cov_79.124246	1690	1770	300	1	80	0.0125000
NODE_150_length_5572_cov_79.124246	1690	1770	302	1	80	0.0125000
NODE_150_length_5572_cov_79.124246	1690	1770	310	1	80	0.0125000
NODE_150_length_5572_cov_79.124246	1690	1770	314	1	80	0.0125000
NODE_150_length_5572_cov_79.124246	1690	1770	316	1	80	0.0125000
NODE_150_length_5572_cov_79.124246	1690	1770	324	1	80	0.0125000
NODE_150_length_5572_cov_79.124246	1690	1770	326	1	80	0.0125000
NODE_150_length_5572_cov_79.124246	1690	1770	328	2	80	0.0250000
NODE_150_length_5572_cov_79.124246	1690	1770	336	1	80	0.0125000
NODE_150_length_5572_cov_79.124246	1690	1770	338	1	80	0.0125000
NODE_150_length_5572_cov_79.124246	1690	1770	339	1	80	0.0125000
NODE_150_length_5572_cov_79.124246	1690	1770	343	1	80	0.0125000
NODE_150_length_5572_cov_79.124246	1690	1770	347	1	80	0.0125000
NODE_150_length_5572_cov_79.124246	1690	1770	348	1	80	0.0125000
NODE_150_length_5572_cov_79.124246	1690	1770	350	1	80	0.0125000
NODE_150_length_5572_cov_79.124246	1690	1770	352	2	80	0.0250000
NODE_150_length_5572_cov_79.124246	1690	1770	354	1	80	0.0125000
NODE_150_length_5572_cov_79.124246	1690	1770	359	1	80	0.0125000
NODE_150_length_5572_cov_79.124246	1690	1770	361	3	80	0.0375000
NODE_150_length_5572_cov_79.124246	1690	1770	363	1	80	0.0125000
NODE_150_length_5572_cov_79.124246	1690	1770	365	1	80	0.0125000
NODE_150_length_5572_cov_79.124246	1690	1770	367	1	80	0.0125000
NODE_150_length_5572_cov_79.124246	1690	1770	369	2	80	0.0250000
NODE_150_length_5572_cov_79.124246	1690	1770	370	1	80	0.0125000
NODE_150_length_5572_cov_79.124246	1690	1770	377	3	80	0.0375000
NODE_150_length_5572_cov_79.124246	1690	1770	381	3	80	0.0375000
NODE_150_length_5572_cov_79.124246	1690	1770	382	1	80	0.0125000
NODE_150_length_5572_cov_79.124246	1690	1770	384	2	80	0.0250000
NODE_150_length_5572_cov_79.124246	1690	1770	386	7	80	0.0875000
NODE_150_length_5572_cov_79.124246	1690	1770	387	2	80	0.0250000
NODE_150_length_5572_cov_79.124246	1690	1770	388	1	80	0.0125000
NODE_150_length_5572_cov_79.124246	1690	1770	390	2	80	0.0250000
NODE_150_length_5572_cov_79.124246	1690	1770	391	2	80	0.0250000
NODE_150_length_5572_cov_79.124246	1690	1770	392	2	80	0.0250000
NODE_150_length_5572_cov_79.124246	1690	1770	396	2	80	0.0250000
NODE_150_length_5572_cov_79.124246	1690	1770	400	3	80	0.0375000
NODE_150_length_5572_cov_79.124246	1690	1770	402	2	80	0.0250000
NODE_150_length_5572_cov_79.124246	1690	1770	404	2	80	0.0250000
NODE_150_length_5572_cov_79.124246	1690	1770	406	2	80	0.0250000
NODE_150_length_5572_cov_79.124246	1690	1770	408	6	80	0.0750000
NODE_150_length_5572_cov_79.124246	1690	1770	410	4	80	0.0500000
NODE_150_length_5572_cov_79.124246	5130	5210	0	35	80	0.4375000
NODE_150_length_5572_cov_79.124246	5130	5210	2	45	80	0.5625000
NODE_150_length_5572_cov_79.124246	5183	5263	0	80	80	1.0000000
NODE_151_length_5557_cov_26.198241	341	414	0	73	73	1.0000000
NODE_151_length_5557_cov_26.198241	394	460	0	66	66	1.0000000
NODE_156_length_5500_cov_35.832438	81	161	0	5	80	0.0625000
NODE_156_length_5500_cov_35.832438	81	161	2	75	80	0.9375000
NODE_156_length_5500_cov_35.832438	134	214	0	29	80	0.3625000
NODE_156_length_5500_cov_35.832438	134	214	2	51	80	0.6375000
NODE_159_length_5470_cov_5.987526	5180	5249	4	24	69	0.3478261
NODE_159_length_5470_cov_5.987526	5180	5249	6	7	69	0.1014493
NODE_159_length_5470_cov_5.987526	5180	5249	7	24	69	0.3478261
NODE_159_length_5470_cov_5.987526	5180	5249	8	14	69	0.2028985
NODE_160_length_5434_cov_14.997751	541	621	0	68	80	0.8500000
NODE_160_length_5434_cov_14.997751	541	621	2	4	80	0.0500000
NODE_160_length_5434_cov_14.997751	541	621	4	8	80	0.1000000
NODE_160_length_5434_cov_14.997751	594	674	0	15	80	0.1875000
NODE_160_length_5434_cov_14.997751	594	674	2	4	80	0.0500000
NODE_160_length_5434_cov_14.997751	594	674	4	61	80	0.7625000
NODE_160_length_5434_cov_14.997751	2664	2744	0	29	80	0.3625000
NODE_160_length_5434_cov_14.997751	2664	2744	4	51	80	0.6375000
NODE_160_length_5434_cov_14.997751	2717	2797	0	80	80	1.0000000
NODE_160_length_5434_cov_14.997751	3041	3093	0	52	52	1.0000000
NODE_160_length_5434_cov_14.997751	3419	3467	12	3	48	0.0625000
NODE_160_length_5434_cov_14.997751	3419	3467	14	34	48	0.7083333
NODE_160_length_5434_cov_14.997751	3419	3467	16	9	48	0.1875000
NODE_160_length_5434_cov_14.997751	3419	3467	18	2	48	0.0416667
NODE_161_length_5425_cov_15.812242	141	218	10	1	77	0.0129870
NODE_161_length_5425_cov_15.812242	141	218	14	1	77	0.0129870
NODE_161_length_5425_cov_15.812242	141	218	16	8	77	0.1038961
NODE_161_length_5425_cov_15.812242	141	218	17	6	77	0.0779221
NODE_161_length_5425_cov_15.812242	141	218	19	2	77	0.0259740
NODE_161_length_5425_cov_15.812242	141	218	21	1	77	0.0129870
NODE_161_length_5425_cov_15.812242	141	218	23	9	77	0.1168831
NODE_161_length_5425_cov_15.812242	141	218	25	29	77	0.3766234
NODE_161_length_5425_cov_15.812242	141	218	27	2	77	0.0259740
NODE_161_length_5425_cov_15.812242	141	218	29	1	77	0.0129870
NODE_161_length_5425_cov_15.812242	141	218	31	3	77	0.0389610
NODE_161_length_5425_cov_15.812242	141	218	33	1	77	0.0129870
NODE_161_length_5425_cov_15.812242	141	218	34	2	77	0.0259740
NODE_161_length_5425_cov_15.812242	141	218	35	2	77	0.0259740
NODE_161_length_5425_cov_15.812242	141	218	36	1	77	0.0129870
NODE_161_length_5425_cov_15.812242	141	218	37	1	77	0.0129870
NODE_161_length_5425_cov_15.812242	141	218	38	1	77	0.0129870
NODE_161_length_5425_cov_15.812242	141	218	39	6	77	0.0779221
NODE_161_length_5425_cov_15.812242	841	921	0	10	80	0.1250000
NODE_161_length_5425_cov_15.812242	841	921	2	23	80	0.2875000
NODE_161_length_5425_cov_15.812242	841	921	4	47	80	0.5875000
NODE_161_length_5425_cov_15.812242	894	974	0	63	80	0.7875000
NODE_161_length_5425_cov_15.812242	894	974	2	17	80	0.2125000
NODE_163_length_5402_cov_5.397322	191	263	2	5	72	0.0694444
NODE_163_length_5402_cov_5.397322	191	263	4	67	72	0.9305556
NODE_163_length_5402_cov_5.397322	2305	2385	33	2	80	0.0250000
NODE_163_length_5402_cov_5.397322	2305	2385	37	1	80	0.0125000
NODE_163_length_5402_cov_5.397322	2305	2385	39	4	80	0.0500000
NODE_163_length_5402_cov_5.397322	2305	2385	41	4	80	0.0500000
NODE_163_length_5402_cov_5.397322	2305	2385	42	5	80	0.0625000
NODE_163_length_5402_cov_5.397322	2305	2385	43	18	80	0.2250000
NODE_163_length_5402_cov_5.397322	2305	2385	44	15	80	0.1875000
NODE_163_length_5402_cov_5.397322	2305	2385	46	6	80	0.0750000
NODE_163_length_5402_cov_5.397322	2305	2385	48	17	80	0.2125000
NODE_163_length_5402_cov_5.397322	2305	2385	50	8	80	0.1000000
NODE_163_length_5402_cov_5.397322	2358	2438	13	1	80	0.0125000
NODE_163_length_5402_cov_5.397322	2358	2438	15	9	80	0.1125000
NODE_163_length_5402_cov_5.397322	2358	2438	16	2	80	0.0250000
NODE_163_length_5402_cov_5.397322	2358	2438	17	2	80	0.0250000
NODE_163_length_5402_cov_5.397322	2358	2438	18	2	80	0.0250000
NODE_163_length_5402_cov_5.397322	2358	2438	20	5	80	0.0625000
NODE_163_length_5402_cov_5.397322	2358	2438	22	1	80	0.0125000
NODE_163_length_5402_cov_5.397322	2358	2438	24	3	80	0.0375000
NODE_163_length_5402_cov_5.397322	2358	2438	30	1	80	0.0125000
NODE_163_length_5402_cov_5.397322	2358	2438	32	5	80	0.0625000
NODE_163_length_5402_cov_5.397322	2358	2438	34	12	80	0.1500000
NODE_163_length_5402_cov_5.397322	2358	2438	36	5	80	0.0625000
NODE_163_length_5402_cov_5.397322	2358	2438	38	5	80	0.0625000
NODE_163_length_5402_cov_5.397322	2358	2438	42	5	80	0.0625000
NODE_163_length_5402_cov_5.397322	2358	2438	44	6	80	0.0750000
NODE_163_length_5402_cov_5.397322	2358	2438	46	5	80	0.0625000
NODE_163_length_5402_cov_5.397322	2358	2438	48	11	80	0.1375000
NODE_164_length_5383_cov_15.680545	205	285	0	16	80	0.2000000
NODE_164_length_5383_cov_15.680545	205	285	2	5	80	0.0625000
NODE_164_length_5383_cov_15.680545	205	285	4	40	80	0.5000000
NODE_164_length_5383_cov_15.680545	205	285	5	1	80	0.0125000
NODE_164_length_5383_cov_15.680545	205	285	6	18	80	0.2250000
NODE_164_length_5383_cov_15.680545	258	317	0	48	59	0.8135593
NODE_164_length_5383_cov_15.680545	258	317	2	5	59	0.0847458
NODE_164_length_5383_cov_15.680545	258	317	4	6	59	0.1016949
NODE_164_length_5383_cov_15.680545	2042	2122	10	8	80	0.1000000
NODE_164_length_5383_cov_15.680545	2042	2122	11	2	80	0.0250000
NODE_164_length_5383_cov_15.680545	2042	2122	12	14	80	0.1750000
NODE_164_length_5383_cov_15.680545	2042	2122	13	1	80	0.0125000
NODE_164_length_5383_cov_15.680545	2042	2122	14	40	80	0.5000000
NODE_164_length_5383_cov_15.680545	2042	2122	16	13	80	0.1625000
NODE_164_length_5383_cov_15.680545	2042	2122	18	2	80	0.0250000
NODE_164_length_5383_cov_15.680545	2095	2175	2	18	80	0.2250000
NODE_164_length_5383_cov_15.680545	2095	2175	4	9	80	0.1125000
NODE_164_length_5383_cov_15.680545	2095	2175	6	11	80	0.1375000
NODE_164_length_5383_cov_15.680545	2095	2175	8	11	80	0.1375000
NODE_164_length_5383_cov_15.680545	2095	2175	10	12	80	0.1500000
NODE_164_length_5383_cov_15.680545	2095	2175	12	14	80	0.1750000
NODE_164_length_5383_cov_15.680545	2095	2175	14	5	80	0.0625000
NODE_165_length_5382_cov_16.894378	1301	1347	18	5	46	0.1086956
NODE_165_length_5382_cov_16.894378	1301	1347	19	8	46	0.1739130
NODE_165_length_5382_cov_16.894378	1301	1347	20	16	46	0.3478261
NODE_165_length_5382_cov_16.894378	1301	1347	22	2	46	0.0434783
NODE_165_length_5382_cov_16.894378	1301	1347	23	8	46	0.1739130
NODE_165_length_5382_cov_16.894378	1301	1347	25	7	46	0.1521739
NODE_165_length_5382_cov_16.894378	5056	5082	26	1	26	0.0384615
NODE_165_length_5382_cov_16.894378	5056	5082	28	2	26	0.0769231
NODE_165_length_5382_cov_16.894378	5056	5082	30	1	26	0.0384615
NODE_165_length_5382_cov_16.894378	5056	5082	38	1	26	0.0384615
NODE_165_length_5382_cov_16.894378	5056	5082	40	5	26	0.1923077
NODE_165_length_5382_cov_16.894378	5056	5082	42	2	26	0.0769231
NODE_165_length_5382_cov_16.894378	5056	5082	44	2	26	0.0769231
NODE_165_length_5382_cov_16.894378	5056	5082	48	1	26	0.0384615
NODE_165_length_5382_cov_16.894378	5056	5082	50	1	26	0.0384615
NODE_165_length_5382_cov_16.894378	5056	5082	53	1	26	0.0384615
NODE_165_length_5382_cov_16.894378	5056	5082	55	1	26	0.0384615
NODE_165_length_5382_cov_16.894378	5056	5082	61	2	26	0.0769231
NODE_165_length_5382_cov_16.894378	5056	5082	63	1	26	0.0384615
NODE_165_length_5382_cov_16.894378	5056	5082	71	1	26	0.0384615
NODE_165_length_5382_cov_16.894378	5056	5082	75	1	26	0.0384615
NODE_165_length_5382_cov_16.894378	5056	5082	77	3	26	0.1153846
NODE_165_length_5382_cov_16.894378	5056	5115	26	1	59	0.0169492
NODE_165_length_5382_cov_16.894378	5056	5115	28	2	59	0.0338983
NODE_165_length_5382_cov_16.894378	5056	5115	30	1	59	0.0169492
NODE_165_length_5382_cov_16.894378	5056	5115	38	1	59	0.0169492
NODE_165_length_5382_cov_16.894378	5056	5115	40	5	59	0.0847458
NODE_165_length_5382_cov_16.894378	5056	5115	42	2	59	0.0338983
NODE_165_length_5382_cov_16.894378	5056	5115	44	2	59	0.0338983
NODE_165_length_5382_cov_16.894378	5056	5115	48	1	59	0.0169492
NODE_165_length_5382_cov_16.894378	5056	5115	50	1	59	0.0169492
NODE_165_length_5382_cov_16.894378	5056	5115	53	1	59	0.0169492
NODE_165_length_5382_cov_16.894378	5056	5115	55	1	59	0.0169492
NODE_165_length_5382_cov_16.894378	5056	5115	61	2	59	0.0338983
NODE_165_length_5382_cov_16.894378	5056	5115	63	1	59	0.0169492
NODE_165_length_5382_cov_16.894378	5056	5115	71	1	59	0.0169492
NODE_165_length_5382_cov_16.894378	5056	5115	75	1	59	0.0169492
NODE_165_length_5382_cov_16.894378	5056	5115	77	4	59	0.0677966
NODE_165_length_5382_cov_16.894378	5056	5115	79	3	59	0.0508475
NODE_165_length_5382_cov_16.894378	5056	5115	81	1	59	0.0169492
NODE_165_length_5382_cov_16.894378	5056	5115	83	2	59	0.0338983
NODE_165_length_5382_cov_16.894378	5056	5115	87	1	59	0.0169492
NODE_165_length_5382_cov_16.894378	5056	5115	89	4	59	0.0677966
NODE_165_length_5382_cov_16.894378	5056	5115	91	1	59	0.0169492
NODE_165_length_5382_cov_16.894378	5056	5115	93	4	59	0.0677966
NODE_165_length_5382_cov_16.894378	5056	5115	95	2	59	0.0338983
NODE_165_length_5382_cov_16.894378	5056	5115	97	1	59	0.0169492
NODE_165_length_5382_cov_16.894378	5056	5115	101	3	59	0.0508475
NODE_165_length_5382_cov_16.894378	5056	5115	103	2	59	0.0338983
NODE_165_length_5382_cov_16.894378	5056	5115	113	2	59	0.0338983
NODE_165_length_5382_cov_16.894378	5056	5115	119	1	59	0.0169492
NODE_165_length_5382_cov_16.894378	5056	5115	123	1	59	0.0169492
NODE_165_length_5382_cov_16.894378	5056	5115	125	1	59	0.0169492
NODE_165_length_5382_cov_16.894378	5056	5115	127	1	59	0.0169492
NODE_165_length_5382_cov_16.894378	5056	5115	129	1	59	0.0169492
NODE_165_length_5382_cov_16.894378	5056	5115	131	1	59	0.0169492
NODE_167_length_5339_cov_28.708969	3375	3455	8	14	80	0.1750000
NODE_167_length_5339_cov_28.708969	3375	3455	13	10	80	0.1250000
NODE_167_length_5339_cov_28.708969	3375	3455	18	56	80	0.7000000
NODE_167_length_5339_cov_28.708969	3428	3508	18	69	80	0.8625000
NODE_167_length_5339_cov_28.708969	3428	3508	24	4	80	0.0500000
NODE_167_length_5339_cov_28.708969	3428	3508	26	7	80	0.0875000
NODE_168_length_5336_cov_33.036471	3109	3189	10	8	80	0.1000000
NODE_168_length_5336_cov_33.036471	3109	3189	12	13	80	0.1625000
NODE_168_length_5336_cov_33.036471	3109	3189	14	1	80	0.0125000
NODE_168_length_5336_cov_33.036471	3109	3189	16	2	80	0.0250000
NODE_168_length_5336_cov_33.036471	3109	3189	18	4	80	0.0500000
NODE_168_length_5336_cov_33.036471	3109	3189	20	4	80	0.0500000
NODE_168_length_5336_cov_33.036471	3109	3189	22	4	80	0.0500000
NODE_168_length_5336_cov_33.036471	3109	3189	24	3	80	0.0375000
NODE_168_length_5336_cov_33.036471	3109	3189	28	20	80	0.2500000
NODE_168_length_5336_cov_33.036471	3109	3189	30	1	80	0.0125000
NODE_168_length_5336_cov_33.036471	3109	3189	31	2	80	0.0250000
NODE_168_length_5336_cov_33.036471	3109	3189	32	3	80	0.0375000
NODE_168_length_5336_cov_33.036471	3109	3189	33	15	80	0.1875000
NODE_168_length_5336_cov_33.036471	3162	3242	5	6	80	0.0750000
NODE_168_length_5336_cov_33.036471	3162	3242	7	11	80	0.1375000
NODE_168_length_5336_cov_33.036471	3162	3242	9	3	80	0.0375000
NODE_168_length_5336_cov_33.036471	3162	3242	15	5	80	0.0625000
NODE_168_length_5336_cov_33.036471	3162	3242	17	4	80	0.0500000
NODE_168_length_5336_cov_33.036471	3162	3242	18	3	80	0.0375000
NODE_168_length_5336_cov_33.036471	3162	3242	20	4	80	0.0500000
NODE_168_length_5336_cov_33.036471	3162	3242	26	3	80	0.0375000
NODE_168_length_5336_cov_33.036471	3162	3242	28	14	80	0.1750000
NODE_168_length_5336_cov_33.036471	3162	3242	30	7	80	0.0875000
NODE_168_length_5336_cov_33.036471	3162	3242	31	2	80	0.0250000
NODE_168_length_5336_cov_33.036471	3162	3242	32	3	80	0.0375000
NODE_168_length_5336_cov_33.036471	3162	3242	33	15	80	0.1875000
NODE_179_length_5269_cov_23.392650	1905	1985	0	80	80	1.0000000
NODE_179_length_5269_cov_23.392650	1958	2038	0	80	80	1.0000000
NODE_181_length_5207_cov_31.352780	4588	4668	4	80	80	1.0000000
NODE_181_length_5207_cov_31.352780	4641	4721	0	43	80	0.5375000
NODE_181_length_5207_cov_31.352780	4641	4721	4	37	80	0.4625000
NODE_183_length_5193_cov_14.930506	4659	4739	0	80	80	1.0000000
NODE_183_length_5193_cov_14.930506	4712	4792	0	80	80	1.0000000
NODE_183_length_5193_cov_14.930506	4788	4868	0	80	80	1.0000000
NODE_183_length_5193_cov_14.930506	4841	4921	0	32	80	0.4000000
NODE_183_length_5193_cov_14.930506	4841	4921	2	48	80	0.6000000
NODE_186_length_5159_cov_261.593676	158	227	80	6	69	0.0869565
NODE_186_length_5159_cov_261.593676	158	227	81	1	69	0.0144928
NODE_186_length_5159_cov_261.593676	158	227	82	7	69	0.1014493
NODE_186_length_5159_cov_261.593676	158	227	84	4	69	0.0579710
NODE_186_length_5159_cov_261.593676	158	227	86	9	69	0.1304348
NODE_186_length_5159_cov_261.593676	158	227	88	3	69	0.0434783
NODE_186_length_5159_cov_261.593676	158	227	90	3	69	0.0434783
NODE_186_length_5159_cov_261.593676	158	227	94	1	69	0.0144928
NODE_186_length_5159_cov_261.593676	158	227	98	4	69	0.0579710
NODE_186_length_5159_cov_261.593676	158	227	99	1	69	0.0144928
NODE_186_length_5159_cov_261.593676	158	227	100	1	69	0.0144928
NODE_186_length_5159_cov_261.593676	158	227	101	3	69	0.0434783
NODE_186_length_5159_cov_261.593676	158	227	102	2	69	0.0289855
NODE_186_length_5159_cov_261.593676	158	227	103	3	69	0.0434783
NODE_186_length_5159_cov_261.593676	158	227	105	1	69	0.0144928
NODE_186_length_5159_cov_261.593676	158	227	109	12	69	0.1739130
NODE_186_length_5159_cov_261.593676	158	227	111	7	69	0.1014493
NODE_186_length_5159_cov_261.593676	158	227	113	1	69	0.0144928
NODE_189_length_5138_cov_31.467355	3004	3075	0	7	71	0.0985916
NODE_189_length_5138_cov_31.467355	3004	3075	2	19	71	0.2676056
NODE_189_length_5138_cov_31.467355	3004	3075	4	2	71	0.0281690
NODE_189_length_5138_cov_31.467355	3004	3075	6	11	71	0.1549296
NODE_189_length_5138_cov_31.467355	3004	3075	10	5	71	0.0704225
NODE_189_length_5138_cov_31.467355	3004	3075	12	3	71	0.0422535
NODE_189_length_5138_cov_31.467355	3004	3075	18	2	71	0.0281690
NODE_189_length_5138_cov_31.467355	3004	3075	20	21	71	0.2957746
NODE_189_length_5138_cov_31.467355	3004	3075	22	1	71	0.0140845
NODE_191_length_5126_cov_5.900935	731	811	2	36	80	0.4500000
NODE_191_length_5126_cov_5.900935	731	811	4	7	80	0.0875000
NODE_191_length_5126_cov_5.900935	731	811	5	1	80	0.0125000
NODE_191_length_5126_cov_5.900935	731	811	6	36	80	0.4500000
NODE_191_length_5126_cov_5.900935	784	864	4	7	80	0.0875000
NODE_191_length_5126_cov_5.900935	784	864	6	73	80	0.9125000
NODE_194_length_5102_cov_12.729962	367	447	2	25	80	0.3125000
NODE_194_length_5102_cov_12.729962	367	447	4	43	80	0.5375000
NODE_194_length_5102_cov_12.729962	367	447	6	12	80	0.1500000
NODE_194_length_5102_cov_12.729962	420	500	2	5	80	0.0625000
NODE_194_length_5102_cov_12.729962	420	500	4	45	80	0.5625000
NODE_194_length_5102_cov_12.729962	420	500	6	30	80	0.3750000
NODE_194_length_5102_cov_12.729962	496	576	2	5	80	0.0625000
NODE_194_length_5102_cov_12.729962	496	576	5	1	80	0.0125000
NODE_194_length_5102_cov_12.729962	496	576	6	74	80	0.9250000
NODE_194_length_5102_cov_12.729962	549	629	0	21	80	0.2625000
NODE_194_length_5102_cov_12.729962	549	629	2	20	80	0.2500000
NODE_194_length_5102_cov_12.729962	549	629	6	39	80	0.4875000
NODE_196_length_5079_cov_5.580522	875	940	22	1	65	0.0153846
NODE_196_length_5079_cov_5.580522	875	940	24	1	65	0.0153846
NODE_196_length_5079_cov_5.580522	875	940	25	9	65	0.1384615
NODE_196_length_5079_cov_5.580522	875	940	26	12	65	0.1846154
NODE_196_length_5079_cov_5.580522	875	940	27	12	65	0.1846154
NODE_196_length_5079_cov_5.580522	875	940	28	22	65	0.3384615
NODE_196_length_5079_cov_5.580522	875	940	29	1	65	0.0153846
NODE_196_length_5079_cov_5.580522	875	940	30	6	65	0.0923077
NODE_196_length_5079_cov_5.580522	875	940	32	1	65	0.0153846
NODE_197_length_5057_cov_16.348729	2929	3000	81	1	71	0.0140845
NODE_197_length_5057_cov_16.348729	2929	3000	85	1	71	0.0140845
NODE_197_length_5057_cov_16.348729	2929	3000	87	1	71	0.0140845
NODE_197_length_5057_cov_16.348729	2929	3000	97	2	71	0.0281690
NODE_197_length_5057_cov_16.348729	2929	3000	102	1	71	0.0140845
NODE_197_length_5057_cov_16.348729	2929	3000	104	3	71	0.0422535
NODE_197_length_5057_cov_16.348729	2929	3000	106	1	71	0.0140845
NODE_197_length_5057_cov_16.348729	2929	3000	110	3	71	0.0422535
NODE_197_length_5057_cov_16.348729	2929	3000	114	2	71	0.0281690
NODE_197_length_5057_cov_16.348729	2929	3000	118	1	71	0.0140845
NODE_197_length_5057_cov_16.348729	2929	3000	122	1	71	0.0140845
NODE_197_length_5057_cov_16.348729	2929	3000	126	3	71	0.0422535
NODE_197_length_5057_cov_16.348729	2929	3000	128	1	71	0.0140845
NODE_197_length_5057_cov_16.348729	2929	3000	138	1	71	0.0140845
NODE_197_length_5057_cov_16.348729	2929	3000	140	1	71	0.0140845
NODE_197_length_5057_cov_16.348729	2929	3000	141	1	71	0.0140845
NODE_197_length_5057_cov_16.348729	2929	3000	149	1	71	0.0140845
NODE_197_length_5057_cov_16.348729	2929	3000	153	1	71	0.0140845
NODE_197_length_5057_cov_16.348729	2929	3000	154	1	71	0.0140845
NODE_197_length_5057_cov_16.348729	2929	3000	158	1	71	0.0140845
NODE_197_length_5057_cov_16.348729	2929	3000	162	3	71	0.0422535
NODE_197_length_5057_cov_16.348729	2929	3000	166	1	71	0.0140845
NODE_197_length_5057_cov_16.348729	2929	3000	168	3	71	0.0422535
NODE_197_length_5057_cov_16.348729	2929	3000	179	1	71	0.0140845
NODE_197_length_5057_cov_16.348729	2929	3000	183	2	71	0.0281690
NODE_197_length_5057_cov_16.348729	2929	3000	185	5	71	0.0704225
NODE_197_length_5057_cov_16.348729	2929	3000	193	4	71	0.0563380
NODE_197_length_5057_cov_16.348729	2929	3000	197	1	71	0.0140845
NODE_197_length_5057_cov_16.348729	2929	3000	205	2	71	0.0281690
NODE_197_length_5057_cov_16.348729	2929	3000	209	1	71	0.0140845
NODE_197_length_5057_cov_16.348729	2929	3000	211	1	71	0.0140845
NODE_197_length_5057_cov_16.348729	2929	3000	213	1	71	0.0140845
NODE_197_length_5057_cov_16.348729	2929	3000	215	1	71	0.0140845
NODE_197_length_5057_cov_16.348729	2929	3000	217	3	71	0.0422535
NODE_197_length_5057_cov_16.348729	2929	3000	223	2	71	0.0281690
NODE_197_length_5057_cov_16.348729	2929	3000	225	3	71	0.0422535
NODE_197_length_5057_cov_16.348729	2929	3000	229	1	71	0.0140845
NODE_197_length_5057_cov_16.348729	2929	3000	231	2	71	0.0281690
NODE_197_length_5057_cov_16.348729	2929	3000	233	1	71	0.0140845
NODE_197_length_5057_cov_16.348729	2929	3000	235	1	71	0.0140845
NODE_197_length_5057_cov_16.348729	2929	3000	239	2	71	0.0281690
NODE_197_length_5057_cov_16.348729	2929	3000	243	2	71	0.0281690
NODE_197_length_5057_cov_16.348729	2973	3012	193	3	39	0.0769231
NODE_197_length_5057_cov_16.348729	2973	3012	197	1	39	0.0256410
NODE_197_length_5057_cov_16.348729	2973	3012	205	2	39	0.0512821
NODE_197_length_5057_cov_16.348729	2973	3012	209	1	39	0.0256410
NODE_197_length_5057_cov_16.348729	2973	3012	211	1	39	0.0256410
NODE_197_length_5057_cov_16.348729	2973	3012	213	1	39	0.0256410
NODE_197_length_5057_cov_16.348729	2973	3012	215	1	39	0.0256410
NODE_197_length_5057_cov_16.348729	2973	3012	217	3	39	0.0769231
NODE_197_length_5057_cov_16.348729	2973	3012	223	2	39	0.0512821
NODE_197_length_5057_cov_16.348729	2973	3012	225	3	39	0.0769231
NODE_197_length_5057_cov_16.348729	2973	3012	229	1	39	0.0256410
NODE_197_length_5057_cov_16.348729	2973	3012	231	2	39	0.0512821
NODE_197_length_5057_cov_16.348729	2973	3012	233	1	39	0.0256410
NODE_197_length_5057_cov_16.348729	2973	3012	235	1	39	0.0256410
NODE_197_length_5057_cov_16.348729	2973	3012	239	2	39	0.0512821
NODE_197_length_5057_cov_16.348729	2973	3012	243	2	39	0.0512821
NODE_197_length_5057_cov_16.348729	2973	3012	245	2	39	0.0512821
NODE_197_length_5057_cov_16.348729	2973	3012	248	2	39	0.0512821
NODE_197_length_5057_cov_16.348729	2973	3012	249	2	39	0.0512821
NODE_197_length_5057_cov_16.348729	2973	3012	250	1	39	0.0256410
NODE_197_length_5057_cov_16.348729	2973	3012	251	2	39	0.0512821
NODE_197_length_5057_cov_16.348729	2973	3012	253	3	39	0.0769231
NODE_198_length_5053_cov_11.281994	791	834	0	43	43	1.0000000
NODE_198_length_5053_cov_11.281994	807	887	0	80	80	1.0000000
NODE_198_length_5053_cov_11.281994	883	963	0	80	80	1.0000000
NODE_198_length_5053_cov_11.281994	936	999	0	63	63	1.0000000
NODE_204_length_4906_cov_37.988350	3170	3251	6	1	81	0.0123457
NODE_204_length_4906_cov_37.988350	3170	3251	7	1	81	0.0123457
NODE_204_length_4906_cov_37.988350	3170	3251	9	2	81	0.0246914
NODE_204_length_4906_cov_37.988350	3170	3251	12	5	81	0.0617284
NODE_204_length_4906_cov_37.988350	3170	3251	16	1	81	0.0123457
NODE_204_length_4906_cov_37.988350	3170	3251	17	3	81	0.0370370
NODE_204_length_4906_cov_37.988350	3170	3251	19	17	81	0.2098765
NODE_204_length_4906_cov_37.988350	3170	3251	21	1	81	0.0123457
NODE_204_length_4906_cov_37.988350	3170	3251	23	4	81	0.0493827
NODE_204_length_4906_cov_37.988350	3170	3251	25	9	81	0.1111111
NODE_204_length_4906_cov_37.988350	3170	3251	27	1	81	0.0123457
NODE_204_length_4906_cov_37.988350	3170	3251	39	1	81	0.0123457
NODE_204_length_4906_cov_37.988350	3170	3251	41	1	81	0.0123457
NODE_204_length_4906_cov_37.988350	3170	3251	43	1	81	0.0123457
NODE_204_length_4906_cov_37.988350	3170	3251	45	2	81	0.0246914
NODE_204_length_4906_cov_37.988350	3170	3251	47	1	81	0.0123457
NODE_204_length_4906_cov_37.988350	3170	3251	51	2	81	0.0246914
NODE_204_length_4906_cov_37.988350	3170	3251	54	2	81	0.0246914
NODE_204_length_4906_cov_37.988350	3170	3251	62	1	81	0.0123457
NODE_204_length_4906_cov_37.988350	3170	3251	63	1	81	0.0123457
NODE_204_length_4906_cov_37.988350	3170	3251	67	2	81	0.0246914
NODE_204_length_4906_cov_37.988350	3170	3251	69	2	81	0.0246914
NODE_204_length_4906_cov_37.988350	3170	3251	73	1	81	0.0123457
NODE_204_length_4906_cov_37.988350	3170	3251	77	2	81	0.0246914
NODE_204_length_4906_cov_37.988350	3170	3251	79	3	81	0.0370370
NODE_204_length_4906_cov_37.988350	3170	3251	83	1	81	0.0123457
NODE_204_length_4906_cov_37.988350	3170	3251	85	3	81	0.0370370
NODE_204_length_4906_cov_37.988350	3170	3251	90	1	81	0.0123457
NODE_204_length_4906_cov_37.988350	3170	3251	93	1	81	0.0123457
NODE_204_length_4906_cov_37.988350	3170	3251	97	1	81	0.0123457
NODE_204_length_4906_cov_37.988350	3170	3251	101	1	81	0.0123457
NODE_204_length_4906_cov_37.988350	3170	3251	103	3	81	0.0370370
NODE_204_length_4906_cov_37.988350	3170	3251	105	1	81	0.0123457
NODE_204_length_4906_cov_37.988350	3170	3251	107	1	81	0.0123457
NODE_204_length_4906_cov_37.988350	3170	3251	111	1	81	0.0123457
NODE_205_length_4888_cov_60.162247	4029	4068	4	3	39	0.0769231
NODE_205_length_4888_cov_60.162247	4029	4068	6	35	39	0.8974359
NODE_205_length_4888_cov_60.162247	4029	4068	8	1	39	0.0256410
NODE_205_length_4888_cov_60.162247	4041	4121	2	15	80	0.1875000
NODE_205_length_4888_cov_60.162247	4041	4121	4	1	80	0.0125000
NODE_205_length_4888_cov_60.162247	4041	4121	6	64	80	0.8000000
NODE_207_length_4875_cov_63.035176	2905	2985	0	80	80	1.0000000
NODE_207_length_4875_cov_63.035176	2958	3038	0	28	80	0.3500000
NODE_207_length_4875_cov_63.035176	2958	3038	2	16	80	0.2000000
NODE_207_length_4875_cov_63.035176	2958	3038	6	6	80	0.0750000
NODE_207_length_4875_cov_63.035176	2958	3038	8	30	80	0.3750000
NODE_208_length_4875_cov_8.996859	4683	4760	0	1	77	0.0129870
NODE_208_length_4875_cov_8.996859	4683	4760	2	76	77	0.9870130
NODE_208_length_4875_cov_8.996859	4736	4813	0	21	77	0.2727273
NODE_208_length_4875_cov_8.996859	4736	4813	2	56	77	0.7272727
NODE_211_length_4827_cov_15.364636	1803	1865	28	2	62	0.0322581
NODE_211_length_4827_cov_15.364636	1803	1865	29	2	62	0.0322581
NODE_211_length_4827_cov_15.364636	1803	1865	30	2	62	0.0322581
NODE_211_length_4827_cov_15.364636	1803	1865	31	3	62	0.0483871
NODE_211_length_4827_cov_15.364636	1803	1865	32	10	62	0.1612903
NODE_211_length_4827_cov_15.364636	1803	1865	33	3	62	0.0483871
NODE_211_length_4827_cov_15.364636	1803	1865	34	7	62	0.1129032
NODE_211_length_4827_cov_15.364636	1803	1865	35	2	62	0.0322581
NODE_211_length_4827_cov_15.364636	1803	1865	36	6	62	0.0967742
NODE_211_length_4827_cov_15.364636	1803	1865	37	4	62	0.0645161
NODE_211_length_4827_cov_15.364636	1803	1865	38	1	62	0.0161290
NODE_211_length_4827_cov_15.364636	1803	1865	40	3	62	0.0483871
NODE_211_length_4827_cov_15.364636	1803	1865	42	2	62	0.0322581
NODE_211_length_4827_cov_15.364636	1803	1865	46	2	62	0.0322581
NODE_211_length_4827_cov_15.364636	1803	1865	50	2	62	0.0322581
NODE_211_length_4827_cov_15.364636	1803	1865	52	2	62	0.0322581
NODE_211_length_4827_cov_15.364636	1803	1865	54	3	62	0.0483871
NODE_211_length_4827_cov_15.364636	1803	1865	56	4	62	0.0645161
NODE_211_length_4827_cov_15.364636	1803	1865	58	2	62	0.0322581
NODE_211_length_4827_cov_15.364636	1899	1979	38	2	80	0.0250000
NODE_211_length_4827_cov_15.364636	1899	1979	40	1	80	0.0125000
NODE_211_length_4827_cov_15.364636	1899	1979	42	14	80	0.1750000
NODE_211_length_4827_cov_15.364636	1899	1979	44	4	80	0.0500000
NODE_211_length_4827_cov_15.364636	1899	1979	46	5	80	0.0625000
NODE_211_length_4827_cov_15.364636	1899	1979	48	3	80	0.0375000
NODE_211_length_4827_cov_15.364636	1899	1979	50	23	80	0.2875000
NODE_211_length_4827_cov_15.364636	1899	1979	52	9	80	0.1125000
NODE_211_length_4827_cov_15.364636	1899	1979	54	16	80	0.2000000
NODE_211_length_4827_cov_15.364636	1899	1979	56	3	80	0.0375000
NODE_211_length_4827_cov_15.364636	1952	1996	37	2	44	0.0454545
NODE_211_length_4827_cov_15.364636	1952	1996	43	4	44	0.0909091
NODE_211_length_4827_cov_15.364636	1952	1996	44	1	44	0.0227273
NODE_211_length_4827_cov_15.364636	1952	1996	46	3	44	0.0681818
NODE_211_length_4827_cov_15.364636	1952	1996	48	1	44	0.0227273
NODE_211_length_4827_cov_15.364636	1952	1996	50	27	44	0.6136364
NODE_211_length_4827_cov_15.364636	1952	1996	52	6	44	0.1363636
NODE_212_length_4821_cov_10.856840	999	1061	2	14	62	0.2258064
NODE_212_length_4821_cov_10.856840	999	1061	4	48	62	0.7741935
NODE_213_length_4819_cov_16.363347	2392	2461	8	31	69	0.4492754
NODE_213_length_4819_cov_16.363347	2392	2461	10	33	69	0.4782609
NODE_213_length_4819_cov_16.363347	2392	2461	12	5	69	0.0724638
NODE_217_length_4794_cov_14.912886	657	737	17	5	80	0.0625000
NODE_217_length_4794_cov_14.912886	657	737	19	2	80	0.0250000
NODE_217_length_4794_cov_14.912886	657	737	21	7	80	0.0875000
NODE_217_length_4794_cov_14.912886	657	737	23	9	80	0.1125000
NODE_217_length_4794_cov_14.912886	657	737	25	6	80	0.0750000
NODE_217_length_4794_cov_14.912886	657	737	27	18	80	0.2250000
NODE_217_length_4794_cov_14.912886	657	737	29	30	80	0.3750000
NODE_217_length_4794_cov_14.912886	657	737	31	3	80	0.0375000
NODE_217_length_4794_cov_14.912886	4240	4312	1	9	72	0.1250000
NODE_217_length_4794_cov_14.912886	4240	4312	2	22	72	0.3055556
NODE_217_length_4794_cov_14.912886	4240	4312	3	20	72	0.2777778
NODE_217_length_4794_cov_14.912886	4240	4312	7	2	72	0.0277778
NODE_217_length_4794_cov_14.912886	4240	4312	8	4	72	0.0555556
NODE_217_length_4794_cov_14.912886	4240	4312	10	15	72	0.2083333
NODE_217_length_4794_cov_14.912886	4293	4312	2	19	19	1.0000000
NODE_217_length_4794_cov_14.912886	4345	4408	10	7	63	0.1111111
NODE_217_length_4794_cov_14.912886	4345	4408	11	8	63	0.1269841
NODE_217_length_4794_cov_14.912886	4345	4408	12	9	63	0.1428571
NODE_217_length_4794_cov_14.912886	4345	4408	14	8	63	0.1269841
NODE_217_length_4794_cov_14.912886	4345	4408	16	23	63	0.3650794
NODE_217_length_4794_cov_14.912886	4345	4408	18	8	63	0.1269841
NODE_218_length_4791_cov_16.126172	2438	2518	0	80	80	1.0000000
NODE_218_length_4791_cov_16.126172	2491	2571	0	80	80	1.0000000
NODE_218_length_4791_cov_16.126172	2567	2647	0	80	80	1.0000000
NODE_218_length_4791_cov_16.126172	2620	2700	0	80	80	1.0000000
NODE_218_length_4791_cov_16.126172	4607	4687	0	80	80	1.0000000
NODE_219_length_4790_cov_9.713494	2159	2239	22	11	80	0.1375000
NODE_219_length_4790_cov_9.713494	2159	2239	24	25	80	0.3125000
NODE_219_length_4790_cov_9.713494	2159	2239	26	22	80	0.2750000
NODE_219_length_4790_cov_9.713494	2159	2239	28	12	80	0.1500000
NODE_219_length_4790_cov_9.713494	2159	2239	30	6	80	0.0750000
NODE_219_length_4790_cov_9.713494	2159	2239	34	4	80	0.0500000
NODE_219_length_4790_cov_9.713494	4273	4353	2	26	80	0.3250000
NODE_219_length_4790_cov_9.713494	4273	4353	4	54	80	0.6750000
NODE_219_length_4790_cov_9.713494	4273	4335	2	26	62	0.4193548
NODE_219_length_4790_cov_9.713494	4273	4335	4	36	62	0.5806451
NODE_219_length_4790_cov_9.713494	4326	4406	4	32	80	0.4000000
NODE_219_length_4790_cov_9.713494	4326	4406	6	19	80	0.2375000
NODE_219_length_4790_cov_9.713494	4326	4406	7	3	80	0.0375000
NODE_219_length_4790_cov_9.713494	4326	4406	8	24	80	0.3000000
NODE_219_length_4790_cov_9.713494	4326	4406	10	2	80	0.0250000
NODE_221_length_4772_cov_10.560454	4281	4367	0	31	86	0.3604651
NODE_221_length_4772_cov_10.560454	4281	4367	2	55	86	0.6395349
NODE_222_length_4770_cov_106.953543	2778	2858	6	5	80	0.0625000
NODE_222_length_4770_cov_106.953543	2778	2858	8	16	80	0.2000000
NODE_222_length_4770_cov_106.953543	2778	2858	10	38	80	0.4750000
NODE_222_length_4770_cov_106.953543	2778	2858	12	12	80	0.1500000
NODE_222_length_4770_cov_106.953543	2778	2858	14	5	80	0.0625000
NODE_222_length_4770_cov_106.953543	2778	2858	16	1	80	0.0125000
NODE_222_length_4770_cov_106.953543	2778	2858	18	3	80	0.0375000
NODE_222_length_4770_cov_106.953543	2831	2911	6	12	80	0.1500000
NODE_222_length_4770_cov_106.953543	2831	2911	8	8	80	0.1000000
NODE_222_length_4770_cov_106.953543	2831	2911	10	16	80	0.2000000
NODE_222_length_4770_cov_106.953543	2831	2911	12	4	80	0.0500000
NODE_222_length_4770_cov_106.953543	2831	2911	14	1	80	0.0125000
NODE_222_length_4770_cov_106.953543	2831	2911	16	1	80	0.0125000
NODE_222_length_4770_cov_106.953543	2831	2911	18	6	80	0.0750000
NODE_222_length_4770_cov_106.953543	2831	2911	20	8	80	0.1000000
NODE_222_length_4770_cov_106.953543	2831	2911	22	3	80	0.0375000
NODE_222_length_4770_cov_106.953543	2831	2911	26	1	80	0.0125000
NODE_222_length_4770_cov_106.953543	2831	2911	30	2	80	0.0250000
NODE_222_length_4770_cov_106.953543	2831	2911	32	3	80	0.0375000
NODE_222_length_4770_cov_106.953543	2831	2911	38	1	80	0.0125000
NODE_222_length_4770_cov_106.953543	2831	2911	41	1	80	0.0125000
NODE_222_length_4770_cov_106.953543	2831	2911	42	13	80	0.1625000
NODE_222_length_4770_cov_106.953543	2907	2987	42	6	80	0.0750000
NODE_222_length_4770_cov_106.953543	2907	2987	44	3	80	0.0375000
NODE_222_length_4770_cov_106.953543	2907	2987	46	1	80	0.0125000
NODE_222_length_4770_cov_106.953543	2907	2987	48	1	80	0.0125000
NODE_222_length_4770_cov_106.953543	2907	2987	56	1	80	0.0125000
NODE_222_length_4770_cov_106.953543	2907	2987	62	3	80	0.0375000
NODE_222_length_4770_cov_106.953543	2907	2987	64	2	80	0.0250000
NODE_222_length_4770_cov_106.953543	2907	2987	66	1	80	0.0125000
NODE_222_length_4770_cov_106.953543	2907	2987	68	3	80	0.0375000
NODE_222_length_4770_cov_106.953543	2907	2987	74	2	80	0.0250000
NODE_222_length_4770_cov_106.953543	2907	2987	76	4	80	0.0500000
NODE_222_length_4770_cov_106.953543	2907	2987	80	2	80	0.0250000
NODE_222_length_4770_cov_106.953543	2907	2987	82	1	80	0.0125000
NODE_222_length_4770_cov_106.953543	2907	2987	91	1	80	0.0125000
NODE_222_length_4770_cov_106.953543	2907	2987	95	1	80	0.0125000
NODE_222_length_4770_cov_106.953543	2907	2987	97	2	80	0.0250000
NODE_222_length_4770_cov_106.953543	2907	2987	99	1	80	0.0125000
NODE_222_length_4770_cov_106.953543	2907	2987	104	1	80	0.0125000
NODE_222_length_4770_cov_106.953543	2907	2987	105	1	80	0.0125000
NODE_222_length_4770_cov_106.953543	2907	2987	107	3	80	0.0375000
NODE_222_length_4770_cov_106.953543	2907	2987	109	2	80	0.0250000
NODE_222_length_4770_cov_106.953543	2907	2987	112	1	80	0.0125000
NODE_222_length_4770_cov_106.953543	2907	2987	114	1	80	0.0125000
NODE_222_length_4770_cov_106.953543	2907	2987	115	2	80	0.0250000
NODE_222_length_4770_cov_106.953543	2907	2987	116	4	80	0.0500000
NODE_222_length_4770_cov_106.953543	2907	2987	117	2	80	0.0250000
NODE_222_length_4770_cov_106.953543	2907	2987	118	14	80	0.1750000
NODE_222_length_4770_cov_106.953543	2907	2987	120	12	80	0.1500000
NODE_222_length_4770_cov_106.953543	2907	2987	122	1	80	0.0125000
NODE_222_length_4770_cov_106.953543	2907	2987	124	1	80	0.0125000
NODE_222_length_4770_cov_106.953543	2960	3040	75	2	80	0.0250000
NODE_222_length_4770_cov_106.953543	2960	3040	83	2	80	0.0250000
NODE_222_length_4770_cov_106.953543	2960	3040	85	4	80	0.0500000
NODE_222_length_4770_cov_106.953543	2960	3040	87	1	80	0.0125000
NODE_222_length_4770_cov_106.953543	2960	3040	93	4	80	0.0500000
NODE_222_length_4770_cov_106.953543	2960	3040	94	1	80	0.0125000
NODE_222_length_4770_cov_106.953543	2960	3040	95	4	80	0.0500000
NODE_222_length_4770_cov_106.953543	2960	3040	97	4	80	0.0500000
NODE_222_length_4770_cov_106.953543	2960	3040	99	2	80	0.0250000
NODE_222_length_4770_cov_106.953543	2960	3040	105	2	80	0.0250000
NODE_222_length_4770_cov_106.953543	2960	3040	107	5	80	0.0625000
NODE_222_length_4770_cov_106.953543	2960	3040	109	1	80	0.0125000
NODE_222_length_4770_cov_106.953543	2960	3040	111	1	80	0.0125000
NODE_222_length_4770_cov_106.953543	2960	3040	112	3	80	0.0375000
NODE_222_length_4770_cov_106.953543	2960	3040	113	4	80	0.0500000
NODE_222_length_4770_cov_106.953543	2960	3040	114	4	80	0.0500000
NODE_222_length_4770_cov_106.953543	2960	3040	115	3	80	0.0375000
NODE_222_length_4770_cov_106.953543	2960	3040	116	8	80	0.1000000
NODE_222_length_4770_cov_106.953543	2960	3040	117	4	80	0.0500000
NODE_222_length_4770_cov_106.953543	2960	3040	118	11	80	0.1375000
NODE_222_length_4770_cov_106.953543	2960	3040	120	8	80	0.1000000
NODE_222_length_4770_cov_106.953543	2960	3040	122	1	80	0.0125000
NODE_222_length_4770_cov_106.953543	2960	3040	124	1	80	0.0125000
NODE_223_length_4768_cov_15.447205	1237	1317	8	1	80	0.0125000
NODE_223_length_4768_cov_15.447205	1237	1317	10	16	80	0.2000000
NODE_223_length_4768_cov_15.447205	1237	1317	16	2	80	0.0250000
NODE_223_length_4768_cov_15.447205	1237	1317	17	2	80	0.0250000
NODE_223_length_4768_cov_15.447205	1237	1317	18	20	80	0.2500000
NODE_223_length_4768_cov_15.447205	1237	1317	20	17	80	0.2125000
NODE_223_length_4768_cov_15.447205	1237	1317	22	10	80	0.1250000
NODE_223_length_4768_cov_15.447205	1237	1317	24	12	80	0.1500000
NODE_228_length_4730_cov_30.142734	256	336	0	18	80	0.2250000
NODE_228_length_4730_cov_30.142734	256	336	2	41	80	0.5125000
NODE_228_length_4730_cov_30.142734	256	336	4	21	80	0.2625000
NODE_228_length_4730_cov_30.142734	309	389	2	6	80	0.0750000
NODE_228_length_4730_cov_30.142734	309	389	4	54	80	0.6750000
NODE_228_length_4730_cov_30.142734	309	389	6	20	80	0.2500000
NODE_228_length_4730_cov_30.142734	4052	4132	0	19	80	0.2375000
NODE_228_length_4730_cov_30.142734	4052	4132	2	43	80	0.5375000
NODE_228_length_4730_cov_30.142734	4052	4132	4	18	80	0.2250000
NODE_228_length_4730_cov_30.142734	4105	4185	2	12	80	0.1500000
NODE_228_length_4730_cov_30.142734	4105	4185	4	68	80	0.8500000
NODE_231_length_4706_cov_25.522683	2181	2261	0	40	80	0.5000000
NODE_231_length_4706_cov_25.522683	2181	2261	2	13	80	0.1625000
NODE_231_length_4706_cov_25.522683	2181	2261	4	1	80	0.0125000
NODE_231_length_4706_cov_25.522683	2181	2261	6	2	80	0.0250000
NODE_231_length_4706_cov_25.522683	2181	2261	10	1	80	0.0125000
NODE_231_length_4706_cov_25.522683	2181	2261	12	2	80	0.0250000
NODE_231_length_4706_cov_25.522683	2181	2261	16	1	80	0.0125000
NODE_231_length_4706_cov_25.522683	2181	2261	18	11	80	0.1375000
NODE_231_length_4706_cov_25.522683	2181	2261	20	4	80	0.0500000
NODE_231_length_4706_cov_25.522683	2181	2261	22	2	80	0.0250000
NODE_231_length_4706_cov_25.522683	2181	2261	24	1	80	0.0125000
NODE_231_length_4706_cov_25.522683	2181	2261	26	2	80	0.0250000
NODE_231_length_4706_cov_25.522683	2234	2288	0	54	54	1.0000000
NODE_231_length_4706_cov_25.522683	3943	4026	26	3	83	0.0361446
NODE_231_length_4706_cov_25.522683	3943	4026	27	5	83	0.0602410
NODE_231_length_4706_cov_25.522683	3943	4026	30	1	83	0.0120482
NODE_231_length_4706_cov_25.522683	3943	4026	31	15	83	0.1807229
NODE_231_length_4706_cov_25.522683	3943	4026	33	33	83	0.3975904
NODE_231_length_4706_cov_25.522683	3943	4026	34	2	83	0.0240964
NODE_231_length_4706_cov_25.522683	3943	4026	35	13	83	0.1566265
NODE_231_length_4706_cov_25.522683	3943	4026	37	5	83	0.0602410
NODE_231_length_4706_cov_25.522683	3943	4026	39	6	83	0.0722892
NODE_235_length_4693_cov_16.973008	374	454	6	2	80	0.0250000
NODE_235_length_4693_cov_16.973008	374	454	8	6	80	0.0750000
NODE_235_length_4693_cov_16.973008	374	454	12	12	80	0.1500000
NODE_235_length_4693_cov_16.973008	374	454	14	13	80	0.1625000
NODE_235_length_4693_cov_16.973008	374	454	15	6	80	0.0750000
NODE_235_length_4693_cov_16.973008	374	454	16	10	80	0.1250000
NODE_235_length_4693_cov_16.973008	374	454	17	5	80	0.0625000
NODE_235_length_4693_cov_16.973008	374	454	19	4	80	0.0500000
NODE_235_length_4693_cov_16.973008	374	454	21	20	80	0.2500000
NODE_235_length_4693_cov_16.973008	374	454	23	2	80	0.0250000
NODE_235_length_4693_cov_16.973008	427	507	17	3	80	0.0375000
NODE_235_length_4693_cov_16.973008	427	507	19	2	80	0.0250000
NODE_235_length_4693_cov_16.973008	427	507	20	1	80	0.0125000
NODE_235_length_4693_cov_16.973008	427	507	21	30	80	0.3750000
NODE_235_length_4693_cov_16.973008	427	507	22	2	80	0.0250000
NODE_235_length_4693_cov_16.973008	427	507	23	2	80	0.0250000
NODE_235_length_4693_cov_16.973008	427	507	24	26	80	0.3250000
NODE_235_length_4693_cov_16.973008	427	507	26	2	80	0.0250000
NODE_235_length_4693_cov_16.973008	427	507	28	12	80	0.1500000
NODE_240_length_4672_cov_39.029084	1391	1470	52	1	79	0.0126582
NODE_240_length_4672_cov_39.029084	1391	1470	53	1	79	0.0126582
NODE_240_length_4672_cov_39.029084	1391	1470	57	1	79	0.0126582
NODE_240_length_4672_cov_39.029084	1391	1470	59	1	79	0.0126582
NODE_240_length_4672_cov_39.029084	1391	1470	63	1	79	0.0126582
NODE_240_length_4672_cov_39.029084	1391	1470	65	1	79	0.0126582
NODE_240_length_4672_cov_39.029084	1391	1470	69	1	79	0.0126582
NODE_240_length_4672_cov_39.029084	1391	1470	71	2	79	0.0253165
NODE_240_length_4672_cov_39.029084	1391	1470	107	1	79	0.0126582
NODE_240_length_4672_cov_39.029084	1391	1470	113	1	79	0.0126582
NODE_240_length_4672_cov_39.029084	1391	1470	119	1	79	0.0126582
NODE_240_length_4672_cov_39.029084	1391	1470	120	1	79	0.0126582
NODE_240_length_4672_cov_39.029084	1391	1470	121	1	79	0.0126582
NODE_240_length_4672_cov_39.029084	1391	1470	122	3	79	0.0379747
NODE_240_length_4672_cov_39.029084	1391	1470	124	2	79	0.0253165
NODE_240_length_4672_cov_39.029084	1391	1470	126	2	79	0.0253165
NODE_240_length_4672_cov_39.029084	1391	1470	130	2	79	0.0253165
NODE_240_length_4672_cov_39.029084	1391	1470	134	1	79	0.0126582
NODE_240_length_4672_cov_39.029084	1391	1470	140	1	79	0.0126582
NODE_240_length_4672_cov_39.029084	1391	1470	146	1	79	0.0126582
NODE_240_length_4672_cov_39.029084	1391	1470	148	1	79	0.0126582
NODE_240_length_4672_cov_39.029084	1391	1470	156	1	79	0.0126582
NODE_240_length_4672_cov_39.029084	1391	1470	168	1	79	0.0126582
NODE_240_length_4672_cov_39.029084	1391	1470	170	1	79	0.0126582
NODE_240_length_4672_cov_39.029084	1391	1470	188	1	79	0.0126582
NODE_240_length_4672_cov_39.029084	1391	1470	194	1	79	0.0126582
NODE_240_length_4672_cov_39.029084	1391	1470	202	1	79	0.0126582
NODE_240_length_4672_cov_39.029084	1391	1470	206	2	79	0.0253165
NODE_240_length_4672_cov_39.029084	1391	1470	208	1	79	0.0126582
NODE_240_length_4672_cov_39.029084	1391	1470	209	2	79	0.0253165
NODE_240_length_4672_cov_39.029084	1391	1470	225	1	79	0.0126582
NODE_240_length_4672_cov_39.029084	1391	1470	231	2	79	0.0253165
NODE_240_length_4672_cov_39.029084	1391	1470	241	1	79	0.0126582
NODE_240_length_4672_cov_39.029084	1391	1470	242	1	79	0.0126582
NODE_240_length_4672_cov_39.029084	1391	1470	243	1	79	0.0126582
NODE_240_length_4672_cov_39.029084	1391	1470	245	1	79	0.0126582
NODE_240_length_4672_cov_39.029084	1391	1470	249	2	79	0.0253165
NODE_240_length_4672_cov_39.029084	1391	1470	251	1	79	0.0126582
NODE_240_length_4672_cov_39.029084	1391	1470	256	1	79	0.0126582
NODE_240_length_4672_cov_39.029084	1391	1470	259	1	79	0.0126582
NODE_240_length_4672_cov_39.029084	1391	1470	261	1	79	0.0126582
NODE_240_length_4672_cov_39.029084	1391	1470	270	1	79	0.0126582
NODE_240_length_4672_cov_39.029084	1391	1470	273	1	79	0.0126582
NODE_240_length_4672_cov_39.029084	1391	1470	275	1	79	0.0126582
NODE_240_length_4672_cov_39.029084	1391	1470	281	2	79	0.0253165
NODE_240_length_4672_cov_39.029084	1391	1470	285	1	79	0.0126582
NODE_240_length_4672_cov_39.029084	1391	1470	287	1	79	0.0126582
NODE_240_length_4672_cov_39.029084	1391	1470	293	3	79	0.0379747
NODE_240_length_4672_cov_39.029084	1391	1470	295	1	79	0.0126582
NODE_240_length_4672_cov_39.029084	1391	1470	297	2	79	0.0253165
NODE_240_length_4672_cov_39.029084	1391	1470	299	2	79	0.0253165
NODE_240_length_4672_cov_39.029084	1391	1470	301	1	79	0.0126582
NODE_240_length_4672_cov_39.029084	1391	1470	303	4	79	0.0506329
NODE_240_length_4672_cov_39.029084	1391	1470	304	2	79	0.0253165
NODE_240_length_4672_cov_39.029084	1391	1470	307	1	79	0.0126582
NODE_240_length_4672_cov_39.029084	1391	1470	309	1	79	0.0126582
NODE_240_length_4672_cov_39.029084	1391	1470	312	1	79	0.0126582
NODE_240_length_4672_cov_39.029084	1391	1470	313	1	79	0.0126582
NODE_240_length_4672_cov_39.029084	1391	1470	314	2	79	0.0253165
NODE_240_length_4672_cov_39.029084	1444	1523	146	1	79	0.0126582
NODE_240_length_4672_cov_39.029084	1444	1523	151	1	79	0.0126582
NODE_240_length_4672_cov_39.029084	1444	1523	163	1	79	0.0126582
NODE_240_length_4672_cov_39.029084	1444	1523	165	1	79	0.0126582
NODE_240_length_4672_cov_39.029084	1444	1523	171	1	79	0.0126582
NODE_240_length_4672_cov_39.029084	1444	1523	178	1	79	0.0126582
NODE_240_length_4672_cov_39.029084	1444	1523	192	1	79	0.0126582
NODE_240_length_4672_cov_39.029084	1444	1523	199	1	79	0.0126582
NODE_240_length_4672_cov_39.029084	1444	1523	211	2	79	0.0253165
NODE_240_length_4672_cov_39.029084	1444	1523	212	1	79	0.0126582
NODE_240_length_4672_cov_39.029084	1444	1523	216	2	79	0.0253165
NODE_240_length_4672_cov_39.029084	1444	1523	218	1	79	0.0126582
NODE_240_length_4672_cov_39.029084	1444	1523	230	1	79	0.0126582
NODE_240_length_4672_cov_39.029084	1444	1523	238	1	79	0.0126582
NODE_240_length_4672_cov_39.029084	1444	1523	244	1	79	0.0126582
NODE_240_length_4672_cov_39.029084	1444	1523	248	1	79	0.0126582
NODE_240_length_4672_cov_39.029084	1444	1523	252	1	79	0.0126582
NODE_240_length_4672_cov_39.029084	1444	1523	254	2	79	0.0253165
NODE_240_length_4672_cov_39.029084	1444	1523	258	1	79	0.0126582
NODE_240_length_4672_cov_39.029084	1444	1523	260	1	79	0.0126582
NODE_240_length_4672_cov_39.029084	1444	1523	263	2	79	0.0253165
NODE_240_length_4672_cov_39.029084	1444	1523	265	2	79	0.0253165
NODE_240_length_4672_cov_39.029084	1444	1523	271	1	79	0.0126582
NODE_240_length_4672_cov_39.029084	1444	1523	273	1	79	0.0126582
NODE_240_length_4672_cov_39.029084	1444	1523	275	1	79	0.0126582
NODE_240_length_4672_cov_39.029084	1444	1523	281	3	79	0.0379747
NODE_240_length_4672_cov_39.029084	1444	1523	285	6	79	0.0759494
NODE_240_length_4672_cov_39.029084	1444	1523	287	3	79	0.0379747
NODE_240_length_4672_cov_39.029084	1444	1523	291	2	79	0.0253165
NODE_240_length_4672_cov_39.029084	1444	1523	293	5	79	0.0632911
NODE_240_length_4672_cov_39.029084	1444	1523	295	4	79	0.0506329
NODE_240_length_4672_cov_39.029084	1444	1523	297	3	79	0.0379747
NODE_240_length_4672_cov_39.029084	1444	1523	299	2	79	0.0253165
NODE_240_length_4672_cov_39.029084	1444	1523	300	2	79	0.0253165
NODE_240_length_4672_cov_39.029084	1444	1523	301	1	79	0.0126582
NODE_240_length_4672_cov_39.029084	1444	1523	302	6	79	0.0759494
NODE_240_length_4672_cov_39.029084	1444	1523	303	4	79	0.0506329
NODE_240_length_4672_cov_39.029084	1444	1523	304	2	79	0.0253165
NODE_240_length_4672_cov_39.029084	1444	1523	307	1	79	0.0126582
NODE_240_length_4672_cov_39.029084	1444	1523	309	1	79	0.0126582
NODE_240_length_4672_cov_39.029084	1444	1523	312	1	79	0.0126582
NODE_240_length_4672_cov_39.029084	1444	1523	313	1	79	0.0126582
NODE_240_length_4672_cov_39.029084	1444	1523	314	2	79	0.0253165
NODE_246_length_4602_cov_17.281368	3106	3186	2	41	80	0.5125000
NODE_246_length_4602_cov_17.281368	3106	3186	4	39	80	0.4875000
NODE_246_length_4602_cov_17.281368	3159	3239	2	19	80	0.2375000
NODE_246_length_4602_cov_17.281368	3159	3239	4	61	80	0.7625000
NODE_248_length_4587_cov_14.431150	1294	1370	38	3	76	0.0394737
NODE_248_length_4587_cov_14.431150	1294	1370	40	4	76	0.0526316
NODE_248_length_4587_cov_14.431150	1294	1370	42	1	76	0.0131579
NODE_248_length_4587_cov_14.431150	1294	1370	48	1	76	0.0131579
NODE_248_length_4587_cov_14.431150	1294	1370	50	2	76	0.0263158
NODE_248_length_4587_cov_14.431150	1294	1370	54	1	76	0.0131579
NODE_248_length_4587_cov_14.431150	1294	1370	55	2	76	0.0263158
NODE_248_length_4587_cov_14.431150	1294	1370	57	2	76	0.0263158
NODE_248_length_4587_cov_14.431150	1294	1370	58	2	76	0.0263158
NODE_248_length_4587_cov_14.431150	1294	1370	60	1	76	0.0131579
NODE_248_length_4587_cov_14.431150	1294	1370	61	1	76	0.0131579
NODE_248_length_4587_cov_14.431150	1294	1370	62	1	76	0.0131579
NODE_248_length_4587_cov_14.431150	1294	1370	63	5	76	0.0657895
NODE_248_length_4587_cov_14.431150	1294	1370	64	1	76	0.0131579
NODE_248_length_4587_cov_14.431150	1294	1370	66	2	76	0.0263158
NODE_248_length_4587_cov_14.431150	1294	1370	68	13	76	0.1710526
NODE_248_length_4587_cov_14.431150	1294	1370	70	4	76	0.0526316
NODE_248_length_4587_cov_14.431150	1294	1370	72	5	76	0.0657895
NODE_248_length_4587_cov_14.431150	1294	1370	74	5	76	0.0657895
NODE_248_length_4587_cov_14.431150	1294	1370	76	3	76	0.0394737
NODE_248_length_4587_cov_14.431150	1294	1370	78	1	76	0.0131579
NODE_248_length_4587_cov_14.431150	1294	1370	80	1	76	0.0131579
NODE_248_length_4587_cov_14.431150	1294	1370	82	3	76	0.0394737
NODE_248_length_4587_cov_14.431150	1294	1370	84	6	76	0.0789474
NODE_248_length_4587_cov_14.431150	1294	1370	85	1	76	0.0131579
NODE_248_length_4587_cov_14.431150	1294	1370	86	4	76	0.0526316
NODE_248_length_4587_cov_14.431150	1294	1370	88	1	76	0.0131579
NODE_248_length_4587_cov_14.431150	1347	1427	72	1	80	0.0125000
NODE_248_length_4587_cov_14.431150	1347	1427	74	2	80	0.0250000
NODE_248_length_4587_cov_14.431150	1347	1427	76	3	80	0.0375000
NODE_248_length_4587_cov_14.431150	1347	1427	78	1	80	0.0125000
NODE_248_length_4587_cov_14.431150	1347	1427	80	1	80	0.0125000
NODE_248_length_4587_cov_14.431150	1347	1427	82	3	80	0.0375000
NODE_248_length_4587_cov_14.431150	1347	1427	84	8	80	0.1000000
NODE_248_length_4587_cov_14.431150	1347	1427	85	1	80	0.0125000
NODE_248_length_4587_cov_14.431150	1347	1427	86	4	80	0.0500000
NODE_248_length_4587_cov_14.431150	1347	1427	88	3	80	0.0375000
NODE_248_length_4587_cov_14.431150	1347	1427	90	17	80	0.2125000
NODE_248_length_4587_cov_14.431150	1347	1427	91	2	80	0.0250000
NODE_248_length_4587_cov_14.431150	1347	1427	92	6	80	0.0750000
NODE_248_length_4587_cov_14.431150	1347	1427	94	12	80	0.1500000
NODE_248_length_4587_cov_14.431150	1347	1427	95	5	80	0.0625000
NODE_248_length_4587_cov_14.431150	1347	1427	96	7	80	0.0875000
NODE_248_length_4587_cov_14.431150	1347	1427	97	2	80	0.0250000
NODE_248_length_4587_cov_14.431150	1347	1427	98	2	80	0.0250000
NODE_248_length_4587_cov_14.431150	1466	1533	95	1	67	0.0149254
NODE_248_length_4587_cov_14.431150	1466	1533	97	7	67	0.1044776
NODE_248_length_4587_cov_14.431150	1466	1533	98	2	67	0.0298507
NODE_248_length_4587_cov_14.431150	1466	1533	99	2	67	0.0298507
NODE_248_length_4587_cov_14.431150	1466	1533	100	9	67	0.1343284
NODE_248_length_4587_cov_14.431150	1466	1533	101	1	67	0.0149254
NODE_248_length_4587_cov_14.431150	1466	1533	102	5	67	0.0746269
NODE_248_length_4587_cov_14.431150	1466	1533	103	1	67	0.0149254
NODE_248_length_4587_cov_14.431150	1466	1533	104	18	67	0.2686567
NODE_248_length_4587_cov_14.431150	1466	1533	105	1	67	0.0149254
NODE_248_length_4587_cov_14.431150	1466	1533	106	6	67	0.0895522
NODE_248_length_4587_cov_14.431150	1466	1533	108	13	67	0.1940299
NODE_248_length_4587_cov_14.431150	1466	1533	110	1	67	0.0149254
NODE_248_length_4587_cov_14.431150	4316	4382	96	1	66	0.0151515
NODE_248_length_4587_cov_14.431150	4316	4382	98	1	66	0.0151515
NODE_248_length_4587_cov_14.431150	4316	4382	102	2	66	0.0303030
NODE_248_length_4587_cov_14.431150	4316	4382	106	2	66	0.0303030
NODE_248_length_4587_cov_14.431150	4316	4382	110	1	66	0.0151515
NODE_248_length_4587_cov_14.431150	4316	4382	116	1	66	0.0151515
NODE_248_length_4587_cov_14.431150	4316	4382	118	1	66	0.0151515
NODE_248_length_4587_cov_14.431150	4316	4382	120	2	66	0.0303030
NODE_248_length_4587_cov_14.431150	4316	4382	122	1	66	0.0151515
NODE_248_length_4587_cov_14.431150	4316	4382	136	1	66	0.0151515
NODE_248_length_4587_cov_14.431150	4316	4382	138	1	66	0.0151515
NODE_248_length_4587_cov_14.431150	4316	4382	140	1	66	0.0151515
NODE_248_length_4587_cov_14.431150	4316	4382	146	1	66	0.0151515
NODE_248_length_4587_cov_14.431150	4316	4382	162	1	66	0.0151515
NODE_248_length_4587_cov_14.431150	4316	4382	166	1	66	0.0151515
NODE_248_length_4587_cov_14.431150	4316	4382	176	1	66	0.0151515
NODE_248_length_4587_cov_14.431150	4316	4382	186	4	66	0.0606061
NODE_248_length_4587_cov_14.431150	4316	4382	189	1	66	0.0151515
NODE_248_length_4587_cov_14.431150	4316	4382	191	1	66	0.0151515
NODE_248_length_4587_cov_14.431150	4316	4382	196	1	66	0.0151515
NODE_248_length_4587_cov_14.431150	4316	4382	197	1	66	0.0151515
NODE_248_length_4587_cov_14.431150	4316	4382	198	1	66	0.0151515
NODE_248_length_4587_cov_14.431150	4316	4382	200	1	66	0.0151515
NODE_248_length_4587_cov_14.431150	4316	4382	213	1	66	0.0151515
NODE_248_length_4587_cov_14.431150	4316	4382	220	1	66	0.0151515
NODE_248_length_4587_cov_14.431150	4316	4382	232	1	66	0.0151515
NODE_248_length_4587_cov_14.431150	4316	4382	238	1	66	0.0151515
NODE_248_length_4587_cov_14.431150	4316	4382	244	1	66	0.0151515
NODE_248_length_4587_cov_14.431150	4316	4382	258	1	66	0.0151515
NODE_248_length_4587_cov_14.431150	4316	4382	261	1	66	0.0151515
NODE_248_length_4587_cov_14.431150	4316	4382	267	1	66	0.0151515
NODE_248_length_4587_cov_14.431150	4316	4382	272	1	66	0.0151515
NODE_248_length_4587_cov_14.431150	4316	4382	278	1	66	0.0151515
NODE_248_length_4587_cov_14.431150	4316	4382	282	1	66	0.0151515
NODE_248_length_4587_cov_14.431150	4316	4382	292	1	66	0.0151515
NODE_248_length_4587_cov_14.431150	4316	4382	294	1	66	0.0151515
NODE_248_length_4587_cov_14.431150	4316	4382	299	1	66	0.0151515
NODE_248_length_4587_cov_14.431150	4316	4382	306	1	66	0.0151515
NODE_248_length_4587_cov_14.431150	4316	4382	309	2	66	0.0303030
NODE_248_length_4587_cov_14.431150	4316	4382	312	5	66	0.0757576
NODE_248_length_4587_cov_14.431150	4316	4382	313	1	66	0.0151515
NODE_248_length_4587_cov_14.431150	4316	4382	314	9	66	0.1363636
NODE_248_length_4587_cov_14.431150	4316	4382	315	1	66	0.0151515
NODE_248_length_4587_cov_14.431150	4316	4382	316	2	66	0.0303030
NODE_248_length_4587_cov_14.431150	4316	4382	317	2	66	0.0303030
NODE_248_length_4587_cov_14.431150	4355	4435	250	1	80	0.0125000
NODE_248_length_4587_cov_14.431150	4355	4435	254	1	80	0.0125000
NODE_248_length_4587_cov_14.431150	4355	4435	259	1	80	0.0125000
NODE_248_length_4587_cov_14.431150	4355	4435	272	1	80	0.0125000
NODE_248_length_4587_cov_14.431150	4355	4435	274	1	80	0.0125000
NODE_248_length_4587_cov_14.431150	4355	4435	280	1	80	0.0125000
NODE_248_length_4587_cov_14.431150	4355	4435	282	1	80	0.0125000
NODE_248_length_4587_cov_14.431150	4355	4435	292	1	80	0.0125000
NODE_248_length_4587_cov_14.431150	4355	4435	294	1	80	0.0125000
NODE_248_length_4587_cov_14.431150	4355	4435	297	1	80	0.0125000
NODE_248_length_4587_cov_14.431150	4355	4435	299	1	80	0.0125000
NODE_248_length_4587_cov_14.431150	4355	4435	300	1	80	0.0125000
NODE_248_length_4587_cov_14.431150	4355	4435	306	2	80	0.0250000
NODE_248_length_4587_cov_14.431150	4355	4435	309	2	80	0.0250000
NODE_248_length_4587_cov_14.431150	4355	4435	312	9	80	0.1125000
NODE_248_length_4587_cov_14.431150	4355	4435	313	1	80	0.0125000
NODE_248_length_4587_cov_14.431150	4355	4435	314	10	80	0.1250000
NODE_248_length_4587_cov_14.431150	4355	4435	315	1	80	0.0125000
NODE_248_length_4587_cov_14.431150	4355	4435	316	2	80	0.0250000
NODE_248_length_4587_cov_14.431150	4355	4435	317	4	80	0.0500000
NODE_248_length_4587_cov_14.431150	4355	4435	320	2	80	0.0250000
NODE_248_length_4587_cov_14.431150	4355	4435	322	2	80	0.0250000
NODE_248_length_4587_cov_14.431150	4355	4435	323	1	80	0.0125000
NODE_248_length_4587_cov_14.431150	4355	4435	324	1	80	0.0125000
NODE_248_length_4587_cov_14.431150	4355	4435	326	1	80	0.0125000
NODE_248_length_4587_cov_14.431150	4355	4435	327	5	80	0.0625000
NODE_248_length_4587_cov_14.431150	4355	4435	329	3	80	0.0375000
NODE_248_length_4587_cov_14.431150	4355	4435	335	3	80	0.0375000
NODE_248_length_4587_cov_14.431150	4355	4435	336	2	80	0.0250000
NODE_248_length_4587_cov_14.431150	4355	4435	339	4	80	0.0500000
NODE_248_length_4587_cov_14.431150	4355	4435	340	2	80	0.0250000
NODE_248_length_4587_cov_14.431150	4355	4435	341	8	80	0.1000000
NODE_248_length_4587_cov_14.431150	4355	4435	342	2	80	0.0250000
NODE_248_length_4587_cov_14.431150	4355	4435	343	1	80	0.0125000
NODE_249_length_4572_cov_50.244579	2406	2483	4	2	77	0.0259740
NODE_249_length_4572_cov_50.244579	2406	2483	6	6	77	0.0779221
NODE_249_length_4572_cov_50.244579	2406	2483	8	69	77	0.8961039
NODE_249_length_4572_cov_50.244579	2406	2483	4	2	77	0.0259740
NODE_249_length_4572_cov_50.244579	2406	2483	6	6	77	0.0779221
NODE_249_length_4572_cov_50.244579	2406	2483	8	69	77	0.8961039
NODE_251_length_4556_cov_14.556652	4229	4288	30	2	59	0.0338983
NODE_251_length_4556_cov_14.556652	4229	4288	32	9	59	0.1525424
NODE_251_length_4556_cov_14.556652	4229	4288	34	14	59	0.2372881
NODE_251_length_4556_cov_14.556652	4229	4288	36	1	59	0.0169492
NODE_251_length_4556_cov_14.556652	4229	4288	38	9	59	0.1525424
NODE_251_length_4556_cov_14.556652	4229	4288	40	16	59	0.2711864
NODE_251_length_4556_cov_14.556652	4229	4288	42	4	59	0.0677966
NODE_251_length_4556_cov_14.556652	4229	4288	44	4	59	0.0677966
NODE_252_length_4550_cov_5.664120	3548	3628	0	80	80	1.0000000
NODE_252_length_4550_cov_5.664120	3601	3681	0	80	80	1.0000000
NODE_253_length_4544_cov_10.690439	353	433	0	37	80	0.4625000
NODE_253_length_4544_cov_10.690439	353	433	4	43	80	0.5375000
NODE_253_length_4544_cov_10.690439	406	486	4	80	80	1.0000000
NODE_253_length_4544_cov_10.690439	4487	4544	0	55	57	0.9649123
NODE_253_length_4544_cov_10.690439	4487	4544	10	2	57	0.0350877
NODE_255_length_4535_cov_24.849188	675	755	0	23	80	0.2875000
NODE_255_length_4535_cov_24.849188	675	755	2	57	80	0.7125000
NODE_255_length_4535_cov_24.849188	728	809	0	77	81	0.9506173
NODE_255_length_4535_cov_24.849188	728	809	2	4	81	0.0493827
NODE_255_length_4535_cov_24.849188	1319	1399	0	80	80	1.0000000
NODE_255_length_4535_cov_24.849188	1372	1452	0	44	80	0.5500000
NODE_255_length_4535_cov_24.849188	1372	1452	2	5	80	0.0625000
NODE_255_length_4535_cov_24.849188	1372	1452	4	2	80	0.0250000
NODE_255_length_4535_cov_24.849188	1372	1452	9	1	80	0.0125000
NODE_255_length_4535_cov_24.849188	1372	1452	11	1	80	0.0125000
NODE_255_length_4535_cov_24.849188	1372	1452	13	1	80	0.0125000
NODE_255_length_4535_cov_24.849188	1372	1452	15	3	80	0.0375000
NODE_255_length_4535_cov_24.849188	1372	1452	21	2	80	0.0250000
NODE_255_length_4535_cov_24.849188	1372	1452	25	1	80	0.0125000
NODE_255_length_4535_cov_24.849188	1372	1452	27	3	80	0.0375000
NODE_255_length_4535_cov_24.849188	1372	1452	31	3	80	0.0375000
NODE_255_length_4535_cov_24.849188	1372	1452	33	3	80	0.0375000
NODE_255_length_4535_cov_24.849188	1372	1452	35	1	80	0.0125000
NODE_255_length_4535_cov_24.849188	1372	1452	36	1	80	0.0125000
NODE_255_length_4535_cov_24.849188	1372	1452	37	3	80	0.0375000
NODE_255_length_4535_cov_24.849188	1372	1452	38	2	80	0.0250000
NODE_255_length_4535_cov_24.849188	1372	1452	43	2	80	0.0250000
NODE_255_length_4535_cov_24.849188	1372	1452	47	2	80	0.0250000
NODE_258_length_4528_cov_19.736509	4295	4366	0	67	71	0.9436620
NODE_258_length_4528_cov_19.736509	4295	4366	4	1	71	0.0140845
NODE_258_length_4528_cov_19.736509	4295	4366	8	1	71	0.0140845
NODE_258_length_4528_cov_19.736509	4295	4366	9	1	71	0.0140845
NODE_258_length_4528_cov_19.736509	4295	4366	23	1	71	0.0140845
NODE_259_length_4505_cov_10.409215	3166	3202	8	4	36	0.1111111
NODE_259_length_4505_cov_10.409215	3166	3202	10	8	36	0.2222222
NODE_259_length_4505_cov_10.409215	3166	3202	12	8	36	0.2222222
NODE_259_length_4505_cov_10.409215	3166	3202	14	8	36	0.2222222
NODE_259_length_4505_cov_10.409215	3166	3202	18	6	36	0.1666667
NODE_259_length_4505_cov_10.409215	3166	3202	20	2	36	0.0555556
NODE_259_length_4505_cov_10.409215	3175	3255	10	3	80	0.0375000
NODE_259_length_4505_cov_10.409215	3175	3255	12	8	80	0.1000000
NODE_259_length_4505_cov_10.409215	3175	3255	14	8	80	0.1000000
NODE_259_length_4505_cov_10.409215	3175	3255	18	6	80	0.0750000
NODE_259_length_4505_cov_10.409215	3175	3255	20	3	80	0.0375000
NODE_259_length_4505_cov_10.409215	3175	3255	22	8	80	0.1000000
NODE_259_length_4505_cov_10.409215	3175	3255	24	19	80	0.2375000
NODE_259_length_4505_cov_10.409215	3175	3255	26	7	80	0.0875000
NODE_259_length_4505_cov_10.409215	3175	3255	28	4	80	0.0500000
NODE_259_length_4505_cov_10.409215	3175	3255	30	14	80	0.1750000
NODE_260_length_4498_cov_8.216185	3161	3219	0	58	58	1.0000000
NODE_260_length_4498_cov_8.216185	4257	4314	2	57	57	1.0000000
NODE_263_length_4476_cov_29.825451	141	215	0	44	74	0.5945946
NODE_263_length_4476_cov_29.825451	141	215	2	30	74	0.4054054
NODE_263_length_4476_cov_29.825451	1890	1970	28	1	80	0.0125000
NODE_263_length_4476_cov_29.825451	1890	1970	30	10	80	0.1250000
NODE_263_length_4476_cov_29.825451	1890	1970	32	1	80	0.0125000
NODE_263_length_4476_cov_29.825451	1890	1970	33	4	80	0.0500000
NODE_263_length_4476_cov_29.825451	1890	1970	35	21	80	0.2625000
NODE_263_length_4476_cov_29.825451	1890	1970	36	2	80	0.0250000
NODE_263_length_4476_cov_29.825451	1890	1970	37	10	80	0.1250000
NODE_263_length_4476_cov_29.825451	1890	1970	39	12	80	0.1500000
NODE_263_length_4476_cov_29.825451	1890	1970	40	10	80	0.1250000
NODE_263_length_4476_cov_29.825451	1890	1970	41	5	80	0.0625000
NODE_263_length_4476_cov_29.825451	1890	1970	42	4	80	0.0500000
NODE_263_length_4476_cov_29.825451	1943	2023	18	13	80	0.1625000
NODE_263_length_4476_cov_29.825451	1943	2023	20	3	80	0.0375000
NODE_263_length_4476_cov_29.825451	1943	2023	22	2	80	0.0250000
NODE_263_length_4476_cov_29.825451	1943	2023	24	4	80	0.0500000
NODE_263_length_4476_cov_29.825451	1943	2023	26	5	80	0.0625000
NODE_263_length_4476_cov_29.825451	1943	2023	28	2	80	0.0250000
NODE_263_length_4476_cov_29.825451	1943	2023	30	4	80	0.0500000
NODE_263_length_4476_cov_29.825451	1943	2023	32	13	80	0.1625000
NODE_263_length_4476_cov_29.825451	1943	2023	34	3	80	0.0375000
NODE_263_length_4476_cov_29.825451	1943	2023	35	7	80	0.0875000
NODE_263_length_4476_cov_29.825451	1943	2023	36	5	80	0.0625000
NODE_263_length_4476_cov_29.825451	1943	2023	37	1	80	0.0125000
NODE_263_length_4476_cov_29.825451	1943	2023	40	10	80	0.1250000
NODE_263_length_4476_cov_29.825451	1943	2023	41	4	80	0.0500000
NODE_263_length_4476_cov_29.825451	1943	2023	42	4	80	0.0500000
NODE_264_length_4474_cov_17.051886	23	99	0	76	76	1.0000000
NODE_264_length_4474_cov_17.051886	23	98	0	75	75	1.0000000
NODE_264_length_4474_cov_17.051886	23	99	0	76	76	1.0000000
NODE_264_length_4474_cov_17.051886	32	99	0	67	67	1.0000000
NODE_264_length_4474_cov_17.051886	76	140	0	64	64	1.0000000
NODE_264_length_4474_cov_17.051886	1528	1569	33	6	41	0.1463415
NODE_264_length_4474_cov_17.051886	1528	1569	36	2	41	0.0487805
NODE_264_length_4474_cov_17.051886	1528	1569	38	4	41	0.0975610
NODE_264_length_4474_cov_17.051886	1528	1569	42	1	41	0.0243902
NODE_264_length_4474_cov_17.051886	1528	1569	46	3	41	0.0731707
NODE_264_length_4474_cov_17.051886	1528	1569	49	1	41	0.0243902
NODE_264_length_4474_cov_17.051886	1528	1569	51	2	41	0.0487805
NODE_264_length_4474_cov_17.051886	1528	1569	52	1	41	0.0243902
NODE_264_length_4474_cov_17.051886	1528	1569	55	1	41	0.0243902
NODE_264_length_4474_cov_17.051886	1528	1569	62	2	41	0.0487805
NODE_264_length_4474_cov_17.051886	1528	1569	64	3	41	0.0731707
NODE_264_length_4474_cov_17.051886	1528	1569	67	1	41	0.0243902
NODE_264_length_4474_cov_17.051886	1528	1569	71	1	41	0.0243902
NODE_264_length_4474_cov_17.051886	1528	1569	78	1	41	0.0243902
NODE_264_length_4474_cov_17.051886	1528	1569	79	1	41	0.0243902
NODE_264_length_4474_cov_17.051886	1528	1569	83	1	41	0.0243902
NODE_264_length_4474_cov_17.051886	1528	1569	84	1	41	0.0243902
NODE_264_length_4474_cov_17.051886	1528	1569	85	1	41	0.0243902
NODE_264_length_4474_cov_17.051886	1528	1569	88	1	41	0.0243902
NODE_264_length_4474_cov_17.051886	1528	1569	89	1	41	0.0243902
NODE_264_length_4474_cov_17.051886	1528	1569	93	1	41	0.0243902
NODE_264_length_4474_cov_17.051886	1528	1569	94	1	41	0.0243902
NODE_264_length_4474_cov_17.051886	1528	1569	95	1	41	0.0243902
NODE_264_length_4474_cov_17.051886	1528	1569	96	1	41	0.0243902
NODE_264_length_4474_cov_17.051886	1528	1569	97	1	41	0.0243902
NODE_264_length_4474_cov_17.051886	1528	1569	98	1	41	0.0243902
NODE_264_length_4474_cov_17.051886	1536	1609	12	1	73	0.0136986
NODE_264_length_4474_cov_17.051886	1536	1609	16	2	73	0.0273973
NODE_264_length_4474_cov_17.051886	1536	1609	18	7	73	0.0958904
NODE_264_length_4474_cov_17.051886	1536	1609	20	4	73	0.0547945
NODE_264_length_4474_cov_17.051886	1536	1609	22	3	73	0.0410959
NODE_264_length_4474_cov_17.051886	1536	1609	23	1	73	0.0136986
NODE_264_length_4474_cov_17.051886	1536	1609	25	2	73	0.0273973
NODE_264_length_4474_cov_17.051886	1536	1609	26	11	73	0.1506849
NODE_264_length_4474_cov_17.051886	1536	1609	27	2	73	0.0273973
NODE_264_length_4474_cov_17.051886	1536	1609	29	3	73	0.0410959
NODE_264_length_4474_cov_17.051886	1536	1609	31	2	73	0.0273973
NODE_264_length_4474_cov_17.051886	1536	1609	33	8	73	0.1095890
NODE_264_length_4474_cov_17.051886	1536	1609	36	2	73	0.0273973
NODE_264_length_4474_cov_17.051886	1536	1609	38	4	73	0.0547945
NODE_264_length_4474_cov_17.051886	1536	1609	42	1	73	0.0136986
NODE_264_length_4474_cov_17.051886	1536	1609	46	3	73	0.0410959
NODE_264_length_4474_cov_17.051886	1536	1609	49	1	73	0.0136986
NODE_264_length_4474_cov_17.051886	1536	1609	51	2	73	0.0273973
NODE_264_length_4474_cov_17.051886	1536	1609	52	1	73	0.0136986
NODE_264_length_4474_cov_17.051886	1536	1609	55	1	73	0.0136986
NODE_264_length_4474_cov_17.051886	1536	1609	62	2	73	0.0273973
NODE_264_length_4474_cov_17.051886	1536	1609	64	3	73	0.0410959
NODE_264_length_4474_cov_17.051886	1536	1609	67	1	73	0.0136986
NODE_264_length_4474_cov_17.051886	1536	1609	71	1	73	0.0136986
NODE_264_length_4474_cov_17.051886	1536	1609	78	1	73	0.0136986
NODE_264_length_4474_cov_17.051886	1536	1609	79	1	73	0.0136986
NODE_264_length_4474_cov_17.051886	1536	1609	83	1	73	0.0136986
NODE_264_length_4474_cov_17.051886	1536	1609	84	1	73	0.0136986
NODE_264_length_4474_cov_17.051886	1536	1609	85	1	73	0.0136986
NODE_264_length_4474_cov_17.051886	1618	1643	0	19	25	0.7600000
NODE_264_length_4474_cov_17.051886	1618	1643	3	1	25	0.0400000
NODE_264_length_4474_cov_17.051886	1618	1643	7	1	25	0.0400000
NODE_264_length_4474_cov_17.051886	1618	1643	8	4	25	0.1600000
NODE_264_length_4474_cov_17.051886	1618	1696	0	20	78	0.2564103
NODE_264_length_4474_cov_17.051886	1618	1696	1	52	78	0.6666667
NODE_264_length_4474_cov_17.051886	1618	1696	3	1	78	0.0128205
NODE_264_length_4474_cov_17.051886	1618	1696	7	1	78	0.0128205
NODE_264_length_4474_cov_17.051886	1618	1696	8	4	78	0.0512821
NODE_265_length_4474_cov_14.441829	282	362	0	31	80	0.3875000
NODE_265_length_4474_cov_14.441829	282	362	2	49	80	0.6125000
NODE_265_length_4474_cov_14.441829	335	415	0	76	80	0.9500000
NODE_265_length_4474_cov_14.441829	335	415	2	1	80	0.0125000
NODE_265_length_4474_cov_14.441829	335	415	8	1	80	0.0125000
NODE_265_length_4474_cov_14.441829	335	415	38	1	80	0.0125000
NODE_265_length_4474_cov_14.441829	335	415	48	1	80	0.0125000
NODE_265_length_4474_cov_14.441829	1522	1575	2	43	53	0.8113208
NODE_265_length_4474_cov_14.441829	1522	1575	4	6	53	0.1132075
NODE_265_length_4474_cov_14.441829	1522	1575	23	1	53	0.0188679
NODE_265_length_4474_cov_14.441829	1522	1575	25	1	53	0.0188679
NODE_265_length_4474_cov_14.441829	1522	1575	27	2	53	0.0377358
NODE_265_length_4474_cov_14.441829	1548	1623	2	21	75	0.2800000
NODE_265_length_4474_cov_14.441829	1548	1623	4	42	75	0.5600000
NODE_265_length_4474_cov_14.441829	1548	1623	6	9	75	0.1200000
NODE_265_length_4474_cov_14.441829	1548	1623	8	3	75	0.0400000
NODE_265_length_4474_cov_14.441829	3068	3121	0	6	53	0.1132075
NODE_265_length_4474_cov_14.441829	3068	3121	1	9	53	0.1698113
NODE_265_length_4474_cov_14.441829	3068	3121	2	4	53	0.0754717
NODE_265_length_4474_cov_14.441829	3068	3121	3	14	53	0.2641509
NODE_265_length_4474_cov_14.441829	3068	3121	4	1	53	0.0188679
NODE_265_length_4474_cov_14.441829	3068	3121	5	8	53	0.1509434
NODE_265_length_4474_cov_14.441829	3068	3121	6	11	53	0.2075472
NODE_268_length_4463_cov_7.023144	119	168	0	40	49	0.8163266
NODE_268_length_4463_cov_7.023144	119	168	2	1	49	0.0204082
NODE_268_length_4463_cov_7.023144	119	168	4	4	49	0.0816327
NODE_268_length_4463_cov_7.023144	119	168	6	1	49	0.0204082
NODE_268_length_4463_cov_7.023144	119	168	8	2	49	0.0408163
NODE_268_length_4463_cov_7.023144	119	168	12	1	49	0.0204082
NODE_270_length_4453_cov_16.820395	3383	3463	27	3	80	0.0375000
NODE_270_length_4453_cov_16.820395	3383	3463	29	1	80	0.0125000
NODE_270_length_4453_cov_16.820395	3383	3463	31	3	80	0.0375000
NODE_270_length_4453_cov_16.820395	3383	3463	33	1	80	0.0125000
NODE_270_length_4453_cov_16.820395	3383	3463	35	3	80	0.0375000
NODE_270_length_4453_cov_16.820395	3383	3463	37	18	80	0.2250000
NODE_270_length_4453_cov_16.820395	3383	3463	41	7	80	0.0875000
NODE_270_length_4453_cov_16.820395	3383	3463	43	5	80	0.0625000
NODE_270_length_4453_cov_16.820395	3383	3463	45	11	80	0.1375000
NODE_270_length_4453_cov_16.820395	3383	3463	46	5	80	0.0625000
NODE_270_length_4453_cov_16.820395	3383	3463	47	9	80	0.1125000
NODE_270_length_4453_cov_16.820395	3383	3463	48	3	80	0.0375000
NODE_270_length_4453_cov_16.820395	3383	3463	49	1	80	0.0125000
NODE_270_length_4453_cov_16.820395	3383	3463	50	8	80	0.1000000
NODE_270_length_4453_cov_16.820395	3383	3463	52	2	80	0.0250000
NODE_270_length_4453_cov_16.820395	3436	3496	15	1	60	0.0166667
NODE_270_length_4453_cov_16.820395	3436	3496	17	2	60	0.0333333
NODE_270_length_4453_cov_16.820395	3436	3496	19	2	60	0.0333333
NODE_270_length_4453_cov_16.820395	3436	3496	21	7	60	0.1166667
NODE_270_length_4453_cov_16.820395	3436	3496	23	6	60	0.1000000
NODE_270_length_4453_cov_16.820395	3436	3496	25	7	60	0.1166667
NODE_270_length_4453_cov_16.820395	3436	3496	27	11	60	0.1833333
NODE_270_length_4453_cov_16.820395	3436	3496	29	1	60	0.0166667
NODE_270_length_4453_cov_16.820395	3436	3496	31	3	60	0.0500000
NODE_270_length_4453_cov_16.820395	3436	3496	33	1	60	0.0166667
NODE_270_length_4453_cov_16.820395	3436	3496	35	3	60	0.0500000
NODE_270_length_4453_cov_16.820395	3436	3496	37	16	60	0.2666667
NODE_272_length_4436_cov_31.114595	2807	2871	2	5	64	0.0781250
NODE_272_length_4436_cov_31.114595	2807	2871	4	14	64	0.2187500
NODE_272_length_4436_cov_31.114595	2807	2871	6	3	64	0.0468750
NODE_272_length_4436_cov_31.114595	2807	2871	8	42	64	0.6562500
NODE_272_length_4436_cov_31.114595	2846	2906	0	34	60	0.5666667
NODE_272_length_4436_cov_31.114595	2846	2906	2	6	60	0.1000000
NODE_272_length_4436_cov_31.114595	2846	2906	4	14	60	0.2333333
NODE_272_length_4436_cov_31.114595	2846	2906	6	3	60	0.0500000
NODE_272_length_4436_cov_31.114595	2846	2906	8	3	60	0.0500000
NODE_272_length_4436_cov_31.114595	2846	2898	0	26	52	0.5000000
NODE_272_length_4436_cov_31.114595	2846	2898	2	6	52	0.1153846
NODE_272_length_4436_cov_31.114595	2846	2898	4	14	52	0.2692308
NODE_272_length_4436_cov_31.114595	2846	2898	6	3	52	0.0576923
NODE_272_length_4436_cov_31.114595	2846	2898	8	3	52	0.0576923
NODE_278_length_4391_cov_7.711323	66	141	0	8	75	0.1066667
NODE_278_length_4391_cov_7.711323	66	141	2	67	75	0.8933333
NODE_278_length_4391_cov_7.711323	119	155	0	17	36	0.4722222
NODE_278_length_4391_cov_7.711323	119	155	2	19	36	0.5277778
NODE_279_length_4385_cov_6.067662	1556	1606	0	4	50	0.0800000
NODE_279_length_4385_cov_6.067662	1556	1606	2	28	50	0.5600000
NODE_279_length_4385_cov_6.067662	1556	1606	4	18	50	0.3600000
NODE_286_length_4331_cov_37.938800	1898	1978	0	58	80	0.7250000
NODE_286_length_4331_cov_37.938800	1898	1978	2	7	80	0.0875000
NODE_286_length_4331_cov_37.938800	1898	1978	4	15	80	0.1875000
NODE_286_length_4331_cov_37.938800	1951	2031	0	5	80	0.0625000
NODE_286_length_4331_cov_37.938800	1951	2031	2	7	80	0.0875000
NODE_286_length_4331_cov_37.938800	1951	2031	4	18	80	0.2250000
NODE_286_length_4331_cov_37.938800	1951	2031	6	1	80	0.0125000
NODE_286_length_4331_cov_37.938800	1951	2031	8	7	80	0.0875000
NODE_286_length_4331_cov_37.938800	1951	2031	9	9	80	0.1125000
NODE_286_length_4331_cov_37.938800	1951	2031	11	1	80	0.0125000
NODE_286_length_4331_cov_37.938800	1951	2031	14	9	80	0.1125000
NODE_286_length_4331_cov_37.938800	1951	2031	15	1	80	0.0125000
NODE_286_length_4331_cov_37.938800	1951	2031	16	6	80	0.0750000
NODE_286_length_4331_cov_37.938800	1951	2031	20	5	80	0.0625000
NODE_286_length_4331_cov_37.938800	1951	2031	22	6	80	0.0750000
NODE_286_length_4331_cov_37.938800	1951	2031	23	2	80	0.0250000
NODE_286_length_4331_cov_37.938800	1951	2031	25	3	80	0.0375000
NODE_286_length_4331_cov_37.938800	2027	2107	23	1	80	0.0125000
NODE_286_length_4331_cov_37.938800	2027	2107	25	7	80	0.0875000
NODE_286_length_4331_cov_37.938800	2027	2107	27	5	80	0.0625000
NODE_286_length_4331_cov_37.938800	2027	2107	29	1	80	0.0125000
NODE_286_length_4331_cov_37.938800	2027	2107	35	2	80	0.0250000
NODE_286_length_4331_cov_37.938800	2027	2107	39	4	80	0.0500000
NODE_286_length_4331_cov_37.938800	2027	2107	47	1	80	0.0125000
NODE_286_length_4331_cov_37.938800	2027	2107	51	2	80	0.0250000
NODE_286_length_4331_cov_37.938800	2027	2107	57	1	80	0.0125000
NODE_286_length_4331_cov_37.938800	2027	2107	61	1	80	0.0125000
NODE_286_length_4331_cov_37.938800	2027	2107	63	2	80	0.0250000
NODE_286_length_4331_cov_37.938800	2027	2107	66	3	80	0.0375000
NODE_286_length_4331_cov_37.938800	2027	2107	72	2	80	0.0250000
NODE_286_length_4331_cov_37.938800	2027	2107	74	2	80	0.0250000
NODE_286_length_4331_cov_37.938800	2027	2107	75	1	80	0.0125000
NODE_286_length_4331_cov_37.938800	2027	2107	76	2	80	0.0250000
NODE_286_length_4331_cov_37.938800	2027	2107	78	1	80	0.0125000
NODE_286_length_4331_cov_37.938800	2027	2107	80	1	80	0.0125000
NODE_286_length_4331_cov_37.938800	2027	2107	82	1	80	0.0125000
NODE_286_length_4331_cov_37.938800	2027	2107	84	4	80	0.0500000
NODE_286_length_4331_cov_37.938800	2027	2107	86	3	80	0.0375000
NODE_286_length_4331_cov_37.938800	2027	2107	89	1	80	0.0125000
NODE_286_length_4331_cov_37.938800	2027	2107	90	2	80	0.0250000
NODE_286_length_4331_cov_37.938800	2027	2107	94	2	80	0.0250000
NODE_286_length_4331_cov_37.938800	2027	2107	96	8	80	0.1000000
NODE_286_length_4331_cov_37.938800	2027	2107	97	8	80	0.1000000
NODE_286_length_4331_cov_37.938800	2027	2107	98	6	80	0.0750000
NODE_286_length_4331_cov_37.938800	2027	2107	99	3	80	0.0375000
NODE_286_length_4331_cov_37.938800	2027	2107	102	1	80	0.0125000
NODE_286_length_4331_cov_37.938800	2027	2107	108	2	80	0.0250000
NODE_286_length_4331_cov_37.938800	2080	2160	46	1	80	0.0125000
NODE_286_length_4331_cov_37.938800	2080	2160	51	1	80	0.0125000
NODE_286_length_4331_cov_37.938800	2080	2160	52	2	80	0.0250000
NODE_286_length_4331_cov_37.938800	2080	2160	56	3	80	0.0375000
NODE_286_length_4331_cov_37.938800	2080	2160	57	1	80	0.0125000
NODE_286_length_4331_cov_37.938800	2080	2160	58	2	80	0.0250000
NODE_286_length_4331_cov_37.938800	2080	2160	61	1	80	0.0125000
NODE_286_length_4331_cov_37.938800	2080	2160	64	1	80	0.0125000
NODE_286_length_4331_cov_37.938800	2080	2160	68	1	80	0.0125000
NODE_286_length_4331_cov_37.938800	2080	2160	75	2	80	0.0250000
NODE_286_length_4331_cov_37.938800	2080	2160	77	3	80	0.0375000
NODE_286_length_4331_cov_37.938800	2080	2160	85	3	80	0.0375000
NODE_286_length_4331_cov_37.938800	2080	2160	86	2	80	0.0250000
NODE_286_length_4331_cov_37.938800	2080	2160	91	2	80	0.0250000
NODE_286_length_4331_cov_37.938800	2080	2160	93	1	80	0.0125000
NODE_286_length_4331_cov_37.938800	2080	2160	95	3	80	0.0375000
NODE_286_length_4331_cov_37.938800	2080	2160	96	7	80	0.0875000
NODE_286_length_4331_cov_37.938800	2080	2160	97	12	80	0.1500000
NODE_286_length_4331_cov_37.938800	2080	2160	98	6	80	0.0750000
NODE_286_length_4331_cov_37.938800	2080	2160	99	3	80	0.0375000
NODE_286_length_4331_cov_37.938800	2080	2160	101	3	80	0.0375000
NODE_286_length_4331_cov_37.938800	2080	2160	102	1	80	0.0125000
NODE_286_length_4331_cov_37.938800	2080	2160	103	4	80	0.0500000
NODE_286_length_4331_cov_37.938800	2080	2160	105	2	80	0.0250000
NODE_286_length_4331_cov_37.938800	2080	2160	106	10	80	0.1250000
NODE_286_length_4331_cov_37.938800	2080	2160	108	3	80	0.0375000
NODE_289_length_4320_cov_7.680881	442	522	0	80	80	1.0000000
NODE_289_length_4320_cov_7.680881	495	575	0	80	80	1.0000000
NODE_289_length_4320_cov_7.680881	571	651	0	80	80	1.0000000
NODE_289_length_4320_cov_7.680881	624	704	0	80	80	1.0000000
NODE_290_length_4314_cov_5.311507	1436	1516	0	7	80	0.0875000
NODE_290_length_4314_cov_5.311507	1436	1516	2	65	80	0.8125000
NODE_290_length_4314_cov_5.311507	1436	1516	4	8	80	0.1000000
NODE_290_length_4314_cov_5.311507	1489	1569	2	78	80	0.9750000
NODE_290_length_4314_cov_5.311507	1489	1569	4	2	80	0.0250000
NODE_290_length_4314_cov_5.311507	3331	3400	0	69	69	1.0000000
NODE_290_length_4314_cov_5.311507	3420	3482	4	62	62	1.0000000
NODE_292_length_4311_cov_8.733381	92	171	2	43	79	0.5443038
NODE_292_length_4311_cov_8.733381	92	171	4	36	79	0.4556962
NODE_292_length_4311_cov_8.733381	1925	2005	0	80	80	1.0000000
NODE_292_length_4311_cov_8.733381	1978	2058	0	80	80	1.0000000
NODE_294_length_4293_cov_3.809251	244	326	0	82	82	1.0000000
NODE_294_length_4293_cov_3.809251	301	394	0	93	93	1.0000000
NODE_295_length_4284_cov_15.940263	3726	3806	0	80	80	1.0000000
NODE_295_length_4284_cov_15.940263	3779	3858	0	79	79	1.0000000
NODE_299_length_4277_cov_5.451173	3818	3898	0	80	80	1.0000000
NODE_299_length_4277_cov_5.451173	3927	3995	0	5	68	0.0735294
NODE_299_length_4277_cov_5.451173	3927	3995	2	8	68	0.1176471
NODE_299_length_4277_cov_5.451173	3927	3995	4	55	68	0.8088235
NODE_299_length_4277_cov_5.451173	3968	4048	0	58	80	0.7250000
NODE_299_length_4277_cov_5.451173	3968	4048	2	8	80	0.1000000
NODE_299_length_4277_cov_5.451173	3968	4048	4	14	80	0.1750000
NODE_300_length_4274_cov_18.943234	591	671	0	8	80	0.1000000
NODE_300_length_4274_cov_18.943234	591	671	2	72	80	0.9000000
NODE_300_length_4274_cov_18.943234	644	724	0	38	80	0.4750000
NODE_300_length_4274_cov_18.943234	644	724	2	42	80	0.5250000
NODE_301_length_4274_cov_16.160958	416	496	0	47	80	0.5875000
NODE_301_length_4274_cov_16.160958	416	496	2	27	80	0.3375000
NODE_301_length_4274_cov_16.160958	416	496	4	6	80	0.0750000
NODE_301_length_4274_cov_16.160958	1034	1114	0	9	80	0.1125000
NODE_301_length_4274_cov_16.160958	1034	1114	1	34	80	0.4250000
NODE_301_length_4274_cov_16.160958	1034	1114	2	37	80	0.4625000
NODE_301_length_4274_cov_16.160958	1087	1167	0	25	80	0.3125000
NODE_301_length_4274_cov_16.160958	1087	1167	1	55	80	0.6875000
NODE_301_length_4274_cov_16.160958	1163	1243	0	80	80	1.0000000
NODE_301_length_4274_cov_16.160958	1216	1296	0	80	80	1.0000000
NODE_301_length_4274_cov_16.160958	3411	3491	0	20	80	0.2500000
NODE_301_length_4274_cov_16.160958	3411	3491	2	15	80	0.1875000
NODE_301_length_4274_cov_16.160958	3411	3491	4	7	80	0.0875000
NODE_301_length_4274_cov_16.160958	3411	3491	6	34	80	0.4250000
NODE_301_length_4274_cov_16.160958	3411	3491	10	2	80	0.0250000
NODE_301_length_4274_cov_16.160958	3411	3491	12	2	80	0.0250000
NODE_302_length_4270_cov_14.045792	3835	3915	55	1	80	0.0125000
NODE_302_length_4270_cov_14.045792	3835	3915	57	1	80	0.0125000
NODE_302_length_4270_cov_14.045792	3835	3915	59	2	80	0.0250000
NODE_302_length_4270_cov_14.045792	3835	3915	61	2	80	0.0250000
NODE_302_length_4270_cov_14.045792	3835	3915	63	4	80	0.0500000
NODE_302_length_4270_cov_14.045792	3835	3915	65	1	80	0.0125000
NODE_302_length_4270_cov_14.045792	3835	3915	67	5	80	0.0625000
NODE_302_length_4270_cov_14.045792	3835	3915	69	1	80	0.0125000
NODE_302_length_4270_cov_14.045792	3835	3915	71	1	80	0.0125000
NODE_302_length_4270_cov_14.045792	3835	3915	73	1	80	0.0125000
NODE_302_length_4270_cov_14.045792	3835	3915	75	2	80	0.0250000
NODE_302_length_4270_cov_14.045792	3835	3915	76	1	80	0.0125000
NODE_302_length_4270_cov_14.045792	3835	3915	81	1	80	0.0125000
NODE_302_length_4270_cov_14.045792	3835	3915	85	5	80	0.0625000
NODE_302_length_4270_cov_14.045792	3835	3915	87	9	80	0.1125000
NODE_302_length_4270_cov_14.045792	3835	3915	89	1	80	0.0125000
NODE_302_length_4270_cov_14.045792	3835	3915	91	1	80	0.0125000
NODE_302_length_4270_cov_14.045792	3835	3915	92	4	80	0.0500000
NODE_302_length_4270_cov_14.045792	3835	3915	93	7	80	0.0875000
NODE_302_length_4270_cov_14.045792	3835	3915	94	4	80	0.0500000
NODE_302_length_4270_cov_14.045792	3835	3915	95	1	80	0.0125000
NODE_302_length_4270_cov_14.045792	3835	3915	96	7	80	0.0875000
NODE_302_length_4270_cov_14.045792	3835	3915	97	1	80	0.0125000
NODE_302_length_4270_cov_14.045792	3835	3915	98	4	80	0.0500000
NODE_302_length_4270_cov_14.045792	3835	3915	99	3	80	0.0375000
NODE_302_length_4270_cov_14.045792	3835	3915	100	7	80	0.0875000
NODE_302_length_4270_cov_14.045792	3835	3915	102	3	80	0.0375000
NODE_302_length_4270_cov_14.045792	3888	3968	81	1	80	0.0125000
NODE_302_length_4270_cov_14.045792	3888	3968	83	2	80	0.0250000
NODE_302_length_4270_cov_14.045792	3888	3968	86	5	80	0.0625000
NODE_302_length_4270_cov_14.045792	3888	3968	87	3	80	0.0375000
NODE_302_length_4270_cov_14.045792	3888	3968	88	3	80	0.0375000
NODE_302_length_4270_cov_14.045792	3888	3968	89	2	80	0.0250000
NODE_302_length_4270_cov_14.045792	3888	3968	90	4	80	0.0500000
NODE_302_length_4270_cov_14.045792	3888	3968	91	6	80	0.0750000
NODE_302_length_4270_cov_14.045792	3888	3968	92	6	80	0.0750000
NODE_302_length_4270_cov_14.045792	3888	3968	94	4	80	0.0500000
NODE_302_length_4270_cov_14.045792	3888	3968	96	8	80	0.1000000
NODE_302_length_4270_cov_14.045792	3888	3968	97	3	80	0.0375000
NODE_302_length_4270_cov_14.045792	3888	3968	98	3	80	0.0375000
NODE_302_length_4270_cov_14.045792	3888	3968	99	13	80	0.1625000
NODE_302_length_4270_cov_14.045792	3888	3968	100	7	80	0.0875000
NODE_302_length_4270_cov_14.045792	3888	3968	101	5	80	0.0625000
NODE_302_length_4270_cov_14.045792	3888	3968	102	3	80	0.0375000
NODE_302_length_4270_cov_14.045792	3888	3968	103	2	80	0.0250000
NODE_303_length_4260_cov_24.780822	244	311	26	6	67	0.0895522
NODE_303_length_4260_cov_24.780822	244	311	28	2	67	0.0298507
NODE_303_length_4260_cov_24.780822	244	311	30	4	67	0.0597015
NODE_303_length_4260_cov_24.780822	244	311	32	2	67	0.0298507
NODE_303_length_4260_cov_24.780822	244	311	36	5	67	0.0746269
NODE_303_length_4260_cov_24.780822	244	311	40	3	67	0.0447761
NODE_303_length_4260_cov_24.780822	244	311	42	2	67	0.0298507
NODE_303_length_4260_cov_24.780822	244	311	44	6	67	0.0895522
NODE_303_length_4260_cov_24.780822	244	311	46	5	67	0.0746269
NODE_303_length_4260_cov_24.780822	244	311	48	32	67	0.4776119
NODE_303_length_4260_cov_24.780822	244	311	26	6	67	0.0895522
NODE_303_length_4260_cov_24.780822	244	311	28	2	67	0.0298507
NODE_303_length_4260_cov_24.780822	244	311	30	4	67	0.0597015
NODE_303_length_4260_cov_24.780822	244	311	32	2	67	0.0298507
NODE_303_length_4260_cov_24.780822	244	311	36	5	67	0.0746269
NODE_303_length_4260_cov_24.780822	244	311	40	3	67	0.0447761
NODE_303_length_4260_cov_24.780822	244	311	42	2	67	0.0298507
NODE_303_length_4260_cov_24.780822	244	311	44	6	67	0.0895522
NODE_303_length_4260_cov_24.780822	244	311	46	5	67	0.0746269
NODE_303_length_4260_cov_24.780822	244	311	48	32	67	0.4776119
NODE_303_length_4260_cov_24.780822	263	311	26	6	48	0.1250000
NODE_303_length_4260_cov_24.780822	263	311	28	2	48	0.0416667
NODE_303_length_4260_cov_24.780822	263	311	30	4	48	0.0833333
NODE_303_length_4260_cov_24.780822	263	311	32	2	48	0.0416667
NODE_303_length_4260_cov_24.780822	263	311	40	3	48	0.0625000
NODE_303_length_4260_cov_24.780822	263	311	44	3	48	0.0625000
NODE_303_length_4260_cov_24.780822	263	311	46	3	48	0.0625000
NODE_303_length_4260_cov_24.780822	263	311	48	25	48	0.5208333
NODE_303_length_4260_cov_24.780822	1605	1633	3	1	28	0.0357143
NODE_303_length_4260_cov_24.780822	1605	1633	5	8	28	0.2857143
NODE_303_length_4260_cov_24.780822	1605	1633	9	1	28	0.0357143
NODE_303_length_4260_cov_24.780822	1605	1633	10	8	28	0.2857143
NODE_303_length_4260_cov_24.780822	1605	1633	12	5	28	0.1785714
NODE_303_length_4260_cov_24.780822	1605	1633	16	1	28	0.0357143
NODE_303_length_4260_cov_24.780822	1605	1633	18	4	28	0.1428571
NODE_303_length_4260_cov_24.780822	1660	1699	22	1	39	0.0256410
NODE_303_length_4260_cov_24.780822	1660	1699	26	2	39	0.0512821
NODE_303_length_4260_cov_24.780822	1660	1699	28	1	39	0.0256410
NODE_303_length_4260_cov_24.780822	1660	1699	30	5	39	0.1282051
NODE_303_length_4260_cov_24.780822	1660	1699	32	1	39	0.0256410
NODE_303_length_4260_cov_24.780822	1660	1699	37	1	39	0.0256410
NODE_303_length_4260_cov_24.780822	1660	1699	38	1	39	0.0256410
NODE_303_length_4260_cov_24.780822	1660	1699	42	1	39	0.0256410
NODE_303_length_4260_cov_24.780822	1660	1699	44	4	39	0.1025641
NODE_303_length_4260_cov_24.780822	1660	1699	46	3	39	0.0769231
NODE_303_length_4260_cov_24.780822	1660	1699	48	2	39	0.0512821
NODE_303_length_4260_cov_24.780822	1660	1699	50	1	39	0.0256410
NODE_303_length_4260_cov_24.780822	1660	1699	52	1	39	0.0256410
NODE_303_length_4260_cov_24.780822	1660	1699	54	2	39	0.0512821
NODE_303_length_4260_cov_24.780822	1660	1699	58	6	39	0.1538462
NODE_303_length_4260_cov_24.780822	1660	1699	60	3	39	0.0769231
NODE_303_length_4260_cov_24.780822	1660	1699	62	3	39	0.0769231
NODE_303_length_4260_cov_24.780822	1660	1699	64	1	39	0.0256410
NODE_310_length_4207_cov_6.923564	3664	3722	3	5	58	0.0862069
NODE_310_length_4207_cov_6.923564	3664	3722	4	27	58	0.4655173
NODE_310_length_4207_cov_6.923564	3664	3722	5	2	58	0.0344828
NODE_310_length_4207_cov_6.923564	3664	3722	6	24	58	0.4137931
NODE_310_length_4207_cov_6.923564	3695	3775	3	58	80	0.7250000
NODE_310_length_4207_cov_6.923564	3695	3775	4	16	80	0.2000000
NODE_310_length_4207_cov_6.923564	3695	3775	5	2	80	0.0250000
NODE_310_length_4207_cov_6.923564	3695	3775	6	4	80	0.0500000
NODE_311_length_4205_cov_6.121042	592	632	2	40	40	1.0000000
NODE_311_length_4205_cov_6.121042	605	685	0	45	80	0.5625000
NODE_311_length_4205_cov_6.121042	605	685	2	35	80	0.4375000
NODE_311_length_4205_cov_6.121042	681	745	0	64	64	1.0000000
NODE_312_length_4196_cov_4.170857	340	420	0	80	80	1.0000000
NODE_312_length_4196_cov_4.170857	393	473	0	80	80	1.0000000
NODE_316_length_4179_cov_6.655882	1	65	4	2	64	0.0312500
NODE_316_length_4179_cov_6.655882	1	65	6	1	64	0.0156250
NODE_316_length_4179_cov_6.655882	1	65	10	2	64	0.0312500
NODE_316_length_4179_cov_6.655882	1	65	12	7	64	0.1093750
NODE_316_length_4179_cov_6.655882	1	65	16	2	64	0.0312500
NODE_316_length_4179_cov_6.655882	1	65	18	6	64	0.0937500
NODE_316_length_4179_cov_6.655882	1	65	20	1	64	0.0156250
NODE_316_length_4179_cov_6.655882	1	65	24	3	64	0.0468750
NODE_316_length_4179_cov_6.655882	1	65	26	3	64	0.0468750
NODE_316_length_4179_cov_6.655882	1	65	28	4	64	0.0625000
NODE_316_length_4179_cov_6.655882	1	65	30	5	64	0.0781250
NODE_316_length_4179_cov_6.655882	1	65	32	28	64	0.4375000
NODE_316_length_4179_cov_6.655882	1087	1140	0	6	53	0.1132075
NODE_316_length_4179_cov_6.655882	1087	1140	2	47	53	0.8867925
NODE_316_length_4179_cov_6.655882	1818	1898	2	56	80	0.7000000
NODE_316_length_4179_cov_6.655882	1818	1898	4	24	80	0.3000000
NODE_319_length_4150_cov_10.600099	2827	2849	52	1	22	0.0454545
NODE_319_length_4150_cov_10.600099	2827	2849	54	8	22	0.3636364
NODE_319_length_4150_cov_10.600099	2827	2849	56	13	22	0.5909091
NODE_319_length_4150_cov_10.600099	2973	3053	8	4	80	0.0500000
NODE_319_length_4150_cov_10.600099	2973	3053	10	27	80	0.3375000
NODE_319_length_4150_cov_10.600099	2973	3053	12	8	80	0.1000000
NODE_319_length_4150_cov_10.600099	2973	3053	14	3	80	0.0375000
NODE_319_length_4150_cov_10.600099	2973	3053	16	9	80	0.1125000
NODE_319_length_4150_cov_10.600099	2973	3053	18	5	80	0.0625000
NODE_319_length_4150_cov_10.600099	2973	3053	20	5	80	0.0625000
NODE_319_length_4150_cov_10.600099	2973	3053	21	1	80	0.0125000
NODE_319_length_4150_cov_10.600099	2973	3053	22	8	80	0.1000000
NODE_319_length_4150_cov_10.600099	2973	3053	23	3	80	0.0375000
NODE_319_length_4150_cov_10.600099	2973	3053	25	2	80	0.0250000
NODE_319_length_4150_cov_10.600099	2973	3053	27	5	80	0.0625000
NODE_319_length_4150_cov_10.600099	3026	3106	18	3	80	0.0375000
NODE_319_length_4150_cov_10.600099	3026	3106	20	6	80	0.0750000
NODE_319_length_4150_cov_10.600099	3026	3106	21	1	80	0.0125000
NODE_319_length_4150_cov_10.600099	3026	3106	22	14	80	0.1750000
NODE_319_length_4150_cov_10.600099	3026	3106	23	3	80	0.0375000
NODE_319_length_4150_cov_10.600099	3026	3106	24	9	80	0.1125000
NODE_319_length_4150_cov_10.600099	3026	3106	25	5	80	0.0625000
NODE_319_length_4150_cov_10.600099	3026	3106	26	2	80	0.0250000
NODE_319_length_4150_cov_10.600099	3026	3106	27	23	80	0.2875000
NODE_319_length_4150_cov_10.600099	3026	3106	29	14	80	0.1750000
NODE_324_length_4119_cov_27.984328	2818	2898	38	4	80	0.0500000
NODE_324_length_4119_cov_27.984328	2818	2898	40	1	80	0.0125000
NODE_324_length_4119_cov_27.984328	2818	2898	42	9	80	0.1125000
NODE_324_length_4119_cov_27.984328	2818	2898	44	1	80	0.0125000
NODE_324_length_4119_cov_27.984328	2818	2898	46	1	80	0.0125000
NODE_324_length_4119_cov_27.984328	2818	2898	48	1	80	0.0125000
NODE_324_length_4119_cov_27.984328	2818	2898	50	2	80	0.0250000
NODE_324_length_4119_cov_27.984328	2818	2898	52	1	80	0.0125000
NODE_324_length_4119_cov_27.984328	2818	2898	56	4	80	0.0500000
NODE_324_length_4119_cov_27.984328	2818	2898	60	4	80	0.0500000
NODE_324_length_4119_cov_27.984328	2818	2898	62	15	80	0.1875000
NODE_324_length_4119_cov_27.984328	2818	2898	64	5	80	0.0625000
NODE_324_length_4119_cov_27.984328	2818	2898	66	1	80	0.0125000
NODE_324_length_4119_cov_27.984328	2818	2898	68	11	80	0.1375000
NODE_324_length_4119_cov_27.984328	2818	2898	70	7	80	0.0875000
NODE_324_length_4119_cov_27.984328	2818	2898	72	6	80	0.0750000
NODE_324_length_4119_cov_27.984328	2818	2898	74	4	80	0.0500000
NODE_324_length_4119_cov_27.984328	2818	2898	76	1	80	0.0125000
NODE_324_length_4119_cov_27.984328	2818	2898	78	2	80	0.0250000
NODE_325_length_4108_cov_14.755550	378	422	0	4	44	0.0909091
NODE_325_length_4108_cov_14.755550	378	422	2	40	44	0.9090909
NODE_325_length_4108_cov_14.755550	3537	3617	0	1	80	0.0125000
NODE_325_length_4108_cov_14.755550	3537	3617	2	20	80	0.2500000
NODE_325_length_4108_cov_14.755550	3537	3617	4	44	80	0.5500000
NODE_325_length_4108_cov_14.755550	3537	3617	6	15	80	0.1875000
NODE_325_length_4108_cov_14.755550	3590	3670	2	7	80	0.0875000
NODE_325_length_4108_cov_14.755550	3590	3670	4	14	80	0.1750000
NODE_325_length_4108_cov_14.755550	3590	3670	6	59	80	0.7375000
NODE_326_length_4107_cov_1.855539	207	287	0	80	80	1.0000000
NODE_328_length_4096_cov_31.197648	379	459	4	42	80	0.5250000
NODE_328_length_4096_cov_31.197648	379	459	6	5	80	0.0625000
NODE_328_length_4096_cov_31.197648	379	459	10	33	80	0.4125000
NODE_328_length_4096_cov_31.197648	432	512	6	33	80	0.4125000
NODE_328_length_4096_cov_31.197648	432	512	8	3	80	0.0375000
NODE_328_length_4096_cov_31.197648	432	512	10	44	80	0.5500000
NODE_328_length_4096_cov_31.197648	3305	3385	0	80	80	1.0000000
NODE_328_length_4096_cov_31.197648	3358	3438	0	80	80	1.0000000
NODE_329_length_4081_cov_20.248870	3673	3753	2	5	80	0.0625000
NODE_329_length_4081_cov_20.248870	3673	3753	4	20	80	0.2500000
NODE_329_length_4081_cov_20.248870	3673	3753	6	28	80	0.3500000
NODE_329_length_4081_cov_20.248870	3673	3753	8	27	80	0.3375000
NODE_329_length_4081_cov_20.248870	3726	3806	0	32	80	0.4000000
NODE_329_length_4081_cov_20.248870	3726	3806	2	26	80	0.3250000
NODE_329_length_4081_cov_20.248870	3726	3806	4	20	80	0.2500000
NODE_329_length_4081_cov_20.248870	3726	3806	6	2	80	0.0250000
NODE_330_length_4076_cov_15.138044	1062	1142	2	65	80	0.8125000
NODE_330_length_4076_cov_15.138044	1062	1142	4	15	80	0.1875000
NODE_330_length_4076_cov_15.138044	1115	1195	2	15	80	0.1875000
NODE_330_length_4076_cov_15.138044	1115	1195	4	65	80	0.8125000
NODE_331_length_4069_cov_14.261209	3871	3936	4	22	65	0.3384615
NODE_331_length_4069_cov_14.261209	3871	3936	6	22	65	0.3384615
NODE_331_length_4069_cov_14.261209	3871	3936	8	21	65	0.3230769
NODE_333_length_4050_cov_31.044039	1703	1783	22	12	80	0.1500000
NODE_333_length_4050_cov_31.044039	1703	1783	24	5	80	0.0625000
NODE_333_length_4050_cov_31.044039	1703	1783	26	15	80	0.1875000
NODE_333_length_4050_cov_31.044039	1703	1783	28	17	80	0.2125000
NODE_333_length_4050_cov_31.044039	1703	1783	30	22	80	0.2750000
NODE_333_length_4050_cov_31.044039	1703	1783	32	5	80	0.0625000
NODE_333_length_4050_cov_31.044039	1703	1783	34	4	80	0.0500000
NODE_335_length_4021_cov_34.619072	379	459	0	15	80	0.1875000
NODE_335_length_4021_cov_34.619072	379	459	2	58	80	0.7250000
NODE_335_length_4021_cov_34.619072	379	459	4	7	80	0.0875000
NODE_335_length_4021_cov_34.619072	432	512	2	69	80	0.8625000
NODE_335_length_4021_cov_34.619072	432	512	4	11	80	0.1375000
NODE_336_length_4020_cov_5.130834	3455	3535	0	44	80	0.5500000
NODE_336_length_4020_cov_5.130834	3455	3535	2	36	80	0.4500000
NODE_336_length_4020_cov_5.130834	3508	3588	2	80	80	1.0000000
NODE_339_length_4004_cov_9.718054	387	467	0	48	80	0.6000000
NODE_339_length_4004_cov_9.718054	387	467	2	32	80	0.4000000
NODE_339_length_4004_cov_9.718054	440	520	0	80	80	1.0000000
NODE_339_length_4004_cov_9.718054	516	596	0	9	80	0.1125000
NODE_339_length_4004_cov_9.718054	516	596	1	14	80	0.1750000
NODE_339_length_4004_cov_9.718054	516	596	2	57	80	0.7125000
NODE_339_length_4004_cov_9.718054	569	649	2	80	80	1.0000000
NODE_341_length_3991_cov_18.617934	867	947	0	80	80	1.0000000
NODE_341_length_3991_cov_18.617934	920	1000	0	80	80	1.0000000
NODE_341_length_3991_cov_18.617934	996	1076	0	80	80	1.0000000
NODE_341_length_3991_cov_18.617934	1049	1124	0	75	75	1.0000000
NODE_348_length_3973_cov_6.906298	17	65	0	48	48	1.0000000
NODE_348_length_3973_cov_6.906298	1945	1995	0	7	50	0.1400000
NODE_348_length_3973_cov_6.906298	1945	1995	2	6	50	0.1200000
NODE_348_length_3973_cov_6.906298	1945	1995	4	13	50	0.2600000
NODE_348_length_3973_cov_6.906298	1945	1995	6	15	50	0.3000000
NODE_348_length_3973_cov_6.906298	1945	1995	8	9	50	0.1800000
NODE_350_length_3960_cov_6.246827	2673	2761	0	88	88	1.0000000
NODE_350_length_3960_cov_6.246827	3520	3600	0	42	80	0.5250000
NODE_350_length_3960_cov_6.246827	3520	3600	2	38	80	0.4750000
NODE_350_length_3960_cov_6.246827	3573	3653	2	80	80	1.0000000
NODE_353_length_3952_cov_8.805346	826	906	0	19	80	0.2375000
NODE_353_length_3952_cov_8.805346	826	906	2	61	80	0.7625000
NODE_353_length_3952_cov_8.805346	879	959	0	72	80	0.9000000
NODE_353_length_3952_cov_8.805346	879	959	2	8	80	0.1000000
NODE_354_length_3928_cov_5.936798	2440	2521	0	17	81	0.2098765
NODE_354_length_3928_cov_5.936798	2440	2521	2	64	81	0.7901235
NODE_354_length_3928_cov_5.936798	2493	2574	0	70	81	0.8641976
NODE_354_length_3928_cov_5.936798	2493	2574	2	11	81	0.1358025
NODE_356_length_3923_cov_14.807793	3759	3800	0	41	41	1.0000000
NODE_358_length_3922_cov_7.609731	1493	1573	30	5	80	0.0625000
NODE_358_length_3922_cov_7.609731	1493	1573	31	1	80	0.0125000
NODE_358_length_3922_cov_7.609731	1493	1573	33	2	80	0.0250000
NODE_358_length_3922_cov_7.609731	1493	1573	34	2	80	0.0250000
NODE_358_length_3922_cov_7.609731	1493	1573	35	3	80	0.0375000
NODE_358_length_3922_cov_7.609731	1493	1573	36	26	80	0.3250000
NODE_358_length_3922_cov_7.609731	1493	1573	38	12	80	0.1500000
NODE_358_length_3922_cov_7.609731	1493	1573	40	7	80	0.0875000
NODE_358_length_3922_cov_7.609731	1493	1573	42	16	80	0.2000000
NODE_358_length_3922_cov_7.609731	1493	1573	43	5	80	0.0625000
NODE_358_length_3922_cov_7.609731	1493	1573	45	1	80	0.0125000
NODE_358_length_3922_cov_7.609731	1546	1600	36	4	54	0.0740741
NODE_358_length_3922_cov_7.609731	1546	1600	38	1	54	0.0185185
NODE_358_length_3922_cov_7.609731	1546	1600	40	1	54	0.0185185
NODE_358_length_3922_cov_7.609731	1546	1600	42	15	54	0.2777778
NODE_358_length_3922_cov_7.609731	1546	1600	43	5	54	0.0925926
NODE_358_length_3922_cov_7.609731	1546	1600	44	1	54	0.0185185
NODE_358_length_3922_cov_7.609731	1546	1600	45	6	54	0.1111111
NODE_358_length_3922_cov_7.609731	1546	1600	46	5	54	0.0925926
NODE_358_length_3922_cov_7.609731	1546	1600	47	1	54	0.0185185
NODE_358_length_3922_cov_7.609731	1546	1600	48	3	54	0.0555556
NODE_358_length_3922_cov_7.609731	1546	1600	49	6	54	0.1111111
NODE_358_length_3922_cov_7.609731	1546	1600	50	5	54	0.0925926
NODE_358_length_3922_cov_7.609731	1546	1600	52	1	54	0.0185185
NODE_359_length_3921_cov_9.943223	2936	3016	161	1	80	0.0125000
NODE_359_length_3921_cov_9.943223	2936	3016	163	2	80	0.0250000
NODE_359_length_3921_cov_9.943223	2936	3016	165	3	80	0.0375000
NODE_359_length_3921_cov_9.943223	2936	3016	166	3	80	0.0375000
NODE_359_length_3921_cov_9.943223	2936	3016	167	2	80	0.0250000
NODE_359_length_3921_cov_9.943223	2936	3016	168	3	80	0.0375000
NODE_359_length_3921_cov_9.943223	2936	3016	169	1	80	0.0125000
NODE_359_length_3921_cov_9.943223	2936	3016	171	6	80	0.0750000
NODE_359_length_3921_cov_9.943223	2936	3016	173	2	80	0.0250000
NODE_359_length_3921_cov_9.943223	2936	3016	174	2	80	0.0250000
NODE_359_length_3921_cov_9.943223	2936	3016	176	1	80	0.0125000
NODE_359_length_3921_cov_9.943223	2936	3016	178	1	80	0.0125000
NODE_359_length_3921_cov_9.943223	2936	3016	188	1	80	0.0125000
NODE_359_length_3921_cov_9.943223	2936	3016	190	1	80	0.0125000
NODE_359_length_3921_cov_9.943223	2936	3016	194	3	80	0.0375000
NODE_359_length_3921_cov_9.943223	2936	3016	197	1	80	0.0125000
NODE_359_length_3921_cov_9.943223	2936	3016	199	1	80	0.0125000
NODE_359_length_3921_cov_9.943223	2936	3016	200	1	80	0.0125000
NODE_359_length_3921_cov_9.943223	2936	3016	201	1	80	0.0125000
NODE_359_length_3921_cov_9.943223	2936	3016	207	1	80	0.0125000
NODE_359_length_3921_cov_9.943223	2936	3016	209	1	80	0.0125000
NODE_359_length_3921_cov_9.943223	2936	3016	211	1	80	0.0125000
NODE_359_length_3921_cov_9.943223	2936	3016	216	2	80	0.0250000
NODE_359_length_3921_cov_9.943223	2936	3016	220	3	80	0.0375000
NODE_359_length_3921_cov_9.943223	2936	3016	222	3	80	0.0375000
NODE_359_length_3921_cov_9.943223	2936	3016	223	1	80	0.0125000
NODE_359_length_3921_cov_9.943223	2936	3016	224	2	80	0.0250000
NODE_359_length_3921_cov_9.943223	2936	3016	229	1	80	0.0125000
NODE_359_length_3921_cov_9.943223	2936	3016	230	3	80	0.0375000
NODE_359_length_3921_cov_9.943223	2936	3016	232	1	80	0.0125000
NODE_359_length_3921_cov_9.943223	2936	3016	233	2	80	0.0250000
NODE_359_length_3921_cov_9.943223	2936	3016	234	5	80	0.0625000
NODE_359_length_3921_cov_9.943223	2936	3016	235	4	80	0.0500000
NODE_359_length_3921_cov_9.943223	2936	3016	236	5	80	0.0625000
NODE_359_length_3921_cov_9.943223	2936	3016	237	2	80	0.0250000
NODE_359_length_3921_cov_9.943223	2936	3016	239	3	80	0.0375000
NODE_359_length_3921_cov_9.943223	2936	3016	240	1	80	0.0125000
NODE_359_length_3921_cov_9.943223	2936	3016	241	2	80	0.0250000
NODE_359_length_3921_cov_9.943223	2936	3016	245	1	80	0.0125000
NODE_359_length_3921_cov_9.943223	2989	3057	124	1	68	0.0147059
NODE_359_length_3921_cov_9.943223	2989	3057	126	1	68	0.0147059
NODE_359_length_3921_cov_9.943223	2989	3057	131	1	68	0.0147059
NODE_359_length_3921_cov_9.943223	2989	3057	132	1	68	0.0147059
NODE_359_length_3921_cov_9.943223	2989	3057	133	1	68	0.0147059
NODE_359_length_3921_cov_9.943223	2989	3057	135	1	68	0.0147059
NODE_359_length_3921_cov_9.943223	2989	3057	138	2	68	0.0294118
NODE_359_length_3921_cov_9.943223	2989	3057	146	1	68	0.0147059
NODE_359_length_3921_cov_9.943223	2989	3057	148	1	68	0.0147059
NODE_359_length_3921_cov_9.943223	2989	3057	152	1	68	0.0147059
NODE_359_length_3921_cov_9.943223	2989	3057	156	2	68	0.0294118
NODE_359_length_3921_cov_9.943223	2989	3057	164	1	68	0.0147059
NODE_359_length_3921_cov_9.943223	2989	3057	175	1	68	0.0147059
NODE_359_length_3921_cov_9.943223	2989	3057	179	1	68	0.0147059
NODE_359_length_3921_cov_9.943223	2989	3057	181	2	68	0.0294118
NODE_359_length_3921_cov_9.943223	2989	3057	183	2	68	0.0294118
NODE_359_length_3921_cov_9.943223	2989	3057	185	1	68	0.0147059
NODE_359_length_3921_cov_9.943223	2989	3057	192	3	68	0.0441176
NODE_359_length_3921_cov_9.943223	2989	3057	194	2	68	0.0294118
NODE_359_length_3921_cov_9.943223	2989	3057	204	1	68	0.0147059
NODE_359_length_3921_cov_9.943223	2989	3057	208	1	68	0.0147059
NODE_359_length_3921_cov_9.943223	2989	3057	210	1	68	0.0147059
NODE_359_length_3921_cov_9.943223	2989	3057	214	1	68	0.0147059
NODE_359_length_3921_cov_9.943223	2989	3057	216	2	68	0.0294118
NODE_359_length_3921_cov_9.943223	2989	3057	218	1	68	0.0147059
NODE_359_length_3921_cov_9.943223	2989	3057	221	2	68	0.0294118
NODE_359_length_3921_cov_9.943223	2989	3057	222	1	68	0.0147059
NODE_359_length_3921_cov_9.943223	2989	3057	223	2	68	0.0294118
NODE_359_length_3921_cov_9.943223	2989	3057	225	3	68	0.0441176
NODE_359_length_3921_cov_9.943223	2989	3057	227	2	68	0.0294118
NODE_359_length_3921_cov_9.943223	2989	3057	229	1	68	0.0147059
NODE_359_length_3921_cov_9.943223	2989	3057	232	1	68	0.0147059
NODE_359_length_3921_cov_9.943223	2989	3057	233	2	68	0.0294118
NODE_359_length_3921_cov_9.943223	2989	3057	234	3	68	0.0441176
NODE_359_length_3921_cov_9.943223	2989	3057	235	4	68	0.0588235
NODE_359_length_3921_cov_9.943223	2989	3057	236	5	68	0.0735294
NODE_359_length_3921_cov_9.943223	2989	3057	237	2	68	0.0294118
NODE_359_length_3921_cov_9.943223	2989	3057	239	3	68	0.0441176
NODE_359_length_3921_cov_9.943223	2989	3057	240	1	68	0.0147059
NODE_359_length_3921_cov_9.943223	2989	3057	241	2	68	0.0294118
NODE_359_length_3921_cov_9.943223	2989	3057	245	1	68	0.0147059
NODE_359_length_3921_cov_9.943223	3047	3066	96	1	19	0.0526316
NODE_359_length_3921_cov_9.943223	3047	3066	100	1	19	0.0526316
NODE_359_length_3921_cov_9.943223	3047	3066	108	2	19	0.1052632
NODE_359_length_3921_cov_9.943223	3047	3066	110	1	19	0.0526316
NODE_359_length_3921_cov_9.943223	3047	3066	114	2	19	0.1052632
NODE_359_length_3921_cov_9.943223	3047	3066	120	1	19	0.0526316
NODE_359_length_3921_cov_9.943223	3047	3066	122	1	19	0.0526316
NODE_359_length_3921_cov_9.943223	3047	3066	124	1	19	0.0526316
NODE_359_length_3921_cov_9.943223	3047	3066	126	1	19	0.0526316
NODE_359_length_3921_cov_9.943223	3047	3066	131	1	19	0.0526316
NODE_359_length_3921_cov_9.943223	3047	3066	132	1	19	0.0526316
NODE_359_length_3921_cov_9.943223	3047	3066	133	1	19	0.0526316
NODE_359_length_3921_cov_9.943223	3047	3066	135	1	19	0.0526316
NODE_359_length_3921_cov_9.943223	3047	3066	138	2	19	0.1052632
NODE_359_length_3921_cov_9.943223	3047	3066	146	1	19	0.0526316
NODE_359_length_3921_cov_9.943223	3047	3066	148	1	19	0.0526316
NODE_363_length_3898_cov_40.033167	3296	3370	14	8	74	0.1081081
NODE_363_length_3898_cov_40.033167	3296	3370	20	7	74	0.0945946
NODE_363_length_3898_cov_40.033167	3296	3370	22	5	74	0.0675676
NODE_363_length_3898_cov_40.033167	3296	3370	25	3	74	0.0405405
NODE_363_length_3898_cov_40.033167	3296	3370	33	13	74	0.1756757
NODE_363_length_3898_cov_40.033167	3296	3370	34	24	74	0.3243243
NODE_363_length_3898_cov_40.033167	3296	3370	35	14	74	0.1891892
NODE_363_length_3898_cov_40.033167	3539	3619	8	2	80	0.0250000
NODE_363_length_3898_cov_40.033167	3539	3619	9	6	80	0.0750000
NODE_363_length_3898_cov_40.033167	3539	3619	10	8	80	0.1000000
NODE_363_length_3898_cov_40.033167	3539	3619	11	20	80	0.2500000
NODE_363_length_3898_cov_40.033167	3539	3619	12	7	80	0.0875000
NODE_363_length_3898_cov_40.033167	3539	3619	13	1	80	0.0125000
NODE_363_length_3898_cov_40.033167	3539	3619	14	26	80	0.3250000
NODE_363_length_3898_cov_40.033167	3539	3619	15	1	80	0.0125000
NODE_363_length_3898_cov_40.033167	3539	3619	16	3	80	0.0375000
NODE_363_length_3898_cov_40.033167	3539	3619	17	1	80	0.0125000
NODE_363_length_3898_cov_40.033167	3539	3619	18	5	80	0.0625000
NODE_364_length_3898_cov_7.550145	668	748	1	8	80	0.1000000
NODE_364_length_3898_cov_7.550145	668	748	2	48	80	0.6000000
NODE_364_length_3898_cov_7.550145	668	748	3	11	80	0.1375000
NODE_364_length_3898_cov_7.550145	668	748	4	13	80	0.1625000
NODE_364_length_3898_cov_7.550145	721	801	2	3	80	0.0375000
NODE_364_length_3898_cov_7.550145	721	801	3	20	80	0.2500000
NODE_364_length_3898_cov_7.550145	721	801	4	52	80	0.6500000
NODE_364_length_3898_cov_7.550145	721	801	13	1	80	0.0125000
NODE_364_length_3898_cov_7.550145	721	801	15	1	80	0.0125000
NODE_364_length_3898_cov_7.550145	721	801	19	1	80	0.0125000
NODE_364_length_3898_cov_7.550145	721	801	23	2	80	0.0250000
NODE_367_length_3882_cov_4.166006	3244	3324	2	5	80	0.0625000
NODE_367_length_3882_cov_4.166006	3244	3324	4	13	80	0.1625000
NODE_367_length_3882_cov_4.166006	3244	3324	6	62	80	0.7750000
NODE_367_length_3882_cov_4.166006	3282	3324	2	5	42	0.1190476
NODE_367_length_3882_cov_4.166006	3282	3324	4	5	42	0.1190476
NODE_367_length_3882_cov_4.166006	3282	3324	6	32	42	0.7619048
NODE_367_length_3882_cov_4.166006	3297	3377	0	24	80	0.3000000
NODE_367_length_3882_cov_4.166006	3297	3377	2	34	80	0.4250000
NODE_367_length_3882_cov_4.166006	3297	3377	4	5	80	0.0625000
NODE_367_length_3882_cov_4.166006	3297	3377	6	17	80	0.2125000
NODE_367_length_3882_cov_4.166006	3297	3377	0	24	80	0.3000000
NODE_367_length_3882_cov_4.166006	3297	3377	2	34	80	0.4250000
NODE_367_length_3882_cov_4.166006	3297	3377	4	5	80	0.0625000
NODE_367_length_3882_cov_4.166006	3297	3377	6	17	80	0.2125000
NODE_367_length_3882_cov_4.166006	3373	3450	0	2	77	0.0259740
NODE_367_length_3882_cov_4.166006	3373	3450	2	2	77	0.0259740
NODE_367_length_3882_cov_4.166006	3373	3450	4	73	77	0.9480519
NODE_374_length_3853_cov_18.816196	524	579	6	10	55	0.1818182
NODE_374_length_3853_cov_18.816196	524	579	8	45	55	0.8181818
NODE_374_length_3853_cov_18.816196	559	639	0	24	80	0.3000000
NODE_374_length_3853_cov_18.816196	559	639	2	2	80	0.0250000
NODE_374_length_3853_cov_18.816196	559	639	4	1	80	0.0125000
NODE_374_length_3853_cov_18.816196	559	639	6	28	80	0.3500000
NODE_374_length_3853_cov_18.816196	559	639	8	25	80	0.3125000
NODE_379_length_3829_cov_12.697319	515	595	2	80	80	1.0000000
NODE_379_length_3829_cov_12.697319	568	648	0	36	80	0.4500000
NODE_379_length_3829_cov_12.697319	568	648	2	44	80	0.5500000
NODE_379_length_3829_cov_12.697319	644	724	0	80	80	1.0000000
NODE_379_length_3829_cov_12.697319	697	777	0	80	80	1.0000000
NODE_381_length_3815_cov_17.218784	399	479	0	80	80	1.0000000
NODE_381_length_3815_cov_17.218784	452	532	0	80	80	1.0000000
NODE_383_length_3812_cov_65.007272	840	903	4	1	63	0.0158730
NODE_383_length_3812_cov_65.007272	840	903	5	2	63	0.0317460
NODE_383_length_3812_cov_65.007272	840	903	7	2	63	0.0317460
NODE_383_length_3812_cov_65.007272	840	903	11	1	63	0.0158730
NODE_383_length_3812_cov_65.007272	840	903	12	3	63	0.0476190
NODE_383_length_3812_cov_65.007272	840	903	15	1	63	0.0158730
NODE_383_length_3812_cov_65.007272	840	903	16	1	63	0.0158730
NODE_383_length_3812_cov_65.007272	840	903	22	2	63	0.0317460
NODE_383_length_3812_cov_65.007272	840	903	23	1	63	0.0158730
NODE_383_length_3812_cov_65.007272	840	903	24	1	63	0.0158730
NODE_383_length_3812_cov_65.007272	840	903	26	2	63	0.0317460
NODE_383_length_3812_cov_65.007272	840	903	30	1	63	0.0158730
NODE_383_length_3812_cov_65.007272	840	903	31	1	63	0.0158730
NODE_383_length_3812_cov_65.007272	840	903	32	1	63	0.0158730
NODE_383_length_3812_cov_65.007272	840	903	36	3	63	0.0476190
NODE_383_length_3812_cov_65.007272	840	903	39	2	63	0.0317460
NODE_383_length_3812_cov_65.007272	840	903	44	1	63	0.0158730
NODE_383_length_3812_cov_65.007272	840	903	46	1	63	0.0158730
NODE_383_length_3812_cov_65.007272	840	903	49	2	63	0.0317460
NODE_383_length_3812_cov_65.007272	840	903	53	1	63	0.0158730
NODE_383_length_3812_cov_65.007272	840	903	58	2	63	0.0317460
NODE_383_length_3812_cov_65.007272	840	903	60	1	63	0.0158730
NODE_383_length_3812_cov_65.007272	840	903	61	2	63	0.0317460
NODE_383_length_3812_cov_65.007272	840	903	63	1	63	0.0158730
NODE_383_length_3812_cov_65.007272	840	903	65	1	63	0.0158730
NODE_383_length_3812_cov_65.007272	840	903	66	3	63	0.0476190
NODE_383_length_3812_cov_65.007272	840	903	67	1	63	0.0158730
NODE_383_length_3812_cov_65.007272	840	903	74	1	63	0.0158730
NODE_383_length_3812_cov_65.007272	840	903	76	1	63	0.0158730
NODE_383_length_3812_cov_65.007272	840	903	77	1	63	0.0158730
NODE_383_length_3812_cov_65.007272	840	903	78	2	63	0.0317460
NODE_383_length_3812_cov_65.007272	840	903	80	1	63	0.0158730
NODE_383_length_3812_cov_65.007272	840	903	84	1	63	0.0158730
NODE_383_length_3812_cov_65.007272	840	903	87	1	63	0.0158730
NODE_383_length_3812_cov_65.007272	840	903	89	6	63	0.0952381
NODE_383_length_3812_cov_65.007272	840	903	95	2	63	0.0317460
NODE_383_length_3812_cov_65.007272	840	903	97	1	63	0.0158730
NODE_383_length_3812_cov_65.007272	840	903	99	1	63	0.0158730
NODE_383_length_3812_cov_65.007272	840	903	100	1	63	0.0158730
NODE_383_length_3812_cov_65.007272	840	903	107	1	63	0.0158730
NODE_383_length_3812_cov_65.007272	840	903	109	2	63	0.0317460
NODE_384_length_3805_cov_9.533189	145	236	0	91	91	1.0000000
NODE_384_length_3805_cov_9.533189	209	279	0	70	70	1.0000000
NODE_386_length_3799_cov_10.046486	2944	3024	0	22	80	0.2750000
NODE_386_length_3799_cov_10.046486	2944	3024	4	38	80	0.4750000
NODE_386_length_3799_cov_10.046486	2944	3024	6	3	80	0.0375000
NODE_386_length_3799_cov_10.046486	2944	3024	10	4	80	0.0500000
NODE_386_length_3799_cov_10.046486	2944	3024	14	2	80	0.0250000
NODE_386_length_3799_cov_10.046486	2944	3024	16	5	80	0.0625000
NODE_386_length_3799_cov_10.046486	2944	3024	18	2	80	0.0250000
NODE_386_length_3799_cov_10.046486	2944	3024	22	2	80	0.0250000
NODE_386_length_3799_cov_10.046486	2944	3024	24	2	80	0.0250000
NODE_386_length_3799_cov_10.046486	2997	3077	0	75	80	0.9375000
NODE_386_length_3799_cov_10.046486	2997	3077	4	5	80	0.0625000
NODE_388_length_3795_cov_13.724297	3350	3430	0	80	80	1.0000000
NODE_388_length_3795_cov_13.724297	3403	3483	0	80	80	1.0000000
NODE_388_length_3795_cov_13.724297	3479	3562	0	7	83	0.0843373
NODE_388_length_3795_cov_13.724297	3479	3562	2	19	83	0.2289157
NODE_388_length_3795_cov_13.724297	3479	3562	4	7	83	0.0843373
NODE_388_length_3795_cov_13.724297	3479	3562	6	6	83	0.0722892
NODE_388_length_3795_cov_13.724297	3479	3562	8	44	83	0.5301205
NODE_388_length_3795_cov_13.724297	3479	3562	0	7	83	0.0843373
NODE_388_length_3795_cov_13.724297	3479	3562	2	19	83	0.2289157
NODE_388_length_3795_cov_13.724297	3479	3562	4	7	83	0.0843373
NODE_388_length_3795_cov_13.724297	3479	3562	6	6	83	0.0722892
NODE_388_length_3795_cov_13.724297	3479	3562	8	44	83	0.5301205
NODE_388_length_3795_cov_13.724297	3479	3552	0	7	73	0.0958904
NODE_388_length_3795_cov_13.724297	3479	3552	2	19	73	0.2602740
NODE_388_length_3795_cov_13.724297	3479	3552	4	7	73	0.0958904
NODE_388_length_3795_cov_13.724297	3479	3552	6	6	73	0.0821918
NODE_388_length_3795_cov_13.724297	3479	3552	8	34	73	0.4657534
NODE_388_length_3795_cov_13.724297	3535	3586	4	17	51	0.3333333
NODE_388_length_3795_cov_13.724297	3535	3586	8	34	51	0.6666667
NODE_388_length_3795_cov_13.724297	3535	3584	4	15	49	0.3061225
NODE_388_length_3795_cov_13.724297	3535	3584	8	34	49	0.6938776
NODE_388_length_3795_cov_13.724297	3698	3721	41	8	23	0.3478261
NODE_388_length_3795_cov_13.724297	3698	3721	42	15	23	0.6521739
NODE_394_length_3774_cov_7.720544	538	595	2	7	57	0.1228070
NODE_394_length_3774_cov_7.720544	538	595	4	27	57	0.4736842
NODE_394_length_3774_cov_7.720544	538	595	6	3	57	0.0526316
NODE_394_length_3774_cov_7.720544	538	595	8	20	57	0.3508772
NODE_404_length_3747_cov_3.328947	2230	2292	0	54	62	0.8709677
NODE_404_length_3747_cov_3.328947	2230	2292	2	8	62	0.1290323
NODE_406_length_3743_cov_38.767014	1354	1434	16	2	80	0.0250000
NODE_406_length_3743_cov_38.767014	1354	1434	22	2	80	0.0250000
NODE_406_length_3743_cov_38.767014	1354	1434	24	2	80	0.0250000
NODE_406_length_3743_cov_38.767014	1354	1434	27	1	80	0.0125000
NODE_406_length_3743_cov_38.767014	1354	1434	28	8	80	0.1000000
NODE_406_length_3743_cov_38.767014	1354	1434	32	5	80	0.0625000
NODE_406_length_3743_cov_38.767014	1354	1434	34	8	80	0.1000000
NODE_406_length_3743_cov_38.767014	1354	1434	36	11	80	0.1375000
NODE_406_length_3743_cov_38.767014	1354	1434	38	11	80	0.1375000
NODE_406_length_3743_cov_38.767014	1354	1434	42	12	80	0.1500000
NODE_406_length_3743_cov_38.767014	1354	1434	44	18	80	0.2250000
NODE_406_length_3743_cov_38.767014	1407	1487	14	5	80	0.0625000
NODE_406_length_3743_cov_38.767014	1407	1487	16	5	80	0.0625000
NODE_406_length_3743_cov_38.767014	1407	1487	18	2	80	0.0250000
NODE_406_length_3743_cov_38.767014	1407	1487	24	2	80	0.0250000
NODE_406_length_3743_cov_38.767014	1407	1487	26	4	80	0.0500000
NODE_406_length_3743_cov_38.767014	1407	1487	30	3	80	0.0375000
NODE_406_length_3743_cov_38.767014	1407	1487	32	3	80	0.0375000
NODE_406_length_3743_cov_38.767014	1407	1487	34	8	80	0.1000000
NODE_406_length_3743_cov_38.767014	1407	1487	36	10	80	0.1250000
NODE_406_length_3743_cov_38.767014	1407	1487	38	5	80	0.0625000
NODE_406_length_3743_cov_38.767014	1407	1487	42	13	80	0.1625000
NODE_406_length_3743_cov_38.767014	1407	1487	44	20	80	0.2500000
NODE_408_length_3733_cov_16.204458	186	249	0	51	63	0.8095238
NODE_408_length_3733_cov_16.204458	186	249	2	1	63	0.0158730
NODE_408_length_3733_cov_16.204458	186	249	4	4	63	0.0634921
NODE_408_length_3733_cov_16.204458	186	249	6	1	63	0.0158730
NODE_408_length_3733_cov_16.204458	186	249	8	1	63	0.0158730
NODE_408_length_3733_cov_16.204458	186	249	16	3	63	0.0476190
NODE_408_length_3733_cov_16.204458	186	249	18	1	63	0.0158730
NODE_408_length_3733_cov_16.204458	186	249	20	1	63	0.0158730
NODE_413_length_3707_cov_56.575665	2387	2467	0	2	80	0.0250000
NODE_413_length_3707_cov_56.575665	2387	2467	2	7	80	0.0875000
NODE_413_length_3707_cov_56.575665	2387	2467	4	71	80	0.8875000
NODE_413_length_3707_cov_56.575665	2440	2520	0	2	80	0.0250000
NODE_413_length_3707_cov_56.575665	2440	2520	2	12	80	0.1500000
NODE_413_length_3707_cov_56.575665	2440	2520	4	30	80	0.3750000
NODE_413_length_3707_cov_56.575665	2440	2520	8	8	80	0.1000000
NODE_413_length_3707_cov_56.575665	2440	2520	10	12	80	0.1500000
NODE_413_length_3707_cov_56.575665	2440	2520	14	1	80	0.0125000
NODE_413_length_3707_cov_56.575665	2440	2520	22	1	80	0.0125000
NODE_413_length_3707_cov_56.575665	2440	2520	23	1	80	0.0125000
NODE_413_length_3707_cov_56.575665	2440	2520	27	3	80	0.0375000
NODE_413_length_3707_cov_56.575665	2440	2520	29	6	80	0.0750000
NODE_413_length_3707_cov_56.575665	2440	2520	31	2	80	0.0250000
NODE_413_length_3707_cov_56.575665	2440	2520	33	2	80	0.0250000
NODE_413_length_3707_cov_56.575665	2516	2596	31	2	80	0.0250000
NODE_413_length_3707_cov_56.575665	2516	2596	33	3	80	0.0375000
NODE_413_length_3707_cov_56.575665	2516	2596	37	1	80	0.0125000
NODE_413_length_3707_cov_56.575665	2516	2596	38	2	80	0.0250000
NODE_413_length_3707_cov_56.575665	2516	2596	40	1	80	0.0125000
NODE_413_length_3707_cov_56.575665	2516	2596	44	1	80	0.0125000
NODE_413_length_3707_cov_56.575665	2516	2596	46	2	80	0.0250000
NODE_413_length_3707_cov_56.575665	2516	2596	47	1	80	0.0125000
NODE_413_length_3707_cov_56.575665	2516	2596	50	1	80	0.0125000
NODE_413_length_3707_cov_56.575665	2516	2596	52	3	80	0.0375000
NODE_413_length_3707_cov_56.575665	2516	2596	54	8	80	0.1000000
NODE_413_length_3707_cov_56.575665	2516	2596	56	4	80	0.0500000
NODE_413_length_3707_cov_56.575665	2516	2596	58	17	80	0.2125000
NODE_413_length_3707_cov_56.575665	2516	2596	62	5	80	0.0625000
NODE_413_length_3707_cov_56.575665	2516	2596	64	6	80	0.0750000
NODE_413_length_3707_cov_56.575665	2516	2596	66	8	80	0.1000000
NODE_413_length_3707_cov_56.575665	2516	2596	68	15	80	0.1875000
NODE_413_length_3707_cov_56.575665	2569	2649	16	7	80	0.0875000
NODE_413_length_3707_cov_56.575665	2569	2649	18	10	80	0.1250000
NODE_413_length_3707_cov_56.575665	2569	2649	22	10	80	0.1250000
NODE_413_length_3707_cov_56.575665	2569	2649	24	1	80	0.0125000
NODE_413_length_3707_cov_56.575665	2569	2649	26	1	80	0.0125000
NODE_413_length_3707_cov_56.575665	2569	2649	28	2	80	0.0250000
NODE_413_length_3707_cov_56.575665	2569	2649	32	3	80	0.0375000
NODE_413_length_3707_cov_56.575665	2569	2649	34	2	80	0.0250000
NODE_413_length_3707_cov_56.575665	2569	2649	36	3	80	0.0375000
NODE_413_length_3707_cov_56.575665	2569	2649	38	3	80	0.0375000
NODE_413_length_3707_cov_56.575665	2569	2649	44	1	80	0.0125000
NODE_413_length_3707_cov_56.575665	2569	2649	46	3	80	0.0375000
NODE_413_length_3707_cov_56.575665	2569	2649	51	1	80	0.0125000
NODE_413_length_3707_cov_56.575665	2569	2649	56	2	80	0.0250000
NODE_413_length_3707_cov_56.575665	2569	2649	58	3	80	0.0375000
NODE_413_length_3707_cov_56.575665	2569	2649	62	2	80	0.0250000
NODE_413_length_3707_cov_56.575665	2569	2649	64	6	80	0.0750000
NODE_413_length_3707_cov_56.575665	2569	2649	66	8	80	0.1000000
NODE_413_length_3707_cov_56.575665	2569	2649	68	12	80	0.1500000
NODE_416_length_3690_cov_7.476190	723	792	0	69	69	1.0000000
NODE_416_length_3690_cov_7.476190	776	855	0	79	79	1.0000000
NODE_419_length_3685_cov_7.011154	1966	2046	72	2	80	0.0250000
NODE_419_length_3685_cov_7.011154	1966	2046	73	8	80	0.1000000
NODE_419_length_3685_cov_7.011154	1966	2046	74	2	80	0.0250000
NODE_419_length_3685_cov_7.011154	1966	2046	75	14	80	0.1750000
NODE_419_length_3685_cov_7.011154	1966	2046	77	2	80	0.0250000
NODE_419_length_3685_cov_7.011154	1966	2046	79	3	80	0.0375000
NODE_419_length_3685_cov_7.011154	1966	2046	81	3	80	0.0375000
NODE_419_length_3685_cov_7.011154	1966	2046	83	4	80	0.0500000
NODE_419_length_3685_cov_7.011154	1966	2046	85	8	80	0.1000000
NODE_419_length_3685_cov_7.011154	1966	2046	87	2	80	0.0250000
NODE_419_length_3685_cov_7.011154	1966	2046	89	4	80	0.0500000
NODE_419_length_3685_cov_7.011154	1966	2046	95	2	80	0.0250000
NODE_419_length_3685_cov_7.011154	1966	2046	99	2	80	0.0250000
NODE_419_length_3685_cov_7.011154	1966	2046	101	6	80	0.0750000
NODE_419_length_3685_cov_7.011154	1966	2046	105	2	80	0.0250000
NODE_419_length_3685_cov_7.011154	1966	2046	107	3	80	0.0375000
NODE_419_length_3685_cov_7.011154	1966	2046	109	7	80	0.0875000
NODE_419_length_3685_cov_7.011154	1966	2046	111	2	80	0.0250000
NODE_419_length_3685_cov_7.011154	1966	2046	113	1	80	0.0125000
NODE_419_length_3685_cov_7.011154	1966	2046	114	1	80	0.0125000
NODE_419_length_3685_cov_7.011154	1966	2046	115	2	80	0.0250000
NODE_419_length_3685_cov_7.011154	2019	2086	72	2	67	0.0298507
NODE_419_length_3685_cov_7.011154	2019	2086	74	2	67	0.0298507
NODE_419_length_3685_cov_7.011154	2019	2086	76	1	67	0.0149254
NODE_419_length_3685_cov_7.011154	2019	2086	78	3	67	0.0447761
NODE_419_length_3685_cov_7.011154	2019	2086	80	1	67	0.0149254
NODE_419_length_3685_cov_7.011154	2019	2086	82	1	67	0.0149254
NODE_419_length_3685_cov_7.011154	2019	2086	88	1	67	0.0149254
NODE_419_length_3685_cov_7.011154	2019	2086	90	1	67	0.0149254
NODE_419_length_3685_cov_7.011154	2019	2086	91	1	67	0.0149254
NODE_419_length_3685_cov_7.011154	2019	2086	95	1	67	0.0149254
NODE_419_length_3685_cov_7.011154	2019	2086	97	1	67	0.0149254
NODE_419_length_3685_cov_7.011154	2019	2086	99	3	67	0.0447761
NODE_419_length_3685_cov_7.011154	2019	2086	101	9	67	0.1343284
NODE_419_length_3685_cov_7.011154	2019	2086	103	3	67	0.0447761
NODE_419_length_3685_cov_7.011154	2019	2086	105	4	67	0.0597015
NODE_419_length_3685_cov_7.011154	2019	2086	107	3	67	0.0447761
NODE_419_length_3685_cov_7.011154	2019	2086	108	1	67	0.0149254
NODE_419_length_3685_cov_7.011154	2019	2086	109	11	67	0.1641791
NODE_419_length_3685_cov_7.011154	2019	2086	110	5	67	0.0746269
NODE_419_length_3685_cov_7.011154	2019	2086	111	4	67	0.0597015
NODE_419_length_3685_cov_7.011154	2019	2086	112	2	67	0.0298507
NODE_419_length_3685_cov_7.011154	2019	2086	113	4	67	0.0597015
NODE_419_length_3685_cov_7.011154	2019	2086	114	1	67	0.0149254
NODE_419_length_3685_cov_7.011154	2019	2086	115	2	67	0.0298507
NODE_426_length_3667_cov_1089.047365	1634	1705	8	14	71	0.1971831
NODE_426_length_3667_cov_1089.047365	1634	1705	12	6	71	0.0845070
NODE_426_length_3667_cov_1089.047365	1634	1705	14	2	71	0.0281690
NODE_426_length_3667_cov_1089.047365	1634	1705	18	9	71	0.1267606
NODE_426_length_3667_cov_1089.047365	1634	1705	20	20	71	0.2816902
NODE_426_length_3667_cov_1089.047365	1634	1705	22	20	71	0.2816902
NODE_426_length_3667_cov_1089.047365	1678	1758	6	2	80	0.0250000
NODE_426_length_3667_cov_1089.047365	1678	1758	8	1	80	0.0125000
NODE_426_length_3667_cov_1089.047365	1678	1758	10	7	80	0.0875000
NODE_426_length_3667_cov_1089.047365	1678	1758	12	14	80	0.1750000
NODE_426_length_3667_cov_1089.047365	1678	1758	15	1	80	0.0125000
NODE_426_length_3667_cov_1089.047365	1678	1758	18	8	80	0.1000000
NODE_426_length_3667_cov_1089.047365	1678	1758	20	24	80	0.3000000
NODE_426_length_3667_cov_1089.047365	1678	1758	22	23	80	0.2875000
NODE_428_length_3660_cov_79.447627	1806	1870	84	1	64	0.0156250
NODE_428_length_3660_cov_79.447627	1806	1870	88	5	64	0.0781250
NODE_428_length_3660_cov_79.447627	1806	1870	90	5	64	0.0781250
NODE_428_length_3660_cov_79.447627	1806	1870	92	3	64	0.0468750
NODE_428_length_3660_cov_79.447627	1806	1870	94	4	64	0.0625000
NODE_428_length_3660_cov_79.447627	1806	1870	98	1	64	0.0156250
NODE_428_length_3660_cov_79.447627	1806	1870	100	2	64	0.0312500
NODE_428_length_3660_cov_79.447627	1806	1870	114	1	64	0.0156250
NODE_428_length_3660_cov_79.447627	1806	1870	115	6	64	0.0937500
NODE_428_length_3660_cov_79.447627	1806	1870	116	1	64	0.0156250
NODE_428_length_3660_cov_79.447627	1806	1870	118	1	64	0.0156250
NODE_428_length_3660_cov_79.447627	1806	1870	119	2	64	0.0312500
NODE_428_length_3660_cov_79.447627	1806	1870	121	1	64	0.0156250
NODE_428_length_3660_cov_79.447627	1806	1870	124	2	64	0.0312500
NODE_428_length_3660_cov_79.447627	1806	1870	125	1	64	0.0156250
NODE_428_length_3660_cov_79.447627	1806	1870	128	2	64	0.0312500
NODE_428_length_3660_cov_79.447627	1806	1870	130	6	64	0.0937500
NODE_428_length_3660_cov_79.447627	1806	1870	132	3	64	0.0468750
NODE_428_length_3660_cov_79.447627	1806	1870	133	1	64	0.0156250
NODE_428_length_3660_cov_79.447627	1806	1870	134	5	64	0.0781250
NODE_428_length_3660_cov_79.447627	1806	1870	136	3	64	0.0468750
NODE_428_length_3660_cov_79.447627	1806	1870	137	1	64	0.0156250
NODE_428_length_3660_cov_79.447627	1806	1870	138	1	64	0.0156250
NODE_428_length_3660_cov_79.447627	1806	1870	139	1	64	0.0156250
NODE_428_length_3660_cov_79.447627	1806	1870	140	2	64	0.0312500
NODE_428_length_3660_cov_79.447627	1806	1870	141	1	64	0.0156250
NODE_428_length_3660_cov_79.447627	1806	1870	142	1	64	0.0156250
NODE_428_length_3660_cov_79.447627	1806	1870	146	1	64	0.0156250
NODE_428_length_3660_cov_79.447627	1859	1906	134	1	47	0.0212766
NODE_428_length_3660_cov_79.447627	1859	1906	136	2	47	0.0425532
NODE_428_length_3660_cov_79.447627	1859	1906	137	1	47	0.0212766
NODE_428_length_3660_cov_79.447627	1859	1906	138	1	47	0.0212766
NODE_428_length_3660_cov_79.447627	1859	1906	139	1	47	0.0212766
NODE_428_length_3660_cov_79.447627	1859	1906	140	2	47	0.0425532
NODE_428_length_3660_cov_79.447627	1859	1906	141	1	47	0.0212766
NODE_428_length_3660_cov_79.447627	1859	1906	142	1	47	0.0212766
NODE_428_length_3660_cov_79.447627	1859	1906	146	1	47	0.0212766
NODE_428_length_3660_cov_79.447627	1859	1906	148	1	47	0.0212766
NODE_428_length_3660_cov_79.447627	1859	1906	150	1	47	0.0212766
NODE_428_length_3660_cov_79.447627	1859	1906	152	1	47	0.0212766
NODE_428_length_3660_cov_79.447627	1859	1906	154	2	47	0.0425532
NODE_428_length_3660_cov_79.447627	1859	1906	155	1	47	0.0212766
NODE_428_length_3660_cov_79.447627	1859	1906	156	1	47	0.0212766
NODE_428_length_3660_cov_79.447627	1859	1906	157	2	47	0.0425532
NODE_428_length_3660_cov_79.447627	1859	1906	158	1	47	0.0212766
NODE_428_length_3660_cov_79.447627	1859	1906	159	3	47	0.0638298
NODE_428_length_3660_cov_79.447627	1859	1906	162	2	47	0.0425532
NODE_428_length_3660_cov_79.447627	1859	1906	163	1	47	0.0212766
NODE_428_length_3660_cov_79.447627	1859	1906	164	1	47	0.0212766
NODE_428_length_3660_cov_79.447627	1859	1906	166	1	47	0.0212766
NODE_428_length_3660_cov_79.447627	1859	1906	170	13	47	0.2765957
NODE_428_length_3660_cov_79.447627	1859	1906	171	1	47	0.0212766
NODE_428_length_3660_cov_79.447627	1859	1906	172	3	47	0.0638298
NODE_428_length_3660_cov_79.447627	1859	1906	174	1	47	0.0212766
NODE_428_length_3660_cov_79.447627	2358	2438	0	80	80	1.0000000
NODE_428_length_3660_cov_79.447627	2411	2491	0	80	80	1.0000000
NODE_428_length_3660_cov_79.447627	2487	2567	0	80	80	1.0000000
NODE_428_length_3660_cov_79.447627	2540	2620	0	80	80	1.0000000
NODE_430_length_3634_cov_34.913154	1499	1544	41	2	45	0.0444444
NODE_430_length_3634_cov_34.913154	1499	1544	43	1	45	0.0222222
NODE_430_length_3634_cov_34.913154	1499	1544	45	1	45	0.0222222
NODE_430_length_3634_cov_34.913154	1499	1544	46	1	45	0.0222222
NODE_430_length_3634_cov_34.913154	1499	1544	47	3	45	0.0666667
NODE_430_length_3634_cov_34.913154	1499	1544	49	1	45	0.0222222
NODE_430_length_3634_cov_34.913154	1499	1544	50	2	45	0.0444444
NODE_430_length_3634_cov_34.913154	1499	1544	54	1	45	0.0222222
NODE_430_length_3634_cov_34.913154	1499	1544	57	2	45	0.0444444
NODE_430_length_3634_cov_34.913154	1499	1544	59	4	45	0.0888889
NODE_430_length_3634_cov_34.913154	1499	1544	61	1	45	0.0222222
NODE_430_length_3634_cov_34.913154	1499	1544	63	2	45	0.0444444
NODE_430_length_3634_cov_34.913154	1499	1544	65	1	45	0.0222222
NODE_430_length_3634_cov_34.913154	1499	1544	71	1	45	0.0222222
NODE_430_length_3634_cov_34.913154	1499	1544	79	1	45	0.0222222
NODE_430_length_3634_cov_34.913154	1499	1544	83	1	45	0.0222222
NODE_430_length_3634_cov_34.913154	1499	1544	89	1	45	0.0222222
NODE_430_length_3634_cov_34.913154	1499	1544	104	1	45	0.0222222
NODE_430_length_3634_cov_34.913154	1499	1544	120	1	45	0.0222222
NODE_430_length_3634_cov_34.913154	1499	1544	124	1	45	0.0222222
NODE_430_length_3634_cov_34.913154	1499	1544	128	1	45	0.0222222
NODE_430_length_3634_cov_34.913154	1499	1544	131	1	45	0.0222222
NODE_430_length_3634_cov_34.913154	1499	1544	139	1	45	0.0222222
NODE_430_length_3634_cov_34.913154	1499	1544	147	2	45	0.0444444
NODE_430_length_3634_cov_34.913154	1499	1544	148	1	45	0.0222222
NODE_430_length_3634_cov_34.913154	1499	1544	157	1	45	0.0222222
NODE_430_length_3634_cov_34.913154	1499	1544	159	1	45	0.0222222
NODE_430_length_3634_cov_34.913154	1499	1544	167	2	45	0.0444444
NODE_430_length_3634_cov_34.913154	1499	1544	169	1	45	0.0222222
NODE_430_length_3634_cov_34.913154	1499	1544	171	1	45	0.0222222
NODE_430_length_3634_cov_34.913154	1499	1544	176	1	45	0.0222222
NODE_430_length_3634_cov_34.913154	1499	1544	178	1	45	0.0222222
NODE_430_length_3634_cov_34.913154	1499	1544	179	1	45	0.0222222
NODE_430_length_3634_cov_34.913154	1499	1544	181	1	45	0.0222222
NODE_430_length_3634_cov_34.913154	1517	1597	59	1	80	0.0125000
NODE_430_length_3634_cov_34.913154	1517	1597	63	2	80	0.0250000
NODE_430_length_3634_cov_34.913154	1517	1597	65	1	80	0.0125000
NODE_430_length_3634_cov_34.913154	1517	1597	71	1	80	0.0125000
NODE_430_length_3634_cov_34.913154	1517	1597	79	1	80	0.0125000
NODE_430_length_3634_cov_34.913154	1517	1597	83	1	80	0.0125000
NODE_430_length_3634_cov_34.913154	1517	1597	89	1	80	0.0125000
NODE_430_length_3634_cov_34.913154	1517	1597	104	1	80	0.0125000
NODE_430_length_3634_cov_34.913154	1517	1597	120	1	80	0.0125000
NODE_430_length_3634_cov_34.913154	1517	1597	124	1	80	0.0125000
NODE_430_length_3634_cov_34.913154	1517	1597	128	1	80	0.0125000
NODE_430_length_3634_cov_34.913154	1517	1597	131	1	80	0.0125000
NODE_430_length_3634_cov_34.913154	1517	1597	139	1	80	0.0125000
NODE_430_length_3634_cov_34.913154	1517	1597	147	2	80	0.0250000
NODE_430_length_3634_cov_34.913154	1517	1597	148	1	80	0.0125000
NODE_430_length_3634_cov_34.913154	1517	1597	157	1	80	0.0125000
NODE_430_length_3634_cov_34.913154	1517	1597	159	1	80	0.0125000
NODE_430_length_3634_cov_34.913154	1517	1597	167	2	80	0.0250000
NODE_430_length_3634_cov_34.913154	1517	1597	169	1	80	0.0125000
NODE_430_length_3634_cov_34.913154	1517	1597	171	1	80	0.0125000
NODE_430_length_3634_cov_34.913154	1517	1597	176	1	80	0.0125000
NODE_430_length_3634_cov_34.913154	1517	1597	178	1	80	0.0125000
NODE_430_length_3634_cov_34.913154	1517	1597	179	1	80	0.0125000
NODE_430_length_3634_cov_34.913154	1517	1597	181	1	80	0.0125000
NODE_430_length_3634_cov_34.913154	1517	1597	182	2	80	0.0250000
NODE_430_length_3634_cov_34.913154	1517	1597	183	1	80	0.0125000
NODE_430_length_3634_cov_34.913154	1517	1597	184	1	80	0.0125000
NODE_430_length_3634_cov_34.913154	1517	1597	188	1	80	0.0125000
NODE_430_length_3634_cov_34.913154	1517	1597	190	1	80	0.0125000
NODE_430_length_3634_cov_34.913154	1517	1597	191	1	80	0.0125000
NODE_430_length_3634_cov_34.913154	1517	1597	199	1	80	0.0125000
NODE_430_length_3634_cov_34.913154	1517	1597	200	4	80	0.0500000
NODE_430_length_3634_cov_34.913154	1517	1597	202	1	80	0.0125000
NODE_430_length_3634_cov_34.913154	1517	1597	206	1	80	0.0125000
NODE_430_length_3634_cov_34.913154	1517	1597	209	1	80	0.0125000
NODE_430_length_3634_cov_34.913154	1517	1597	217	1	80	0.0125000
NODE_430_length_3634_cov_34.913154	1517	1597	220	1	80	0.0125000
NODE_430_length_3634_cov_34.913154	1517	1597	227	3	80	0.0375000
NODE_430_length_3634_cov_34.913154	1517	1597	229	2	80	0.0250000
NODE_430_length_3634_cov_34.913154	1517	1597	235	1	80	0.0125000
NODE_430_length_3634_cov_34.913154	1517	1597	247	1	80	0.0125000
NODE_430_length_3634_cov_34.913154	1517	1597	249	2	80	0.0250000
NODE_430_length_3634_cov_34.913154	1517	1597	253	1	80	0.0125000
NODE_430_length_3634_cov_34.913154	1517	1597	256	1	80	0.0125000
NODE_430_length_3634_cov_34.913154	1517	1597	257	1	80	0.0125000
NODE_430_length_3634_cov_34.913154	1517	1597	264	1	80	0.0125000
NODE_430_length_3634_cov_34.913154	1517	1597	270	1	80	0.0125000
NODE_430_length_3634_cov_34.913154	1517	1597	276	2	80	0.0250000
NODE_430_length_3634_cov_34.913154	1517	1597	282	1	80	0.0125000
NODE_430_length_3634_cov_34.913154	1517	1597	286	1	80	0.0125000
NODE_430_length_3634_cov_34.913154	1517	1597	287	1	80	0.0125000
NODE_430_length_3634_cov_34.913154	1517	1597	288	3	80	0.0375000
NODE_430_length_3634_cov_34.913154	1517	1597	289	6	80	0.0750000
NODE_430_length_3634_cov_34.913154	1517	1597	290	3	80	0.0375000
NODE_430_length_3634_cov_34.913154	1517	1597	292	1	80	0.0125000
NODE_430_length_3634_cov_34.913154	1517	1597	294	4	80	0.0500000
NODE_430_length_3634_cov_34.913154	1978	2058	75	1	80	0.0125000
NODE_430_length_3634_cov_34.913154	1978	2058	81	1	80	0.0125000
NODE_430_length_3634_cov_34.913154	1978	2058	85	1	80	0.0125000
NODE_430_length_3634_cov_34.913154	1978	2058	87	1	80	0.0125000
NODE_430_length_3634_cov_34.913154	1978	2058	88	5	80	0.0625000
NODE_430_length_3634_cov_34.913154	1978	2058	91	1	80	0.0125000
NODE_430_length_3634_cov_34.913154	1978	2058	94	2	80	0.0250000
NODE_430_length_3634_cov_34.913154	1978	2058	100	1	80	0.0125000
NODE_430_length_3634_cov_34.913154	1978	2058	104	1	80	0.0125000
NODE_430_length_3634_cov_34.913154	1978	2058	108	1	80	0.0125000
NODE_430_length_3634_cov_34.913154	1978	2058	109	1	80	0.0125000
NODE_430_length_3634_cov_34.913154	1978	2058	115	2	80	0.0250000
NODE_430_length_3634_cov_34.913154	1978	2058	119	3	80	0.0375000
NODE_430_length_3634_cov_34.913154	1978	2058	121	1	80	0.0125000
NODE_430_length_3634_cov_34.913154	1978	2058	123	1	80	0.0125000
NODE_430_length_3634_cov_34.913154	1978	2058	125	1	80	0.0125000
NODE_430_length_3634_cov_34.913154	1978	2058	127	1	80	0.0125000
NODE_430_length_3634_cov_34.913154	1978	2058	129	1	80	0.0125000
NODE_430_length_3634_cov_34.913154	1978	2058	135	1	80	0.0125000
NODE_430_length_3634_cov_34.913154	1978	2058	136	1	80	0.0125000
NODE_430_length_3634_cov_34.913154	1978	2058	140	1	80	0.0125000
NODE_430_length_3634_cov_34.913154	1978	2058	144	2	80	0.0250000
NODE_430_length_3634_cov_34.913154	1978	2058	148	1	80	0.0125000
NODE_430_length_3634_cov_34.913154	1978	2058	150	4	80	0.0500000
NODE_430_length_3634_cov_34.913154	1978	2058	151	1	80	0.0125000
NODE_430_length_3634_cov_34.913154	1978	2058	155	1	80	0.0125000
NODE_430_length_3634_cov_34.913154	1978	2058	161	1	80	0.0125000
NODE_430_length_3634_cov_34.913154	1978	2058	168	1	80	0.0125000
NODE_430_length_3634_cov_34.913154	1978	2058	170	2	80	0.0250000
NODE_430_length_3634_cov_34.913154	1978	2058	172	1	80	0.0125000
NODE_430_length_3634_cov_34.913154	1978	2058	174	2	80	0.0250000
NODE_430_length_3634_cov_34.913154	1978	2058	176	1	80	0.0125000
NODE_430_length_3634_cov_34.913154	1978	2058	179	1	80	0.0125000
NODE_430_length_3634_cov_34.913154	1978	2058	182	2	80	0.0250000
NODE_430_length_3634_cov_34.913154	1978	2058	190	1	80	0.0125000
NODE_430_length_3634_cov_34.913154	1978	2058	192	6	80	0.0750000
NODE_430_length_3634_cov_34.913154	1978	2058	197	1	80	0.0125000
NODE_430_length_3634_cov_34.913154	1978	2058	199	1	80	0.0125000
NODE_430_length_3634_cov_34.913154	1978	2058	201	1	80	0.0125000
NODE_430_length_3634_cov_34.913154	1978	2058	205	1	80	0.0125000
NODE_430_length_3634_cov_34.913154	1978	2058	210	1	80	0.0125000
NODE_430_length_3634_cov_34.913154	1978	2058	214	1	80	0.0125000
NODE_430_length_3634_cov_34.913154	1978	2058	216	1	80	0.0125000
NODE_430_length_3634_cov_34.913154	1978	2058	228	1	80	0.0125000
NODE_430_length_3634_cov_34.913154	1978	2058	234	1	80	0.0125000
NODE_430_length_3634_cov_34.913154	1978	2058	237	1	80	0.0125000
NODE_430_length_3634_cov_34.913154	1978	2058	239	1	80	0.0125000
NODE_430_length_3634_cov_34.913154	1978	2058	242	1	80	0.0125000
NODE_430_length_3634_cov_34.913154	1978	2058	244	1	80	0.0125000
NODE_430_length_3634_cov_34.913154	1978	2058	251	1	80	0.0125000
NODE_430_length_3634_cov_34.913154	1978	2058	255	1	80	0.0125000
NODE_430_length_3634_cov_34.913154	1978	2058	265	1	80	0.0125000
NODE_430_length_3634_cov_34.913154	1978	2058	275	1	80	0.0125000
NODE_430_length_3634_cov_34.913154	1978	2058	279	3	80	0.0375000
NODE_430_length_3634_cov_34.913154	1978	2058	281	1	80	0.0125000
NODE_430_length_3634_cov_34.913154	1978	2058	285	1	80	0.0125000
NODE_430_length_3634_cov_34.913154	1978	2058	287	1	80	0.0125000
NODE_430_length_3634_cov_34.913154	1978	2058	289	1	80	0.0125000
NODE_430_length_3634_cov_34.913154	2031	2077	19	1	46	0.0217391
NODE_430_length_3634_cov_34.913154	2031	2077	30	1	46	0.0217391
NODE_430_length_3634_cov_34.913154	2031	2077	35	1	46	0.0217391
NODE_430_length_3634_cov_34.913154	2031	2077	40	1	46	0.0217391
NODE_430_length_3634_cov_34.913154	2031	2077	42	1	46	0.0217391
NODE_430_length_3634_cov_34.913154	2031	2077	44	2	46	0.0434783
NODE_430_length_3634_cov_34.913154	2031	2077	46	3	46	0.0652174
NODE_430_length_3634_cov_34.913154	2031	2077	48	1	46	0.0217391
NODE_430_length_3634_cov_34.913154	2031	2077	50	1	46	0.0217391
NODE_430_length_3634_cov_34.913154	2031	2077	56	3	46	0.0652174
NODE_430_length_3634_cov_34.913154	2031	2077	60	1	46	0.0217391
NODE_430_length_3634_cov_34.913154	2031	2077	62	1	46	0.0217391
NODE_430_length_3634_cov_34.913154	2031	2077	64	2	46	0.0434783
NODE_430_length_3634_cov_34.913154	2031	2077	75	1	46	0.0217391
NODE_430_length_3634_cov_34.913154	2031	2077	81	1	46	0.0217391
NODE_430_length_3634_cov_34.913154	2031	2077	85	1	46	0.0217391
NODE_430_length_3634_cov_34.913154	2031	2077	87	1	46	0.0217391
NODE_430_length_3634_cov_34.913154	2031	2077	88	5	46	0.1086956
NODE_430_length_3634_cov_34.913154	2031	2077	91	1	46	0.0217391
NODE_430_length_3634_cov_34.913154	2031	2077	94	2	46	0.0434783
NODE_430_length_3634_cov_34.913154	2031	2077	100	1	46	0.0217391
NODE_430_length_3634_cov_34.913154	2031	2077	104	1	46	0.0217391
NODE_430_length_3634_cov_34.913154	2031	2077	108	1	46	0.0217391
NODE_430_length_3634_cov_34.913154	2031	2077	109	1	46	0.0217391
NODE_430_length_3634_cov_34.913154	2031	2077	115	2	46	0.0434783
NODE_430_length_3634_cov_34.913154	2031	2077	119	3	46	0.0652174
NODE_430_length_3634_cov_34.913154	2031	2077	121	1	46	0.0217391
NODE_430_length_3634_cov_34.913154	2031	2077	123	1	46	0.0217391
NODE_430_length_3634_cov_34.913154	2031	2077	125	1	46	0.0217391
NODE_430_length_3634_cov_34.913154	2031	2077	127	1	46	0.0217391
NODE_430_length_3634_cov_34.913154	2031	2077	129	1	46	0.0217391
NODE_430_length_3634_cov_34.913154	2031	2077	135	1	46	0.0217391
NODE_435_length_3622_cov_29.112120	201	281	0	61	80	0.7625000
NODE_435_length_3622_cov_29.112120	201	281	2	1	80	0.0125000
NODE_435_length_3622_cov_29.112120	201	281	8	18	80	0.2250000
NODE_435_length_3622_cov_29.112120	254	334	0	8	80	0.1000000
NODE_435_length_3622_cov_29.112120	254	334	2	1	80	0.0125000
NODE_435_length_3622_cov_29.112120	254	334	8	49	80	0.6125000
NODE_435_length_3622_cov_29.112120	254	334	10	22	80	0.2750000
NODE_435_length_3622_cov_29.112120	2310	2390	80	1	80	0.0125000
NODE_435_length_3622_cov_29.112120	2310	2390	84	2	80	0.0250000
NODE_435_length_3622_cov_29.112120	2310	2390	86	7	80	0.0875000
NODE_435_length_3622_cov_29.112120	2310	2390	93	1	80	0.0125000
NODE_435_length_3622_cov_29.112120	2310	2390	94	1	80	0.0125000
NODE_435_length_3622_cov_29.112120	2310	2390	98	4	80	0.0500000
NODE_435_length_3622_cov_29.112120	2310	2390	100	1	80	0.0125000
NODE_435_length_3622_cov_29.112120	2310	2390	103	1	80	0.0125000
NODE_435_length_3622_cov_29.112120	2310	2390	107	1	80	0.0125000
NODE_435_length_3622_cov_29.112120	2310	2390	108	3	80	0.0375000
NODE_435_length_3622_cov_29.112120	2310	2390	110	1	80	0.0125000
NODE_435_length_3622_cov_29.112120	2310	2390	116	1	80	0.0125000
NODE_435_length_3622_cov_29.112120	2310	2390	126	1	80	0.0125000
NODE_435_length_3622_cov_29.112120	2310	2390	132	1	80	0.0125000
NODE_435_length_3622_cov_29.112120	2310	2390	134	2	80	0.0250000
NODE_435_length_3622_cov_29.112120	2310	2390	140	1	80	0.0125000
NODE_435_length_3622_cov_29.112120	2310	2390	142	1	80	0.0125000
NODE_435_length_3622_cov_29.112120	2310	2390	148	1	80	0.0125000
NODE_435_length_3622_cov_29.112120	2310	2390	150	1	80	0.0125000
NODE_435_length_3622_cov_29.112120	2310	2390	152	1	80	0.0125000
NODE_435_length_3622_cov_29.112120	2310	2390	154	1	80	0.0125000
NODE_435_length_3622_cov_29.112120	2310	2390	158	1	80	0.0125000
NODE_435_length_3622_cov_29.112120	2310	2390	160	2	80	0.0250000
NODE_435_length_3622_cov_29.112120	2310	2390	168	1	80	0.0125000
NODE_435_length_3622_cov_29.112120	2310	2390	170	1	80	0.0125000
NODE_435_length_3622_cov_29.112120	2310	2390	180	1	80	0.0125000
NODE_435_length_3622_cov_29.112120	2310	2390	188	3	80	0.0375000
NODE_435_length_3622_cov_29.112120	2310	2390	191	1	80	0.0125000
NODE_435_length_3622_cov_29.112120	2310	2390	199	2	80	0.0250000
NODE_435_length_3622_cov_29.112120	2310	2390	200	1	80	0.0125000
NODE_435_length_3622_cov_29.112120	2310	2390	201	1	80	0.0125000
NODE_435_length_3622_cov_29.112120	2310	2390	206	4	80	0.0500000
NODE_435_length_3622_cov_29.112120	2310	2390	207	1	80	0.0125000
NODE_435_length_3622_cov_29.112120	2310	2390	208	1	80	0.0125000
NODE_435_length_3622_cov_29.112120	2310	2390	209	4	80	0.0500000
NODE_435_length_3622_cov_29.112120	2310	2390	210	1	80	0.0125000
NODE_435_length_3622_cov_29.112120	2310	2390	211	4	80	0.0500000
NODE_435_length_3622_cov_29.112120	2310	2390	212	5	80	0.0625000
NODE_435_length_3622_cov_29.112120	2310	2390	214	7	80	0.0875000
NODE_435_length_3622_cov_29.112120	2310	2390	215	1	80	0.0125000
NODE_435_length_3622_cov_29.112120	2310	2390	216	1	80	0.0125000
NODE_435_length_3622_cov_29.112120	2310	2390	217	1	80	0.0125000
NODE_435_length_3622_cov_29.112120	2310	2390	218	2	80	0.0250000
NODE_435_length_3622_cov_29.112120	2363	2441	6	6	78	0.0769231
NODE_435_length_3622_cov_29.112120	2363	2441	10	1	78	0.0128205
NODE_435_length_3622_cov_29.112120	2363	2441	14	3	78	0.0384615
NODE_435_length_3622_cov_29.112120	2363	2441	18	1	78	0.0128205
NODE_435_length_3622_cov_29.112120	2363	2441	20	1	78	0.0128205
NODE_435_length_3622_cov_29.112120	2363	2441	26	4	78	0.0512821
NODE_435_length_3622_cov_29.112120	2363	2441	30	6	78	0.0769231
NODE_435_length_3622_cov_29.112120	2363	2441	34	9	78	0.1153846
NODE_435_length_3622_cov_29.112120	2363	2441	36	1	78	0.0128205
NODE_435_length_3622_cov_29.112120	2363	2441	40	1	78	0.0128205
NODE_435_length_3622_cov_29.112120	2363	2441	42	1	78	0.0128205
NODE_435_length_3622_cov_29.112120	2363	2441	45	1	78	0.0128205
NODE_435_length_3622_cov_29.112120	2363	2441	47	3	78	0.0384615
NODE_435_length_3622_cov_29.112120	2363	2441	49	1	78	0.0128205
NODE_435_length_3622_cov_29.112120	2363	2441	51	1	78	0.0128205
NODE_435_length_3622_cov_29.112120	2363	2441	54	1	78	0.0128205
NODE_435_length_3622_cov_29.112120	2363	2441	56	4	78	0.0512821
NODE_435_length_3622_cov_29.112120	2363	2441	62	1	78	0.0128205
NODE_435_length_3622_cov_29.112120	2363	2441	71	1	78	0.0128205
NODE_435_length_3622_cov_29.112120	2363	2441	76	2	78	0.0256410
NODE_435_length_3622_cov_29.112120	2363	2441	80	3	78	0.0384615
NODE_435_length_3622_cov_29.112120	2363	2441	84	2	78	0.0256410
NODE_435_length_3622_cov_29.112120	2363	2441	86	7	78	0.0897436
NODE_435_length_3622_cov_29.112120	2363	2441	93	1	78	0.0128205
NODE_435_length_3622_cov_29.112120	2363	2441	94	1	78	0.0128205
NODE_435_length_3622_cov_29.112120	2363	2441	98	4	78	0.0512821
NODE_435_length_3622_cov_29.112120	2363	2441	100	1	78	0.0128205
NODE_435_length_3622_cov_29.112120	2363	2441	103	1	78	0.0128205
NODE_435_length_3622_cov_29.112120	2363	2441	107	1	78	0.0128205
NODE_435_length_3622_cov_29.112120	2363	2441	108	3	78	0.0384615
NODE_435_length_3622_cov_29.112120	2363	2441	110	1	78	0.0128205
NODE_435_length_3622_cov_29.112120	2363	2441	116	1	78	0.0128205
NODE_435_length_3622_cov_29.112120	2363	2441	126	1	78	0.0128205
NODE_435_length_3622_cov_29.112120	2363	2441	132	1	78	0.0128205
NODE_435_length_3622_cov_29.112120	2363	2441	134	1	78	0.0128205
NODE_437_length_3610_cov_8.785816	294	340	6	7	46	0.1521739
NODE_437_length_3610_cov_8.785816	294	340	8	19	46	0.4130435
NODE_437_length_3610_cov_8.785816	294	340	12	20	46	0.4347826
NODE_437_length_3610_cov_8.785816	313	393	4	12	80	0.1500000
NODE_437_length_3610_cov_8.785816	313	393	6	33	80	0.4125000
NODE_437_length_3610_cov_8.785816	313	393	8	15	80	0.1875000
NODE_437_length_3610_cov_8.785816	313	393	12	20	80	0.2500000
NODE_444_length_3588_cov_16.296360	2421	2501	1	39	80	0.4875000
NODE_444_length_3588_cov_16.296360	2421	2501	2	41	80	0.5125000
NODE_444_length_3588_cov_16.296360	2474	2539	1	65	65	1.0000000
NODE_447_length_3585_cov_2.283419	605	668	0	63	63	1.0000000
NODE_451_length_3567_cov_16.283160	410	429	2	18	19	0.9473684
NODE_451_length_3567_cov_16.283160	410	429	5	1	19	0.0526316
NODE_451_length_3567_cov_16.283160	2259	2339	123	1	80	0.0125000
NODE_451_length_3567_cov_16.283160	2259	2339	124	1	80	0.0125000
NODE_451_length_3567_cov_16.283160	2259	2339	125	7	80	0.0875000
NODE_451_length_3567_cov_16.283160	2259	2339	127	2	80	0.0250000
NODE_451_length_3567_cov_16.283160	2259	2339	129	7	80	0.0875000
NODE_451_length_3567_cov_16.283160	2259	2339	130	8	80	0.1000000
NODE_451_length_3567_cov_16.283160	2259	2339	131	1	80	0.0125000
NODE_451_length_3567_cov_16.283160	2259	2339	132	5	80	0.0625000
NODE_451_length_3567_cov_16.283160	2259	2339	134	15	80	0.1875000
NODE_451_length_3567_cov_16.283160	2259	2339	136	8	80	0.1000000
NODE_451_length_3567_cov_16.283160	2259	2339	137	1	80	0.0125000
NODE_451_length_3567_cov_16.283160	2259	2339	139	2	80	0.0250000
NODE_451_length_3567_cov_16.283160	2259	2339	140	1	80	0.0125000
NODE_451_length_3567_cov_16.283160	2259	2339	142	1	80	0.0125000
NODE_451_length_3567_cov_16.283160	2259	2339	143	1	80	0.0125000
NODE_451_length_3567_cov_16.283160	2259	2339	145	1	80	0.0125000
NODE_451_length_3567_cov_16.283160	2259	2339	146	4	80	0.0500000
NODE_451_length_3567_cov_16.283160	2259	2339	147	2	80	0.0250000
NODE_451_length_3567_cov_16.283160	2259	2339	148	2	80	0.0250000
NODE_451_length_3567_cov_16.283160	2259	2339	149	1	80	0.0125000
NODE_451_length_3567_cov_16.283160	2259	2339	150	2	80	0.0250000
NODE_451_length_3567_cov_16.283160	2259	2339	151	3	80	0.0375000
NODE_451_length_3567_cov_16.283160	2259	2339	152	4	80	0.0500000
NODE_451_length_3567_cov_16.283160	2312	2379	1	1	67	0.0149254
NODE_451_length_3567_cov_16.283160	2312	2379	7	1	67	0.0149254
NODE_451_length_3567_cov_16.283160	2312	2379	19	3	67	0.0447761
NODE_451_length_3567_cov_16.283160	2312	2379	26	1	67	0.0149254
NODE_451_length_3567_cov_16.283160	2312	2379	30	2	67	0.0298507
NODE_451_length_3567_cov_16.283160	2312	2379	37	1	67	0.0149254
NODE_451_length_3567_cov_16.283160	2312	2379	40	1	67	0.0149254
NODE_451_length_3567_cov_16.283160	2312	2379	42	2	67	0.0298507
NODE_451_length_3567_cov_16.283160	2312	2379	46	2	67	0.0298507
NODE_451_length_3567_cov_16.283160	2312	2379	48	1	67	0.0149254
NODE_451_length_3567_cov_16.283160	2312	2379	50	2	67	0.0298507
NODE_451_length_3567_cov_16.283160	2312	2379	54	2	67	0.0298507
NODE_451_length_3567_cov_16.283160	2312	2379	56	1	67	0.0149254
NODE_451_length_3567_cov_16.283160	2312	2379	58	1	67	0.0149254
NODE_451_length_3567_cov_16.283160	2312	2379	64	1	67	0.0149254
NODE_451_length_3567_cov_16.283160	2312	2379	68	1	67	0.0149254
NODE_451_length_3567_cov_16.283160	2312	2379	79	1	67	0.0149254
NODE_451_length_3567_cov_16.283160	2312	2379	81	1	67	0.0149254
NODE_451_length_3567_cov_16.283160	2312	2379	87	1	67	0.0149254
NODE_451_length_3567_cov_16.283160	2312	2379	91	1	67	0.0149254
NODE_451_length_3567_cov_16.283160	2312	2379	95	1	67	0.0149254
NODE_451_length_3567_cov_16.283160	2312	2379	103	3	67	0.0447761
NODE_451_length_3567_cov_16.283160	2312	2379	110	1	67	0.0149254
NODE_451_length_3567_cov_16.283160	2312	2379	111	1	67	0.0149254
NODE_451_length_3567_cov_16.283160	2312	2379	112	1	67	0.0149254
NODE_451_length_3567_cov_16.283160	2312	2379	114	1	67	0.0149254
NODE_451_length_3567_cov_16.283160	2312	2379	117	1	67	0.0149254
NODE_451_length_3567_cov_16.283160	2312	2379	119	1	67	0.0149254
NODE_451_length_3567_cov_16.283160	2312	2379	121	1	67	0.0149254
NODE_451_length_3567_cov_16.283160	2312	2379	123	2	67	0.0298507
NODE_451_length_3567_cov_16.283160	2312	2379	125	3	67	0.0447761
NODE_451_length_3567_cov_16.283160	2312	2379	127	1	67	0.0149254
NODE_451_length_3567_cov_16.283160	2312	2379	129	6	67	0.0895522
NODE_451_length_3567_cov_16.283160	2312	2379	130	8	67	0.1194030
NODE_451_length_3567_cov_16.283160	2312	2379	132	3	67	0.0447761
NODE_451_length_3567_cov_16.283160	2312	2379	134	6	67	0.0895522
NODE_454_length_3557_cov_12.423077	640	718	0	61	78	0.7820513
NODE_454_length_3557_cov_12.423077	640	718	2	17	78	0.2179487
NODE_454_length_3557_cov_12.423077	640	688	0	48	48	1.0000000
NODE_454_length_3557_cov_12.423077	640	688	0	48	48	1.0000000
NODE_454_length_3557_cov_12.423077	640	688	0	48	48	1.0000000
NODE_454_length_3557_cov_12.423077	640	688	0	48	48	1.0000000
NODE_454_length_3557_cov_12.423077	693	771	0	12	78	0.1538462
NODE_454_length_3557_cov_12.423077	693	771	2	66	78	0.8461539
NODE_455_length_3548_cov_7.216295	554	634	0	80	80	1.0000000
NODE_455_length_3548_cov_7.216295	607	687	0	80	80	1.0000000
NODE_461_length_3518_cov_40.508336	1320	1400	6	3	80	0.0375000
NODE_461_length_3518_cov_40.508336	1320	1400	8	4	80	0.0500000
NODE_461_length_3518_cov_40.508336	1320	1400	10	9	80	0.1125000
NODE_461_length_3518_cov_40.508336	1320	1400	14	13	80	0.1625000
NODE_461_length_3518_cov_40.508336	1320	1400	16	19	80	0.2375000
NODE_461_length_3518_cov_40.508336	1320	1400	18	8	80	0.1000000
NODE_461_length_3518_cov_40.508336	1320	1400	20	1	80	0.0125000
NODE_461_length_3518_cov_40.508336	1320	1400	22	1	80	0.0125000
NODE_461_length_3518_cov_40.508336	1320	1400	24	10	80	0.1250000
NODE_461_length_3518_cov_40.508336	1320	1400	30	2	80	0.0250000
NODE_461_length_3518_cov_40.508336	1320	1400	32	10	80	0.1250000
NODE_461_length_3518_cov_40.508336	1373	1453	18	3	80	0.0375000
NODE_461_length_3518_cov_40.508336	1373	1453	20	1	80	0.0125000
NODE_461_length_3518_cov_40.508336	1373	1453	22	1	80	0.0125000
NODE_461_length_3518_cov_40.508336	1373	1453	24	11	80	0.1375000
NODE_461_length_3518_cov_40.508336	1373	1453	26	16	80	0.2000000
NODE_461_length_3518_cov_40.508336	1373	1453	28	5	80	0.0625000
NODE_461_length_3518_cov_40.508336	1373	1453	30	3	80	0.0375000
NODE_461_length_3518_cov_40.508336	1373	1453	32	21	80	0.2625000
NODE_461_length_3518_cov_40.508336	1373	1453	34	7	80	0.0875000
NODE_461_length_3518_cov_40.508336	1373	1453	36	12	80	0.1500000
NODE_465_length_3497_cov_65.791348	3062	3142	298	1	80	0.0125000
NODE_465_length_3497_cov_65.791348	3062	3142	299	1	80	0.0125000
NODE_465_length_3497_cov_65.791348	3062	3142	301	1	80	0.0125000
NODE_465_length_3497_cov_65.791348	3062	3142	302	2	80	0.0250000
NODE_465_length_3497_cov_65.791348	3062	3142	303	1	80	0.0125000
NODE_465_length_3497_cov_65.791348	3062	3142	304	3	80	0.0375000
NODE_465_length_3497_cov_65.791348	3062	3142	306	1	80	0.0125000
NODE_465_length_3497_cov_65.791348	3062	3142	313	1	80	0.0125000
NODE_465_length_3497_cov_65.791348	3062	3142	322	1	80	0.0125000
NODE_465_length_3497_cov_65.791348	3062	3142	327	1	80	0.0125000
NODE_465_length_3497_cov_65.791348	3062	3142	332	1	80	0.0125000
NODE_465_length_3497_cov_65.791348	3062	3142	336	1	80	0.0125000
NODE_465_length_3497_cov_65.791348	3062	3142	342	1	80	0.0125000
NODE_465_length_3497_cov_65.791348	3062	3142	343	1	80	0.0125000
NODE_465_length_3497_cov_65.791348	3062	3142	344	3	80	0.0375000
NODE_465_length_3497_cov_65.791348	3062	3142	349	1	80	0.0125000
NODE_465_length_3497_cov_65.791348	3062	3142	351	1	80	0.0125000
NODE_465_length_3497_cov_65.791348	3062	3142	354	1	80	0.0125000
NODE_465_length_3497_cov_65.791348	3062	3142	355	2	80	0.0250000
NODE_465_length_3497_cov_65.791348	3062	3142	357	3	80	0.0375000
NODE_465_length_3497_cov_65.791348	3062	3142	359	3	80	0.0375000
NODE_465_length_3497_cov_65.791348	3062	3142	360	1	80	0.0125000
NODE_465_length_3497_cov_65.791348	3062	3142	361	2	80	0.0250000
NODE_465_length_3497_cov_65.791348	3062	3142	362	2	80	0.0250000
NODE_465_length_3497_cov_65.791348	3062	3142	363	2	80	0.0250000
NODE_465_length_3497_cov_65.791348	3062	3142	364	1	80	0.0125000
NODE_465_length_3497_cov_65.791348	3062	3142	366	2	80	0.0250000
NODE_465_length_3497_cov_65.791348	3062	3142	367	3	80	0.0375000
NODE_465_length_3497_cov_65.791348	3062	3142	368	2	80	0.0250000
NODE_465_length_3497_cov_65.791348	3062	3142	369	1	80	0.0125000
NODE_465_length_3497_cov_65.791348	3062	3142	370	4	80	0.0500000
NODE_465_length_3497_cov_65.791348	3062	3142	371	5	80	0.0625000
NODE_465_length_3497_cov_65.791348	3062	3142	372	5	80	0.0625000
NODE_465_length_3497_cov_65.791348	3062	3142	373	3	80	0.0375000
NODE_465_length_3497_cov_65.791348	3062	3142	374	1	80	0.0125000
NODE_465_length_3497_cov_65.791348	3062	3142	375	2	80	0.0250000
NODE_465_length_3497_cov_65.791348	3062	3142	378	3	80	0.0375000
NODE_465_length_3497_cov_65.791348	3062	3142	379	2	80	0.0250000
NODE_465_length_3497_cov_65.791348	3062	3142	381	1	80	0.0125000
NODE_465_length_3497_cov_65.791348	3062	3142	383	2	80	0.0250000
NODE_465_length_3497_cov_65.791348	3062	3142	384	2	80	0.0250000
NODE_465_length_3497_cov_65.791348	3062	3142	385	1	80	0.0125000
NODE_465_length_3497_cov_65.791348	3062	3142	386	1	80	0.0125000
NODE_465_length_3497_cov_65.791348	3062	3142	387	1	80	0.0125000
NODE_466_length_3488_cov_2.243730	506	529	0	22	23	0.9565217
NODE_466_length_3488_cov_2.243730	506	529	2	1	23	0.0434783
NODE_470_length_3483_cov_14.759456	360	440	0	80	80	1.0000000
NODE_470_length_3483_cov_14.759456	413	493	0	80	80	1.0000000
NODE_474_length_3471_cov_37.887604	2795	2875	0	53	80	0.6625000
NODE_474_length_3471_cov_37.887604	2795	2875	4	27	80	0.3375000
NODE_474_length_3471_cov_37.887604	2848	2928	4	80	80	1.0000000
NODE_474_length_3471_cov_37.887604	2924	2943	4	19	19	1.0000000
NODE_474_length_3471_cov_37.887604	2924	3004	0	55	80	0.6875000
NODE_474_length_3471_cov_37.887604	2924	3004	4	25	80	0.3125000
NODE_474_length_3471_cov_37.887604	2977	3057	0	76	80	0.9500000
NODE_474_length_3471_cov_37.887604	2977	3057	1	4	80	0.0500000
NODE_479_length_3451_cov_29.833234	2973	3053	0	14	80	0.1750000
NODE_479_length_3451_cov_29.833234	2973	3053	2	3	80	0.0375000
NODE_479_length_3451_cov_29.833234	2973	3053	4	17	80	0.2125000
NODE_479_length_3451_cov_29.833234	2973	3053	6	46	80	0.5750000
NODE_479_length_3451_cov_29.833234	3026	3106	0	21	80	0.2625000
NODE_479_length_3451_cov_29.833234	3026	3106	2	13	80	0.1625000
NODE_479_length_3451_cov_29.833234	3026	3106	4	14	80	0.1750000
NODE_479_length_3451_cov_29.833234	3026	3106	6	32	80	0.4000000
NODE_481_length_3446_cov_32.421273	3181	3261	12	2	80	0.0250000
NODE_481_length_3446_cov_32.421273	3181	3261	14	18	80	0.2250000
NODE_481_length_3446_cov_32.421273	3181	3261	18	2	80	0.0250000
NODE_481_length_3446_cov_32.421273	3181	3261	22	24	80	0.3000000
NODE_481_length_3446_cov_32.421273	3181	3261	24	11	80	0.1375000
NODE_481_length_3446_cov_32.421273	3181	3261	26	23	80	0.2875000
NODE_482_length_3444_cov_29.954858	792	872	8	8	80	0.1000000
NODE_482_length_3444_cov_29.954858	792	872	12	8	80	0.1000000
NODE_482_length_3444_cov_29.954858	792	872	16	9	80	0.1125000
NODE_482_length_3444_cov_29.954858	792	872	20	15	80	0.1875000
NODE_482_length_3444_cov_29.954858	792	872	22	8	80	0.1000000
NODE_482_length_3444_cov_29.954858	792	872	24	16	80	0.2000000
NODE_482_length_3444_cov_29.954858	792	872	26	6	80	0.0750000
NODE_482_length_3444_cov_29.954858	792	872	28	10	80	0.1250000
NODE_482_length_3444_cov_29.954858	845	925	10	6	80	0.0750000
NODE_482_length_3444_cov_29.954858	845	925	12	7	80	0.0875000
NODE_482_length_3444_cov_29.954858	845	925	13	1	80	0.0125000
NODE_482_length_3444_cov_29.954858	845	925	14	29	80	0.3625000
NODE_482_length_3444_cov_29.954858	845	925	16	2	80	0.0250000
NODE_482_length_3444_cov_29.954858	845	925	20	1	80	0.0125000
NODE_482_length_3444_cov_29.954858	845	925	22	1	80	0.0125000
NODE_482_length_3444_cov_29.954858	845	925	24	14	80	0.1750000
NODE_482_length_3444_cov_29.954858	845	925	26	9	80	0.1125000
NODE_482_length_3444_cov_29.954858	845	925	28	10	80	0.1250000
NODE_483_length_3442_cov_17.799880	3155	3220	4	11	65	0.1692308
NODE_483_length_3442_cov_17.799880	3155	3220	6	3	65	0.0461538
NODE_483_length_3442_cov_17.799880	3155	3220	10	2	65	0.0307692
NODE_483_length_3442_cov_17.799880	3155	3220	12	2	65	0.0307692
NODE_483_length_3442_cov_17.799880	3155	3220	14	2	65	0.0307692
NODE_483_length_3442_cov_17.799880	3155	3220	16	1	65	0.0153846
NODE_483_length_3442_cov_17.799880	3155	3220	18	5	65	0.0769231
NODE_483_length_3442_cov_17.799880	3155	3220	20	2	65	0.0307692
NODE_483_length_3442_cov_17.799880	3155	3220	22	2	65	0.0307692
NODE_483_length_3442_cov_17.799880	3155	3220	24	1	65	0.0153846
NODE_483_length_3442_cov_17.799880	3155	3220	28	3	65	0.0461538
NODE_483_length_3442_cov_17.799880	3155	3220	30	9	65	0.1384615
NODE_483_length_3442_cov_17.799880	3155	3220	32	5	65	0.0769231
NODE_483_length_3442_cov_17.799880	3155	3220	34	11	65	0.1692308
NODE_483_length_3442_cov_17.799880	3155	3220	36	5	65	0.0769231
NODE_483_length_3442_cov_17.799880	3155	3220	38	1	65	0.0153846
NODE_483_length_3442_cov_17.799880	3208	3273	34	6	65	0.0923077
NODE_483_length_3442_cov_17.799880	3208	3273	36	5	65	0.0769231
NODE_483_length_3442_cov_17.799880	3208	3273	38	8	65	0.1230769
NODE_483_length_3442_cov_17.799880	3208	3273	40	4	65	0.0615385
NODE_483_length_3442_cov_17.799880	3208	3273	42	5	65	0.0769231
NODE_483_length_3442_cov_17.799880	3208	3273	44	2	65	0.0307692
NODE_483_length_3442_cov_17.799880	3208	3273	46	1	65	0.0153846
NODE_483_length_3442_cov_17.799880	3208	3273	47	1	65	0.0153846
NODE_483_length_3442_cov_17.799880	3208	3273	48	1	65	0.0153846
NODE_483_length_3442_cov_17.799880	3208	3273	51	1	65	0.0153846
NODE_483_length_3442_cov_17.799880	3208	3273	56	2	65	0.0307692
NODE_483_length_3442_cov_17.799880	3208	3273	57	1	65	0.0153846
NODE_483_length_3442_cov_17.799880	3208	3273	58	3	65	0.0461538
NODE_483_length_3442_cov_17.799880	3208	3273	60	1	65	0.0153846
NODE_483_length_3442_cov_17.799880	3208	3273	64	2	65	0.0307692
NODE_483_length_3442_cov_17.799880	3208	3273	66	1	65	0.0153846
NODE_483_length_3442_cov_17.799880	3208	3273	71	1	65	0.0153846
NODE_483_length_3442_cov_17.799880	3208	3273	73	1	65	0.0153846
NODE_483_length_3442_cov_17.799880	3208	3273	75	1	65	0.0153846
NODE_483_length_3442_cov_17.799880	3208	3273	80	1	65	0.0153846
NODE_483_length_3442_cov_17.799880	3208	3273	86	1	65	0.0153846
NODE_483_length_3442_cov_17.799880	3208	3273	88	3	65	0.0461538
NODE_483_length_3442_cov_17.799880	3208	3273	90	2	65	0.0307692
NODE_483_length_3442_cov_17.799880	3208	3273	92	7	65	0.1076923
NODE_483_length_3442_cov_17.799880	3208	3273	93	1	65	0.0153846
NODE_483_length_3442_cov_17.799880	3208	3273	95	1	65	0.0153846
NODE_483_length_3442_cov_17.799880	3208	3273	97	1	65	0.0153846
NODE_483_length_3442_cov_17.799880	3208	3273	99	1	65	0.0153846
NODE_486_length_3429_cov_5.070270	125	148	42	2	23	0.0869565
NODE_486_length_3429_cov_5.070270	125	148	44	3	23	0.1304348
NODE_486_length_3429_cov_5.070270	125	148	46	9	23	0.3913043
NODE_486_length_3429_cov_5.070270	125	148	48	6	23	0.2608696
NODE_486_length_3429_cov_5.070270	125	148	50	3	23	0.1304348
NODE_493_length_3408_cov_2.406769	0	45	0	45	45	1.0000000
NODE_495_length_3405_cov_44.930127	2683	2759	2	17	76	0.2236842
NODE_495_length_3405_cov_44.930127	2683	2759	4	10	76	0.1315790
NODE_495_length_3405_cov_44.930127	2683	2759	6	24	76	0.3157895
NODE_495_length_3405_cov_44.930127	2683	2759	8	25	76	0.3289474
NODE_495_length_3405_cov_44.930127	3116	3164	0	1	48	0.0208333
NODE_495_length_3405_cov_44.930127	3116	3164	2	15	48	0.3125000
NODE_495_length_3405_cov_44.930127	3116	3164	4	32	48	0.6666667
NODE_496_length_3402_cov_28.961550	128	183	2	10	55	0.1818182
NODE_496_length_3402_cov_28.961550	128	183	4	43	55	0.7818182
NODE_496_length_3402_cov_28.961550	128	183	6	2	55	0.0363636
NODE_496_length_3402_cov_28.961550	3154	3234	16	6	80	0.0750000
NODE_496_length_3402_cov_28.961550	3154	3234	18	1	80	0.0125000
NODE_496_length_3402_cov_28.961550	3154	3234	20	3	80	0.0375000
NODE_496_length_3402_cov_28.961550	3154	3234	22	5	80	0.0625000
NODE_496_length_3402_cov_28.961550	3154	3234	23	12	80	0.1500000
NODE_496_length_3402_cov_28.961550	3154	3234	26	14	80	0.1750000
NODE_496_length_3402_cov_28.961550	3154	3234	27	1	80	0.0125000
NODE_496_length_3402_cov_28.961550	3154	3234	28	31	80	0.3875000
NODE_496_length_3402_cov_28.961550	3154	3234	29	3	80	0.0375000
NODE_496_length_3402_cov_28.961550	3154	3234	31	4	80	0.0500000
NODE_496_length_3402_cov_28.961550	3207	3287	0	1	80	0.0125000
NODE_496_length_3402_cov_28.961550	3207	3287	2	18	80	0.2250000
NODE_496_length_3402_cov_28.961550	3207	3287	4	5	80	0.0625000
NODE_496_length_3402_cov_28.961550	3207	3287	5	22	80	0.2750000
NODE_496_length_3402_cov_28.961550	3207	3287	7	2	80	0.0250000
NODE_496_length_3402_cov_28.961550	3207	3287	8	1	80	0.0125000
NODE_496_length_3402_cov_28.961550	3207	3287	11	1	80	0.0125000
NODE_496_length_3402_cov_28.961550	3207	3287	14	2	80	0.0250000
NODE_496_length_3402_cov_28.961550	3207	3287	16	7	80	0.0875000
NODE_496_length_3402_cov_28.961550	3207	3287	18	1	80	0.0125000
NODE_496_length_3402_cov_28.961550	3207	3287	20	3	80	0.0375000
NODE_496_length_3402_cov_28.961550	3207	3287	22	5	80	0.0625000
NODE_496_length_3402_cov_28.961550	3207	3287	23	12	80	0.1500000
NODE_498_length_3393_cov_43.623558	1009	1075	64	1	66	0.0151515
NODE_498_length_3393_cov_43.623558	1009	1075	70	2	66	0.0303030
NODE_498_length_3393_cov_43.623558	1009	1075	74	1	66	0.0151515
NODE_498_length_3393_cov_43.623558	1009	1075	76	1	66	0.0151515
NODE_498_length_3393_cov_43.623558	1009	1075	80	1	66	0.0151515
NODE_498_length_3393_cov_43.623558	1009	1075	82	1	66	0.0151515
NODE_498_length_3393_cov_43.623558	1009	1075	86	1	66	0.0151515
NODE_498_length_3393_cov_43.623558	1009	1075	88	4	66	0.0606061
NODE_498_length_3393_cov_43.623558	1009	1075	90	1	66	0.0151515
NODE_498_length_3393_cov_43.623558	1009	1075	92	2	66	0.0303030
NODE_498_length_3393_cov_43.623558	1009	1075	93	1	66	0.0151515
NODE_498_length_3393_cov_43.623558	1009	1075	94	1	66	0.0151515
NODE_498_length_3393_cov_43.623558	1009	1075	102	1	66	0.0151515
NODE_498_length_3393_cov_43.623558	1009	1075	104	1	66	0.0151515
NODE_498_length_3393_cov_43.623558	1009	1075	110	1	66	0.0151515
NODE_498_length_3393_cov_43.623558	1009	1075	112	1	66	0.0151515
NODE_498_length_3393_cov_43.623558	1009	1075	114	1	66	0.0151515
NODE_498_length_3393_cov_43.623558	1009	1075	116	1	66	0.0151515
NODE_498_length_3393_cov_43.623558	1009	1075	117	1	66	0.0151515
NODE_498_length_3393_cov_43.623558	1009	1075	119	5	66	0.0757576
NODE_498_length_3393_cov_43.623558	1009	1075	125	2	66	0.0303030
NODE_498_length_3393_cov_43.623558	1009	1075	130	10	66	0.1515152
NODE_498_length_3393_cov_43.623558	1009	1075	132	2	66	0.0303030
NODE_498_length_3393_cov_43.623558	1009	1075	133	1	66	0.0151515
NODE_498_length_3393_cov_43.623558	1009	1075	137	1	66	0.0151515
NODE_498_length_3393_cov_43.623558	1009	1075	138	2	66	0.0303030
NODE_498_length_3393_cov_43.623558	1009	1075	139	3	66	0.0454545
NODE_498_length_3393_cov_43.623558	1009	1075	140	5	66	0.0757576
NODE_498_length_3393_cov_43.623558	1009	1075	142	2	66	0.0303030
NODE_498_length_3393_cov_43.623558	1009	1075	144	4	66	0.0606061
NODE_498_length_3393_cov_43.623558	1009	1075	146	3	66	0.0454545
NODE_498_length_3393_cov_43.623558	1009	1075	148	1	66	0.0151515
NODE_498_length_3393_cov_43.623558	1009	1075	150	1	66	0.0151515
NODE_498_length_3393_cov_43.623558	1048	1128	53	7	80	0.0875000
NODE_498_length_3393_cov_43.623558	1048	1128	54	1	80	0.0125000
NODE_498_length_3393_cov_43.623558	1048	1128	55	2	80	0.0250000
NODE_498_length_3393_cov_43.623558	1048	1128	56	1	80	0.0125000
NODE_498_length_3393_cov_43.623558	1048	1128	57	1	80	0.0125000
NODE_498_length_3393_cov_43.623558	1048	1128	58	6	80	0.0750000
NODE_498_length_3393_cov_43.623558	1048	1128	59	2	80	0.0250000
NODE_498_length_3393_cov_43.623558	1048	1128	60	4	80	0.0500000
NODE_498_length_3393_cov_43.623558	1048	1128	61	5	80	0.0625000
NODE_498_length_3393_cov_43.623558	1048	1128	62	13	80	0.1625000
NODE_498_length_3393_cov_43.623558	1048	1128	63	5	80	0.0625000
NODE_498_length_3393_cov_43.623558	1048	1128	64	7	80	0.0875000
NODE_498_length_3393_cov_43.623558	1048	1128	70	2	80	0.0250000
NODE_498_length_3393_cov_43.623558	1048	1128	74	1	80	0.0125000
NODE_498_length_3393_cov_43.623558	1048	1128	76	1	80	0.0125000
NODE_498_length_3393_cov_43.623558	1048	1128	80	1	80	0.0125000
NODE_498_length_3393_cov_43.623558	1048	1128	82	1	80	0.0125000
NODE_498_length_3393_cov_43.623558	1048	1128	86	1	80	0.0125000
NODE_498_length_3393_cov_43.623558	1048	1128	88	4	80	0.0500000
NODE_498_length_3393_cov_43.623558	1048	1128	90	1	80	0.0125000
NODE_498_length_3393_cov_43.623558	1048	1128	92	2	80	0.0250000
NODE_498_length_3393_cov_43.623558	1048	1128	93	1	80	0.0125000
NODE_498_length_3393_cov_43.623558	1048	1128	94	1	80	0.0125000
NODE_498_length_3393_cov_43.623558	1048	1128	102	1	80	0.0125000
NODE_498_length_3393_cov_43.623558	1048	1128	104	1	80	0.0125000
NODE_498_length_3393_cov_43.623558	1048	1128	110	1	80	0.0125000
NODE_498_length_3393_cov_43.623558	1048	1128	112	1	80	0.0125000
NODE_498_length_3393_cov_43.623558	1048	1128	114	1	80	0.0125000
NODE_498_length_3393_cov_43.623558	1048	1128	116	1	80	0.0125000
NODE_498_length_3393_cov_43.623558	1048	1128	117	1	80	0.0125000
NODE_498_length_3393_cov_43.623558	1048	1128	119	3	80	0.0375000
NODE_498_length_3393_cov_43.623558	3086	3128	51	1	42	0.0238095
NODE_498_length_3393_cov_43.623558	3086	3128	78	2	42	0.0476190
NODE_498_length_3393_cov_43.623558	3086	3128	93	1	42	0.0238095
NODE_498_length_3393_cov_43.623558	3086	3128	98	1	42	0.0238095
NODE_498_length_3393_cov_43.623558	3086	3128	105	1	42	0.0238095
NODE_498_length_3393_cov_43.623558	3086	3128	111	1	42	0.0238095
NODE_498_length_3393_cov_43.623558	3086	3128	119	1	42	0.0238095
NODE_498_length_3393_cov_43.623558	3086	3128	123	2	42	0.0476190
NODE_498_length_3393_cov_43.623558	3086	3128	127	2	42	0.0476190
NODE_498_length_3393_cov_43.623558	3086	3128	129	1	42	0.0238095
NODE_498_length_3393_cov_43.623558	3086	3128	131	1	42	0.0238095
NODE_498_length_3393_cov_43.623558	3086	3128	133	1	42	0.0238095
NODE_498_length_3393_cov_43.623558	3086	3128	143	1	42	0.0238095
NODE_498_length_3393_cov_43.623558	3086	3128	145	2	42	0.0476190
NODE_498_length_3393_cov_43.623558	3086	3128	149	1	42	0.0238095
NODE_498_length_3393_cov_43.623558	3086	3128	153	1	42	0.0238095
NODE_498_length_3393_cov_43.623558	3086	3128	161	1	42	0.0238095
NODE_498_length_3393_cov_43.623558	3086	3128	167	2	42	0.0476190
NODE_498_length_3393_cov_43.623558	3086	3128	171	1	42	0.0238095
NODE_498_length_3393_cov_43.623558	3086	3128	180	1	42	0.0238095
NODE_498_length_3393_cov_43.623558	3086	3128	191	1	42	0.0238095
NODE_498_length_3393_cov_43.623558	3086	3128	197	1	42	0.0238095
NODE_498_length_3393_cov_43.623558	3086	3128	199	1	42	0.0238095
NODE_498_length_3393_cov_43.623558	3086	3128	200	2	42	0.0476190
NODE_498_length_3393_cov_43.623558	3086	3128	203	1	42	0.0238095
NODE_498_length_3393_cov_43.623558	3086	3128	207	1	42	0.0238095
NODE_498_length_3393_cov_43.623558	3086	3128	208	1	42	0.0238095
NODE_498_length_3393_cov_43.623558	3086	3128	210	2	42	0.0476190
NODE_498_length_3393_cov_43.623558	3086	3128	211	1	42	0.0238095
NODE_498_length_3393_cov_43.623558	3086	3128	219	1	42	0.0238095
NODE_498_length_3393_cov_43.623558	3086	3128	225	1	42	0.0238095
NODE_498_length_3393_cov_43.623558	3086	3128	232	2	42	0.0476190
NODE_498_length_3393_cov_43.623558	3086	3128	236	1	42	0.0238095
NODE_498_length_3393_cov_43.623558	3086	3128	237	1	42	0.0238095
NODE_498_length_3393_cov_43.623558	3293	3373	56	2	80	0.0250000
NODE_498_length_3393_cov_43.623558	3293	3373	61	1	80	0.0125000
NODE_498_length_3393_cov_43.623558	3293	3373	66	1	80	0.0125000
NODE_498_length_3393_cov_43.623558	3293	3373	70	1	80	0.0125000
NODE_498_length_3393_cov_43.623558	3293	3373	72	1	80	0.0125000
NODE_498_length_3393_cov_43.623558	3293	3373	74	3	80	0.0375000
NODE_498_length_3393_cov_43.623558	3293	3373	81	1	80	0.0125000
NODE_498_length_3393_cov_43.623558	3293	3373	85	1	80	0.0125000
NODE_498_length_3393_cov_43.623558	3293	3373	87	1	80	0.0125000
NODE_498_length_3393_cov_43.623558	3293	3373	101	1	80	0.0125000
NODE_498_length_3393_cov_43.623558	3293	3373	104	1	80	0.0125000
NODE_498_length_3393_cov_43.623558	3293	3373	111	1	80	0.0125000
NODE_498_length_3393_cov_43.623558	3293	3373	116	1	80	0.0125000
NODE_498_length_3393_cov_43.623558	3293	3373	123	1	80	0.0125000
NODE_498_length_3393_cov_43.623558	3293	3373	126	1	80	0.0125000
NODE_498_length_3393_cov_43.623558	3293	3373	135	1	80	0.0125000
NODE_498_length_3393_cov_43.623558	3293	3373	143	1	80	0.0125000
NODE_498_length_3393_cov_43.623558	3293	3373	144	1	80	0.0125000
NODE_498_length_3393_cov_43.623558	3293	3373	158	1	80	0.0125000
NODE_498_length_3393_cov_43.623558	3293	3373	163	1	80	0.0125000
NODE_498_length_3393_cov_43.623558	3293	3373	169	1	80	0.0125000
NODE_498_length_3393_cov_43.623558	3293	3373	173	1	80	0.0125000
NODE_498_length_3393_cov_43.623558	3293	3373	199	3	80	0.0375000
NODE_498_length_3393_cov_43.623558	3293	3373	203	1	80	0.0125000
NODE_498_length_3393_cov_43.623558	3293	3373	207	1	80	0.0125000
NODE_498_length_3393_cov_43.623558	3293	3373	209	1	80	0.0125000
NODE_498_length_3393_cov_43.623558	3293	3373	213	1	80	0.0125000
NODE_498_length_3393_cov_43.623558	3293	3373	214	2	80	0.0250000
NODE_498_length_3393_cov_43.623558	3293	3373	228	1	80	0.0125000
NODE_498_length_3393_cov_43.623558	3293	3373	237	1	80	0.0125000
NODE_498_length_3393_cov_43.623558	3293	3373	252	2	80	0.0250000
NODE_498_length_3393_cov_43.623558	3293	3373	254	1	80	0.0125000
NODE_498_length_3393_cov_43.623558	3293	3373	256	1	80	0.0125000
NODE_498_length_3393_cov_43.623558	3293	3373	261	1	80	0.0125000
NODE_498_length_3393_cov_43.623558	3293	3373	264	1	80	0.0125000
NODE_498_length_3393_cov_43.623558	3293	3373	265	1	80	0.0125000
NODE_498_length_3393_cov_43.623558	3293	3373	267	3	80	0.0375000
NODE_498_length_3393_cov_43.623558	3293	3373	271	1	80	0.0125000
NODE_498_length_3393_cov_43.623558	3293	3373	275	1	80	0.0125000
NODE_498_length_3393_cov_43.623558	3293	3373	276	1	80	0.0125000
NODE_498_length_3393_cov_43.623558	3293	3373	283	1	80	0.0125000
NODE_498_length_3393_cov_43.623558	3293	3373	289	2	80	0.0250000
NODE_498_length_3393_cov_43.623558	3293	3373	293	2	80	0.0250000
NODE_498_length_3393_cov_43.623558	3293	3373	301	1	80	0.0125000
NODE_498_length_3393_cov_43.623558	3293	3373	305	1	80	0.0125000
NODE_498_length_3393_cov_43.623558	3293	3373	307	2	80	0.0250000
NODE_498_length_3393_cov_43.623558	3293	3373	310	3	80	0.0375000
NODE_498_length_3393_cov_43.623558	3293	3373	313	1	80	0.0125000
NODE_498_length_3393_cov_43.623558	3293	3373	317	1	80	0.0125000
NODE_498_length_3393_cov_43.623558	3293	3373	332	1	80	0.0125000
NODE_498_length_3393_cov_43.623558	3293	3373	334	1	80	0.0125000
NODE_498_length_3393_cov_43.623558	3293	3373	342	1	80	0.0125000
NODE_498_length_3393_cov_43.623558	3293	3373	349	1	80	0.0125000
NODE_498_length_3393_cov_43.623558	3293	3373	351	1	80	0.0125000
NODE_498_length_3393_cov_43.623558	3293	3373	355	1	80	0.0125000
NODE_498_length_3393_cov_43.623558	3293	3373	361	1	80	0.0125000
NODE_498_length_3393_cov_43.623558	3293	3373	365	2	80	0.0250000
NODE_498_length_3393_cov_43.623558	3293	3373	369	1	80	0.0125000
NODE_498_length_3393_cov_43.623558	3293	3373	371	1	80	0.0125000
NODE_498_length_3393_cov_43.623558	3293	3373	377	1	80	0.0125000
NODE_498_length_3393_cov_43.623558	3293	3373	386	2	80	0.0250000
NODE_498_length_3393_cov_43.623558	3293	3373	388	1	80	0.0125000
NODE_498_length_3393_cov_43.623558	3293	3373	394	1	80	0.0125000
NODE_498_length_3393_cov_43.623558	3293	3373	396	1	80	0.0125000
NODE_499_length_3392_cov_41.514728	255	335	0	19	80	0.2375000
NODE_499_length_3392_cov_41.514728	255	335	2	61	80	0.7625000
NODE_499_length_3392_cov_41.514728	308	388	0	20	80	0.2500000
NODE_499_length_3392_cov_41.514728	308	388	2	60	80	0.7500000
NODE_499_length_3392_cov_41.514728	917	997	90	2	80	0.0250000
NODE_499_length_3392_cov_41.514728	917	997	92	1	80	0.0125000
NODE_499_length_3392_cov_41.514728	917	997	93	1	80	0.0125000
NODE_499_length_3392_cov_41.514728	917	997	99	1	80	0.0125000
NODE_499_length_3392_cov_41.514728	917	997	105	2	80	0.0250000
NODE_499_length_3392_cov_41.514728	917	997	109	1	80	0.0125000
NODE_499_length_3392_cov_41.514728	917	997	112	1	80	0.0125000
NODE_499_length_3392_cov_41.514728	917	997	113	1	80	0.0125000
NODE_499_length_3392_cov_41.514728	917	997	117	1	80	0.0125000
NODE_499_length_3392_cov_41.514728	917	997	119	1	80	0.0125000
NODE_499_length_3392_cov_41.514728	917	997	129	1	80	0.0125000
NODE_499_length_3392_cov_41.514728	917	997	131	1	80	0.0125000
NODE_499_length_3392_cov_41.514728	917	997	138	1	80	0.0125000
NODE_499_length_3392_cov_41.514728	917	997	147	2	80	0.0250000
NODE_499_length_3392_cov_41.514728	917	997	154	1	80	0.0125000
NODE_499_length_3392_cov_41.514728	917	997	160	1	80	0.0125000
NODE_499_length_3392_cov_41.514728	917	997	182	1	80	0.0125000
NODE_499_length_3392_cov_41.514728	917	997	187	1	80	0.0125000
NODE_499_length_3392_cov_41.514728	917	997	195	1	80	0.0125000
NODE_499_length_3392_cov_41.514728	917	997	202	1	80	0.0125000
NODE_499_length_3392_cov_41.514728	917	997	204	1	80	0.0125000
NODE_499_length_3392_cov_41.514728	917	997	208	2	80	0.0250000
NODE_499_length_3392_cov_41.514728	917	997	215	1	80	0.0125000
NODE_499_length_3392_cov_41.514728	917	997	218	1	80	0.0125000
NODE_499_length_3392_cov_41.514728	917	997	222	1	80	0.0125000
NODE_499_length_3392_cov_41.514728	917	997	230	1	80	0.0125000
NODE_499_length_3392_cov_41.514728	917	997	234	2	80	0.0250000
NODE_499_length_3392_cov_41.514728	917	997	241	1	80	0.0125000
NODE_499_length_3392_cov_41.514728	917	997	242	1	80	0.0125000
NODE_499_length_3392_cov_41.514728	917	997	249	1	80	0.0125000
NODE_499_length_3392_cov_41.514728	917	997	258	1	80	0.0125000
NODE_499_length_3392_cov_41.514728	917	997	264	1	80	0.0125000
NODE_499_length_3392_cov_41.514728	917	997	266	1	80	0.0125000
NODE_499_length_3392_cov_41.514728	917	997	268	1	80	0.0125000
NODE_499_length_3392_cov_41.514728	917	997	270	1	80	0.0125000
NODE_499_length_3392_cov_41.514728	917	997	279	1	80	0.0125000
NODE_499_length_3392_cov_41.514728	917	997	286	2	80	0.0250000
NODE_499_length_3392_cov_41.514728	917	997	288	1	80	0.0125000
NODE_499_length_3392_cov_41.514728	917	997	290	1	80	0.0125000
NODE_499_length_3392_cov_41.514728	917	997	292	1	80	0.0125000
NODE_499_length_3392_cov_41.514728	917	997	296	1	80	0.0125000
NODE_499_length_3392_cov_41.514728	917	997	297	1	80	0.0125000
NODE_499_length_3392_cov_41.514728	917	997	300	1	80	0.0125000
NODE_499_length_3392_cov_41.514728	917	997	301	1	80	0.0125000
NODE_499_length_3392_cov_41.514728	917	997	302	1	80	0.0125000
NODE_499_length_3392_cov_41.514728	917	997	305	1	80	0.0125000
NODE_499_length_3392_cov_41.514728	917	997	314	1	80	0.0125000
NODE_499_length_3392_cov_41.514728	917	997	316	1	80	0.0125000
NODE_499_length_3392_cov_41.514728	917	997	320	1	80	0.0125000
NODE_499_length_3392_cov_41.514728	917	997	326	1	80	0.0125000
NODE_499_length_3392_cov_41.514728	917	997	334	1	80	0.0125000
NODE_499_length_3392_cov_41.514728	917	997	337	2	80	0.0250000
NODE_499_length_3392_cov_41.514728	917	997	344	1	80	0.0125000
NODE_499_length_3392_cov_41.514728	917	997	350	1	80	0.0125000
NODE_499_length_3392_cov_41.514728	917	997	363	2	80	0.0250000
NODE_499_length_3392_cov_41.514728	917	997	377	1	80	0.0125000
NODE_499_length_3392_cov_41.514728	917	997	381	1	80	0.0125000
NODE_499_length_3392_cov_41.514728	917	997	385	1	80	0.0125000
NODE_499_length_3392_cov_41.514728	917	997	396	1	80	0.0125000
NODE_499_length_3392_cov_41.514728	917	997	402	1	80	0.0125000
NODE_499_length_3392_cov_41.514728	917	997	410	2	80	0.0250000
NODE_499_length_3392_cov_41.514728	917	997	418	1	80	0.0125000
NODE_499_length_3392_cov_41.514728	917	997	423	1	80	0.0125000
NODE_499_length_3392_cov_41.514728	917	997	427	1	80	0.0125000
NODE_499_length_3392_cov_41.514728	917	997	433	1	80	0.0125000
NODE_499_length_3392_cov_41.514728	917	997	443	1	80	0.0125000
NODE_499_length_3392_cov_41.514728	917	997	444	2	80	0.0250000
NODE_499_length_3392_cov_41.514728	917	997	445	1	80	0.0125000
NODE_499_length_3392_cov_41.514728	917	997	450	1	80	0.0125000
NODE_499_length_3392_cov_41.514728	917	997	452	1	80	0.0125000
NODE_499_length_3392_cov_41.514728	970	1053	52	1	83	0.0120482
NODE_499_length_3392_cov_41.514728	970	1053	53	1	83	0.0120482
NODE_499_length_3392_cov_41.514728	970	1053	54	1	83	0.0120482
NODE_499_length_3392_cov_41.514728	970	1053	56	5	83	0.0602410
NODE_499_length_3392_cov_41.514728	970	1053	57	2	83	0.0240964
NODE_499_length_3392_cov_41.514728	970	1053	58	5	83	0.0602410
NODE_499_length_3392_cov_41.514728	970	1053	59	4	83	0.0481928
NODE_499_length_3392_cov_41.514728	970	1053	60	3	83	0.0361446
NODE_499_length_3392_cov_41.514728	970	1053	61	5	83	0.0602410
NODE_499_length_3392_cov_41.514728	970	1053	62	4	83	0.0481928
NODE_499_length_3392_cov_41.514728	970	1053	63	1	83	0.0120482
NODE_499_length_3392_cov_41.514728	970	1053	64	1	83	0.0120482
NODE_499_length_3392_cov_41.514728	970	1053	65	1	83	0.0120482
NODE_499_length_3392_cov_41.514728	970	1053	66	3	83	0.0361446
NODE_499_length_3392_cov_41.514728	970	1053	68	2	83	0.0240964
NODE_499_length_3392_cov_41.514728	970	1053	71	3	83	0.0361446
NODE_499_length_3392_cov_41.514728	970	1053	72	1	83	0.0120482
NODE_499_length_3392_cov_41.514728	970	1053	75	2	83	0.0240964
NODE_499_length_3392_cov_41.514728	970	1053	77	1	83	0.0120482
NODE_499_length_3392_cov_41.514728	970	1053	79	3	83	0.0361446
NODE_499_length_3392_cov_41.514728	970	1053	81	1	83	0.0120482
NODE_499_length_3392_cov_41.514728	970	1053	82	1	83	0.0120482
NODE_499_length_3392_cov_41.514728	970	1053	83	3	83	0.0361446
NODE_499_length_3392_cov_41.514728	970	1053	84	1	83	0.0120482
NODE_499_length_3392_cov_41.514728	970	1053	86	1	83	0.0120482
NODE_499_length_3392_cov_41.514728	970	1053	90	2	83	0.0240964
NODE_499_length_3392_cov_41.514728	970	1053	92	1	83	0.0120482
NODE_499_length_3392_cov_41.514728	970	1053	93	1	83	0.0120482
NODE_499_length_3392_cov_41.514728	970	1053	99	1	83	0.0120482
NODE_499_length_3392_cov_41.514728	970	1053	105	2	83	0.0240964
NODE_499_length_3392_cov_41.514728	970	1053	109	1	83	0.0120482
NODE_499_length_3392_cov_41.514728	970	1053	112	1	83	0.0120482
NODE_499_length_3392_cov_41.514728	970	1053	113	1	83	0.0120482
NODE_499_length_3392_cov_41.514728	970	1053	117	1	83	0.0120482
NODE_499_length_3392_cov_41.514728	970	1053	119	1	83	0.0120482
NODE_499_length_3392_cov_41.514728	970	1053	129	1	83	0.0120482
NODE_499_length_3392_cov_41.514728	970	1053	131	1	83	0.0120482
NODE_499_length_3392_cov_41.514728	970	1053	138	1	83	0.0120482
NODE_499_length_3392_cov_41.514728	970	1053	147	2	83	0.0240964
NODE_499_length_3392_cov_41.514728	970	1053	154	1	83	0.0120482
NODE_499_length_3392_cov_41.514728	970	1053	160	1	83	0.0120482
NODE_499_length_3392_cov_41.514728	970	1053	182	1	83	0.0120482
NODE_499_length_3392_cov_41.514728	970	1053	187	1	83	0.0120482
NODE_499_length_3392_cov_41.514728	970	1053	195	1	83	0.0120482
NODE_499_length_3392_cov_41.514728	970	1053	202	1	83	0.0120482
NODE_499_length_3392_cov_41.514728	970	1053	204	1	83	0.0120482
NODE_499_length_3392_cov_41.514728	970	1053	208	2	83	0.0240964
NODE_499_length_3392_cov_41.514728	970	1053	215	1	83	0.0120482
NODE_501_length_3389_cov_8.244073	2159	2239	0	80	80	1.0000000
NODE_501_length_3389_cov_8.244073	2212	2292	0	80	80	1.0000000
NODE_506_length_3363_cov_4.412684	56	124	18	3	68	0.0441176
NODE_506_length_3363_cov_4.412684	56	124	22	3	68	0.0441176
NODE_506_length_3363_cov_4.412684	56	124	28	1	68	0.0147059
NODE_506_length_3363_cov_4.412684	56	124	32	3	68	0.0441176
NODE_506_length_3363_cov_4.412684	56	124	36	4	68	0.0588235
NODE_506_length_3363_cov_4.412684	56	124	40	6	68	0.0882353
NODE_506_length_3363_cov_4.412684	56	124	44	48	68	0.7058824
NODE_510_length_3353_cov_2.687462	0	61	0	61	61	1.0000000
NODE_510_length_3353_cov_2.687462	0	61	0	61	61	1.0000000
NODE_510_length_3353_cov_2.687462	34	99	0	65	65	1.0000000
NODE_513_length_3348_cov_243.959372	2473	2553	263	1	80	0.0125000
NODE_513_length_3348_cov_243.959372	2473	2553	268	1	80	0.0125000
NODE_513_length_3348_cov_243.959372	2473	2553	269	2	80	0.0250000
NODE_513_length_3348_cov_243.959372	2473	2553	273	1	80	0.0125000
NODE_513_length_3348_cov_243.959372	2473	2553	275	1	80	0.0125000
NODE_513_length_3348_cov_243.959372	2473	2553	276	1	80	0.0125000
NODE_513_length_3348_cov_243.959372	2473	2553	277	2	80	0.0250000
NODE_513_length_3348_cov_243.959372	2473	2553	280	1	80	0.0125000
NODE_513_length_3348_cov_243.959372	2473	2553	281	1	80	0.0125000
NODE_513_length_3348_cov_243.959372	2473	2553	282	2	80	0.0250000
NODE_513_length_3348_cov_243.959372	2473	2553	284	2	80	0.0250000
NODE_513_length_3348_cov_243.959372	2473	2553	285	1	80	0.0125000
NODE_513_length_3348_cov_243.959372	2473	2553	286	5	80	0.0625000
NODE_513_length_3348_cov_243.959372	2473	2553	287	1	80	0.0125000
NODE_513_length_3348_cov_243.959372	2473	2553	288	1	80	0.0125000
NODE_513_length_3348_cov_243.959372	2473	2553	290	2	80	0.0250000
NODE_513_length_3348_cov_243.959372	2473	2553	291	2	80	0.0250000
NODE_513_length_3348_cov_243.959372	2473	2553	292	1	80	0.0125000
NODE_513_length_3348_cov_243.959372	2473	2553	294	1	80	0.0125000
NODE_513_length_3348_cov_243.959372	2473	2553	299	1	80	0.0125000
NODE_513_length_3348_cov_243.959372	2473	2553	306	1	80	0.0125000
NODE_513_length_3348_cov_243.959372	2473	2553	313	1	80	0.0125000
NODE_513_length_3348_cov_243.959372	2473	2553	322	1	80	0.0125000
NODE_513_length_3348_cov_243.959372	2473	2553	338	2	80	0.0250000
NODE_513_length_3348_cov_243.959372	2473	2553	344	1	80	0.0125000
NODE_513_length_3348_cov_243.959372	2473	2553	352	1	80	0.0125000
NODE_513_length_3348_cov_243.959372	2473	2553	360	1	80	0.0125000
NODE_513_length_3348_cov_243.959372	2473	2553	370	1	80	0.0125000
NODE_513_length_3348_cov_243.959372	2473	2553	372	1	80	0.0125000
NODE_513_length_3348_cov_243.959372	2473	2553	378	1	80	0.0125000
NODE_513_length_3348_cov_243.959372	2473	2553	381	1	80	0.0125000
NODE_513_length_3348_cov_243.959372	2473	2553	382	3	80	0.0375000
NODE_513_length_3348_cov_243.959372	2473	2553	385	2	80	0.0250000
NODE_513_length_3348_cov_243.959372	2473	2553	391	2	80	0.0250000
NODE_513_length_3348_cov_243.959372	2473	2553	393	1	80	0.0125000
NODE_513_length_3348_cov_243.959372	2473	2553	394	2	80	0.0250000
NODE_513_length_3348_cov_243.959372	2473	2553	406	1	80	0.0125000
NODE_513_length_3348_cov_243.959372	2473	2553	408	1	80	0.0125000
NODE_513_length_3348_cov_243.959372	2473	2553	410	1	80	0.0125000
NODE_513_length_3348_cov_243.959372	2473	2553	417	1	80	0.0125000
NODE_513_length_3348_cov_243.959372	2473	2553	420	1	80	0.0125000
NODE_513_length_3348_cov_243.959372	2473	2553	427	1	80	0.0125000
NODE_513_length_3348_cov_243.959372	2473	2553	429	1	80	0.0125000
NODE_513_length_3348_cov_243.959372	2473	2553	430	3	80	0.0375000
NODE_513_length_3348_cov_243.959372	2473	2553	434	1	80	0.0125000
NODE_513_length_3348_cov_243.959372	2473	2553	435	2	80	0.0250000
NODE_513_length_3348_cov_243.959372	2473	2553	438	2	80	0.0250000
NODE_513_length_3348_cov_243.959372	2473	2553	456	1	80	0.0125000
NODE_513_length_3348_cov_243.959372	2473	2553	463	1	80	0.0125000
NODE_513_length_3348_cov_243.959372	2473	2553	478	1	80	0.0125000
NODE_513_length_3348_cov_243.959372	2473	2553	494	1	80	0.0125000
NODE_513_length_3348_cov_243.959372	2473	2553	498	1	80	0.0125000
NODE_513_length_3348_cov_243.959372	2473	2553	500	1	80	0.0125000
NODE_513_length_3348_cov_243.959372	2473	2553	529	1	80	0.0125000
NODE_513_length_3348_cov_243.959372	2473	2553	543	1	80	0.0125000
NODE_513_length_3348_cov_243.959372	2473	2553	545	1	80	0.0125000
NODE_513_length_3348_cov_243.959372	2473	2553	547	1	80	0.0125000
NODE_513_length_3348_cov_243.959372	2473	2553	551	1	80	0.0125000
NODE_513_length_3348_cov_243.959372	2473	2553	557	1	80	0.0125000
NODE_513_length_3348_cov_243.959372	2473	2553	566	1	80	0.0125000
NODE_513_length_3348_cov_243.959372	2526	2606	263	1	80	0.0125000
NODE_513_length_3348_cov_243.959372	2526	2606	268	1	80	0.0125000
NODE_513_length_3348_cov_243.959372	2526	2606	269	2	80	0.0250000
NODE_513_length_3348_cov_243.959372	2526	2606	273	1	80	0.0125000
NODE_513_length_3348_cov_243.959372	2526	2606	275	1	80	0.0125000
NODE_513_length_3348_cov_243.959372	2526	2606	276	1	80	0.0125000
NODE_513_length_3348_cov_243.959372	2526	2606	277	1	80	0.0125000
NODE_513_length_3348_cov_243.959372	2526	2606	280	1	80	0.0125000
NODE_513_length_3348_cov_243.959372	2526	2606	281	1	80	0.0125000
NODE_513_length_3348_cov_243.959372	2526	2606	282	2	80	0.0250000
NODE_513_length_3348_cov_243.959372	2526	2606	284	2	80	0.0250000
NODE_513_length_3348_cov_243.959372	2526	2606	286	5	80	0.0625000
NODE_513_length_3348_cov_243.959372	2526	2606	287	1	80	0.0125000
NODE_513_length_3348_cov_243.959372	2526	2606	288	1	80	0.0125000
NODE_513_length_3348_cov_243.959372	2526	2606	290	2	80	0.0250000
NODE_513_length_3348_cov_243.959372	2526	2606	291	2	80	0.0250000
NODE_513_length_3348_cov_243.959372	2526	2606	292	1	80	0.0125000
NODE_513_length_3348_cov_243.959372	2526	2606	294	1	80	0.0125000
NODE_513_length_3348_cov_243.959372	2526	2606	302	1	80	0.0125000
NODE_513_length_3348_cov_243.959372	2526	2606	315	2	80	0.0250000
NODE_513_length_3348_cov_243.959372	2526	2606	317	1	80	0.0125000
NODE_513_length_3348_cov_243.959372	2526	2606	321	1	80	0.0125000
NODE_513_length_3348_cov_243.959372	2526	2606	328	1	80	0.0125000
NODE_513_length_3348_cov_243.959372	2526	2606	337	1	80	0.0125000
NODE_513_length_3348_cov_243.959372	2526	2606	338	1	80	0.0125000
NODE_513_length_3348_cov_243.959372	2526	2606	343	1	80	0.0125000
NODE_513_length_3348_cov_243.959372	2526	2606	350	1	80	0.0125000
NODE_513_length_3348_cov_243.959372	2526	2606	351	1	80	0.0125000
NODE_513_length_3348_cov_243.959372	2526	2606	353	2	80	0.0250000
NODE_513_length_3348_cov_243.959372	2526	2606	355	3	80	0.0375000
NODE_513_length_3348_cov_243.959372	2526	2606	356	5	80	0.0625000
NODE_513_length_3348_cov_243.959372	2526	2606	357	3	80	0.0375000
NODE_513_length_3348_cov_243.959372	2526	2606	358	6	80	0.0750000
NODE_513_length_3348_cov_243.959372	2526	2606	360	1	80	0.0125000
NODE_513_length_3348_cov_243.959372	2526	2606	361	1	80	0.0125000
NODE_513_length_3348_cov_243.959372	2526	2606	362	1	80	0.0125000
NODE_513_length_3348_cov_243.959372	2526	2606	364	7	80	0.0875000
NODE_513_length_3348_cov_243.959372	2526	2606	365	3	80	0.0375000
NODE_513_length_3348_cov_243.959372	2526	2606	366	2	80	0.0250000
NODE_513_length_3348_cov_243.959372	2526	2606	367	1	80	0.0125000
NODE_513_length_3348_cov_243.959372	2526	2606	374	1	80	0.0125000
NODE_513_length_3348_cov_243.959372	2526	2606	376	1	80	0.0125000
NODE_513_length_3348_cov_243.959372	2526	2606	377	1	80	0.0125000
NODE_513_length_3348_cov_243.959372	2526	2606	378	1	80	0.0125000
NODE_513_length_3348_cov_243.959372	2526	2606	379	1	80	0.0125000
NODE_513_length_3348_cov_243.959372	2526	2606	381	2	80	0.0250000
NODE_514_length_3348_cov_31.953216	103	183	0	80	80	1.0000000
NODE_514_length_3348_cov_31.953216	105	179	0	74	74	1.0000000
NODE_514_length_3348_cov_31.953216	156	236	0	80	80	1.0000000
NODE_514_length_3348_cov_31.953216	156	236	0	80	80	1.0000000
NODE_514_length_3348_cov_31.953216	2405	2476	61	2	71	0.0281690
NODE_514_length_3348_cov_31.953216	2405	2476	65	1	71	0.0140845
NODE_514_length_3348_cov_31.953216	2405	2476	67	1	71	0.0140845
NODE_514_length_3348_cov_31.953216	2405	2476	69	5	71	0.0704225
NODE_514_length_3348_cov_31.953216	2405	2476	71	1	71	0.0140845
NODE_514_length_3348_cov_31.953216	2405	2476	73	2	71	0.0281690
NODE_514_length_3348_cov_31.953216	2405	2476	75	3	71	0.0422535
NODE_514_length_3348_cov_31.953216	2405	2476	77	3	71	0.0422535
NODE_514_length_3348_cov_31.953216	2405	2476	79	1	71	0.0140845
NODE_514_length_3348_cov_31.953216	2405	2476	80	1	71	0.0140845
NODE_514_length_3348_cov_31.953216	2405	2476	81	2	71	0.0281690
NODE_514_length_3348_cov_31.953216	2405	2476	82	1	71	0.0140845
NODE_514_length_3348_cov_31.953216	2405	2476	83	3	71	0.0422535
NODE_514_length_3348_cov_31.953216	2405	2476	85	1	71	0.0140845
NODE_514_length_3348_cov_31.953216	2405	2476	87	2	71	0.0281690
NODE_514_length_3348_cov_31.953216	2405	2476	88	2	71	0.0281690
NODE_514_length_3348_cov_31.953216	2405	2476	89	5	71	0.0704225
NODE_514_length_3348_cov_31.953216	2405	2476	91	1	71	0.0140845
NODE_514_length_3348_cov_31.953216	2405	2476	95	1	71	0.0140845
NODE_514_length_3348_cov_31.953216	2405	2476	96	1	71	0.0140845
NODE_514_length_3348_cov_31.953216	2405	2476	98	2	71	0.0281690
NODE_514_length_3348_cov_31.953216	2405	2476	99	2	71	0.0281690
NODE_514_length_3348_cov_31.953216	2405	2476	100	7	71	0.0985916
NODE_514_length_3348_cov_31.953216	2405	2476	102	2	71	0.0281690
NODE_514_length_3348_cov_31.953216	2405	2476	110	1	71	0.0140845
NODE_514_length_3348_cov_31.953216	2405	2476	112	1	71	0.0140845
NODE_514_length_3348_cov_31.953216	2405	2476	114	6	71	0.0845070
NODE_514_length_3348_cov_31.953216	2405	2476	116	2	71	0.0281690
NODE_514_length_3348_cov_31.953216	2405	2476	117	3	71	0.0422535
NODE_514_length_3348_cov_31.953216	2405	2476	119	2	71	0.0281690
NODE_514_length_3348_cov_31.953216	2405	2476	120	1	71	0.0140845
NODE_514_length_3348_cov_31.953216	2405	2476	123	2	71	0.0281690
NODE_514_length_3348_cov_31.953216	2405	2476	125	1	71	0.0140845
NODE_514_length_3348_cov_31.953216	2458	2529	112	1	71	0.0140845
NODE_514_length_3348_cov_31.953216	2458	2529	114	6	71	0.0845070
NODE_514_length_3348_cov_31.953216	2458	2529	116	2	71	0.0281690
NODE_514_length_3348_cov_31.953216	2458	2529	117	3	71	0.0422535
NODE_514_length_3348_cov_31.953216	2458	2529	118	1	71	0.0140845
NODE_514_length_3348_cov_31.953216	2458	2529	119	5	71	0.0704225
NODE_514_length_3348_cov_31.953216	2458	2529	120	1	71	0.0140845
NODE_514_length_3348_cov_31.953216	2458	2529	121	2	71	0.0281690
NODE_514_length_3348_cov_31.953216	2458	2529	122	2	71	0.0281690
NODE_514_length_3348_cov_31.953216	2458	2529	123	5	71	0.0704225
NODE_514_length_3348_cov_31.953216	2458	2529	124	1	71	0.0140845
NODE_514_length_3348_cov_31.953216	2458	2529	125	5	71	0.0704225
NODE_514_length_3348_cov_31.953216	2458	2529	126	5	71	0.0704225
NODE_514_length_3348_cov_31.953216	2458	2529	127	2	71	0.0281690
NODE_514_length_3348_cov_31.953216	2458	2529	128	3	71	0.0422535
NODE_514_length_3348_cov_31.953216	2458	2529	129	2	71	0.0281690
NODE_514_length_3348_cov_31.953216	2458	2529	130	3	71	0.0422535
NODE_514_length_3348_cov_31.953216	2458	2529	131	3	71	0.0422535
NODE_514_length_3348_cov_31.953216	2458	2529	132	3	71	0.0422535
NODE_514_length_3348_cov_31.953216	2458	2529	133	1	71	0.0140845
NODE_514_length_3348_cov_31.953216	2458	2529	134	2	71	0.0281690
NODE_514_length_3348_cov_31.953216	2458	2529	135	1	71	0.0140845
NODE_514_length_3348_cov_31.953216	2458	2529	136	4	71	0.0563380
NODE_514_length_3348_cov_31.953216	2458	2529	137	4	71	0.0563380
NODE_514_length_3348_cov_31.953216	2458	2529	138	2	71	0.0281690
NODE_514_length_3348_cov_31.953216	2458	2529	139	2	71	0.0281690
NODE_517_length_3335_cov_19.649567	2100	2180	4	5	80	0.0625000
NODE_517_length_3335_cov_19.649567	2100	2180	6	5	80	0.0625000
NODE_517_length_3335_cov_19.649567	2100	2180	8	21	80	0.2625000
NODE_517_length_3335_cov_19.649567	2100	2180	13	21	80	0.2625000
NODE_517_length_3335_cov_19.649567	2100	2180	14	28	80	0.3500000
NODE_517_length_3335_cov_19.649567	2153	2233	6	9	80	0.1125000
NODE_517_length_3335_cov_19.649567	2153	2233	8	4	80	0.0500000
NODE_517_length_3335_cov_19.649567	2153	2233	10	5	80	0.0625000
NODE_517_length_3335_cov_19.649567	2153	2233	11	2	80	0.0250000
NODE_517_length_3335_cov_19.649567	2153	2233	12	16	80	0.2000000
NODE_517_length_3335_cov_19.649567	2153	2233	13	28	80	0.3500000
NODE_517_length_3335_cov_19.649567	2153	2233	14	16	80	0.2000000
NODE_517_length_3335_cov_19.649567	2229	2309	6	11	80	0.1375000
NODE_517_length_3335_cov_19.649567	2229	2309	7	1	80	0.0125000
NODE_517_length_3335_cov_19.649567	2229	2309	8	16	80	0.2000000
NODE_517_length_3335_cov_19.649567	2229	2309	10	39	80	0.4875000
NODE_517_length_3335_cov_19.649567	2229	2309	12	13	80	0.1625000
NODE_517_length_3335_cov_19.649567	2282	2362	6	14	80	0.1750000
NODE_517_length_3335_cov_19.649567	2282	2362	8	14	80	0.1750000
NODE_517_length_3335_cov_19.649567	2282	2362	10	29	80	0.3625000
NODE_517_length_3335_cov_19.649567	2282	2362	12	23	80	0.2875000
NODE_518_length_3333_cov_24.805504	734	814	2	80	80	1.0000000
NODE_518_length_3333_cov_24.805504	787	867	0	24	80	0.3000000
NODE_518_length_3333_cov_24.805504	787	867	2	56	80	0.7000000
NODE_523_length_3312_cov_6.996576	85	165	2	49	80	0.6125000
NODE_523_length_3312_cov_6.996576	85	165	4	31	80	0.3875000
NODE_523_length_3312_cov_6.996576	138	218	2	18	80	0.2250000
NODE_523_length_3312_cov_6.996576	138	218	4	62	80	0.7750000
NODE_525_length_3302_cov_3.859195	3184	3262	0	4	78	0.0512821
NODE_525_length_3302_cov_3.859195	3184	3262	2	74	78	0.9487180
NODE_525_length_3302_cov_3.859195	3184	3253	2	69	69	1.0000000
NODE_526_length_3299_cov_6.014687	1632	1688	2	1	56	0.0178571
NODE_526_length_3299_cov_6.014687	1632	1688	5	1	56	0.0178571
NODE_526_length_3299_cov_6.014687	1632	1688	7	54	56	0.9642857
NODE_530_length_3290_cov_17.805390	773	853	7	1	80	0.0125000
NODE_530_length_3290_cov_17.805390	773	853	8	5	80	0.0625000
NODE_530_length_3290_cov_17.805390	773	853	10	11	80	0.1375000
NODE_530_length_3290_cov_17.805390	773	853	12	2	80	0.0250000
NODE_530_length_3290_cov_17.805390	773	853	20	11	80	0.1375000
NODE_530_length_3290_cov_17.805390	773	853	22	13	80	0.1625000
NODE_530_length_3290_cov_17.805390	773	853	24	8	80	0.1000000
NODE_530_length_3290_cov_17.805390	773	853	26	29	80	0.3625000
NODE_530_length_3290_cov_17.805390	826	906	6	7	80	0.0875000
NODE_530_length_3290_cov_17.805390	826	906	8	2	80	0.0250000
NODE_530_length_3290_cov_17.805390	826	906	10	12	80	0.1500000
NODE_530_length_3290_cov_17.805390	826	906	16	5	80	0.0625000
NODE_530_length_3290_cov_17.805390	826	906	18	9	80	0.1125000
NODE_530_length_3290_cov_17.805390	826	906	20	9	80	0.1125000
NODE_530_length_3290_cov_17.805390	826	906	24	13	80	0.1625000
NODE_530_length_3290_cov_17.805390	826	906	26	23	80	0.2875000
NODE_531_length_3290_cov_12.352554	2749	2829	0	61	80	0.7625000
NODE_531_length_3290_cov_12.352554	2749	2829	2	19	80	0.2375000
NODE_531_length_3290_cov_12.352554	2802	2882	0	12	80	0.1500000
NODE_531_length_3290_cov_12.352554	2802	2882	2	68	80	0.8500000
NODE_532_length_3286_cov_5.973015	0	50	0	13	50	0.2600000
NODE_532_length_3286_cov_5.973015	0	50	2	37	50	0.7400000
NODE_532_length_3286_cov_5.973015	0	50	0	13	50	0.2600000
NODE_532_length_3286_cov_5.973015	0	50	2	37	50	0.7400000
NODE_532_length_3286_cov_5.973015	0	50	0	13	50	0.2600000
NODE_532_length_3286_cov_5.973015	0	50	2	37	50	0.7400000
NODE_532_length_3286_cov_5.973015	23	89	2	66	66	1.0000000
NODE_532_length_3286_cov_5.973015	23	94	2	71	71	1.0000000
NODE_533_length_3284_cov_6.453689	313	392	0	56	79	0.7088608
NODE_533_length_3284_cov_6.453689	313	392	2	22	79	0.2784810
NODE_533_length_3284_cov_6.453689	313	392	4	1	79	0.0126582
NODE_533_length_3284_cov_6.453689	365	445	0	80	80	1.0000000
NODE_541_length_3267_cov_12.768624	11	91	2	4	80	0.0500000
NODE_541_length_3267_cov_12.768624	11	91	4	1	80	0.0125000
NODE_541_length_3267_cov_12.768624	11	91	6	4	80	0.0500000
NODE_541_length_3267_cov_12.768624	11	91	8	2	80	0.0250000
NODE_541_length_3267_cov_12.768624	11	91	12	9	80	0.1125000
NODE_541_length_3267_cov_12.768624	11	91	14	11	80	0.1375000
NODE_541_length_3267_cov_12.768624	11	91	16	1	80	0.0125000
NODE_541_length_3267_cov_12.768624	11	91	20	4	80	0.0500000
NODE_541_length_3267_cov_12.768624	11	91	22	4	80	0.0500000
NODE_541_length_3267_cov_12.768624	11	91	24	7	80	0.0875000
NODE_541_length_3267_cov_12.768624	11	91	26	21	80	0.2625000
NODE_541_length_3267_cov_12.768624	11	91	28	2	80	0.0250000
NODE_541_length_3267_cov_12.768624	11	91	30	7	80	0.0875000
NODE_541_length_3267_cov_12.768624	11	91	36	3	80	0.0375000
NODE_542_length_3266_cov_14.108304	2620	2684	2	64	64	1.0000000
NODE_542_length_3266_cov_14.108304	2620	2684	2	64	64	1.0000000
NODE_542_length_3266_cov_14.108304	2620	2684	2	64	64	1.0000000
NODE_547_length_3242_cov_12.407891	391	471	0	80	80	1.0000000
NODE_547_length_3242_cov_12.407891	444	524	0	44	80	0.5500000
NODE_547_length_3242_cov_12.407891	444	524	2	36	80	0.4500000
NODE_550_length_3233_cov_19.903957	411	491	0	80	80	1.0000000
NODE_550_length_3233_cov_19.903957	411	491	0	80	80	1.0000000
NODE_550_length_3233_cov_19.903957	464	544	0	80	80	1.0000000
NODE_552_length_3232_cov_11.378870	2586	2621	2	35	35	1.0000000
NODE_555_length_3214_cov_22.853291	2090	2170	20	3	80	0.0375000
NODE_555_length_3214_cov_22.853291	2090	2170	22	4	80	0.0500000
NODE_555_length_3214_cov_22.853291	2090	2170	24	1	80	0.0125000
NODE_555_length_3214_cov_22.853291	2090	2170	26	15	80	0.1875000
NODE_555_length_3214_cov_22.853291	2090	2170	28	8	80	0.1000000
NODE_555_length_3214_cov_22.853291	2090	2170	30	26	80	0.3250000
NODE_555_length_3214_cov_22.853291	2090	2170	32	19	80	0.2375000
NODE_555_length_3214_cov_22.853291	2090	2170	34	4	80	0.0500000
NODE_555_length_3214_cov_22.853291	2143	2223	20	9	80	0.1125000
NODE_555_length_3214_cov_22.853291	2143	2223	22	4	80	0.0500000
NODE_555_length_3214_cov_22.853291	2143	2223	24	14	80	0.1750000
NODE_555_length_3214_cov_22.853291	2143	2223	25	4	80	0.0500000
NODE_555_length_3214_cov_22.853291	2143	2223	26	28	80	0.3500000
NODE_555_length_3214_cov_22.853291	2143	2223	28	8	80	0.1000000
NODE_555_length_3214_cov_22.853291	2143	2223	30	9	80	0.1125000
NODE_555_length_3214_cov_22.853291	2143	2223	32	2	80	0.0250000
NODE_555_length_3214_cov_22.853291	2143	2223	34	2	80	0.0250000
NODE_555_length_3214_cov_22.853291	3028	3086	6	2	58	0.0344828
NODE_555_length_3214_cov_22.853291	3028	3086	8	1	58	0.0172414
NODE_555_length_3214_cov_22.853291	3028	3086	10	1	58	0.0172414
NODE_555_length_3214_cov_22.853291	3028	3086	11	12	58	0.2068966
NODE_555_length_3214_cov_22.853291	3028	3086	12	10	58	0.1724138
NODE_555_length_3214_cov_22.853291	3028	3086	16	23	58	0.3965517
NODE_555_length_3214_cov_22.853291	3028	3086	18	6	58	0.1034483
NODE_555_length_3214_cov_22.853291	3028	3086	19	1	58	0.0172414
NODE_555_length_3214_cov_22.853291	3028	3086	21	1	58	0.0172414
NODE_555_length_3214_cov_22.853291	3028	3086	23	1	58	0.0172414
NODE_556_length_3211_cov_1.921915	95	175	2	7	80	0.0875000
NODE_556_length_3211_cov_1.921915	95	175	3	5	80	0.0625000
NODE_556_length_3211_cov_1.921915	95	175	4	7	80	0.0875000
NODE_556_length_3211_cov_1.921915	95	175	6	2	80	0.0250000
NODE_556_length_3211_cov_1.921915	95	175	8	23	80	0.2875000
NODE_556_length_3211_cov_1.921915	95	175	10	14	80	0.1750000
NODE_556_length_3211_cov_1.921915	95	175	12	22	80	0.2750000
NODE_556_length_3211_cov_1.921915	148	178	2	10	30	0.3333333
NODE_556_length_3211_cov_1.921915	148	178	3	5	30	0.1666667
NODE_556_length_3211_cov_1.921915	148	178	4	7	30	0.2333333
NODE_556_length_3211_cov_1.921915	148	178	6	2	30	0.0666667
NODE_556_length_3211_cov_1.921915	148	178	8	6	30	0.2000000
NODE_557_length_3210_cov_7.428480	2040	2111	2	8	71	0.1126761
NODE_557_length_3210_cov_7.428480	2040	2111	4	1	71	0.0140845
NODE_557_length_3210_cov_7.428480	2040	2111	8	5	71	0.0704225
NODE_557_length_3210_cov_7.428480	2040	2111	10	9	71	0.1267606
NODE_557_length_3210_cov_7.428480	2040	2111	12	48	71	0.6760563
NODE_557_length_3210_cov_7.428480	2084	2164	2	2	80	0.0250000
NODE_557_length_3210_cov_7.428480	2084	2164	4	4	80	0.0500000
NODE_557_length_3210_cov_7.428480	2084	2164	6	27	80	0.3375000
NODE_557_length_3210_cov_7.428480	2084	2164	8	5	80	0.0625000
NODE_557_length_3210_cov_7.428480	2084	2164	10	4	80	0.0500000
NODE_557_length_3210_cov_7.428480	2084	2164	12	38	80	0.4750000
NODE_557_length_3210_cov_7.428480	2715	2797	0	82	82	1.0000000
NODE_557_length_3210_cov_7.428480	2770	2850	0	80	80	1.0000000
NODE_562_length_3201_cov_3.591231	3120	3200	0	33	80	0.4125000
NODE_562_length_3201_cov_3.591231	3120	3200	2	47	80	0.5875000
NODE_566_length_3189_cov_69.446602	137	188	0	51	51	1.0000000
NODE_567_length_3188_cov_7.233085	1663	1743	2	8	80	0.1000000
NODE_567_length_3188_cov_7.233085	1663	1743	4	23	80	0.2875000
NODE_567_length_3188_cov_7.233085	1663	1743	5	41	80	0.5125000
NODE_567_length_3188_cov_7.233085	1663	1743	6	8	80	0.1000000
NODE_567_length_3188_cov_7.233085	1716	1796	2	53	80	0.6625000
NODE_567_length_3188_cov_7.233085	1716	1796	4	19	80	0.2375000
NODE_567_length_3188_cov_7.233085	1716	1796	5	8	80	0.1000000
NODE_570_length_3177_cov_2.789474	2021	2042	0	21	21	1.0000000
NODE_575_length_3158_cov_19.018960	840	920	0	20	80	0.2500000
NODE_575_length_3158_cov_19.018960	840	920	2	60	80	0.7500000
NODE_575_length_3158_cov_19.018960	893	973	2	72	80	0.9000000
NODE_575_length_3158_cov_19.018960	893	973	4	8	80	0.1000000
NODE_575_length_3158_cov_19.018960	2833	2915	0	82	82	1.0000000
NODE_575_length_3158_cov_19.018960	2888	2959	0	71	71	1.0000000
NODE_576_length_3150_cov_26.520813	770	850	12	5	80	0.0625000
NODE_576_length_3150_cov_26.520813	770	850	13	14	80	0.1750000
NODE_576_length_3150_cov_26.520813	770	850	15	5	80	0.0625000
NODE_576_length_3150_cov_26.520813	770	850	17	4	80	0.0500000
NODE_576_length_3150_cov_26.520813	770	850	19	33	80	0.4125000
NODE_576_length_3150_cov_26.520813	770	850	21	19	80	0.2375000
NODE_576_length_3150_cov_26.520813	823	901	0	13	78	0.1666667
NODE_576_length_3150_cov_26.520813	823	901	1	3	78	0.0384615
NODE_576_length_3150_cov_26.520813	823	901	5	10	78	0.1282051
NODE_576_length_3150_cov_26.520813	823	901	7	3	78	0.0384615
NODE_576_length_3150_cov_26.520813	823	901	9	7	78	0.0897436
NODE_576_length_3150_cov_26.520813	823	901	11	8	78	0.1025641
NODE_576_length_3150_cov_26.520813	823	901	13	17	78	0.2179487
NODE_576_length_3150_cov_26.520813	823	901	15	3	78	0.0384615
NODE_576_length_3150_cov_26.520813	823	901	17	4	78	0.0512821
NODE_576_length_3150_cov_26.520813	823	901	19	2	78	0.0256410
NODE_576_length_3150_cov_26.520813	823	901	21	8	78	0.1025641
NODE_576_length_3150_cov_26.520813	2616	2696	2	71	80	0.8875000
NODE_576_length_3150_cov_26.520813	2616	2696	4	9	80	0.1125000
NODE_576_length_3150_cov_26.520813	2669	2749	0	12	80	0.1500000
NODE_576_length_3150_cov_26.520813	2669	2749	2	68	80	0.8500000
NODE_577_length_3150_cov_5.923959	2313	2393	5	15	80	0.1875000
NODE_577_length_3150_cov_5.923959	2313	2393	7	8	80	0.1000000
NODE_577_length_3150_cov_5.923959	2313	2393	9	16	80	0.2000000
NODE_577_length_3150_cov_5.923959	2313	2393	10	7	80	0.0875000
NODE_577_length_3150_cov_5.923959	2313	2393	12	34	80	0.4250000
NODE_579_length_3148_cov_2.313873	3053	3105	0	52	52	1.0000000
NODE_581_length_3146_cov_18.277322	2418	2498	0	80	80	1.0000000
NODE_581_length_3146_cov_18.277322	2471	2551	0	74	80	0.9250000
NODE_581_length_3146_cov_18.277322	2471	2551	2	6	80	0.0750000
NODE_581_length_3146_cov_18.277322	2547	2627	2	28	80	0.3500000
NODE_581_length_3146_cov_18.277322	2547	2627	6	27	80	0.3375000
NODE_581_length_3146_cov_18.277322	2547	2627	10	8	80	0.1000000
NODE_581_length_3146_cov_18.277322	2547	2627	12	17	80	0.2125000
NODE_581_length_3146_cov_18.277322	2600	2680	6	2	80	0.0250000
NODE_581_length_3146_cov_18.277322	2600	2680	10	21	80	0.2625000
NODE_581_length_3146_cov_18.277322	2600	2680	12	29	80	0.3625000
NODE_581_length_3146_cov_18.277322	2600	2680	14	28	80	0.3500000
NODE_581_length_3146_cov_18.277322	2975	3055	0	80	80	1.0000000
NODE_585_length_3134_cov_8.717957	1290	1362	6	4	72	0.0555556
NODE_585_length_3134_cov_8.717957	1290	1362	8	43	72	0.5972222
NODE_585_length_3134_cov_8.717957	1290	1362	10	3	72	0.0416667
NODE_585_length_3134_cov_8.717957	1290	1362	14	4	72	0.0555556
NODE_585_length_3134_cov_8.717957	1290	1362	16	10	72	0.1388889
NODE_585_length_3134_cov_8.717957	1290	1362	17	8	72	0.1111111
NODE_585_length_3134_cov_8.717957	1335	1415	8	2	80	0.0250000
NODE_585_length_3134_cov_8.717957	1335	1415	10	3	80	0.0375000
NODE_585_length_3134_cov_8.717957	1335	1415	13	2	80	0.0250000
NODE_585_length_3134_cov_8.717957	1335	1415	14	36	80	0.4500000
NODE_585_length_3134_cov_8.717957	1335	1415	15	1	80	0.0125000
NODE_585_length_3134_cov_8.717957	1335	1415	16	27	80	0.3375000
NODE_585_length_3134_cov_8.717957	1335	1415	17	9	80	0.1125000
NODE_586_length_3131_cov_26.910620	232	312	0	49	80	0.6125000
NODE_586_length_3131_cov_26.910620	232	312	2	3	80	0.0375000
NODE_586_length_3131_cov_26.910620	232	312	4	28	80	0.3500000
NODE_586_length_3131_cov_26.910620	285	364	2	2	79	0.0253165
NODE_586_length_3131_cov_26.910620	285	364	4	77	79	0.9746835
NODE_586_length_3131_cov_26.910620	2151	2231	0	80	80	1.0000000
NODE_586_length_3131_cov_26.910620	2155	2227	0	72	72	1.0000000
NODE_586_length_3131_cov_26.910620	2204	2284	0	80	80	1.0000000
NODE_586_length_3131_cov_26.910620	2208	2284	0	76	76	1.0000000
NODE_586_length_3131_cov_26.910620	2280	2360	0	80	80	1.0000000
NODE_586_length_3131_cov_26.910620	2333	2413	0	80	80	1.0000000
NODE_590_length_3118_cov_5.059622	367	445	0	78	78	1.0000000
NODE_590_length_3118_cov_5.059622	418	498	0	80	80	1.0000000
NODE_591_length_3117_cov_5.938038	2525	2605	0	80	80	1.0000000
NODE_591_length_3117_cov_5.938038	2578	2658	0	80	80	1.0000000
NODE_595_length_3110_cov_31.733643	2864	2923	0	59	59	1.0000000
NODE_602_length_3093_cov_54.559786	571	651	0	80	80	1.0000000
NODE_602_length_3093_cov_54.559786	624	704	0	80	80	1.0000000
NODE_602_length_3093_cov_54.559786	2901	2981	29	2	80	0.0250000
NODE_602_length_3093_cov_54.559786	2901	2981	30	6	80	0.0750000
NODE_602_length_3093_cov_54.559786	2901	2981	31	4	80	0.0500000
NODE_602_length_3093_cov_54.559786	2901	2981	32	10	80	0.1250000
NODE_602_length_3093_cov_54.559786	2901	2981	33	3	80	0.0375000
NODE_602_length_3093_cov_54.559786	2901	2981	34	3	80	0.0375000
NODE_602_length_3093_cov_54.559786	2901	2981	35	4	80	0.0500000
NODE_602_length_3093_cov_54.559786	2901	2981	37	45	80	0.5625000
NODE_602_length_3093_cov_54.559786	2901	2981	39	1	80	0.0125000
NODE_602_length_3093_cov_54.559786	2901	2981	41	2	80	0.0250000
NODE_602_length_3093_cov_54.559786	2954	3034	4	4	80	0.0500000
NODE_602_length_3093_cov_54.559786	2954	3034	7	2	80	0.0250000
NODE_602_length_3093_cov_54.559786	2954	3034	9	1	80	0.0125000
NODE_602_length_3093_cov_54.559786	2954	3034	11	25	80	0.3125000
NODE_602_length_3093_cov_54.559786	2954	3034	13	5	80	0.0625000
NODE_602_length_3093_cov_54.559786	2954	3034	15	2	80	0.0250000
NODE_602_length_3093_cov_54.559786	2954	3034	17	7	80	0.0875000
NODE_602_length_3093_cov_54.559786	2954	3034	23	2	80	0.0250000
NODE_602_length_3093_cov_54.559786	2954	3034	25	3	80	0.0375000
NODE_602_length_3093_cov_54.559786	2954	3034	29	4	80	0.0500000
NODE_602_length_3093_cov_54.559786	2954	3034	31	4	80	0.0500000
NODE_602_length_3093_cov_54.559786	2954	3034	33	3	80	0.0375000
NODE_602_length_3093_cov_54.559786	2954	3034	35	1	80	0.0125000
NODE_602_length_3093_cov_54.559786	2954	3034	37	14	80	0.1750000
NODE_602_length_3093_cov_54.559786	2954	3034	39	1	80	0.0125000
NODE_602_length_3093_cov_54.559786	2954	3034	41	2	80	0.0250000
NODE_603_length_3091_cov_35.895722	1743	1804	0	61	61	1.0000000
NODE_603_length_3091_cov_35.895722	1777	1857	0	80	80	1.0000000
NODE_603_length_3091_cov_35.895722	2472	2535	0	63	63	1.0000000
NODE_603_length_3091_cov_35.895722	2508	2553	0	45	45	1.0000000
NODE_603_length_3091_cov_35.895722	2534	2604	0	26	70	0.3714286
NODE_603_length_3091_cov_35.895722	2534	2604	4	44	70	0.6285715
NODE_603_length_3091_cov_35.895722	2578	2618	4	40	40	1.0000000
NODE_603_length_3091_cov_35.895722	2586	2623	2	1	37	0.0270270
NODE_603_length_3091_cov_35.895722	2586	2623	4	36	37	0.9729730
NODE_603_length_3091_cov_35.895722	2626	2671	0	42	45	0.9333333
NODE_603_length_3091_cov_35.895722	2626	2671	2	3	45	0.0666667
NODE_603_length_3091_cov_35.895722	2682	2730	0	48	48	1.0000000
NODE_603_length_3091_cov_35.895722	2918	2969	0	51	51	1.0000000
NODE_603_length_3091_cov_35.895722	2942	2987	0	45	45	1.0000000
NODE_603_length_3091_cov_35.895722	2994	3039	0	45	45	1.0000000
NODE_607_length_3079_cov_7.081879	2340	2420	4	3	80	0.0375000
NODE_607_length_3079_cov_7.081879	2340	2420	6	26	80	0.3250000
NODE_607_length_3079_cov_7.081879	2340	2420	8	44	80	0.5500000
NODE_607_length_3079_cov_7.081879	2340	2420	10	7	80	0.0875000
NODE_607_length_3079_cov_7.081879	2886	2938	1	15	52	0.2884615
NODE_607_length_3079_cov_7.081879	2886	2938	3	16	52	0.3076923
NODE_607_length_3079_cov_7.081879	2886	2938	5	1	52	0.0192308
NODE_607_length_3079_cov_7.081879	2886	2938	6	10	52	0.1923077
NODE_607_length_3079_cov_7.081879	2886	2938	8	1	52	0.0192308
NODE_607_length_3079_cov_7.081879	2886	2938	10	9	52	0.1730769
NODE_607_length_3079_cov_7.081879	2893	2959	1	15	66	0.2272727
NODE_607_length_3079_cov_7.081879	2893	2959	3	9	66	0.1363636
NODE_607_length_3079_cov_7.081879	2893	2959	5	1	66	0.0151515
NODE_607_length_3079_cov_7.081879	2893	2959	6	10	66	0.1515152
NODE_607_length_3079_cov_7.081879	2893	2959	8	1	66	0.0151515
NODE_607_length_3079_cov_7.081879	2893	2959	10	9	66	0.1363636
NODE_607_length_3079_cov_7.081879	2893	2959	12	4	66	0.0606061
NODE_607_length_3079_cov_7.081879	2893	2959	16	1	66	0.0151515
NODE_607_length_3079_cov_7.081879	2893	2959	18	1	66	0.0151515
NODE_607_length_3079_cov_7.081879	2893	2959	20	1	66	0.0151515
NODE_607_length_3079_cov_7.081879	2893	2959	24	1	66	0.0151515
NODE_607_length_3079_cov_7.081879	2893	2959	26	2	66	0.0303030
NODE_607_length_3079_cov_7.081879	2893	2959	28	1	66	0.0151515
NODE_607_length_3079_cov_7.081879	2893	2959	32	2	66	0.0303030
NODE_607_length_3079_cov_7.081879	2893	2959	34	1	66	0.0151515
NODE_607_length_3079_cov_7.081879	2893	2959	38	1	66	0.0151515
NODE_607_length_3079_cov_7.081879	2893	2959	42	6	66	0.0909091
NODE_607_length_3079_cov_7.081879	2932	2993	10	6	61	0.0983607
NODE_607_length_3079_cov_7.081879	2932	2993	12	4	61	0.0655738
NODE_607_length_3079_cov_7.081879	2932	2993	16	1	61	0.0163934
NODE_607_length_3079_cov_7.081879	2932	2993	18	1	61	0.0163934
NODE_607_length_3079_cov_7.081879	2932	2993	20	1	61	0.0163934
NODE_607_length_3079_cov_7.081879	2932	2993	24	1	61	0.0163934
NODE_607_length_3079_cov_7.081879	2932	2993	26	2	61	0.0327869
NODE_607_length_3079_cov_7.081879	2932	2993	28	1	61	0.0163934
NODE_607_length_3079_cov_7.081879	2932	2993	32	2	61	0.0327869
NODE_607_length_3079_cov_7.081879	2932	2993	34	1	61	0.0163934
NODE_607_length_3079_cov_7.081879	2932	2993	38	1	61	0.0163934
NODE_607_length_3079_cov_7.081879	2932	2993	42	21	61	0.3442623
NODE_607_length_3079_cov_7.081879	2932	2993	44	19	61	0.3114754
NODE_607_length_3079_cov_7.081879	2932	2995	10	6	63	0.0952381
NODE_607_length_3079_cov_7.081879	2932	2995	12	4	63	0.0634921
NODE_607_length_3079_cov_7.081879	2932	2995	16	1	63	0.0158730
NODE_607_length_3079_cov_7.081879	2932	2995	18	1	63	0.0158730
NODE_607_length_3079_cov_7.081879	2932	2995	20	1	63	0.0158730
NODE_607_length_3079_cov_7.081879	2932	2995	24	1	63	0.0158730
NODE_607_length_3079_cov_7.081879	2932	2995	26	2	63	0.0317460
NODE_607_length_3079_cov_7.081879	2932	2995	28	1	63	0.0158730
NODE_607_length_3079_cov_7.081879	2932	2995	32	2	63	0.0317460
NODE_607_length_3079_cov_7.081879	2932	2995	34	1	63	0.0158730
NODE_607_length_3079_cov_7.081879	2932	2995	38	1	63	0.0158730
NODE_607_length_3079_cov_7.081879	2932	2995	42	21	63	0.3333333
NODE_607_length_3079_cov_7.081879	2932	2995	44	21	63	0.3333333
NODE_607_length_3079_cov_7.081879	2932	2995	10	6	63	0.0952381
NODE_607_length_3079_cov_7.081879	2932	2995	12	4	63	0.0634921
NODE_607_length_3079_cov_7.081879	2932	2995	16	1	63	0.0158730
NODE_607_length_3079_cov_7.081879	2932	2995	18	1	63	0.0158730
NODE_607_length_3079_cov_7.081879	2932	2995	20	1	63	0.0158730
NODE_607_length_3079_cov_7.081879	2932	2995	24	1	63	0.0158730
NODE_607_length_3079_cov_7.081879	2932	2995	26	2	63	0.0317460
NODE_607_length_3079_cov_7.081879	2932	2995	28	1	63	0.0158730
NODE_607_length_3079_cov_7.081879	2932	2995	32	2	63	0.0317460
NODE_607_length_3079_cov_7.081879	2932	2995	34	1	63	0.0158730
NODE_607_length_3079_cov_7.081879	2932	2995	38	1	63	0.0158730
NODE_607_length_3079_cov_7.081879	2932	2995	42	21	63	0.3333333
NODE_607_length_3079_cov_7.081879	2932	2995	44	21	63	0.3333333
NODE_608_length_3077_cov_23.535259	1244	1321	0	23	77	0.2987013
NODE_608_length_3077_cov_23.535259	1244	1321	4	54	77	0.7012987
NODE_608_length_3077_cov_23.535259	1911	1991	0	61	80	0.7625000
NODE_608_length_3077_cov_23.535259	1911	1991	2	19	80	0.2375000
NODE_608_length_3077_cov_23.535259	1964	2016	0	8	52	0.1538462
NODE_608_length_3077_cov_23.535259	1964	2016	2	44	52	0.8461539
NODE_608_length_3077_cov_23.535259	2028	2114	2	69	86	0.8023256
NODE_608_length_3077_cov_23.535259	2028	2114	5	1	86	0.0116279
NODE_608_length_3077_cov_23.535259	2028	2114	6	1	86	0.0116279
NODE_608_length_3077_cov_23.535259	2028	2114	10	1	86	0.0116279
NODE_608_length_3077_cov_23.535259	2028	2114	12	6	86	0.0697674
NODE_608_length_3077_cov_23.535259	2028	2114	14	8	86	0.0930233
NODE_609_length_3077_cov_8.693083	1157	1237	0	31	80	0.3875000
NODE_609_length_3077_cov_8.693083	1157	1237	2	12	80	0.1500000
NODE_609_length_3077_cov_8.693083	1157	1237	4	28	80	0.3500000
NODE_609_length_3077_cov_8.693083	1157	1237	6	8	80	0.1000000
NODE_609_length_3077_cov_8.693083	1157	1237	8	1	80	0.0125000
NODE_609_length_3077_cov_8.693083	1161	1184	0	23	23	1.0000000
NODE_609_length_3077_cov_8.693083	1233	1313	6	3	80	0.0375000
NODE_609_length_3077_cov_8.693083	1233	1313	8	13	80	0.1625000
NODE_609_length_3077_cov_8.693083	1233	1313	10	9	80	0.1125000
NODE_609_length_3077_cov_8.693083	1233	1313	16	12	80	0.1500000
NODE_609_length_3077_cov_8.693083	1233	1313	18	1	80	0.0125000
NODE_609_length_3077_cov_8.693083	1233	1313	20	6	80	0.0750000
NODE_609_length_3077_cov_8.693083	1233	1313	22	18	80	0.2250000
NODE_609_length_3077_cov_8.693083	1233	1313	24	18	80	0.2250000
NODE_609_length_3077_cov_8.693083	1286	1352	20	4	66	0.0606061
NODE_609_length_3077_cov_8.693083	1286	1352	22	12	66	0.1818182
NODE_609_length_3077_cov_8.693083	1286	1352	24	14	66	0.2121212
NODE_609_length_3077_cov_8.693083	1286	1352	28	2	66	0.0303030
NODE_609_length_3077_cov_8.693083	1286	1352	30	10	66	0.1515152
NODE_609_length_3077_cov_8.693083	1286	1352	32	24	66	0.3636364
NODE_609_length_3077_cov_8.693083	2672	2757	0	6	85	0.0705882
NODE_609_length_3077_cov_8.693083	2672	2757	2	52	85	0.6117647
NODE_609_length_3077_cov_8.693083	2672	2757	4	4	85	0.0470588
NODE_609_length_3077_cov_8.693083	2672	2757	8	3	85	0.0352941
NODE_609_length_3077_cov_8.693083	2672	2757	10	3	85	0.0352941
NODE_609_length_3077_cov_8.693083	2672	2757	16	8	85	0.0941176
NODE_609_length_3077_cov_8.693083	2672	2757	18	9	85	0.1058824
NODE_611_length_3074_cov_2.996303	2561	2629	8	3	68	0.0441176
NODE_611_length_3074_cov_2.996303	2561	2629	10	1	68	0.0147059
NODE_611_length_3074_cov_2.996303	2561	2629	14	1	68	0.0147059
NODE_611_length_3074_cov_2.996303	2561	2629	17	1	68	0.0147059
NODE_611_length_3074_cov_2.996303	2561	2629	21	1	68	0.0147059
NODE_611_length_3074_cov_2.996303	2561	2629	24	1	68	0.0147059
NODE_611_length_3074_cov_2.996303	2561	2629	25	1	68	0.0147059
NODE_611_length_3074_cov_2.996303	2561	2629	26	1	68	0.0147059
NODE_611_length_3074_cov_2.996303	2561	2629	29	1	68	0.0147059
NODE_611_length_3074_cov_2.996303	2561	2629	31	1	68	0.0147059
NODE_611_length_3074_cov_2.996303	2561	2629	32	1	68	0.0147059
NODE_611_length_3074_cov_2.996303	2561	2629	33	2	68	0.0294118
NODE_611_length_3074_cov_2.996303	2561	2629	34	2	68	0.0294118
NODE_611_length_3074_cov_2.996303	2561	2629	38	1	68	0.0147059
NODE_611_length_3074_cov_2.996303	2561	2629	40	1	68	0.0147059
NODE_611_length_3074_cov_2.996303	2561	2629	44	1	68	0.0147059
NODE_611_length_3074_cov_2.996303	2561	2629	48	1	68	0.0147059
NODE_611_length_3074_cov_2.996303	2561	2629	51	3	68	0.0441176
NODE_611_length_3074_cov_2.996303	2561	2629	54	1	68	0.0147059
NODE_611_length_3074_cov_2.996303	2561	2629	58	2	68	0.0294118
NODE_611_length_3074_cov_2.996303	2561	2629	62	1	68	0.0147059
NODE_611_length_3074_cov_2.996303	2561	2629	64	6	68	0.0882353
NODE_611_length_3074_cov_2.996303	2561	2629	66	2	68	0.0294118
NODE_611_length_3074_cov_2.996303	2561	2629	67	1	68	0.0147059
NODE_611_length_3074_cov_2.996303	2561	2629	73	1	68	0.0147059
NODE_611_length_3074_cov_2.996303	2561	2629	81	1	68	0.0147059
NODE_611_length_3074_cov_2.996303	2561	2629	83	1	68	0.0147059
NODE_611_length_3074_cov_2.996303	2561	2629	85	1	68	0.0147059
NODE_611_length_3074_cov_2.996303	2561	2629	87	1	68	0.0147059
NODE_611_length_3074_cov_2.996303	2561	2629	90	1	68	0.0147059
NODE_611_length_3074_cov_2.996303	2561	2629	93	1	68	0.0147059
NODE_611_length_3074_cov_2.996303	2561	2629	99	4	68	0.0588235
NODE_611_length_3074_cov_2.996303	2561	2629	101	2	68	0.0294118
NODE_611_length_3074_cov_2.996303	2561	2629	105	1	68	0.0147059
NODE_611_length_3074_cov_2.996303	2561	2629	108	1	68	0.0147059
NODE_611_length_3074_cov_2.996303	2561	2629	112	1	68	0.0147059
NODE_611_length_3074_cov_2.996303	2561	2629	114	1	68	0.0147059
NODE_611_length_3074_cov_2.996303	2561	2629	118	1	68	0.0147059
NODE_611_length_3074_cov_2.996303	2561	2629	122	2	68	0.0294118
NODE_611_length_3074_cov_2.996303	2561	2629	133	1	68	0.0147059
NODE_611_length_3074_cov_2.996303	2561	2629	137	1	68	0.0147059
NODE_611_length_3074_cov_2.996303	2561	2629	144	1	68	0.0147059
NODE_611_length_3074_cov_2.996303	2561	2629	147	1	68	0.0147059
NODE_611_length_3074_cov_2.996303	2561	2629	153	1	68	0.0147059
NODE_611_length_3074_cov_2.996303	2561	2629	158	1	68	0.0147059
NODE_611_length_3074_cov_2.996303	2561	2629	165	1	68	0.0147059
NODE_611_length_3074_cov_2.996303	2561	2629	177	1	68	0.0147059
NODE_611_length_3074_cov_2.996303	2561	2629	192	1	68	0.0147059
NODE_611_length_3074_cov_2.996303	2561	2629	193	1	68	0.0147059
NODE_611_length_3074_cov_2.996303	2561	2629	199	1	68	0.0147059
NODE_615_length_3069_cov_2.448822	2948	2991	0	9	43	0.2093023
NODE_615_length_3069_cov_2.448822	2948	2991	2	34	43	0.7906977
NODE_616_length_3059_cov_20.037500	346	426	24	10	80	0.1250000
NODE_616_length_3059_cov_20.037500	346	426	26	3	80	0.0375000
NODE_616_length_3059_cov_20.037500	346	426	28	4	80	0.0500000
NODE_616_length_3059_cov_20.037500	346	426	30	4	80	0.0500000
NODE_616_length_3059_cov_20.037500	346	426	32	1	80	0.0125000
NODE_616_length_3059_cov_20.037500	346	426	34	1	80	0.0125000
NODE_616_length_3059_cov_20.037500	346	426	36	6	80	0.0750000
NODE_616_length_3059_cov_20.037500	346	426	38	14	80	0.1750000
NODE_616_length_3059_cov_20.037500	346	426	40	3	80	0.0375000
NODE_616_length_3059_cov_20.037500	346	426	42	1	80	0.0125000
NODE_616_length_3059_cov_20.037500	346	426	46	15	80	0.1875000
NODE_616_length_3059_cov_20.037500	346	426	48	18	80	0.2250000
NODE_616_length_3059_cov_20.037500	399	479	24	3	80	0.0375000
NODE_616_length_3059_cov_20.037500	399	479	26	4	80	0.0500000
NODE_616_length_3059_cov_20.037500	399	479	28	6	80	0.0750000
NODE_616_length_3059_cov_20.037500	399	479	30	7	80	0.0875000
NODE_616_length_3059_cov_20.037500	399	479	32	5	80	0.0625000
NODE_616_length_3059_cov_20.037500	399	479	34	4	80	0.0500000
NODE_616_length_3059_cov_20.037500	399	479	36	9	80	0.1125000
NODE_616_length_3059_cov_20.037500	399	479	40	5	80	0.0625000
NODE_616_length_3059_cov_20.037500	399	479	42	3	80	0.0375000
NODE_616_length_3059_cov_20.037500	399	479	46	15	80	0.1875000
NODE_616_length_3059_cov_20.037500	399	479	48	19	80	0.2375000
NODE_616_length_3059_cov_20.037500	1317	1397	0	11	80	0.1375000
NODE_616_length_3059_cov_20.037500	1317	1397	1	4	80	0.0500000
NODE_616_length_3059_cov_20.037500	1317	1397	2	16	80	0.2000000
NODE_616_length_3059_cov_20.037500	1317	1397	4	42	80	0.5250000
NODE_616_length_3059_cov_20.037500	1317	1397	6	7	80	0.0875000
NODE_616_length_3059_cov_20.037500	1370	1447	0	61	77	0.7922078
NODE_616_length_3059_cov_20.037500	1370	1447	1	4	77	0.0519481
NODE_616_length_3059_cov_20.037500	1370	1447	2	12	77	0.1558442
NODE_616_length_3059_cov_20.037500	2514	2594	0	80	80	1.0000000
NODE_616_length_3059_cov_20.037500	2567	2647	0	80	80	1.0000000
NODE_617_length_3058_cov_21.767489	2802	2882	0	78	80	0.9750000
NODE_617_length_3058_cov_21.767489	2802	2882	1	2	80	0.0250000
NODE_617_length_3058_cov_21.767489	2855	2930	0	75	75	1.0000000
NODE_621_length_3047_cov_47.232361	418	489	0	71	71	1.0000000
NODE_621_length_3047_cov_47.232361	758	801	8	7	43	0.1627907
NODE_621_length_3047_cov_47.232361	758	801	10	2	43	0.0465116
NODE_621_length_3047_cov_47.232361	758	801	14	3	43	0.0697674
NODE_621_length_3047_cov_47.232361	758	801	16	1	43	0.0232558
NODE_621_length_3047_cov_47.232361	758	801	18	2	43	0.0465116
NODE_621_length_3047_cov_47.232361	758	801	20	4	43	0.0930233
NODE_621_length_3047_cov_47.232361	758	801	22	4	43	0.0930233
NODE_621_length_3047_cov_47.232361	758	801	24	10	43	0.2325581
NODE_621_length_3047_cov_47.232361	758	801	26	1	43	0.0232558
NODE_621_length_3047_cov_47.232361	758	801	27	3	43	0.0697674
NODE_621_length_3047_cov_47.232361	758	801	29	6	43	0.1395349
NODE_623_length_3044_cov_38.951783	1702	1782	0	80	80	1.0000000
NODE_623_length_3044_cov_38.951783	1755	1835	0	80	80	1.0000000
NODE_623_length_3044_cov_38.951783	1831	1911	0	80	80	1.0000000
NODE_623_length_3044_cov_38.951783	1884	1964	0	80	80	1.0000000
NODE_623_length_3044_cov_38.951783	2556	2636	0	80	80	1.0000000
NODE_623_length_3044_cov_38.951783	2609	2689	0	80	80	1.0000000
NODE_625_length_3039_cov_3.258163	261	337	0	76	76	1.0000000
NODE_625_length_3039_cov_3.258163	261	336	0	75	75	1.0000000
NODE_625_length_3039_cov_3.258163	261	337	0	76	76	1.0000000
NODE_625_length_3039_cov_3.258163	270	337	0	67	67	1.0000000
NODE_627_length_3036_cov_8.968676	2303	2367	0	64	64	1.0000000
NODE_627_length_3036_cov_8.968676	2340	2420	0	45	80	0.5625000
NODE_627_length_3036_cov_8.968676	2340	2420	2	7	80	0.0875000
NODE_627_length_3036_cov_8.968676	2340	2420	4	18	80	0.2250000
NODE_627_length_3036_cov_8.968676	2340	2420	6	10	80	0.1250000
NODE_627_length_3036_cov_8.968676	2416	2496	6	50	80	0.6250000
NODE_627_length_3036_cov_8.968676	2416	2496	8	30	80	0.3750000
NODE_627_length_3036_cov_8.968676	2469	2549	0	15	80	0.1875000
NODE_627_length_3036_cov_8.968676	2469	2549	2	26	80	0.3250000
NODE_627_length_3036_cov_8.968676	2469	2549	4	6	80	0.0750000
NODE_627_length_3036_cov_8.968676	2469	2549	6	33	80	0.4125000
NODE_629_length_3032_cov_7.470849	1026	1068	17	2	42	0.0476190
NODE_629_length_3032_cov_7.470849	1026	1068	19	2	42	0.0476190
NODE_629_length_3032_cov_7.470849	1026	1068	21	2	42	0.0476190
NODE_629_length_3032_cov_7.470849	1026	1068	23	2	42	0.0476190
NODE_629_length_3032_cov_7.470849	1026	1068	25	6	42	0.1428571
NODE_629_length_3032_cov_7.470849	1026	1068	27	4	42	0.0952381
NODE_629_length_3032_cov_7.470849	1026	1068	29	12	42	0.2857143
NODE_629_length_3032_cov_7.470849	1026	1068	31	2	42	0.0476190
NODE_629_length_3032_cov_7.470849	1026	1068	33	10	42	0.2380952
NODE_630_length_3025_cov_11.862611	2371	2451	0	80	80	1.0000000
NODE_630_length_3025_cov_11.862611	2424	2504	0	80	80	1.0000000
NODE_630_length_3025_cov_11.862611	2500	2580	0	80	80	1.0000000
NODE_630_length_3025_cov_11.862611	2553	2633	0	80	80	1.0000000
NODE_635_length_3012_cov_33.100240	2379	2459	0	49	80	0.6125000
NODE_635_length_3012_cov_33.100240	2379	2459	2	31	80	0.3875000
NODE_635_length_3012_cov_33.100240	2432	2512	2	80	80	1.0000000
NODE_637_length_3007_cov_11.843535	2641	2721	0	79	80	0.9875000
NODE_637_length_3007_cov_11.843535	2641	2721	1	1	80	0.0125000
NODE_643_length_2992_cov_2.636709	2032	2112	0	21	80	0.2625000
NODE_643_length_2992_cov_2.636709	2032	2112	2	59	80	0.7375000
NODE_643_length_2992_cov_2.636709	2085	2165	2	31	80	0.3875000
NODE_643_length_2992_cov_2.636709	2085	2165	4	7	80	0.0875000
NODE_643_length_2992_cov_2.636709	2085	2165	6	9	80	0.1125000
NODE_643_length_2992_cov_2.636709	2085	2165	8	1	80	0.0125000
NODE_643_length_2992_cov_2.636709	2085	2165	10	32	80	0.4000000
NODE_646_length_2978_cov_4.883293	382	452	0	60	70	0.8571429
NODE_646_length_2978_cov_4.883293	382	452	2	10	70	0.1428571
NODE_646_length_2978_cov_4.883293	1858	1938	0	80	80	1.0000000
NODE_646_length_2978_cov_4.883293	1926	1991	0	65	65	1.0000000
NODE_646_length_2978_cov_4.883293	1987	2066	0	79	79	1.0000000
NODE_646_length_2978_cov_4.883293	2040	2079	0	39	39	1.0000000
NODE_647_length_2976_cov_24.683003	1764	1844	0	80	80	1.0000000
NODE_647_length_2976_cov_24.683003	1817	1897	0	80	80	1.0000000
NODE_647_length_2976_cov_24.683003	1893	1973	0	80	80	1.0000000
NODE_647_length_2976_cov_24.683003	1946	2026	0	80	80	1.0000000
NODE_651_length_2967_cov_16.146095	238	318	0	80	80	1.0000000
NODE_651_length_2967_cov_16.146095	291	371	0	80	80	1.0000000
NODE_651_length_2967_cov_16.146095	367	447	0	22	80	0.2750000
NODE_651_length_2967_cov_16.146095	367	447	2	22	80	0.2750000
NODE_651_length_2967_cov_16.146095	367	447	3	23	80	0.2875000
NODE_651_length_2967_cov_16.146095	367	447	4	13	80	0.1625000
NODE_651_length_2967_cov_16.146095	420	500	2	12	80	0.1500000
NODE_651_length_2967_cov_16.146095	420	500	3	14	80	0.1750000
NODE_651_length_2967_cov_16.146095	420	500	4	54	80	0.6750000
NODE_653_length_2965_cov_19.913468	92	134	10	6	42	0.1428571
NODE_653_length_2965_cov_19.913468	92	134	12	1	42	0.0238095
NODE_653_length_2965_cov_19.913468	92	134	14	3	42	0.0714286
NODE_653_length_2965_cov_19.913468	92	134	16	2	42	0.0476190
NODE_653_length_2965_cov_19.913468	92	134	18	2	42	0.0476190
NODE_653_length_2965_cov_19.913468	92	134	22	2	42	0.0476190
NODE_653_length_2965_cov_19.913468	92	134	24	1	42	0.0238095
NODE_653_length_2965_cov_19.913468	92	134	30	1	42	0.0238095
NODE_653_length_2965_cov_19.913468	92	134	36	2	42	0.0476190
NODE_653_length_2965_cov_19.913468	92	134	40	1	42	0.0238095
NODE_653_length_2965_cov_19.913468	92	134	44	21	42	0.5000000
NODE_653_length_2965_cov_19.913468	109	178	0	7	69	0.1014493
NODE_653_length_2965_cov_19.913468	109	178	2	4	69	0.0579710
NODE_653_length_2965_cov_19.913468	109	178	4	5	69	0.0724638
NODE_653_length_2965_cov_19.913468	109	178	6	12	69	0.1739130
NODE_653_length_2965_cov_19.913468	109	178	8	2	69	0.0289855
NODE_653_length_2965_cov_19.913468	109	178	9	2	69	0.0289855
NODE_653_length_2965_cov_19.913468	109	178	10	18	69	0.2608696
NODE_653_length_2965_cov_19.913468	109	178	12	1	69	0.0144928
NODE_653_length_2965_cov_19.913468	109	178	14	3	69	0.0434783
NODE_653_length_2965_cov_19.913468	109	178	16	2	69	0.0289855
NODE_653_length_2965_cov_19.913468	109	178	18	2	69	0.0289855
NODE_653_length_2965_cov_19.913468	109	178	22	2	69	0.0289855
NODE_653_length_2965_cov_19.913468	109	178	24	1	69	0.0144928
NODE_653_length_2965_cov_19.913468	109	178	30	1	69	0.0144928
NODE_653_length_2965_cov_19.913468	109	178	36	2	69	0.0289855
NODE_653_length_2965_cov_19.913468	109	178	40	1	69	0.0144928
NODE_653_length_2965_cov_19.913468	109	178	44	4	69	0.0579710
NODE_653_length_2965_cov_19.913468	109	178	0	7	69	0.1014493
NODE_653_length_2965_cov_19.913468	109	178	2	4	69	0.0579710
NODE_653_length_2965_cov_19.913468	109	178	4	5	69	0.0724638
NODE_653_length_2965_cov_19.913468	109	178	6	12	69	0.1739130
NODE_653_length_2965_cov_19.913468	109	178	8	2	69	0.0289855
NODE_653_length_2965_cov_19.913468	109	178	9	2	69	0.0289855
NODE_653_length_2965_cov_19.913468	109	178	10	18	69	0.2608696
NODE_653_length_2965_cov_19.913468	109	178	12	1	69	0.0144928
NODE_653_length_2965_cov_19.913468	109	178	14	3	69	0.0434783
NODE_653_length_2965_cov_19.913468	109	178	16	2	69	0.0289855
NODE_653_length_2965_cov_19.913468	109	178	18	2	69	0.0289855
NODE_653_length_2965_cov_19.913468	109	178	22	2	69	0.0289855
NODE_653_length_2965_cov_19.913468	109	178	24	1	69	0.0144928
NODE_653_length_2965_cov_19.913468	109	178	30	1	69	0.0144928
NODE_653_length_2965_cov_19.913468	109	178	36	2	69	0.0289855
NODE_653_length_2965_cov_19.913468	109	178	40	1	69	0.0144928
NODE_653_length_2965_cov_19.913468	109	178	44	4	69	0.0579710
NODE_653_length_2965_cov_19.913468	2298	2378	0	22	80	0.2750000
NODE_653_length_2965_cov_19.913468	2298	2378	2	58	80	0.7250000
NODE_653_length_2965_cov_19.913468	2351	2431	0	35	80	0.4375000
NODE_653_length_2965_cov_19.913468	2351	2431	2	45	80	0.5625000
NODE_653_length_2965_cov_19.913468	2427	2507	0	7	80	0.0875000
NODE_653_length_2965_cov_19.913468	2427	2507	1	1	80	0.0125000
NODE_653_length_2965_cov_19.913468	2427	2507	2	72	80	0.9000000
NODE_653_length_2965_cov_19.913468	2480	2560	0	52	80	0.6500000
NODE_653_length_2965_cov_19.913468	2480	2560	2	28	80	0.3500000
NODE_656_length_2960_cov_35.741699	459	539	0	80	80	1.0000000
NODE_656_length_2960_cov_35.741699	512	592	0	80	80	1.0000000
NODE_659_length_2951_cov_7.195652	1100	1141	101	1	41	0.0243902
NODE_659_length_2951_cov_7.195652	1100	1141	102	1	41	0.0243902
NODE_659_length_2951_cov_7.195652	1100	1141	109	1	41	0.0243902
NODE_659_length_2951_cov_7.195652	1100	1141	113	2	41	0.0487805
NODE_659_length_2951_cov_7.195652	1100	1141	117	3	41	0.0731707
NODE_659_length_2951_cov_7.195652	1100	1141	119	1	41	0.0243902
NODE_659_length_2951_cov_7.195652	1100	1141	123	3	41	0.0731707
NODE_659_length_2951_cov_7.195652	1100	1141	127	2	41	0.0487805
NODE_659_length_2951_cov_7.195652	1100	1141	129	3	41	0.0731707
NODE_659_length_2951_cov_7.195652	1100	1141	131	3	41	0.0731707
NODE_659_length_2951_cov_7.195652	1100	1141	133	1	41	0.0243902
NODE_659_length_2951_cov_7.195652	1100	1141	135	2	41	0.0487805
NODE_659_length_2951_cov_7.195652	1100	1141	137	1	41	0.0243902
NODE_659_length_2951_cov_7.195652	1100	1141	141	1	41	0.0243902
NODE_659_length_2951_cov_7.195652	1100	1141	147	2	41	0.0487805
NODE_659_length_2951_cov_7.195652	1100	1141	150	3	41	0.0731707
NODE_659_length_2951_cov_7.195652	1100	1141	151	1	41	0.0243902
NODE_659_length_2951_cov_7.195652	1100	1141	152	1	41	0.0243902
NODE_659_length_2951_cov_7.195652	1100	1141	153	3	41	0.0731707
NODE_659_length_2951_cov_7.195652	1100	1141	154	1	41	0.0243902
NODE_659_length_2951_cov_7.195652	1100	1141	155	2	41	0.0487805
NODE_659_length_2951_cov_7.195652	1100	1141	158	2	41	0.0487805
NODE_659_length_2951_cov_7.195652	1100	1141	159	1	41	0.0243902
NODE_665_length_2935_cov_37.693230	1492	1572	10	4	80	0.0500000
NODE_665_length_2935_cov_37.693230	1492	1572	12	5	80	0.0625000
NODE_665_length_2935_cov_37.693230	1492	1572	14	17	80	0.2125000
NODE_665_length_2935_cov_37.693230	1492	1572	16	54	80	0.6750000
NODE_665_length_2935_cov_37.693230	1534	1589	6	10	55	0.1818182
NODE_665_length_2935_cov_37.693230	1534	1589	10	6	55	0.1090909
NODE_665_length_2935_cov_37.693230	1534	1589	12	1	55	0.0181818
NODE_665_length_2935_cov_37.693230	1534	1589	14	14	55	0.2545455
NODE_665_length_2935_cov_37.693230	1534	1589	16	24	55	0.4363636
NODE_665_length_2935_cov_37.693230	1545	1619	0	5	74	0.0675676
NODE_665_length_2935_cov_37.693230	1545	1619	2	2	74	0.0270270
NODE_665_length_2935_cov_37.693230	1545	1619	4	18	74	0.2432432
NODE_665_length_2935_cov_37.693230	1545	1619	6	15	74	0.2027027
NODE_665_length_2935_cov_37.693230	1545	1619	10	6	74	0.0810811
NODE_665_length_2935_cov_37.693230	1545	1619	12	1	74	0.0135135
NODE_665_length_2935_cov_37.693230	1545	1619	14	14	74	0.1891892
NODE_665_length_2935_cov_37.693230	1545	1619	16	13	74	0.1756757
NODE_665_length_2935_cov_37.693230	1625	1701	0	25	76	0.3289474
NODE_665_length_2935_cov_37.693230	1625	1701	2	51	76	0.6710526
NODE_665_length_2935_cov_37.693230	2863	2906	0	19	43	0.4418605
NODE_665_length_2935_cov_37.693230	2863	2906	2	24	43	0.5581396
NODE_675_length_2913_cov_4.376688	2664	2739	0	16	75	0.2133333
NODE_675_length_2913_cov_4.376688	2664	2739	6	59	75	0.7866667
NODE_675_length_2913_cov_4.376688	2664	2723	6	59	59	1.0000000
NODE_675_length_2913_cov_4.376688	2664	2739	0	16	75	0.2133333
NODE_675_length_2913_cov_4.376688	2664	2739	6	59	75	0.7866667
NODE_675_length_2913_cov_4.376688	2664	2739	0	16	75	0.2133333
NODE_675_length_2913_cov_4.376688	2664	2739	6	59	75	0.7866667
NODE_675_length_2913_cov_4.376688	2673	2739	0	16	66	0.2424242
NODE_675_length_2913_cov_4.376688	2673	2739	6	50	66	0.7575758
NODE_675_length_2913_cov_4.376688	2717	2780	0	57	63	0.9047619
NODE_675_length_2913_cov_4.376688	2717	2780	6	6	63	0.0952381
NODE_675_length_2913_cov_4.376688	2745	2778	0	33	33	1.0000000
NODE_677_length_2909_cov_71.975089	2090	2174	11	1	84	0.0119048
NODE_677_length_2909_cov_71.975089	2090	2174	13	2	84	0.0238095
NODE_677_length_2909_cov_71.975089	2090	2174	14	5	84	0.0595238
NODE_677_length_2909_cov_71.975089	2090	2174	15	10	84	0.1190476
NODE_677_length_2909_cov_71.975089	2090	2174	16	2	84	0.0238095
NODE_677_length_2909_cov_71.975089	2090	2174	17	11	84	0.1309524
NODE_677_length_2909_cov_71.975089	2090	2174	18	7	84	0.0833333
NODE_677_length_2909_cov_71.975089	2090	2174	22	1	84	0.0119048
NODE_677_length_2909_cov_71.975089	2090	2174	26	4	84	0.0476190
NODE_677_length_2909_cov_71.975089	2090	2174	30	5	84	0.0595238
NODE_677_length_2909_cov_71.975089	2090	2174	32	1	84	0.0119048
NODE_677_length_2909_cov_71.975089	2090	2174	36	1	84	0.0119048
NODE_677_length_2909_cov_71.975089	2090	2174	40	1	84	0.0119048
NODE_677_length_2909_cov_71.975089	2090	2174	42	1	84	0.0119048
NODE_677_length_2909_cov_71.975089	2090	2174	44	1	84	0.0119048
NODE_677_length_2909_cov_71.975089	2090	2174	48	1	84	0.0119048
NODE_677_length_2909_cov_71.975089	2090	2174	52	1	84	0.0119048
NODE_677_length_2909_cov_71.975089	2090	2174	58	4	84	0.0476190
NODE_677_length_2909_cov_71.975089	2090	2174	60	2	84	0.0238095
NODE_677_length_2909_cov_71.975089	2090	2174	62	2	84	0.0238095
NODE_677_length_2909_cov_71.975089	2090	2174	64	1	84	0.0119048
NODE_677_length_2909_cov_71.975089	2090	2174	66	1	84	0.0119048
NODE_677_length_2909_cov_71.975089	2090	2174	68	1	84	0.0119048
NODE_677_length_2909_cov_71.975089	2090	2174	70	1	84	0.0119048
NODE_677_length_2909_cov_71.975089	2090	2174	81	1	84	0.0119048
NODE_677_length_2909_cov_71.975089	2090	2174	82	1	84	0.0119048
NODE_677_length_2909_cov_71.975089	2090	2174	84	2	84	0.0238095
NODE_677_length_2909_cov_71.975089	2090	2174	86	1	84	0.0119048
NODE_677_length_2909_cov_71.975089	2090	2174	90	2	84	0.0238095
NODE_677_length_2909_cov_71.975089	2090	2174	96	1	84	0.0119048
NODE_677_length_2909_cov_71.975089	2090	2174	100	1	84	0.0119048
NODE_677_length_2909_cov_71.975089	2090	2174	104	2	84	0.0238095
NODE_677_length_2909_cov_71.975089	2090	2174	106	6	84	0.0714286
NODE_678_length_2908_cov_5.937344	2495	2575	0	30	80	0.3750000
NODE_678_length_2908_cov_5.937344	2495	2575	2	50	80	0.6250000
NODE_678_length_2908_cov_5.937344	2548	2628	0	65	80	0.8125000
NODE_678_length_2908_cov_5.937344	2548	2628	2	15	80	0.1875000
NODE_678_length_2908_cov_5.937344	2624	2704	2	40	80	0.5000000
NODE_678_length_2908_cov_5.937344	2624	2704	4	10	80	0.1250000
NODE_678_length_2908_cov_5.937344	2624	2704	6	30	80	0.3750000
NODE_678_length_2908_cov_5.937344	2677	2757	0	4	80	0.0500000
NODE_678_length_2908_cov_5.937344	2677	2757	2	11	80	0.1375000
NODE_678_length_2908_cov_5.937344	2677	2757	4	29	80	0.3625000
NODE_678_length_2908_cov_5.937344	2677	2757	6	36	80	0.4500000
NODE_679_length_2905_cov_12.777619	2358	2419	0	58	61	0.9508197
NODE_679_length_2905_cov_12.777619	2358	2419	4	3	61	0.0491803
NODE_679_length_2905_cov_12.777619	2358	2419	0	58	61	0.9508197
NODE_679_length_2905_cov_12.777619	2358	2419	4	3	61	0.0491803
NODE_679_length_2905_cov_12.777619	2358	2419	0	58	61	0.9508197
NODE_679_length_2905_cov_12.777619	2358	2419	4	3	61	0.0491803
NODE_679_length_2905_cov_12.777619	2392	2472	0	80	80	1.0000000
NODE_680_length_2903_cov_5.474322	2423	2464	10	41	41	1.0000000
NODE_684_length_2898_cov_5.786352	0	74	0	74	74	1.0000000
NODE_684_length_2898_cov_5.786352	47	124	0	77	77	1.0000000
NODE_686_length_2895_cov_8.519313	869	949	2	37	80	0.4625000
NODE_686_length_2895_cov_8.519313	869	949	4	43	80	0.5375000
NODE_686_length_2895_cov_8.519313	922	1002	0	15	80	0.1875000
NODE_686_length_2895_cov_8.519313	922	1002	2	65	80	0.8125000
NODE_688_length_2894_cov_2.036136	2677	2757	4	1	80	0.0125000
NODE_688_length_2894_cov_2.036136	2677	2757	6	2	80	0.0250000
NODE_688_length_2894_cov_2.036136	2677	2757	8	1	80	0.0125000
NODE_688_length_2894_cov_2.036136	2677	2757	10	1	80	0.0125000
NODE_688_length_2894_cov_2.036136	2677	2757	12	21	80	0.2625000
NODE_688_length_2894_cov_2.036136	2677	2757	14	39	80	0.4875000
NODE_688_length_2894_cov_2.036136	2677	2757	16	15	80	0.1875000
NODE_689_length_2891_cov_7.938037	193	275	2	32	82	0.3902439
NODE_689_length_2891_cov_7.938037	193	275	4	23	82	0.2804878
NODE_689_length_2891_cov_7.938037	193	275	6	4	82	0.0487805
NODE_689_length_2891_cov_7.938037	193	275	7	1	82	0.0121951
NODE_689_length_2891_cov_7.938037	193	275	8	4	82	0.0487805
NODE_689_length_2891_cov_7.938037	193	275	10	3	82	0.0365854
NODE_689_length_2891_cov_7.938037	193	275	12	5	82	0.0609756
NODE_689_length_2891_cov_7.938037	193	275	14	10	82	0.1219512
NODE_691_length_2889_cov_11.426882	407	487	0	18	80	0.2250000
NODE_691_length_2889_cov_11.426882	407	487	2	62	80	0.7750000
NODE_691_length_2889_cov_11.426882	460	540	0	55	80	0.6875000
NODE_691_length_2889_cov_11.426882	460	540	2	25	80	0.3125000
NODE_691_length_2889_cov_11.426882	1006	1086	0	4	80	0.0500000
NODE_691_length_2889_cov_11.426882	1006	1086	2	6	80	0.0750000
NODE_691_length_2889_cov_11.426882	1006	1086	4	1	80	0.0125000
NODE_691_length_2889_cov_11.426882	1006	1086	6	3	80	0.0375000
NODE_691_length_2889_cov_11.426882	1006	1086	8	3	80	0.0375000
NODE_691_length_2889_cov_11.426882	1006	1086	10	1	80	0.0125000
NODE_691_length_2889_cov_11.426882	1006	1086	12	8	80	0.1000000
NODE_691_length_2889_cov_11.426882	1006	1086	16	54	80	0.6750000
NODE_691_length_2889_cov_11.426882	1007	1086	0	4	79	0.0506329
NODE_691_length_2889_cov_11.426882	1007	1086	2	6	79	0.0759494
NODE_691_length_2889_cov_11.426882	1007	1086	4	1	79	0.0126582
NODE_691_length_2889_cov_11.426882	1007	1086	6	3	79	0.0379747
NODE_691_length_2889_cov_11.426882	1007	1086	8	3	79	0.0379747
NODE_691_length_2889_cov_11.426882	1007	1086	10	1	79	0.0126582
NODE_691_length_2889_cov_11.426882	1007	1086	12	8	79	0.1012658
NODE_691_length_2889_cov_11.426882	1007	1086	16	53	79	0.6708861
NODE_691_length_2889_cov_11.426882	1059	1138	0	56	79	0.7088608
NODE_691_length_2889_cov_11.426882	1059	1138	2	6	79	0.0759494
NODE_691_length_2889_cov_11.426882	1059	1138	4	1	79	0.0126582
NODE_691_length_2889_cov_11.426882	1059	1138	6	3	79	0.0379747
NODE_691_length_2889_cov_11.426882	1059	1138	8	3	79	0.0379747
NODE_691_length_2889_cov_11.426882	1059	1138	10	1	79	0.0126582
NODE_691_length_2889_cov_11.426882	1059	1138	12	8	79	0.1012658
NODE_691_length_2889_cov_11.426882	1059	1138	16	1	79	0.0126582
NODE_691_length_2889_cov_11.426882	1059	1138	0	56	79	0.7088608
NODE_691_length_2889_cov_11.426882	1059	1138	2	6	79	0.0759494
NODE_691_length_2889_cov_11.426882	1059	1138	4	1	79	0.0126582
NODE_691_length_2889_cov_11.426882	1059	1138	6	3	79	0.0379747
NODE_691_length_2889_cov_11.426882	1059	1138	8	3	79	0.0379747
NODE_691_length_2889_cov_11.426882	1059	1138	10	1	79	0.0126582
NODE_691_length_2889_cov_11.426882	1059	1138	12	8	79	0.1012658
NODE_691_length_2889_cov_11.426882	1059	1138	16	1	79	0.0126582
NODE_693_length_2888_cov_3.789172	992	1072	8	1	80	0.0125000
NODE_693_length_2888_cov_3.789172	992	1072	10	12	80	0.1500000
NODE_693_length_2888_cov_3.789172	992	1072	12	67	80	0.8375000
NODE_693_length_2888_cov_3.789172	1045	1087	4	9	42	0.2142857
NODE_693_length_2888_cov_3.789172	1045	1087	10	2	42	0.0476190
NODE_693_length_2888_cov_3.789172	1045	1087	12	31	42	0.7380952
NODE_697_length_2878_cov_6.277798	2712	2781	1	37	69	0.5362319
NODE_697_length_2878_cov_6.277798	2712	2781	3	9	69	0.1304348
NODE_697_length_2878_cov_6.277798	2712	2781	5	16	69	0.2318841
NODE_697_length_2878_cov_6.277798	2712	2781	7	7	69	0.1014493
NODE_703_length_2862_cov_9.060803	2409	2489	4	80	80	1.0000000
NODE_703_length_2862_cov_9.060803	2462	2542	0	48	80	0.6000000
NODE_703_length_2862_cov_9.060803	2462	2542	2	2	80	0.0250000
NODE_703_length_2862_cov_9.060803	2462	2542	4	30	80	0.3750000
NODE_712_length_2840_cov_2.079533	1660	1740	0	54	80	0.6750000
NODE_712_length_2840_cov_2.079533	1660	1740	2	26	80	0.3250000
NODE_713_length_2839_cov_16.762044	327	402	0	75	75	1.0000000
NODE_713_length_2839_cov_16.762044	380	468	0	88	88	1.0000000
NODE_713_length_2839_cov_16.762044	1021	1101	0	61	80	0.7625000
NODE_713_length_2839_cov_16.762044	1021	1101	2	19	80	0.2375000
NODE_713_length_2839_cov_16.762044	1074	1154	0	8	80	0.1000000
NODE_713_length_2839_cov_16.762044	1074	1154	2	72	80	0.9000000
NODE_714_length_2835_cov_29.691520	1552	1581	64	6	29	0.2068966
NODE_714_length_2835_cov_29.691520	1552	1581	66	4	29	0.1379310
NODE_714_length_2835_cov_29.691520	1552	1581	68	2	29	0.0689655
NODE_714_length_2835_cov_29.691520	1552	1581	70	2	29	0.0689655
NODE_714_length_2835_cov_29.691520	1552	1581	72	2	29	0.0689655
NODE_714_length_2835_cov_29.691520	1552	1581	74	3	29	0.1034483
NODE_714_length_2835_cov_29.691520	1552	1581	76	8	29	0.2758621
NODE_714_length_2835_cov_29.691520	1552	1581	78	2	29	0.0689655
NODE_714_length_2835_cov_29.691520	1554	1629	7	1	75	0.0133333
NODE_714_length_2835_cov_29.691520	1554	1629	9	2	75	0.0266667
NODE_714_length_2835_cov_29.691520	1554	1629	13	3	75	0.0400000
NODE_714_length_2835_cov_29.691520	1554	1629	16	1	75	0.0133333
NODE_714_length_2835_cov_29.691520	1554	1629	20	6	75	0.0800000
NODE_714_length_2835_cov_29.691520	1554	1629	24	2	75	0.0266667
NODE_714_length_2835_cov_29.691520	1554	1629	26	1	75	0.0133333
NODE_714_length_2835_cov_29.691520	1554	1629	30	1	75	0.0133333
NODE_714_length_2835_cov_29.691520	1554	1629	31	1	75	0.0133333
NODE_714_length_2835_cov_29.691520	1554	1629	32	3	75	0.0400000
NODE_714_length_2835_cov_29.691520	1554	1629	36	1	75	0.0133333
NODE_714_length_2835_cov_29.691520	1554	1629	40	1	75	0.0133333
NODE_714_length_2835_cov_29.691520	1554	1629	42	2	75	0.0266667
NODE_714_length_2835_cov_29.691520	1554	1629	44	3	75	0.0400000
NODE_714_length_2835_cov_29.691520	1554	1629	46	1	75	0.0133333
NODE_714_length_2835_cov_29.691520	1554	1629	50	1	75	0.0133333
NODE_714_length_2835_cov_29.691520	1554	1629	52	1	75	0.0133333
NODE_714_length_2835_cov_29.691520	1554	1629	54	2	75	0.0266667
NODE_714_length_2835_cov_29.691520	1554	1629	56	1	75	0.0133333
NODE_714_length_2835_cov_29.691520	1554	1629	61	1	75	0.0133333
NODE_714_length_2835_cov_29.691520	1554	1629	62	4	75	0.0533333
NODE_714_length_2835_cov_29.691520	1554	1629	64	15	75	0.2000000
NODE_714_length_2835_cov_29.691520	1554	1629	66	4	75	0.0533333
NODE_714_length_2835_cov_29.691520	1554	1629	68	2	75	0.0266667
NODE_714_length_2835_cov_29.691520	1554	1629	70	2	75	0.0266667
NODE_714_length_2835_cov_29.691520	1554	1629	72	2	75	0.0266667
NODE_714_length_2835_cov_29.691520	1554	1629	74	3	75	0.0400000
NODE_714_length_2835_cov_29.691520	1554	1629	76	8	75	0.1066667
NODE_720_length_2825_cov_9.731108	487	567	0	1	80	0.0125000
NODE_720_length_2825_cov_9.731108	487	567	2	79	80	0.9875000
NODE_720_length_2825_cov_9.731108	540	620	0	54	80	0.6750000
NODE_720_length_2825_cov_9.731108	540	620	2	26	80	0.3250000
NODE_726_length_2810_cov_2.844338	206	289	16	3	83	0.0361446
NODE_726_length_2810_cov_2.844338	206	289	18	1	83	0.0120482
NODE_726_length_2810_cov_2.844338	206	289	20	1	83	0.0120482
NODE_726_length_2810_cov_2.844338	206	289	22	1	83	0.0120482
NODE_726_length_2810_cov_2.844338	206	289	24	1	83	0.0120482
NODE_726_length_2810_cov_2.844338	206	289	32	3	83	0.0361446
NODE_726_length_2810_cov_2.844338	206	289	33	2	83	0.0240964
NODE_726_length_2810_cov_2.844338	206	289	35	1	83	0.0120482
NODE_726_length_2810_cov_2.844338	206	289	39	2	83	0.0240964
NODE_726_length_2810_cov_2.844338	206	289	41	3	83	0.0361446
NODE_726_length_2810_cov_2.844338	206	289	43	3	83	0.0361446
NODE_726_length_2810_cov_2.844338	206	289	44	4	83	0.0481928
NODE_726_length_2810_cov_2.844338	206	289	47	1	83	0.0120482
NODE_726_length_2810_cov_2.844338	206	289	48	2	83	0.0240964
NODE_726_length_2810_cov_2.844338	206	289	52	1	83	0.0120482
NODE_726_length_2810_cov_2.844338	206	289	54	5	83	0.0602410
NODE_726_length_2810_cov_2.844338	206	289	56	2	83	0.0240964
NODE_726_length_2810_cov_2.844338	206	289	58	2	83	0.0240964
NODE_726_length_2810_cov_2.844338	206	289	60	17	83	0.2048193
NODE_726_length_2810_cov_2.844338	206	289	62	2	83	0.0240964
NODE_726_length_2810_cov_2.844338	206	289	64	8	83	0.0963855
NODE_726_length_2810_cov_2.844338	206	289	68	10	83	0.1204819
NODE_726_length_2810_cov_2.844338	206	289	70	4	83	0.0481928
NODE_726_length_2810_cov_2.844338	206	289	72	2	83	0.0240964
NODE_726_length_2810_cov_2.844338	206	289	75	1	83	0.0120482
NODE_726_length_2810_cov_2.844338	206	289	76	1	83	0.0120482
NODE_728_length_2808_cov_2.867110	140	163	18	23	23	1.0000000
NODE_729_length_2807_cov_8.423191	125	205	2	55	80	0.6875000
NODE_729_length_2807_cov_8.423191	125	205	4	25	80	0.3125000
NODE_729_length_2807_cov_8.423191	178	258	2	27	80	0.3375000
NODE_729_length_2807_cov_8.423191	178	258	4	53	80	0.6625000
NODE_729_length_2807_cov_8.423191	2451	2515	0	55	64	0.8593750
NODE_729_length_2807_cov_8.423191	2451	2515	4	1	64	0.0156250
NODE_729_length_2807_cov_8.423191	2451	2515	5	8	64	0.1250000
NODE_735_length_2801_cov_26.131384	461	521	3	5	60	0.0833333
NODE_735_length_2801_cov_26.131384	461	521	5	17	60	0.2833333
NODE_735_length_2801_cov_26.131384	461	521	7	14	60	0.2333333
NODE_735_length_2801_cov_26.131384	461	521	9	24	60	0.4000000
NODE_735_length_2801_cov_26.131384	494	574	2	2	80	0.0250000
NODE_735_length_2801_cov_26.131384	494	574	4	2	80	0.0250000
NODE_735_length_2801_cov_26.131384	494	574	7	55	80	0.6875000
NODE_735_length_2801_cov_26.131384	494	574	9	21	80	0.2625000
NODE_735_length_2801_cov_26.131384	1536	1596	10	3	60	0.0500000
NODE_735_length_2801_cov_26.131384	1536	1596	15	2	60	0.0333333
NODE_735_length_2801_cov_26.131384	1536	1596	19	5	60	0.0833333
NODE_735_length_2801_cov_26.131384	1536	1596	23	1	60	0.0166667
NODE_735_length_2801_cov_26.131384	1536	1596	25	3	60	0.0500000
NODE_735_length_2801_cov_26.131384	1536	1596	29	1	60	0.0166667
NODE_735_length_2801_cov_26.131384	1536	1596	31	3	60	0.0500000
NODE_735_length_2801_cov_26.131384	1536	1596	33	3	60	0.0500000
NODE_735_length_2801_cov_26.131384	1536	1596	39	1	60	0.0166667
NODE_735_length_2801_cov_26.131384	1536	1596	40	4	60	0.0666667
NODE_735_length_2801_cov_26.131384	1536	1596	44	2	60	0.0333333
NODE_735_length_2801_cov_26.131384	1536	1596	48	1	60	0.0166667
NODE_735_length_2801_cov_26.131384	1536	1596	60	3	60	0.0500000
NODE_735_length_2801_cov_26.131384	1536	1596	62	2	60	0.0333333
NODE_735_length_2801_cov_26.131384	1536	1596	66	1	60	0.0166667
NODE_735_length_2801_cov_26.131384	1536	1596	68	2	60	0.0333333
NODE_735_length_2801_cov_26.131384	1536	1596	70	13	60	0.2166667
NODE_735_length_2801_cov_26.131384	1536	1596	72	7	60	0.1166667
NODE_735_length_2801_cov_26.131384	1536	1596	78	2	60	0.0333333
NODE_735_length_2801_cov_26.131384	1536	1596	82	1	60	0.0166667
NODE_735_length_2801_cov_26.131384	1815	1881	0	66	66	1.0000000
NODE_735_length_2801_cov_26.131384	1854	1934	0	80	80	1.0000000
NODE_736_length_2801_cov_3.594375	2589	2645	8	39	56	0.6964286
NODE_736_length_2801_cov_3.594375	2589	2645	9	17	56	0.3035714
NODE_738_length_2796_cov_94.511680	1090	1137	3	1	47	0.0212766
NODE_738_length_2796_cov_94.511680	1090	1137	5	2	47	0.0425532
NODE_738_length_2796_cov_94.511680	1090	1137	7	3	47	0.0638298
NODE_738_length_2796_cov_94.511680	1090	1137	10	4	47	0.0851064
NODE_738_length_2796_cov_94.511680	1090	1137	11	1	47	0.0212766
NODE_738_length_2796_cov_94.511680	1090	1137	12	2	47	0.0425532
NODE_738_length_2796_cov_94.511680	1090	1137	14	1	47	0.0212766
NODE_738_length_2796_cov_94.511680	1090	1137	15	9	47	0.1914894
NODE_738_length_2796_cov_94.511680	1090	1137	16	3	47	0.0638298
NODE_738_length_2796_cov_94.511680	1090	1137	17	2	47	0.0425532
NODE_738_length_2796_cov_94.511680	1090	1137	20	1	47	0.0212766
NODE_738_length_2796_cov_94.511680	1090	1137	22	1	47	0.0212766
NODE_738_length_2796_cov_94.511680	1090	1137	24	1	47	0.0212766
NODE_738_length_2796_cov_94.511680	1090	1137	27	2	47	0.0425532
NODE_738_length_2796_cov_94.511680	1090	1137	31	4	47	0.0851064
NODE_738_length_2796_cov_94.511680	1090	1137	33	1	47	0.0212766
NODE_738_length_2796_cov_94.511680	1090	1137	37	1	47	0.0212766
NODE_738_length_2796_cov_94.511680	1090	1137	41	1	47	0.0212766
NODE_738_length_2796_cov_94.511680	1090	1137	43	1	47	0.0212766
NODE_738_length_2796_cov_94.511680	1090	1137	45	1	47	0.0212766
NODE_738_length_2796_cov_94.511680	1090	1137	49	1	47	0.0212766
NODE_738_length_2796_cov_94.511680	1090	1137	50	2	47	0.0425532
NODE_738_length_2796_cov_94.511680	1090	1137	54	2	47	0.0425532
NODE_738_length_2796_cov_94.511680	2717	2796	0	79	79	1.0000000
NODE_744_length_2791_cov_9.997028	310	390	0	31	80	0.3875000
NODE_744_length_2791_cov_9.997028	310	390	2	49	80	0.6125000
NODE_744_length_2791_cov_9.997028	363	443	0	24	80	0.3000000
NODE_744_length_2791_cov_9.997028	363	443	2	56	80	0.7000000
NODE_752_length_2778_cov_31.340799	2241	2321	0	2	80	0.0250000
NODE_752_length_2778_cov_31.340799	2241	2321	2	6	80	0.0750000
NODE_752_length_2778_cov_31.340799	2241	2321	4	72	80	0.9000000
NODE_752_length_2778_cov_31.340799	2294	2374	2	6	80	0.0750000
NODE_752_length_2778_cov_31.340799	2294	2374	4	74	80	0.9250000
NODE_752_length_2778_cov_31.340799	2370	2450	0	12	80	0.1500000
NODE_752_length_2778_cov_31.340799	2370	2450	2	68	80	0.8500000
NODE_752_length_2778_cov_31.340799	2423	2503	0	52	80	0.6500000
NODE_752_length_2778_cov_31.340799	2423	2503	1	1	80	0.0125000
NODE_752_length_2778_cov_31.340799	2423	2503	2	27	80	0.3375000
NODE_752_length_2778_cov_31.340799	2564	2620	0	29	56	0.5178571
NODE_752_length_2778_cov_31.340799	2564	2620	2	2	56	0.0357143
NODE_752_length_2778_cov_31.340799	2564	2620	4	25	56	0.4464286
NODE_758_length_2767_cov_12.450150	1941	2021	0	80	80	1.0000000
NODE_758_length_2767_cov_12.450150	1994	2074	0	80	80	1.0000000
NODE_767_length_2745_cov_5.322751	511	583	0	72	72	1.0000000
NODE_777_length_2720_cov_25.561618	2213	2293	2	2	80	0.0250000
NODE_777_length_2720_cov_25.561618	2213	2293	4	28	80	0.3500000
NODE_777_length_2720_cov_25.561618	2213	2293	6	50	80	0.6250000
NODE_777_length_2720_cov_25.561618	2266	2346	0	19	80	0.2375000
NODE_777_length_2720_cov_25.561618	2266	2346	2	23	80	0.2875000
NODE_777_length_2720_cov_25.561618	2266	2346	4	16	80	0.2000000
NODE_777_length_2720_cov_25.561618	2266	2346	6	22	80	0.2750000
NODE_782_length_2716_cov_39.885747	715	795	4	37	80	0.4625000
NODE_782_length_2716_cov_39.885747	715	795	6	32	80	0.4000000
NODE_782_length_2716_cov_39.885747	715	795	8	11	80	0.1375000
NODE_782_length_2716_cov_39.885747	768	848	4	6	80	0.0750000
NODE_782_length_2716_cov_39.885747	768	848	6	37	80	0.4625000
NODE_782_length_2716_cov_39.885747	768	848	8	37	80	0.4625000
NODE_782_length_2716_cov_39.885747	844	924	6	67	80	0.8375000
NODE_782_length_2716_cov_39.885747	844	924	8	13	80	0.1625000
NODE_782_length_2716_cov_39.885747	897	977	4	3	80	0.0375000
NODE_782_length_2716_cov_39.885747	897	977	6	53	80	0.6625000
NODE_782_length_2716_cov_39.885747	897	977	8	24	80	0.3000000
NODE_785_length_2710_cov_10.896974	2410	2446	4	3	36	0.0833333
NODE_785_length_2710_cov_10.896974	2410	2446	6	33	36	0.9166667
NODE_785_length_2710_cov_10.896974	2419	2499	6	60	80	0.7500000
NODE_785_length_2710_cov_10.896974	2419	2499	8	20	80	0.2500000
NODE_788_length_2708_cov_25.097355	2289	2369	0	80	80	1.0000000
NODE_788_length_2708_cov_25.097355	2342	2422	0	80	80	1.0000000
NODE_789_length_2708_cov_14.569950	18	98	58	1	80	0.0125000
NODE_789_length_2708_cov_14.569950	18	98	60	4	80	0.0500000
NODE_789_length_2708_cov_14.569950	18	98	64	4	80	0.0500000
NODE_789_length_2708_cov_14.569950	18	98	66	12	80	0.1500000
NODE_789_length_2708_cov_14.569950	18	98	68	59	80	0.7375000
NODE_789_length_2708_cov_14.569950	71	134	2	1	63	0.0158730
NODE_789_length_2708_cov_14.569950	71	134	12	1	63	0.0158730
NODE_789_length_2708_cov_14.569950	71	134	18	1	63	0.0158730
NODE_789_length_2708_cov_14.569950	71	134	26	1	63	0.0158730
NODE_789_length_2708_cov_14.569950	71	134	28	2	63	0.0317460
NODE_789_length_2708_cov_14.569950	71	134	34	2	63	0.0317460
NODE_789_length_2708_cov_14.569950	71	134	36	2	63	0.0317460
NODE_789_length_2708_cov_14.569950	71	134	40	3	63	0.0476190
NODE_789_length_2708_cov_14.569950	71	134	42	3	63	0.0476190
NODE_789_length_2708_cov_14.569950	71	134	46	5	63	0.0793651
NODE_789_length_2708_cov_14.569950	71	134	48	1	63	0.0158730
NODE_789_length_2708_cov_14.569950	71	134	49	1	63	0.0158730
NODE_789_length_2708_cov_14.569950	71	134	50	1	63	0.0158730
NODE_789_length_2708_cov_14.569950	71	134	55	1	63	0.0158730
NODE_789_length_2708_cov_14.569950	71	134	62	3	63	0.0476190
NODE_789_length_2708_cov_14.569950	71	134	66	1	63	0.0158730
NODE_789_length_2708_cov_14.569950	71	134	67	1	63	0.0158730
NODE_789_length_2708_cov_14.569950	71	134	68	33	63	0.5238096
NODE_797_length_2691_cov_35.457948	401	481	0	80	80	1.0000000
NODE_797_length_2691_cov_35.457948	454	534	0	80	80	1.0000000
NODE_803_length_2684_cov_17.345068	146	194	0	48	48	1.0000000
NODE_803_length_2684_cov_17.345068	146	194	0	48	48	1.0000000
NODE_803_length_2684_cov_17.345068	146	194	0	48	48	1.0000000
NODE_803_length_2684_cov_17.345068	146	194	0	48	48	1.0000000
NODE_803_length_2684_cov_17.345068	146	194	0	48	48	1.0000000
NODE_805_length_2682_cov_43.500581	913	992	168	3	79	0.0379747
NODE_805_length_2682_cov_43.500581	913	992	172	3	79	0.0379747
NODE_805_length_2682_cov_43.500581	913	992	174	1	79	0.0126582
NODE_805_length_2682_cov_43.500581	913	992	176	1	79	0.0126582
NODE_805_length_2682_cov_43.500581	913	992	178	2	79	0.0253165
NODE_805_length_2682_cov_43.500581	913	992	180	1	79	0.0126582
NODE_805_length_2682_cov_43.500581	913	992	184	1	79	0.0126582
NODE_805_length_2682_cov_43.500581	913	992	188	3	79	0.0379747
NODE_805_length_2682_cov_43.500581	913	992	190	1	79	0.0126582
NODE_805_length_2682_cov_43.500581	913	992	192	2	79	0.0253165
NODE_805_length_2682_cov_43.500581	913	992	194	1	79	0.0126582
NODE_805_length_2682_cov_43.500581	913	992	196	1	79	0.0126582
NODE_805_length_2682_cov_43.500581	913	992	198	1	79	0.0126582
NODE_805_length_2682_cov_43.500581	913	992	208	3	79	0.0379747
NODE_805_length_2682_cov_43.500581	913	992	213	1	79	0.0126582
NODE_805_length_2682_cov_43.500581	913	992	215	1	79	0.0126582
NODE_805_length_2682_cov_43.500581	913	992	220	1	79	0.0126582
NODE_805_length_2682_cov_43.500581	913	992	222	1	79	0.0126582
NODE_805_length_2682_cov_43.500581	913	992	225	1	79	0.0126582
NODE_805_length_2682_cov_43.500581	913	992	230	2	79	0.0253165
NODE_805_length_2682_cov_43.500581	913	992	232	1	79	0.0126582
NODE_805_length_2682_cov_43.500581	913	992	234	1	79	0.0126582
NODE_805_length_2682_cov_43.500581	913	992	235	1	79	0.0126582
NODE_805_length_2682_cov_43.500581	913	992	236	1	79	0.0126582
NODE_805_length_2682_cov_43.500581	913	992	243	1	79	0.0126582
NODE_805_length_2682_cov_43.500581	913	992	245	1	79	0.0126582
NODE_805_length_2682_cov_43.500581	913	992	248	1	79	0.0126582
NODE_805_length_2682_cov_43.500581	913	992	249	2	79	0.0253165
NODE_805_length_2682_cov_43.500581	913	992	251	1	79	0.0126582
NODE_805_length_2682_cov_43.500581	913	992	259	1	79	0.0126582
NODE_805_length_2682_cov_43.500581	913	992	262	2	79	0.0253165
NODE_805_length_2682_cov_43.500581	913	992	264	1	79	0.0126582
NODE_805_length_2682_cov_43.500581	913	992	268	3	79	0.0379747
NODE_805_length_2682_cov_43.500581	913	992	270	1	79	0.0126582
NODE_805_length_2682_cov_43.500581	913	992	272	1	79	0.0126582
NODE_805_length_2682_cov_43.500581	913	992	274	1	79	0.0126582
NODE_805_length_2682_cov_43.500581	913	992	275	1	79	0.0126582
NODE_805_length_2682_cov_43.500581	913	992	276	1	79	0.0126582
NODE_805_length_2682_cov_43.500581	913	992	277	4	79	0.0506329
NODE_805_length_2682_cov_43.500581	913	992	279	4	79	0.0506329
NODE_805_length_2682_cov_43.500581	913	992	280	1	79	0.0126582
NODE_805_length_2682_cov_43.500581	913	992	281	1	79	0.0126582
NODE_805_length_2682_cov_43.500581	913	992	283	1	79	0.0126582
NODE_805_length_2682_cov_43.500581	913	992	284	1	79	0.0126582
NODE_805_length_2682_cov_43.500581	913	992	285	1	79	0.0126582
NODE_805_length_2682_cov_43.500581	913	992	294	1	79	0.0126582
NODE_805_length_2682_cov_43.500581	913	992	295	1	79	0.0126582
NODE_805_length_2682_cov_43.500581	913	992	299	2	79	0.0253165
NODE_805_length_2682_cov_43.500581	913	992	301	1	79	0.0126582
NODE_805_length_2682_cov_43.500581	913	992	306	1	79	0.0126582
NODE_805_length_2682_cov_43.500581	913	992	313	1	79	0.0126582
NODE_805_length_2682_cov_43.500581	913	992	315	2	79	0.0253165
NODE_805_length_2682_cov_43.500581	913	992	316	1	79	0.0126582
NODE_805_length_2682_cov_43.500581	913	992	318	1	79	0.0126582
NODE_805_length_2682_cov_43.500581	913	992	320	1	79	0.0126582
NODE_805_length_2682_cov_43.500581	913	992	324	1	79	0.0126582
NODE_805_length_2682_cov_43.500581	965	1002	158	3	37	0.0810811
NODE_805_length_2682_cov_43.500581	965	1002	162	1	37	0.0270270
NODE_805_length_2682_cov_43.500581	965	1002	164	3	37	0.0810811
NODE_805_length_2682_cov_43.500581	965	1002	166	2	37	0.0540541
NODE_805_length_2682_cov_43.500581	965	1002	168	4	37	0.1081081
NODE_805_length_2682_cov_43.500581	965	1002	172	3	37	0.0810811
NODE_805_length_2682_cov_43.500581	965	1002	174	1	37	0.0270270
NODE_805_length_2682_cov_43.500581	965	1002	176	1	37	0.0270270
NODE_805_length_2682_cov_43.500581	965	1002	178	2	37	0.0540541
NODE_805_length_2682_cov_43.500581	965	1002	180	1	37	0.0270270
NODE_805_length_2682_cov_43.500581	965	1002	184	1	37	0.0270270
NODE_805_length_2682_cov_43.500581	965	1002	188	3	37	0.0810811
NODE_805_length_2682_cov_43.500581	965	1002	190	1	37	0.0270270
NODE_805_length_2682_cov_43.500581	965	1002	192	2	37	0.0540541
NODE_805_length_2682_cov_43.500581	965	1002	194	1	37	0.0270270
NODE_805_length_2682_cov_43.500581	965	1002	196	1	37	0.0270270
NODE_805_length_2682_cov_43.500581	965	1002	198	1	37	0.0270270
NODE_805_length_2682_cov_43.500581	965	1002	208	3	37	0.0810811
NODE_805_length_2682_cov_43.500581	965	1002	213	1	37	0.0270270
NODE_805_length_2682_cov_43.500581	965	1002	215	1	37	0.0270270
NODE_805_length_2682_cov_43.500581	965	1002	220	1	37	0.0270270
NODE_808_length_2675_cov_10.369565	209	289	6	6	80	0.0750000
NODE_808_length_2675_cov_10.369565	209	289	8	10	80	0.1250000
NODE_808_length_2675_cov_10.369565	209	289	10	23	80	0.2875000
NODE_808_length_2675_cov_10.369565	209	289	12	11	80	0.1375000
NODE_808_length_2675_cov_10.369565	209	289	14	2	80	0.0250000
NODE_808_length_2675_cov_10.369565	209	289	16	2	80	0.0250000
NODE_808_length_2675_cov_10.369565	209	289	18	1	80	0.0125000
NODE_808_length_2675_cov_10.369565	209	289	20	18	80	0.2250000
NODE_808_length_2675_cov_10.369565	209	289	22	6	80	0.0750000
NODE_808_length_2675_cov_10.369565	209	289	23	1	80	0.0125000
NODE_813_length_2670_cov_17.489304	1995	2075	0	68	80	0.8500000
NODE_813_length_2670_cov_17.489304	1995	2075	2	12	80	0.1500000
NODE_813_length_2670_cov_17.489304	2048	2128	0	67	80	0.8375000
NODE_813_length_2670_cov_17.489304	2048	2128	4	13	80	0.1625000
NODE_813_length_2670_cov_17.489304	2124	2204	4	58	80	0.7250000
NODE_813_length_2670_cov_17.489304	2124	2204	6	22	80	0.2750000
NODE_813_length_2670_cov_17.489304	2177	2257	2	36	80	0.4500000
NODE_813_length_2670_cov_17.489304	2177	2257	4	5	80	0.0625000
NODE_813_length_2670_cov_17.489304	2177	2257	6	39	80	0.4875000
NODE_815_length_2665_cov_19.145752	548	628	0	45	80	0.5625000
NODE_815_length_2665_cov_19.145752	548	628	2	24	80	0.3000000
NODE_815_length_2665_cov_19.145752	548	628	4	11	80	0.1375000
NODE_815_length_2665_cov_19.145752	601	681	0	3	80	0.0375000
NODE_815_length_2665_cov_19.145752	601	681	1	8	80	0.1000000
NODE_815_length_2665_cov_19.145752	601	681	2	16	80	0.2000000
NODE_815_length_2665_cov_19.145752	601	681	3	6	80	0.0750000
NODE_815_length_2665_cov_19.145752	601	681	4	47	80	0.5875000
NODE_815_length_2665_cov_19.145752	2099	2176	0	29	77	0.3766234
NODE_815_length_2665_cov_19.145752	2099	2176	2	11	77	0.1428571
NODE_815_length_2665_cov_19.145752	2099	2176	3	8	77	0.1038961
NODE_815_length_2665_cov_19.145752	2099	2176	4	3	77	0.0389610
NODE_815_length_2665_cov_19.145752	2099	2176	6	26	77	0.3376623
NODE_815_length_2665_cov_19.145752	2172	2252	4	36	80	0.4500000
NODE_815_length_2665_cov_19.145752	2172	2252	6	44	80	0.5500000
NODE_815_length_2665_cov_19.145752	2172	2252	4	36	80	0.4500000
NODE_815_length_2665_cov_19.145752	2172	2252	6	44	80	0.5500000
NODE_815_length_2665_cov_19.145752	2225	2267	0	5	42	0.1190476
NODE_815_length_2665_cov_19.145752	2225	2267	4	37	42	0.8809524
NODE_816_length_2664_cov_4.175049	2005	2085	2	59	80	0.7375000
NODE_816_length_2664_cov_4.175049	2005	2085	4	21	80	0.2625000
NODE_816_length_2664_cov_4.175049	2058	2138	0	29	80	0.3625000
NODE_816_length_2664_cov_4.175049	2058	2138	2	51	80	0.6375000
NODE_822_length_2650_cov_19.800862	800	880	6	3	80	0.0375000
NODE_822_length_2650_cov_19.800862	800	880	8	4	80	0.0500000
NODE_822_length_2650_cov_19.800862	800	880	10	22	80	0.2750000
NODE_822_length_2650_cov_19.800862	800	880	12	5	80	0.0625000
NODE_822_length_2650_cov_19.800862	800	880	14	6	80	0.0750000
NODE_822_length_2650_cov_19.800862	800	880	15	1	80	0.0125000
NODE_822_length_2650_cov_19.800862	800	880	16	39	80	0.4875000
NODE_824_length_2645_cov_8.618225	931	1011	0	80	80	1.0000000
NODE_824_length_2645_cov_8.618225	984	1064	0	68	80	0.8500000
NODE_824_length_2645_cov_8.618225	984	1064	1	3	80	0.0375000
NODE_824_length_2645_cov_8.618225	984	1064	3	9	80	0.1125000
NODE_827_length_2640_cov_16.462810	94	164	117	1	70	0.0142857
NODE_827_length_2640_cov_16.462810	94	164	119	1	70	0.0142857
NODE_827_length_2640_cov_16.462810	94	164	121	3	70	0.0428571
NODE_827_length_2640_cov_16.462810	94	164	123	3	70	0.0428571
NODE_827_length_2640_cov_16.462810	94	164	124	1	70	0.0142857
NODE_827_length_2640_cov_16.462810	94	164	125	1	70	0.0142857
NODE_827_length_2640_cov_16.462810	94	164	127	1	70	0.0142857
NODE_827_length_2640_cov_16.462810	94	164	136	1	70	0.0142857
NODE_827_length_2640_cov_16.462810	94	164	140	2	70	0.0285714
NODE_827_length_2640_cov_16.462810	94	164	142	2	70	0.0285714
NODE_827_length_2640_cov_16.462810	94	164	143	1	70	0.0142857
NODE_827_length_2640_cov_16.462810	94	164	144	2	70	0.0285714
NODE_827_length_2640_cov_16.462810	94	164	145	1	70	0.0142857
NODE_827_length_2640_cov_16.462810	94	164	146	2	70	0.0285714
NODE_827_length_2640_cov_16.462810	94	164	149	1	70	0.0142857
NODE_827_length_2640_cov_16.462810	94	164	163	1	70	0.0142857
NODE_827_length_2640_cov_16.462810	94	164	168	3	70	0.0428571
NODE_827_length_2640_cov_16.462810	94	164	182	1	70	0.0142857
NODE_827_length_2640_cov_16.462810	94	164	188	1	70	0.0142857
NODE_827_length_2640_cov_16.462810	94	164	194	1	70	0.0142857
NODE_827_length_2640_cov_16.462810	94	164	197	1	70	0.0142857
NODE_827_length_2640_cov_16.462810	94	164	198	2	70	0.0285714
NODE_827_length_2640_cov_16.462810	94	164	200	1	70	0.0142857
NODE_827_length_2640_cov_16.462810	94	164	208	1	70	0.0142857
NODE_827_length_2640_cov_16.462810	94	164	210	3	70	0.0428571
NODE_827_length_2640_cov_16.462810	94	164	216	3	70	0.0428571
NODE_827_length_2640_cov_16.462810	94	164	218	1	70	0.0142857
NODE_827_length_2640_cov_16.462810	94	164	220	1	70	0.0142857
NODE_827_length_2640_cov_16.462810	94	164	224	1	70	0.0142857
NODE_827_length_2640_cov_16.462810	94	164	234	1	70	0.0142857
NODE_827_length_2640_cov_16.462810	94	164	236	1	70	0.0142857
NODE_827_length_2640_cov_16.462810	94	164	243	1	70	0.0142857
NODE_827_length_2640_cov_16.462810	94	164	248	1	70	0.0142857
NODE_827_length_2640_cov_16.462810	94	164	254	1	70	0.0142857
NODE_827_length_2640_cov_16.462810	94	164	255	2	70	0.0285714
NODE_827_length_2640_cov_16.462810	94	164	260	1	70	0.0142857
NODE_827_length_2640_cov_16.462810	94	164	262	1	70	0.0142857
NODE_827_length_2640_cov_16.462810	94	164	265	2	70	0.0285714
NODE_827_length_2640_cov_16.462810	94	164	267	1	70	0.0142857
NODE_827_length_2640_cov_16.462810	94	164	272	2	70	0.0285714
NODE_827_length_2640_cov_16.462810	94	164	273	1	70	0.0142857
NODE_827_length_2640_cov_16.462810	94	164	274	2	70	0.0285714
NODE_827_length_2640_cov_16.462810	94	164	275	2	70	0.0285714
NODE_827_length_2640_cov_16.462810	94	164	276	6	70	0.0857143
NODE_827_length_2640_cov_16.462810	94	164	278	1	70	0.0142857
NODE_827_length_2640_cov_16.462810	147	209	72	2	62	0.0322581
NODE_827_length_2640_cov_16.462810	147	209	74	3	62	0.0483871
NODE_827_length_2640_cov_16.462810	147	209	78	1	62	0.0161290
NODE_827_length_2640_cov_16.462810	147	209	79	1	62	0.0161290
NODE_827_length_2640_cov_16.462810	147	209	81	4	62	0.0645161
NODE_827_length_2640_cov_16.462810	147	209	83	2	62	0.0322581
NODE_827_length_2640_cov_16.462810	147	209	87	1	62	0.0161290
NODE_827_length_2640_cov_16.462810	147	209	88	1	62	0.0161290
NODE_827_length_2640_cov_16.462810	147	209	89	2	62	0.0322581
NODE_827_length_2640_cov_16.462810	147	209	90	8	62	0.1290323
NODE_827_length_2640_cov_16.462810	147	209	96	3	62	0.0483871
NODE_827_length_2640_cov_16.462810	147	209	97	1	62	0.0161290
NODE_827_length_2640_cov_16.462810	147	209	99	6	62	0.0967742
NODE_827_length_2640_cov_16.462810	147	209	101	2	62	0.0322581
NODE_827_length_2640_cov_16.462810	147	209	103	2	62	0.0322581
NODE_827_length_2640_cov_16.462810	147	209	105	2	62	0.0322581
NODE_827_length_2640_cov_16.462810	147	209	111	1	62	0.0161290
NODE_827_length_2640_cov_16.462810	147	209	113	1	62	0.0161290
NODE_827_length_2640_cov_16.462810	147	209	115	1	62	0.0161290
NODE_827_length_2640_cov_16.462810	147	209	117	2	62	0.0322581
NODE_827_length_2640_cov_16.462810	147	209	119	1	62	0.0161290
NODE_827_length_2640_cov_16.462810	147	209	121	3	62	0.0483871
NODE_827_length_2640_cov_16.462810	147	209	123	3	62	0.0483871
NODE_827_length_2640_cov_16.462810	147	209	124	1	62	0.0161290
NODE_827_length_2640_cov_16.462810	147	209	125	1	62	0.0161290
NODE_827_length_2640_cov_16.462810	147	209	127	1	62	0.0161290
NODE_827_length_2640_cov_16.462810	147	209	136	1	62	0.0161290
NODE_827_length_2640_cov_16.462810	147	209	140	1	62	0.0161290
NODE_827_length_2640_cov_16.462810	147	209	142	2	62	0.0322581
NODE_827_length_2640_cov_16.462810	147	209	144	2	62	0.0322581
NODE_828_length_2636_cov_200.191171	561	641	86	2	80	0.0250000
NODE_828_length_2636_cov_200.191171	561	641	88	1	80	0.0125000
NODE_828_length_2636_cov_200.191171	561	641	89	1	80	0.0125000
NODE_828_length_2636_cov_200.191171	561	641	92	1	80	0.0125000
NODE_828_length_2636_cov_200.191171	561	641	100	1	80	0.0125000
NODE_828_length_2636_cov_200.191171	561	641	104	2	80	0.0250000
NODE_828_length_2636_cov_200.191171	561	641	105	1	80	0.0125000
NODE_828_length_2636_cov_200.191171	561	641	106	2	80	0.0250000
NODE_828_length_2636_cov_200.191171	561	641	107	1	80	0.0125000
NODE_828_length_2636_cov_200.191171	561	641	108	1	80	0.0125000
NODE_828_length_2636_cov_200.191171	561	641	111	1	80	0.0125000
NODE_828_length_2636_cov_200.191171	561	641	114	2	80	0.0250000
NODE_828_length_2636_cov_200.191171	561	641	122	3	80	0.0375000
NODE_828_length_2636_cov_200.191171	561	641	130	2	80	0.0250000
NODE_828_length_2636_cov_200.191171	561	641	132	1	80	0.0125000
NODE_828_length_2636_cov_200.191171	561	641	136	2	80	0.0250000
NODE_828_length_2636_cov_200.191171	561	641	137	3	80	0.0375000
NODE_828_length_2636_cov_200.191171	561	641	138	6	80	0.0750000
NODE_828_length_2636_cov_200.191171	561	641	140	4	80	0.0500000
NODE_828_length_2636_cov_200.191171	561	641	142	5	80	0.0625000
NODE_828_length_2636_cov_200.191171	561	641	144	1	80	0.0125000
NODE_828_length_2636_cov_200.191171	561	641	146	1	80	0.0125000
NODE_828_length_2636_cov_200.191171	561	641	148	13	80	0.1625000
NODE_828_length_2636_cov_200.191171	561	641	152	5	80	0.0625000
NODE_828_length_2636_cov_200.191171	561	641	154	2	80	0.0250000
NODE_828_length_2636_cov_200.191171	561	641	157	11	80	0.1375000
NODE_828_length_2636_cov_200.191171	561	641	158	3	80	0.0375000
NODE_828_length_2636_cov_200.191171	561	641	160	2	80	0.0250000
NODE_828_length_2636_cov_200.191171	614	695	46	2	81	0.0246914
NODE_828_length_2636_cov_200.191171	614	695	48	1	81	0.0123457
NODE_828_length_2636_cov_200.191171	614	695	49	2	81	0.0246914
NODE_828_length_2636_cov_200.191171	614	695	51	3	81	0.0370370
NODE_828_length_2636_cov_200.191171	614	695	52	2	81	0.0246914
NODE_828_length_2636_cov_200.191171	614	695	54	2	81	0.0246914
NODE_828_length_2636_cov_200.191171	614	695	60	1	81	0.0123457
NODE_828_length_2636_cov_200.191171	614	695	64	1	81	0.0123457
NODE_828_length_2636_cov_200.191171	614	695	66	1	81	0.0123457
NODE_828_length_2636_cov_200.191171	614	695	70	1	81	0.0123457
NODE_828_length_2636_cov_200.191171	614	695	72	3	81	0.0370370
NODE_828_length_2636_cov_200.191171	614	695	74	1	81	0.0123457
NODE_828_length_2636_cov_200.191171	614	695	76	1	81	0.0123457
NODE_828_length_2636_cov_200.191171	614	695	78	2	81	0.0246914
NODE_828_length_2636_cov_200.191171	614	695	82	1	81	0.0123457
NODE_828_length_2636_cov_200.191171	614	695	85	1	81	0.0123457
NODE_828_length_2636_cov_200.191171	614	695	87	1	81	0.0123457
NODE_828_length_2636_cov_200.191171	614	695	91	1	81	0.0123457
NODE_828_length_2636_cov_200.191171	614	695	96	1	81	0.0123457
NODE_828_length_2636_cov_200.191171	614	695	102	1	81	0.0123457
NODE_828_length_2636_cov_200.191171	614	695	114	1	81	0.0123457
NODE_828_length_2636_cov_200.191171	614	695	118	4	81	0.0493827
NODE_828_length_2636_cov_200.191171	614	695	120	3	81	0.0370370
NODE_828_length_2636_cov_200.191171	614	695	121	1	81	0.0123457
NODE_828_length_2636_cov_200.191171	614	695	123	4	81	0.0493827
NODE_828_length_2636_cov_200.191171	614	695	125	3	81	0.0370370
NODE_828_length_2636_cov_200.191171	614	695	127	3	81	0.0370370
NODE_828_length_2636_cov_200.191171	614	695	129	1	81	0.0123457
NODE_828_length_2636_cov_200.191171	614	695	131	2	81	0.0246914
NODE_828_length_2636_cov_200.191171	614	695	133	2	81	0.0246914
NODE_828_length_2636_cov_200.191171	614	695	137	4	81	0.0493827
NODE_828_length_2636_cov_200.191171	614	695	138	6	81	0.0740741
NODE_828_length_2636_cov_200.191171	614	695	140	2	81	0.0246914
NODE_828_length_2636_cov_200.191171	614	695	142	5	81	0.0617284
NODE_828_length_2636_cov_200.191171	614	695	148	11	81	0.1358025
NODE_830_length_2631_cov_10.831754	446	526	7	41	80	0.5125000
NODE_830_length_2631_cov_10.831754	446	526	9	20	80	0.2500000
NODE_830_length_2631_cov_10.831754	446	526	13	19	80	0.2375000
NODE_830_length_2631_cov_10.831754	499	572	8	16	73	0.2191781
NODE_830_length_2631_cov_10.831754	499	572	9	12	73	0.1643836
NODE_830_length_2631_cov_10.831754	499	572	11	19	73	0.2602740
NODE_830_length_2631_cov_10.831754	499	572	13	26	73	0.3561644
NODE_833_length_2622_cov_63.057471	1877	1953	94	6	76	0.0789474
NODE_833_length_2622_cov_63.057471	1877	1953	96	1	76	0.0131579
NODE_833_length_2622_cov_63.057471	1877	1953	97	1	76	0.0131579
NODE_833_length_2622_cov_63.057471	1877	1953	99	1	76	0.0131579
NODE_833_length_2622_cov_63.057471	1877	1953	101	2	76	0.0263158
NODE_833_length_2622_cov_63.057471	1877	1953	103	1	76	0.0131579
NODE_833_length_2622_cov_63.057471	1877	1953	105	3	76	0.0394737
NODE_833_length_2622_cov_63.057471	1877	1953	107	5	76	0.0657895
NODE_833_length_2622_cov_63.057471	1877	1953	108	4	76	0.0526316
NODE_833_length_2622_cov_63.057471	1877	1953	109	9	76	0.1184211
NODE_833_length_2622_cov_63.057471	1877	1953	110	8	76	0.1052632
NODE_833_length_2622_cov_63.057471	1877	1953	112	13	76	0.1710526
NODE_833_length_2622_cov_63.057471	1877	1953	113	9	76	0.1184211
NODE_833_length_2622_cov_63.057471	1877	1953	114	9	76	0.1184211
NODE_833_length_2622_cov_63.057471	1877	1953	115	4	76	0.0526316
NODE_833_length_2622_cov_63.057471	2426	2506	40	4	80	0.0500000
NODE_833_length_2622_cov_63.057471	2426	2506	42	8	80	0.1000000
NODE_833_length_2622_cov_63.057471	2426	2506	44	2	80	0.0250000
NODE_833_length_2622_cov_63.057471	2426	2506	46	1	80	0.0125000
NODE_833_length_2622_cov_63.057471	2426	2506	52	5	80	0.0625000
NODE_833_length_2622_cov_63.057471	2426	2506	53	2	80	0.0250000
NODE_833_length_2622_cov_63.057471	2426	2506	54	19	80	0.2375000
NODE_833_length_2622_cov_63.057471	2426	2506	56	6	80	0.0750000
NODE_833_length_2622_cov_63.057471	2426	2506	58	11	80	0.1375000
NODE_833_length_2622_cov_63.057471	2426	2506	60	17	80	0.2125000
NODE_833_length_2622_cov_63.057471	2426	2506	61	1	80	0.0125000
NODE_833_length_2622_cov_63.057471	2426	2506	64	1	80	0.0125000
NODE_833_length_2622_cov_63.057471	2426	2506	66	2	80	0.0250000
NODE_833_length_2622_cov_63.057471	2426	2506	68	1	80	0.0125000
NODE_833_length_2622_cov_63.057471	2479	2559	48	3	80	0.0375000
NODE_833_length_2622_cov_63.057471	2479	2559	51	1	80	0.0125000
NODE_833_length_2622_cov_63.057471	2479	2559	52	4	80	0.0500000
NODE_833_length_2622_cov_63.057471	2479	2559	54	13	80	0.1625000
NODE_833_length_2622_cov_63.057471	2479	2559	56	5	80	0.0625000
NODE_833_length_2622_cov_63.057471	2479	2559	58	7	80	0.0875000
NODE_833_length_2622_cov_63.057471	2479	2559	60	5	80	0.0625000
NODE_833_length_2622_cov_63.057471	2479	2559	61	1	80	0.0125000
NODE_833_length_2622_cov_63.057471	2479	2559	62	1	80	0.0125000
NODE_833_length_2622_cov_63.057471	2479	2559	64	5	80	0.0625000
NODE_833_length_2622_cov_63.057471	2479	2559	66	7	80	0.0875000
NODE_833_length_2622_cov_63.057471	2479	2559	68	1	80	0.0125000
NODE_833_length_2622_cov_63.057471	2479	2559	70	19	80	0.2375000
NODE_833_length_2622_cov_63.057471	2479	2559	72	4	80	0.0500000
NODE_833_length_2622_cov_63.057471	2479	2559	74	4	80	0.0500000
NODE_836_length_2617_cov_16.817315	1404	1448	6	17	44	0.3863636
NODE_836_length_2617_cov_16.817315	1404	1448	8	27	44	0.6136364
NODE_836_length_2617_cov_16.817315	1467	1521	0	23	54	0.4259259
NODE_836_length_2617_cov_16.817315	1467	1521	2	31	54	0.5740741
NODE_839_length_2610_cov_2.232577	2127	2163	0	36	36	1.0000000
NODE_840_length_2609_cov_13.245418	2066	2146	0	3	80	0.0375000
NODE_840_length_2609_cov_13.245418	2066	2146	6	7	80	0.0875000
NODE_840_length_2609_cov_13.245418	2066	2146	10	70	80	0.8750000
NODE_840_length_2609_cov_13.245418	2119	2199	0	56	80	0.7000000
NODE_840_length_2609_cov_13.245418	2119	2199	6	7	80	0.0875000
NODE_840_length_2609_cov_13.245418	2119	2199	10	17	80	0.2125000
NODE_840_length_2609_cov_13.245418	2195	2275	0	77	80	0.9625000
NODE_840_length_2609_cov_13.245418	2195	2275	4	3	80	0.0375000
NODE_840_length_2609_cov_13.245418	2248	2328	0	24	80	0.3000000
NODE_840_length_2609_cov_13.245418	2248	2328	4	56	80	0.7000000
NODE_845_length_2595_cov_5.638622	2157	2237	2	80	80	1.0000000
NODE_847_length_2594_cov_109.880160	386	450	11	2	64	0.0312500
NODE_847_length_2594_cov_109.880160	386	450	13	1	64	0.0156250
NODE_847_length_2594_cov_109.880160	386	450	15	1	64	0.0156250
NODE_847_length_2594_cov_109.880160	386	450	17	8	64	0.1250000
NODE_847_length_2594_cov_109.880160	386	450	19	2	64	0.0312500
NODE_847_length_2594_cov_109.880160	386	450	25	1	64	0.0156250
NODE_847_length_2594_cov_109.880160	386	450	27	1	64	0.0156250
NODE_847_length_2594_cov_109.880160	386	450	28	1	64	0.0156250
NODE_847_length_2594_cov_109.880160	386	450	37	1	64	0.0156250
NODE_847_length_2594_cov_109.880160	386	450	45	2	64	0.0312500
NODE_847_length_2594_cov_109.880160	386	450	49	2	64	0.0312500
NODE_847_length_2594_cov_109.880160	386	450	54	3	64	0.0468750
NODE_847_length_2594_cov_109.880160	386	450	55	1	64	0.0156250
NODE_847_length_2594_cov_109.880160	386	450	58	3	64	0.0468750
NODE_847_length_2594_cov_109.880160	386	450	62	1	64	0.0156250
NODE_847_length_2594_cov_109.880160	386	450	68	1	64	0.0156250
NODE_847_length_2594_cov_109.880160	386	450	70	7	64	0.1093750
NODE_847_length_2594_cov_109.880160	386	450	71	3	64	0.0468750
NODE_847_length_2594_cov_109.880160	386	450	79	1	64	0.0156250
NODE_847_length_2594_cov_109.880160	386	450	88	3	64	0.0468750
NODE_847_length_2594_cov_109.880160	386	450	90	4	64	0.0625000
NODE_847_length_2594_cov_109.880160	386	450	92	3	64	0.0468750
NODE_847_length_2594_cov_109.880160	386	450	94	2	64	0.0312500
NODE_847_length_2594_cov_109.880160	386	450	96	2	64	0.0312500
NODE_847_length_2594_cov_109.880160	386	450	98	8	64	0.1250000
NODE_856_length_2575_cov_4.890549	1860	1912	0	17	52	0.3269231
NODE_856_length_2575_cov_4.890549	1860	1912	2	5	52	0.0961538
NODE_856_length_2575_cov_4.890549	1860	1912	6	15	52	0.2884615
NODE_856_length_2575_cov_4.890549	1860	1912	8	13	52	0.2500000
NODE_856_length_2575_cov_4.890549	1860	1912	10	2	52	0.0384615
NODE_857_length_2572_cov_46.828548	302	382	0	80	80	1.0000000
NODE_857_length_2572_cov_46.828548	355	435	0	80	80	1.0000000
NODE_868_length_2551_cov_40.721860	1104	1150	4	41	46	0.8913044
NODE_868_length_2551_cov_40.721860	1104	1150	8	5	46	0.1086956
NODE_868_length_2551_cov_40.721860	1199	1259	2	5	60	0.0833333
NODE_868_length_2551_cov_40.721860	1199	1259	4	5	60	0.0833333
NODE_868_length_2551_cov_40.721860	1199	1259	6	2	60	0.0333333
NODE_868_length_2551_cov_40.721860	1199	1259	10	48	60	0.8000000
NODE_870_length_2547_cov_218.062908	436	486	0	26	50	0.5200000
NODE_870_length_2547_cov_218.062908	436	486	1	5	50	0.1000000
NODE_870_length_2547_cov_218.062908	436	486	3	3	50	0.0600000
NODE_870_length_2547_cov_218.062908	436	486	5	7	50	0.1400000
NODE_870_length_2547_cov_218.062908	436	486	7	2	50	0.0400000
NODE_870_length_2547_cov_218.062908	436	486	11	4	50	0.0800000
NODE_870_length_2547_cov_218.062908	436	486	13	3	50	0.0600000
NODE_879_length_2527_cov_27.275947	503	548	52	1	45	0.0222222
NODE_879_length_2527_cov_27.275947	503	548	53	1	45	0.0222222
NODE_879_length_2527_cov_27.275947	503	548	54	12	45	0.2666667
NODE_879_length_2527_cov_27.275947	503	548	56	8	45	0.1777778
NODE_879_length_2527_cov_27.275947	503	548	58	3	45	0.0666667
NODE_879_length_2527_cov_27.275947	503	548	59	8	45	0.1777778
NODE_879_length_2527_cov_27.275947	503	548	60	6	45	0.1333333
NODE_879_length_2527_cov_27.275947	503	548	62	6	45	0.1333333
NODE_884_length_2519_cov_15.991322	2122	2202	0	7	80	0.0875000
NODE_884_length_2519_cov_15.991322	2122	2202	4	73	80	0.9125000
NODE_884_length_2519_cov_15.991322	2175	2255	0	6	80	0.0750000
NODE_884_length_2519_cov_15.991322	2175	2255	2	36	80	0.4500000
NODE_884_length_2519_cov_15.991322	2175	2255	4	38	80	0.4750000
NODE_885_length_2518_cov_7.035965	62	142	13	1	80	0.0125000
NODE_885_length_2518_cov_7.035965	62	142	20	1	80	0.0125000
NODE_885_length_2518_cov_7.035965	62	142	24	3	80	0.0375000
NODE_885_length_2518_cov_7.035965	62	142	28	2	80	0.0250000
NODE_885_length_2518_cov_7.035965	62	142	34	3	80	0.0375000
NODE_885_length_2518_cov_7.035965	62	142	38	2	80	0.0250000
NODE_885_length_2518_cov_7.035965	62	142	40	4	80	0.0500000
NODE_885_length_2518_cov_7.035965	62	142	42	1	80	0.0125000
NODE_885_length_2518_cov_7.035965	62	142	44	11	80	0.1375000
NODE_885_length_2518_cov_7.035965	62	142	46	16	80	0.2000000
NODE_885_length_2518_cov_7.035965	62	142	48	15	80	0.1875000
NODE_885_length_2518_cov_7.035965	62	142	50	21	80	0.2625000
NODE_885_length_2518_cov_7.035965	2005	2085	0	80	80	1.0000000
NODE_885_length_2518_cov_7.035965	2058	2138	0	80	80	1.0000000
NODE_887_length_2515_cov_37.984272	393	473	0	35	80	0.4375000
NODE_887_length_2515_cov_37.984272	393	473	2	20	80	0.2500000
NODE_887_length_2515_cov_37.984272	393	473	4	25	80	0.3125000
NODE_887_length_2515_cov_37.984272	446	526	2	10	80	0.1250000
NODE_887_length_2515_cov_37.984272	446	526	4	70	80	0.8750000
NODE_887_length_2515_cov_37.984272	1896	1976	0	7	80	0.0875000
NODE_887_length_2515_cov_37.984272	1896	1976	2	48	80	0.6000000
NODE_887_length_2515_cov_37.984272	1896	1976	4	25	80	0.3125000
NODE_887_length_2515_cov_37.984272	1949	2029	2	63	80	0.7875000
NODE_887_length_2515_cov_37.984272	1949	2029	4	17	80	0.2125000
NODE_887_length_2515_cov_37.984272	2025	2105	0	8	80	0.1000000
NODE_887_length_2515_cov_37.984272	2025	2105	2	72	80	0.9000000
NODE_887_length_2515_cov_37.984272	2025	2104	0	8	79	0.1012658
NODE_887_length_2515_cov_37.984272	2025	2104	2	71	79	0.8987342
NODE_887_length_2515_cov_37.984272	2078	2158	0	44	80	0.5500000
NODE_887_length_2515_cov_37.984272	2078	2158	2	36	80	0.4500000
NODE_888_length_2512_cov_48.259428	1299	1379	12	10	80	0.1250000
NODE_888_length_2512_cov_48.259428	1299	1379	14	25	80	0.3125000
NODE_888_length_2512_cov_48.259428	1299	1379	16	23	80	0.2875000
NODE_888_length_2512_cov_48.259428	1299	1379	18	22	80	0.2750000
NODE_888_length_2512_cov_48.259428	1352	1432	6	3	80	0.0375000
NODE_888_length_2512_cov_48.259428	1352	1432	8	9	80	0.1125000
NODE_888_length_2512_cov_48.259428	1352	1432	10	3	80	0.0375000
NODE_888_length_2512_cov_48.259428	1352	1432	12	1	80	0.0125000
NODE_888_length_2512_cov_48.259428	1352	1432	14	23	80	0.2875000
NODE_888_length_2512_cov_48.259428	1352	1432	16	9	80	0.1125000
NODE_888_length_2512_cov_48.259428	1352	1432	18	32	80	0.4000000
NODE_888_length_2512_cov_48.259428	1428	1512	6	1	84	0.0119048
NODE_888_length_2512_cov_48.259428	1428	1512	8	6	84	0.0714286
NODE_888_length_2512_cov_48.259428	1428	1512	10	1	84	0.0119048
NODE_888_length_2512_cov_48.259428	1428	1512	12	4	84	0.0476190
NODE_888_length_2512_cov_48.259428	1428	1512	13	6	84	0.0714286
NODE_888_length_2512_cov_48.259428	1428	1512	14	5	84	0.0595238
NODE_888_length_2512_cov_48.259428	1428	1512	15	1	84	0.0119048
NODE_888_length_2512_cov_48.259428	1428	1512	17	3	84	0.0357143
NODE_888_length_2512_cov_48.259428	1428	1512	18	2	84	0.0238095
NODE_888_length_2512_cov_48.259428	1428	1512	20	10	84	0.1190476
NODE_888_length_2512_cov_48.259428	1428	1512	22	2	84	0.0238095
NODE_888_length_2512_cov_48.259428	1428	1512	24	4	84	0.0476190
NODE_888_length_2512_cov_48.259428	1428	1512	26	1	84	0.0119048
NODE_888_length_2512_cov_48.259428	1428	1512	28	5	84	0.0595238
NODE_888_length_2512_cov_48.259428	1428	1512	32	1	84	0.0119048
NODE_888_length_2512_cov_48.259428	1428	1512	34	1	84	0.0119048
NODE_888_length_2512_cov_48.259428	1428	1512	36	7	84	0.0833333
NODE_888_length_2512_cov_48.259428	1428	1512	38	6	84	0.0714286
NODE_888_length_2512_cov_48.259428	1428	1512	40	1	84	0.0119048
NODE_888_length_2512_cov_48.259428	1428	1512	42	3	84	0.0357143
NODE_888_length_2512_cov_48.259428	1428	1512	44	14	84	0.1666667
NODE_888_length_2512_cov_48.259428	1485	1565	34	1	80	0.0125000
NODE_888_length_2512_cov_48.259428	1485	1565	36	9	80	0.1125000
NODE_888_length_2512_cov_48.259428	1485	1565	38	13	80	0.1625000
NODE_888_length_2512_cov_48.259428	1485	1565	40	1	80	0.0125000
NODE_888_length_2512_cov_48.259428	1485	1565	42	4	80	0.0500000
NODE_888_length_2512_cov_48.259428	1485	1565	44	19	80	0.2375000
NODE_888_length_2512_cov_48.259428	1485	1565	45	1	80	0.0125000
NODE_888_length_2512_cov_48.259428	1485	1565	46	1	80	0.0125000
NODE_888_length_2512_cov_48.259428	1485	1565	47	4	80	0.0500000
NODE_888_length_2512_cov_48.259428	1485	1565	49	4	80	0.0500000
NODE_888_length_2512_cov_48.259428	1485	1565	50	3	80	0.0375000
NODE_888_length_2512_cov_48.259428	1485	1565	52	1	80	0.0125000
NODE_888_length_2512_cov_48.259428	1485	1565	54	15	80	0.1875000
NODE_888_length_2512_cov_48.259428	1485	1565	56	4	80	0.0500000
NODE_891_length_2505_cov_102.009975	390	470	0	1	80	0.0125000
NODE_891_length_2505_cov_102.009975	390	470	2	21	80	0.2625000
NODE_891_length_2505_cov_102.009975	390	470	3	15	80	0.1875000
NODE_891_length_2505_cov_102.009975	390	470	4	12	80	0.1500000
NODE_891_length_2505_cov_102.009975	390	470	5	7	80	0.0875000
NODE_891_length_2505_cov_102.009975	390	470	6	2	80	0.0250000
NODE_891_length_2505_cov_102.009975	390	470	7	22	80	0.2750000
NODE_891_length_2505_cov_102.009975	443	510	0	41	67	0.6119403
NODE_891_length_2505_cov_102.009975	443	510	2	21	67	0.3134328
NODE_891_length_2505_cov_102.009975	443	510	3	5	67	0.0746269
NODE_894_length_2499_cov_2.655417	2325	2375	5	1	50	0.0200000
NODE_894_length_2499_cov_2.655417	2325	2375	7	2	50	0.0400000
NODE_894_length_2499_cov_2.655417	2325	2375	8	2	50	0.0400000
NODE_894_length_2499_cov_2.655417	2325	2375	10	6	50	0.1200000
NODE_894_length_2499_cov_2.655417	2325	2375	12	31	50	0.6200000
NODE_894_length_2499_cov_2.655417	2325	2375	14	8	50	0.1600000
NODE_895_length_2498_cov_9.614840	239	281	4	1	42	0.0238095
NODE_895_length_2498_cov_9.614840	239	281	8	41	42	0.9761904
NODE_895_length_2498_cov_9.614840	254	335	0	2	81	0.0246914
NODE_895_length_2498_cov_9.614840	254	335	2	43	81	0.5308642
NODE_895_length_2498_cov_9.614840	254	335	4	10	81	0.1234568
NODE_895_length_2498_cov_9.614840	254	335	8	26	81	0.3209876
NODE_895_length_2498_cov_9.614840	254	335	0	2	81	0.0246914
NODE_895_length_2498_cov_9.614840	254	335	2	43	81	0.5308642
NODE_895_length_2498_cov_9.614840	254	335	4	10	81	0.1234568
NODE_895_length_2498_cov_9.614840	254	335	8	26	81	0.3209876
NODE_895_length_2498_cov_9.614840	331	411	0	66	80	0.8250000
NODE_895_length_2498_cov_9.614840	331	411	2	14	80	0.1750000
NODE_895_length_2498_cov_9.614840	384	464	0	15	80	0.1875000
NODE_895_length_2498_cov_9.614840	384	464	2	65	80	0.8125000
NODE_898_length_2495_cov_5.151085	2395	2444	0	49	49	1.0000000
NODE_898_length_2495_cov_5.151085	2395	2444	0	49	49	1.0000000
NODE_898_length_2495_cov_5.151085	2396	2444	0	48	48	1.0000000
NODE_898_length_2495_cov_5.151085	2396	2444	0	48	48	1.0000000
NODE_898_length_2495_cov_5.151085	2396	2444	0	48	48	1.0000000
NODE_900_length_2492_cov_43.645215	408	488	2	80	80	1.0000000
NODE_903_length_2489_cov_15.105021	204	234	6	8	30	0.2666667
NODE_903_length_2489_cov_15.105021	204	234	8	20	30	0.6666667
NODE_903_length_2489_cov_15.105021	204	234	10	2	30	0.0666667
NODE_905_length_2488_cov_2.434910	2141	2200	17	1	59	0.0169492
NODE_905_length_2488_cov_2.434910	2141	2200	19	2	59	0.0338983
NODE_905_length_2488_cov_2.434910	2141	2200	21	23	59	0.3898305
NODE_905_length_2488_cov_2.434910	2141	2200	23	8	59	0.1355932
NODE_905_length_2488_cov_2.434910	2141	2200	27	16	59	0.2711864
NODE_905_length_2488_cov_2.434910	2141	2200	29	9	59	0.1525424
NODE_906_length_2484_cov_335.301887	224	279	348	1	55	0.0181818
NODE_906_length_2484_cov_335.301887	224	279	349	2	55	0.0363636
NODE_906_length_2484_cov_335.301887	224	279	351	2	55	0.0363636
NODE_906_length_2484_cov_335.301887	224	279	362	2	55	0.0363636
NODE_906_length_2484_cov_335.301887	224	279	364	2	55	0.0363636
NODE_906_length_2484_cov_335.301887	224	279	365	1	55	0.0181818
NODE_906_length_2484_cov_335.301887	224	279	368	1	55	0.0181818
NODE_906_length_2484_cov_335.301887	224	279	369	1	55	0.0181818
NODE_906_length_2484_cov_335.301887	224	279	370	2	55	0.0363636
NODE_906_length_2484_cov_335.301887	224	279	372	1	55	0.0181818
NODE_906_length_2484_cov_335.301887	224	279	373	3	55	0.0545455
NODE_906_length_2484_cov_335.301887	224	279	374	1	55	0.0181818
NODE_906_length_2484_cov_335.301887	224	279	376	2	55	0.0363636
NODE_906_length_2484_cov_335.301887	224	279	377	1	55	0.0181818
NODE_906_length_2484_cov_335.301887	224	279	378	3	55	0.0545455
NODE_906_length_2484_cov_335.301887	224	279	379	1	55	0.0181818
NODE_906_length_2484_cov_335.301887	224	279	380	2	55	0.0363636
NODE_906_length_2484_cov_335.301887	224	279	381	3	55	0.0545455
NODE_906_length_2484_cov_335.301887	224	279	382	1	55	0.0181818
NODE_906_length_2484_cov_335.301887	224	279	383	1	55	0.0181818
NODE_906_length_2484_cov_335.301887	224	279	384	1	55	0.0181818
NODE_906_length_2484_cov_335.301887	224	279	385	5	55	0.0909091
NODE_906_length_2484_cov_335.301887	224	279	386	1	55	0.0181818
NODE_906_length_2484_cov_335.301887	224	279	388	1	55	0.0181818
NODE_906_length_2484_cov_335.301887	224	279	389	1	55	0.0181818
NODE_906_length_2484_cov_335.301887	224	279	390	2	55	0.0363636
NODE_906_length_2484_cov_335.301887	224	279	393	1	55	0.0181818
NODE_906_length_2484_cov_335.301887	224	279	394	1	55	0.0181818
NODE_906_length_2484_cov_335.301887	224	279	396	1	55	0.0181818
NODE_906_length_2484_cov_335.301887	224	279	397	1	55	0.0181818
NODE_906_length_2484_cov_335.301887	224	279	398	2	55	0.0363636
NODE_906_length_2484_cov_335.301887	224	279	399	3	55	0.0545455
NODE_906_length_2484_cov_335.301887	224	279	403	1	55	0.0181818
NODE_906_length_2484_cov_335.301887	224	279	405	1	55	0.0181818
NODE_906_length_2484_cov_335.301887	252	332	328	1	80	0.0125000
NODE_906_length_2484_cov_335.301887	252	332	334	2	80	0.0250000
NODE_906_length_2484_cov_335.301887	252	332	340	1	80	0.0125000
NODE_906_length_2484_cov_335.301887	252	332	344	1	80	0.0125000
NODE_906_length_2484_cov_335.301887	252	332	348	1	80	0.0125000
NODE_906_length_2484_cov_335.301887	252	332	350	1	80	0.0125000
NODE_906_length_2484_cov_335.301887	252	332	356	1	80	0.0125000
NODE_906_length_2484_cov_335.301887	252	332	358	1	80	0.0125000
NODE_906_length_2484_cov_335.301887	252	332	365	1	80	0.0125000
NODE_906_length_2484_cov_335.301887	252	332	369	1	80	0.0125000
NODE_906_length_2484_cov_335.301887	252	332	371	1	80	0.0125000
NODE_906_length_2484_cov_335.301887	252	332	373	1	80	0.0125000
NODE_906_length_2484_cov_335.301887	252	332	374	1	80	0.0125000
NODE_906_length_2484_cov_335.301887	252	332	375	1	80	0.0125000
NODE_906_length_2484_cov_335.301887	252	332	376	4	80	0.0500000
NODE_906_length_2484_cov_335.301887	252	332	378	2	80	0.0250000
NODE_906_length_2484_cov_335.301887	252	332	380	1	80	0.0125000
NODE_906_length_2484_cov_335.301887	252	332	381	4	80	0.0500000
NODE_906_length_2484_cov_335.301887	252	332	382	2	80	0.0250000
NODE_906_length_2484_cov_335.301887	252	332	383	1	80	0.0125000
NODE_906_length_2484_cov_335.301887	252	332	384	3	80	0.0375000
NODE_906_length_2484_cov_335.301887	252	332	385	5	80	0.0625000
NODE_906_length_2484_cov_335.301887	252	332	388	2	80	0.0250000
NODE_906_length_2484_cov_335.301887	252	332	389	1	80	0.0125000
NODE_906_length_2484_cov_335.301887	252	332	390	2	80	0.0250000
NODE_906_length_2484_cov_335.301887	252	332	391	1	80	0.0125000
NODE_906_length_2484_cov_335.301887	252	332	392	1	80	0.0125000
NODE_906_length_2484_cov_335.301887	252	332	393	2	80	0.0250000
NODE_906_length_2484_cov_335.301887	252	332	394	1	80	0.0125000
NODE_906_length_2484_cov_335.301887	252	332	395	3	80	0.0375000
NODE_906_length_2484_cov_335.301887	252	332	396	3	80	0.0375000
NODE_906_length_2484_cov_335.301887	252	332	397	5	80	0.0625000
NODE_906_length_2484_cov_335.301887	252	332	398	3	80	0.0375000
NODE_906_length_2484_cov_335.301887	252	332	399	5	80	0.0625000
NODE_906_length_2484_cov_335.301887	252	332	401	1	80	0.0125000
NODE_906_length_2484_cov_335.301887	252	332	402	3	80	0.0375000
NODE_906_length_2484_cov_335.301887	252	332	403	3	80	0.0375000
NODE_906_length_2484_cov_335.301887	252	332	404	3	80	0.0375000
NODE_906_length_2484_cov_335.301887	252	332	405	3	80	0.0375000
NODE_906_length_2484_cov_335.301887	252	332	409	1	80	0.0125000
NODE_912_length_2479_cov_90.381092	369	449	0	13	80	0.1625000
NODE_912_length_2479_cov_90.381092	369	449	2	67	80	0.8375000
NODE_912_length_2479_cov_90.381092	422	499	0	51	77	0.6623377
NODE_912_length_2479_cov_90.381092	422	499	2	26	77	0.3376623
NODE_912_length_2479_cov_90.381092	1610	1685	26	1	75	0.0133333
NODE_912_length_2479_cov_90.381092	1610	1685	34	1	75	0.0133333
NODE_912_length_2479_cov_90.381092	1610	1685	38	1	75	0.0133333
NODE_912_length_2479_cov_90.381092	1610	1685	40	3	75	0.0400000
NODE_912_length_2479_cov_90.381092	1610	1685	48	3	75	0.0400000
NODE_912_length_2479_cov_90.381092	1610	1685	50	1	75	0.0133333
NODE_912_length_2479_cov_90.381092	1610	1685	52	1	75	0.0133333
NODE_912_length_2479_cov_90.381092	1610	1685	56	1	75	0.0133333
NODE_912_length_2479_cov_90.381092	1610	1685	62	4	75	0.0533333
NODE_912_length_2479_cov_90.381092	1610	1685	66	1	75	0.0133333
NODE_912_length_2479_cov_90.381092	1610	1685	77	1	75	0.0133333
NODE_912_length_2479_cov_90.381092	1610	1685	81	1	75	0.0133333
NODE_912_length_2479_cov_90.381092	1610	1685	83	1	75	0.0133333
NODE_912_length_2479_cov_90.381092	1610	1685	84	1	75	0.0133333
NODE_912_length_2479_cov_90.381092	1610	1685	86	1	75	0.0133333
NODE_912_length_2479_cov_90.381092	1610	1685	88	1	75	0.0133333
NODE_912_length_2479_cov_90.381092	1610	1685	96	6	75	0.0800000
NODE_912_length_2479_cov_90.381092	1610	1685	100	3	75	0.0400000
NODE_912_length_2479_cov_90.381092	1610	1685	102	2	75	0.0266667
NODE_912_length_2479_cov_90.381092	1610	1685	104	1	75	0.0133333
NODE_912_length_2479_cov_90.381092	1610	1685	106	1	75	0.0133333
NODE_912_length_2479_cov_90.381092	1610	1685	108	1	75	0.0133333
NODE_912_length_2479_cov_90.381092	1610	1685	110	2	75	0.0266667
NODE_912_length_2479_cov_90.381092	1610	1685	118	1	75	0.0133333
NODE_912_length_2479_cov_90.381092	1610	1685	120	1	75	0.0133333
NODE_912_length_2479_cov_90.381092	1610	1685	124	1	75	0.0133333
NODE_912_length_2479_cov_90.381092	1610	1685	134	2	75	0.0266667
NODE_912_length_2479_cov_90.381092	1610	1685	140	2	75	0.0266667
NODE_912_length_2479_cov_90.381092	1610	1685	146	1	75	0.0133333
NODE_912_length_2479_cov_90.381092	1610	1685	150	3	75	0.0400000
NODE_912_length_2479_cov_90.381092	1610	1685	154	1	75	0.0133333
NODE_912_length_2479_cov_90.381092	1610	1685	164	1	75	0.0133333
NODE_912_length_2479_cov_90.381092	1610	1685	166	1	75	0.0133333
NODE_912_length_2479_cov_90.381092	1610	1685	170	1	75	0.0133333
NODE_912_length_2479_cov_90.381092	1610	1685	174	1	75	0.0133333
NODE_912_length_2479_cov_90.381092	1610	1685	176	1	75	0.0133333
NODE_912_length_2479_cov_90.381092	1610	1685	188	1	75	0.0133333
NODE_912_length_2479_cov_90.381092	1610	1685	196	2	75	0.0266667
NODE_912_length_2479_cov_90.381092	1610	1685	200	4	75	0.0533333
NODE_912_length_2479_cov_90.381092	1610	1685	202	1	75	0.0133333
NODE_912_length_2479_cov_90.381092	1610	1685	204	2	75	0.0266667
NODE_912_length_2479_cov_90.381092	1610	1685	206	3	75	0.0400000
NODE_912_length_2479_cov_90.381092	1610	1685	208	1	75	0.0133333
NODE_912_length_2479_cov_90.381092	1610	1685	210	3	75	0.0400000
NODE_912_length_2479_cov_90.381092	1610	1685	216	1	75	0.0133333
NODE_912_length_2479_cov_90.381092	1610	1685	218	1	75	0.0133333
NODE_912_length_2479_cov_90.381092	1658	1730	150	2	72	0.0277778
NODE_912_length_2479_cov_90.381092	1658	1730	154	1	72	0.0138889
NODE_912_length_2479_cov_90.381092	1658	1730	164	1	72	0.0138889
NODE_912_length_2479_cov_90.381092	1658	1730	166	1	72	0.0138889
NODE_912_length_2479_cov_90.381092	1658	1730	170	1	72	0.0138889
NODE_912_length_2479_cov_90.381092	1658	1730	174	1	72	0.0138889
NODE_912_length_2479_cov_90.381092	1658	1730	176	1	72	0.0138889
NODE_912_length_2479_cov_90.381092	1658	1730	188	1	72	0.0138889
NODE_912_length_2479_cov_90.381092	1658	1730	196	2	72	0.0277778
NODE_912_length_2479_cov_90.381092	1658	1730	200	4	72	0.0555556
NODE_912_length_2479_cov_90.381092	1658	1730	202	1	72	0.0138889
NODE_912_length_2479_cov_90.381092	1658	1730	204	2	72	0.0277778
NODE_912_length_2479_cov_90.381092	1658	1730	206	3	72	0.0416667
NODE_912_length_2479_cov_90.381092	1658	1730	208	1	72	0.0138889
NODE_912_length_2479_cov_90.381092	1658	1730	210	4	72	0.0555556
NODE_912_length_2479_cov_90.381092	1658	1730	212	3	72	0.0416667
NODE_912_length_2479_cov_90.381092	1658	1730	213	1	72	0.0138889
NODE_912_length_2479_cov_90.381092	1658	1730	214	2	72	0.0277778
NODE_912_length_2479_cov_90.381092	1658	1730	216	5	72	0.0694444
NODE_912_length_2479_cov_90.381092	1658	1730	217	1	72	0.0138889
NODE_912_length_2479_cov_90.381092	1658	1730	218	13	72	0.1805556
NODE_912_length_2479_cov_90.381092	1658	1730	219	5	72	0.0694444
NODE_912_length_2479_cov_90.381092	1658	1730	220	8	72	0.1111111
NODE_912_length_2479_cov_90.381092	1658	1730	221	5	72	0.0694444
NODE_912_length_2479_cov_90.381092	1658	1730	222	2	72	0.0277778
NODE_912_length_2479_cov_90.381092	1658	1730	223	1	72	0.0138889
NODE_913_length_2479_cov_3.433193	2379	2426	0	47	47	1.0000000
NODE_913_length_2479_cov_3.433193	2399	2479	0	80	80	1.0000000
NODE_915_length_2474_cov_7.237895	399	479	0	80	80	1.0000000
NODE_915_length_2474_cov_7.237895	452	532	0	80	80	1.0000000
NODE_922_length_2465_cov_3.098056	2133	2213	0	80	80	1.0000000
NODE_922_length_2465_cov_3.098056	2191	2253	0	62	62	1.0000000
NODE_923_length_2464_cov_24.562791	331	409	0	78	78	1.0000000
NODE_923_length_2464_cov_24.562791	382	462	0	29	80	0.3625000
NODE_923_length_2464_cov_24.562791	382	462	2	51	80	0.6375000
NODE_924_length_2461_cov_2.696444	292	372	0	75	80	0.9375000
NODE_924_length_2461_cov_2.696444	292	372	2	5	80	0.0625000
NODE_924_length_2461_cov_2.696444	345	425	0	80	80	1.0000000
NODE_938_length_2447_cov_16.079216	2344	2424	20	1	80	0.0125000
NODE_938_length_2447_cov_16.079216	2344	2424	22	5	80	0.0625000
NODE_938_length_2447_cov_16.079216	2344	2424	26	2	80	0.0250000
NODE_938_length_2447_cov_16.079216	2344	2424	28	21	80	0.2625000
NODE_938_length_2447_cov_16.079216	2344	2424	30	1	80	0.0125000
NODE_938_length_2447_cov_16.079216	2344	2424	34	6	80	0.0750000
NODE_938_length_2447_cov_16.079216	2344	2424	36	5	80	0.0625000
NODE_938_length_2447_cov_16.079216	2344	2424	40	2	80	0.0250000
NODE_938_length_2447_cov_16.079216	2344	2424	44	1	80	0.0125000
NODE_938_length_2447_cov_16.079216	2344	2424	46	3	80	0.0375000
NODE_938_length_2447_cov_16.079216	2344	2424	50	11	80	0.1375000
NODE_938_length_2447_cov_16.079216	2344	2424	52	1	80	0.0125000
NODE_938_length_2447_cov_16.079216	2344	2424	54	2	80	0.0250000
NODE_938_length_2447_cov_16.079216	2344	2424	56	4	80	0.0500000
NODE_938_length_2447_cov_16.079216	2344	2424	62	3	80	0.0375000
NODE_938_length_2447_cov_16.079216	2344	2424	64	1	80	0.0125000
NODE_938_length_2447_cov_16.079216	2344	2424	66	4	80	0.0500000
NODE_938_length_2447_cov_16.079216	2344	2424	70	3	80	0.0375000
NODE_938_length_2447_cov_16.079216	2344	2424	72	4	80	0.0500000
NODE_938_length_2447_cov_16.079216	2397	2447	6	3	50	0.0600000
NODE_938_length_2447_cov_16.079216	2397	2447	10	1	50	0.0200000
NODE_938_length_2447_cov_16.079216	2397	2447	14	3	50	0.0600000
NODE_938_length_2447_cov_16.079216	2397	2447	18	6	50	0.1200000
NODE_938_length_2447_cov_16.079216	2397	2447	20	11	50	0.2200000
NODE_938_length_2447_cov_16.079216	2397	2447	22	5	50	0.1000000
NODE_938_length_2447_cov_16.079216	2397	2447	26	2	50	0.0400000
NODE_938_length_2447_cov_16.079216	2397	2447	28	19	50	0.3800000
NODE_940_length_2446_cov_2.341287	1521	1578	2	2	57	0.0350877
NODE_940_length_2446_cov_2.341287	1521	1578	4	55	57	0.9649123
NODE_940_length_2446_cov_2.341287	1551	1593	2	17	42	0.4047619
NODE_940_length_2446_cov_2.341287	1551	1593	4	25	42	0.5952381
NODE_949_length_2437_cov_13.341745	418	498	0	30	80	0.3750000
NODE_949_length_2437_cov_13.341745	418	498	2	21	80	0.2625000
NODE_949_length_2437_cov_13.341745	418	498	4	29	80	0.3625000
NODE_949_length_2437_cov_13.341745	471	551	0	50	80	0.6250000
NODE_949_length_2437_cov_13.341745	471	551	1	26	80	0.3250000
NODE_949_length_2437_cov_13.341745	471	551	3	4	80	0.0500000
NODE_951_length_2432_cov_70.360909	1875	1955	0	1	80	0.0125000
NODE_951_length_2432_cov_70.360909	1875	1955	2	1	80	0.0125000
NODE_951_length_2432_cov_70.360909	1875	1955	6	78	80	0.9750000
NODE_951_length_2432_cov_70.360909	1928	2008	0	20	80	0.2500000
NODE_951_length_2432_cov_70.360909	1928	2008	3	1	80	0.0125000
NODE_951_length_2432_cov_70.360909	1928	2008	4	21	80	0.2625000
NODE_951_length_2432_cov_70.360909	1928	2008	6	38	80	0.4750000
NODE_955_length_2430_cov_19.835264	0	68	4	2	68	0.0294118
NODE_955_length_2430_cov_19.835264	0	68	6	1	68	0.0147059
NODE_955_length_2430_cov_19.835264	0	68	10	2	68	0.0294118
NODE_955_length_2430_cov_19.835264	0	68	12	5	68	0.0735294
NODE_955_length_2430_cov_19.835264	0	68	18	3	68	0.0441176
NODE_955_length_2430_cov_19.835264	0	68	20	4	68	0.0588235
NODE_955_length_2430_cov_19.835264	0	68	24	2	68	0.0294118
NODE_955_length_2430_cov_19.835264	0	68	26	3	68	0.0441176
NODE_955_length_2430_cov_19.835264	0	68	28	1	68	0.0147059
NODE_955_length_2430_cov_19.835264	0	68	30	1	68	0.0147059
NODE_955_length_2430_cov_19.835264	0	68	34	1	68	0.0147059
NODE_955_length_2430_cov_19.835264	0	68	36	1	68	0.0147059
NODE_955_length_2430_cov_19.835264	0	68	38	1	68	0.0147059
NODE_955_length_2430_cov_19.835264	0	68	40	3	68	0.0441176
NODE_955_length_2430_cov_19.835264	0	68	42	7	68	0.1029412
NODE_955_length_2430_cov_19.835264	0	68	44	2	68	0.0294118
NODE_955_length_2430_cov_19.835264	0	68	46	2	68	0.0294118
NODE_955_length_2430_cov_19.835264	0	68	48	1	68	0.0147059
NODE_955_length_2430_cov_19.835264	0	68	50	2	68	0.0294118
NODE_955_length_2430_cov_19.835264	0	68	54	1	68	0.0147059
NODE_955_length_2430_cov_19.835264	0	68	58	10	68	0.1470588
NODE_955_length_2430_cov_19.835264	0	68	60	1	68	0.0147059
NODE_955_length_2430_cov_19.835264	0	68	62	1	68	0.0147059
NODE_955_length_2430_cov_19.835264	0	68	64	1	68	0.0147059
NODE_955_length_2430_cov_19.835264	0	68	66	1	68	0.0147059
NODE_955_length_2430_cov_19.835264	0	68	70	2	68	0.0294118
NODE_955_length_2430_cov_19.835264	0	68	72	3	68	0.0441176
NODE_955_length_2430_cov_19.835264	0	68	75	1	68	0.0147059
NODE_955_length_2430_cov_19.835264	0	68	77	3	68	0.0441176
NODE_955_length_2430_cov_19.835264	0	24	4	2	24	0.0833333
NODE_955_length_2430_cov_19.835264	0	24	6	1	24	0.0416667
NODE_955_length_2430_cov_19.835264	0	24	10	2	24	0.0833333
NODE_955_length_2430_cov_19.835264	0	24	12	5	24	0.2083333
NODE_955_length_2430_cov_19.835264	0	24	18	3	24	0.1250000
NODE_955_length_2430_cov_19.835264	0	24	20	4	24	0.1666667
NODE_955_length_2430_cov_19.835264	0	24	24	2	24	0.0833333
NODE_955_length_2430_cov_19.835264	0	24	26	3	24	0.1250000
NODE_955_length_2430_cov_19.835264	0	24	28	1	24	0.0416667
NODE_955_length_2430_cov_19.835264	0	24	30	1	24	0.0416667
NODE_956_length_2428_cov_179.842422	538	618	2	20	80	0.2500000
NODE_956_length_2428_cov_179.842422	538	618	4	1	80	0.0125000
NODE_956_length_2428_cov_179.842422	538	618	6	59	80	0.7375000
NODE_956_length_2428_cov_179.842422	591	671	0	24	80	0.3000000
NODE_956_length_2428_cov_179.842422	591	671	2	49	80	0.6125000
NODE_956_length_2428_cov_179.842422	591	671	6	7	80	0.0875000
NODE_956_length_2428_cov_179.842422	667	747	0	23	80	0.2875000
NODE_956_length_2428_cov_179.842422	667	747	4	57	80	0.7125000
NODE_956_length_2428_cov_179.842422	720	800	0	42	80	0.5250000
NODE_956_length_2428_cov_179.842422	720	800	4	38	80	0.4750000
NODE_956_length_2428_cov_179.842422	1308	1388	0	2	80	0.0250000
NODE_956_length_2428_cov_179.842422	1308	1388	2	78	80	0.9750000
NODE_956_length_2428_cov_179.842422	1361	1441	0	38	80	0.4750000
NODE_956_length_2428_cov_179.842422	1361	1441	2	25	80	0.3125000
NODE_956_length_2428_cov_179.842422	1361	1441	6	17	80	0.2125000
NODE_956_length_2428_cov_179.842422	1437	1517	6	80	80	1.0000000
NODE_956_length_2428_cov_179.842422	1490	1570	0	19	80	0.2375000
NODE_956_length_2428_cov_179.842422	1490	1570	6	61	80	0.7625000
NODE_956_length_2428_cov_179.842422	1986	2026	364	2	40	0.0500000
NODE_956_length_2428_cov_179.842422	1986	2026	367	1	40	0.0250000
NODE_956_length_2428_cov_179.842422	1986	2026	370	1	40	0.0250000
NODE_956_length_2428_cov_179.842422	1986	2026	374	2	40	0.0500000
NODE_956_length_2428_cov_179.842422	1986	2026	375	1	40	0.0250000
NODE_956_length_2428_cov_179.842422	1986	2026	376	1	40	0.0250000
NODE_956_length_2428_cov_179.842422	1986	2026	377	2	40	0.0500000
NODE_956_length_2428_cov_179.842422	1986	2026	378	2	40	0.0500000
NODE_956_length_2428_cov_179.842422	1986	2026	379	5	40	0.1250000
NODE_956_length_2428_cov_179.842422	1986	2026	380	3	40	0.0750000
NODE_956_length_2428_cov_179.842422	1986	2026	381	4	40	0.1000000
NODE_956_length_2428_cov_179.842422	1986	2026	384	1	40	0.0250000
NODE_956_length_2428_cov_179.842422	1986	2026	385	1	40	0.0250000
NODE_956_length_2428_cov_179.842422	1986	2026	387	1	40	0.0250000
NODE_956_length_2428_cov_179.842422	1986	2026	390	1	40	0.0250000
NODE_956_length_2428_cov_179.842422	1986	2026	391	1	40	0.0250000
NODE_956_length_2428_cov_179.842422	1986	2026	392	1	40	0.0250000
NODE_956_length_2428_cov_179.842422	1986	2026	394	2	40	0.0500000
NODE_956_length_2428_cov_179.842422	1986	2026	397	2	40	0.0500000
NODE_956_length_2428_cov_179.842422	1986	2026	399	2	40	0.0500000
NODE_956_length_2428_cov_179.842422	1986	2026	400	1	40	0.0250000
NODE_956_length_2428_cov_179.842422	1986	2026	401	3	40	0.0750000
NODE_959_length_2422_cov_6.665088	197	255	0	9	58	0.1551724
NODE_959_length_2422_cov_6.665088	197	255	2	49	58	0.8448276
NODE_963_length_2414_cov_32.871706	411	491	0	46	80	0.5750000
NODE_963_length_2414_cov_32.871706	411	491	2	34	80	0.4250000
NODE_963_length_2414_cov_32.871706	464	544	2	80	80	1.0000000
NODE_964_length_2414_cov_2.105832	2349	2390	0	41	41	1.0000000
NODE_968_length_2410_cov_9.107313	1874	1954	0	28	80	0.3500000
NODE_968_length_2410_cov_9.107313	1874	1954	2	52	80	0.6500000
NODE_968_length_2410_cov_9.107313	1927	2007	0	16	80	0.2000000
NODE_968_length_2410_cov_9.107313	1927	2007	2	64	80	0.8000000
NODE_977_length_2390_cov_20.371454	1753	1833	0	80	80	1.0000000
NODE_977_length_2390_cov_20.371454	1806	1886	0	80	80	1.0000000
NODE_979_length_2389_cov_17.904803	1601	1681	4	2	80	0.0250000
NODE_979_length_2389_cov_17.904803	1601	1681	10	3	80	0.0375000
NODE_979_length_2389_cov_17.904803	1601	1681	12	24	80	0.3000000
NODE_979_length_2389_cov_17.904803	1601	1681	15	1	80	0.0125000
NODE_979_length_2389_cov_17.904803	1601	1681	16	50	80	0.6250000
NODE_979_length_2389_cov_17.904803	1654	1734	0	8	80	0.1000000
NODE_979_length_2389_cov_17.904803	1654	1734	4	28	80	0.3500000
NODE_979_length_2389_cov_17.904803	1654	1734	6	5	80	0.0625000
NODE_979_length_2389_cov_17.904803	1654	1734	8	10	80	0.1250000
NODE_979_length_2389_cov_17.904803	1654	1734	12	22	80	0.2750000
NODE_979_length_2389_cov_17.904803	1654	1734	16	7	80	0.0875000
NODE_979_length_2389_cov_17.904803	1730	1810	0	80	80	1.0000000
NODE_979_length_2389_cov_17.904803	1783	1863	0	80	80	1.0000000
NODE_988_length_2381_cov_32.280894	398	478	0	80	80	1.0000000
NODE_988_length_2381_cov_32.280894	451	531	0	80	80	1.0000000
NODE_988_length_2381_cov_32.280894	527	607	0	80	80	1.0000000
NODE_988_length_2381_cov_32.280894	580	660	0	80	80	1.0000000
NODE_988_length_2381_cov_32.280894	2288	2368	0	1	80	0.0125000
NODE_988_length_2381_cov_32.280894	2288	2368	2	79	80	0.9875000
NODE_997_length_2369_cov_4.896916	241	321	0	80	80	1.0000000
NODE_997_length_2369_cov_4.896916	294	374	0	80	80	1.0000000
NODE_1002_length_2364_cov_2.482561	0	79	0	79	79	1.0000000
NODE_1004_length_2360_cov_8.620080	587	651	9	19	64	0.2968750
NODE_1004_length_2360_cov_8.620080	587	651	11	10	64	0.1562500
NODE_1004_length_2360_cov_8.620080	587	651	12	35	64	0.5468750
NODE_1004_length_2360_cov_8.620080	587	651	9	19	64	0.2968750
NODE_1004_length_2360_cov_8.620080	587	651	11	10	64	0.1562500
NODE_1004_length_2360_cov_8.620080	587	651	12	35	64	0.5468750
NODE_1004_length_2360_cov_8.620080	624	684	0	5	60	0.0833333
NODE_1004_length_2360_cov_8.620080	624	684	2	14	60	0.2333333
NODE_1004_length_2360_cov_8.620080	624	684	4	1	60	0.0166667
NODE_1004_length_2360_cov_8.620080	624	684	8	11	60	0.1833333
NODE_1004_length_2360_cov_8.620080	624	684	9	21	60	0.3500000
NODE_1004_length_2360_cov_8.620080	624	684	11	8	60	0.1333333
NODE_1004_length_2360_cov_8.620080	1827	1907	0	80	80	1.0000000
NODE_1004_length_2360_cov_8.620080	1880	1960	0	80	80	1.0000000
NODE_1005_length_2359_cov_22.317257	958	1038	0	16	80	0.2000000
NODE_1005_length_2359_cov_22.317257	958	1038	2	64	80	0.8000000
NODE_1005_length_2359_cov_22.317257	1011	1091	1	2	80	0.0250000
NODE_1005_length_2359_cov_22.317257	1011	1091	2	75	80	0.9375000
NODE_1005_length_2359_cov_22.317257	1011	1091	3	3	80	0.0375000
NODE_1008_length_2357_cov_25.711249	716	796	0	47	80	0.5875000
NODE_1008_length_2357_cov_25.711249	716	796	2	15	80	0.1875000
NODE_1008_length_2357_cov_25.711249	716	796	4	12	80	0.1500000
NODE_1008_length_2357_cov_25.711249	716	796	6	6	80	0.0750000
NODE_1008_length_2357_cov_25.711249	769	849	2	9	80	0.1125000
NODE_1008_length_2357_cov_25.711249	769	849	4	12	80	0.1500000
NODE_1008_length_2357_cov_25.711249	769	849	6	30	80	0.3750000
NODE_1008_length_2357_cov_25.711249	769	849	8	29	80	0.3625000
NODE_1015_length_2345_cov_5.386465	1845	1925	0	80	80	1.0000000
NODE_1015_length_2345_cov_5.386465	1898	1978	0	80	80	1.0000000
NODE_1016_length_2344_cov_6.236526	1208	1269	4	6	61	0.0983607
NODE_1016_length_2344_cov_6.236526	1208	1269	10	12	61	0.1967213
NODE_1016_length_2344_cov_6.236526	1208	1269	12	23	61	0.3770492
NODE_1016_length_2344_cov_6.236526	1208	1269	14	20	61	0.3278688
NODE_1016_length_2344_cov_6.236526	1208	1269	4	6	61	0.0983607
NODE_1016_length_2344_cov_6.236526	1208	1269	10	12	61	0.1967213
NODE_1016_length_2344_cov_6.236526	1208	1269	12	23	61	0.3770492
NODE_1016_length_2344_cov_6.236526	1208	1269	14	20	61	0.3278688
NODE_1016_length_2344_cov_6.236526	1208	1269	4	6	61	0.0983607
NODE_1016_length_2344_cov_6.236526	1208	1269	10	12	61	0.1967213
NODE_1016_length_2344_cov_6.236526	1208	1269	12	23	61	0.3770492
NODE_1016_length_2344_cov_6.236526	1208	1269	14	20	61	0.3278688
NODE_1016_length_2344_cov_6.236526	1208	1267	4	4	59	0.0677966
NODE_1016_length_2344_cov_6.236526	1208	1267	10	12	59	0.2033898
NODE_1016_length_2344_cov_6.236526	1208	1267	12	23	59	0.3898305
NODE_1016_length_2344_cov_6.236526	1208	1267	14	20	59	0.3389831
NODE_1023_length_2332_cov_4.725929	34	101	4	65	67	0.9701493
NODE_1023_length_2332_cov_4.725929	34	101	8	2	67	0.0298507
NODE_1027_length_2327_cov_18.210952	2213	2293	4	50	80	0.6250000
NODE_1027_length_2327_cov_18.210952	2213	2293	6	12	80	0.1500000
NODE_1027_length_2327_cov_18.210952	2213	2293	8	18	80	0.2250000
NODE_1027_length_2327_cov_18.210952	2266	2327	4	20	61	0.3278688
NODE_1027_length_2327_cov_18.210952	2266	2327	6	26	61	0.4262295
NODE_1027_length_2327_cov_18.210952	2266	2327	8	15	61	0.2459016
NODE_1028_length_2326_cov_15.583745	1709	1789	0	24	80	0.3000000
NODE_1028_length_2326_cov_15.583745	1709	1789	2	34	80	0.4250000
NODE_1028_length_2326_cov_15.583745	1709	1789	4	22	80	0.2750000
NODE_1028_length_2326_cov_15.583745	1762	1842	2	43	80	0.5375000
NODE_1028_length_2326_cov_15.583745	1762	1842	4	37	80	0.4625000
NODE_1030_length_2325_cov_14.998652	553	633	0	80	80	1.0000000
NODE_1030_length_2325_cov_14.998652	606	686	0	80	80	1.0000000
NODE_1034_length_2317_cov_11.956718	920	1000	2	67	80	0.8375000
NODE_1034_length_2317_cov_11.956718	920	1000	4	1	80	0.0125000
NODE_1034_length_2317_cov_11.956718	920	1000	5	12	80	0.1500000
NODE_1034_length_2317_cov_11.956718	973	1053	0	38	80	0.4750000
NODE_1034_length_2317_cov_11.956718	973	1053	2	42	80	0.5250000
NODE_1034_length_2317_cov_11.956718	1049	1129	0	42	80	0.5250000
NODE_1034_length_2317_cov_11.956718	1049	1129	2	36	80	0.4500000
NODE_1034_length_2317_cov_11.956718	1049	1129	6	2	80	0.0250000
NODE_1034_length_2317_cov_11.956718	1102	1184	2	25	82	0.3048781
NODE_1034_length_2317_cov_11.956718	1102	1184	4	7	82	0.0853659
NODE_1034_length_2317_cov_11.956718	1102	1184	6	50	82	0.6097561
NODE_1037_length_2316_cov_8.556608	168	247	24	2	79	0.0253165
NODE_1037_length_2316_cov_8.556608	168	247	26	7	79	0.0886076
NODE_1037_length_2316_cov_8.556608	168	247	28	1	79	0.0126582
NODE_1037_length_2316_cov_8.556608	168	247	30	1	79	0.0126582
NODE_1037_length_2316_cov_8.556608	168	247	35	2	79	0.0253165
NODE_1037_length_2316_cov_8.556608	168	247	36	6	79	0.0759494
NODE_1037_length_2316_cov_8.556608	168	247	38	2	79	0.0253165
NODE_1037_length_2316_cov_8.556608	168	247	39	1	79	0.0126582
NODE_1037_length_2316_cov_8.556608	168	247	42	1	79	0.0126582
NODE_1037_length_2316_cov_8.556608	168	247	46	3	79	0.0379747
NODE_1037_length_2316_cov_8.556608	168	247	52	2	79	0.0253165
NODE_1037_length_2316_cov_8.556608	168	247	54	6	79	0.0759494
NODE_1037_length_2316_cov_8.556608	168	247	56	41	79	0.5189874
NODE_1037_length_2316_cov_8.556608	168	247	58	1	79	0.0126582
NODE_1037_length_2316_cov_8.556608	168	247	60	3	79	0.0379747
NODE_1037_length_2316_cov_8.556608	1117	1198	16	3	81	0.0370370
NODE_1037_length_2316_cov_8.556608	1117	1198	18	22	81	0.2716049
NODE_1037_length_2316_cov_8.556608	1117	1198	20	18	81	0.2222222
NODE_1037_length_2316_cov_8.556608	1117	1198	22	11	81	0.1358025
NODE_1037_length_2316_cov_8.556608	1117	1198	24	13	81	0.1604938
NODE_1037_length_2316_cov_8.556608	1117	1198	26	6	81	0.0740741
NODE_1037_length_2316_cov_8.556608	1117	1198	28	8	81	0.0987654
NODE_1037_length_2316_cov_8.556608	1369	1412	57	4	43	0.0930233
NODE_1037_length_2316_cov_8.556608	1369	1412	59	5	43	0.1162791
NODE_1037_length_2316_cov_8.556608	1369	1412	61	1	43	0.0232558
NODE_1037_length_2316_cov_8.556608	1369	1412	65	1	43	0.0232558
NODE_1037_length_2316_cov_8.556608	1369	1412	67	2	43	0.0465116
NODE_1037_length_2316_cov_8.556608	1369	1412	69	4	43	0.0930233
NODE_1037_length_2316_cov_8.556608	1369	1412	71	10	43	0.2325581
NODE_1037_length_2316_cov_8.556608	1369	1412	75	3	43	0.0697674
NODE_1037_length_2316_cov_8.556608	1369	1412	77	4	43	0.0930233
NODE_1037_length_2316_cov_8.556608	1369	1412	78	2	43	0.0465116
NODE_1037_length_2316_cov_8.556608	1369	1412	80	3	43	0.0697674
NODE_1037_length_2316_cov_8.556608	1369	1412	81	1	43	0.0232558
NODE_1037_length_2316_cov_8.556608	1369	1412	82	3	43	0.0697674
NODE_1040_length_2311_cov_2.821881	2121	2201	0	80	80	1.0000000
NODE_1040_length_2311_cov_2.821881	2174	2225	0	51	51	1.0000000
NODE_1044_length_2306_cov_17.347984	995	1075	0	5	80	0.0625000
NODE_1044_length_2306_cov_17.347984	995	1075	2	19	80	0.2375000
NODE_1044_length_2306_cov_17.347984	995	1075	4	56	80	0.7000000
NODE_1044_length_2306_cov_17.347984	1048	1128	2	24	80	0.3000000
NODE_1044_length_2306_cov_17.347984	1048	1128	4	56	80	0.7000000
NODE_1052_length_2300_cov_9.803271	934	1014	0	80	80	1.0000000
NODE_1052_length_2300_cov_9.803271	1892	1965	0	73	73	1.0000000
NODE_1059_length_2289_cov_17.807306	968	1026	70	2	58	0.0344828
NODE_1059_length_2289_cov_17.807306	968	1026	72	5	58	0.0862069
NODE_1059_length_2289_cov_17.807306	968	1026	74	3	58	0.0517241
NODE_1059_length_2289_cov_17.807306	968	1026	76	15	58	0.2586207
NODE_1059_length_2289_cov_17.807306	968	1026	77	2	58	0.0344828
NODE_1059_length_2289_cov_17.807306	968	1026	78	15	58	0.2586207
NODE_1059_length_2289_cov_17.807306	968	1026	80	13	58	0.2241379
NODE_1059_length_2289_cov_17.807306	968	1026	82	3	58	0.0517241
NODE_1059_length_2289_cov_17.807306	1021	1079	29	1	58	0.0172414
NODE_1059_length_2289_cov_17.807306	1021	1079	31	1	58	0.0172414
NODE_1059_length_2289_cov_17.807306	1021	1079	33	1	58	0.0172414
NODE_1059_length_2289_cov_17.807306	1021	1079	35	1	58	0.0172414
NODE_1059_length_2289_cov_17.807306	1021	1079	38	2	58	0.0344828
NODE_1059_length_2289_cov_17.807306	1021	1079	40	1	58	0.0172414
NODE_1059_length_2289_cov_17.807306	1021	1079	42	4	58	0.0689655
NODE_1059_length_2289_cov_17.807306	1021	1079	43	2	58	0.0344828
NODE_1059_length_2289_cov_17.807306	1021	1079	44	2	58	0.0344828
NODE_1059_length_2289_cov_17.807306	1021	1079	48	2	58	0.0344828
NODE_1059_length_2289_cov_17.807306	1021	1079	49	2	58	0.0344828
NODE_1059_length_2289_cov_17.807306	1021	1079	53	2	58	0.0344828
NODE_1059_length_2289_cov_17.807306	1021	1079	55	3	58	0.0517241
NODE_1059_length_2289_cov_17.807306	1021	1079	56	1	58	0.0172414
NODE_1059_length_2289_cov_17.807306	1021	1079	58	4	58	0.0689655
NODE_1059_length_2289_cov_17.807306	1021	1079	60	3	58	0.0517241
NODE_1059_length_2289_cov_17.807306	1021	1079	64	3	58	0.0517241
NODE_1059_length_2289_cov_17.807306	1021	1079	72	1	58	0.0172414
NODE_1059_length_2289_cov_17.807306	1021	1079	74	3	58	0.0517241
NODE_1059_length_2289_cov_17.807306	1021	1079	75	2	58	0.0344828
NODE_1059_length_2289_cov_17.807306	1021	1079	76	5	58	0.0862069
NODE_1059_length_2289_cov_17.807306	1021	1079	77	5	58	0.0862069
NODE_1059_length_2289_cov_17.807306	1021	1079	78	7	58	0.1206897
NODE_1060_length_2289_cov_7.736986	2161	2218	44	1	57	0.0175439
NODE_1060_length_2289_cov_7.736986	2161	2218	48	1	57	0.0175439
NODE_1060_length_2289_cov_7.736986	2161	2218	53	1	57	0.0175439
NODE_1060_length_2289_cov_7.736986	2161	2218	70	2	57	0.0350877
NODE_1060_length_2289_cov_7.736986	2161	2218	72	2	57	0.0350877
NODE_1060_length_2289_cov_7.736986	2161	2218	74	1	57	0.0175439
NODE_1060_length_2289_cov_7.736986	2161	2218	80	1	57	0.0175439
NODE_1060_length_2289_cov_7.736986	2161	2218	82	2	57	0.0350877
NODE_1060_length_2289_cov_7.736986	2161	2218	84	2	57	0.0350877
NODE_1060_length_2289_cov_7.736986	2161	2218	86	2	57	0.0350877
NODE_1060_length_2289_cov_7.736986	2161	2218	88	4	57	0.0701754
NODE_1060_length_2289_cov_7.736986	2161	2218	98	1	57	0.0175439
NODE_1060_length_2289_cov_7.736986	2161	2218	100	1	57	0.0175439
NODE_1060_length_2289_cov_7.736986	2161	2218	106	1	57	0.0175439
NODE_1060_length_2289_cov_7.736986	2161	2218	108	2	57	0.0350877
NODE_1060_length_2289_cov_7.736986	2161	2218	110	1	57	0.0175439
NODE_1060_length_2289_cov_7.736986	2161	2218	114	32	57	0.5614035
NODE_1060_length_2289_cov_7.736986	2191	2271	65	2	80	0.0250000
NODE_1060_length_2289_cov_7.736986	2191	2271	69	1	80	0.0125000
NODE_1060_length_2289_cov_7.736986	2191	2271	77	1	80	0.0125000
NODE_1060_length_2289_cov_7.736986	2191	2271	78	1	80	0.0125000
NODE_1060_length_2289_cov_7.736986	2191	2271	90	1	80	0.0125000
NODE_1060_length_2289_cov_7.736986	2191	2271	92	2	80	0.0250000
NODE_1060_length_2289_cov_7.736986	2191	2271	94	1	80	0.0125000
NODE_1060_length_2289_cov_7.736986	2191	2271	96	1	80	0.0125000
NODE_1060_length_2289_cov_7.736986	2191	2271	98	1	80	0.0125000
NODE_1060_length_2289_cov_7.736986	2191	2271	100	2	80	0.0250000
NODE_1060_length_2289_cov_7.736986	2191	2271	106	1	80	0.0125000
NODE_1060_length_2289_cov_7.736986	2191	2271	108	1	80	0.0125000
NODE_1060_length_2289_cov_7.736986	2191	2271	112	25	80	0.3125000
NODE_1060_length_2289_cov_7.736986	2191	2271	114	40	80	0.5000000
NODE_1061_length_2288_cov_8.539973	340	420	0	53	80	0.6625000
NODE_1061_length_2288_cov_8.539973	340	420	12	7	80	0.0875000
NODE_1061_length_2288_cov_8.539973	340	420	14	6	80	0.0750000
NODE_1061_length_2288_cov_8.539973	340	420	15	12	80	0.1500000
NODE_1061_length_2288_cov_8.539973	340	420	17	1	80	0.0125000
NODE_1061_length_2288_cov_8.539973	340	420	19	1	80	0.0125000
NODE_1061_length_2288_cov_8.539973	393	473	0	77	80	0.9625000
NODE_1061_length_2288_cov_8.539973	393	473	2	3	80	0.0375000
NODE_1065_length_2278_cov_19.655805	450	530	0	77	80	0.9625000
NODE_1065_length_2278_cov_19.655805	450	530	4	3	80	0.0375000
NODE_1065_length_2278_cov_19.655805	503	583	0	80	80	1.0000000
NODE_1065_length_2278_cov_19.655805	579	659	0	80	80	1.0000000
NODE_1065_length_2278_cov_19.655805	632	712	0	42	80	0.5250000
NODE_1065_length_2278_cov_19.655805	632	712	2	38	80	0.4750000
NODE_1071_length_2272_cov_26.123792	226	306	0	80	80	1.0000000
NODE_1071_length_2272_cov_26.123792	279	359	0	80	80	1.0000000
NODE_1071_length_2272_cov_26.123792	1684	1731	9	2	47	0.0425532
NODE_1071_length_2272_cov_26.123792	1684	1731	13	1	47	0.0212766
NODE_1071_length_2272_cov_26.123792	1684	1731	20	1	47	0.0212766
NODE_1071_length_2272_cov_26.123792	1684	1731	25	2	47	0.0425532
NODE_1071_length_2272_cov_26.123792	1684	1731	27	3	47	0.0638298
NODE_1071_length_2272_cov_26.123792	1684	1731	30	6	47	0.1276596
NODE_1071_length_2272_cov_26.123792	1684	1731	32	1	47	0.0212766
NODE_1071_length_2272_cov_26.123792	1684	1731	33	1	47	0.0212766
NODE_1071_length_2272_cov_26.123792	1684	1731	37	1	47	0.0212766
NODE_1071_length_2272_cov_26.123792	1684	1731	42	6	47	0.1276596
NODE_1071_length_2272_cov_26.123792	1684	1731	46	1	47	0.0212766
NODE_1071_length_2272_cov_26.123792	1684	1731	48	2	47	0.0425532
NODE_1071_length_2272_cov_26.123792	1684	1731	50	1	47	0.0212766
NODE_1071_length_2272_cov_26.123792	1684	1731	52	2	47	0.0425532
NODE_1071_length_2272_cov_26.123792	1684	1731	56	2	47	0.0425532
NODE_1071_length_2272_cov_26.123792	1684	1731	58	1	47	0.0212766
NODE_1071_length_2272_cov_26.123792	1684	1731	63	2	47	0.0425532
NODE_1071_length_2272_cov_26.123792	1684	1731	68	2	47	0.0425532
NODE_1071_length_2272_cov_26.123792	1684	1731	73	4	47	0.0851064
NODE_1071_length_2272_cov_26.123792	1684	1731	75	1	47	0.0212766
NODE_1071_length_2272_cov_26.123792	1684	1731	77	3	47	0.0638298
NODE_1071_length_2272_cov_26.123792	1684	1731	81	2	47	0.0425532
NODE_1071_length_2272_cov_26.123792	1694	1725	27	3	31	0.0967742
NODE_1071_length_2272_cov_26.123792	1694	1725	30	6	31	0.1935484
NODE_1071_length_2272_cov_26.123792	1694	1725	32	1	31	0.0322581
NODE_1071_length_2272_cov_26.123792	1694	1725	33	1	31	0.0322581
NODE_1071_length_2272_cov_26.123792	1694	1725	37	1	31	0.0322581
NODE_1071_length_2272_cov_26.123792	1694	1725	42	6	31	0.1935484
NODE_1071_length_2272_cov_26.123792	1694	1725	46	1	31	0.0322581
NODE_1071_length_2272_cov_26.123792	1694	1725	48	2	31	0.0645161
NODE_1071_length_2272_cov_26.123792	1694	1725	50	1	31	0.0322581
NODE_1071_length_2272_cov_26.123792	1694	1725	52	2	31	0.0645161
NODE_1071_length_2272_cov_26.123792	1694	1725	56	2	31	0.0645161
NODE_1071_length_2272_cov_26.123792	1694	1725	58	1	31	0.0322581
NODE_1071_length_2272_cov_26.123792	1694	1725	63	2	31	0.0645161
NODE_1071_length_2272_cov_26.123792	1694	1725	68	2	31	0.0645161
NODE_1071_length_2272_cov_26.123792	1759	1833	6	22	74	0.2972973
NODE_1071_length_2272_cov_26.123792	1759	1833	10	52	74	0.7027027
NODE_1071_length_2272_cov_26.123792	1812	1892	0	5	80	0.0625000
NODE_1071_length_2272_cov_26.123792	1812	1892	2	37	80	0.4625000
NODE_1071_length_2272_cov_26.123792	1812	1892	6	24	80	0.3000000
NODE_1071_length_2272_cov_26.123792	1812	1892	10	14	80	0.1750000
NODE_1072_length_2272_cov_8.175334	213	293	48	8	80	0.1000000
NODE_1072_length_2272_cov_8.175334	213	293	50	4	80	0.0500000
NODE_1072_length_2272_cov_8.175334	213	293	52	7	80	0.0875000
NODE_1072_length_2272_cov_8.175334	213	293	56	1	80	0.0125000
NODE_1072_length_2272_cov_8.175334	213	293	58	2	80	0.0250000
NODE_1072_length_2272_cov_8.175334	213	293	60	4	80	0.0500000
NODE_1072_length_2272_cov_8.175334	213	293	62	4	80	0.0500000
NODE_1072_length_2272_cov_8.175334	213	293	64	15	80	0.1875000
NODE_1072_length_2272_cov_8.175334	213	293	66	8	80	0.1000000
NODE_1072_length_2272_cov_8.175334	213	293	68	16	80	0.2000000
NODE_1072_length_2272_cov_8.175334	213	293	70	10	80	0.1250000
NODE_1072_length_2272_cov_8.175334	213	293	72	1	80	0.0125000
NODE_1072_length_2272_cov_8.175334	266	346	6	1	80	0.0125000
NODE_1072_length_2272_cov_8.175334	266	346	8	1	80	0.0125000
NODE_1072_length_2272_cov_8.175334	266	346	10	2	80	0.0250000
NODE_1072_length_2272_cov_8.175334	266	346	12	1	80	0.0125000
NODE_1072_length_2272_cov_8.175334	266	346	14	2	80	0.0250000
NODE_1072_length_2272_cov_8.175334	266	346	16	1	80	0.0125000
NODE_1072_length_2272_cov_8.175334	266	346	18	1	80	0.0125000
NODE_1072_length_2272_cov_8.175334	266	346	20	1	80	0.0125000
NODE_1072_length_2272_cov_8.175334	266	346	24	1	80	0.0125000
NODE_1072_length_2272_cov_8.175334	266	346	27	1	80	0.0125000
NODE_1072_length_2272_cov_8.175334	266	346	28	1	80	0.0125000
NODE_1072_length_2272_cov_8.175334	266	346	30	8	80	0.1000000
NODE_1072_length_2272_cov_8.175334	266	346	32	1	80	0.0125000
NODE_1072_length_2272_cov_8.175334	266	346	34	14	80	0.1750000
NODE_1072_length_2272_cov_8.175334	266	346	36	3	80	0.0375000
NODE_1072_length_2272_cov_8.175334	266	346	38	6	80	0.0750000
NODE_1072_length_2272_cov_8.175334	266	346	40	1	80	0.0125000
NODE_1072_length_2272_cov_8.175334	266	346	46	1	80	0.0125000
NODE_1072_length_2272_cov_8.175334	266	346	48	11	80	0.1375000
NODE_1072_length_2272_cov_8.175334	266	346	50	1	80	0.0125000
NODE_1072_length_2272_cov_8.175334	266	346	52	4	80	0.0500000
NODE_1072_length_2272_cov_8.175334	266	346	60	4	80	0.0500000
NODE_1072_length_2272_cov_8.175334	266	346	62	2	80	0.0250000
NODE_1072_length_2272_cov_8.175334	266	346	64	7	80	0.0875000
NODE_1072_length_2272_cov_8.175334	266	346	66	4	80	0.0500000
NODE_1077_length_2266_cov_13.206276	359	439	0	70	80	0.8750000
NODE_1077_length_2266_cov_13.206276	359	439	2	10	80	0.1250000
NODE_1077_length_2266_cov_13.206276	412	492	0	32	80	0.4000000
NODE_1077_length_2266_cov_13.206276	412	492	2	48	80	0.6000000
NODE_1077_length_2266_cov_13.206276	488	568	2	10	80	0.1250000
NODE_1077_length_2266_cov_13.206276	488	568	4	2	80	0.0250000
NODE_1077_length_2266_cov_13.206276	488	568	6	4	80	0.0500000
NODE_1077_length_2266_cov_13.206276	488	568	10	22	80	0.2750000
NODE_1077_length_2266_cov_13.206276	488	568	12	42	80	0.5250000
NODE_1077_length_2266_cov_13.206276	541	627	0	25	86	0.2906977
NODE_1077_length_2266_cov_13.206276	541	627	6	6	86	0.0697674
NODE_1077_length_2266_cov_13.206276	541	627	8	4	86	0.0465116
NODE_1077_length_2266_cov_13.206276	541	627	10	46	86	0.5348837
NODE_1077_length_2266_cov_13.206276	541	627	12	5	86	0.0581395
NODE_1078_length_2262_cov_11.759131	413	493	0	80	80	1.0000000
NODE_1078_length_2262_cov_11.759131	466	546	0	80	80	1.0000000
NODE_1079_length_2260_cov_37.814901	219	299	0	8	80	0.1000000
NODE_1079_length_2260_cov_37.814901	219	299	2	1	80	0.0125000
NODE_1079_length_2260_cov_37.814901	219	299	4	71	80	0.8875000
NODE_1079_length_2260_cov_37.814901	742	822	0	35	80	0.4375000
NODE_1079_length_2260_cov_37.814901	742	822	2	22	80	0.2750000
NODE_1079_length_2260_cov_37.814901	742	822	4	14	80	0.1750000
NODE_1079_length_2260_cov_37.814901	742	822	6	9	80	0.1125000
NODE_1079_length_2260_cov_37.814901	795	875	2	18	80	0.2250000
NODE_1079_length_2260_cov_37.814901	795	875	4	20	80	0.2500000
NODE_1079_length_2260_cov_37.814901	795	875	6	42	80	0.5250000
NODE_1079_length_2260_cov_37.814901	1533	1613	18	31	80	0.3875000
NODE_1079_length_2260_cov_37.814901	1533	1613	20	7	80	0.0875000
NODE_1079_length_2260_cov_37.814901	1533	1613	22	42	80	0.5250000
NODE_1079_length_2260_cov_37.814901	1586	1666	0	32	80	0.4000000
NODE_1079_length_2260_cov_37.814901	1586	1666	2	2	80	0.0250000
NODE_1079_length_2260_cov_37.814901	1586	1666	4	2	80	0.0250000
NODE_1079_length_2260_cov_37.814901	1586	1666	6	14	80	0.1750000
NODE_1079_length_2260_cov_37.814901	1586	1666	13	1	80	0.0125000
NODE_1079_length_2260_cov_37.814901	1586	1666	18	29	80	0.3625000
NODE_1079_length_2260_cov_37.814901	1662	1742	0	33	80	0.4125000
NODE_1079_length_2260_cov_37.814901	1662	1742	2	47	80	0.5875000
NODE_1079_length_2260_cov_37.814901	1715	1795	0	12	80	0.1500000
NODE_1079_length_2260_cov_37.814901	1715	1795	2	68	80	0.8500000
NODE_1082_length_2253_cov_8.904828	472	552	16	15	80	0.1875000
NODE_1082_length_2253_cov_8.904828	472	552	18	12	80	0.1500000
NODE_1082_length_2253_cov_8.904828	472	552	20	29	80	0.3625000
NODE_1082_length_2253_cov_8.904828	472	552	22	5	80	0.0625000
NODE_1082_length_2253_cov_8.904828	472	552	24	9	80	0.1125000
NODE_1082_length_2253_cov_8.904828	472	552	26	7	80	0.0875000
NODE_1082_length_2253_cov_8.904828	472	552	28	3	80	0.0375000
NODE_1085_length_2252_cov_2.801208	1128	1170	2	42	42	1.0000000
NODE_1085_length_2252_cov_2.801208	1137	1172	2	35	35	1.0000000
NODE_1086_length_2252_cov_2.078031	13	62	0	49	49	1.0000000
NODE_1086_length_2252_cov_2.078031	13	61	0	48	48	1.0000000
NODE_1086_length_2252_cov_2.078031	13	62	0	49	49	1.0000000
NODE_1086_length_2252_cov_2.078031	13	62	0	49	49	1.0000000
NODE_1086_length_2252_cov_2.078031	13	61	0	48	48	1.0000000
NODE_1087_length_2251_cov_15.458178	1443	1506	2	13	63	0.2063492
NODE_1087_length_2251_cov_15.458178	1443	1506	4	46	63	0.7301587
NODE_1087_length_2251_cov_15.458178	1443	1506	8	1	63	0.0158730
NODE_1087_length_2251_cov_15.458178	1443	1506	14	2	63	0.0317460
NODE_1087_length_2251_cov_15.458178	1443	1506	16	1	63	0.0158730
NODE_1087_length_2251_cov_15.458178	1496	1550	2	30	54	0.5555556
NODE_1087_length_2251_cov_15.458178	1496	1550	3	6	54	0.1111111
NODE_1087_length_2251_cov_15.458178	1496	1550	5	2	54	0.0370370
NODE_1087_length_2251_cov_15.458178	1496	1550	7	3	54	0.0555556
NODE_1087_length_2251_cov_15.458178	1496	1550	8	3	54	0.0555556
NODE_1087_length_2251_cov_15.458178	1496	1550	12	2	54	0.0370370
NODE_1087_length_2251_cov_15.458178	1496	1550	15	4	54	0.0740741
NODE_1087_length_2251_cov_15.458178	1496	1550	17	3	54	0.0555556
NODE_1087_length_2251_cov_15.458178	1496	1550	19	1	54	0.0185185
NODE_1089_length_2250_cov_18.370990	1658	1738	4	11	80	0.1375000
NODE_1089_length_2250_cov_18.370990	1658	1738	6	38	80	0.4750000
NODE_1089_length_2250_cov_18.370990	1658	1738	8	31	80	0.3875000
NODE_1089_length_2250_cov_18.370990	1711	1791	0	15	80	0.1875000
NODE_1089_length_2250_cov_18.370990	1711	1791	2	29	80	0.3625000
NODE_1089_length_2250_cov_18.370990	1711	1791	6	23	80	0.2875000
NODE_1089_length_2250_cov_18.370990	1711	1791	8	13	80	0.1625000
NODE_1090_length_2250_cov_5.331474	1844	1924	0	5	80	0.0625000
NODE_1090_length_2250_cov_5.331474	1844	1924	2	75	80	0.9375000
NODE_1093_length_2247_cov_7.906890	364	436	2	35	72	0.4861111
NODE_1093_length_2247_cov_7.906890	364	436	4	37	72	0.5138889
NODE_1095_length_2246_cov_7.612948	1992	2055	0	26	63	0.4126984
NODE_1095_length_2246_cov_7.612948	1992	2055	1	6	63	0.0952381
NODE_1095_length_2246_cov_7.612948	1992	2055	2	31	63	0.4920635
NODE_1095_length_2246_cov_7.612948	2045	2108	0	63	63	1.0000000
NODE_1104_length_2233_cov_35.127460	1517	1597	0	80	80	1.0000000
NODE_1104_length_2233_cov_35.127460	1570	1650	0	80	80	1.0000000
NODE_1105_length_2231_cov_45.701689	315	396	0	6	81	0.0740741
NODE_1105_length_2231_cov_45.701689	315	396	2	10	81	0.1234568
NODE_1105_length_2231_cov_45.701689	315	396	4	6	81	0.0740741
NODE_1105_length_2231_cov_45.701689	315	396	6	57	81	0.7037037
NODE_1105_length_2231_cov_45.701689	315	396	8	2	81	0.0246914
NODE_1105_length_2231_cov_45.701689	369	449	0	59	80	0.7375000
NODE_1105_length_2231_cov_45.701689	369	449	2	10	80	0.1250000
NODE_1105_length_2231_cov_45.701689	369	449	4	6	80	0.0750000
NODE_1105_length_2231_cov_45.701689	369	449	6	5	80	0.0625000
NODE_1105_length_2231_cov_45.701689	496	576	0	80	80	1.0000000
NODE_1105_length_2231_cov_45.701689	582	662	0	80	80	1.0000000
NODE_1105_length_2231_cov_45.701689	625	705	0	70	80	0.8750000
NODE_1105_length_2231_cov_45.701689	625	705	1	4	80	0.0500000
NODE_1105_length_2231_cov_45.701689	625	705	2	6	80	0.0750000
NODE_1105_length_2231_cov_45.701689	711	791	2	80	80	1.0000000
NODE_1105_length_2231_cov_45.701689	1141	1186	5	1	45	0.0222222
NODE_1105_length_2231_cov_45.701689	1141	1186	9	5	45	0.1111111
NODE_1105_length_2231_cov_45.701689	1141	1186	12	20	45	0.4444444
NODE_1105_length_2231_cov_45.701689	1141	1186	14	12	45	0.2666667
NODE_1105_length_2231_cov_45.701689	1141	1186	16	7	45	0.1555556
NODE_1105_length_2231_cov_45.701689	1787	1867	0	80	80	1.0000000
NODE_1105_length_2231_cov_45.701689	1840	1920	0	80	80	1.0000000
NODE_1106_length_2230_cov_12.608634	1520	1600	0	80	80	1.0000000
NODE_1106_length_2230_cov_12.608634	1573	1653	0	80	80	1.0000000
NODE_1112_length_2218_cov_5.292591	1427	1497	0	70	70	1.0000000
NODE_1112_length_2218_cov_5.292591	1470	1536	0	52	66	0.7878788
NODE_1112_length_2218_cov_5.292591	1470	1536	1	14	66	0.2121212
NODE_1115_length_2215_cov_51.865784	108	188	0	80	80	1.0000000
NODE_1115_length_2215_cov_51.865784	161	241	0	80	80	1.0000000
NODE_1115_length_2215_cov_51.865784	237	317	0	80	80	1.0000000
NODE_1115_length_2215_cov_51.865784	290	370	0	80	80	1.0000000
NODE_1115_length_2215_cov_51.865784	1030	1102	8	1	72	0.0138889
NODE_1115_length_2215_cov_51.865784	1030	1102	10	21	72	0.2916667
NODE_1115_length_2215_cov_51.865784	1030	1102	12	10	72	0.1388889
NODE_1115_length_2215_cov_51.865784	1030	1102	14	6	72	0.0833333
NODE_1115_length_2215_cov_51.865784	1030	1102	16	7	72	0.0972222
NODE_1115_length_2215_cov_51.865784	1030	1102	20	1	72	0.0138889
NODE_1115_length_2215_cov_51.865784	1030	1102	24	1	72	0.0138889
NODE_1115_length_2215_cov_51.865784	1030	1102	26	3	72	0.0416667
NODE_1115_length_2215_cov_51.865784	1030	1102	30	6	72	0.0833333
NODE_1115_length_2215_cov_51.865784	1030	1102	34	2	72	0.0277778
NODE_1115_length_2215_cov_51.865784	1030	1102	36	8	72	0.1111111
NODE_1115_length_2215_cov_51.865784	1030	1102	38	6	72	0.0833333
NODE_1115_length_2215_cov_51.865784	1571	1651	0	80	80	1.0000000
NODE_1115_length_2215_cov_51.865784	1624	1704	0	80	80	1.0000000
NODE_1117_length_2212_cov_63.988168	459	539	0	80	80	1.0000000
NODE_1117_length_2212_cov_63.988168	512	592	0	80	80	1.0000000
NODE_1117_length_2212_cov_63.988168	588	668	0	80	80	1.0000000
NODE_1117_length_2212_cov_63.988168	641	721	0	80	80	1.0000000
NODE_1119_length_2212_cov_4.632750	1479	1559	0	35	80	0.4375000
NODE_1119_length_2212_cov_4.632750	1479	1559	2	45	80	0.5625000
NODE_1119_length_2212_cov_4.632750	1532	1612	0	7	80	0.0875000
NODE_1119_length_2212_cov_4.632750	1532	1612	2	73	80	0.9125000
NODE_1122_length_2211_cov_16.247159	1808	1888	14	7	80	0.0875000
NODE_1122_length_2211_cov_16.247159	1808	1888	16	29	80	0.3625000
NODE_1122_length_2211_cov_16.247159	1808	1888	18	32	80	0.4000000
NODE_1122_length_2211_cov_16.247159	1808	1888	20	12	80	0.1500000
NODE_1124_length_2207_cov_46.766129	1273	1348	90	6	75	0.0800000
NODE_1124_length_2207_cov_46.766129	1273	1348	92	1	75	0.0133333
NODE_1124_length_2207_cov_46.766129	1273	1348	94	1	75	0.0133333
NODE_1124_length_2207_cov_46.766129	1273	1348	96	1	75	0.0133333
NODE_1124_length_2207_cov_46.766129	1273	1348	98	2	75	0.0266667
NODE_1124_length_2207_cov_46.766129	1273	1348	102	1	75	0.0133333
NODE_1124_length_2207_cov_46.766129	1273	1348	106	4	75	0.0533333
NODE_1124_length_2207_cov_46.766129	1273	1348	108	1	75	0.0133333
NODE_1124_length_2207_cov_46.766129	1273	1348	110	1	75	0.0133333
NODE_1124_length_2207_cov_46.766129	1273	1348	114	2	75	0.0266667
NODE_1124_length_2207_cov_46.766129	1273	1348	116	2	75	0.0266667
NODE_1124_length_2207_cov_46.766129	1273	1348	118	5	75	0.0666667
NODE_1124_length_2207_cov_46.766129	1273	1348	122	3	75	0.0400000
NODE_1124_length_2207_cov_46.766129	1273	1348	124	1	75	0.0133333
NODE_1124_length_2207_cov_46.766129	1273	1348	134	1	75	0.0133333
NODE_1124_length_2207_cov_46.766129	1273	1348	136	6	75	0.0800000
NODE_1124_length_2207_cov_46.766129	1273	1348	137	3	75	0.0400000
NODE_1124_length_2207_cov_46.766129	1273	1348	139	1	75	0.0133333
NODE_1124_length_2207_cov_46.766129	1273	1348	141	1	75	0.0133333
NODE_1124_length_2207_cov_46.766129	1273	1348	143	2	75	0.0266667
NODE_1124_length_2207_cov_46.766129	1273	1348	145	1	75	0.0133333
NODE_1124_length_2207_cov_46.766129	1273	1348	146	1	75	0.0133333
NODE_1124_length_2207_cov_46.766129	1273	1348	147	3	75	0.0400000
NODE_1124_length_2207_cov_46.766129	1273	1348	148	2	75	0.0266667
NODE_1124_length_2207_cov_46.766129	1273	1348	150	7	75	0.0933333
NODE_1124_length_2207_cov_46.766129	1273	1348	152	2	75	0.0266667
NODE_1124_length_2207_cov_46.766129	1273	1348	154	13	75	0.1733333
NODE_1124_length_2207_cov_46.766129	1273	1348	156	1	75	0.0133333
NODE_1124_length_2207_cov_46.766129	1324	1401	24	6	77	0.0779221
NODE_1124_length_2207_cov_46.766129	1324	1401	26	12	77	0.1558442
NODE_1124_length_2207_cov_46.766129	1324	1401	28	3	77	0.0389610
NODE_1124_length_2207_cov_46.766129	1324	1401	32	3	77	0.0389610
NODE_1124_length_2207_cov_46.766129	1324	1401	33	1	77	0.0129870
NODE_1124_length_2207_cov_46.766129	1324	1401	34	2	77	0.0259740
NODE_1124_length_2207_cov_46.766129	1324	1401	35	2	77	0.0259740
NODE_1124_length_2207_cov_46.766129	1324	1401	39	1	77	0.0129870
NODE_1124_length_2207_cov_46.766129	1324	1401	41	1	77	0.0129870
NODE_1124_length_2207_cov_46.766129	1324	1401	42	1	77	0.0129870
NODE_1124_length_2207_cov_46.766129	1324	1401	44	1	77	0.0129870
NODE_1124_length_2207_cov_46.766129	1324	1401	52	1	77	0.0129870
NODE_1124_length_2207_cov_46.766129	1324	1401	56	1	77	0.0129870
NODE_1124_length_2207_cov_46.766129	1324	1401	58	3	77	0.0389610
NODE_1124_length_2207_cov_46.766129	1324	1401	60	2	77	0.0259740
NODE_1124_length_2207_cov_46.766129	1324	1401	66	1	77	0.0129870
NODE_1124_length_2207_cov_46.766129	1324	1401	72	4	77	0.0519481
NODE_1124_length_2207_cov_46.766129	1324	1401	78	1	77	0.0129870
NODE_1124_length_2207_cov_46.766129	1324	1401	82	2	77	0.0259740
NODE_1124_length_2207_cov_46.766129	1324	1401	86	4	77	0.0519481
NODE_1124_length_2207_cov_46.766129	1324	1401	90	7	77	0.0909091
NODE_1124_length_2207_cov_46.766129	1324	1401	92	1	77	0.0129870
NODE_1124_length_2207_cov_46.766129	1324	1401	94	1	77	0.0129870
NODE_1124_length_2207_cov_46.766129	1324	1401	96	1	77	0.0129870
NODE_1124_length_2207_cov_46.766129	1324	1401	98	2	77	0.0259740
NODE_1124_length_2207_cov_46.766129	1324	1401	102	1	77	0.0129870
NODE_1124_length_2207_cov_46.766129	1324	1401	106	4	77	0.0519481
NODE_1124_length_2207_cov_46.766129	1324	1401	108	1	77	0.0129870
NODE_1124_length_2207_cov_46.766129	1324	1401	110	1	77	0.0129870
NODE_1124_length_2207_cov_46.766129	1324	1401	114	2	77	0.0259740
NODE_1124_length_2207_cov_46.766129	1324	1401	116	1	77	0.0129870
NODE_1124_length_2207_cov_46.766129	1324	1401	118	3	77	0.0389610
NODE_1127_length_2205_cov_12.762108	1818	1898	2	76	80	0.9500000
NODE_1127_length_2205_cov_12.762108	1818	1898	4	4	80	0.0500000
NODE_1127_length_2205_cov_12.762108	1871	1951	0	10	80	0.1250000
NODE_1127_length_2205_cov_12.762108	1871	1951	2	66	80	0.8250000
NODE_1127_length_2205_cov_12.762108	1871	1951	4	4	80	0.0500000
NODE_1127_length_2205_cov_12.762108	1872	1951	0	10	79	0.1265823
NODE_1127_length_2205_cov_12.762108	1872	1951	2	65	79	0.8227848
NODE_1127_length_2205_cov_12.762108	1872	1951	4	4	79	0.0506329
NODE_1127_length_2205_cov_12.762108	1947	2020	0	73	73	1.0000000
NODE_1128_length_2202_cov_8.687114	1848	1912	0	64	64	1.0000000
NODE_1130_length_2200_cov_10.639695	1461	1541	0	80	80	1.0000000
NODE_1130_length_2200_cov_10.639695	1514	1594	0	80	80	1.0000000
NODE_1131_length_2199_cov_10.839524	1709	1789	0	80	80	1.0000000
NODE_1131_length_2199_cov_10.839524	1762	1842	0	31	80	0.3875000
NODE_1131_length_2199_cov_10.839524	1762	1842	2	49	80	0.6125000
NODE_1135_length_2196_cov_64.718646	885	965	16	2	80	0.0250000
NODE_1135_length_2196_cov_64.718646	885	965	18	4	80	0.0500000
NODE_1135_length_2196_cov_64.718646	885	965	20	4	80	0.0500000
NODE_1135_length_2196_cov_64.718646	885	965	22	9	80	0.1125000
NODE_1135_length_2196_cov_64.718646	885	965	24	3	80	0.0375000
NODE_1135_length_2196_cov_64.718646	885	965	26	10	80	0.1250000
NODE_1135_length_2196_cov_64.718646	885	965	28	3	80	0.0375000
NODE_1135_length_2196_cov_64.718646	885	965	30	1	80	0.0125000
NODE_1135_length_2196_cov_64.718646	885	965	32	2	80	0.0250000
NODE_1135_length_2196_cov_64.718646	885	965	34	6	80	0.0750000
NODE_1135_length_2196_cov_64.718646	885	965	36	22	80	0.2750000
NODE_1135_length_2196_cov_64.718646	885	965	38	14	80	0.1750000
NODE_1135_length_2196_cov_64.718646	938	1018	16	1	80	0.0125000
NODE_1135_length_2196_cov_64.718646	938	1018	18	5	80	0.0625000
NODE_1135_length_2196_cov_64.718646	938	1018	20	3	80	0.0375000
NODE_1135_length_2196_cov_64.718646	938	1018	22	7	80	0.0875000
NODE_1135_length_2196_cov_64.718646	938	1018	24	2	80	0.0250000
NODE_1135_length_2196_cov_64.718646	938	1018	26	4	80	0.0500000
NODE_1135_length_2196_cov_64.718646	938	1018	28	5	80	0.0625000
NODE_1135_length_2196_cov_64.718646	938	1018	30	6	80	0.0750000
NODE_1135_length_2196_cov_64.718646	938	1018	32	1	80	0.0125000
NODE_1135_length_2196_cov_64.718646	938	1018	34	17	80	0.2125000
NODE_1135_length_2196_cov_64.718646	938	1018	36	12	80	0.1500000
NODE_1135_length_2196_cov_64.718646	938	1018	38	17	80	0.2125000
NODE_1138_length_2195_cov_8.443225	114	136	6	22	22	1.0000000
NODE_1139_length_2195_cov_6.113550	1245	1330	0	3	85	0.0352941
NODE_1139_length_2195_cov_6.113550	1245	1330	2	82	85	0.9647059
NODE_1139_length_2195_cov_6.113550	1306	1352	0	3	46	0.0652174
NODE_1139_length_2195_cov_6.113550	1306	1352	2	43	46	0.9347826
NODE_1141_length_2194_cov_1.366587	15	77	2	59	62	0.9516129
NODE_1141_length_2194_cov_1.366587	15	77	4	3	62	0.0483871
NODE_1142_length_2193_cov_8.320917	374	454	2	73	80	0.9125000
NODE_1142_length_2193_cov_8.320917	374	454	4	7	80	0.0875000
NODE_1142_length_2193_cov_8.320917	427	502	0	27	75	0.3600000
NODE_1142_length_2193_cov_8.320917	427	502	2	48	75	0.6400000
NODE_1146_length_2189_cov_36.884689	383	463	0	80	80	1.0000000
NODE_1146_length_2189_cov_36.884689	436	516	0	80	80	1.0000000
NODE_1146_length_2189_cov_36.884689	1257	1337	2	80	80	1.0000000
NODE_1146_length_2189_cov_36.884689	1310	1390	0	39	80	0.4875000
NODE_1146_length_2189_cov_36.884689	1310	1390	2	41	80	0.5125000
NODE_1146_length_2189_cov_36.884689	1427	1507	0	29	80	0.3625000
NODE_1146_length_2189_cov_36.884689	1427	1507	2	51	80	0.6375000
NODE_1146_length_2189_cov_36.884689	1480	1560	0	7	80	0.0875000
NODE_1146_length_2189_cov_36.884689	1480	1560	2	73	80	0.9125000
NODE_1152_length_2184_cov_9.464748	1536	1616	0	80	80	1.0000000
NODE_1152_length_2184_cov_9.464748	1589	1669	0	80	80	1.0000000
NODE_1154_length_2183_cov_45.471209	1632	1712	0	45	80	0.5625000
NODE_1154_length_2183_cov_45.471209	1632	1712	2	35	80	0.4375000
NODE_1154_length_2183_cov_45.471209	1685	1765	0	80	80	1.0000000
NODE_1159_length_2176_cov_47.338950	0	52	0	52	52	1.0000000
NODE_1162_length_2174_cov_40.560964	1638	1718	0	80	80	1.0000000
NODE_1162_length_2174_cov_40.560964	1691	1771	0	80	80	1.0000000
NODE_1163_length_2174_cov_35.399518	284	364	2	64	80	0.8000000
NODE_1163_length_2174_cov_35.399518	284	364	4	16	80	0.2000000
NODE_1163_length_2174_cov_35.399518	337	414	0	35	77	0.4545455
NODE_1163_length_2174_cov_35.399518	337	414	1	3	77	0.0389610
NODE_1163_length_2174_cov_35.399518	337	414	2	39	77	0.5064935
NODE_1163_length_2174_cov_35.399518	1542	1620	67	1	78	0.0128205
NODE_1163_length_2174_cov_35.399518	1542	1620	69	1	78	0.0128205
NODE_1163_length_2174_cov_35.399518	1542	1620	71	2	78	0.0256410
NODE_1163_length_2174_cov_35.399518	1542	1620	73	3	78	0.0384615
NODE_1163_length_2174_cov_35.399518	1542	1620	75	1	78	0.0128205
NODE_1163_length_2174_cov_35.399518	1542	1620	77	3	78	0.0384615
NODE_1163_length_2174_cov_35.399518	1542	1620	78	2	78	0.0256410
NODE_1163_length_2174_cov_35.399518	1542	1620	80	4	78	0.0512821
NODE_1163_length_2174_cov_35.399518	1542	1620	82	2	78	0.0256410
NODE_1163_length_2174_cov_35.399518	1542	1620	83	1	78	0.0128205
NODE_1163_length_2174_cov_35.399518	1542	1620	85	3	78	0.0384615
NODE_1163_length_2174_cov_35.399518	1542	1620	87	2	78	0.0256410
NODE_1163_length_2174_cov_35.399518	1542	1620	88	3	78	0.0384615
NODE_1163_length_2174_cov_35.399518	1542	1620	89	2	78	0.0256410
NODE_1163_length_2174_cov_35.399518	1542	1620	90	12	78	0.1538462
NODE_1163_length_2174_cov_35.399518	1542	1620	91	2	78	0.0256410
NODE_1163_length_2174_cov_35.399518	1542	1620	92	9	78	0.1153846
NODE_1163_length_2174_cov_35.399518	1542	1620	94	6	78	0.0769231
NODE_1163_length_2174_cov_35.399518	1542	1620	95	6	78	0.0769231
NODE_1163_length_2174_cov_35.399518	1542	1620	96	5	78	0.0641026
NODE_1163_length_2174_cov_35.399518	1542	1620	97	1	78	0.0128205
NODE_1163_length_2174_cov_35.399518	1542	1620	98	2	78	0.0256410
NODE_1163_length_2174_cov_35.399518	1542	1620	100	3	78	0.0384615
NODE_1163_length_2174_cov_35.399518	1542	1620	104	2	78	0.0256410
NODE_1163_length_2174_cov_35.399518	1593	1673	67	1	80	0.0125000
NODE_1163_length_2174_cov_35.399518	1593	1673	69	1	80	0.0125000
NODE_1163_length_2174_cov_35.399518	1593	1673	71	2	80	0.0250000
NODE_1163_length_2174_cov_35.399518	1593	1673	73	3	80	0.0375000
NODE_1163_length_2174_cov_35.399518	1593	1673	75	1	80	0.0125000
NODE_1163_length_2174_cov_35.399518	1593	1673	77	3	80	0.0375000
NODE_1163_length_2174_cov_35.399518	1593	1673	78	2	80	0.0250000
NODE_1163_length_2174_cov_35.399518	1593	1673	80	4	80	0.0500000
NODE_1163_length_2174_cov_35.399518	1593	1673	82	2	80	0.0250000
NODE_1163_length_2174_cov_35.399518	1593	1673	83	1	80	0.0125000
NODE_1163_length_2174_cov_35.399518	1593	1673	92	3	80	0.0375000
NODE_1163_length_2174_cov_35.399518	1593	1673	94	1	80	0.0125000
NODE_1163_length_2174_cov_35.399518	1593	1673	96	4	80	0.0500000
NODE_1163_length_2174_cov_35.399518	1593	1673	98	2	80	0.0250000
NODE_1163_length_2174_cov_35.399518	1593	1673	102	2	80	0.0250000
NODE_1163_length_2174_cov_35.399518	1593	1673	104	2	80	0.0250000
NODE_1163_length_2174_cov_35.399518	1593	1673	105	1	80	0.0125000
NODE_1163_length_2174_cov_35.399518	1593	1673	106	3	80	0.0375000
NODE_1163_length_2174_cov_35.399518	1593	1673	107	1	80	0.0125000
NODE_1163_length_2174_cov_35.399518	1593	1673	108	1	80	0.0125000
NODE_1163_length_2174_cov_35.399518	1593	1673	109	2	80	0.0250000
NODE_1163_length_2174_cov_35.399518	1593	1673	110	2	80	0.0250000
NODE_1163_length_2174_cov_35.399518	1593	1673	112	5	80	0.0625000
NODE_1163_length_2174_cov_35.399518	1593	1673	113	1	80	0.0125000
NODE_1163_length_2174_cov_35.399518	1593	1673	114	2	80	0.0250000
NODE_1163_length_2174_cov_35.399518	1593	1673	115	1	80	0.0125000
NODE_1163_length_2174_cov_35.399518	1593	1673	116	4	80	0.0500000
NODE_1163_length_2174_cov_35.399518	1593	1673	117	5	80	0.0625000
NODE_1163_length_2174_cov_35.399518	1593	1673	118	1	80	0.0125000
NODE_1163_length_2174_cov_35.399518	1593	1673	120	3	80	0.0375000
NODE_1163_length_2174_cov_35.399518	1593	1673	122	4	80	0.0500000
NODE_1163_length_2174_cov_35.399518	1593	1673	124	3	80	0.0375000
NODE_1163_length_2174_cov_35.399518	1593	1673	126	1	80	0.0125000
NODE_1163_length_2174_cov_35.399518	1593	1673	128	3	80	0.0375000
NODE_1163_length_2174_cov_35.399518	1593	1673	130	1	80	0.0125000
NODE_1163_length_2174_cov_35.399518	1593	1673	131	1	80	0.0125000
NODE_1163_length_2174_cov_35.399518	1593	1673	132	1	80	0.0125000
NODE_1163_length_2174_cov_35.399518	2075	2152	56	77	77	1.0000000
NODE_1163_length_2174_cov_35.399518	2075	2152	56	77	77	1.0000000
NODE_1163_length_2174_cov_35.399518	2075	2152	56	77	77	1.0000000
NODE_1163_length_2174_cov_35.399518	2125	2174	8	1	49	0.0204082
NODE_1163_length_2174_cov_35.399518	2125	2174	12	1	49	0.0204082
NODE_1163_length_2174_cov_35.399518	2125	2174	14	5	49	0.1020408
NODE_1163_length_2174_cov_35.399518	2125	2174	18	1	49	0.0204082
NODE_1163_length_2174_cov_35.399518	2125	2174	22	3	49	0.0612245
NODE_1163_length_2174_cov_35.399518	2125	2174	26	1	49	0.0204082
NODE_1163_length_2174_cov_35.399518	2125	2174	35	2	49	0.0408163
NODE_1163_length_2174_cov_35.399518	2125	2174	37	1	49	0.0204082
NODE_1163_length_2174_cov_35.399518	2125	2174	38	1	49	0.0204082
NODE_1163_length_2174_cov_35.399518	2125	2174	42	1	49	0.0204082
NODE_1163_length_2174_cov_35.399518	2125	2174	44	2	49	0.0408163
NODE_1163_length_2174_cov_35.399518	2125	2174	46	1	49	0.0204082
NODE_1163_length_2174_cov_35.399518	2125	2174	52	1	49	0.0204082
NODE_1163_length_2174_cov_35.399518	2125	2174	54	1	49	0.0204082
NODE_1163_length_2174_cov_35.399518	2125	2174	56	27	49	0.5510204
NODE_1163_length_2174_cov_35.399518	2128	2174	8	1	46	0.0217391
NODE_1163_length_2174_cov_35.399518	2128	2174	12	1	46	0.0217391
NODE_1163_length_2174_cov_35.399518	2128	2174	14	5	46	0.1086956
NODE_1163_length_2174_cov_35.399518	2128	2174	18	1	46	0.0217391
NODE_1163_length_2174_cov_35.399518	2128	2174	22	3	46	0.0652174
NODE_1163_length_2174_cov_35.399518	2128	2174	26	1	46	0.0217391
NODE_1163_length_2174_cov_35.399518	2128	2174	35	2	46	0.0434783
NODE_1163_length_2174_cov_35.399518	2128	2174	37	1	46	0.0217391
NODE_1163_length_2174_cov_35.399518	2128	2174	38	1	46	0.0217391
NODE_1163_length_2174_cov_35.399518	2128	2174	42	1	46	0.0217391
NODE_1163_length_2174_cov_35.399518	2128	2174	44	2	46	0.0434783
NODE_1163_length_2174_cov_35.399518	2128	2174	46	1	46	0.0217391
NODE_1163_length_2174_cov_35.399518	2128	2174	52	1	46	0.0217391
NODE_1163_length_2174_cov_35.399518	2128	2174	54	1	46	0.0217391
NODE_1163_length_2174_cov_35.399518	2128	2174	56	24	46	0.5217391
NODE_1163_length_2174_cov_35.399518	2130	2174	8	1	44	0.0227273
NODE_1163_length_2174_cov_35.399518	2130	2174	12	1	44	0.0227273
NODE_1163_length_2174_cov_35.399518	2130	2174	14	5	44	0.1136364
NODE_1163_length_2174_cov_35.399518	2130	2174	18	1	44	0.0227273
NODE_1163_length_2174_cov_35.399518	2130	2174	22	3	44	0.0681818
NODE_1163_length_2174_cov_35.399518	2130	2174	26	1	44	0.0227273
NODE_1163_length_2174_cov_35.399518	2130	2174	35	2	44	0.0454545
NODE_1163_length_2174_cov_35.399518	2130	2174	37	1	44	0.0227273
NODE_1163_length_2174_cov_35.399518	2130	2174	38	1	44	0.0227273
NODE_1163_length_2174_cov_35.399518	2130	2174	42	1	44	0.0227273
NODE_1163_length_2174_cov_35.399518	2130	2174	44	2	44	0.0454545
NODE_1163_length_2174_cov_35.399518	2130	2174	46	1	44	0.0227273
NODE_1163_length_2174_cov_35.399518	2130	2174	52	1	44	0.0227273
NODE_1163_length_2174_cov_35.399518	2130	2174	54	1	44	0.0227273
NODE_1163_length_2174_cov_35.399518	2130	2174	56	22	44	0.5000000
NODE_1164_length_2172_cov_44.861553	1110	1190	10	1	80	0.0125000
NODE_1164_length_2172_cov_44.861553	1110	1190	12	13	80	0.1625000
NODE_1164_length_2172_cov_44.861553	1110	1190	14	44	80	0.5500000
NODE_1164_length_2172_cov_44.861553	1110	1190	16	22	80	0.2750000
NODE_1164_length_2172_cov_44.861553	1163	1243	4	1	80	0.0125000
NODE_1164_length_2172_cov_44.861553	1163	1243	5	1	80	0.0125000
NODE_1164_length_2172_cov_44.861553	1163	1243	6	10	80	0.1250000
NODE_1164_length_2172_cov_44.861553	1163	1243	8	10	80	0.1250000
NODE_1164_length_2172_cov_44.861553	1163	1243	10	26	80	0.3250000
NODE_1164_length_2172_cov_44.861553	1163	1243	12	9	80	0.1125000
NODE_1164_length_2172_cov_44.861553	1163	1243	14	15	80	0.1875000
NODE_1164_length_2172_cov_44.861553	1163	1243	16	8	80	0.1000000
NODE_1164_length_2172_cov_44.861553	1239	1319	12	7	80	0.0875000
NODE_1164_length_2172_cov_44.861553	1239	1319	14	2	80	0.0250000
NODE_1164_length_2172_cov_44.861553	1239	1319	18	3	80	0.0375000
NODE_1164_length_2172_cov_44.861553	1239	1319	19	4	80	0.0500000
NODE_1164_length_2172_cov_44.861553	1239	1319	21	4	80	0.0500000
NODE_1164_length_2172_cov_44.861553	1239	1319	22	16	80	0.2000000
NODE_1164_length_2172_cov_44.861553	1239	1319	23	2	80	0.0250000
NODE_1164_length_2172_cov_44.861553	1239	1319	24	9	80	0.1125000
NODE_1164_length_2172_cov_44.861553	1239	1319	25	6	80	0.0750000
NODE_1164_length_2172_cov_44.861553	1239	1319	26	1	80	0.0125000
NODE_1164_length_2172_cov_44.861553	1239	1319	28	8	80	0.1000000
NODE_1164_length_2172_cov_44.861553	1239	1319	30	1	80	0.0125000
NODE_1164_length_2172_cov_44.861553	1239	1319	32	2	80	0.0250000
NODE_1164_length_2172_cov_44.861553	1239	1319	33	1	80	0.0125000
NODE_1164_length_2172_cov_44.861553	1239	1319	35	3	80	0.0375000
NODE_1164_length_2172_cov_44.861553	1239	1319	37	1	80	0.0125000
NODE_1164_length_2172_cov_44.861553	1239	1319	39	1	80	0.0125000
NODE_1164_length_2172_cov_44.861553	1239	1319	43	9	80	0.1125000
NODE_1164_length_2172_cov_44.861553	1292	1372	22	1	80	0.0125000
NODE_1164_length_2172_cov_44.861553	1292	1372	24	10	80	0.1250000
NODE_1164_length_2172_cov_44.861553	1292	1372	26	3	80	0.0375000
NODE_1164_length_2172_cov_44.861553	1292	1372	28	8	80	0.1000000
NODE_1164_length_2172_cov_44.861553	1292	1372	30	1	80	0.0125000
NODE_1164_length_2172_cov_44.861553	1292	1372	31	6	80	0.0750000
NODE_1164_length_2172_cov_44.861553	1292	1372	32	2	80	0.0250000
NODE_1164_length_2172_cov_44.861553	1292	1372	33	4	80	0.0500000
NODE_1164_length_2172_cov_44.861553	1292	1372	34	10	80	0.1250000
NODE_1164_length_2172_cov_44.861553	1292	1372	35	3	80	0.0375000
NODE_1164_length_2172_cov_44.861553	1292	1372	37	3	80	0.0375000
NODE_1164_length_2172_cov_44.861553	1292	1372	39	11	80	0.1375000
NODE_1164_length_2172_cov_44.861553	1292	1372	41	7	80	0.0875000
NODE_1164_length_2172_cov_44.861553	1292	1372	43	11	80	0.1375000
NODE_1166_length_2167_cov_33.133946	414	494	0	15	80	0.1875000
NODE_1166_length_2167_cov_33.133946	414	494	2	65	80	0.8125000
NODE_1166_length_2167_cov_33.133946	467	547	0	27	80	0.3375000
NODE_1166_length_2167_cov_33.133946	467	547	2	53	80	0.6625000
NODE_1166_length_2167_cov_33.133946	543	623	2	74	80	0.9250000
NODE_1166_length_2167_cov_33.133946	543	623	4	3	80	0.0375000
NODE_1166_length_2167_cov_33.133946	543	623	6	3	80	0.0375000
NODE_1166_length_2167_cov_33.133946	596	676	2	21	80	0.2625000
NODE_1166_length_2167_cov_33.133946	596	676	4	3	80	0.0375000
NODE_1166_length_2167_cov_33.133946	596	676	6	13	80	0.1625000
NODE_1166_length_2167_cov_33.133946	596	676	8	38	80	0.4750000
NODE_1166_length_2167_cov_33.133946	596	676	10	5	80	0.0625000
NODE_1169_length_2165_cov_21.460794	980	1060	0	80	80	1.0000000
NODE_1169_length_2165_cov_21.460794	1033	1113	0	80	80	1.0000000
NODE_1176_length_2157_cov_22.284257	989	1069	0	80	80	1.0000000
NODE_1176_length_2157_cov_22.284257	1042	1122	0	80	80	1.0000000
NODE_1176_length_2157_cov_22.284257	1118	1198	0	80	80	1.0000000
NODE_1176_length_2157_cov_22.284257	1171	1251	0	80	80	1.0000000
NODE_1177_length_2157_cov_8.830418	867	947	2	29	80	0.3625000
NODE_1177_length_2157_cov_8.830418	867	947	4	51	80	0.6375000
NODE_1177_length_2157_cov_8.830418	920	1000	0	31	80	0.3875000
NODE_1177_length_2157_cov_8.830418	920	1000	2	24	80	0.3000000
NODE_1177_length_2157_cov_8.830418	920	1000	4	25	80	0.3125000
NODE_1177_length_2157_cov_8.830418	996	1076	0	80	80	1.0000000
NODE_1177_length_2157_cov_8.830418	1049	1129	0	80	80	1.0000000
NODE_1178_length_2156_cov_25.065630	0	41	7	1	41	0.0243902
NODE_1178_length_2156_cov_25.065630	0	41	13	2	41	0.0487805
NODE_1178_length_2156_cov_25.065630	0	41	15	2	41	0.0487805
NODE_1178_length_2156_cov_25.065630	0	41	19	1	41	0.0243902
NODE_1178_length_2156_cov_25.065630	0	41	23	9	41	0.2195122
NODE_1178_length_2156_cov_25.065630	0	41	27	1	41	0.0243902
NODE_1178_length_2156_cov_25.065630	0	41	29	1	41	0.0243902
NODE_1178_length_2156_cov_25.065630	0	41	31	7	41	0.1707317
NODE_1178_length_2156_cov_25.065630	0	41	33	1	41	0.0243902
NODE_1178_length_2156_cov_25.065630	0	41	37	3	41	0.0731707
NODE_1178_length_2156_cov_25.065630	0	41	41	3	41	0.0731707
NODE_1178_length_2156_cov_25.065630	0	41	43	3	41	0.0731707
NODE_1178_length_2156_cov_25.065630	0	41	45	3	41	0.0731707
NODE_1178_length_2156_cov_25.065630	0	41	47	3	41	0.0731707
NODE_1178_length_2156_cov_25.065630	0	41	51	1	41	0.0243902
NODE_1178_length_2156_cov_25.065630	14	94	23	1	80	0.0125000
NODE_1178_length_2156_cov_25.065630	14	94	27	1	80	0.0125000
NODE_1178_length_2156_cov_25.065630	14	94	29	1	80	0.0125000
NODE_1178_length_2156_cov_25.065630	14	94	31	7	80	0.0875000
NODE_1178_length_2156_cov_25.065630	14	94	33	1	80	0.0125000
NODE_1178_length_2156_cov_25.065630	14	94	37	3	80	0.0375000
NODE_1178_length_2156_cov_25.065630	14	94	41	3	80	0.0375000
NODE_1178_length_2156_cov_25.065630	14	94	43	3	80	0.0375000
NODE_1178_length_2156_cov_25.065630	14	94	45	3	80	0.0375000
NODE_1178_length_2156_cov_25.065630	14	94	47	3	80	0.0375000
NODE_1178_length_2156_cov_25.065630	14	94	51	2	80	0.0250000
NODE_1178_length_2156_cov_25.065630	14	94	53	2	80	0.0250000
NODE_1178_length_2156_cov_25.065630	14	94	55	1	80	0.0125000
NODE_1178_length_2156_cov_25.065630	14	94	56	2	80	0.0250000
NODE_1178_length_2156_cov_25.065630	14	94	60	8	80	0.1000000
NODE_1178_length_2156_cov_25.065630	14	94	62	3	80	0.0375000
NODE_1178_length_2156_cov_25.065630	14	94	65	1	80	0.0125000
NODE_1178_length_2156_cov_25.065630	14	94	67	2	80	0.0250000
NODE_1178_length_2156_cov_25.065630	14	94	69	1	80	0.0125000
NODE_1178_length_2156_cov_25.065630	14	94	75	8	80	0.1000000
NODE_1178_length_2156_cov_25.065630	14	94	77	1	80	0.0125000
NODE_1178_length_2156_cov_25.065630	14	94	78	5	80	0.0625000
NODE_1178_length_2156_cov_25.065630	14	94	80	3	80	0.0375000
NODE_1178_length_2156_cov_25.065630	14	94	82	1	80	0.0125000
NODE_1178_length_2156_cov_25.065630	14	94	85	6	80	0.0750000
NODE_1178_length_2156_cov_25.065630	14	94	86	6	80	0.0750000
NODE_1178_length_2156_cov_25.065630	14	94	87	2	80	0.0250000
NODE_1181_length_2156_cov_3.216334	1890	1970	0	80	80	1.0000000
NODE_1181_length_2156_cov_3.216334	1943	2023	0	80	80	1.0000000
NODE_1184_length_2153_cov_11.610029	1968	2048	0	7	80	0.0875000
NODE_1184_length_2153_cov_11.610029	1968	2048	2	62	80	0.7750000
NODE_1184_length_2153_cov_11.610029	1968	2048	4	1	80	0.0125000
NODE_1184_length_2153_cov_11.610029	1968	2048	8	1	80	0.0125000
NODE_1184_length_2153_cov_11.610029	1968	2048	10	1	80	0.0125000
NODE_1184_length_2153_cov_11.610029	1968	2048	14	1	80	0.0125000
NODE_1184_length_2153_cov_11.610029	1968	2048	16	7	80	0.0875000
NODE_1184_length_2153_cov_11.610029	1977	2048	0	7	71	0.0985916
NODE_1184_length_2153_cov_11.610029	1977	2048	2	53	71	0.7464789
NODE_1184_length_2153_cov_11.610029	1977	2048	4	1	71	0.0140845
NODE_1184_length_2153_cov_11.610029	1977	2048	8	1	71	0.0140845
NODE_1184_length_2153_cov_11.610029	1977	2048	10	1	71	0.0140845
NODE_1184_length_2153_cov_11.610029	1977	2048	14	1	71	0.0140845
NODE_1184_length_2153_cov_11.610029	1977	2048	16	7	71	0.0985916
NODE_1190_length_2147_cov_25.116211	814	894	26	3	80	0.0375000
NODE_1190_length_2147_cov_25.116211	814	894	28	2	80	0.0250000
NODE_1190_length_2147_cov_25.116211	814	894	29	1	80	0.0125000
NODE_1190_length_2147_cov_25.116211	814	894	32	3	80	0.0375000
NODE_1190_length_2147_cov_25.116211	814	894	38	2	80	0.0250000
NODE_1190_length_2147_cov_25.116211	814	894	42	8	80	0.1000000
NODE_1190_length_2147_cov_25.116211	814	894	43	1	80	0.0125000
NODE_1190_length_2147_cov_25.116211	814	894	44	17	80	0.2125000
NODE_1190_length_2147_cov_25.116211	814	894	45	10	80	0.1250000
NODE_1190_length_2147_cov_25.116211	814	894	46	6	80	0.0750000
NODE_1190_length_2147_cov_25.116211	814	894	47	4	80	0.0500000
NODE_1190_length_2147_cov_25.116211	814	894	48	21	80	0.2625000
NODE_1190_length_2147_cov_25.116211	814	894	50	2	80	0.0250000
NODE_1190_length_2147_cov_25.116211	867	947	8	5	80	0.0625000
NODE_1190_length_2147_cov_25.116211	867	947	10	7	80	0.0875000
NODE_1190_length_2147_cov_25.116211	867	947	14	15	80	0.1875000
NODE_1190_length_2147_cov_25.116211	867	947	15	1	80	0.0125000
NODE_1190_length_2147_cov_25.116211	867	947	17	1	80	0.0125000
NODE_1190_length_2147_cov_25.116211	867	947	19	2	80	0.0250000
NODE_1190_length_2147_cov_25.116211	867	947	21	2	80	0.0250000
NODE_1190_length_2147_cov_25.116211	867	947	23	8	80	0.1000000
NODE_1190_length_2147_cov_25.116211	867	947	24	5	80	0.0625000
NODE_1190_length_2147_cov_25.116211	867	947	26	10	80	0.1250000
NODE_1190_length_2147_cov_25.116211	867	947	28	2	80	0.0250000
NODE_1190_length_2147_cov_25.116211	867	947	29	1	80	0.0125000
NODE_1190_length_2147_cov_25.116211	867	947	32	3	80	0.0375000
NODE_1190_length_2147_cov_25.116211	867	947	38	2	80	0.0250000
NODE_1190_length_2147_cov_25.116211	867	947	44	13	80	0.1625000
NODE_1190_length_2147_cov_25.116211	867	947	46	1	80	0.0125000
NODE_1190_length_2147_cov_25.116211	867	947	47	2	80	0.0250000
NODE_1197_length_2136_cov_16.947472	279	359	0	3	80	0.0375000
NODE_1197_length_2136_cov_16.947472	279	359	2	45	80	0.5625000
NODE_1197_length_2136_cov_16.947472	279	359	4	20	80	0.2500000
NODE_1197_length_2136_cov_16.947472	279	359	6	12	80	0.1500000
NODE_1197_length_2136_cov_16.947472	332	412	2	16	80	0.2000000
NODE_1197_length_2136_cov_16.947472	332	412	4	34	80	0.4250000
NODE_1197_length_2136_cov_16.947472	332	412	6	30	80	0.3750000
NODE_1197_length_2136_cov_16.947472	408	488	0	22	80	0.2750000
NODE_1197_length_2136_cov_16.947472	408	488	2	22	80	0.2750000
NODE_1197_length_2136_cov_16.947472	408	488	4	36	80	0.4500000
NODE_1197_length_2136_cov_16.947472	461	541	0	75	80	0.9375000
NODE_1197_length_2136_cov_16.947472	461	541	2	5	80	0.0625000
NODE_1199_length_2133_cov_15.038840	498	578	0	30	80	0.3750000
NODE_1199_length_2133_cov_15.038840	498	578	2	50	80	0.6250000
NODE_1199_length_2133_cov_15.038840	551	631	0	36	80	0.4500000
NODE_1199_length_2133_cov_15.038840	551	631	2	44	80	0.5500000
NODE_1199_length_2133_cov_15.038840	627	707	0	80	80	1.0000000
NODE_1199_length_2133_cov_15.038840	680	722	0	42	42	1.0000000
NODE_1204_length_2128_cov_11.799409	1698	1778	0	80	80	1.0000000
NODE_1204_length_2128_cov_11.799409	1751	1831	0	80	80	1.0000000
NODE_1206_length_2126_cov_6.854465	1614	1694	0	80	80	1.0000000
NODE_1206_length_2126_cov_6.854465	1667	1747	0	80	80	1.0000000
NODE_1209_length_2123_cov_12.668478	102	143	0	31	41	0.7560976
NODE_1209_length_2123_cov_12.668478	102	143	2	10	41	0.2439024
NODE_1209_length_2123_cov_12.668478	1474	1500	0	26	26	1.0000000
NODE_1209_length_2123_cov_12.668478	1552	1601	2	25	49	0.5102041
NODE_1209_length_2123_cov_12.668478	1552	1601	4	24	49	0.4897959
NODE_1209_length_2123_cov_12.668478	1574	1654	2	3	80	0.0375000
NODE_1209_length_2123_cov_12.668478	1574	1654	4	52	80	0.6500000
NODE_1209_length_2123_cov_12.668478	1574	1654	6	25	80	0.3125000
NODE_1211_length_2121_cov_10.101879	497	577	0	80	80	1.0000000
NODE_1211_length_2121_cov_10.101879	550	630	0	80	80	1.0000000
NODE_1211_length_2121_cov_10.101879	1935	2008	2	73	73	1.0000000
NODE_1212_length_2121_cov_9.964886	1523	1603	6	22	80	0.2750000
NODE_1212_length_2121_cov_9.964886	1523	1603	8	47	80	0.5875000
NODE_1212_length_2121_cov_9.964886	1523	1603	10	5	80	0.0625000
NODE_1212_length_2121_cov_9.964886	1523	1603	12	6	80	0.0750000
NODE_1212_length_2121_cov_9.964886	1576	1656	6	27	80	0.3375000
NODE_1212_length_2121_cov_9.964886	1576	1656	8	49	80	0.6125000
NODE_1212_length_2121_cov_9.964886	1576	1656	10	1	80	0.0125000
NODE_1212_length_2121_cov_9.964886	1576	1656	12	3	80	0.0375000
NODE_1213_length_2120_cov_24.609599	25	92	0	67	67	1.0000000
NODE_1215_length_2119_cov_18.446040	366	446	0	7	80	0.0875000
NODE_1215_length_2119_cov_18.446040	366	446	2	37	80	0.4625000
NODE_1215_length_2119_cov_18.446040	366	446	4	36	80	0.4500000
NODE_1215_length_2119_cov_18.446040	419	499	0	60	80	0.7500000
NODE_1215_length_2119_cov_18.446040	419	499	2	20	80	0.2500000
NODE_1215_length_2119_cov_18.446040	1239	1319	0	49	80	0.6125000
NODE_1215_length_2119_cov_18.446040	1239	1319	4	31	80	0.3875000
NODE_1215_length_2119_cov_18.446040	1292	1372	4	80	80	1.0000000
NODE_1225_length_2110_cov_8.668324	1755	1835	0	80	80	1.0000000
NODE_1225_length_2110_cov_8.668324	1808	1888	0	80	80	1.0000000
NODE_1227_length_2106_cov_14.643747	1579	1659	0	80	80	1.0000000
NODE_1227_length_2106_cov_14.643747	1632	1712	0	62	80	0.7750000
NODE_1227_length_2106_cov_14.643747	1632	1712	2	18	80	0.2250000
NODE_1227_length_2106_cov_14.643747	1708	1786	0	13	78	0.1666667
NODE_1227_length_2106_cov_14.643747	1708	1786	2	65	78	0.8333333
NODE_1227_length_2106_cov_14.643747	1759	1839	0	66	80	0.8250000
NODE_1227_length_2106_cov_14.643747	1759	1839	2	14	80	0.1750000
NODE_1228_length_2106_cov_3.173393	48	96	0	48	48	1.0000000
NODE_1228_length_2106_cov_3.173393	48	96	0	48	48	1.0000000
NODE_1228_length_2106_cov_3.173393	48	96	0	48	48	1.0000000
NODE_1228_length_2106_cov_3.173393	48	96	0	48	48	1.0000000
NODE_1228_length_2106_cov_3.173393	48	96	0	48	48	1.0000000
NODE_1229_length_2102_cov_23.872192	390	470	0	80	80	1.0000000
NODE_1229_length_2102_cov_23.872192	443	523	0	79	80	0.9875000
NODE_1229_length_2102_cov_23.872192	443	523	2	1	80	0.0125000
NODE_1229_length_2102_cov_23.872192	519	599	0	3	80	0.0375000
NODE_1229_length_2102_cov_23.872192	519	599	2	17	80	0.2125000
NODE_1229_length_2102_cov_23.872192	519	599	5	1	80	0.0125000
NODE_1229_length_2102_cov_23.872192	519	599	6	22	80	0.2750000
NODE_1229_length_2102_cov_23.872192	519	599	8	17	80	0.2125000
NODE_1229_length_2102_cov_23.872192	519	599	10	20	80	0.2500000
NODE_1229_length_2102_cov_23.872192	572	652	6	13	80	0.1625000
NODE_1229_length_2102_cov_23.872192	572	652	8	14	80	0.1750000
NODE_1229_length_2102_cov_23.872192	572	652	10	53	80	0.6625000
NODE_1229_length_2102_cov_23.872192	1049	1101	242	3	52	0.0576923
NODE_1229_length_2102_cov_23.872192	1049	1101	244	2	52	0.0384615
NODE_1229_length_2102_cov_23.872192	1049	1101	246	1	52	0.0192308
NODE_1229_length_2102_cov_23.872192	1049	1101	250	1	52	0.0192308
NODE_1229_length_2102_cov_23.872192	1049	1101	252	1	52	0.0192308
NODE_1229_length_2102_cov_23.872192	1049	1101	254	1	52	0.0192308
NODE_1229_length_2102_cov_23.872192	1049	1101	264	1	52	0.0192308
NODE_1229_length_2102_cov_23.872192	1049	1101	268	1	52	0.0192308
NODE_1229_length_2102_cov_23.872192	1049	1101	276	1	52	0.0192308
NODE_1229_length_2102_cov_23.872192	1049	1101	280	2	52	0.0384615
NODE_1229_length_2102_cov_23.872192	1049	1101	282	1	52	0.0192308
NODE_1229_length_2102_cov_23.872192	1049	1101	286	1	52	0.0192308
NODE_1229_length_2102_cov_23.872192	1049	1101	287	1	52	0.0192308
NODE_1229_length_2102_cov_23.872192	1049	1101	292	2	52	0.0384615
NODE_1229_length_2102_cov_23.872192	1049	1101	293	1	52	0.0192308
NODE_1229_length_2102_cov_23.872192	1049	1101	294	2	52	0.0384615
NODE_1229_length_2102_cov_23.872192	1049	1101	296	1	52	0.0192308
NODE_1229_length_2102_cov_23.872192	1049	1101	311	1	52	0.0192308
NODE_1229_length_2102_cov_23.872192	1049	1101	321	1	52	0.0192308
NODE_1229_length_2102_cov_23.872192	1049	1101	323	1	52	0.0192308
NODE_1229_length_2102_cov_23.872192	1049	1101	325	2	52	0.0384615
NODE_1229_length_2102_cov_23.872192	1049	1101	326	5	52	0.0961538
NODE_1229_length_2102_cov_23.872192	1049	1101	328	3	52	0.0576923
NODE_1229_length_2102_cov_23.872192	1049	1101	329	1	52	0.0192308
NODE_1229_length_2102_cov_23.872192	1049	1101	330	2	52	0.0384615
NODE_1229_length_2102_cov_23.872192	1049	1101	332	6	52	0.1153846
NODE_1229_length_2102_cov_23.872192	1049	1101	333	1	52	0.0192308
NODE_1229_length_2102_cov_23.872192	1049	1101	334	4	52	0.0769231
NODE_1229_length_2102_cov_23.872192	1049	1101	336	2	52	0.0384615
NODE_1231_length_2100_cov_21.504248	450	530	0	80	80	1.0000000
NODE_1231_length_2100_cov_21.504248	503	578	0	75	75	1.0000000
NODE_1231_length_2100_cov_21.504248	579	659	0	41	80	0.5125000
NODE_1231_length_2100_cov_21.504248	579	659	2	39	80	0.4875000
NODE_1231_length_2100_cov_21.504248	632	712	0	36	80	0.4500000
NODE_1231_length_2100_cov_21.504248	632	712	2	44	80	0.5500000
NODE_1231_length_2100_cov_21.504248	1420	1500	0	80	80	1.0000000
NODE_1231_length_2100_cov_21.504248	1473	1553	0	80	80	1.0000000
NODE_1232_length_2100_cov_6.399300	1510	1590	0	24	80	0.3000000
NODE_1232_length_2100_cov_6.399300	1510	1590	2	56	80	0.7000000
NODE_1232_length_2100_cov_6.399300	1559	1590	2	31	31	1.0000000
NODE_1232_length_2100_cov_6.399300	1563	1644	0	17	81	0.2098765
NODE_1232_length_2100_cov_6.399300	1563	1644	2	64	81	0.7901235
NODE_1232_length_2100_cov_6.399300	1563	1644	0	17	81	0.2098765
NODE_1232_length_2100_cov_6.399300	1563	1644	2	64	81	0.7901235
NODE_1234_length_2099_cov_40.603500	960	1040	0	41	80	0.5125000
NODE_1234_length_2099_cov_40.603500	960	1040	2	39	80	0.4875000
NODE_1234_length_2099_cov_40.603500	1013	1093	0	14	80	0.1750000
NODE_1234_length_2099_cov_40.603500	1013	1093	2	66	80	0.8250000
NODE_1234_length_2099_cov_40.603500	1089	1169	2	25	80	0.3125000
NODE_1234_length_2099_cov_40.603500	1089	1169	3	2	80	0.0250000
NODE_1234_length_2099_cov_40.603500	1089	1169	4	53	80	0.6625000
NODE_1234_length_2099_cov_40.603500	1142	1222	2	33	80	0.4125000
NODE_1234_length_2099_cov_40.603500	1142	1222	3	2	80	0.0250000
NODE_1234_length_2099_cov_40.603500	1142	1222	4	45	80	0.5625000
NODE_1235_length_2098_cov_62.733867	1042	1122	2	5	80	0.0625000
NODE_1235_length_2098_cov_62.733867	1042	1122	4	15	80	0.1875000
NODE_1235_length_2098_cov_62.733867	1042	1122	6	18	80	0.2250000
NODE_1235_length_2098_cov_62.733867	1042	1122	8	42	80	0.5250000
NODE_1235_length_2098_cov_62.733867	1095	1175	0	21	80	0.2625000
NODE_1235_length_2098_cov_62.733867	1095	1175	2	14	80	0.1750000
NODE_1235_length_2098_cov_62.733867	1095	1175	6	26	80	0.3250000
NODE_1235_length_2098_cov_62.733867	1095	1175	8	19	80	0.2375000
NODE_1235_length_2098_cov_62.733867	1171	1251	0	40	80	0.5000000
NODE_1235_length_2098_cov_62.733867	1171	1251	2	40	80	0.5000000
NODE_1235_length_2098_cov_62.733867	1224	1304	2	80	80	1.0000000
NODE_1236_length_2098_cov_20.220110	550	630	0	80	80	1.0000000
NODE_1236_length_2098_cov_20.220110	603	683	0	80	80	1.0000000
NODE_1236_length_2098_cov_20.220110	1571	1651	0	70	80	0.8750000
NODE_1236_length_2098_cov_20.220110	1571	1651	2	10	80	0.1250000
NODE_1236_length_2098_cov_20.220110	1624	1704	0	17	80	0.2125000
NODE_1236_length_2098_cov_20.220110	1624	1704	2	54	80	0.6750000
NODE_1236_length_2098_cov_20.220110	1624	1704	4	9	80	0.1125000
NODE_1237_length_2098_cov_8.261631	324	404	0	17	80	0.2125000
NODE_1237_length_2098_cov_8.261631	324	404	2	63	80	0.7875000
NODE_1239_length_2095_cov_29.930862	1128	1209	119	1	81	0.0123457
NODE_1239_length_2095_cov_29.930862	1128	1209	123	1	81	0.0123457
NODE_1239_length_2095_cov_29.930862	1128	1209	130	1	81	0.0123457
NODE_1239_length_2095_cov_29.930862	1128	1209	133	1	81	0.0123457
NODE_1239_length_2095_cov_29.930862	1128	1209	139	1	81	0.0123457
NODE_1239_length_2095_cov_29.930862	1128	1209	145	1	81	0.0123457
NODE_1239_length_2095_cov_29.930862	1128	1209	151	1	81	0.0123457
NODE_1239_length_2095_cov_29.930862	1128	1209	153	1	81	0.0123457
NODE_1239_length_2095_cov_29.930862	1128	1209	158	1	81	0.0123457
NODE_1239_length_2095_cov_29.930862	1128	1209	163	1	81	0.0123457
NODE_1239_length_2095_cov_29.930862	1128	1209	169	1	81	0.0123457
NODE_1239_length_2095_cov_29.930862	1128	1209	182	1	81	0.0123457
NODE_1239_length_2095_cov_29.930862	1128	1209	187	1	81	0.0123457
NODE_1239_length_2095_cov_29.930862	1128	1209	189	1	81	0.0123457
NODE_1239_length_2095_cov_29.930862	1128	1209	193	2	81	0.0246914
NODE_1239_length_2095_cov_29.930862	1128	1209	199	1	81	0.0123457
NODE_1239_length_2095_cov_29.930862	1128	1209	200	2	81	0.0246914
NODE_1239_length_2095_cov_29.930862	1128	1209	203	1	81	0.0123457
NODE_1239_length_2095_cov_29.930862	1128	1209	205	1	81	0.0123457
NODE_1239_length_2095_cov_29.930862	1128	1209	211	2	81	0.0246914
NODE_1239_length_2095_cov_29.930862	1128	1209	218	1	81	0.0123457
NODE_1239_length_2095_cov_29.930862	1128	1209	223	1	81	0.0123457
NODE_1239_length_2095_cov_29.930862	1128	1209	224	1	81	0.0123457
NODE_1239_length_2095_cov_29.930862	1128	1209	226	1	81	0.0123457
NODE_1239_length_2095_cov_29.930862	1128	1209	227	1	81	0.0123457
NODE_1239_length_2095_cov_29.930862	1128	1209	228	1	81	0.0123457
NODE_1239_length_2095_cov_29.930862	1128	1209	229	1	81	0.0123457
NODE_1239_length_2095_cov_29.930862	1128	1209	235	2	81	0.0246914
NODE_1239_length_2095_cov_29.930862	1128	1209	244	1	81	0.0123457
NODE_1239_length_2095_cov_29.930862	1128	1209	252	1	81	0.0123457
NODE_1239_length_2095_cov_29.930862	1128	1209	255	1	81	0.0123457
NODE_1239_length_2095_cov_29.930862	1128	1209	257	1	81	0.0123457
NODE_1239_length_2095_cov_29.930862	1128	1209	277	1	81	0.0123457
NODE_1239_length_2095_cov_29.930862	1128	1209	280	1	81	0.0123457
NODE_1239_length_2095_cov_29.930862	1128	1209	282	1	81	0.0123457
NODE_1239_length_2095_cov_29.930862	1128	1209	287	1	81	0.0123457
NODE_1239_length_2095_cov_29.930862	1128	1209	294	1	81	0.0123457
NODE_1239_length_2095_cov_29.930862	1128	1209	298	1	81	0.0123457
NODE_1239_length_2095_cov_29.930862	1128	1209	310	1	81	0.0123457
NODE_1239_length_2095_cov_29.930862	1128	1209	314	2	81	0.0246914
NODE_1239_length_2095_cov_29.930862	1128	1209	316	1	81	0.0123457
NODE_1239_length_2095_cov_29.930862	1128	1209	326	1	81	0.0123457
NODE_1239_length_2095_cov_29.930862	1128	1209	330	1	81	0.0123457
NODE_1239_length_2095_cov_29.930862	1128	1209	336	1	81	0.0123457
NODE_1239_length_2095_cov_29.930862	1128	1209	339	1	81	0.0123457
NODE_1239_length_2095_cov_29.930862	1128	1209	341	1	81	0.0123457
NODE_1239_length_2095_cov_29.930862	1128	1209	348	1	81	0.0123457
NODE_1239_length_2095_cov_29.930862	1128	1209	357	1	81	0.0123457
NODE_1239_length_2095_cov_29.930862	1128	1209	359	2	81	0.0246914
NODE_1239_length_2095_cov_29.930862	1128	1209	361	1	81	0.0123457
NODE_1239_length_2095_cov_29.930862	1128	1209	365	1	81	0.0123457
NODE_1239_length_2095_cov_29.930862	1128	1209	375	1	81	0.0123457
NODE_1239_length_2095_cov_29.930862	1128	1209	379	1	81	0.0123457
NODE_1239_length_2095_cov_29.930862	1128	1209	390	1	81	0.0123457
NODE_1239_length_2095_cov_29.930862	1128	1209	396	1	81	0.0123457
NODE_1239_length_2095_cov_29.930862	1128	1209	398	2	81	0.0246914
NODE_1239_length_2095_cov_29.930862	1128	1209	402	1	81	0.0123457
NODE_1239_length_2095_cov_29.930862	1128	1209	408	1	81	0.0123457
NODE_1239_length_2095_cov_29.930862	1128	1209	422	1	81	0.0123457
NODE_1239_length_2095_cov_29.930862	1128	1209	427	1	81	0.0123457
NODE_1239_length_2095_cov_29.930862	1128	1209	431	1	81	0.0123457
NODE_1239_length_2095_cov_29.930862	1128	1209	433	1	81	0.0123457
NODE_1239_length_2095_cov_29.930862	1128	1209	437	2	81	0.0246914
NODE_1239_length_2095_cov_29.930862	1128	1209	441	1	81	0.0123457
NODE_1239_length_2095_cov_29.930862	1128	1209	444	1	81	0.0123457
NODE_1239_length_2095_cov_29.930862	1128	1209	448	1	81	0.0123457
NODE_1239_length_2095_cov_29.930862	1128	1209	452	1	81	0.0123457
NODE_1239_length_2095_cov_29.930862	1128	1209	456	1	81	0.0123457
NODE_1239_length_2095_cov_29.930862	1128	1209	464	1	81	0.0123457
NODE_1239_length_2095_cov_29.930862	1128	1209	466	1	81	0.0123457
NODE_1239_length_2095_cov_29.930862	1128	1209	469	1	81	0.0123457
NODE_1239_length_2095_cov_29.930862	1128	1209	471	2	81	0.0246914
NODE_1239_length_2095_cov_29.930862	1204	1258	411	1	54	0.0185185
NODE_1239_length_2095_cov_29.930862	1204	1258	415	1	54	0.0185185
NODE_1239_length_2095_cov_29.930862	1204	1258	417	1	54	0.0185185
NODE_1239_length_2095_cov_29.930862	1204	1258	421	1	54	0.0185185
NODE_1239_length_2095_cov_29.930862	1204	1258	422	1	54	0.0185185
NODE_1239_length_2095_cov_29.930862	1204	1258	423	1	54	0.0185185
NODE_1239_length_2095_cov_29.930862	1204	1258	424	2	54	0.0370370
NODE_1239_length_2095_cov_29.930862	1204	1258	428	1	54	0.0185185
NODE_1239_length_2095_cov_29.930862	1204	1258	434	1	54	0.0185185
NODE_1239_length_2095_cov_29.930862	1204	1258	450	1	54	0.0185185
NODE_1239_length_2095_cov_29.930862	1204	1258	451	2	54	0.0370370
NODE_1239_length_2095_cov_29.930862	1204	1258	454	1	54	0.0185185
NODE_1239_length_2095_cov_29.930862	1204	1258	455	1	54	0.0185185
NODE_1239_length_2095_cov_29.930862	1204	1258	462	2	54	0.0370370
NODE_1239_length_2095_cov_29.930862	1204	1258	464	3	54	0.0555556
NODE_1239_length_2095_cov_29.930862	1204	1258	466	3	54	0.0555556
NODE_1239_length_2095_cov_29.930862	1204	1258	468	2	54	0.0370370
NODE_1239_length_2095_cov_29.930862	1204	1258	469	4	54	0.0740741
NODE_1239_length_2095_cov_29.930862	1204	1258	470	2	54	0.0370370
NODE_1239_length_2095_cov_29.930862	1204	1258	471	4	54	0.0740741
NODE_1239_length_2095_cov_29.930862	1204	1258	472	2	54	0.0370370
NODE_1239_length_2095_cov_29.930862	1204	1258	473	4	54	0.0740741
NODE_1239_length_2095_cov_29.930862	1204	1258	475	1	54	0.0185185
NODE_1239_length_2095_cov_29.930862	1204	1258	477	5	54	0.0925926
NODE_1239_length_2095_cov_29.930862	1204	1258	478	1	54	0.0185185
NODE_1239_length_2095_cov_29.930862	1204	1258	479	3	54	0.0555556
NODE_1239_length_2095_cov_29.930862	1204	1258	480	1	54	0.0185185
NODE_1239_length_2095_cov_29.930862	1204	1258	481	1	54	0.0185185
NODE_1239_length_2095_cov_29.930862	1204	1258	483	1	54	0.0185185
NODE_1251_length_2084_cov_1.720403	959	1039	3	2	80	0.0250000
NODE_1251_length_2084_cov_1.720403	959	1039	4	8	80	0.1000000
NODE_1251_length_2084_cov_1.720403	959	1039	5	16	80	0.2000000
NODE_1251_length_2084_cov_1.720403	959	1039	6	54	80	0.6750000
NODE_1251_length_2084_cov_1.720403	1012	1092	0	9	80	0.1125000
NODE_1251_length_2084_cov_1.720403	1012	1092	1	18	80	0.2250000
NODE_1251_length_2084_cov_1.720403	1012	1092	3	27	80	0.3375000
NODE_1251_length_2084_cov_1.720403	1012	1092	5	16	80	0.2000000
NODE_1251_length_2084_cov_1.720403	1012	1092	6	10	80	0.1250000
NODE_1252_length_2083_cov_5.864415	419	499	0	80	80	1.0000000
NODE_1252_length_2083_cov_5.864415	472	552	0	71	80	0.8875000
NODE_1252_length_2083_cov_5.864415	472	552	2	9	80	0.1125000
NODE_1252_length_2083_cov_5.864415	548	628	0	10	80	0.1250000
NODE_1252_length_2083_cov_5.864415	548	628	2	70	80	0.8750000
NODE_1252_length_2083_cov_5.864415	601	681	0	63	80	0.7875000
NODE_1252_length_2083_cov_5.864415	601	681	2	17	80	0.2125000
NODE_1256_length_2078_cov_47.394644	311	391	2	15	80	0.1875000
NODE_1256_length_2078_cov_47.394644	311	391	4	26	80	0.3250000
NODE_1256_length_2078_cov_47.394644	311	391	6	39	80	0.4875000
NODE_1256_length_2078_cov_47.394644	364	444	2	43	80	0.5375000
NODE_1256_length_2078_cov_47.394644	364	444	4	12	80	0.1500000
NODE_1256_length_2078_cov_47.394644	364	444	6	25	80	0.3125000
NODE_1256_length_2078_cov_47.394644	440	520	0	4	80	0.0500000
NODE_1256_length_2078_cov_47.394644	440	520	2	59	80	0.7375000
NODE_1256_length_2078_cov_47.394644	440	520	4	17	80	0.2125000
NODE_1256_length_2078_cov_47.394644	493	573	2	10	80	0.1250000
NODE_1256_length_2078_cov_47.394644	493	573	4	70	80	0.8750000
NODE_1267_length_2067_cov_13.647866	1349	1429	0	43	80	0.5375000
NODE_1267_length_2067_cov_13.647866	1349	1429	2	37	80	0.4625000
NODE_1267_length_2067_cov_13.647866	1402	1482	2	34	80	0.4250000
NODE_1267_length_2067_cov_13.647866	1402	1482	4	46	80	0.5750000
NODE_1269_length_2066_cov_19.127605	1497	1577	4	6	80	0.0750000
NODE_1269_length_2066_cov_19.127605	1497	1577	6	1	80	0.0125000
NODE_1269_length_2066_cov_19.127605	1497	1577	10	3	80	0.0375000
NODE_1269_length_2066_cov_19.127605	1497	1577	12	11	80	0.1375000
NODE_1269_length_2066_cov_19.127605	1497	1577	14	1	80	0.0125000
NODE_1269_length_2066_cov_19.127605	1497	1577	16	2	80	0.0250000
NODE_1269_length_2066_cov_19.127605	1497	1577	18	1	80	0.0125000
NODE_1269_length_2066_cov_19.127605	1497	1577	21	1	80	0.0125000
NODE_1269_length_2066_cov_19.127605	1497	1577	22	4	80	0.0500000
NODE_1269_length_2066_cov_19.127605	1497	1577	24	11	80	0.1375000
NODE_1269_length_2066_cov_19.127605	1497	1577	26	12	80	0.1500000
NODE_1269_length_2066_cov_19.127605	1497	1577	28	7	80	0.0875000
NODE_1269_length_2066_cov_19.127605	1497	1577	30	20	80	0.2500000
NODE_1269_length_2066_cov_19.127605	1550	1630	8	2	80	0.0250000
NODE_1269_length_2066_cov_19.127605	1550	1630	10	8	80	0.1000000
NODE_1269_length_2066_cov_19.127605	1550	1630	12	5	80	0.0625000
NODE_1269_length_2066_cov_19.127605	1550	1630	14	6	80	0.0750000
NODE_1269_length_2066_cov_19.127605	1550	1630	16	4	80	0.0500000
NODE_1269_length_2066_cov_19.127605	1550	1630	18	1	80	0.0125000
NODE_1269_length_2066_cov_19.127605	1550	1630	22	6	80	0.0750000
NODE_1269_length_2066_cov_19.127605	1550	1630	24	8	80	0.1000000
NODE_1269_length_2066_cov_19.127605	1550	1630	26	1	80	0.0125000
NODE_1269_length_2066_cov_19.127605	1550	1630	28	16	80	0.2000000
NODE_1269_length_2066_cov_19.127605	1550	1630	30	23	80	0.2875000
NODE_1274_length_2061_cov_43.187054	364	444	0	80	80	1.0000000
NODE_1274_length_2061_cov_43.187054	417	497	0	80	80	1.0000000
NODE_1275_length_2061_cov_3.251784	981	1033	0	52	52	1.0000000
NODE_1275_length_2061_cov_3.251784	1006	1086	0	80	80	1.0000000
NODE_1277_length_2058_cov_4.531394	1844	1875	2	13	31	0.4193548
NODE_1277_length_2058_cov_4.531394	1844	1875	4	18	31	0.5806451
NODE_1277_length_2058_cov_4.531394	1848	1928	2	15	80	0.1875000
NODE_1277_length_2058_cov_4.531394	1848	1928	4	62	80	0.7750000
NODE_1277_length_2058_cov_4.531394	1848	1928	6	3	80	0.0375000
NODE_1279_length_2056_cov_20.525805	749	829	0	80	80	1.0000000
NODE_1279_length_2056_cov_20.525805	802	882	0	33	80	0.4125000
NODE_1279_length_2056_cov_20.525805	802	882	2	32	80	0.4000000
NODE_1279_length_2056_cov_20.525805	802	882	4	15	80	0.1875000
NODE_1279_length_2056_cov_20.525805	878	958	2	58	80	0.7250000
NODE_1279_length_2056_cov_20.525805	878	958	4	22	80	0.2750000
NODE_1279_length_2056_cov_20.525805	931	1011	0	51	80	0.6375000
NODE_1279_length_2056_cov_20.525805	931	1011	2	29	80	0.3625000
NODE_1281_length_2055_cov_10.047546	1468	1548	0	80	80	1.0000000
NODE_1281_length_2055_cov_10.047546	1521	1601	0	80	80	1.0000000
NODE_1286_length_2049_cov_6.846154	270	350	0	80	80	1.0000000
NODE_1286_length_2049_cov_6.846154	323	403	0	80	80	1.0000000
NODE_1286_length_2049_cov_6.846154	1595	1674	0	79	79	1.0000000
NODE_1286_length_2049_cov_6.846154	1648	1712	0	64	64	1.0000000
NODE_1293_length_2045_cov_46.790339	876	956	6	26	80	0.3250000
NODE_1293_length_2045_cov_46.790339	876	956	8	49	80	0.6125000
NODE_1293_length_2045_cov_46.790339	876	956	10	5	80	0.0625000
NODE_1293_length_2045_cov_46.790339	929	1009	2	18	80	0.2250000
NODE_1293_length_2045_cov_46.790339	929	1009	4	27	80	0.3375000
NODE_1293_length_2045_cov_46.790339	929	1009	6	22	80	0.2750000
NODE_1293_length_2045_cov_46.790339	929	1009	8	8	80	0.1000000
NODE_1293_length_2045_cov_46.790339	929	1009	10	5	80	0.0625000
NODE_1293_length_2045_cov_46.790339	1005	1085	2	21	80	0.2625000
NODE_1293_length_2045_cov_46.790339	1005	1085	4	1	80	0.0125000
NODE_1293_length_2045_cov_46.790339	1005	1085	6	22	80	0.2750000
NODE_1293_length_2045_cov_46.790339	1005	1085	8	36	80	0.4500000
NODE_1293_length_2045_cov_46.790339	1058	1138	0	1	80	0.0125000
NODE_1293_length_2045_cov_46.790339	1058	1138	2	10	80	0.1250000
NODE_1293_length_2045_cov_46.790339	1058	1138	4	14	80	0.1750000
NODE_1293_length_2045_cov_46.790339	1058	1138	6	15	80	0.1875000
NODE_1293_length_2045_cov_46.790339	1058	1138	8	40	80	0.5000000
NODE_1298_length_2042_cov_4.447761	241	315	4	12	74	0.1621622
NODE_1298_length_2042_cov_4.447761	241	315	6	62	74	0.8378378
NODE_1301_length_2040_cov_30.109737	1760	1844	72	3	84	0.0357143
NODE_1301_length_2040_cov_30.109737	1760	1844	78	10	84	0.1190476
NODE_1301_length_2040_cov_30.109737	1760	1844	79	1	84	0.0119048
NODE_1301_length_2040_cov_30.109737	1760	1844	80	1	84	0.0119048
NODE_1301_length_2040_cov_30.109737	1760	1844	81	2	84	0.0238095
NODE_1301_length_2040_cov_30.109737	1760	1844	82	1	84	0.0119048
NODE_1301_length_2040_cov_30.109737	1760	1844	83	2	84	0.0238095
NODE_1301_length_2040_cov_30.109737	1760	1844	89	1	84	0.0119048
NODE_1301_length_2040_cov_30.109737	1760	1844	91	1	84	0.0119048
NODE_1301_length_2040_cov_30.109737	1760	1844	93	4	84	0.0476190
NODE_1301_length_2040_cov_30.109737	1760	1844	97	1	84	0.0119048
NODE_1301_length_2040_cov_30.109737	1760	1844	101	1	84	0.0119048
NODE_1301_length_2040_cov_30.109737	1760	1844	103	1	84	0.0119048
NODE_1301_length_2040_cov_30.109737	1760	1844	104	4	84	0.0476190
NODE_1301_length_2040_cov_30.109737	1760	1844	106	1	84	0.0119048
NODE_1301_length_2040_cov_30.109737	1760	1844	107	1	84	0.0119048
NODE_1301_length_2040_cov_30.109737	1760	1844	111	1	84	0.0119048
NODE_1301_length_2040_cov_30.109737	1760	1844	117	1	84	0.0119048
NODE_1301_length_2040_cov_30.109737	1760	1844	121	2	84	0.0238095
NODE_1301_length_2040_cov_30.109737	1760	1844	125	2	84	0.0238095
NODE_1301_length_2040_cov_30.109737	1760	1844	127	3	84	0.0357143
NODE_1301_length_2040_cov_30.109737	1760	1844	129	1	84	0.0119048
NODE_1301_length_2040_cov_30.109737	1760	1844	131	1	84	0.0119048
NODE_1301_length_2040_cov_30.109737	1760	1844	133	3	84	0.0357143
NODE_1301_length_2040_cov_30.109737	1760	1844	135	1	84	0.0119048
NODE_1301_length_2040_cov_30.109737	1760	1844	137	1	84	0.0119048
NODE_1301_length_2040_cov_30.109737	1760	1844	139	2	84	0.0238095
NODE_1301_length_2040_cov_30.109737	1760	1844	141	2	84	0.0238095
NODE_1301_length_2040_cov_30.109737	1760	1844	144	1	84	0.0119048
NODE_1301_length_2040_cov_30.109737	1760	1844	145	1	84	0.0119048
NODE_1301_length_2040_cov_30.109737	1760	1844	147	1	84	0.0119048
NODE_1301_length_2040_cov_30.109737	1760	1844	149	3	84	0.0357143
NODE_1301_length_2040_cov_30.109737	1760	1844	151	2	84	0.0238095
NODE_1301_length_2040_cov_30.109737	1760	1844	155	1	84	0.0119048
NODE_1301_length_2040_cov_30.109737	1760	1844	157	1	84	0.0119048
NODE_1301_length_2040_cov_30.109737	1760	1844	158	3	84	0.0357143
NODE_1301_length_2040_cov_30.109737	1760	1844	159	4	84	0.0476190
NODE_1301_length_2040_cov_30.109737	1760	1844	160	3	84	0.0357143
NODE_1301_length_2040_cov_30.109737	1760	1844	161	2	84	0.0238095
NODE_1301_length_2040_cov_30.109737	1760	1844	162	4	84	0.0476190
NODE_1301_length_2040_cov_30.109737	1760	1844	163	1	84	0.0119048
NODE_1301_length_2040_cov_30.109737	1760	1844	164	1	84	0.0119048
NODE_1301_length_2040_cov_30.109737	1760	1844	165	1	84	0.0119048
NODE_1306_length_2036_cov_11.672173	369	449	0	80	80	1.0000000
NODE_1306_length_2036_cov_11.672173	422	502	0	80	80	1.0000000
NODE_1312_length_2032_cov_11.188308	416	496	0	80	80	1.0000000
NODE_1312_length_2032_cov_11.188308	469	549	0	80	80	1.0000000
NODE_1318_length_2027_cov_43.702282	1129	1209	6	50	80	0.6250000
NODE_1318_length_2027_cov_43.702282	1129	1209	8	30	80	0.3750000
NODE_1318_length_2027_cov_43.702282	1182	1262	0	2	80	0.0250000
NODE_1318_length_2027_cov_43.702282	1182	1262	2	11	80	0.1375000
NODE_1318_length_2027_cov_43.702282	1182	1262	6	3	80	0.0375000
NODE_1318_length_2027_cov_43.702282	1182	1262	8	64	80	0.8000000
NODE_1318_length_2027_cov_43.702282	1258	1338	0	22	80	0.2750000
NODE_1318_length_2027_cov_43.702282	1258	1338	2	45	80	0.5625000
NODE_1318_length_2027_cov_43.702282	1258	1338	4	13	80	0.1625000
NODE_1318_length_2027_cov_43.702282	1311	1391	2	36	80	0.4500000
NODE_1318_length_2027_cov_43.702282	1311	1391	4	44	80	0.5500000
NODE_1319_length_2027_cov_6.558610	229	303	4	74	74	1.0000000
NODE_1319_length_2027_cov_6.558610	229	303	4	74	74	1.0000000
NODE_1319_length_2027_cov_6.558610	276	356	2	4	80	0.0500000
NODE_1319_length_2027_cov_6.558610	276	356	4	76	80	0.9500000
NODE_1320_length_2026_cov_18.457706	688	768	0	40	80	0.5000000
NODE_1320_length_2026_cov_18.457706	688	768	2	40	80	0.5000000
NODE_1320_length_2026_cov_18.457706	741	821	0	23	80	0.2875000
NODE_1320_length_2026_cov_18.457706	741	821	2	57	80	0.7125000
NODE_1324_length_2025_cov_10.711319	617	697	0	10	80	0.1250000
NODE_1324_length_2025_cov_10.711319	617	697	2	70	80	0.8750000
NODE_1324_length_2025_cov_10.711319	712	783	0	71	71	1.0000000
NODE_1324_length_2025_cov_10.711319	756	829	0	73	73	1.0000000
NODE_1325_length_2024_cov_33.891948	1045	1125	0	80	80	1.0000000
NODE_1325_length_2024_cov_33.891948	1098	1178	0	80	80	1.0000000
NODE_1331_length_2018_cov_33.742053	1215	1295	64	5	80	0.0625000
NODE_1331_length_2018_cov_33.742053	1215	1295	66	2	80	0.0250000
NODE_1331_length_2018_cov_33.742053	1215	1295	67	2	80	0.0250000
NODE_1331_length_2018_cov_33.742053	1215	1295	68	1	80	0.0125000
NODE_1331_length_2018_cov_33.742053	1215	1295	69	1	80	0.0125000
NODE_1331_length_2018_cov_33.742053	1215	1295	72	1	80	0.0125000
NODE_1331_length_2018_cov_33.742053	1215	1295	74	1	80	0.0125000
NODE_1331_length_2018_cov_33.742053	1215	1295	76	2	80	0.0250000
NODE_1331_length_2018_cov_33.742053	1215	1295	78	2	80	0.0250000
NODE_1331_length_2018_cov_33.742053	1215	1295	80	2	80	0.0250000
NODE_1331_length_2018_cov_33.742053	1215	1295	88	5	80	0.0625000
NODE_1331_length_2018_cov_33.742053	1215	1295	90	8	80	0.1000000
NODE_1331_length_2018_cov_33.742053	1215	1295	92	2	80	0.0250000
NODE_1331_length_2018_cov_33.742053	1215	1295	94	5	80	0.0625000
NODE_1331_length_2018_cov_33.742053	1215	1295	95	1	80	0.0125000
NODE_1331_length_2018_cov_33.742053	1215	1295	96	3	80	0.0375000
NODE_1331_length_2018_cov_33.742053	1215	1295	97	7	80	0.0875000
NODE_1331_length_2018_cov_33.742053	1215	1295	98	4	80	0.0500000
NODE_1331_length_2018_cov_33.742053	1215	1295	99	5	80	0.0625000
NODE_1331_length_2018_cov_33.742053	1215	1295	100	5	80	0.0625000
NODE_1331_length_2018_cov_33.742053	1215	1295	101	5	80	0.0625000
NODE_1331_length_2018_cov_33.742053	1215	1295	102	1	80	0.0125000
NODE_1331_length_2018_cov_33.742053	1215	1295	104	5	80	0.0625000
NODE_1331_length_2018_cov_33.742053	1215	1295	106	5	80	0.0625000
NODE_1331_length_2018_cov_33.742053	1268	1298	95	1	30	0.0333333
NODE_1331_length_2018_cov_33.742053	1268	1298	97	6	30	0.2000000
NODE_1331_length_2018_cov_33.742053	1268	1298	99	1	30	0.0333333
NODE_1331_length_2018_cov_33.742053	1268	1298	100	5	30	0.1666667
NODE_1331_length_2018_cov_33.742053	1268	1298	101	3	30	0.1000000
NODE_1331_length_2018_cov_33.742053	1268	1298	102	1	30	0.0333333
NODE_1331_length_2018_cov_33.742053	1268	1298	104	6	30	0.2000000
NODE_1331_length_2018_cov_33.742053	1268	1298	106	6	30	0.2000000
NODE_1331_length_2018_cov_33.742053	1268	1298	108	1	30	0.0333333
NODE_1331_length_2018_cov_33.742053	1876	1942	38	3	66	0.0454545
NODE_1331_length_2018_cov_33.742053	1876	1942	39	1	66	0.0151515
NODE_1331_length_2018_cov_33.742053	1876	1942	41	1	66	0.0151515
NODE_1331_length_2018_cov_33.742053	1876	1942	47	1	66	0.0151515
NODE_1331_length_2018_cov_33.742053	1876	1942	49	1	66	0.0151515
NODE_1331_length_2018_cov_33.742053	1876	1942	60	1	66	0.0151515
NODE_1331_length_2018_cov_33.742053	1876	1942	63	1	66	0.0151515
NODE_1331_length_2018_cov_33.742053	1876	1942	72	1	66	0.0151515
NODE_1331_length_2018_cov_33.742053	1876	1942	74	3	66	0.0454545
NODE_1331_length_2018_cov_33.742053	1876	1942	78	1	66	0.0151515
NODE_1331_length_2018_cov_33.742053	1876	1942	84	1	66	0.0151515
NODE_1331_length_2018_cov_33.742053	1876	1942	86	1	66	0.0151515
NODE_1331_length_2018_cov_33.742053	1876	1942	90	2	66	0.0303030
NODE_1331_length_2018_cov_33.742053	1876	1942	91	1	66	0.0151515
NODE_1331_length_2018_cov_33.742053	1876	1942	92	1	66	0.0151515
NODE_1331_length_2018_cov_33.742053	1876	1942	93	4	66	0.0606061
NODE_1331_length_2018_cov_33.742053	1876	1942	95	1	66	0.0151515
NODE_1331_length_2018_cov_33.742053	1876	1942	97	3	66	0.0454545
NODE_1331_length_2018_cov_33.742053	1876	1942	121	1	66	0.0151515
NODE_1331_length_2018_cov_33.742053	1876	1942	123	1	66	0.0151515
NODE_1331_length_2018_cov_33.742053	1876	1942	130	1	66	0.0151515
NODE_1331_length_2018_cov_33.742053	1876	1942	135	1	66	0.0151515
NODE_1331_length_2018_cov_33.742053	1876	1942	141	1	66	0.0151515
NODE_1331_length_2018_cov_33.742053	1876	1942	145	1	66	0.0151515
NODE_1331_length_2018_cov_33.742053	1876	1942	153	1	66	0.0151515
NODE_1331_length_2018_cov_33.742053	1876	1942	155	1	66	0.0151515
NODE_1331_length_2018_cov_33.742053	1876	1942	161	1	66	0.0151515
NODE_1331_length_2018_cov_33.742053	1876	1942	162	1	66	0.0151515
NODE_1331_length_2018_cov_33.742053	1876	1942	177	2	66	0.0303030
NODE_1331_length_2018_cov_33.742053	1876	1942	183	2	66	0.0303030
NODE_1331_length_2018_cov_33.742053	1876	1942	191	1	66	0.0151515
NODE_1331_length_2018_cov_33.742053	1876	1942	197	1	66	0.0151515
NODE_1331_length_2018_cov_33.742053	1876	1942	201	1	66	0.0151515
NODE_1331_length_2018_cov_33.742053	1876	1942	205	1	66	0.0151515
NODE_1331_length_2018_cov_33.742053	1876	1942	209	1	66	0.0151515
NODE_1331_length_2018_cov_33.742053	1876	1942	221	1	66	0.0151515
NODE_1331_length_2018_cov_33.742053	1876	1942	223	1	66	0.0151515
NODE_1331_length_2018_cov_33.742053	1876	1942	227	1	66	0.0151515
NODE_1331_length_2018_cov_33.742053	1876	1942	231	1	66	0.0151515
NODE_1331_length_2018_cov_33.742053	1876	1942	245	1	66	0.0151515
NODE_1331_length_2018_cov_33.742053	1876	1942	247	1	66	0.0151515
NODE_1331_length_2018_cov_33.742053	1876	1942	249	1	66	0.0151515
NODE_1331_length_2018_cov_33.742053	1876	1942	255	1	66	0.0151515
NODE_1331_length_2018_cov_33.742053	1876	1942	259	2	66	0.0303030
NODE_1331_length_2018_cov_33.742053	1876	1942	261	1	66	0.0151515
NODE_1331_length_2018_cov_33.742053	1876	1942	262	3	66	0.0454545
NODE_1331_length_2018_cov_33.742053	1876	1942	263	1	66	0.0151515
NODE_1331_length_2018_cov_33.742053	1876	1942	264	1	66	0.0151515
NODE_1331_length_2018_cov_33.742053	1876	1942	276	1	66	0.0151515
NODE_1331_length_2018_cov_33.742053	1876	1942	278	1	66	0.0151515
NODE_1331_length_2018_cov_33.742053	1876	1942	282	1	66	0.0151515
NODE_1331_length_2018_cov_33.742053	1915	1995	0	9	80	0.1125000
NODE_1331_length_2018_cov_33.742053	1915	1995	2	4	80	0.0500000
NODE_1331_length_2018_cov_33.742053	1915	1995	4	5	80	0.0625000
NODE_1331_length_2018_cov_33.742053	1915	1995	5	3	80	0.0375000
NODE_1331_length_2018_cov_33.742053	1915	1995	6	5	80	0.0625000
NODE_1331_length_2018_cov_33.742053	1915	1995	8	3	80	0.0375000
NODE_1331_length_2018_cov_33.742053	1915	1995	10	3	80	0.0375000
NODE_1331_length_2018_cov_33.742053	1915	1995	16	1	80	0.0125000
NODE_1331_length_2018_cov_33.742053	1915	1995	20	2	80	0.0250000
NODE_1331_length_2018_cov_33.742053	1915	1995	22	3	80	0.0375000
NODE_1331_length_2018_cov_33.742053	1915	1995	24	5	80	0.0625000
NODE_1331_length_2018_cov_33.742053	1915	1995	26	1	80	0.0125000
NODE_1331_length_2018_cov_33.742053	1915	1995	30	1	80	0.0125000
NODE_1331_length_2018_cov_33.742053	1915	1995	35	1	80	0.0125000
NODE_1331_length_2018_cov_33.742053	1915	1995	36	5	80	0.0625000
NODE_1331_length_2018_cov_33.742053	1915	1995	38	5	80	0.0625000
NODE_1331_length_2018_cov_33.742053	1915	1995	39	1	80	0.0125000
NODE_1331_length_2018_cov_33.742053	1915	1995	41	1	80	0.0125000
NODE_1331_length_2018_cov_33.742053	1915	1995	47	1	80	0.0125000
NODE_1331_length_2018_cov_33.742053	1915	1995	49	1	80	0.0125000
NODE_1331_length_2018_cov_33.742053	1915	1995	60	1	80	0.0125000
NODE_1331_length_2018_cov_33.742053	1915	1995	63	1	80	0.0125000
NODE_1331_length_2018_cov_33.742053	1915	1995	72	1	80	0.0125000
NODE_1331_length_2018_cov_33.742053	1915	1995	74	3	80	0.0375000
NODE_1331_length_2018_cov_33.742053	1915	1995	78	1	80	0.0125000
NODE_1331_length_2018_cov_33.742053	1915	1995	84	1	80	0.0125000
NODE_1331_length_2018_cov_33.742053	1915	1995	86	1	80	0.0125000
NODE_1331_length_2018_cov_33.742053	1915	1995	90	2	80	0.0250000
NODE_1331_length_2018_cov_33.742053	1915	1995	91	1	80	0.0125000
NODE_1331_length_2018_cov_33.742053	1915	1995	92	1	80	0.0125000
NODE_1331_length_2018_cov_33.742053	1915	1995	93	4	80	0.0500000
NODE_1331_length_2018_cov_33.742053	1915	1995	95	1	80	0.0125000
NODE_1331_length_2018_cov_33.742053	1915	1995	97	2	80	0.0250000
NODE_1337_length_2011_cov_22.430439	434	514	0	80	80	1.0000000
NODE_1337_length_2011_cov_22.430439	487	567	0	80	80	1.0000000
NODE_1337_length_2011_cov_22.430439	1124	1204	0	11	80	0.1375000
NODE_1337_length_2011_cov_22.430439	1124	1204	2	27	80	0.3375000
NODE_1337_length_2011_cov_22.430439	1124	1204	4	40	80	0.5000000
NODE_1337_length_2011_cov_22.430439	1124	1204	6	2	80	0.0250000
NODE_1337_length_2011_cov_22.430439	1177	1257	2	10	80	0.1250000
NODE_1337_length_2011_cov_22.430439	1177	1257	4	56	80	0.7000000
NODE_1337_length_2011_cov_22.430439	1177	1257	6	14	80	0.1750000
NODE_1343_length_2001_cov_10.416404	692	772	0	25	80	0.3125000
NODE_1343_length_2001_cov_10.416404	692	772	4	55	80	0.6875000
NODE_1343_length_2001_cov_10.416404	745	825	0	33	80	0.4125000
NODE_1343_length_2001_cov_10.416404	745	825	4	47	80	0.5875000
NODE_1350_length_1991_cov_112.926533	212	292	122	1	80	0.0125000
NODE_1350_length_1991_cov_112.926533	212	292	124	2	80	0.0250000
NODE_1350_length_1991_cov_112.926533	212	292	126	3	80	0.0375000
NODE_1350_length_1991_cov_112.926533	212	292	127	1	80	0.0125000
NODE_1350_length_1991_cov_112.926533	212	292	128	1	80	0.0125000
NODE_1350_length_1991_cov_112.926533	212	292	130	3	80	0.0375000
NODE_1350_length_1991_cov_112.926533	212	292	133	1	80	0.0125000
NODE_1350_length_1991_cov_112.926533	212	292	135	3	80	0.0375000
NODE_1350_length_1991_cov_112.926533	212	292	136	4	80	0.0500000
NODE_1350_length_1991_cov_112.926533	212	292	138	2	80	0.0250000
NODE_1350_length_1991_cov_112.926533	212	292	139	1	80	0.0125000
NODE_1350_length_1991_cov_112.926533	212	292	142	2	80	0.0250000
NODE_1350_length_1991_cov_112.926533	212	292	144	1	80	0.0125000
NODE_1350_length_1991_cov_112.926533	212	292	145	1	80	0.0125000
NODE_1350_length_1991_cov_112.926533	212	292	146	1	80	0.0125000
NODE_1350_length_1991_cov_112.926533	212	292	148	9	80	0.1125000
NODE_1350_length_1991_cov_112.926533	212	292	149	3	80	0.0375000
NODE_1350_length_1991_cov_112.926533	212	292	151	1	80	0.0125000
NODE_1350_length_1991_cov_112.926533	212	292	153	3	80	0.0375000
NODE_1350_length_1991_cov_112.926533	212	292	155	4	80	0.0500000
NODE_1350_length_1991_cov_112.926533	212	292	157	10	80	0.1250000
NODE_1350_length_1991_cov_112.926533	212	292	159	2	80	0.0250000
NODE_1350_length_1991_cov_112.926533	212	292	161	3	80	0.0375000
NODE_1350_length_1991_cov_112.926533	212	292	163	13	80	0.1625000
NODE_1350_length_1991_cov_112.926533	212	292	164	3	80	0.0375000
NODE_1350_length_1991_cov_112.926533	212	292	165	2	80	0.0250000
NODE_1352_length_1988_cov_13.736368	865	945	0	31	80	0.3875000
NODE_1352_length_1988_cov_13.736368	865	945	2	49	80	0.6125000
NODE_1352_length_1988_cov_13.736368	918	998	0	37	80	0.4625000
NODE_1352_length_1988_cov_13.736368	918	998	2	43	80	0.5375000
NODE_1353_length_1988_cov_9.980413	1616	1696	0	11	80	0.1375000
NODE_1353_length_1988_cov_9.980413	1616	1696	1	8	80	0.1000000
NODE_1353_length_1988_cov_9.980413	1616	1696	2	3	80	0.0375000
NODE_1353_length_1988_cov_9.980413	1616	1696	3	58	80	0.7250000
NODE_1353_length_1988_cov_9.980413	1669	1749	0	11	80	0.1375000
NODE_1353_length_1988_cov_9.980413	1669	1749	1	8	80	0.1000000
NODE_1353_length_1988_cov_9.980413	1669	1749	2	56	80	0.7000000
NODE_1353_length_1988_cov_9.980413	1669	1749	3	5	80	0.0625000
NODE_1356_length_1983_cov_17.332803	494	574	2	51	80	0.6375000
NODE_1356_length_1983_cov_17.332803	494	574	4	14	80	0.1750000
NODE_1356_length_1983_cov_17.332803	494	574	6	15	80	0.1875000
NODE_1356_length_1983_cov_17.332803	547	627	2	3	80	0.0375000
NODE_1356_length_1983_cov_17.332803	547	627	4	28	80	0.3500000
NODE_1356_length_1983_cov_17.332803	547	627	6	49	80	0.6125000
NODE_1356_length_1983_cov_17.332803	1600	1680	0	80	80	1.0000000
NODE_1356_length_1983_cov_17.332803	1653	1733	0	80	80	1.0000000
NODE_1359_length_1982_cov_17.164100	457	537	2	31	80	0.3875000
NODE_1359_length_1982_cov_17.164100	457	537	4	49	80	0.6125000
NODE_1359_length_1982_cov_17.164100	510	590	0	16	80	0.2000000
NODE_1359_length_1982_cov_17.164100	510	590	2	23	80	0.2875000
NODE_1359_length_1982_cov_17.164100	510	590	4	41	80	0.5125000
NODE_1359_length_1982_cov_17.164100	586	666	0	80	80	1.0000000
NODE_1359_length_1982_cov_17.164100	639	723	0	84	84	1.0000000
NODE_1360_length_1981_cov_46.444208	0	70	0	70	70	1.0000000
NODE_1362_length_1979_cov_1.630851	1554	1634	0	80	80	1.0000000
NODE_1364_length_1976_cov_1.959510	154	215	2	25	61	0.4098361
NODE_1364_length_1976_cov_1.959510	154	215	6	36	61	0.5901639
NODE_1364_length_1976_cov_1.959510	154	215	2	25	61	0.4098361
NODE_1364_length_1976_cov_1.959510	154	215	6	36	61	0.5901639
NODE_1364_length_1976_cov_1.959510	154	213	2	23	59	0.3898305
NODE_1364_length_1976_cov_1.959510	154	213	6	36	59	0.6101695
NODE_1365_length_1974_cov_8.058133	617	697	18	17	80	0.2125000
NODE_1365_length_1974_cov_8.058133	617	697	20	21	80	0.2625000
NODE_1365_length_1974_cov_8.058133	617	697	22	16	80	0.2000000
NODE_1365_length_1974_cov_8.058133	617	697	24	10	80	0.1250000
NODE_1365_length_1974_cov_8.058133	617	697	26	16	80	0.2000000
NODE_1365_length_1974_cov_8.058133	670	750	0	5	80	0.0625000
NODE_1365_length_1974_cov_8.058133	670	750	2	3	80	0.0375000
NODE_1365_length_1974_cov_8.058133	670	750	4	6	80	0.0750000
NODE_1365_length_1974_cov_8.058133	670	750	7	9	80	0.1125000
NODE_1365_length_1974_cov_8.058133	670	750	9	8	80	0.1000000
NODE_1365_length_1974_cov_8.058133	670	750	13	2	80	0.0250000
NODE_1365_length_1974_cov_8.058133	670	750	15	1	80	0.0125000
NODE_1365_length_1974_cov_8.058133	670	750	17	5	80	0.0625000
NODE_1365_length_1974_cov_8.058133	670	750	18	21	80	0.2625000
NODE_1365_length_1974_cov_8.058133	670	750	20	20	80	0.2500000
NODE_1366_length_1973_cov_14.885272	640	726	1	86	86	1.0000000
NODE_1366_length_1973_cov_14.885272	699	779	0	16	80	0.2000000
NODE_1366_length_1973_cov_14.885272	699	779	1	64	80	0.8000000
NODE_1366_length_1973_cov_14.885272	1389	1469	0	80	80	1.0000000
NODE_1366_length_1973_cov_14.885272	1442	1522	0	80	80	1.0000000
NODE_1372_length_1971_cov_3.126068	1662	1742	6	23	80	0.2875000
NODE_1372_length_1971_cov_3.126068	1662	1742	7	10	80	0.1250000
NODE_1372_length_1971_cov_3.126068	1662	1742	8	11	80	0.1375000
NODE_1372_length_1971_cov_3.126068	1662	1742	9	4	80	0.0500000
NODE_1372_length_1971_cov_3.126068	1662	1742	10	6	80	0.0750000
NODE_1372_length_1971_cov_3.126068	1662	1742	11	5	80	0.0625000
NODE_1372_length_1971_cov_3.126068	1662	1742	12	18	80	0.2250000
NODE_1372_length_1971_cov_3.126068	1662	1742	13	3	80	0.0375000
NODE_1372_length_1971_cov_3.126068	1715	1799	8	31	84	0.3690476
NODE_1372_length_1971_cov_3.126068	1715	1799	10	6	84	0.0714286
NODE_1372_length_1971_cov_3.126068	1715	1799	12	34	84	0.4047619
NODE_1372_length_1971_cov_3.126068	1715	1799	14	13	84	0.1547619
NODE_1386_length_1962_cov_23.774557	281	311	2	30	30	1.0000000
NODE_1386_length_1962_cov_23.774557	329	355	0	26	26	1.0000000
NODE_1386_length_1962_cov_23.774557	408	487	0	79	79	1.0000000
NODE_1386_length_1962_cov_23.774557	460	540	0	80	80	1.0000000
NODE_1386_length_1962_cov_23.774557	1417	1497	0	80	80	1.0000000
NODE_1386_length_1962_cov_23.774557	1470	1550	0	80	80	1.0000000
NODE_1386_length_1962_cov_23.774557	1607	1640	0	33	33	1.0000000
NODE_1395_length_1953_cov_26.183927	1	81	0	11	80	0.1375000
NODE_1395_length_1953_cov_26.183927	1	81	2	3	80	0.0375000
NODE_1395_length_1953_cov_26.183927	1	81	4	66	80	0.8250000
NODE_1395_length_1953_cov_26.183927	6	28	0	6	22	0.2727273
NODE_1395_length_1953_cov_26.183927	6	28	2	3	22	0.1363636
NODE_1395_length_1953_cov_26.183927	6	28	4	13	22	0.5909091
NODE_1395_length_1953_cov_26.183927	152	232	0	27	80	0.3375000
NODE_1395_length_1953_cov_26.183927	152	232	2	31	80	0.3875000
NODE_1395_length_1953_cov_26.183927	152	232	4	22	80	0.2750000
NODE_1395_length_1953_cov_26.183927	205	257	0	50	52	0.9615384
NODE_1395_length_1953_cov_26.183927	205	257	1	1	52	0.0192308
NODE_1395_length_1953_cov_26.183927	205	257	11	1	52	0.0192308
NODE_1405_length_1943_cov_11.218547	516	596	2	42	80	0.5250000
NODE_1405_length_1943_cov_11.218547	516	596	4	38	80	0.4750000
NODE_1405_length_1943_cov_11.218547	569	649	0	38	80	0.4750000
NODE_1405_length_1943_cov_11.218547	569	649	1	12	80	0.1500000
NODE_1405_length_1943_cov_11.218547	569	649	2	30	80	0.3750000
NODE_1408_length_1941_cov_14.407709	891	921	0	30	30	1.0000000
NODE_1408_length_1941_cov_14.407709	894	964	0	70	70	1.0000000
NODE_1408_length_1941_cov_14.407709	1878	1941	0	63	63	1.0000000
NODE_1409_length_1941_cov_9.632465	139	213	2	2	74	0.0270270
NODE_1409_length_1941_cov_9.632465	139	213	4	41	74	0.5540541
NODE_1409_length_1941_cov_9.632465	139	213	6	31	74	0.4189189
NODE_1409_length_1941_cov_9.632465	139	219	2	2	80	0.0250000
NODE_1409_length_1941_cov_9.632465	139	219	4	47	80	0.5875000
NODE_1409_length_1941_cov_9.632465	139	219	6	31	80	0.3875000
NODE_1409_length_1941_cov_9.632465	139	194	2	2	55	0.0363636
NODE_1409_length_1941_cov_9.632465	139	194	4	22	55	0.4000000
NODE_1409_length_1941_cov_9.632465	139	194	6	31	55	0.5636364
NODE_1409_length_1941_cov_9.632465	192	272	0	29	80	0.3625000
NODE_1409_length_1941_cov_9.632465	192	272	4	51	80	0.6375000
NODE_1414_length_1936_cov_13.338596	679	759	0	80	80	1.0000000
NODE_1414_length_1936_cov_13.338596	732	812	0	80	80	1.0000000
NODE_1414_length_1936_cov_13.338596	738	812	0	74	74	1.0000000
NODE_1414_length_1936_cov_13.338596	738	759	0	21	21	1.0000000
NODE_1415_length_1936_cov_12.592814	102	153	0	16	51	0.3137255
NODE_1415_length_1936_cov_12.592814	102	153	2	4	51	0.0784314
NODE_1415_length_1936_cov_12.592814	102	153	4	1	51	0.0196078
NODE_1415_length_1936_cov_12.592814	102	153	6	1	51	0.0196078
NODE_1415_length_1936_cov_12.592814	102	153	8	6	51	0.1176471
NODE_1415_length_1936_cov_12.592814	102	153	10	5	51	0.0980392
NODE_1415_length_1936_cov_12.592814	102	153	14	1	51	0.0196078
NODE_1415_length_1936_cov_12.592814	102	153	18	6	51	0.1176471
NODE_1415_length_1936_cov_12.592814	102	153	20	5	51	0.0980392
NODE_1415_length_1936_cov_12.592814	102	153	22	2	51	0.0392157
NODE_1415_length_1936_cov_12.592814	102	153	24	4	51	0.0784314
NODE_1415_length_1936_cov_12.592814	154	230	12	1	76	0.0131579
NODE_1415_length_1936_cov_12.592814	154	230	15	1	76	0.0131579
NODE_1415_length_1936_cov_12.592814	154	230	16	1	76	0.0131579
NODE_1415_length_1936_cov_12.592814	154	230	18	2	76	0.0263158
NODE_1415_length_1936_cov_12.592814	154	230	26	2	76	0.0263158
NODE_1415_length_1936_cov_12.592814	154	230	32	1	76	0.0131579
NODE_1415_length_1936_cov_12.592814	154	230	34	1	76	0.0131579
NODE_1415_length_1936_cov_12.592814	154	230	36	2	76	0.0263158
NODE_1415_length_1936_cov_12.592814	154	230	38	1	76	0.0131579
NODE_1415_length_1936_cov_12.592814	154	230	40	3	76	0.0394737
NODE_1415_length_1936_cov_12.592814	154	230	42	4	76	0.0526316
NODE_1415_length_1936_cov_12.592814	154	230	46	3	76	0.0394737
NODE_1415_length_1936_cov_12.592814	154	230	48	3	76	0.0394737
NODE_1415_length_1936_cov_12.592814	154	230	50	2	76	0.0263158
NODE_1415_length_1936_cov_12.592814	154	230	52	11	76	0.1447368
NODE_1415_length_1936_cov_12.592814	154	230	54	38	76	0.5000000
NODE_1415_length_1936_cov_12.592814	211	251	16	1	40	0.0250000
NODE_1415_length_1936_cov_12.592814	211	251	17	1	40	0.0250000
NODE_1415_length_1936_cov_12.592814	211	251	20	1	40	0.0250000
NODE_1415_length_1936_cov_12.592814	211	251	22	3	40	0.0750000
NODE_1415_length_1936_cov_12.592814	211	251	24	4	40	0.1000000
NODE_1415_length_1936_cov_12.592814	211	251	26	2	40	0.0500000
NODE_1415_length_1936_cov_12.592814	211	251	34	1	40	0.0250000
NODE_1415_length_1936_cov_12.592814	211	251	35	1	40	0.0250000
NODE_1415_length_1936_cov_12.592814	211	251	38	1	40	0.0250000
NODE_1415_length_1936_cov_12.592814	211	251	42	5	40	0.1250000
NODE_1415_length_1936_cov_12.592814	211	251	45	1	40	0.0250000
NODE_1415_length_1936_cov_12.592814	211	251	46	2	40	0.0500000
NODE_1415_length_1936_cov_12.592814	211	251	50	2	40	0.0500000
NODE_1415_length_1936_cov_12.592814	211	251	52	2	40	0.0500000
NODE_1415_length_1936_cov_12.592814	211	251	54	13	40	0.3250000
NODE_1416_length_1933_cov_86.724646	1044	1124	2	10	80	0.1250000
NODE_1416_length_1933_cov_86.724646	1044	1124	4	66	80	0.8250000
NODE_1416_length_1933_cov_86.724646	1044	1124	6	4	80	0.0500000
NODE_1416_length_1933_cov_86.724646	1097	1177	2	4	80	0.0500000
NODE_1416_length_1933_cov_86.724646	1097	1177	4	42	80	0.5250000
NODE_1416_length_1933_cov_86.724646	1097	1177	6	34	80	0.4250000
NODE_1416_length_1933_cov_86.724646	1173	1253	0	65	80	0.8125000
NODE_1416_length_1933_cov_86.724646	1173	1253	2	15	80	0.1875000
NODE_1416_length_1933_cov_86.724646	1226	1306	0	80	80	1.0000000
NODE_1419_length_1932_cov_5.905074	1534	1614	0	48	80	0.6000000
NODE_1419_length_1932_cov_5.905074	1534	1614	2	32	80	0.4000000
NODE_1422_length_1930_cov_3.005461	1700	1780	26	1	80	0.0125000
NODE_1422_length_1930_cov_3.005461	1700	1780	29	1	80	0.0125000
NODE_1422_length_1930_cov_3.005461	1700	1780	30	10	80	0.1250000
NODE_1422_length_1930_cov_3.005461	1700	1780	32	3	80	0.0375000
NODE_1422_length_1930_cov_3.005461	1700	1780	34	4	80	0.0500000
NODE_1422_length_1930_cov_3.005461	1700	1780	38	2	80	0.0250000
NODE_1422_length_1930_cov_3.005461	1700	1780	40	59	80	0.7375000
NODE_1427_length_1928_cov_2.580098	74	131	20	12	57	0.2105263
NODE_1427_length_1928_cov_2.580098	74	131	22	45	57	0.7894737
NODE_1427_length_1928_cov_2.580098	127	184	3	5	57	0.0877193
NODE_1427_length_1928_cov_2.580098	127	184	5	9	57	0.1578947
NODE_1427_length_1928_cov_2.580098	127	184	7	4	57	0.0701754
NODE_1427_length_1928_cov_2.580098	127	184	9	5	57	0.0877193
NODE_1427_length_1928_cov_2.580098	127	184	13	6	57	0.1052632
NODE_1427_length_1928_cov_2.580098	127	184	15	3	57	0.0526316
NODE_1427_length_1928_cov_2.580098	127	184	17	4	57	0.0701754
NODE_1427_length_1928_cov_2.580098	127	184	19	11	57	0.1929825
NODE_1427_length_1928_cov_2.580098	127	184	20	7	57	0.1228070
NODE_1427_length_1928_cov_2.580098	127	184	21	3	57	0.0526316
NODE_1434_length_1919_cov_17.901099	454	529	10	4	75	0.0533333
NODE_1434_length_1919_cov_17.901099	454	529	12	14	75	0.1866667
NODE_1434_length_1919_cov_17.901099	454	529	14	4	75	0.0533333
NODE_1434_length_1919_cov_17.901099	454	529	16	28	75	0.3733333
NODE_1434_length_1919_cov_17.901099	454	529	18	18	75	0.2400000
NODE_1434_length_1919_cov_17.901099	454	529	20	7	75	0.0933333
NODE_1434_length_1919_cov_17.901099	507	558	0	14	51	0.2745098
NODE_1434_length_1919_cov_17.901099	507	558	2	6	51	0.1176471
NODE_1434_length_1919_cov_17.901099	507	558	4	1	51	0.0196078
NODE_1434_length_1919_cov_17.901099	507	558	6	1	51	0.0196078
NODE_1434_length_1919_cov_17.901099	507	558	8	5	51	0.0980392
NODE_1434_length_1919_cov_17.901099	507	558	10	6	51	0.1176471
NODE_1434_length_1919_cov_17.901099	507	558	12	12	51	0.2352941
NODE_1434_length_1919_cov_17.901099	507	558	14	4	51	0.0784314
NODE_1434_length_1919_cov_17.901099	507	558	16	2	51	0.0392157
NODE_1436_length_1918_cov_14.876855	314	396	0	3	82	0.0365854
NODE_1436_length_1918_cov_14.876855	314	396	2	7	82	0.0853659
NODE_1436_length_1918_cov_14.876855	314	396	4	72	82	0.8780488
NODE_1438_length_1918_cov_3.493128	9	55	2	6	46	0.1304348
NODE_1438_length_1918_cov_3.493128	9	55	4	12	46	0.2608696
NODE_1438_length_1918_cov_3.493128	9	55	6	28	46	0.6086956
NODE_1438_length_1918_cov_3.493128	1480	1561	2	9	81	0.1111111
NODE_1438_length_1918_cov_3.493128	1480	1561	4	2	81	0.0246914
NODE_1438_length_1918_cov_3.493128	1480	1561	6	70	81	0.8641976
NODE_1440_length_1916_cov_4.426527	162	192	6	12	30	0.4000000
NODE_1440_length_1916_cov_4.426527	162	192	8	18	30	0.6000000
NODE_1442_length_1915_cov_35.787996	106	186	2	2	80	0.0250000
NODE_1442_length_1915_cov_35.787996	106	186	4	9	80	0.1125000
NODE_1442_length_1915_cov_35.787996	106	186	5	1	80	0.0125000
NODE_1442_length_1915_cov_35.787996	106	186	9	3	80	0.0375000
NODE_1442_length_1915_cov_35.787996	106	186	11	1	80	0.0125000
NODE_1442_length_1915_cov_35.787996	106	186	12	6	80	0.0750000
NODE_1442_length_1915_cov_35.787996	106	186	14	1	80	0.0125000
NODE_1442_length_1915_cov_35.787996	106	186	16	24	80	0.3000000
NODE_1442_length_1915_cov_35.787996	106	186	18	4	80	0.0500000
NODE_1442_length_1915_cov_35.787996	106	186	20	3	80	0.0375000
NODE_1442_length_1915_cov_35.787996	106	186	22	4	80	0.0500000
NODE_1442_length_1915_cov_35.787996	106	186	24	2	80	0.0250000
NODE_1442_length_1915_cov_35.787996	106	186	26	5	80	0.0625000
NODE_1442_length_1915_cov_35.787996	106	186	28	13	80	0.1625000
NODE_1442_length_1915_cov_35.787996	106	186	30	2	80	0.0250000
NODE_1451_length_1905_cov_18.464563	740	820	0	80	80	1.0000000
NODE_1451_length_1905_cov_18.464563	793	873	0	80	80	1.0000000
NODE_1451_length_1905_cov_18.464563	869	949	0	80	80	1.0000000
NODE_1451_length_1905_cov_18.464563	922	1010	0	88	88	1.0000000
NODE_1452_length_1905_cov_7.197121	596	676	0	66	80	0.8250000
NODE_1452_length_1905_cov_7.197121	596	676	2	14	80	0.1750000
NODE_1452_length_1905_cov_7.197121	649	682	0	33	33	1.0000000
NODE_1455_length_1902_cov_1.633943	1728	1792	12	1	64	0.0156250
NODE_1455_length_1902_cov_1.633943	1728	1792	14	3	64	0.0468750
NODE_1455_length_1902_cov_1.633943	1728	1792	16	5	64	0.0781250
NODE_1455_length_1902_cov_1.633943	1728	1792	19	4	64	0.0625000
NODE_1455_length_1902_cov_1.633943	1728	1792	21	2	64	0.0312500
NODE_1455_length_1902_cov_1.633943	1728	1792	23	1	64	0.0156250
NODE_1455_length_1902_cov_1.633943	1728	1792	24	1	64	0.0156250
NODE_1455_length_1902_cov_1.633943	1728	1792	27	1	64	0.0156250
NODE_1455_length_1902_cov_1.633943	1728	1792	28	1	64	0.0156250
NODE_1455_length_1902_cov_1.633943	1728	1792	31	7	64	0.1093750
NODE_1455_length_1902_cov_1.633943	1728	1792	35	2	64	0.0312500
NODE_1455_length_1902_cov_1.633943	1728	1792	37	5	64	0.0781250
NODE_1455_length_1902_cov_1.633943	1728	1792	39	31	64	0.4843750
NODE_1458_length_1900_cov_1.081066	1805	1851	0	46	46	1.0000000
NODE_1458_length_1900_cov_1.081066	1824	1900	0	76	76	1.0000000
NODE_1461_length_1895_cov_17.940980	1070	1150	0	1	80	0.0125000
NODE_1461_length_1895_cov_17.940980	1070	1150	2	79	80	0.9875000
NODE_1461_length_1895_cov_17.940980	1123	1203	0	17	80	0.2125000
NODE_1461_length_1895_cov_17.940980	1123	1203	2	63	80	0.7875000
NODE_1466_length_1893_cov_3.299331	918	998	2	1	80	0.0125000
NODE_1466_length_1893_cov_3.299331	918	998	4	79	80	0.9875000
NODE_1467_length_1892_cov_5.158394	317	397	0	44	80	0.5500000
NODE_1467_length_1892_cov_5.158394	317	397	1	36	80	0.4500000
NODE_1467_length_1892_cov_5.158394	370	445	1	75	75	1.0000000
NODE_1469_length_1889_cov_4.049162	1652	1686	0	1	34	0.0294118
NODE_1469_length_1889_cov_4.049162	1652	1686	2	33	34	0.9705882
NODE_1470_length_1889_cov_3.888268	960	1040	0	54	80	0.6750000
NODE_1470_length_1889_cov_3.888268	960	1040	2	26	80	0.3250000
NODE_1470_length_1889_cov_3.888268	1013	1093	0	9	80	0.1125000
NODE_1470_length_1889_cov_3.888268	1013	1093	2	71	80	0.8875000
NODE_1472_length_1888_cov_17.106764	15	96	22	6	81	0.0740741
NODE_1472_length_1888_cov_17.106764	15	96	26	25	81	0.3086420
NODE_1472_length_1888_cov_17.106764	15	96	27	1	81	0.0123457
NODE_1472_length_1888_cov_17.106764	15	96	29	5	81	0.0617284
NODE_1472_length_1888_cov_17.106764	15	96	32	1	81	0.0123457
NODE_1472_length_1888_cov_17.106764	15	96	34	1	81	0.0123457
NODE_1472_length_1888_cov_17.106764	15	96	36	22	81	0.2716049
NODE_1472_length_1888_cov_17.106764	15	96	40	20	81	0.2469136
NODE_1472_length_1888_cov_17.106764	68	143	24	12	75	0.1600000
NODE_1472_length_1888_cov_17.106764	68	143	26	15	75	0.2000000
NODE_1472_length_1888_cov_17.106764	68	143	28	5	75	0.0666667
NODE_1472_length_1888_cov_17.106764	68	143	36	9	75	0.1200000
NODE_1472_length_1888_cov_17.106764	68	143	38	5	75	0.0666667
NODE_1472_length_1888_cov_17.106764	68	143	40	29	75	0.3866667
NODE_1477_length_1885_cov_4.439530	441	521	0	80	80	1.0000000
NODE_1477_length_1885_cov_4.439530	494	574	0	80	80	1.0000000
NODE_1483_length_1882_cov_5.884464	1499	1579	0	80	80	1.0000000
NODE_1483_length_1882_cov_5.884464	1552	1632	0	80	80	1.0000000
NODE_1493_length_1875_cov_3.974662	1650	1730	6	14	80	0.1750000
NODE_1493_length_1875_cov_3.974662	1650	1730	8	25	80	0.3125000
NODE_1493_length_1875_cov_3.974662	1650	1730	10	41	80	0.5125000
NODE_1497_length_1872_cov_21.355330	153	201	0	48	48	1.0000000
NODE_1503_length_1868_cov_96.046919	1018	1098	4	12	80	0.1500000
NODE_1503_length_1868_cov_96.046919	1018	1098	5	12	80	0.1500000
NODE_1503_length_1868_cov_96.046919	1018	1098	7	2	80	0.0250000
NODE_1503_length_1868_cov_96.046919	1018	1098	13	3	80	0.0375000
NODE_1503_length_1868_cov_96.046919	1018	1098	14	9	80	0.1125000
NODE_1503_length_1868_cov_96.046919	1018	1098	15	8	80	0.1000000
NODE_1503_length_1868_cov_96.046919	1018	1098	16	3	80	0.0375000
NODE_1503_length_1868_cov_96.046919	1018	1098	20	10	80	0.1250000
NODE_1503_length_1868_cov_96.046919	1018	1098	22	2	80	0.0250000
NODE_1503_length_1868_cov_96.046919	1018	1098	24	12	80	0.1500000
NODE_1503_length_1868_cov_96.046919	1018	1098	25	7	80	0.0875000
NODE_1503_length_1868_cov_96.046919	1071	1151	20	6	80	0.0750000
NODE_1503_length_1868_cov_96.046919	1071	1151	22	18	80	0.2250000
NODE_1503_length_1868_cov_96.046919	1071	1151	24	23	80	0.2875000
NODE_1503_length_1868_cov_96.046919	1071	1151	25	10	80	0.1250000
NODE_1503_length_1868_cov_96.046919	1071	1151	26	15	80	0.1875000
NODE_1503_length_1868_cov_96.046919	1071	1151	28	8	80	0.1000000
NODE_1508_length_1866_cov_53.869270	1149	1229	2	10	80	0.1250000
NODE_1508_length_1866_cov_53.869270	1149	1229	4	16	80	0.2000000
NODE_1508_length_1866_cov_53.869270	1149	1229	6	54	80	0.6750000
NODE_1508_length_1866_cov_53.869270	1202	1282	2	16	80	0.2000000
NODE_1508_length_1866_cov_53.869270	1202	1282	4	27	80	0.3375000
NODE_1508_length_1866_cov_53.869270	1202	1282	6	37	80	0.4625000
NODE_1508_length_1866_cov_53.869270	1278	1358	2	1	80	0.0125000
NODE_1508_length_1866_cov_53.869270	1278	1358	4	14	80	0.1750000
NODE_1508_length_1866_cov_53.869270	1278	1358	6	57	80	0.7125000
NODE_1508_length_1866_cov_53.869270	1278	1358	8	8	80	0.1000000
NODE_1508_length_1866_cov_53.869270	1331	1411	0	12	80	0.1500000
NODE_1508_length_1866_cov_53.869270	1331	1411	2	20	80	0.2500000
NODE_1508_length_1866_cov_53.869270	1331	1411	4	17	80	0.2125000
NODE_1508_length_1866_cov_53.869270	1331	1411	6	31	80	0.3875000
NODE_1510_length_1866_cov_3.347482	888	966	0	78	78	1.0000000
NODE_1510_length_1866_cov_3.347482	939	1019	0	80	80	1.0000000
NODE_1513_length_1863_cov_11.265306	698	778	0	80	80	1.0000000
NODE_1513_length_1863_cov_11.265306	751	831	0	80	80	1.0000000
NODE_1518_length_1858_cov_19.019329	23	85	0	62	62	1.0000000
NODE_1518_length_1858_cov_19.019329	1125	1205	0	70	80	0.8750000
NODE_1518_length_1858_cov_19.019329	1125	1205	2	10	80	0.1250000
NODE_1518_length_1858_cov_19.019329	1178	1256	0	17	78	0.2179487
NODE_1518_length_1858_cov_19.019329	1178	1256	2	53	78	0.6794872
NODE_1518_length_1858_cov_19.019329	1178	1256	4	8	78	0.1025641
NODE_1518_length_1858_cov_19.019329	1387	1464	0	77	77	1.0000000
NODE_1518_length_1858_cov_19.019329	1440	1503	0	63	63	1.0000000
NODE_1519_length_1857_cov_18.402730	1282	1348	0	66	66	1.0000000
NODE_1519_length_1857_cov_18.402730	1321	1401	0	80	80	1.0000000
NODE_1519_length_1857_cov_18.402730	1397	1477	0	80	80	1.0000000
NODE_1519_length_1857_cov_18.402730	1450	1530	0	80	80	1.0000000
NODE_1531_length_1845_cov_12.653494	473	553	0	14	80	0.1750000
NODE_1531_length_1845_cov_12.653494	473	553	2	13	80	0.1625000
NODE_1531_length_1845_cov_12.653494	473	553	4	53	80	0.6625000
NODE_1531_length_1845_cov_12.653494	526	606	0	67	80	0.8375000
NODE_1531_length_1845_cov_12.653494	526	606	2	13	80	0.1625000
NODE_1546_length_1833_cov_31.337947	810	888	2	75	78	0.9615384
NODE_1546_length_1833_cov_31.337947	810	888	4	3	78	0.0384615
NODE_1546_length_1833_cov_31.337947	861	941	0	27	80	0.3375000
NODE_1546_length_1833_cov_31.337947	861	941	2	50	80	0.6250000
NODE_1546_length_1833_cov_31.337947	861	941	4	3	80	0.0375000
NODE_1546_length_1833_cov_31.337947	937	1017	0	80	80	1.0000000
NODE_1546_length_1833_cov_31.337947	990	1070	0	70	80	0.8750000
NODE_1546_length_1833_cov_31.337947	990	1070	2	5	80	0.0625000
NODE_1546_length_1833_cov_31.337947	990	1070	6	5	80	0.0625000
NODE_1550_length_1831_cov_3.065820	112	154	0	5	42	0.1190476
NODE_1550_length_1831_cov_3.065820	112	154	2	3	42	0.0714286
NODE_1550_length_1831_cov_3.065820	112	154	4	3	42	0.0714286
NODE_1550_length_1831_cov_3.065820	112	154	6	6	42	0.1428571
NODE_1550_length_1831_cov_3.065820	112	154	10	1	42	0.0238095
NODE_1550_length_1831_cov_3.065820	112	154	12	4	42	0.0952381
NODE_1550_length_1831_cov_3.065820	112	154	16	1	42	0.0238095
NODE_1550_length_1831_cov_3.065820	112	154	18	1	42	0.0238095
NODE_1550_length_1831_cov_3.065820	112	154	22	10	42	0.2380952
NODE_1550_length_1831_cov_3.065820	112	154	28	2	42	0.0476190
NODE_1550_length_1831_cov_3.065820	112	154	36	1	42	0.0238095
NODE_1550_length_1831_cov_3.065820	112	154	38	5	42	0.1190476
NODE_1553_length_1830_cov_2.512998	123	203	0	2	80	0.0250000
NODE_1553_length_1830_cov_2.512998	123	203	2	78	80	0.9750000
NODE_1553_length_1830_cov_2.512998	176	256	0	55	80	0.6875000
NODE_1553_length_1830_cov_2.512998	176	256	2	25	80	0.3125000
NODE_1553_length_1830_cov_2.512998	308	357	0	37	49	0.7551020
NODE_1553_length_1830_cov_2.512998	308	357	2	12	49	0.2448980
NODE_1554_length_1828_cov_40.437825	789	869	0	80	80	1.0000000
NODE_1554_length_1828_cov_40.437825	842	922	0	56	80	0.7000000
NODE_1554_length_1828_cov_40.437825	842	922	2	22	80	0.2750000
NODE_1554_length_1828_cov_40.437825	842	922	4	2	80	0.0250000
NODE_1554_length_1828_cov_40.437825	918	998	2	2	80	0.0250000
NODE_1554_length_1828_cov_40.437825	918	998	4	19	80	0.2375000
NODE_1554_length_1828_cov_40.437825	918	998	6	5	80	0.0625000
NODE_1554_length_1828_cov_40.437825	918	998	8	18	80	0.2250000
NODE_1554_length_1828_cov_40.437825	918	998	10	36	80	0.4500000
NODE_1554_length_1828_cov_40.437825	971	1051	0	5	80	0.0625000
NODE_1554_length_1828_cov_40.437825	971	1051	2	22	80	0.2750000
NODE_1554_length_1828_cov_40.437825	971	1051	4	13	80	0.1625000
NODE_1554_length_1828_cov_40.437825	971	1051	6	10	80	0.1250000
NODE_1554_length_1828_cov_40.437825	971	1051	8	8	80	0.1000000
NODE_1554_length_1828_cov_40.437825	971	1051	10	22	80	0.2750000
NODE_1559_length_1825_cov_6.652955	641	689	1	38	48	0.7916667
NODE_1559_length_1825_cov_6.652955	641	689	2	1	48	0.0208333
NODE_1559_length_1825_cov_6.652955	641	689	4	9	48	0.1875000
NODE_1559_length_1825_cov_6.652955	694	744	4	50	50	1.0000000
NODE_1562_length_1824_cov_10.152464	685	765	4	14	80	0.1750000
NODE_1562_length_1824_cov_10.152464	685	765	6	40	80	0.5000000
NODE_1562_length_1824_cov_10.152464	685	765	8	26	80	0.3250000
NODE_1562_length_1824_cov_10.152464	738	818	2	39	80	0.4875000
NODE_1562_length_1824_cov_10.152464	738	818	4	16	80	0.2000000
NODE_1562_length_1824_cov_10.152464	738	818	6	5	80	0.0625000
NODE_1562_length_1824_cov_10.152464	738	818	8	20	80	0.2500000
NODE_1562_length_1824_cov_10.152464	1412	1433	4	21	21	1.0000000
NODE_1564_length_1821_cov_7.682346	953	1033	0	80	80	1.0000000
NODE_1564_length_1821_cov_7.682346	1006	1086	0	80	80	1.0000000
NODE_1566_length_1820_cov_12.061592	477	557	0	36	80	0.4500000
NODE_1566_length_1820_cov_12.061592	477	557	2	44	80	0.5500000
NODE_1566_length_1820_cov_12.061592	530	610	2	35	80	0.4375000
NODE_1566_length_1820_cov_12.061592	530	610	4	45	80	0.5625000
NODE_1566_length_1820_cov_12.061592	1232	1312	0	80	80	1.0000000
NODE_1566_length_1820_cov_12.061592	1285	1365	0	80	80	1.0000000
NODE_1572_length_1817_cov_8.302095	63	122	0	33	59	0.5593221
NODE_1572_length_1817_cov_8.302095	63	122	2	26	59	0.4406780
NODE_1572_length_1817_cov_8.302095	1195	1275	0	65	80	0.8125000
NODE_1572_length_1817_cov_8.302095	1195	1275	2	15	80	0.1875000
NODE_1572_length_1817_cov_8.302095	1248	1328	0	41	80	0.5125000
NODE_1572_length_1817_cov_8.302095	1248	1328	2	39	80	0.4875000
NODE_1573_length_1816_cov_25.489225	1059	1139	0	80	80	1.0000000
NODE_1573_length_1816_cov_25.489225	1112	1192	0	80	80	1.0000000
NODE_1578_length_1812_cov_11.453006	398	427	6	18	29	0.6206896
NODE_1578_length_1812_cov_11.453006	398	427	8	11	29	0.3793103
NODE_1578_length_1812_cov_11.453006	400	480	4	16	80	0.2000000
NODE_1578_length_1812_cov_11.453006	400	480	6	22	80	0.2750000
NODE_1578_length_1812_cov_11.453006	400	480	8	42	80	0.5250000
NODE_1586_length_1807_cov_3.977752	1743	1807	0	64	64	1.0000000
NODE_1590_length_1806_cov_2.681312	1461	1541	2	5	80	0.0625000
NODE_1590_length_1806_cov_2.681312	1461	1541	4	7	80	0.0875000
NODE_1590_length_1806_cov_2.681312	1461	1541	6	2	80	0.0250000
NODE_1590_length_1806_cov_2.681312	1461	1541	8	18	80	0.2250000
NODE_1590_length_1806_cov_2.681312	1461	1541	10	6	80	0.0750000
NODE_1590_length_1806_cov_2.681312	1461	1541	12	4	80	0.0500000
NODE_1590_length_1806_cov_2.681312	1461	1541	14	2	80	0.0250000
NODE_1590_length_1806_cov_2.681312	1461	1541	18	1	80	0.0125000
NODE_1590_length_1806_cov_2.681312	1461	1541	20	11	80	0.1375000
NODE_1590_length_1806_cov_2.681312	1461	1541	21	1	80	0.0125000
NODE_1590_length_1806_cov_2.681312	1461	1541	23	1	80	0.0125000
NODE_1590_length_1806_cov_2.681312	1461	1541	27	2	80	0.0250000
NODE_1590_length_1806_cov_2.681312	1461	1541	29	1	80	0.0125000
NODE_1590_length_1806_cov_2.681312	1461	1541	31	9	80	0.1125000
NODE_1590_length_1806_cov_2.681312	1461	1541	33	3	80	0.0375000
NODE_1590_length_1806_cov_2.681312	1461	1541	35	2	80	0.0250000
NODE_1590_length_1806_cov_2.681312	1461	1541	37	3	80	0.0375000
NODE_1590_length_1806_cov_2.681312	1461	1541	40	1	80	0.0125000
NODE_1590_length_1806_cov_2.681312	1461	1541	42	1	80	0.0125000
NODE_1590_length_1806_cov_2.681312	1517	1594	0	14	77	0.1818182
NODE_1590_length_1806_cov_2.681312	1517	1594	2	44	77	0.5714286
NODE_1590_length_1806_cov_2.681312	1517	1594	4	7	77	0.0909091
NODE_1590_length_1806_cov_2.681312	1517	1594	6	2	77	0.0259740
NODE_1590_length_1806_cov_2.681312	1517	1594	8	10	77	0.1298701
NODE_1593_length_1805_cov_10.271395	258	329	0	71	71	1.0000000
NODE_1593_length_1805_cov_10.271395	311	391	0	80	80	1.0000000
NODE_1598_length_1802_cov_11.546682	1284	1364	0	80	80	1.0000000
NODE_1598_length_1802_cov_11.546682	1337	1417	0	80	80	1.0000000
NODE_1600_length_1801_cov_12.145711	85	165	12	19	80	0.2375000
NODE_1600_length_1801_cov_12.145711	85	165	16	2	80	0.0250000
NODE_1600_length_1801_cov_12.145711	85	165	18	5	80	0.0625000
NODE_1600_length_1801_cov_12.145711	85	165	20	2	80	0.0250000
NODE_1600_length_1801_cov_12.145711	85	165	22	2	80	0.0250000
NODE_1600_length_1801_cov_12.145711	85	165	24	4	80	0.0500000
NODE_1600_length_1801_cov_12.145711	85	165	26	1	80	0.0125000
NODE_1600_length_1801_cov_12.145711	85	165	28	1	80	0.0125000
NODE_1600_length_1801_cov_12.145711	85	165	30	7	80	0.0875000
NODE_1600_length_1801_cov_12.145711	85	165	32	6	80	0.0750000
NODE_1600_length_1801_cov_12.145711	85	165	34	2	80	0.0250000
NODE_1600_length_1801_cov_12.145711	85	165	36	29	80	0.3625000
NODE_1600_length_1801_cov_12.145711	138	218	5	2	80	0.0250000
NODE_1600_length_1801_cov_12.145711	138	218	7	1	80	0.0125000
NODE_1600_length_1801_cov_12.145711	138	218	9	1	80	0.0125000
NODE_1600_length_1801_cov_12.145711	138	218	14	4	80	0.0500000
NODE_1600_length_1801_cov_12.145711	138	218	18	1	80	0.0125000
NODE_1600_length_1801_cov_12.145711	138	218	22	1	80	0.0125000
NODE_1600_length_1801_cov_12.145711	138	218	24	4	80	0.0500000
NODE_1600_length_1801_cov_12.145711	138	218	26	6	80	0.0750000
NODE_1600_length_1801_cov_12.145711	138	218	28	7	80	0.0875000
NODE_1600_length_1801_cov_12.145711	138	218	30	6	80	0.0750000
NODE_1600_length_1801_cov_12.145711	138	218	32	6	80	0.0750000
NODE_1600_length_1801_cov_12.145711	138	218	36	41	80	0.5125000
NODE_1601_length_1801_cov_9.793184	1010	1090	2	34	80	0.4250000
NODE_1601_length_1801_cov_9.793184	1010	1090	4	46	80	0.5750000
NODE_1601_length_1801_cov_9.793184	1063	1143	0	49	80	0.6125000
NODE_1601_length_1801_cov_9.793184	1063	1143	2	31	80	0.3875000
NODE_1604_length_1800_cov_15.074662	695	775	0	80	80	1.0000000
NODE_1604_length_1800_cov_15.074662	755	826	0	71	71	1.0000000
NODE_1605_length_1800_cov_7.281599	10	74	20	1	64	0.0156250
NODE_1605_length_1800_cov_7.281599	10	74	22	1	64	0.0156250
NODE_1605_length_1800_cov_7.281599	10	74	24	3	64	0.0468750
NODE_1605_length_1800_cov_7.281599	10	74	26	1	64	0.0156250
NODE_1605_length_1800_cov_7.281599	10	74	28	4	64	0.0625000
NODE_1605_length_1800_cov_7.281599	10	74	30	1	64	0.0156250
NODE_1605_length_1800_cov_7.281599	10	74	32	1	64	0.0156250
NODE_1605_length_1800_cov_7.281599	10	74	34	3	64	0.0468750
NODE_1605_length_1800_cov_7.281599	10	74	36	8	64	0.1250000
NODE_1605_length_1800_cov_7.281599	10	74	38	18	64	0.2812500
NODE_1605_length_1800_cov_7.281599	10	74	42	17	64	0.2656250
NODE_1605_length_1800_cov_7.281599	10	74	48	2	64	0.0312500
NODE_1605_length_1800_cov_7.281599	10	74	50	4	64	0.0625000
NODE_1605_length_1800_cov_7.281599	10	74	20	1	64	0.0156250
NODE_1605_length_1800_cov_7.281599	10	74	22	1	64	0.0156250
NODE_1605_length_1800_cov_7.281599	10	74	24	3	64	0.0468750
NODE_1605_length_1800_cov_7.281599	10	74	26	1	64	0.0156250
NODE_1605_length_1800_cov_7.281599	10	74	28	4	64	0.0625000
NODE_1605_length_1800_cov_7.281599	10	74	30	1	64	0.0156250
NODE_1605_length_1800_cov_7.281599	10	74	32	1	64	0.0156250
NODE_1605_length_1800_cov_7.281599	10	74	34	3	64	0.0468750
NODE_1605_length_1800_cov_7.281599	10	74	36	8	64	0.1250000
NODE_1605_length_1800_cov_7.281599	10	74	38	18	64	0.2812500
NODE_1605_length_1800_cov_7.281599	10	74	42	17	64	0.2656250
NODE_1605_length_1800_cov_7.281599	10	74	48	2	64	0.0312500
NODE_1605_length_1800_cov_7.281599	10	74	50	4	64	0.0625000
NODE_1605_length_1800_cov_7.281599	10	74	20	1	64	0.0156250
NODE_1605_length_1800_cov_7.281599	10	74	22	1	64	0.0156250
NODE_1605_length_1800_cov_7.281599	10	74	24	3	64	0.0468750
NODE_1605_length_1800_cov_7.281599	10	74	26	1	64	0.0156250
NODE_1605_length_1800_cov_7.281599	10	74	28	4	64	0.0625000
NODE_1605_length_1800_cov_7.281599	10	74	30	1	64	0.0156250
NODE_1605_length_1800_cov_7.281599	10	74	32	1	64	0.0156250
NODE_1605_length_1800_cov_7.281599	10	74	34	3	64	0.0468750
NODE_1605_length_1800_cov_7.281599	10	74	36	8	64	0.1250000
NODE_1605_length_1800_cov_7.281599	10	74	38	18	64	0.2812500
NODE_1605_length_1800_cov_7.281599	10	74	42	17	64	0.2656250
NODE_1605_length_1800_cov_7.281599	10	74	48	2	64	0.0312500
NODE_1605_length_1800_cov_7.281599	10	74	50	4	64	0.0625000
NODE_1605_length_1800_cov_7.281599	47	127	32	4	80	0.0500000
NODE_1605_length_1800_cov_7.281599	47	127	34	4	80	0.0500000
NODE_1605_length_1800_cov_7.281599	47	127	38	4	80	0.0500000
NODE_1605_length_1800_cov_7.281599	47	127	42	17	80	0.2125000
NODE_1605_length_1800_cov_7.281599	47	127	43	3	80	0.0375000
NODE_1605_length_1800_cov_7.281599	47	127	45	2	80	0.0250000
NODE_1605_length_1800_cov_7.281599	47	127	47	5	80	0.0625000
NODE_1605_length_1800_cov_7.281599	47	127	48	2	80	0.0250000
NODE_1605_length_1800_cov_7.281599	47	127	50	5	80	0.0625000
NODE_1605_length_1800_cov_7.281599	47	127	53	5	80	0.0625000
NODE_1605_length_1800_cov_7.281599	47	127	54	29	80	0.3625000
NODE_1605_length_1800_cov_7.281599	63	126	32	3	63	0.0476190
NODE_1605_length_1800_cov_7.281599	63	126	34	4	63	0.0634921
NODE_1605_length_1800_cov_7.281599	63	126	42	5	63	0.0793651
NODE_1605_length_1800_cov_7.281599	63	126	43	3	63	0.0476190
NODE_1605_length_1800_cov_7.281599	63	126	45	2	63	0.0317460
NODE_1605_length_1800_cov_7.281599	63	126	47	5	63	0.0793651
NODE_1605_length_1800_cov_7.281599	63	126	48	2	63	0.0317460
NODE_1605_length_1800_cov_7.281599	63	126	50	5	63	0.0793651
NODE_1605_length_1800_cov_7.281599	63	126	53	5	63	0.0793651
NODE_1605_length_1800_cov_7.281599	63	126	54	29	63	0.4603175
NODE_1616_length_1793_cov_16.161157	539	619	0	23	80	0.2875000
NODE_1616_length_1793_cov_16.161157	539	619	2	24	80	0.3000000
NODE_1616_length_1793_cov_16.161157	539	619	4	7	80	0.0875000
NODE_1616_length_1793_cov_16.161157	539	619	6	1	80	0.0125000
NODE_1616_length_1793_cov_16.161157	539	619	8	9	80	0.1125000
NODE_1616_length_1793_cov_16.161157	539	619	10	16	80	0.2000000
NODE_1616_length_1793_cov_16.161157	592	672	4	1	80	0.0125000
NODE_1616_length_1793_cov_16.161157	592	672	6	11	80	0.1375000
NODE_1616_length_1793_cov_16.161157	592	672	8	12	80	0.1500000
NODE_1616_length_1793_cov_16.161157	592	672	10	56	80	0.7000000
NODE_1616_length_1793_cov_16.161157	1202	1281	0	79	79	1.0000000
NODE_1616_length_1793_cov_16.161157	1254	1335	0	81	81	1.0000000
NODE_1617_length_1793_cov_14.322904	521	601	0	3	80	0.0375000
NODE_1617_length_1793_cov_14.322904	521	601	2	77	80	0.9625000
NODE_1617_length_1793_cov_14.322904	574	654	0	56	80	0.7000000
NODE_1617_length_1793_cov_14.322904	574	654	2	24	80	0.3000000
NODE_1617_length_1793_cov_14.322904	1230	1310	0	80	80	1.0000000
NODE_1618_length_1791_cov_5.516548	1190	1261	0	71	71	1.0000000
NODE_1621_length_1790_cov_4.282082	684	764	0	80	80	1.0000000
NODE_1621_length_1790_cov_4.282082	737	817	0	42	80	0.5250000
NODE_1621_length_1790_cov_4.282082	737	817	2	38	80	0.4750000
NODE_1623_length_1788_cov_39.558911	385	465	0	80	80	1.0000000
NODE_1623_length_1788_cov_39.558911	438	518	0	80	80	1.0000000
NODE_1623_length_1788_cov_39.558911	514	594	0	80	80	1.0000000
NODE_1623_length_1788_cov_39.558911	567	647	0	80	80	1.0000000
NODE_1624_length_1787_cov_44.927133	530	610	20	11	80	0.1375000
NODE_1624_length_1787_cov_44.927133	530	610	21	8	80	0.1000000
NODE_1624_length_1787_cov_44.927133	530	610	22	13	80	0.1625000
NODE_1624_length_1787_cov_44.927133	530	610	24	2	80	0.0250000
NODE_1624_length_1787_cov_44.927133	530	610	28	9	80	0.1125000
NODE_1624_length_1787_cov_44.927133	530	610	30	4	80	0.0500000
NODE_1624_length_1787_cov_44.927133	530	610	32	24	80	0.3000000
NODE_1624_length_1787_cov_44.927133	530	610	34	3	80	0.0375000
NODE_1624_length_1787_cov_44.927133	530	610	40	6	80	0.0750000
NODE_1625_length_1787_cov_2.752370	675	755	0	80	80	1.0000000
NODE_1625_length_1787_cov_2.752370	728	806	0	78	78	1.0000000
NODE_1626_length_1786_cov_13.459395	523	603	0	80	80	1.0000000
NODE_1626_length_1786_cov_13.459395	576	656	0	80	80	1.0000000
NODE_1633_length_1784_cov_40.769733	358	438	0	80	80	1.0000000
NODE_1633_length_1784_cov_40.769733	411	491	0	80	80	1.0000000
NODE_1633_length_1784_cov_40.769733	1057	1137	0	14	80	0.1750000
NODE_1633_length_1784_cov_40.769733	1057	1137	2	66	80	0.8250000
NODE_1633_length_1784_cov_40.769733	1110	1190	0	54	80	0.6750000
NODE_1633_length_1784_cov_40.769733	1110	1190	2	26	80	0.3250000
NODE_1633_length_1784_cov_40.769733	1186	1266	0	80	80	1.0000000
NODE_1633_length_1784_cov_40.769733	1239	1319	0	80	80	1.0000000
NODE_1634_length_1784_cov_6.049258	1646	1725	0	79	79	1.0000000
NODE_1637_length_1783_cov_45.569477	600	680	0	57	80	0.7125000
NODE_1637_length_1783_cov_45.569477	600	680	2	12	80	0.1500000
NODE_1637_length_1783_cov_45.569477	600	680	4	11	80	0.1375000
NODE_1637_length_1783_cov_45.569477	653	733	0	4	80	0.0500000
NODE_1637_length_1783_cov_45.569477	653	733	2	12	80	0.1500000
NODE_1637_length_1783_cov_45.569477	653	733	4	51	80	0.6375000
NODE_1637_length_1783_cov_45.569477	653	733	6	13	80	0.1625000
NODE_1640_length_1780_cov_21.089233	361	441	4	22	80	0.2750000
NODE_1640_length_1780_cov_21.089233	361	441	6	58	80	0.7250000
NODE_1640_length_1780_cov_21.089233	414	494	2	40	80	0.5000000
NODE_1640_length_1780_cov_21.089233	414	494	4	2	80	0.0250000
NODE_1640_length_1780_cov_21.089233	414	494	6	38	80	0.4750000
NODE_1640_length_1780_cov_21.089233	1031	1104	2	14	73	0.1917808
NODE_1640_length_1780_cov_21.089233	1031	1104	8	3	73	0.0410959
NODE_1640_length_1780_cov_21.089233	1031	1104	12	1	73	0.0136986
NODE_1640_length_1780_cov_21.089233	1031	1104	14	12	73	0.1643836
NODE_1640_length_1780_cov_21.089233	1031	1104	16	18	73	0.2465753
NODE_1640_length_1780_cov_21.089233	1031	1104	18	5	73	0.0684932
NODE_1640_length_1780_cov_21.089233	1031	1104	22	1	73	0.0136986
NODE_1640_length_1780_cov_21.089233	1031	1104	24	2	73	0.0273973
NODE_1640_length_1780_cov_21.089233	1031	1104	26	1	73	0.0136986
NODE_1640_length_1780_cov_21.089233	1031	1104	27	2	73	0.0273973
NODE_1640_length_1780_cov_21.089233	1031	1104	30	1	73	0.0136986
NODE_1640_length_1780_cov_21.089233	1031	1104	32	8	73	0.1095890
NODE_1640_length_1780_cov_21.089233	1031	1104	33	2	73	0.0273973
NODE_1640_length_1780_cov_21.089233	1031	1104	35	3	73	0.0410959
NODE_1640_length_1780_cov_21.089233	1071	1112	16	8	41	0.1951219
NODE_1640_length_1780_cov_21.089233	1071	1112	18	5	41	0.1219512
NODE_1640_length_1780_cov_21.089233	1071	1112	22	1	41	0.0243902
NODE_1640_length_1780_cov_21.089233	1071	1112	24	2	41	0.0487805
NODE_1640_length_1780_cov_21.089233	1071	1112	26	1	41	0.0243902
NODE_1640_length_1780_cov_21.089233	1071	1112	27	2	41	0.0487805
NODE_1640_length_1780_cov_21.089233	1071	1112	30	1	41	0.0243902
NODE_1640_length_1780_cov_21.089233	1071	1112	32	8	41	0.1951219
NODE_1640_length_1780_cov_21.089233	1071	1112	33	2	41	0.0487805
NODE_1640_length_1780_cov_21.089233	1071	1112	35	3	41	0.0731707
NODE_1640_length_1780_cov_21.089233	1071	1112	39	3	41	0.0731707
NODE_1640_length_1780_cov_21.089233	1071	1112	41	2	41	0.0487805
NODE_1640_length_1780_cov_21.089233	1071	1112	42	3	41	0.0731707
NODE_1641_length_1780_cov_7.837597	1682	1747	0	65	65	1.0000000
NODE_1649_length_1778_cov_52.804050	1528	1568	0	8	40	0.2000000
NODE_1649_length_1778_cov_52.804050	1528	1568	2	3	40	0.0750000
NODE_1649_length_1778_cov_52.804050	1528	1568	3	1	40	0.0250000
NODE_1649_length_1778_cov_52.804050	1528	1568	5	1	40	0.0250000
NODE_1649_length_1778_cov_52.804050	1528	1568	7	3	40	0.0750000
NODE_1649_length_1778_cov_52.804050	1528	1568	17	2	40	0.0500000
NODE_1649_length_1778_cov_52.804050	1528	1568	24	1	40	0.0250000
NODE_1649_length_1778_cov_52.804050	1528	1568	25	9	40	0.2250000
NODE_1649_length_1778_cov_52.804050	1528	1568	28	12	40	0.3000000
NODE_1649_length_1778_cov_52.804050	1541	1621	7	3	80	0.0375000
NODE_1649_length_1778_cov_52.804050	1541	1621	17	2	80	0.0250000
NODE_1649_length_1778_cov_52.804050	1541	1621	24	1	80	0.0125000
NODE_1649_length_1778_cov_52.804050	1541	1621	25	9	80	0.1125000
NODE_1649_length_1778_cov_52.804050	1541	1621	28	16	80	0.2000000
NODE_1649_length_1778_cov_52.804050	1541	1621	30	19	80	0.2375000
NODE_1649_length_1778_cov_52.804050	1541	1621	32	25	80	0.3125000
NODE_1649_length_1778_cov_52.804050	1541	1621	34	5	80	0.0625000
NODE_1649_length_1778_cov_52.804050	1541	1621	7	3	80	0.0375000
NODE_1649_length_1778_cov_52.804050	1541	1621	17	2	80	0.0250000
NODE_1649_length_1778_cov_52.804050	1541	1621	24	1	80	0.0125000
NODE_1649_length_1778_cov_52.804050	1541	1621	25	9	80	0.1125000
NODE_1649_length_1778_cov_52.804050	1541	1621	28	16	80	0.2000000
NODE_1649_length_1778_cov_52.804050	1541	1621	30	19	80	0.2375000
NODE_1649_length_1778_cov_52.804050	1541	1621	32	25	80	0.3125000
NODE_1649_length_1778_cov_52.804050	1541	1621	34	5	80	0.0625000
NODE_1649_length_1778_cov_52.804050	1541	1621	7	3	80	0.0375000
NODE_1649_length_1778_cov_52.804050	1541	1621	17	2	80	0.0250000
NODE_1649_length_1778_cov_52.804050	1541	1621	24	1	80	0.0125000
NODE_1649_length_1778_cov_52.804050	1541	1621	25	9	80	0.1125000
NODE_1649_length_1778_cov_52.804050	1541	1621	28	16	80	0.2000000
NODE_1649_length_1778_cov_52.804050	1541	1621	30	19	80	0.2375000
NODE_1649_length_1778_cov_52.804050	1541	1621	32	25	80	0.3125000
NODE_1649_length_1778_cov_52.804050	1541	1621	34	5	80	0.0625000
NODE_1649_length_1778_cov_52.804050	1541	1621	7	3	80	0.0375000
NODE_1649_length_1778_cov_52.804050	1541	1621	17	2	80	0.0250000
NODE_1649_length_1778_cov_52.804050	1541	1621	24	1	80	0.0125000
NODE_1649_length_1778_cov_52.804050	1541	1621	25	9	80	0.1125000
NODE_1649_length_1778_cov_52.804050	1541	1621	28	16	80	0.2000000
NODE_1649_length_1778_cov_52.804050	1541	1621	30	19	80	0.2375000
NODE_1649_length_1778_cov_52.804050	1541	1621	32	25	80	0.3125000
NODE_1649_length_1778_cov_52.804050	1541	1621	34	5	80	0.0625000
NODE_1649_length_1778_cov_52.804050	1541	1621	7	3	80	0.0375000
NODE_1649_length_1778_cov_52.804050	1541	1621	17	2	80	0.0250000
NODE_1649_length_1778_cov_52.804050	1541	1621	24	1	80	0.0125000
NODE_1649_length_1778_cov_52.804050	1541	1621	25	9	80	0.1125000
NODE_1649_length_1778_cov_52.804050	1541	1621	28	16	80	0.2000000
NODE_1649_length_1778_cov_52.804050	1541	1621	30	19	80	0.2375000
NODE_1649_length_1778_cov_52.804050	1541	1621	32	25	80	0.3125000
NODE_1649_length_1778_cov_52.804050	1541	1621	34	5	80	0.0625000
NODE_1649_length_1778_cov_52.804050	1541	1621	7	3	80	0.0375000
NODE_1649_length_1778_cov_52.804050	1541	1621	17	2	80	0.0250000
NODE_1649_length_1778_cov_52.804050	1541	1621	24	1	80	0.0125000
NODE_1649_length_1778_cov_52.804050	1541	1621	25	9	80	0.1125000
NODE_1649_length_1778_cov_52.804050	1541	1621	28	16	80	0.2000000
NODE_1649_length_1778_cov_52.804050	1541	1621	30	19	80	0.2375000
NODE_1649_length_1778_cov_52.804050	1541	1621	32	25	80	0.3125000
NODE_1649_length_1778_cov_52.804050	1541	1621	34	5	80	0.0625000
NODE_1649_length_1778_cov_52.804050	1617	1697	12	1	80	0.0125000
NODE_1649_length_1778_cov_52.804050	1617	1697	14	21	80	0.2625000
NODE_1649_length_1778_cov_52.804050	1617	1697	18	1	80	0.0125000
NODE_1649_length_1778_cov_52.804050	1617	1697	24	11	80	0.1375000
NODE_1649_length_1778_cov_52.804050	1617	1697	26	1	80	0.0125000
NODE_1649_length_1778_cov_52.804050	1617	1697	28	6	80	0.0750000
NODE_1649_length_1778_cov_52.804050	1617	1697	30	3	80	0.0375000
NODE_1649_length_1778_cov_52.804050	1617	1697	32	6	80	0.0750000
NODE_1649_length_1778_cov_52.804050	1617	1697	34	24	80	0.3000000
NODE_1649_length_1778_cov_52.804050	1617	1697	36	6	80	0.0750000
NODE_1649_length_1778_cov_52.804050	1617	1697	12	1	80	0.0125000
NODE_1649_length_1778_cov_52.804050	1617	1697	14	21	80	0.2625000
NODE_1649_length_1778_cov_52.804050	1617	1697	18	1	80	0.0125000
NODE_1649_length_1778_cov_52.804050	1617	1697	24	11	80	0.1375000
NODE_1649_length_1778_cov_52.804050	1617	1697	26	1	80	0.0125000
NODE_1649_length_1778_cov_52.804050	1617	1697	28	6	80	0.0750000
NODE_1649_length_1778_cov_52.804050	1617	1697	30	3	80	0.0375000
NODE_1649_length_1778_cov_52.804050	1617	1697	32	6	80	0.0750000
NODE_1649_length_1778_cov_52.804050	1617	1697	34	24	80	0.3000000
NODE_1649_length_1778_cov_52.804050	1617	1697	36	6	80	0.0750000
NODE_1649_length_1778_cov_52.804050	1617	1697	12	1	80	0.0125000
NODE_1649_length_1778_cov_52.804050	1617	1697	14	21	80	0.2625000
NODE_1649_length_1778_cov_52.804050	1617	1697	18	1	80	0.0125000
NODE_1649_length_1778_cov_52.804050	1617	1697	24	11	80	0.1375000
NODE_1649_length_1778_cov_52.804050	1617	1697	26	1	80	0.0125000
NODE_1649_length_1778_cov_52.804050	1617	1697	28	6	80	0.0750000
NODE_1649_length_1778_cov_52.804050	1617	1697	30	3	80	0.0375000
NODE_1649_length_1778_cov_52.804050	1617	1697	32	6	80	0.0750000
NODE_1649_length_1778_cov_52.804050	1617	1697	34	24	80	0.3000000
NODE_1649_length_1778_cov_52.804050	1617	1697	36	6	80	0.0750000
NODE_1649_length_1778_cov_52.804050	1617	1697	12	1	80	0.0125000
NODE_1649_length_1778_cov_52.804050	1617	1697	14	21	80	0.2625000
NODE_1649_length_1778_cov_52.804050	1617	1697	18	1	80	0.0125000
NODE_1649_length_1778_cov_52.804050	1617	1697	24	11	80	0.1375000
NODE_1649_length_1778_cov_52.804050	1617	1697	26	1	80	0.0125000
NODE_1649_length_1778_cov_52.804050	1617	1697	28	6	80	0.0750000
NODE_1649_length_1778_cov_52.804050	1617	1697	30	3	80	0.0375000
NODE_1649_length_1778_cov_52.804050	1617	1697	32	6	80	0.0750000
NODE_1649_length_1778_cov_52.804050	1617	1697	34	24	80	0.3000000
NODE_1649_length_1778_cov_52.804050	1617	1697	36	6	80	0.0750000
NODE_1649_length_1778_cov_52.804050	1670	1750	2	9	80	0.1125000
NODE_1649_length_1778_cov_52.804050	1670	1750	4	3	80	0.0375000
NODE_1649_length_1778_cov_52.804050	1670	1750	6	3	80	0.0375000
NODE_1649_length_1778_cov_52.804050	1670	1750	8	17	80	0.2125000
NODE_1649_length_1778_cov_52.804050	1670	1750	9	15	80	0.1875000
NODE_1649_length_1778_cov_52.804050	1670	1750	11	2	80	0.0250000
NODE_1649_length_1778_cov_52.804050	1670	1750	12	5	80	0.0625000
NODE_1649_length_1778_cov_52.804050	1670	1750	14	21	80	0.2625000
NODE_1649_length_1778_cov_52.804050	1670	1750	18	1	80	0.0125000
NODE_1649_length_1778_cov_52.804050	1670	1750	24	4	80	0.0500000
NODE_1649_length_1778_cov_52.804050	1670	1750	2	9	80	0.1125000
NODE_1649_length_1778_cov_52.804050	1670	1750	4	3	80	0.0375000
NODE_1649_length_1778_cov_52.804050	1670	1750	6	3	80	0.0375000
NODE_1649_length_1778_cov_52.804050	1670	1750	8	17	80	0.2125000
NODE_1649_length_1778_cov_52.804050	1670	1750	9	15	80	0.1875000
NODE_1649_length_1778_cov_52.804050	1670	1750	11	2	80	0.0250000
NODE_1649_length_1778_cov_52.804050	1670	1750	12	5	80	0.0625000
NODE_1649_length_1778_cov_52.804050	1670	1750	14	21	80	0.2625000
NODE_1649_length_1778_cov_52.804050	1670	1750	18	1	80	0.0125000
NODE_1649_length_1778_cov_52.804050	1670	1750	24	4	80	0.0500000
NODE_1649_length_1778_cov_52.804050	1670	1750	2	9	80	0.1125000
NODE_1649_length_1778_cov_52.804050	1670	1750	4	3	80	0.0375000
NODE_1649_length_1778_cov_52.804050	1670	1750	6	3	80	0.0375000
NODE_1649_length_1778_cov_52.804050	1670	1750	8	17	80	0.2125000
NODE_1649_length_1778_cov_52.804050	1670	1750	9	15	80	0.1875000
NODE_1649_length_1778_cov_52.804050	1670	1750	11	2	80	0.0250000
NODE_1649_length_1778_cov_52.804050	1670	1750	12	5	80	0.0625000
NODE_1649_length_1778_cov_52.804050	1670	1750	14	21	80	0.2625000
NODE_1649_length_1778_cov_52.804050	1670	1750	18	1	80	0.0125000
NODE_1649_length_1778_cov_52.804050	1670	1750	24	4	80	0.0500000
NODE_1649_length_1778_cov_52.804050	1670	1741	4	3	71	0.0422535
NODE_1649_length_1778_cov_52.804050	1670	1741	6	3	71	0.0422535
NODE_1649_length_1778_cov_52.804050	1670	1741	8	17	71	0.2394366
NODE_1649_length_1778_cov_52.804050	1670	1741	9	15	71	0.2112676
NODE_1649_length_1778_cov_52.804050	1670	1741	11	2	71	0.0281690
NODE_1649_length_1778_cov_52.804050	1670	1741	12	5	71	0.0704225
NODE_1649_length_1778_cov_52.804050	1670	1741	14	21	71	0.2957746
NODE_1649_length_1778_cov_52.804050	1670	1741	18	1	71	0.0140845
NODE_1649_length_1778_cov_52.804050	1670	1741	24	4	71	0.0563380
NODE_1649_length_1778_cov_52.804050	1673	1743	2	2	70	0.0285714
NODE_1649_length_1778_cov_52.804050	1673	1743	4	3	70	0.0428571
NODE_1649_length_1778_cov_52.804050	1673	1743	6	3	70	0.0428571
NODE_1649_length_1778_cov_52.804050	1673	1743	8	17	70	0.2428571
NODE_1649_length_1778_cov_52.804050	1673	1743	9	15	70	0.2142857
NODE_1649_length_1778_cov_52.804050	1673	1743	11	2	70	0.0285714
NODE_1649_length_1778_cov_52.804050	1673	1743	12	5	70	0.0714286
NODE_1649_length_1778_cov_52.804050	1673	1743	14	21	70	0.3000000
NODE_1649_length_1778_cov_52.804050	1673	1743	18	1	70	0.0142857
NODE_1649_length_1778_cov_52.804050	1673	1743	24	1	70	0.0142857
NODE_1649_length_1778_cov_52.804050	1679	1750	2	9	71	0.1267606
NODE_1649_length_1778_cov_52.804050	1679	1750	4	3	71	0.0422535
NODE_1649_length_1778_cov_52.804050	1679	1750	6	3	71	0.0422535
NODE_1649_length_1778_cov_52.804050	1679	1750	8	17	71	0.2394366
NODE_1649_length_1778_cov_52.804050	1679	1750	9	15	71	0.2112676
NODE_1649_length_1778_cov_52.804050	1679	1750	11	2	71	0.0281690
NODE_1649_length_1778_cov_52.804050	1679	1750	12	5	71	0.0704225
NODE_1649_length_1778_cov_52.804050	1679	1750	14	17	71	0.2394366
NODE_1651_length_1776_cov_43.081694	1246	1308	0	57	62	0.9193549
NODE_1651_length_1776_cov_43.081694	1246	1308	8	4	62	0.0645161
NODE_1651_length_1776_cov_43.081694	1246	1308	13	1	62	0.0161290
NODE_1651_length_1776_cov_43.081694	1281	1361	0	80	80	1.0000000
NODE_1652_length_1776_cov_9.256410	1120	1200	0	80	80	1.0000000
NODE_1652_length_1776_cov_9.256410	1173	1253	0	80	80	1.0000000
NODE_1652_length_1776_cov_9.256410	1249	1329	0	16	80	0.2000000
NODE_1652_length_1776_cov_9.256410	1249	1329	2	23	80	0.2875000
NODE_1652_length_1776_cov_9.256410	1249	1329	4	41	80	0.5125000
NODE_1652_length_1776_cov_9.256410	1302	1382	0	42	80	0.5250000
NODE_1652_length_1776_cov_9.256410	1302	1382	2	2	80	0.0250000
NODE_1652_length_1776_cov_9.256410	1302	1382	4	36	80	0.4500000
NODE_1657_length_1775_cov_54.208234	1103	1167	57	3	64	0.0468750
NODE_1657_length_1775_cov_54.208234	1103	1167	58	1	64	0.0156250
NODE_1657_length_1775_cov_54.208234	1103	1167	59	1	64	0.0156250
NODE_1657_length_1775_cov_54.208234	1103	1167	61	3	64	0.0468750
NODE_1657_length_1775_cov_54.208234	1103	1167	63	1	64	0.0156250
NODE_1657_length_1775_cov_54.208234	1103	1167	64	1	64	0.0156250
NODE_1657_length_1775_cov_54.208234	1103	1167	68	10	64	0.1562500
NODE_1657_length_1775_cov_54.208234	1103	1167	70	9	64	0.1406250
NODE_1657_length_1775_cov_54.208234	1103	1167	71	12	64	0.1875000
NODE_1657_length_1775_cov_54.208234	1103	1167	72	17	64	0.2656250
NODE_1657_length_1775_cov_54.208234	1103	1167	73	2	64	0.0312500
NODE_1657_length_1775_cov_54.208234	1103	1167	74	4	64	0.0625000
NODE_1657_length_1775_cov_54.208234	1103	1167	57	3	64	0.0468750
NODE_1657_length_1775_cov_54.208234	1103	1167	58	1	64	0.0156250
NODE_1657_length_1775_cov_54.208234	1103	1167	59	1	64	0.0156250
NODE_1657_length_1775_cov_54.208234	1103	1167	61	3	64	0.0468750
NODE_1657_length_1775_cov_54.208234	1103	1167	63	1	64	0.0156250
NODE_1657_length_1775_cov_54.208234	1103	1167	64	1	64	0.0156250
NODE_1657_length_1775_cov_54.208234	1103	1167	68	10	64	0.1562500
NODE_1657_length_1775_cov_54.208234	1103	1167	70	9	64	0.1406250
NODE_1657_length_1775_cov_54.208234	1103	1167	71	12	64	0.1875000
NODE_1657_length_1775_cov_54.208234	1103	1167	72	17	64	0.2656250
NODE_1657_length_1775_cov_54.208234	1103	1167	73	2	64	0.0312500
NODE_1657_length_1775_cov_54.208234	1103	1167	74	4	64	0.0625000
NODE_1657_length_1775_cov_54.208234	1140	1200	16	2	60	0.0333333
NODE_1657_length_1775_cov_54.208234	1140	1200	18	2	60	0.0333333
NODE_1657_length_1775_cov_54.208234	1140	1200	20	4	60	0.0666667
NODE_1657_length_1775_cov_54.208234	1140	1200	22	3	60	0.0500000
NODE_1657_length_1775_cov_54.208234	1140	1200	24	1	60	0.0166667
NODE_1657_length_1775_cov_54.208234	1140	1200	26	2	60	0.0333333
NODE_1657_length_1775_cov_54.208234	1140	1200	28	1	60	0.0166667
NODE_1657_length_1775_cov_54.208234	1140	1200	30	3	60	0.0500000
NODE_1657_length_1775_cov_54.208234	1140	1200	32	1	60	0.0166667
NODE_1657_length_1775_cov_54.208234	1140	1200	34	3	60	0.0500000
NODE_1657_length_1775_cov_54.208234	1140	1200	39	1	60	0.0166667
NODE_1657_length_1775_cov_54.208234	1140	1200	47	1	60	0.0166667
NODE_1657_length_1775_cov_54.208234	1140	1200	50	4	60	0.0666667
NODE_1657_length_1775_cov_54.208234	1140	1200	52	3	60	0.0500000
NODE_1657_length_1775_cov_54.208234	1140	1200	56	2	60	0.0333333
NODE_1657_length_1775_cov_54.208234	1140	1200	57	3	60	0.0500000
NODE_1657_length_1775_cov_54.208234	1140	1200	58	1	60	0.0166667
NODE_1657_length_1775_cov_54.208234	1140	1200	59	1	60	0.0166667
NODE_1657_length_1775_cov_54.208234	1140	1200	61	3	60	0.0500000
NODE_1657_length_1775_cov_54.208234	1140	1200	63	1	60	0.0166667
NODE_1657_length_1775_cov_54.208234	1140	1200	64	1	60	0.0166667
NODE_1657_length_1775_cov_54.208234	1140	1200	68	3	60	0.0500000
NODE_1657_length_1775_cov_54.208234	1140	1200	70	1	60	0.0166667
NODE_1657_length_1775_cov_54.208234	1140	1200	71	11	60	0.1833333
NODE_1657_length_1775_cov_54.208234	1140	1200	73	2	60	0.0333333
NODE_1658_length_1775_cov_13.181981	1170	1250	0	80	80	1.0000000
NODE_1658_length_1775_cov_13.181981	1223	1303	0	80	80	1.0000000
NODE_1659_length_1775_cov_4.218974	1304	1384	0	80	80	1.0000000
NODE_1659_length_1775_cov_4.218974	1357	1437	0	80	80	1.0000000
NODE_1660_length_1774_cov_48.617313	345	425	0	21	80	0.2625000
NODE_1660_length_1774_cov_48.617313	345	425	2	59	80	0.7375000
NODE_1660_length_1774_cov_48.617313	398	478	0	11	80	0.1375000
NODE_1660_length_1774_cov_48.617313	398	478	2	69	80	0.8625000
NODE_1660_length_1774_cov_48.617313	474	554	0	80	80	1.0000000
NODE_1660_length_1774_cov_48.617313	527	607	0	80	80	1.0000000
NODE_1660_length_1774_cov_48.617313	1027	1107	0	5	80	0.0625000
NODE_1660_length_1774_cov_48.617313	1027	1107	2	30	80	0.3750000
NODE_1660_length_1774_cov_48.617313	1027	1107	4	45	80	0.5625000
NODE_1660_length_1774_cov_48.617313	1080	1160	0	29	80	0.3625000
NODE_1660_length_1774_cov_48.617313	1080	1160	2	19	80	0.2375000
NODE_1660_length_1774_cov_48.617313	1080	1160	4	32	80	0.4000000
NODE_1660_length_1774_cov_48.617313	1156	1236	4	80	80	1.0000000
NODE_1660_length_1774_cov_48.617313	1209	1289	0	28	80	0.3500000
NODE_1660_length_1774_cov_48.617313	1209	1289	4	52	80	0.6500000
NODE_1662_length_1774_cov_8.011343	1655	1735	0	80	80	1.0000000
NODE_1663_length_1773_cov_5.547192	433	513	0	23	80	0.2875000
NODE_1663_length_1773_cov_5.547192	433	513	2	1	80	0.0125000
NODE_1663_length_1773_cov_5.547192	433	513	3	25	80	0.3125000
NODE_1663_length_1773_cov_5.547192	433	513	4	31	80	0.3875000
NODE_1663_length_1773_cov_5.547192	486	566	0	18	80	0.2250000
NODE_1663_length_1773_cov_5.547192	486	566	4	62	80	0.7750000
NODE_1664_length_1773_cov_3.925329	267	347	0	29	80	0.3625000
NODE_1664_length_1773_cov_3.925329	267	347	1	51	80	0.6375000
NODE_1664_length_1773_cov_3.925329	320	400	0	80	80	1.0000000
NODE_1666_length_1770_cov_9.912029	369	437	0	68	68	1.0000000
NODE_1666_length_1770_cov_9.912029	388	431	0	43	43	1.0000000
NODE_1666_length_1770_cov_9.912029	509	577	0	68	68	1.0000000
NODE_1666_length_1770_cov_9.912029	515	571	0	56	56	1.0000000
NODE_1666_length_1770_cov_9.912029	579	618	0	39	39	1.0000000
NODE_1666_length_1770_cov_9.912029	697	776	0	79	79	1.0000000
NODE_1666_length_1770_cov_9.912029	714	794	0	80	80	1.0000000
NODE_1666_length_1770_cov_9.912029	767	819	0	52	52	1.0000000
NODE_1666_length_1770_cov_9.912029	785	819	0	34	34	1.0000000
NODE_1667_length_1768_cov_9.134811	687	736	43	2	49	0.0408163
NODE_1667_length_1768_cov_9.134811	687	736	45	2	49	0.0408163
NODE_1667_length_1768_cov_9.134811	687	736	47	6	49	0.1224490
NODE_1667_length_1768_cov_9.134811	687	736	49	1	49	0.0204082
NODE_1667_length_1768_cov_9.134811	687	736	51	5	49	0.1020408
NODE_1667_length_1768_cov_9.134811	687	736	52	1	49	0.0204082
NODE_1667_length_1768_cov_9.134811	687	736	53	5	49	0.1020408
NODE_1667_length_1768_cov_9.134811	687	736	54	1	49	0.0204082
NODE_1667_length_1768_cov_9.134811	687	736	55	12	49	0.2448980
NODE_1667_length_1768_cov_9.134811	687	736	56	5	49	0.1020408
NODE_1667_length_1768_cov_9.134811	687	736	57	9	49	0.1836735
NODE_1668_length_1768_cov_6.605153	1207	1287	0	80	80	1.0000000
NODE_1668_length_1768_cov_6.605153	1260	1340	0	80	80	1.0000000
NODE_1668_length_1768_cov_6.605153	1336	1416	0	55	80	0.6875000
NODE_1668_length_1768_cov_6.605153	1336	1416	2	25	80	0.3125000
NODE_1668_length_1768_cov_6.605153	1389	1469	0	2	80	0.0250000
NODE_1668_length_1768_cov_6.605153	1389	1469	2	52	80	0.6500000
NODE_1668_length_1768_cov_6.605153	1389	1469	4	26	80	0.3250000
NODE_1669_length_1767_cov_5.475420	508	588	2	3	80	0.0375000
NODE_1669_length_1767_cov_5.475420	508	588	4	52	80	0.6500000
NODE_1669_length_1767_cov_5.475420	508	588	8	2	80	0.0250000
NODE_1669_length_1767_cov_5.475420	508	588	10	3	80	0.0375000
NODE_1669_length_1767_cov_5.475420	508	588	12	18	80	0.2250000
NODE_1669_length_1767_cov_5.475420	508	588	14	2	80	0.0250000
NODE_1680_length_1762_cov_18.673482	606	686	0	80	80	1.0000000
NODE_1680_length_1762_cov_18.673482	659	739	0	80	80	1.0000000
NODE_1680_length_1762_cov_18.673482	735	815	0	31	80	0.3875000
NODE_1680_length_1762_cov_18.673482	735	815	2	36	80	0.4500000
NODE_1680_length_1762_cov_18.673482	735	815	3	11	80	0.1375000
NODE_1680_length_1762_cov_18.673482	735	815	4	2	80	0.0250000
NODE_1680_length_1762_cov_18.673482	788	868	2	51	80	0.6375000
NODE_1680_length_1762_cov_18.673482	788	868	3	11	80	0.1375000
NODE_1680_length_1762_cov_18.673482	788	868	4	18	80	0.2250000
NODE_1681_length_1762_cov_6.760072	1033	1113	0	24	80	0.3000000
NODE_1681_length_1762_cov_6.760072	1033	1113	2	56	80	0.7000000
NODE_1681_length_1762_cov_6.760072	1086	1166	0	38	80	0.4750000
NODE_1681_length_1762_cov_6.760072	1086	1166	2	42	80	0.5250000
NODE_1685_length_1760_cov_8.064419	941	1021	0	56	80	0.7000000
NODE_1685_length_1760_cov_8.064419	941	1021	2	24	80	0.3000000
NODE_1685_length_1760_cov_8.064419	994	1074	0	11	80	0.1375000
NODE_1685_length_1760_cov_8.064419	994	1074	2	69	80	0.8625000
NODE_1692_length_1758_cov_99.869198	599	679	0	58	80	0.7250000
NODE_1692_length_1758_cov_99.869198	599	679	1	14	80	0.1750000
NODE_1692_length_1758_cov_99.869198	599	679	2	3	80	0.0375000
NODE_1692_length_1758_cov_99.869198	599	679	4	5	80	0.0625000
NODE_1692_length_1758_cov_99.869198	652	732	0	5	80	0.0625000
NODE_1692_length_1758_cov_99.869198	652	732	1	14	80	0.1750000
NODE_1692_length_1758_cov_99.869198	652	732	2	3	80	0.0375000
NODE_1692_length_1758_cov_99.869198	652	732	4	58	80	0.7250000
NODE_1692_length_1758_cov_99.869198	728	808	4	13	80	0.1625000
NODE_1692_length_1758_cov_99.869198	728	808	6	13	80	0.1625000
NODE_1692_length_1758_cov_99.869198	728	808	10	4	80	0.0500000
NODE_1692_length_1758_cov_99.869198	728	808	11	1	80	0.0125000
NODE_1692_length_1758_cov_99.869198	728	808	12	31	80	0.3875000
NODE_1692_length_1758_cov_99.869198	728	808	14	18	80	0.2250000
NODE_1692_length_1758_cov_99.869198	781	861	0	3	80	0.0375000
NODE_1692_length_1758_cov_99.869198	781	861	2	1	80	0.0125000
NODE_1692_length_1758_cov_99.869198	781	861	4	27	80	0.3375000
NODE_1692_length_1758_cov_99.869198	781	861	10	9	80	0.1125000
NODE_1692_length_1758_cov_99.869198	781	861	11	14	80	0.1750000
NODE_1692_length_1758_cov_99.869198	781	861	12	26	80	0.3250000
NODE_1693_length_1757_cov_3.126659	49	121	0	72	72	1.0000000
NODE_1696_length_1755_cov_9.938406	231	311	0	80	80	1.0000000
NODE_1696_length_1755_cov_9.938406	284	364	0	80	80	1.0000000
NODE_1698_length_1755_cov_3.614130	171	222	2	51	51	1.0000000
NODE_1699_length_1754_cov_8.523263	0	77	0	15	77	0.1948052
NODE_1699_length_1754_cov_8.523263	0	77	2	5	77	0.0649351
NODE_1699_length_1754_cov_8.523263	0	77	4	57	77	0.7402598
NODE_1699_length_1754_cov_8.523263	0	77	0	15	77	0.1948052
NODE_1699_length_1754_cov_8.523263	0	77	2	5	77	0.0649351
NODE_1699_length_1754_cov_8.523263	0	77	4	57	77	0.7402598
NODE_1699_length_1754_cov_8.523263	0	77	0	15	77	0.1948052
NODE_1699_length_1754_cov_8.523263	0	77	2	5	77	0.0649351
NODE_1699_length_1754_cov_8.523263	0	77	4	57	77	0.7402598
NODE_1699_length_1754_cov_8.523263	50	99	4	49	49	1.0000000
NODE_1699_length_1754_cov_8.523263	53	99	4	46	46	1.0000000
NODE_1699_length_1754_cov_8.523263	55	99	4	44	44	1.0000000
NODE_1700_length_1753_cov_26.851874	356	436	2	47	80	0.5875000
NODE_1700_length_1753_cov_26.851874	356	436	4	33	80	0.4125000
NODE_1700_length_1753_cov_26.851874	409	489	0	21	80	0.2625000
NODE_1700_length_1753_cov_26.851874	409	489	2	38	80	0.4750000
NODE_1700_length_1753_cov_26.851874	409	489	4	21	80	0.2625000
NODE_1701_length_1753_cov_12.297461	355	435	0	80	80	1.0000000
NODE_1701_length_1753_cov_12.297461	408	488	0	80	80	1.0000000
NODE_1705_length_1750_cov_90.732283	1191	1254	70	5	63	0.0793651
NODE_1705_length_1750_cov_90.732283	1191	1254	72	5	63	0.0793651
NODE_1705_length_1750_cov_90.732283	1191	1254	74	5	63	0.0793651
NODE_1705_length_1750_cov_90.732283	1191	1254	76	2	63	0.0317460
NODE_1705_length_1750_cov_90.732283	1191	1254	78	4	63	0.0634921
NODE_1705_length_1750_cov_90.732283	1191	1254	80	2	63	0.0317460
NODE_1705_length_1750_cov_90.732283	1191	1254	83	1	63	0.0158730
NODE_1705_length_1750_cov_90.732283	1191	1254	86	1	63	0.0158730
NODE_1705_length_1750_cov_90.732283	1191	1254	88	2	63	0.0317460
NODE_1705_length_1750_cov_90.732283	1191	1254	89	2	63	0.0317460
NODE_1705_length_1750_cov_90.732283	1191	1254	90	3	63	0.0476190
NODE_1705_length_1750_cov_90.732283	1191	1254	91	4	63	0.0634921
NODE_1705_length_1750_cov_90.732283	1191	1254	92	1	63	0.0158730
NODE_1705_length_1750_cov_90.732283	1191	1254	93	1	63	0.0158730
NODE_1705_length_1750_cov_90.732283	1191	1254	94	3	63	0.0476190
NODE_1705_length_1750_cov_90.732283	1191	1254	95	1	63	0.0158730
NODE_1705_length_1750_cov_90.732283	1191	1254	96	3	63	0.0476190
NODE_1705_length_1750_cov_90.732283	1191	1254	100	1	63	0.0158730
NODE_1705_length_1750_cov_90.732283	1191	1254	104	1	63	0.0158730
NODE_1705_length_1750_cov_90.732283	1191	1254	110	1	63	0.0158730
NODE_1705_length_1750_cov_90.732283	1191	1254	112	1	63	0.0158730
NODE_1705_length_1750_cov_90.732283	1191	1254	113	5	63	0.0793651
NODE_1705_length_1750_cov_90.732283	1191	1254	114	3	63	0.0476190
NODE_1705_length_1750_cov_90.732283	1191	1254	115	2	63	0.0317460
NODE_1705_length_1750_cov_90.732283	1191	1254	116	1	63	0.0158730
NODE_1705_length_1750_cov_90.732283	1191	1254	117	1	63	0.0158730
NODE_1705_length_1750_cov_90.732283	1191	1254	121	1	63	0.0158730
NODE_1705_length_1750_cov_90.732283	1191	1254	122	1	63	0.0158730
NODE_1705_length_1750_cov_90.732283	1239	1310	112	2	71	0.0281690
NODE_1705_length_1750_cov_90.732283	1239	1310	113	5	71	0.0704225
NODE_1705_length_1750_cov_90.732283	1239	1310	114	4	71	0.0563380
NODE_1705_length_1750_cov_90.732283	1239	1310	115	2	71	0.0281690
NODE_1705_length_1750_cov_90.732283	1239	1310	116	1	71	0.0140845
NODE_1705_length_1750_cov_90.732283	1239	1310	117	2	71	0.0281690
NODE_1705_length_1750_cov_90.732283	1239	1310	119	1	71	0.0140845
NODE_1705_length_1750_cov_90.732283	1239	1310	121	1	71	0.0140845
NODE_1705_length_1750_cov_90.732283	1239	1310	122	1	71	0.0140845
NODE_1705_length_1750_cov_90.732283	1239	1310	123	2	71	0.0281690
NODE_1705_length_1750_cov_90.732283	1239	1310	125	2	71	0.0281690
NODE_1705_length_1750_cov_90.732283	1239	1310	126	1	71	0.0140845
NODE_1705_length_1750_cov_90.732283	1239	1310	127	1	71	0.0140845
NODE_1705_length_1750_cov_90.732283	1239	1310	128	3	71	0.0422535
NODE_1705_length_1750_cov_90.732283	1239	1310	130	1	71	0.0140845
NODE_1705_length_1750_cov_90.732283	1239	1310	132	1	71	0.0140845
NODE_1705_length_1750_cov_90.732283	1239	1310	134	2	71	0.0281690
NODE_1705_length_1750_cov_90.732283	1239	1310	136	2	71	0.0281690
NODE_1705_length_1750_cov_90.732283	1239	1310	138	2	71	0.0281690
NODE_1705_length_1750_cov_90.732283	1239	1310	140	1	71	0.0140845
NODE_1705_length_1750_cov_90.732283	1239	1310	142	4	71	0.0563380
NODE_1705_length_1750_cov_90.732283	1239	1310	144	1	71	0.0140845
NODE_1705_length_1750_cov_90.732283	1239	1310	148	2	71	0.0281690
NODE_1705_length_1750_cov_90.732283	1239	1310	150	7	71	0.0985916
NODE_1705_length_1750_cov_90.732283	1239	1310	152	3	71	0.0422535
NODE_1705_length_1750_cov_90.732283	1239	1310	154	4	71	0.0563380
NODE_1705_length_1750_cov_90.732283	1239	1310	156	4	71	0.0563380
NODE_1705_length_1750_cov_90.732283	1239	1310	157	1	71	0.0140845
NODE_1705_length_1750_cov_90.732283	1239	1310	158	5	71	0.0704225
NODE_1705_length_1750_cov_90.732283	1239	1310	160	2	71	0.0281690
NODE_1705_length_1750_cov_90.732283	1239	1310	162	1	71	0.0140845
NODE_1711_length_1746_cov_3.095932	458	524	0	56	66	0.8484849
NODE_1711_length_1746_cov_3.095932	458	524	2	10	66	0.1515152
NODE_1712_length_1745_cov_7.646416	430	510	0	17	80	0.2125000
NODE_1712_length_1745_cov_7.646416	430	510	2	63	80	0.7875000
NODE_1712_length_1745_cov_7.646416	483	563	0	70	80	0.8750000
NODE_1712_length_1745_cov_7.646416	483	563	2	10	80	0.1250000
NODE_1715_length_1744_cov_10.144681	1213	1289	0	43	76	0.5657895
NODE_1715_length_1744_cov_10.144681	1213	1289	2	2	76	0.0263158
NODE_1715_length_1744_cov_10.144681	1213	1289	4	31	76	0.4078947
NODE_1715_length_1744_cov_10.144681	1262	1342	4	80	80	1.0000000
NODE_1719_length_1742_cov_18.923311	699	776	0	3	77	0.0389610
NODE_1719_length_1742_cov_18.923311	699	776	2	20	77	0.2597403
NODE_1719_length_1742_cov_18.923311	699	776	4	54	77	0.7012987
NODE_1719_length_1742_cov_18.923311	749	829	0	5	80	0.0625000
NODE_1719_length_1742_cov_18.923311	749	829	2	1	80	0.0125000
NODE_1719_length_1742_cov_18.923311	749	829	4	74	80	0.9250000
NODE_1722_length_1741_cov_7.657734	1234	1314	0	80	80	1.0000000
NODE_1722_length_1741_cov_7.657734	1287	1367	0	80	80	1.0000000
NODE_1722_length_1741_cov_7.657734	1363	1443	0	80	80	1.0000000
NODE_1722_length_1741_cov_7.657734	1416	1496	0	80	80	1.0000000
NODE_1726_length_1740_cov_38.411335	517	597	0	80	80	1.0000000
NODE_1726_length_1740_cov_38.411335	570	650	0	80	80	1.0000000
NODE_1726_length_1740_cov_38.411335	646	726	0	45	80	0.5625000
NODE_1726_length_1740_cov_38.411335	646	726	2	6	80	0.0750000
NODE_1726_length_1740_cov_38.411335	646	726	6	29	80	0.3625000
NODE_1726_length_1740_cov_38.411335	699	779	6	80	80	1.0000000
NODE_1727_length_1740_cov_10.843388	552	632	0	80	80	1.0000000
NODE_1727_length_1740_cov_10.843388	708	788	2	80	80	1.0000000
NODE_1727_length_1740_cov_10.843388	708	788	2	80	80	1.0000000
NODE_1727_length_1740_cov_10.843388	708	788	2	80	80	1.0000000
NODE_1727_length_1740_cov_10.843388	761	841	0	32	80	0.4000000
NODE_1727_length_1740_cov_10.843388	761	841	2	48	80	0.6000000
NODE_1727_length_1740_cov_10.843388	761	808	2	47	47	1.0000000
NODE_1727_length_1740_cov_10.843388	761	808	2	47	47	1.0000000
NODE_1737_length_1736_cov_71.959682	841	901	24	3	60	0.0500000
NODE_1737_length_1736_cov_71.959682	841	901	25	1	60	0.0166667
NODE_1737_length_1736_cov_71.959682	841	901	27	1	60	0.0166667
NODE_1737_length_1736_cov_71.959682	841	901	31	4	60	0.0666667
NODE_1737_length_1736_cov_71.959682	841	901	33	1	60	0.0166667
NODE_1737_length_1736_cov_71.959682	841	901	36	2	60	0.0333333
NODE_1737_length_1736_cov_71.959682	841	901	37	1	60	0.0166667
NODE_1737_length_1736_cov_71.959682	841	901	39	2	60	0.0333333
NODE_1737_length_1736_cov_71.959682	841	901	41	4	60	0.0666667
NODE_1737_length_1736_cov_71.959682	841	901	43	10	60	0.1666667
NODE_1737_length_1736_cov_71.959682	841	901	45	2	60	0.0333333
NODE_1737_length_1736_cov_71.959682	841	901	47	3	60	0.0500000
NODE_1737_length_1736_cov_71.959682	841	901	48	12	60	0.2000000
NODE_1737_length_1736_cov_71.959682	841	901	52	14	60	0.2333333
NODE_1738_length_1736_cov_29.174710	1361	1390	81	1	29	0.0344828
NODE_1738_length_1736_cov_29.174710	1361	1390	83	6	29	0.2068966
NODE_1738_length_1736_cov_29.174710	1361	1390	85	1	29	0.0344828
NODE_1738_length_1736_cov_29.174710	1361	1390	87	1	29	0.0344828
NODE_1738_length_1736_cov_29.174710	1361	1390	89	1	29	0.0344828
NODE_1738_length_1736_cov_29.174710	1361	1390	91	1	29	0.0344828
NODE_1738_length_1736_cov_29.174710	1361	1390	92	1	29	0.0344828
NODE_1738_length_1736_cov_29.174710	1361	1390	93	6	29	0.2068966
NODE_1738_length_1736_cov_29.174710	1361	1390	95	1	29	0.0344828
NODE_1738_length_1736_cov_29.174710	1361	1390	97	1	29	0.0344828
NODE_1738_length_1736_cov_29.174710	1361	1390	99	3	29	0.1034483
NODE_1738_length_1736_cov_29.174710	1361	1390	103	2	29	0.0689655
NODE_1738_length_1736_cov_29.174710	1361	1390	105	4	29	0.1379310
NODE_1738_length_1736_cov_29.174710	1566	1628	94	3	62	0.0483871
NODE_1738_length_1736_cov_29.174710	1566	1628	96	2	62	0.0322581
NODE_1738_length_1736_cov_29.174710	1566	1628	97	1	62	0.0161290
NODE_1738_length_1736_cov_29.174710	1566	1628	100	8	62	0.1290323
NODE_1738_length_1736_cov_29.174710	1566	1628	102	6	62	0.0967742
NODE_1738_length_1736_cov_29.174710	1566	1628	106	2	62	0.0322581
NODE_1738_length_1736_cov_29.174710	1566	1628	107	2	62	0.0322581
NODE_1738_length_1736_cov_29.174710	1566	1628	108	1	62	0.0161290
NODE_1738_length_1736_cov_29.174710	1566	1628	109	1	62	0.0161290
NODE_1738_length_1736_cov_29.174710	1566	1628	111	4	62	0.0645161
NODE_1738_length_1736_cov_29.174710	1566	1628	113	5	62	0.0806452
NODE_1738_length_1736_cov_29.174710	1566	1628	115	7	62	0.1129032
NODE_1738_length_1736_cov_29.174710	1566	1628	117	3	62	0.0483871
NODE_1738_length_1736_cov_29.174710	1566	1628	119	1	62	0.0161290
NODE_1738_length_1736_cov_29.174710	1566	1628	121	4	62	0.0645161
NODE_1738_length_1736_cov_29.174710	1566	1628	124	1	62	0.0161290
NODE_1738_length_1736_cov_29.174710	1566	1628	126	5	62	0.0806452
NODE_1738_length_1736_cov_29.174710	1566	1628	128	2	62	0.0322581
NODE_1738_length_1736_cov_29.174710	1566	1628	130	4	62	0.0645161
NODE_1743_length_1732_cov_6.162890	807	887	0	80	80	1.0000000
NODE_1743_length_1732_cov_6.162890	860	940	0	80	80	1.0000000
NODE_1749_length_1729_cov_23.708589	364	443	0	79	79	1.0000000
NODE_1749_length_1729_cov_23.708589	416	496	0	80	80	1.0000000
NODE_1749_length_1729_cov_23.708589	492	572	0	28	80	0.3500000
NODE_1749_length_1729_cov_23.708589	492	572	1	9	80	0.1125000
NODE_1749_length_1729_cov_23.708589	492	572	3	43	80	0.5375000
NODE_1749_length_1729_cov_23.708589	545	625	3	80	80	1.0000000
NODE_1753_length_1728_cov_26.505832	259	339	4	12	80	0.1500000
NODE_1753_length_1728_cov_26.505832	259	339	6	5	80	0.0625000
NODE_1753_length_1728_cov_26.505832	259	339	8	23	80	0.2875000
NODE_1753_length_1728_cov_26.505832	259	339	9	1	80	0.0125000
NODE_1753_length_1728_cov_26.505832	259	339	10	39	80	0.4875000
NODE_1753_length_1728_cov_26.505832	312	392	2	22	80	0.2750000
NODE_1753_length_1728_cov_26.505832	312	392	4	43	80	0.5375000
NODE_1753_length_1728_cov_26.505832	312	392	6	1	80	0.0125000
NODE_1753_length_1728_cov_26.505832	312	392	8	14	80	0.1750000
NODE_1757_length_1725_cov_142.158057	767	814	244	1	47	0.0212766
NODE_1757_length_1725_cov_142.158057	767	814	246	1	47	0.0212766
NODE_1757_length_1725_cov_142.158057	767	814	252	1	47	0.0212766
NODE_1757_length_1725_cov_142.158057	767	814	256	2	47	0.0425532
NODE_1757_length_1725_cov_142.158057	767	814	258	4	47	0.0851064
NODE_1757_length_1725_cov_142.158057	767	814	260	2	47	0.0425532
NODE_1757_length_1725_cov_142.158057	767	814	261	1	47	0.0212766
NODE_1757_length_1725_cov_142.158057	767	814	262	2	47	0.0425532
NODE_1757_length_1725_cov_142.158057	767	814	264	4	47	0.0851064
NODE_1757_length_1725_cov_142.158057	767	814	266	3	47	0.0638298
NODE_1757_length_1725_cov_142.158057	767	814	268	1	47	0.0212766
NODE_1757_length_1725_cov_142.158057	767	814	274	1	47	0.0212766
NODE_1757_length_1725_cov_142.158057	767	814	278	1	47	0.0212766
NODE_1757_length_1725_cov_142.158057	767	814	284	1	47	0.0212766
NODE_1757_length_1725_cov_142.158057	767	814	286	2	47	0.0425532
NODE_1757_length_1725_cov_142.158057	767	814	294	1	47	0.0212766
NODE_1757_length_1725_cov_142.158057	767	814	295	1	47	0.0212766
NODE_1757_length_1725_cov_142.158057	767	814	296	2	47	0.0425532
NODE_1757_length_1725_cov_142.158057	767	814	297	3	47	0.0638298
NODE_1757_length_1725_cov_142.158057	767	814	298	3	47	0.0638298
NODE_1757_length_1725_cov_142.158057	767	814	299	1	47	0.0212766
NODE_1757_length_1725_cov_142.158057	767	814	300	2	47	0.0425532
NODE_1757_length_1725_cov_142.158057	767	814	302	1	47	0.0212766
NODE_1757_length_1725_cov_142.158057	767	814	303	4	47	0.0851064
NODE_1757_length_1725_cov_142.158057	767	814	305	2	47	0.0425532
NODE_1757_length_1725_cov_142.158057	803	867	254	2	64	0.0312500
NODE_1757_length_1725_cov_142.158057	803	867	256	1	64	0.0156250
NODE_1757_length_1725_cov_142.158057	803	867	258	4	64	0.0625000
NODE_1757_length_1725_cov_142.158057	803	867	260	1	64	0.0156250
NODE_1757_length_1725_cov_142.158057	803	867	261	1	64	0.0156250
NODE_1757_length_1725_cov_142.158057	803	867	262	3	64	0.0468750
NODE_1757_length_1725_cov_142.158057	803	867	264	2	64	0.0312500
NODE_1757_length_1725_cov_142.158057	803	867	266	1	64	0.0156250
NODE_1757_length_1725_cov_142.158057	803	867	268	1	64	0.0156250
NODE_1757_length_1725_cov_142.158057	803	867	270	1	64	0.0156250
NODE_1757_length_1725_cov_142.158057	803	867	272	1	64	0.0156250
NODE_1757_length_1725_cov_142.158057	803	867	278	1	64	0.0156250
NODE_1757_length_1725_cov_142.158057	803	867	281	1	64	0.0156250
NODE_1757_length_1725_cov_142.158057	803	867	285	1	64	0.0156250
NODE_1757_length_1725_cov_142.158057	803	867	296	1	64	0.0156250
NODE_1757_length_1725_cov_142.158057	803	867	297	2	64	0.0312500
NODE_1757_length_1725_cov_142.158057	803	867	298	1	64	0.0156250
NODE_1757_length_1725_cov_142.158057	803	867	299	4	64	0.0625000
NODE_1757_length_1725_cov_142.158057	803	867	300	2	64	0.0312500
NODE_1757_length_1725_cov_142.158057	803	867	301	5	64	0.0781250
NODE_1757_length_1725_cov_142.158057	803	867	302	4	64	0.0625000
NODE_1757_length_1725_cov_142.158057	803	867	303	9	64	0.1406250
NODE_1757_length_1725_cov_142.158057	803	867	304	2	64	0.0312500
NODE_1757_length_1725_cov_142.158057	803	867	305	5	64	0.0781250
NODE_1757_length_1725_cov_142.158057	803	867	306	2	64	0.0312500
NODE_1757_length_1725_cov_142.158057	803	867	307	4	64	0.0625000
NODE_1757_length_1725_cov_142.158057	803	867	308	2	64	0.0312500
NODE_1759_length_1724_cov_17.931077	677	746	0	69	69	1.0000000
NODE_1759_length_1724_cov_17.931077	788	850	0	9	62	0.1451613
NODE_1759_length_1724_cov_17.931077	788	850	2	53	62	0.8548387
NODE_1761_length_1723_cov_35.355296	1174	1254	0	80	80	1.0000000
NODE_1761_length_1723_cov_35.355296	1227	1307	0	80	80	1.0000000
NODE_1763_length_1722_cov_13.235367	708	788	0	35	80	0.4375000
NODE_1763_length_1722_cov_13.235367	708	788	2	45	80	0.5625000
NODE_1763_length_1722_cov_13.235367	761	841	0	9	80	0.1125000
NODE_1763_length_1722_cov_13.235367	761	841	2	71	80	0.8875000
NODE_1763_length_1722_cov_13.235367	1319	1399	0	80	80	1.0000000
NODE_1763_length_1722_cov_13.235367	1372	1452	0	80	80	1.0000000
NODE_1765_length_1720_cov_27.328192	1248	1307	46	13	59	0.2203390
NODE_1765_length_1720_cov_27.328192	1248	1307	48	12	59	0.2033898
NODE_1765_length_1720_cov_27.328192	1248	1307	49	1	59	0.0169492
NODE_1765_length_1720_cov_27.328192	1248	1307	50	1	59	0.0169492
NODE_1765_length_1720_cov_27.328192	1248	1307	52	1	59	0.0169492
NODE_1765_length_1720_cov_27.328192	1248	1307	54	5	59	0.0847458
NODE_1765_length_1720_cov_27.328192	1248	1307	56	5	59	0.0847458
NODE_1765_length_1720_cov_27.328192	1248	1307	57	1	59	0.0169492
NODE_1765_length_1720_cov_27.328192	1248	1307	58	1	59	0.0169492
NODE_1765_length_1720_cov_27.328192	1248	1307	60	8	59	0.1355932
NODE_1765_length_1720_cov_27.328192	1248	1307	62	11	59	0.1864407
NODE_1765_length_1720_cov_27.328192	1280	1360	26	9	80	0.1125000
NODE_1765_length_1720_cov_27.328192	1280	1360	28	13	80	0.1625000
NODE_1765_length_1720_cov_27.328192	1280	1360	30	1	80	0.0125000
NODE_1765_length_1720_cov_27.328192	1280	1360	36	1	80	0.0125000
NODE_1765_length_1720_cov_27.328192	1280	1360	40	1	80	0.0125000
NODE_1765_length_1720_cov_27.328192	1280	1360	42	2	80	0.0250000
NODE_1765_length_1720_cov_27.328192	1280	1360	46	9	80	0.1125000
NODE_1765_length_1720_cov_27.328192	1280	1360	48	4	80	0.0500000
NODE_1765_length_1720_cov_27.328192	1280	1360	50	5	80	0.0625000
NODE_1765_length_1720_cov_27.328192	1280	1360	54	1	80	0.0125000
NODE_1765_length_1720_cov_27.328192	1280	1360	55	2	80	0.0250000
NODE_1765_length_1720_cov_27.328192	1280	1360	56	5	80	0.0625000
NODE_1765_length_1720_cov_27.328192	1280	1360	57	7	80	0.0875000
NODE_1765_length_1720_cov_27.328192	1280	1360	58	1	80	0.0125000
NODE_1765_length_1720_cov_27.328192	1280	1360	60	8	80	0.1000000
NODE_1765_length_1720_cov_27.328192	1280	1360	62	11	80	0.1375000
NODE_1766_length_1720_cov_4.129550	241	321	0	80	80	1.0000000
NODE_1766_length_1720_cov_4.129550	294	374	0	80	80	1.0000000
NODE_1768_length_1719_cov_9.878395	410	490	0	80	80	1.0000000
NODE_1768_length_1719_cov_9.878395	463	543	0	80	80	1.0000000
NODE_1768_length_1719_cov_9.878395	539	619	0	37	80	0.4625000
NODE_1768_length_1719_cov_9.878395	539	619	2	43	80	0.5375000
NODE_1768_length_1719_cov_9.878395	592	672	2	80	80	1.0000000
NODE_1772_length_1717_cov_5.159456	145	219	4	6	74	0.0810811
NODE_1772_length_1717_cov_5.159456	145	219	8	4	74	0.0540541
NODE_1772_length_1717_cov_5.159456	145	219	10	13	74	0.1756757
NODE_1772_length_1717_cov_5.159456	145	219	14	1	74	0.0135135
NODE_1772_length_1717_cov_5.159456	145	219	18	1	74	0.0135135
NODE_1772_length_1717_cov_5.159456	145	219	22	1	74	0.0135135
NODE_1772_length_1717_cov_5.159456	145	219	24	5	74	0.0675676
NODE_1772_length_1717_cov_5.159456	145	219	26	1	74	0.0135135
NODE_1772_length_1717_cov_5.159456	145	219	28	6	74	0.0810811
NODE_1772_length_1717_cov_5.159456	145	219	30	2	74	0.0270270
NODE_1772_length_1717_cov_5.159456	145	219	32	15	74	0.2027027
NODE_1772_length_1717_cov_5.159456	145	219	34	7	74	0.0945946
NODE_1772_length_1717_cov_5.159456	145	219	36	7	74	0.0945946
NODE_1772_length_1717_cov_5.159456	145	219	38	1	74	0.0135135
NODE_1772_length_1717_cov_5.159456	145	219	40	4	74	0.0540541
NODE_1772_length_1717_cov_5.159456	1450	1508	0	58	58	1.0000000
NODE_1772_length_1717_cov_5.159456	1503	1561	0	58	58	1.0000000
NODE_1778_length_1715_cov_12.607054	555	635	0	80	80	1.0000000
NODE_1778_length_1715_cov_12.607054	608	688	0	80	80	1.0000000
NODE_1778_length_1715_cov_12.607054	684	764	0	80	80	1.0000000
NODE_1778_length_1715_cov_12.607054	737	817	0	80	80	1.0000000
NODE_1788_length_1707_cov_16.909204	397	477	0	80	80	1.0000000
NODE_1788_length_1707_cov_16.909204	450	530	0	80	80	1.0000000
NODE_1788_length_1707_cov_16.909204	1151	1231	0	80	80	1.0000000
NODE_1788_length_1707_cov_16.909204	1204	1284	0	80	80	1.0000000
NODE_1792_length_1705_cov_19.645081	451	531	0	80	80	1.0000000
NODE_1792_length_1705_cov_19.645081	504	584	0	80	80	1.0000000
NODE_1792_length_1705_cov_19.645081	580	660	0	80	80	1.0000000
NODE_1792_length_1705_cov_19.645081	633	714	0	81	81	1.0000000
NODE_1792_length_1705_cov_19.645081	1315	1395	0	80	80	1.0000000
NODE_1792_length_1705_cov_19.645081	1368	1448	0	80	80	1.0000000
NODE_1796_length_1703_cov_26.016833	1201	1264	2	46	63	0.7301587
NODE_1796_length_1703_cov_26.016833	1201	1264	4	6	63	0.0952381
NODE_1796_length_1703_cov_26.016833	1201	1264	7	2	63	0.0317460
NODE_1796_length_1703_cov_26.016833	1201	1264	9	5	63	0.0793651
NODE_1796_length_1703_cov_26.016833	1201	1264	15	4	63	0.0634921
NODE_1796_length_1703_cov_26.016833	1207	1264	2	46	57	0.8070176
NODE_1796_length_1703_cov_26.016833	1207	1264	4	6	57	0.1052632
NODE_1796_length_1703_cov_26.016833	1207	1264	7	2	57	0.0350877
NODE_1796_length_1703_cov_26.016833	1207	1264	9	3	57	0.0526316
NODE_1796_length_1703_cov_26.016833	1207	1264	2	46	57	0.8070176
NODE_1796_length_1703_cov_26.016833	1207	1264	4	6	57	0.1052632
NODE_1796_length_1703_cov_26.016833	1207	1264	7	2	57	0.0350877
NODE_1796_length_1703_cov_26.016833	1207	1264	9	3	57	0.0526316
NODE_1799_length_1701_cov_15.969413	1490	1565	2	4	75	0.0533333
NODE_1799_length_1701_cov_15.969413	1490	1565	4	2	75	0.0266667
NODE_1799_length_1701_cov_15.969413	1490	1565	6	2	75	0.0266667
NODE_1799_length_1701_cov_15.969413	1490	1565	7	3	75	0.0400000
NODE_1799_length_1701_cov_15.969413	1490	1565	8	4	75	0.0533333
NODE_1799_length_1701_cov_15.969413	1490	1565	10	1	75	0.0133333
NODE_1799_length_1701_cov_15.969413	1490	1565	12	1	75	0.0133333
NODE_1799_length_1701_cov_15.969413	1490	1565	13	5	75	0.0666667
NODE_1799_length_1701_cov_15.969413	1490	1565	14	2	75	0.0266667
NODE_1799_length_1701_cov_15.969413	1490	1565	18	1	75	0.0133333
NODE_1799_length_1701_cov_15.969413	1490	1565	20	9	75	0.1200000
NODE_1799_length_1701_cov_15.969413	1490	1565	21	2	75	0.0266667
NODE_1799_length_1701_cov_15.969413	1490	1565	22	4	75	0.0533333
NODE_1799_length_1701_cov_15.969413	1490	1565	24	6	75	0.0800000
NODE_1799_length_1701_cov_15.969413	1490	1565	26	5	75	0.0666667
NODE_1799_length_1701_cov_15.969413	1490	1565	28	2	75	0.0266667
NODE_1799_length_1701_cov_15.969413	1490	1565	30	4	75	0.0533333
NODE_1799_length_1701_cov_15.969413	1490	1565	32	4	75	0.0533333
NODE_1799_length_1701_cov_15.969413	1490	1565	33	8	75	0.1066667
NODE_1799_length_1701_cov_15.969413	1490	1565	36	1	75	0.0133333
NODE_1799_length_1701_cov_15.969413	1490	1565	38	1	75	0.0133333
NODE_1799_length_1701_cov_15.969413	1490	1565	40	1	75	0.0133333
NODE_1799_length_1701_cov_15.969413	1490	1565	42	1	75	0.0133333
NODE_1799_length_1701_cov_15.969413	1490	1565	44	1	75	0.0133333
NODE_1799_length_1701_cov_15.969413	1490	1565	50	1	75	0.0133333
NODE_1799_length_1701_cov_15.969413	1538	1603	26	3	65	0.0461538
NODE_1799_length_1701_cov_15.969413	1538	1603	28	2	65	0.0307692
NODE_1799_length_1701_cov_15.969413	1538	1603	30	4	65	0.0615385
NODE_1799_length_1701_cov_15.969413	1538	1603	32	4	65	0.0615385
NODE_1799_length_1701_cov_15.969413	1538	1603	33	8	65	0.1230769
NODE_1799_length_1701_cov_15.969413	1538	1603	36	1	65	0.0153846
NODE_1799_length_1701_cov_15.969413	1538	1603	38	1	65	0.0153846
NODE_1799_length_1701_cov_15.969413	1538	1603	40	1	65	0.0153846
NODE_1799_length_1701_cov_15.969413	1538	1603	42	1	65	0.0153846
NODE_1799_length_1701_cov_15.969413	1538	1603	44	1	65	0.0153846
NODE_1799_length_1701_cov_15.969413	1538	1603	50	1	65	0.0153846
NODE_1799_length_1701_cov_15.969413	1538	1603	52	4	65	0.0615385
NODE_1799_length_1701_cov_15.969413	1538	1603	56	3	65	0.0461538
NODE_1799_length_1701_cov_15.969413	1538	1603	58	1	65	0.0153846
NODE_1799_length_1701_cov_15.969413	1538	1603	60	1	65	0.0153846
NODE_1799_length_1701_cov_15.969413	1538	1603	62	1	65	0.0153846
NODE_1799_length_1701_cov_15.969413	1538	1603	66	9	65	0.1384615
NODE_1799_length_1701_cov_15.969413	1538	1603	76	3	65	0.0461538
NODE_1799_length_1701_cov_15.969413	1538	1603	78	1	65	0.0153846
NODE_1799_length_1701_cov_15.969413	1538	1603	80	1	65	0.0153846
NODE_1799_length_1701_cov_15.969413	1538	1603	84	2	65	0.0307692
NODE_1799_length_1701_cov_15.969413	1538	1603	85	10	65	0.1538462
NODE_1799_length_1701_cov_15.969413	1538	1603	86	2	65	0.0307692
NODE_1800_length_1701_cov_13.549313	607	687	0	11	80	0.1375000
NODE_1800_length_1701_cov_13.549313	607	687	2	69	80	0.8625000
NODE_1800_length_1701_cov_13.549313	660	740	0	30	80	0.3750000
NODE_1800_length_1701_cov_13.549313	660	740	2	50	80	0.6250000
NODE_1805_length_1700_cov_20.003123	1168	1197	132	1	29	0.0344828
NODE_1805_length_1700_cov_20.003123	1168	1197	133	2	29	0.0689655
NODE_1805_length_1700_cov_20.003123	1168	1197	134	4	29	0.1379310
NODE_1805_length_1700_cov_20.003123	1168	1197	135	1	29	0.0344828
NODE_1805_length_1700_cov_20.003123	1168	1197	136	3	29	0.1034483
NODE_1805_length_1700_cov_20.003123	1168	1197	137	1	29	0.0344828
NODE_1805_length_1700_cov_20.003123	1168	1197	138	3	29	0.1034483
NODE_1805_length_1700_cov_20.003123	1168	1197	139	4	29	0.1379310
NODE_1805_length_1700_cov_20.003123	1168	1197	140	3	29	0.1034483
NODE_1805_length_1700_cov_20.003123	1168	1197	142	1	29	0.0344828
NODE_1805_length_1700_cov_20.003123	1168	1197	146	1	29	0.0344828
NODE_1805_length_1700_cov_20.003123	1168	1197	150	1	29	0.0344828
NODE_1805_length_1700_cov_20.003123	1168	1197	152	3	29	0.1034483
NODE_1805_length_1700_cov_20.003123	1168	1197	154	1	29	0.0344828
NODE_1805_length_1700_cov_20.003123	1184	1263	131	1	79	0.0126582
NODE_1805_length_1700_cov_20.003123	1184	1263	132	1	79	0.0126582
NODE_1805_length_1700_cov_20.003123	1184	1263	134	1	79	0.0126582
NODE_1805_length_1700_cov_20.003123	1184	1263	135	1	79	0.0126582
NODE_1805_length_1700_cov_20.003123	1184	1263	136	1	79	0.0126582
NODE_1805_length_1700_cov_20.003123	1184	1263	137	1	79	0.0126582
NODE_1805_length_1700_cov_20.003123	1184	1263	138	5	79	0.0632911
NODE_1805_length_1700_cov_20.003123	1184	1263	139	2	79	0.0253165
NODE_1805_length_1700_cov_20.003123	1184	1263	140	6	79	0.0759494
NODE_1805_length_1700_cov_20.003123	1184	1263	141	2	79	0.0253165
NODE_1805_length_1700_cov_20.003123	1184	1263	143	1	79	0.0126582
NODE_1805_length_1700_cov_20.003123	1184	1263	144	1	79	0.0126582
NODE_1805_length_1700_cov_20.003123	1184	1263	146	2	79	0.0253165
NODE_1805_length_1700_cov_20.003123	1184	1263	147	1	79	0.0126582
NODE_1805_length_1700_cov_20.003123	1184	1263	150	1	79	0.0126582
NODE_1805_length_1700_cov_20.003123	1184	1263	151	2	79	0.0253165
NODE_1805_length_1700_cov_20.003123	1184	1263	152	3	79	0.0379747
NODE_1805_length_1700_cov_20.003123	1184	1263	154	1	79	0.0126582
NODE_1805_length_1700_cov_20.003123	1184	1263	157	1	79	0.0126582
NODE_1805_length_1700_cov_20.003123	1184	1263	160	1	79	0.0126582
NODE_1805_length_1700_cov_20.003123	1184	1263	164	1	79	0.0126582
NODE_1805_length_1700_cov_20.003123	1184	1263	168	1	79	0.0126582
NODE_1805_length_1700_cov_20.003123	1184	1263	170	1	79	0.0126582
NODE_1805_length_1700_cov_20.003123	1184	1263	173	4	79	0.0506329
NODE_1805_length_1700_cov_20.003123	1184	1263	174	1	79	0.0126582
NODE_1805_length_1700_cov_20.003123	1184	1263	175	1	79	0.0126582
NODE_1805_length_1700_cov_20.003123	1184	1263	176	2	79	0.0253165
NODE_1805_length_1700_cov_20.003123	1184	1263	177	1	79	0.0126582
NODE_1805_length_1700_cov_20.003123	1184	1263	178	2	79	0.0253165
NODE_1805_length_1700_cov_20.003123	1184	1263	179	2	79	0.0253165
NODE_1805_length_1700_cov_20.003123	1184	1263	180	1	79	0.0126582
NODE_1805_length_1700_cov_20.003123	1184	1263	181	1	79	0.0126582
NODE_1805_length_1700_cov_20.003123	1184	1263	183	1	79	0.0126582
NODE_1805_length_1700_cov_20.003123	1184	1263	185	2	79	0.0253165
NODE_1805_length_1700_cov_20.003123	1184	1263	187	2	79	0.0253165
NODE_1805_length_1700_cov_20.003123	1184	1263	190	4	79	0.0506329
NODE_1805_length_1700_cov_20.003123	1184	1263	191	1	79	0.0126582
NODE_1805_length_1700_cov_20.003123	1184	1263	198	2	79	0.0253165
NODE_1805_length_1700_cov_20.003123	1184	1263	200	1	79	0.0126582
NODE_1805_length_1700_cov_20.003123	1184	1263	202	6	79	0.0759494
NODE_1805_length_1700_cov_20.003123	1184	1263	204	1	79	0.0126582
NODE_1805_length_1700_cov_20.003123	1184	1263	209	1	79	0.0126582
NODE_1805_length_1700_cov_20.003123	1184	1263	220	4	79	0.0506329
NODE_1805_length_1700_cov_20.003123	1184	1263	222	1	79	0.0126582
NODE_1810_length_1698_cov_19.175735	1001	1081	0	79	80	0.9875000
NODE_1810_length_1698_cov_19.175735	1001	1081	2	1	80	0.0125000
NODE_1810_length_1698_cov_19.175735	1054	1134	0	80	80	1.0000000
NODE_1814_length_1696_cov_11.494678	590	670	2	80	80	1.0000000
NODE_1814_length_1696_cov_11.494678	643	723	0	34	80	0.4250000
NODE_1814_length_1696_cov_11.494678	643	723	2	46	80	0.5750000
NODE_1815_length_1696_cov_6.620539	369	449	2	4	80	0.0500000
NODE_1815_length_1696_cov_6.620539	369	449	4	6	80	0.0750000
NODE_1815_length_1696_cov_6.620539	369	449	5	22	80	0.2750000
NODE_1815_length_1696_cov_6.620539	369	449	6	25	80	0.3125000
NODE_1815_length_1696_cov_6.620539	369	449	7	16	80	0.2000000
NODE_1815_length_1696_cov_6.620539	369	449	8	7	80	0.0875000
NODE_1815_length_1696_cov_6.620539	422	502	0	39	80	0.4875000
NODE_1815_length_1696_cov_6.620539	422	502	2	18	80	0.2250000
NODE_1815_length_1696_cov_6.620539	422	502	4	6	80	0.0750000
NODE_1815_length_1696_cov_6.620539	422	502	5	17	80	0.2125000
NODE_1816_length_1695_cov_27.783208	399	479	4	14	80	0.1750000
NODE_1816_length_1695_cov_27.783208	399	479	6	9	80	0.1125000
NODE_1816_length_1695_cov_27.783208	399	479	8	20	80	0.2500000
NODE_1816_length_1695_cov_27.783208	399	479	10	37	80	0.4625000
NODE_1816_length_1695_cov_27.783208	452	532	4	22	80	0.2750000
NODE_1816_length_1695_cov_27.783208	452	532	6	12	80	0.1500000
NODE_1816_length_1695_cov_27.783208	452	532	8	2	80	0.0250000
NODE_1816_length_1695_cov_27.783208	452	532	10	36	80	0.4500000
NODE_1816_length_1695_cov_27.783208	452	532	12	8	80	0.1000000
NODE_1817_length_1695_cov_12.084586	1047	1127	0	80	80	1.0000000
NODE_1817_length_1695_cov_12.084586	1100	1180	0	80	80	1.0000000
NODE_1825_length_1692_cov_4.557439	727	807	0	25	80	0.3125000
NODE_1825_length_1692_cov_4.557439	727	807	2	55	80	0.6875000
NODE_1825_length_1692_cov_4.557439	780	860	0	78	80	0.9750000
NODE_1825_length_1692_cov_4.557439	780	860	2	2	80	0.0250000
NODE_1830_length_1689_cov_5.844025	1210	1285	0	75	75	1.0000000
NODE_1830_length_1689_cov_5.844025	1260	1338	0	78	78	1.0000000
NODE_1837_length_1682_cov_14.416930	1183	1263	0	80	80	1.0000000
NODE_1837_length_1682_cov_14.416930	1236	1315	0	79	79	1.0000000
NODE_1843_length_1678_cov_23.965168	636	716	0	80	80	1.0000000
NODE_1843_length_1678_cov_23.965168	689	769	0	80	80	1.0000000
NODE_1843_length_1678_cov_23.965168	1145	1225	0	80	80	1.0000000
NODE_1843_length_1678_cov_23.965168	1198	1278	0	54	80	0.6750000
NODE_1843_length_1678_cov_23.965168	1198	1278	6	26	80	0.3250000
NODE_1846_length_1677_cov_3.578580	407	487	0	66	80	0.8250000
NODE_1846_length_1677_cov_3.578580	407	487	2	14	80	0.1750000
NODE_1846_length_1677_cov_3.578580	460	530	0	70	70	1.0000000
NODE_1846_length_1677_cov_3.578580	666	724	0	7	58	0.1206897
NODE_1846_length_1677_cov_3.578580	666	724	2	51	58	0.8793104
NODE_1856_length_1670_cov_29.264163	741	821	0	80	80	1.0000000
NODE_1856_length_1670_cov_29.264163	794	874	0	80	80	1.0000000
NODE_1857_length_1669_cov_5.913376	246	326	0	62	80	0.7750000
NODE_1857_length_1669_cov_5.913376	246	326	2	18	80	0.2250000
NODE_1857_length_1669_cov_5.913376	299	379	0	13	80	0.1625000
NODE_1857_length_1669_cov_5.913376	299	379	2	67	80	0.8375000
NODE_1860_length_1668_cov_18.372212	1100	1180	0	80	80	1.0000000
NODE_1860_length_1668_cov_18.372212	1153	1233	0	80	80	1.0000000
NODE_1861_length_1667_cov_15.651786	902	982	0	54	80	0.6750000
NODE_1861_length_1667_cov_15.651786	902	982	2	26	80	0.3250000
NODE_1861_length_1667_cov_15.651786	955	1035	0	1	80	0.0125000
NODE_1861_length_1667_cov_15.651786	955	1035	2	79	80	0.9875000
NODE_1862_length_1667_cov_3.661352	649	679	0	30	30	1.0000000
NODE_1865_length_1666_cov_4.601149	1541	1623	0	6	82	0.0731707
NODE_1865_length_1666_cov_4.601149	1541	1623	2	7	82	0.0853659
NODE_1865_length_1666_cov_4.601149	1541	1623	4	1	82	0.0121951
NODE_1865_length_1666_cov_4.601149	1541	1623	6	2	82	0.0243902
NODE_1865_length_1666_cov_4.601149	1541	1623	8	1	82	0.0121951
NODE_1865_length_1666_cov_4.601149	1541	1623	14	65	82	0.7926829
NODE_1865_length_1666_cov_4.601149	1553	1613	2	1	60	0.0166667
NODE_1865_length_1666_cov_4.601149	1553	1613	4	1	60	0.0166667
NODE_1865_length_1666_cov_4.601149	1553	1613	6	2	60	0.0333333
NODE_1865_length_1666_cov_4.601149	1553	1613	8	1	60	0.0166667
NODE_1865_length_1666_cov_4.601149	1553	1613	14	55	60	0.9166667
NODE_1865_length_1666_cov_4.601149	1553	1613	2	1	60	0.0166667
NODE_1865_length_1666_cov_4.601149	1553	1613	4	1	60	0.0166667
NODE_1865_length_1666_cov_4.601149	1553	1613	6	2	60	0.0333333
NODE_1865_length_1666_cov_4.601149	1553	1613	8	1	60	0.0166667
NODE_1865_length_1666_cov_4.601149	1553	1613	14	55	60	0.9166667
NODE_1865_length_1666_cov_4.601149	1557	1623	8	1	66	0.0151515
NODE_1865_length_1666_cov_4.601149	1557	1623	14	65	66	0.9848485
NODE_1865_length_1666_cov_4.601149	1596	1666	6	3	70	0.0428571
NODE_1865_length_1666_cov_4.601149	1596	1666	8	3	70	0.0428571
NODE_1865_length_1666_cov_4.601149	1596	1666	10	3	70	0.0428571
NODE_1865_length_1666_cov_4.601149	1596	1666	12	2	70	0.0285714
NODE_1865_length_1666_cov_4.601149	1596	1666	14	59	70	0.8428571
NODE_1865_length_1666_cov_4.601149	1596	1666	6	3	70	0.0428571
NODE_1865_length_1666_cov_4.601149	1596	1666	8	3	70	0.0428571
NODE_1865_length_1666_cov_4.601149	1596	1666	10	3	70	0.0428571
NODE_1865_length_1666_cov_4.601149	1596	1666	12	2	70	0.0285714
NODE_1865_length_1666_cov_4.601149	1596	1666	14	59	70	0.8428571
NODE_1865_length_1666_cov_4.601149	1596	1666	6	3	70	0.0428571
NODE_1865_length_1666_cov_4.601149	1596	1666	8	3	70	0.0428571
NODE_1865_length_1666_cov_4.601149	1596	1666	10	3	70	0.0428571
NODE_1865_length_1666_cov_4.601149	1596	1666	12	2	70	0.0285714
NODE_1865_length_1666_cov_4.601149	1596	1666	14	59	70	0.8428571
NODE_1872_length_1662_cov_16.638516	538	618	0	72	80	0.9000000
NODE_1872_length_1662_cov_16.638516	538	618	2	8	80	0.1000000
NODE_1872_length_1662_cov_16.638516	591	671	0	38	80	0.4750000
NODE_1872_length_1662_cov_16.638516	591	671	4	11	80	0.1375000
NODE_1872_length_1662_cov_16.638516	591	671	6	24	80	0.3000000
NODE_1872_length_1662_cov_16.638516	591	671	8	4	80	0.0500000
NODE_1872_length_1662_cov_16.638516	591	671	10	3	80	0.0375000
NODE_1872_length_1662_cov_16.638516	667	747	8	4	80	0.0500000
NODE_1872_length_1662_cov_16.638516	667	747	10	31	80	0.3875000
NODE_1872_length_1662_cov_16.638516	667	747	11	10	80	0.1250000
NODE_1872_length_1662_cov_16.638516	667	747	12	35	80	0.4375000
NODE_1872_length_1662_cov_16.638516	720	800	4	21	80	0.2625000
NODE_1872_length_1662_cov_16.638516	720	800	6	16	80	0.2000000
NODE_1872_length_1662_cov_16.638516	720	800	8	19	80	0.2375000
NODE_1872_length_1662_cov_16.638516	720	800	10	8	80	0.1000000
NODE_1872_length_1662_cov_16.638516	720	800	11	10	80	0.1250000
NODE_1872_length_1662_cov_16.638516	720	800	12	6	80	0.0750000
NODE_1876_length_1660_cov_28.297886	415	495	2	37	80	0.4625000
NODE_1876_length_1660_cov_28.297886	415	495	4	9	80	0.1125000
NODE_1876_length_1660_cov_28.297886	415	495	6	20	80	0.2500000
NODE_1876_length_1660_cov_28.297886	415	495	8	14	80	0.1750000
NODE_1876_length_1660_cov_28.297886	468	548	4	23	80	0.2875000
NODE_1876_length_1660_cov_28.297886	468	548	6	16	80	0.2000000
NODE_1876_length_1660_cov_28.297886	468	548	7	22	80	0.2750000
NODE_1876_length_1660_cov_28.297886	468	548	8	19	80	0.2375000
NODE_1886_length_1654_cov_17.245016	631	711	2	4	80	0.0500000
NODE_1886_length_1654_cov_17.245016	631	711	4	36	80	0.4500000
NODE_1886_length_1654_cov_17.245016	631	711	6	9	80	0.1125000
NODE_1886_length_1654_cov_17.245016	631	711	8	31	80	0.3875000
NODE_1886_length_1654_cov_17.245016	684	764	2	13	80	0.1625000
NODE_1886_length_1654_cov_17.245016	684	764	4	14	80	0.1750000
NODE_1886_length_1654_cov_17.245016	684	764	6	25	80	0.3125000
NODE_1886_length_1654_cov_17.245016	684	764	8	28	80	0.3500000
NODE_1888_length_1653_cov_34.827542	0	41	0	3	41	0.0731707
NODE_1888_length_1653_cov_34.827542	0	41	1	3	41	0.0731707
NODE_1888_length_1653_cov_34.827542	0	41	2	35	41	0.8536586
NODE_1888_length_1653_cov_34.827542	14	44	1	5	30	0.1666667
NODE_1888_length_1653_cov_34.827542	14	44	2	25	30	0.8333333
NODE_1888_length_1653_cov_34.827542	1081	1161	2	3	80	0.0375000
NODE_1888_length_1653_cov_34.827542	1081	1161	4	15	80	0.1875000
NODE_1888_length_1653_cov_34.827542	1081	1161	6	62	80	0.7750000
NODE_1888_length_1653_cov_34.827542	1134	1214	0	7	80	0.0875000
NODE_1888_length_1653_cov_34.827542	1134	1214	4	60	80	0.7500000
NODE_1888_length_1653_cov_34.827542	1134	1214	6	13	80	0.1625000
NODE_1888_length_1653_cov_34.827542	1210	1290	4	3	80	0.0375000
NODE_1888_length_1653_cov_34.827542	1210	1290	6	8	80	0.1000000
NODE_1888_length_1653_cov_34.827542	1210	1290	8	6	80	0.0750000
NODE_1888_length_1653_cov_34.827542	1210	1290	10	63	80	0.7875000
NODE_1888_length_1653_cov_34.827542	1263	1339	0	3	76	0.0394737
NODE_1888_length_1653_cov_34.827542	1263	1339	2	17	76	0.2236842
NODE_1888_length_1653_cov_34.827542	1263	1339	4	23	76	0.3026316
NODE_1888_length_1653_cov_34.827542	1263	1339	7	1	76	0.0131579
NODE_1888_length_1653_cov_34.827542	1263	1339	8	6	76	0.0789474
NODE_1888_length_1653_cov_34.827542	1263	1339	10	26	76	0.3421053
NODE_1892_length_1652_cov_23.939472	1352	1432	0	80	80	1.0000000
NODE_1892_length_1652_cov_23.939472	1405	1485	0	80	80	1.0000000
NODE_1894_length_1651_cov_3.916881	1552	1617	6	65	65	1.0000000
NODE_1899_length_1649_cov_7.480000	774	854	2	26	80	0.3250000
NODE_1899_length_1649_cov_7.480000	774	854	4	54	80	0.6750000
NODE_1899_length_1649_cov_7.480000	827	907	0	30	80	0.3750000
NODE_1899_length_1649_cov_7.480000	827	907	2	23	80	0.2875000
NODE_1899_length_1649_cov_7.480000	827	907	4	27	80	0.3375000
NODE_1903_length_1647_cov_3.534238	1012	1075	0	52	63	0.8253968
NODE_1903_length_1647_cov_3.534238	1012	1075	2	7	63	0.1111111
NODE_1903_length_1647_cov_3.534238	1012	1075	4	4	63	0.0634921
NODE_1906_length_1645_cov_16.040103	155	235	0	80	80	1.0000000
NODE_1906_length_1645_cov_16.040103	208	288	0	80	80	1.0000000
NODE_1906_length_1645_cov_16.040103	1090	1170	0	80	80	1.0000000
NODE_1906_length_1645_cov_16.040103	1143	1222	0	79	79	1.0000000
NODE_1908_length_1644_cov_2.902913	1160	1240	10	6	80	0.0750000
NODE_1908_length_1644_cov_2.902913	1160	1240	12	47	80	0.5875000
NODE_1908_length_1644_cov_2.902913	1160	1240	14	27	80	0.3375000
NODE_1917_length_1641_cov_34.032425	487	567	0	80	80	1.0000000
NODE_1917_length_1641_cov_34.032425	540	620	0	80	80	1.0000000
NODE_1917_length_1641_cov_34.032425	616	696	0	80	80	1.0000000
NODE_1917_length_1641_cov_34.032425	669	749	0	80	80	1.0000000
NODE_1917_length_1641_cov_34.032425	1168	1248	0	65	80	0.8125000
NODE_1917_length_1641_cov_34.032425	1168	1248	4	15	80	0.1875000
NODE_1917_length_1641_cov_34.032425	1219	1301	0	14	82	0.1707317
NODE_1917_length_1641_cov_34.032425	1219	1301	4	68	82	0.8292683
NODE_1918_length_1641_cov_7.042802	339	390	0	51	51	1.0000000
NODE_1922_length_1640_cov_33.097339	943	1023	0	62	80	0.7750000
NODE_1922_length_1640_cov_33.097339	943	1023	2	18	80	0.2250000
NODE_1922_length_1640_cov_33.097339	996	1076	0	9	80	0.1125000
NODE_1922_length_1640_cov_33.097339	996	1076	2	42	80	0.5250000
NODE_1922_length_1640_cov_33.097339	996	1076	4	18	80	0.2250000
NODE_1922_length_1640_cov_33.097339	996	1076	6	11	80	0.1375000
NODE_1922_length_1640_cov_33.097339	1072	1152	0	17	80	0.2125000
NODE_1922_length_1640_cov_33.097339	1072	1152	2	12	80	0.1500000
NODE_1922_length_1640_cov_33.097339	1072	1152	4	24	80	0.3000000
NODE_1922_length_1640_cov_33.097339	1072	1152	6	27	80	0.3375000
NODE_1922_length_1640_cov_33.097339	1125	1206	0	71	81	0.8765432
NODE_1922_length_1640_cov_33.097339	1125	1206	2	10	81	0.1234568
NODE_1923_length_1640_cov_18.519143	471	551	0	71	80	0.8875000
NODE_1923_length_1640_cov_18.519143	471	551	2	9	80	0.1125000
NODE_1923_length_1640_cov_18.519143	524	604	0	18	80	0.2250000
NODE_1923_length_1640_cov_18.519143	524	604	2	22	80	0.2750000
NODE_1923_length_1640_cov_18.519143	524	604	4	40	80	0.5000000
NODE_1925_length_1639_cov_6.585714	975	1056	0	81	81	1.0000000
NODE_1925_length_1639_cov_6.585714	1028	1109	0	81	81	1.0000000
NODE_1926_length_1639_cov_2.163636	1260	1334	0	74	74	1.0000000
NODE_1926_length_1639_cov_2.163636	1312	1387	0	75	75	1.0000000
NODE_1928_length_1638_cov_18.598441	443	523	0	53	80	0.6625000
NODE_1928_length_1638_cov_18.598441	443	523	2	27	80	0.3375000
NODE_1928_length_1638_cov_18.598441	496	576	0	29	80	0.3625000
NODE_1928_length_1638_cov_18.598441	496	576	2	51	80	0.6375000
NODE_1928_length_1638_cov_18.598441	1157	1237	0	80	80	1.0000000
NODE_1928_length_1638_cov_18.598441	1210	1290	0	80	80	1.0000000
NODE_1932_length_1637_cov_12.048765	410	490	2	67	80	0.8375000
NODE_1932_length_1637_cov_12.048765	410	490	4	13	80	0.1625000
NODE_1932_length_1637_cov_12.048765	463	543	0	14	80	0.1750000
NODE_1932_length_1637_cov_12.048765	463	543	2	53	80	0.6625000
NODE_1932_length_1637_cov_12.048765	463	543	4	13	80	0.1625000
NODE_1932_length_1637_cov_12.048765	1081	1161	0	80	80	1.0000000
NODE_1932_length_1637_cov_12.048765	1134	1214	0	80	80	1.0000000
NODE_1934_length_1635_cov_21.022786	958	1038	0	1	80	0.0125000
NODE_1934_length_1635_cov_21.022786	958	1038	2	31	80	0.3875000
NODE_1934_length_1635_cov_21.022786	958	1038	4	48	80	0.6000000
NODE_1934_length_1635_cov_21.022786	1011	1091	2	40	80	0.5000000
NODE_1934_length_1635_cov_21.022786	1011	1091	4	40	80	0.5000000
NODE_1934_length_1635_cov_21.022786	1087	1167	2	9	80	0.1125000
NODE_1934_length_1635_cov_21.022786	1087	1167	6	50	80	0.6250000
NODE_1934_length_1635_cov_21.022786	1087	1167	8	21	80	0.2625000
NODE_1934_length_1635_cov_21.022786	1140	1220	0	35	80	0.4375000
NODE_1934_length_1635_cov_21.022786	1140	1220	2	2	80	0.0250000
NODE_1934_length_1635_cov_21.022786	1140	1220	6	43	80	0.5375000
NODE_1936_length_1633_cov_16.743807	1067	1147	2	2	80	0.0250000
NODE_1936_length_1633_cov_16.743807	1067	1147	4	20	80	0.2500000
NODE_1936_length_1633_cov_16.743807	1067	1147	6	58	80	0.7250000
NODE_1936_length_1633_cov_16.743807	1120	1200	0	17	80	0.2125000
NODE_1936_length_1633_cov_16.743807	1120	1200	2	38	80	0.4750000
NODE_1936_length_1633_cov_16.743807	1120	1200	4	6	80	0.0750000
NODE_1936_length_1633_cov_16.743807	1120	1200	6	19	80	0.2375000
NODE_1937_length_1633_cov_14.271838	977	1057	0	68	80	0.8500000
NODE_1937_length_1633_cov_14.271838	977	1057	2	12	80	0.1500000
NODE_1937_length_1633_cov_14.271838	1030	1110	0	15	80	0.1875000
NODE_1937_length_1633_cov_14.271838	1030	1110	2	65	80	0.8125000
NODE_1937_length_1633_cov_14.271838	1106	1186	0	59	80	0.7375000
NODE_1937_length_1633_cov_14.271838	1106	1186	2	21	80	0.2625000
NODE_1937_length_1633_cov_14.271838	1159	1239	0	80	80	1.0000000
NODE_1939_length_1631_cov_25.881201	424	504	0	45	80	0.5625000
NODE_1939_length_1631_cov_25.881201	424	504	2	2	80	0.0250000
NODE_1939_length_1631_cov_25.881201	424	504	4	33	80	0.4125000
NODE_1939_length_1631_cov_25.881201	477	557	2	4	80	0.0500000
NODE_1939_length_1631_cov_25.881201	477	557	4	76	80	0.9500000
NODE_1939_length_1631_cov_25.881201	553	633	0	62	80	0.7750000
NODE_1939_length_1631_cov_25.881201	553	633	2	18	80	0.2250000
NODE_1939_length_1631_cov_25.881201	606	686	0	29	80	0.3625000
NODE_1939_length_1631_cov_25.881201	606	686	2	42	80	0.5250000
NODE_1939_length_1631_cov_25.881201	606	686	4	9	80	0.1125000
NODE_1943_length_1629_cov_32.733987	518	598	0	80	80	1.0000000
NODE_1943_length_1629_cov_32.733987	635	715	0	10	80	0.1250000
NODE_1943_length_1629_cov_32.733987	635	715	2	12	80	0.1500000
NODE_1943_length_1629_cov_32.733987	635	715	4	1	80	0.0125000
NODE_1943_length_1629_cov_32.733987	635	715	6	4	80	0.0500000
NODE_1943_length_1629_cov_32.733987	635	715	8	46	80	0.5750000
NODE_1943_length_1629_cov_32.733987	635	715	10	7	80	0.0875000
NODE_1943_length_1629_cov_32.733987	688	768	4	3	80	0.0375000
NODE_1943_length_1629_cov_32.733987	688	768	6	8	80	0.1000000
NODE_1943_length_1629_cov_32.733987	688	768	8	30	80	0.3750000
NODE_1943_length_1629_cov_32.733987	688	768	10	39	80	0.4875000
NODE_1946_length_1628_cov_15.551995	1454	1518	76	1	64	0.0156250
NODE_1946_length_1628_cov_15.551995	1454	1518	78	1	64	0.0156250
NODE_1946_length_1628_cov_15.551995	1454	1518	81	1	64	0.0156250
NODE_1946_length_1628_cov_15.551995	1454	1518	91	1	64	0.0156250
NODE_1946_length_1628_cov_15.551995	1454	1518	98	2	64	0.0312500
NODE_1946_length_1628_cov_15.551995	1454	1518	101	1	64	0.0156250
NODE_1946_length_1628_cov_15.551995	1454	1518	103	1	64	0.0156250
NODE_1946_length_1628_cov_15.551995	1454	1518	105	1	64	0.0156250
NODE_1946_length_1628_cov_15.551995	1454	1518	108	1	64	0.0156250
NODE_1946_length_1628_cov_15.551995	1454	1518	113	1	64	0.0156250
NODE_1946_length_1628_cov_15.551995	1454	1518	122	2	64	0.0312500
NODE_1946_length_1628_cov_15.551995	1454	1518	126	1	64	0.0156250
NODE_1946_length_1628_cov_15.551995	1454	1518	128	1	64	0.0156250
NODE_1946_length_1628_cov_15.551995	1454	1518	136	1	64	0.0156250
NODE_1946_length_1628_cov_15.551995	1454	1518	139	1	64	0.0156250
NODE_1946_length_1628_cov_15.551995	1454	1518	149	1	64	0.0156250
NODE_1946_length_1628_cov_15.551995	1454	1518	150	1	64	0.0156250
NODE_1946_length_1628_cov_15.551995	1454	1518	152	1	64	0.0156250
NODE_1946_length_1628_cov_15.551995	1454	1518	159	1	64	0.0156250
NODE_1946_length_1628_cov_15.551995	1454	1518	162	1	64	0.0156250
NODE_1946_length_1628_cov_15.551995	1454	1518	167	1	64	0.0156250
NODE_1946_length_1628_cov_15.551995	1454	1518	176	1	64	0.0156250
NODE_1946_length_1628_cov_15.551995	1454	1518	177	2	64	0.0312500
NODE_1946_length_1628_cov_15.551995	1454	1518	191	1	64	0.0156250
NODE_1946_length_1628_cov_15.551995	1454	1518	193	1	64	0.0156250
NODE_1946_length_1628_cov_15.551995	1454	1518	203	2	64	0.0312500
NODE_1946_length_1628_cov_15.551995	1454	1518	213	1	64	0.0156250
NODE_1946_length_1628_cov_15.551995	1454	1518	217	2	64	0.0312500
NODE_1946_length_1628_cov_15.551995	1454	1518	223	1	64	0.0156250
NODE_1946_length_1628_cov_15.551995	1454	1518	234	4	64	0.0625000
NODE_1946_length_1628_cov_15.551995	1454	1518	238	1	64	0.0156250
NODE_1946_length_1628_cov_15.551995	1454	1518	242	1	64	0.0156250
NODE_1946_length_1628_cov_15.551995	1454	1518	246	1	64	0.0156250
NODE_1946_length_1628_cov_15.551995	1454	1518	254	1	64	0.0156250
NODE_1946_length_1628_cov_15.551995	1454	1518	265	1	64	0.0156250
NODE_1946_length_1628_cov_15.551995	1454	1518	270	1	64	0.0156250
NODE_1946_length_1628_cov_15.551995	1454	1518	274	1	64	0.0156250
NODE_1946_length_1628_cov_15.551995	1454	1518	278	1	64	0.0156250
NODE_1946_length_1628_cov_15.551995	1454	1518	285	1	64	0.0156250
NODE_1946_length_1628_cov_15.551995	1454	1518	294	1	64	0.0156250
NODE_1946_length_1628_cov_15.551995	1454	1518	296	2	64	0.0312500
NODE_1946_length_1628_cov_15.551995	1454	1518	298	1	64	0.0156250
NODE_1946_length_1628_cov_15.551995	1454	1518	306	1	64	0.0156250
NODE_1946_length_1628_cov_15.551995	1454	1518	308	1	64	0.0156250
NODE_1946_length_1628_cov_15.551995	1454	1518	312	1	64	0.0156250
NODE_1946_length_1628_cov_15.551995	1454	1518	318	1	64	0.0156250
NODE_1946_length_1628_cov_15.551995	1454	1518	322	1	64	0.0156250
NODE_1946_length_1628_cov_15.551995	1454	1518	324	2	64	0.0312500
NODE_1946_length_1628_cov_15.551995	1454	1518	328	2	64	0.0312500
NODE_1946_length_1628_cov_15.551995	1454	1518	330	1	64	0.0156250
NODE_1946_length_1628_cov_15.551995	1454	1518	332	2	64	0.0312500
NODE_1946_length_1628_cov_15.551995	1454	1518	334	1	64	0.0156250
NODE_1947_length_1628_cov_4.852845	81	163	15	6	82	0.0731707
NODE_1947_length_1628_cov_4.852845	81	163	16	10	82	0.1219512
NODE_1947_length_1628_cov_4.852845	81	163	17	7	82	0.0853659
NODE_1947_length_1628_cov_4.852845	81	163	18	11	82	0.1341463
NODE_1947_length_1628_cov_4.852845	81	163	20	11	82	0.1341463
NODE_1947_length_1628_cov_4.852845	81	163	22	8	82	0.0975610
NODE_1947_length_1628_cov_4.852845	81	163	23	6	82	0.0731707
NODE_1947_length_1628_cov_4.852845	81	163	24	2	82	0.0243902
NODE_1947_length_1628_cov_4.852845	81	163	25	5	82	0.0609756
NODE_1947_length_1628_cov_4.852845	81	163	27	1	82	0.0121951
NODE_1947_length_1628_cov_4.852845	81	163	28	2	82	0.0243902
NODE_1947_length_1628_cov_4.852845	81	163	30	7	82	0.0853659
NODE_1947_length_1628_cov_4.852845	81	163	32	6	82	0.0731707
NODE_1952_length_1626_cov_20.549443	495	575	0	27	80	0.3375000
NODE_1952_length_1626_cov_20.549443	495	575	1	7	80	0.0875000
NODE_1952_length_1626_cov_20.549443	495	575	3	46	80	0.5750000
NODE_1952_length_1626_cov_20.549443	548	628	2	19	80	0.2375000
NODE_1952_length_1626_cov_20.549443	548	628	3	30	80	0.3750000
NODE_1952_length_1626_cov_20.549443	548	628	4	31	80	0.3875000
NODE_1953_length_1626_cov_6.552718	1189	1269	0	35	80	0.4375000
NODE_1953_length_1626_cov_6.552718	1189	1269	2	45	80	0.5625000
NODE_1953_length_1626_cov_6.552718	1242	1321	0	11	79	0.1392405
NODE_1953_length_1626_cov_6.552718	1242	1321	2	68	79	0.8607595
NODE_1954_length_1626_cov_4.728880	247	329	2	79	82	0.9634146
NODE_1954_length_1626_cov_4.728880	247	329	4	3	82	0.0365854
NODE_1954_length_1626_cov_4.728880	302	382	2	80	80	1.0000000
NODE_1956_length_1625_cov_20.598952	938	1018	0	8	80	0.1000000
NODE_1956_length_1625_cov_20.598952	938	1018	2	72	80	0.9000000
NODE_1956_length_1625_cov_20.598952	991	1071	0	61	80	0.7625000
NODE_1956_length_1625_cov_20.598952	991	1071	2	19	80	0.2375000
NODE_1962_length_1623_cov_28.551181	416	486	2	33	70	0.4714286
NODE_1962_length_1623_cov_28.551181	416	486	4	1	70	0.0142857
NODE_1962_length_1623_cov_28.551181	416	486	6	6	70	0.0857143
NODE_1962_length_1623_cov_28.551181	416	486	8	29	70	0.4142857
NODE_1962_length_1623_cov_28.551181	416	486	10	1	70	0.0142857
NODE_1962_length_1623_cov_28.551181	459	507	2	43	48	0.8958333
NODE_1962_length_1623_cov_28.551181	459	507	4	2	48	0.0416667
NODE_1962_length_1623_cov_28.551181	459	507	11	2	48	0.0416667
NODE_1962_length_1623_cov_28.551181	459	507	13	1	48	0.0208333
NODE_1965_length_1622_cov_7.969140	645	725	0	80	80	1.0000000
NODE_1965_length_1622_cov_7.969140	698	778	0	80	80	1.0000000
NODE_1970_length_1621_cov_2.192510	330	401	0	38	71	0.5352113
NODE_1970_length_1621_cov_2.192510	330	401	2	30	71	0.4225352
NODE_1970_length_1621_cov_2.192510	330	401	4	3	71	0.0422535
NODE_1975_length_1618_cov_44.138907	361	441	0	32	80	0.4000000
NODE_1975_length_1618_cov_44.138907	361	441	2	48	80	0.6000000
NODE_1975_length_1618_cov_44.138907	414	494	0	9	80	0.1125000
NODE_1975_length_1618_cov_44.138907	414	494	2	71	80	0.8875000
NODE_1975_length_1618_cov_44.138907	1063	1143	0	39	80	0.4875000
NODE_1975_length_1618_cov_44.138907	1063	1143	2	41	80	0.5125000
NODE_1975_length_1618_cov_44.138907	1116	1196	0	80	80	1.0000000
NODE_1976_length_1618_cov_5.779460	332	414	0	6	82	0.0731707
NODE_1976_length_1618_cov_5.779460	332	414	3	1	82	0.0121951
NODE_1976_length_1618_cov_5.779460	332	414	4	1	82	0.0121951
NODE_1976_length_1618_cov_5.779460	332	414	6	68	82	0.8292683
NODE_1976_length_1618_cov_5.779460	332	414	10	6	82	0.0731707
NODE_1976_length_1618_cov_5.779460	387	467	4	18	80	0.2250000
NODE_1976_length_1618_cov_5.779460	387	467	6	21	80	0.2625000
NODE_1976_length_1618_cov_5.779460	387	467	7	1	80	0.0125000
NODE_1976_length_1618_cov_5.779460	387	467	8	11	80	0.1375000
NODE_1976_length_1618_cov_5.779460	387	467	10	29	80	0.3625000
NODE_1976_length_1618_cov_5.779460	972	1028	2	17	56	0.3035714
NODE_1976_length_1618_cov_5.779460	972	1028	4	39	56	0.6964286
NODE_1980_length_1616_cov_5.313777	589	669	0	34	80	0.4250000
NODE_1980_length_1616_cov_5.313777	589	669	2	46	80	0.5750000
NODE_1980_length_1616_cov_5.313777	642	722	0	12	80	0.1500000
NODE_1980_length_1616_cov_5.313777	642	722	2	68	80	0.8500000
NODE_1981_length_1615_cov_12.575858	1032	1112	2	17	80	0.2125000
NODE_1981_length_1615_cov_12.575858	1032	1112	4	63	80	0.7875000
NODE_1981_length_1615_cov_12.575858	1085	1162	0	44	77	0.5714286
NODE_1981_length_1615_cov_12.575858	1085	1162	2	23	77	0.2987013
NODE_1981_length_1615_cov_12.575858	1085	1162	4	10	77	0.1298701
NODE_1981_length_1615_cov_12.575858	1158	1238	0	80	80	1.0000000
NODE_1981_length_1615_cov_12.575858	1211	1291	0	80	80	1.0000000
NODE_1983_length_1614_cov_94.900990	0	46	4	3	46	0.0652174
NODE_1983_length_1614_cov_94.900990	0	46	6	8	46	0.1739130
NODE_1983_length_1614_cov_94.900990	0	46	12	2	46	0.0434783
NODE_1983_length_1614_cov_94.900990	0	46	14	2	46	0.0434783
NODE_1983_length_1614_cov_94.900990	0	46	18	2	46	0.0434783
NODE_1983_length_1614_cov_94.900990	0	46	22	1	46	0.0217391
NODE_1983_length_1614_cov_94.900990	0	46	28	28	46	0.6086956
NODE_1983_length_1614_cov_94.900990	23	99	28	76	76	1.0000000
NODE_1984_length_1614_cov_18.799340	655	735	0	26	80	0.3250000
NODE_1984_length_1614_cov_18.799340	655	735	4	54	80	0.6750000
NODE_1984_length_1614_cov_18.799340	708	788	0	15	80	0.1875000
NODE_1984_length_1614_cov_18.799340	708	788	4	65	80	0.8125000
NODE_1986_length_1613_cov_6.865258	1128	1203	0	8	75	0.1066667
NODE_1986_length_1613_cov_6.865258	1128	1203	2	19	75	0.2533333
NODE_1986_length_1613_cov_6.865258	1128	1203	4	48	75	0.6400000
NODE_1986_length_1613_cov_6.865258	1176	1256	4	80	80	1.0000000
NODE_1993_length_1610_cov_18.014560	1035	1115	4	48	80	0.6000000
NODE_1993_length_1610_cov_18.014560	1035	1115	6	32	80	0.4000000
NODE_1993_length_1610_cov_18.014560	1088	1168	0	28	80	0.3500000
NODE_1993_length_1610_cov_18.014560	1088	1168	2	24	80	0.3000000
NODE_1993_length_1610_cov_18.014560	1088	1168	4	2	80	0.0250000
NODE_1993_length_1610_cov_18.014560	1088	1168	6	26	80	0.3250000
NODE_2001_length_1603_cov_9.128324	1109	1189	0	30	80	0.3750000
NODE_2001_length_1603_cov_9.128324	1109	1189	2	50	80	0.6250000
NODE_2001_length_1603_cov_9.128324	1162	1242	0	65	80	0.8125000
NODE_2001_length_1603_cov_9.128324	1162	1242	2	15	80	0.1875000
NODE_2003_length_1602_cov_79.840319	1378	1445	28	10	67	0.1492537
NODE_2003_length_1602_cov_79.840319	1378	1445	30	4	67	0.0597015
NODE_2003_length_1602_cov_79.840319	1378	1445	31	4	67	0.0597015
NODE_2003_length_1602_cov_79.840319	1378	1445	33	5	67	0.0746269
NODE_2003_length_1602_cov_79.840319	1378	1445	35	1	67	0.0149254
NODE_2003_length_1602_cov_79.840319	1378	1445	41	1	67	0.0149254
NODE_2003_length_1602_cov_79.840319	1378	1445	45	2	67	0.0298507
NODE_2003_length_1602_cov_79.840319	1378	1445	47	1	67	0.0149254
NODE_2003_length_1602_cov_79.840319	1378	1445	52	1	67	0.0149254
NODE_2003_length_1602_cov_79.840319	1378	1445	54	1	67	0.0149254
NODE_2003_length_1602_cov_79.840319	1378	1445	56	3	67	0.0447761
NODE_2003_length_1602_cov_79.840319	1378	1445	60	2	67	0.0298507
NODE_2003_length_1602_cov_79.840319	1378	1445	61	2	67	0.0298507
NODE_2003_length_1602_cov_79.840319	1378	1445	63	7	67	0.1044776
NODE_2003_length_1602_cov_79.840319	1378	1445	65	1	67	0.0149254
NODE_2003_length_1602_cov_79.840319	1378	1445	67	1	67	0.0149254
NODE_2003_length_1602_cov_79.840319	1378	1445	70	2	67	0.0298507
NODE_2003_length_1602_cov_79.840319	1378	1445	72	3	67	0.0447761
NODE_2003_length_1602_cov_79.840319	1378	1445	77	1	67	0.0149254
NODE_2003_length_1602_cov_79.840319	1378	1445	83	2	67	0.0298507
NODE_2003_length_1602_cov_79.840319	1378	1445	84	1	67	0.0149254
NODE_2003_length_1602_cov_79.840319	1378	1445	85	2	67	0.0298507
NODE_2003_length_1602_cov_79.840319	1378	1445	87	1	67	0.0149254
NODE_2003_length_1602_cov_79.840319	1378	1445	90	1	67	0.0149254
NODE_2003_length_1602_cov_79.840319	1378	1445	92	1	67	0.0149254
NODE_2003_length_1602_cov_79.840319	1378	1445	94	2	67	0.0298507
NODE_2003_length_1602_cov_79.840319	1378	1445	95	1	67	0.0149254
NODE_2003_length_1602_cov_79.840319	1378	1445	96	3	67	0.0447761
NODE_2003_length_1602_cov_79.840319	1378	1445	98	1	67	0.0149254
NODE_2003_length_1602_cov_79.840319	1462	1508	13	3	46	0.0652174
NODE_2003_length_1602_cov_79.840319	1462	1508	15	4	46	0.0869565
NODE_2003_length_1602_cov_79.840319	1462	1508	16	1	46	0.0217391
NODE_2003_length_1602_cov_79.840319	1462	1508	17	8	46	0.1739130
NODE_2003_length_1602_cov_79.840319	1462	1508	20	1	46	0.0217391
NODE_2003_length_1602_cov_79.840319	1462	1508	21	4	46	0.0869565
NODE_2003_length_1602_cov_79.840319	1462	1508	22	1	46	0.0217391
NODE_2003_length_1602_cov_79.840319	1462	1508	24	3	46	0.0652174
NODE_2003_length_1602_cov_79.840319	1462	1508	25	20	46	0.4347826
NODE_2003_length_1602_cov_79.840319	1462	1508	26	1	46	0.0217391
NODE_2004_length_1602_cov_2.701264	1490	1570	2	34	80	0.4250000
NODE_2004_length_1602_cov_2.701264	1490	1570	4	46	80	0.5750000
NODE_2009_length_1600_cov_34.988008	785	865	0	21	80	0.2625000
NODE_2009_length_1600_cov_34.988008	785	865	2	26	80	0.3250000
NODE_2009_length_1600_cov_34.988008	785	865	4	33	80	0.4125000
NODE_2009_length_1600_cov_34.988008	838	918	2	31	80	0.3875000
NODE_2009_length_1600_cov_34.988008	838	918	4	49	80	0.6125000
NODE_2009_length_1600_cov_34.988008	914	994	0	62	80	0.7750000
NODE_2009_length_1600_cov_34.988008	914	994	2	18	80	0.2250000
NODE_2009_length_1600_cov_34.988008	967	1047	0	31	80	0.3875000
NODE_2009_length_1600_cov_34.988008	967	1047	2	7	80	0.0875000
NODE_2009_length_1600_cov_34.988008	967	1047	4	42	80	0.5250000
NODE_2011_length_1600_cov_11.383744	0	72	0	72	72	1.0000000
NODE_2011_length_1600_cov_11.383744	45	99	0	54	54	1.0000000
NODE_2011_length_1600_cov_11.383744	891	971	4	18	80	0.2250000
NODE_2011_length_1600_cov_11.383744	891	971	6	62	80	0.7750000
NODE_2011_length_1600_cov_11.383744	944	1024	2	52	80	0.6500000
NODE_2011_length_1600_cov_11.383744	944	1024	4	2	80	0.0250000
NODE_2011_length_1600_cov_11.383744	944	1024	6	26	80	0.3250000
NODE_2013_length_1600_cov_7.236509	1037	1109	0	21	72	0.2916667
NODE_2013_length_1600_cov_7.236509	1037	1109	2	51	72	0.7083333
NODE_2013_length_1600_cov_7.236509	1090	1160	0	70	70	1.0000000
NODE_2018_length_1598_cov_29.337558	335	415	0	80	80	1.0000000
NODE_2018_length_1598_cov_29.337558	388	468	0	73	80	0.9125000
NODE_2018_length_1598_cov_29.337558	388	468	4	4	80	0.0500000
NODE_2018_length_1598_cov_29.337558	388	468	6	3	80	0.0375000
NODE_2018_length_1598_cov_29.337558	464	516	4	1	52	0.0192308
NODE_2018_length_1598_cov_29.337558	464	516	6	6	52	0.1153846
NODE_2018_length_1598_cov_29.337558	464	516	10	3	52	0.0576923
NODE_2018_length_1598_cov_29.337558	464	516	12	3	52	0.0576923
NODE_2018_length_1598_cov_29.337558	464	516	14	4	52	0.0769231
NODE_2018_length_1598_cov_29.337558	464	516	16	11	52	0.2115385
NODE_2018_length_1598_cov_29.337558	464	516	18	17	52	0.3269231
NODE_2018_length_1598_cov_29.337558	464	516	19	1	52	0.0192308
NODE_2018_length_1598_cov_29.337558	464	516	20	6	52	0.1153846
NODE_2018_length_1598_cov_29.337558	1026	1106	0	80	80	1.0000000
NODE_2018_length_1598_cov_29.337558	1079	1159	0	80	80	1.0000000
NODE_2019_length_1598_cov_3.730487	1117	1197	0	8	80	0.1000000
NODE_2019_length_1598_cov_3.730487	1117	1197	2	72	80	0.9000000
NODE_2021_length_1597_cov_7.434579	1373	1453	2	4	80	0.0500000
NODE_2021_length_1597_cov_7.434579	1373	1453	3	1	80	0.0125000
NODE_2021_length_1597_cov_7.434579	1373	1453	5	3	80	0.0375000
NODE_2021_length_1597_cov_7.434579	1373	1453	6	3	80	0.0375000
NODE_2021_length_1597_cov_7.434579	1373	1453	8	5	80	0.0625000
NODE_2021_length_1597_cov_7.434579	1373	1453	10	25	80	0.3125000
NODE_2021_length_1597_cov_7.434579	1373	1453	12	20	80	0.2500000
NODE_2021_length_1597_cov_7.434579	1373	1453	18	1	80	0.0125000
NODE_2021_length_1597_cov_7.434579	1373	1453	20	1	80	0.0125000
NODE_2021_length_1597_cov_7.434579	1373	1453	22	2	80	0.0250000
NODE_2021_length_1597_cov_7.434579	1373	1453	24	3	80	0.0375000
NODE_2021_length_1597_cov_7.434579	1373	1453	33	2	80	0.0250000
NODE_2021_length_1597_cov_7.434579	1373	1453	35	1	80	0.0125000
NODE_2021_length_1597_cov_7.434579	1373	1453	39	1	80	0.0125000
NODE_2021_length_1597_cov_7.434579	1373	1453	41	1	80	0.0125000
NODE_2021_length_1597_cov_7.434579	1373	1453	43	1	80	0.0125000
NODE_2021_length_1597_cov_7.434579	1373	1453	47	1	80	0.0125000
NODE_2021_length_1597_cov_7.434579	1373	1453	54	1	80	0.0125000
NODE_2021_length_1597_cov_7.434579	1373	1453	55	2	80	0.0250000
NODE_2021_length_1597_cov_7.434579	1373	1453	57	2	80	0.0250000
NODE_2021_length_1597_cov_7.434579	1382	1453	6	2	71	0.0281690
NODE_2021_length_1597_cov_7.434579	1382	1453	8	5	71	0.0704225
NODE_2021_length_1597_cov_7.434579	1382	1453	10	25	71	0.3521127
NODE_2021_length_1597_cov_7.434579	1382	1453	12	20	71	0.2816902
NODE_2021_length_1597_cov_7.434579	1382	1453	18	1	71	0.0140845
NODE_2021_length_1597_cov_7.434579	1382	1453	20	1	71	0.0140845
NODE_2021_length_1597_cov_7.434579	1382	1453	22	2	71	0.0281690
NODE_2021_length_1597_cov_7.434579	1382	1453	24	3	71	0.0422535
NODE_2021_length_1597_cov_7.434579	1382	1453	33	2	71	0.0281690
NODE_2021_length_1597_cov_7.434579	1382	1453	35	1	71	0.0140845
NODE_2021_length_1597_cov_7.434579	1382	1453	39	1	71	0.0140845
NODE_2021_length_1597_cov_7.434579	1382	1453	41	1	71	0.0140845
NODE_2021_length_1597_cov_7.434579	1382	1453	43	1	71	0.0140845
NODE_2021_length_1597_cov_7.434579	1382	1453	47	1	71	0.0140845
NODE_2021_length_1597_cov_7.434579	1382	1453	54	1	71	0.0140845
NODE_2021_length_1597_cov_7.434579	1382	1453	55	2	71	0.0281690
NODE_2021_length_1597_cov_7.434579	1382	1453	57	2	71	0.0281690
NODE_2022_length_1595_cov_16.788770	215	267	6	52	52	1.0000000
NODE_2022_length_1595_cov_16.788770	614	673	14	15	59	0.2542373
NODE_2022_length_1595_cov_16.788770	614	673	18	37	59	0.6271186
NODE_2022_length_1595_cov_16.788770	614	673	20	7	59	0.1186441
NODE_2025_length_1593_cov_22.412316	144	224	0	52	80	0.6500000
NODE_2025_length_1593_cov_22.412316	144	224	2	28	80	0.3500000
NODE_2025_length_1593_cov_22.412316	197	277	2	80	80	1.0000000
NODE_2025_length_1593_cov_22.412316	1192	1272	0	69	80	0.8625000
NODE_2025_length_1593_cov_22.412316	1192	1272	4	11	80	0.1375000
NODE_2025_length_1593_cov_22.412316	1245	1325	0	22	80	0.2750000
NODE_2025_length_1593_cov_22.412316	1245	1325	4	58	80	0.7250000
NODE_2026_length_1593_cov_14.092369	357	437	4	16	80	0.2000000
NODE_2026_length_1593_cov_14.092369	357	437	8	19	80	0.2375000
NODE_2026_length_1593_cov_14.092369	357	437	10	45	80	0.5625000
NODE_2026_length_1593_cov_14.092369	410	490	0	17	80	0.2125000
NODE_2026_length_1593_cov_14.092369	410	490	2	32	80	0.4000000
NODE_2026_length_1593_cov_14.092369	410	490	4	2	80	0.0250000
NODE_2026_length_1593_cov_14.092369	410	490	8	9	80	0.1125000
NODE_2026_length_1593_cov_14.092369	410	490	10	20	80	0.2500000
NODE_2026_length_1593_cov_14.092369	1061	1141	0	66	80	0.8250000
NODE_2026_length_1593_cov_14.092369	1061	1141	2	14	80	0.1750000
NODE_2026_length_1593_cov_14.092369	1114	1194	0	13	80	0.1625000
NODE_2026_length_1593_cov_14.092369	1114	1194	2	60	80	0.7500000
NODE_2026_length_1593_cov_14.092369	1114	1194	4	7	80	0.0875000
NODE_2031_length_1592_cov_4.576691	277	357	2	44	80	0.5500000
NODE_2031_length_1592_cov_4.576691	277	357	4	36	80	0.4500000
NODE_2031_length_1592_cov_4.576691	330	410	0	41	80	0.5125000
NODE_2031_length_1592_cov_4.576691	330	410	2	39	80	0.4875000
NODE_2034_length_1591_cov_15.481233	841	921	0	13	80	0.1625000
NODE_2034_length_1591_cov_15.481233	841	921	3	28	80	0.3500000
NODE_2034_length_1591_cov_15.481233	841	921	5	9	80	0.1125000
NODE_2034_length_1591_cov_15.481233	841	921	6	1	80	0.0125000
NODE_2034_length_1591_cov_15.481233	841	921	8	29	80	0.3625000
NODE_2034_length_1591_cov_15.481233	894	974	4	20	80	0.2500000
NODE_2034_length_1591_cov_15.481233	894	974	6	5	80	0.0625000
NODE_2034_length_1591_cov_15.481233	894	974	8	55	80	0.6875000
NODE_2035_length_1591_cov_4.040885	35	65	0	30	30	1.0000000
NODE_2035_length_1591_cov_4.040885	38	99	0	58	61	0.9508197
NODE_2035_length_1591_cov_4.040885	38	99	2	1	61	0.0163934
NODE_2035_length_1591_cov_4.040885	38	99	6	2	61	0.0327869
NODE_2042_length_1589_cov_10.184564	379	459	0	9	80	0.1125000
NODE_2042_length_1589_cov_10.184564	379	459	2	71	80	0.8875000
NODE_2042_length_1589_cov_10.184564	432	512	0	57	80	0.7125000
NODE_2042_length_1589_cov_10.184564	432	512	2	23	80	0.2875000
NODE_2042_length_1589_cov_10.184564	473	512	0	39	39	1.0000000
NODE_2042_length_1589_cov_10.184564	508	588	0	80	80	1.0000000
NODE_2042_length_1589_cov_10.184564	561	641	0	80	80	1.0000000
NODE_2043_length_1588_cov_9.955675	415	495	0	33	80	0.4125000
NODE_2043_length_1588_cov_9.955675	415	495	2	47	80	0.5875000
NODE_2043_length_1588_cov_9.955675	468	548	0	57	80	0.7125000
NODE_2043_length_1588_cov_9.955675	468	548	2	23	80	0.2875000
NODE_2046_length_1587_cov_7.942204	710	790	4	41	80	0.5125000
NODE_2046_length_1587_cov_7.942204	710	790	6	39	80	0.4875000
NODE_2046_length_1587_cov_7.942204	763	843	2	9	80	0.1125000
NODE_2046_length_1587_cov_7.942204	763	843	4	53	80	0.6625000
NODE_2046_length_1587_cov_7.942204	763	843	6	18	80	0.2250000
NODE_2049_length_1586_cov_6.488231	447	474	0	27	27	1.0000000
NODE_2049_length_1586_cov_6.488231	447	527	0	80	80	1.0000000
NODE_2049_length_1586_cov_6.488231	500	580	0	80	80	1.0000000
NODE_2056_length_1583_cov_27.825472	800	880	0	80	80	1.0000000
NODE_2056_length_1583_cov_27.825472	853	933	0	80	80	1.0000000
NODE_2056_length_1583_cov_27.825472	929	1009	0	80	80	1.0000000
NODE_2056_length_1583_cov_27.825472	982	1062	0	80	80	1.0000000
NODE_2060_length_1581_cov_10.610661	457	537	0	80	80	1.0000000
NODE_2060_length_1581_cov_10.610661	510	590	0	80	80	1.0000000
NODE_2065_length_1579_cov_7.395946	5	80	0	75	75	1.0000000
NODE_2065_length_1579_cov_7.395946	58	126	0	68	68	1.0000000
NODE_2066_length_1579_cov_7.152027	1331	1409	2	31	78	0.3974359
NODE_2066_length_1579_cov_7.152027	1331	1409	4	10	78	0.1282051
NODE_2066_length_1579_cov_7.152027	1331	1409	6	37	78	0.4743590
NODE_2066_length_1579_cov_7.152027	1382	1462	4	45	80	0.5625000
NODE_2066_length_1579_cov_7.152027	1382	1462	6	35	80	0.4375000
NODE_2067_length_1579_cov_6.741892	4	52	0	6	48	0.1250000
NODE_2067_length_1579_cov_6.741892	4	52	2	6	48	0.1250000
NODE_2067_length_1579_cov_6.741892	4	52	8	6	48	0.1250000
NODE_2067_length_1579_cov_6.741892	4	52	12	2	48	0.0416667
NODE_2067_length_1579_cov_6.741892	4	52	15	4	48	0.0833333
NODE_2067_length_1579_cov_6.741892	4	52	18	1	48	0.0208333
NODE_2067_length_1579_cov_6.741892	4	52	19	1	48	0.0208333
NODE_2067_length_1579_cov_6.741892	4	52	21	3	48	0.0625000
NODE_2067_length_1579_cov_6.741892	4	52	22	7	48	0.1458333
NODE_2067_length_1579_cov_6.741892	4	52	26	4	48	0.0833333
NODE_2067_length_1579_cov_6.741892	4	52	28	6	48	0.1250000
NODE_2067_length_1579_cov_6.741892	4	52	34	2	48	0.0416667
NODE_2067_length_1579_cov_6.741892	4	52	0	6	48	0.1250000
NODE_2067_length_1579_cov_6.741892	4	52	2	6	48	0.1250000
NODE_2067_length_1579_cov_6.741892	4	52	8	6	48	0.1250000
NODE_2067_length_1579_cov_6.741892	4	52	12	2	48	0.0416667
NODE_2067_length_1579_cov_6.741892	4	52	15	4	48	0.0833333
NODE_2067_length_1579_cov_6.741892	4	52	18	1	48	0.0208333
NODE_2067_length_1579_cov_6.741892	4	52	19	1	48	0.0208333
NODE_2067_length_1579_cov_6.741892	4	52	21	3	48	0.0625000
NODE_2067_length_1579_cov_6.741892	4	52	22	7	48	0.1458333
NODE_2067_length_1579_cov_6.741892	4	52	26	4	48	0.0833333
NODE_2067_length_1579_cov_6.741892	4	52	28	6	48	0.1250000
NODE_2067_length_1579_cov_6.741892	4	52	34	2	48	0.0416667
NODE_2067_length_1579_cov_6.741892	4	52	0	6	48	0.1250000
NODE_2067_length_1579_cov_6.741892	4	52	2	6	48	0.1250000
NODE_2067_length_1579_cov_6.741892	4	52	8	6	48	0.1250000
NODE_2067_length_1579_cov_6.741892	4	52	12	2	48	0.0416667
NODE_2067_length_1579_cov_6.741892	4	52	15	4	48	0.0833333
NODE_2067_length_1579_cov_6.741892	4	52	18	1	48	0.0208333
NODE_2067_length_1579_cov_6.741892	4	52	19	1	48	0.0208333
NODE_2067_length_1579_cov_6.741892	4	52	21	3	48	0.0625000
NODE_2067_length_1579_cov_6.741892	4	52	22	7	48	0.1458333
NODE_2067_length_1579_cov_6.741892	4	52	26	4	48	0.0833333
NODE_2067_length_1579_cov_6.741892	4	52	28	6	48	0.1250000
NODE_2067_length_1579_cov_6.741892	4	52	34	2	48	0.0416667
NODE_2067_length_1579_cov_6.741892	25	105	15	3	80	0.0375000
NODE_2067_length_1579_cov_6.741892	25	105	18	1	80	0.0125000
NODE_2067_length_1579_cov_6.741892	25	105	19	1	80	0.0125000
NODE_2067_length_1579_cov_6.741892	25	105	21	3	80	0.0375000
NODE_2067_length_1579_cov_6.741892	25	105	22	7	80	0.0875000
NODE_2067_length_1579_cov_6.741892	25	105	26	4	80	0.0500000
NODE_2067_length_1579_cov_6.741892	25	105	28	6	80	0.0750000
NODE_2067_length_1579_cov_6.741892	25	105	34	2	80	0.0250000
NODE_2067_length_1579_cov_6.741892	25	105	36	3	80	0.0375000
NODE_2067_length_1579_cov_6.741892	25	105	38	9	80	0.1125000
NODE_2067_length_1579_cov_6.741892	25	105	40	41	80	0.5125000
NODE_2067_length_1579_cov_6.741892	25	91	15	3	66	0.0454545
NODE_2067_length_1579_cov_6.741892	25	91	18	1	66	0.0151515
NODE_2067_length_1579_cov_6.741892	25	91	19	1	66	0.0151515
NODE_2067_length_1579_cov_6.741892	25	91	21	3	66	0.0454545
NODE_2067_length_1579_cov_6.741892	25	91	22	7	66	0.1060606
NODE_2067_length_1579_cov_6.741892	25	91	26	4	66	0.0606061
NODE_2067_length_1579_cov_6.741892	25	91	28	6	66	0.0909091
NODE_2067_length_1579_cov_6.741892	25	91	34	2	66	0.0303030
NODE_2067_length_1579_cov_6.741892	25	91	36	3	66	0.0454545
NODE_2067_length_1579_cov_6.741892	25	91	38	9	66	0.1363636
NODE_2067_length_1579_cov_6.741892	25	91	40	27	66	0.4090909
NODE_2067_length_1579_cov_6.741892	25	96	15	3	71	0.0422535
NODE_2067_length_1579_cov_6.741892	25	96	18	1	71	0.0140845
NODE_2067_length_1579_cov_6.741892	25	96	19	1	71	0.0140845
NODE_2067_length_1579_cov_6.741892	25	96	21	3	71	0.0422535
NODE_2067_length_1579_cov_6.741892	25	96	22	7	71	0.0985916
NODE_2067_length_1579_cov_6.741892	25	96	26	4	71	0.0563380
NODE_2067_length_1579_cov_6.741892	25	96	28	6	71	0.0845070
NODE_2067_length_1579_cov_6.741892	25	96	34	2	71	0.0281690
NODE_2067_length_1579_cov_6.741892	25	96	36	3	71	0.0422535
NODE_2067_length_1579_cov_6.741892	25	96	38	9	71	0.1267606
NODE_2067_length_1579_cov_6.741892	25	96	40	32	71	0.4507042
NODE_2076_length_1575_cov_4.250000	993	1073	0	80	80	1.0000000
NODE_2076_length_1575_cov_4.250000	1046	1126	0	80	80	1.0000000
NODE_2078_length_1574_cov_40.682034	551	631	8	41	80	0.5125000
NODE_2078_length_1574_cov_40.682034	551	631	10	39	80	0.4875000
NODE_2078_length_1574_cov_40.682034	604	684	0	34	80	0.4250000
NODE_2078_length_1574_cov_40.682034	604	684	2	12	80	0.1500000
NODE_2078_length_1574_cov_40.682034	604	684	6	6	80	0.0750000
NODE_2078_length_1574_cov_40.682034	604	684	8	28	80	0.3500000
NODE_2078_length_1574_cov_40.682034	680	760	0	23	80	0.2875000
NODE_2078_length_1574_cov_40.682034	680	760	2	57	80	0.7125000
NODE_2078_length_1574_cov_40.682034	733	813	2	71	80	0.8875000
NODE_2078_length_1574_cov_40.682034	733	813	4	9	80	0.1125000
NODE_2079_length_1574_cov_7.572203	1306	1386	0	38	80	0.4750000
NODE_2079_length_1574_cov_7.572203	1306	1386	2	42	80	0.5250000
NODE_2079_length_1574_cov_7.572203	1359	1439	0	80	80	1.0000000
NODE_2081_length_1573_cov_16.107191	437	512	2	75	75	1.0000000
NODE_2081_length_1573_cov_16.107191	485	565	0	50	80	0.6250000
NODE_2081_length_1573_cov_16.107191	485	565	2	30	80	0.3750000
NODE_2081_length_1573_cov_16.107191	561	639	0	78	78	1.0000000
NODE_2081_length_1573_cov_16.107191	612	692	0	80	80	1.0000000
NODE_2085_length_1572_cov_25.966735	359	404	149	1	45	0.0222222
NODE_2085_length_1572_cov_25.966735	359	404	150	1	45	0.0222222
NODE_2085_length_1572_cov_25.966735	359	404	153	5	45	0.1111111
NODE_2085_length_1572_cov_25.966735	359	404	154	2	45	0.0444444
NODE_2085_length_1572_cov_25.966735	359	404	155	4	45	0.0888889
NODE_2085_length_1572_cov_25.966735	359	404	156	2	45	0.0444444
NODE_2085_length_1572_cov_25.966735	359	404	157	2	45	0.0444444
NODE_2085_length_1572_cov_25.966735	359	404	159	2	45	0.0444444
NODE_2085_length_1572_cov_25.966735	359	404	160	1	45	0.0222222
NODE_2085_length_1572_cov_25.966735	359	404	161	1	45	0.0222222
NODE_2085_length_1572_cov_25.966735	359	404	163	1	45	0.0222222
NODE_2085_length_1572_cov_25.966735	359	404	164	1	45	0.0222222
NODE_2085_length_1572_cov_25.966735	359	404	165	1	45	0.0222222
NODE_2085_length_1572_cov_25.966735	359	404	166	2	45	0.0444444
NODE_2085_length_1572_cov_25.966735	359	404	167	1	45	0.0222222
NODE_2085_length_1572_cov_25.966735	359	404	169	3	45	0.0666667
NODE_2085_length_1572_cov_25.966735	359	404	171	1	45	0.0222222
NODE_2085_length_1572_cov_25.966735	359	404	172	1	45	0.0222222
NODE_2085_length_1572_cov_25.966735	359	404	175	1	45	0.0222222
NODE_2085_length_1572_cov_25.966735	359	404	181	1	45	0.0222222
NODE_2085_length_1572_cov_25.966735	359	404	185	2	45	0.0444444
NODE_2085_length_1572_cov_25.966735	359	404	187	3	45	0.0666667
NODE_2085_length_1572_cov_25.966735	359	404	194	1	45	0.0222222
NODE_2085_length_1572_cov_25.966735	359	404	196	1	45	0.0222222
NODE_2085_length_1572_cov_25.966735	359	404	198	1	45	0.0222222
NODE_2085_length_1572_cov_25.966735	359	404	200	3	45	0.0666667
NODE_2085_length_1572_cov_25.966735	405	477	77	4	72	0.0555556
NODE_2085_length_1572_cov_25.966735	405	477	78	1	72	0.0138889
NODE_2085_length_1572_cov_25.966735	405	477	79	5	72	0.0694444
NODE_2085_length_1572_cov_25.966735	405	477	81	4	72	0.0555556
NODE_2085_length_1572_cov_25.966735	405	477	82	7	72	0.0972222
NODE_2085_length_1572_cov_25.966735	405	477	83	2	72	0.0277778
NODE_2085_length_1572_cov_25.966735	405	477	84	1	72	0.0138889
NODE_2085_length_1572_cov_25.966735	405	477	86	2	72	0.0277778
NODE_2085_length_1572_cov_25.966735	405	477	88	4	72	0.0555556
NODE_2085_length_1572_cov_25.966735	405	477	92	1	72	0.0138889
NODE_2085_length_1572_cov_25.966735	405	477	94	1	72	0.0138889
NODE_2085_length_1572_cov_25.966735	405	477	97	1	72	0.0138889
NODE_2085_length_1572_cov_25.966735	405	477	99	2	72	0.0277778
NODE_2085_length_1572_cov_25.966735	405	477	101	1	72	0.0138889
NODE_2085_length_1572_cov_25.966735	405	477	105	4	72	0.0555556
NODE_2085_length_1572_cov_25.966735	405	477	109	1	72	0.0138889
NODE_2085_length_1572_cov_25.966735	405	477	111	2	72	0.0277778
NODE_2085_length_1572_cov_25.966735	405	477	113	1	72	0.0138889
NODE_2085_length_1572_cov_25.966735	405	477	114	2	72	0.0277778
NODE_2085_length_1572_cov_25.966735	405	477	116	2	72	0.0277778
NODE_2085_length_1572_cov_25.966735	405	477	118	3	72	0.0416667
NODE_2085_length_1572_cov_25.966735	405	477	124	1	72	0.0138889
NODE_2085_length_1572_cov_25.966735	405	477	126	1	72	0.0138889
NODE_2085_length_1572_cov_25.966735	405	477	127	1	72	0.0138889
NODE_2085_length_1572_cov_25.966735	405	477	129	2	72	0.0277778
NODE_2085_length_1572_cov_25.966735	405	477	135	1	72	0.0138889
NODE_2085_length_1572_cov_25.966735	405	477	140	2	72	0.0277778
NODE_2085_length_1572_cov_25.966735	405	477	142	4	72	0.0555556
NODE_2085_length_1572_cov_25.966735	405	477	144	4	72	0.0555556
NODE_2085_length_1572_cov_25.966735	405	477	146	1	72	0.0138889
NODE_2085_length_1572_cov_25.966735	405	477	148	2	72	0.0277778
NODE_2085_length_1572_cov_25.966735	405	477	152	2	72	0.0277778
NODE_2085_length_1572_cov_25.966735	1016	1096	2	80	80	1.0000000
NODE_2085_length_1572_cov_25.966735	1069	1149	0	3	80	0.0375000
NODE_2085_length_1572_cov_25.966735	1069	1149	2	77	80	0.9625000
NODE_2086_length_1572_cov_3.513238	1386	1462	6	46	76	0.6052632
NODE_2086_length_1572_cov_3.513238	1386	1462	8	30	76	0.3947369
NODE_2090_length_1570_cov_21.745071	700	780	0	4	80	0.0500000
NODE_2090_length_1570_cov_21.745071	700	780	2	4	80	0.0500000
NODE_2090_length_1570_cov_21.745071	700	780	7	1	80	0.0125000
NODE_2090_length_1570_cov_21.745071	700	780	8	12	80	0.1500000
NODE_2090_length_1570_cov_21.745071	700	780	10	40	80	0.5000000
NODE_2090_length_1570_cov_21.745071	700	780	12	19	80	0.2375000
NODE_2090_length_1570_cov_21.745071	753	833	2	8	80	0.1000000
NODE_2090_length_1570_cov_21.745071	753	833	4	5	80	0.0625000
NODE_2090_length_1570_cov_21.745071	753	833	10	10	80	0.1250000
NODE_2090_length_1570_cov_21.745071	753	833	12	57	80	0.7125000
NODE_2091_length_1570_cov_3.276003	387	467	0	80	80	1.0000000
NODE_2091_length_1570_cov_3.276003	440	520	0	80	80	1.0000000
NODE_2093_length_1569_cov_53.941497	741	821	2	34	80	0.4250000
NODE_2093_length_1569_cov_53.941497	741	821	4	14	80	0.1750000
NODE_2093_length_1569_cov_53.941497	741	821	6	6	80	0.0750000
NODE_2093_length_1569_cov_53.941497	741	821	10	26	80	0.3250000
NODE_2093_length_1569_cov_53.941497	794	874	6	22	80	0.2750000
NODE_2093_length_1569_cov_53.941497	794	874	8	18	80	0.2250000
NODE_2093_length_1569_cov_53.941497	794	874	10	40	80	0.5000000
NODE_2093_length_1569_cov_53.941497	870	950	0	3	80	0.0375000
NODE_2093_length_1569_cov_53.941497	870	950	2	69	80	0.8625000
NODE_2093_length_1569_cov_53.941497	870	950	6	8	80	0.1000000
NODE_2093_length_1569_cov_53.941497	923	1003	0	14	80	0.1750000
NODE_2093_length_1569_cov_53.941497	923	1003	2	66	80	0.8250000
NODE_2094_length_1569_cov_12.426531	640	720	0	80	80	1.0000000
NODE_2094_length_1569_cov_12.426531	693	773	0	80	80	1.0000000
NODE_2094_length_1569_cov_12.426531	769	849	0	46	80	0.5750000
NODE_2094_length_1569_cov_12.426531	769	849	2	34	80	0.4250000
NODE_2094_length_1569_cov_12.426531	822	902	0	6	80	0.0750000
NODE_2094_length_1569_cov_12.426531	822	902	2	74	80	0.9250000
NODE_2095_length_1569_cov_12.365986	450	530	2	35	80	0.4375000
NODE_2095_length_1569_cov_12.365986	450	530	4	5	80	0.0625000
NODE_2095_length_1569_cov_12.365986	450	530	6	5	80	0.0625000
NODE_2095_length_1569_cov_12.365986	450	530	8	10	80	0.1250000
NODE_2095_length_1569_cov_12.365986	450	530	10	25	80	0.3125000
NODE_2095_length_1569_cov_12.365986	450	530	2	35	80	0.4375000
NODE_2095_length_1569_cov_12.365986	450	530	4	5	80	0.0625000
NODE_2095_length_1569_cov_12.365986	450	530	6	5	80	0.0625000
NODE_2095_length_1569_cov_12.365986	450	530	8	10	80	0.1250000
NODE_2095_length_1569_cov_12.365986	450	530	10	25	80	0.3125000
NODE_2095_length_1569_cov_12.365986	503	564	6	4	61	0.0655738
NODE_2095_length_1569_cov_12.365986	503	564	8	12	61	0.1967213
NODE_2095_length_1569_cov_12.365986	503	564	10	45	61	0.7377049
NODE_2095_length_1569_cov_12.365986	503	556	8	8	53	0.1509434
NODE_2095_length_1569_cov_12.365986	503	556	10	45	53	0.8490566
NODE_2096_length_1569_cov_11.599320	798	878	0	2	80	0.0250000
NODE_2096_length_1569_cov_11.599320	798	878	2	9	80	0.1125000
NODE_2096_length_1569_cov_11.599320	798	878	3	21	80	0.2625000
NODE_2096_length_1569_cov_11.599320	798	878	7	35	80	0.4375000
NODE_2096_length_1569_cov_11.599320	798	878	8	13	80	0.1625000
NODE_2096_length_1569_cov_11.599320	851	931	4	26	80	0.3250000
NODE_2096_length_1569_cov_11.599320	851	931	7	15	80	0.1875000
NODE_2096_length_1569_cov_11.599320	851	931	8	39	80	0.4875000
NODE_2097_length_1569_cov_10.917687	521	601	0	80	80	1.0000000
NODE_2097_length_1569_cov_10.917687	574	654	0	80	80	1.0000000
NODE_2108_length_1563_cov_15.357240	590	670	0	80	80	1.0000000
NODE_2108_length_1563_cov_15.357240	643	723	0	80	80	1.0000000
NODE_2110_length_1561_cov_18.420657	354	434	0	80	80	1.0000000
NODE_2110_length_1561_cov_18.420657	407	487	0	80	80	1.0000000
NODE_2110_length_1561_cov_18.420657	483	563	0	80	80	1.0000000
NODE_2110_length_1561_cov_18.420657	536	616	0	80	80	1.0000000
NODE_2116_length_1559_cov_7.071233	347	427	0	63	80	0.7875000
NODE_2116_length_1559_cov_7.071233	347	427	2	17	80	0.2125000
NODE_2116_length_1559_cov_7.071233	400	478	0	10	78	0.1282051
NODE_2116_length_1559_cov_7.071233	400	478	2	44	78	0.5641026
NODE_2116_length_1559_cov_7.071233	400	478	3	1	78	0.0128205
NODE_2116_length_1559_cov_7.071233	400	478	5	1	78	0.0128205
NODE_2116_length_1559_cov_7.071233	400	478	6	22	78	0.2820513
NODE_2116_length_1559_cov_7.071233	1187	1238	0	51	51	1.0000000
NODE_2118_length_1558_cov_3.486635	338	418	0	80	80	1.0000000
NODE_2118_length_1558_cov_3.486635	391	471	0	80	80	1.0000000
NODE_2119_length_1557_cov_17.089163	542	622	0	48	80	0.6000000
NODE_2119_length_1557_cov_17.089163	542	622	2	29	80	0.3625000
NODE_2119_length_1557_cov_17.089163	542	622	4	3	80	0.0375000
NODE_2119_length_1557_cov_17.089163	595	675	0	55	80	0.6875000
NODE_2119_length_1557_cov_17.089163	595	675	2	25	80	0.3125000
NODE_2120_length_1557_cov_4.639918	0	56	0	56	56	1.0000000
NODE_2120_length_1557_cov_4.639918	49	112	0	63	63	1.0000000
NODE_2120_length_1557_cov_4.639918	85	161	0	76	76	1.0000000
NODE_2123_length_1556_cov_23.289636	456	536	2	20	80	0.2500000
NODE_2123_length_1556_cov_23.289636	456	536	4	60	80	0.7500000
NODE_2123_length_1556_cov_23.289636	509	589	0	47	80	0.5875000
NODE_2123_length_1556_cov_23.289636	509	589	2	7	80	0.0875000
NODE_2123_length_1556_cov_23.289636	509	589	4	26	80	0.3250000
NODE_2123_length_1556_cov_23.289636	681	761	0	66	80	0.8250000
NODE_2123_length_1556_cov_23.289636	681	761	2	14	80	0.1750000
NODE_2123_length_1556_cov_23.289636	734	814	0	16	80	0.2000000
NODE_2123_length_1556_cov_23.289636	734	814	2	64	80	0.8000000
NODE_2123_length_1556_cov_23.289636	1445	1525	20	2	80	0.0250000
NODE_2123_length_1556_cov_23.289636	1445	1525	22	2	80	0.0250000
NODE_2123_length_1556_cov_23.289636	1445	1525	28	76	80	0.9500000
NODE_2124_length_1556_cov_7.494166	300	380	2	27	80	0.3375000
NODE_2124_length_1556_cov_7.494166	300	380	6	26	80	0.3250000
NODE_2124_length_1556_cov_7.494166	300	380	8	2	80	0.0250000
NODE_2124_length_1556_cov_7.494166	300	380	10	25	80	0.3125000
NODE_2124_length_1556_cov_7.494166	353	433	2	2	80	0.0250000
NODE_2124_length_1556_cov_7.494166	353	433	4	36	80	0.4500000
NODE_2124_length_1556_cov_7.494166	353	433	8	17	80	0.2125000
NODE_2124_length_1556_cov_7.494166	353	433	10	25	80	0.3125000
NODE_2126_length_1555_cov_13.461538	666	746	0	20	80	0.2500000
NODE_2126_length_1555_cov_13.461538	666	746	2	60	80	0.7500000
NODE_2126_length_1555_cov_13.461538	719	799	2	65	80	0.8125000
NODE_2126_length_1555_cov_13.461538	719	799	4	15	80	0.1875000
NODE_2127_length_1554_cov_30.239175	144	226	0	29	82	0.3536585
NODE_2127_length_1554_cov_30.239175	144	226	1	8	82	0.0975610
NODE_2127_length_1554_cov_30.239175	144	226	2	3	82	0.0365854
NODE_2127_length_1554_cov_30.239175	144	226	4	42	82	0.5121951
NODE_2127_length_1554_cov_30.239175	199	279	0	29	80	0.3625000
NODE_2127_length_1554_cov_30.239175	199	279	2	1	80	0.0125000
NODE_2127_length_1554_cov_30.239175	199	279	4	3	80	0.0375000
NODE_2127_length_1554_cov_30.239175	199	279	8	1	80	0.0125000
NODE_2127_length_1554_cov_30.239175	199	279	10	1	80	0.0125000
NODE_2127_length_1554_cov_30.239175	199	279	12	1	80	0.0125000
NODE_2127_length_1554_cov_30.239175	199	279	13	5	80	0.0625000
NODE_2127_length_1554_cov_30.239175	199	279	15	1	80	0.0125000
NODE_2127_length_1554_cov_30.239175	199	279	16	8	80	0.1000000
NODE_2127_length_1554_cov_30.239175	199	279	18	4	80	0.0500000
NODE_2127_length_1554_cov_30.239175	199	279	20	2	80	0.0250000
NODE_2127_length_1554_cov_30.239175	199	279	22	8	80	0.1000000
NODE_2127_length_1554_cov_30.239175	199	279	24	4	80	0.0500000
NODE_2127_length_1554_cov_30.239175	199	279	26	3	80	0.0375000
NODE_2127_length_1554_cov_30.239175	199	279	28	4	80	0.0500000
NODE_2127_length_1554_cov_30.239175	199	279	32	5	80	0.0625000
NODE_2127_length_1554_cov_30.239175	877	903	0	13	26	0.5000000
NODE_2127_length_1554_cov_30.239175	877	903	2	13	26	0.5000000
NODE_2127_length_1554_cov_30.239175	930	1010	2	3	80	0.0375000
NODE_2127_length_1554_cov_30.239175	930	1010	4	77	80	0.9625000
NODE_2127_length_1554_cov_30.239175	983	1063	0	16	80	0.2000000
NODE_2127_length_1554_cov_30.239175	983	1063	2	38	80	0.4750000
NODE_2127_length_1554_cov_30.239175	983	1063	4	26	80	0.3250000
NODE_2128_length_1554_cov_5.381443	1494	1554	12	4	60	0.0666667
NODE_2128_length_1554_cov_5.381443	1494	1554	14	3	60	0.0500000
NODE_2128_length_1554_cov_5.381443	1494	1554	18	53	60	0.8833333
NODE_2132_length_1552_cov_11.367515	379	445	0	6	66	0.0909091
NODE_2132_length_1552_cov_11.367515	379	445	2	4	66	0.0606061
NODE_2132_length_1552_cov_11.367515	379	445	4	56	66	0.8484849
NODE_2132_length_1552_cov_11.367515	418	484	0	1	66	0.0151515
NODE_2132_length_1552_cov_11.367515	418	484	2	17	66	0.2575758
NODE_2132_length_1552_cov_11.367515	418	484	4	48	66	0.7272727
NODE_2138_length_1549_cov_15.480000	1288	1368	0	28	80	0.3500000
NODE_2138_length_1549_cov_15.480000	1288	1368	4	20	80	0.2500000
NODE_2138_length_1549_cov_15.480000	1288	1368	6	32	80	0.4000000
NODE_2138_length_1549_cov_15.480000	1341	1421	2	27	80	0.3375000
NODE_2138_length_1549_cov_15.480000	1341	1421	6	53	80	0.6625000
NODE_2142_length_1548_cov_12.789510	770	850	0	80	80	1.0000000
NODE_2142_length_1548_cov_12.789510	823	903	0	80	80	1.0000000
NODE_2149_length_1546_cov_24.069800	775	855	0	7	80	0.0875000
NODE_2149_length_1546_cov_24.069800	775	855	2	73	80	0.9125000
NODE_2149_length_1546_cov_24.069800	828	908	0	26	80	0.3250000
NODE_2149_length_1546_cov_24.069800	828	908	2	54	80	0.6750000
NODE_2150_length_1546_cov_10.911541	417	497	0	14	80	0.1750000
NODE_2150_length_1546_cov_10.911541	417	497	2	66	80	0.8250000
NODE_2150_length_1546_cov_10.911541	470	550	0	60	80	0.7500000
NODE_2150_length_1546_cov_10.911541	470	550	2	20	80	0.2500000
NODE_2150_length_1546_cov_10.911541	1065	1145	0	80	80	1.0000000
NODE_2150_length_1546_cov_10.911541	1118	1198	0	75	80	0.9375000
NODE_2150_length_1546_cov_10.911541	1118	1198	2	5	80	0.0625000
NODE_2155_length_1543_cov_10.400970	480	560	0	80	80	1.0000000
NODE_2155_length_1543_cov_10.400970	533	613	0	55	80	0.6875000
NODE_2155_length_1543_cov_10.400970	533	613	2	25	80	0.3125000
NODE_2156_length_1543_cov_4.532548	43	98	0	55	55	1.0000000
NODE_2162_length_1541_cov_7.316921	523	603	0	80	80	1.0000000
NODE_2162_length_1541_cov_7.316921	576	658	0	82	82	1.0000000
NODE_2165_length_1539_cov_19.067361	334	414	0	80	80	1.0000000
NODE_2165_length_1539_cov_19.067361	387	467	0	80	80	1.0000000
NODE_2165_length_1539_cov_19.067361	463	543	0	52	80	0.6500000
NODE_2165_length_1539_cov_19.067361	463	543	4	28	80	0.3500000
NODE_2165_length_1539_cov_19.067361	516	596	4	80	80	1.0000000
NODE_2171_length_1538_cov_68.273801	604	684	0	17	80	0.2125000
NODE_2171_length_1538_cov_68.273801	604	684	1	56	80	0.7000000
NODE_2171_length_1538_cov_68.273801	604	684	2	7	80	0.0875000
NODE_2171_length_1538_cov_68.273801	657	737	0	17	80	0.2125000
NODE_2171_length_1538_cov_68.273801	657	737	1	3	80	0.0375000
NODE_2171_length_1538_cov_68.273801	657	737	2	60	80	0.7500000
NODE_2172_length_1538_cov_2.402363	1456	1499	6	43	43	1.0000000
NODE_2173_length_1537_cov_39.413074	782	862	0	80	80	1.0000000
NODE_2173_length_1537_cov_39.413074	835	915	0	80	80	1.0000000
NODE_2173_length_1537_cov_39.413074	911	991	0	25	80	0.3125000
NODE_2173_length_1537_cov_39.413074	911	991	2	15	80	0.1875000
NODE_2173_length_1537_cov_39.413074	911	991	4	19	80	0.2375000
NODE_2173_length_1537_cov_39.413074	911	991	6	4	80	0.0500000
NODE_2173_length_1537_cov_39.413074	911	991	8	4	80	0.0500000
NODE_2173_length_1537_cov_39.413074	911	991	10	13	80	0.1625000
NODE_2173_length_1537_cov_39.413074	964	1044	4	6	80	0.0750000
NODE_2173_length_1537_cov_39.413074	964	1044	6	4	80	0.0500000
NODE_2173_length_1537_cov_39.413074	964	1044	8	7	80	0.0875000
NODE_2173_length_1537_cov_39.413074	964	1044	10	37	80	0.4625000
NODE_2173_length_1537_cov_39.413074	964	1044	12	13	80	0.1625000
NODE_2173_length_1537_cov_39.413074	964	1044	14	13	80	0.1625000
NODE_2174_length_1537_cov_30.412378	739	819	0	29	80	0.3625000
NODE_2174_length_1537_cov_30.412378	739	819	2	51	80	0.6375000
NODE_2174_length_1537_cov_30.412378	792	872	2	80	80	1.0000000
NODE_2174_length_1537_cov_30.412378	868	948	0	74	80	0.9250000
NODE_2174_length_1537_cov_30.412378	868	948	2	6	80	0.0750000
NODE_2174_length_1537_cov_30.412378	921	1001	0	30	80	0.3750000
NODE_2174_length_1537_cov_30.412378	921	1001	2	50	80	0.6250000
NODE_2175_length_1537_cov_18.707232	669	749	4	48	80	0.6000000
NODE_2175_length_1537_cov_18.707232	669	749	6	32	80	0.4000000
NODE_2175_length_1537_cov_18.707232	722	802	0	31	80	0.3875000
NODE_2175_length_1537_cov_18.707232	722	802	2	6	80	0.0750000
NODE_2175_length_1537_cov_18.707232	722	802	4	41	80	0.5125000
NODE_2175_length_1537_cov_18.707232	722	802	6	2	80	0.0250000
NODE_2176_length_1536_cov_24.991649	832	912	0	80	80	1.0000000
NODE_2176_length_1536_cov_24.991649	885	965	0	80	80	1.0000000
NODE_2176_length_1536_cov_24.991649	961	1041	0	20	80	0.2500000
NODE_2176_length_1536_cov_24.991649	961	1041	2	60	80	0.7500000
NODE_2176_length_1536_cov_24.991649	1014	1094	0	25	80	0.3125000
NODE_2176_length_1536_cov_24.991649	1014	1094	2	55	80	0.6875000
NODE_2183_length_1535_cov_46.662256	992	1072	0	80	80	1.0000000
NODE_2183_length_1535_cov_46.662256	1045	1125	0	80	80	1.0000000
NODE_2183_length_1535_cov_46.662256	1127	1203	0	71	76	0.9342105
NODE_2183_length_1535_cov_46.662256	1127	1203	2	5	76	0.0657895
NODE_2183_length_1535_cov_46.662256	1176	1256	0	22	80	0.2750000
NODE_2183_length_1535_cov_46.662256	1176	1256	2	58	80	0.7250000
NODE_2184_length_1535_cov_32.610724	992	1072	0	38	80	0.4750000
NODE_2184_length_1535_cov_32.610724	992	1072	2	42	80	0.5250000
NODE_2184_length_1535_cov_32.610724	1045	1125	0	30	80	0.3750000
NODE_2184_length_1535_cov_32.610724	1045	1125	2	50	80	0.6250000
NODE_2184_length_1535_cov_32.610724	1121	1201	0	73	80	0.9125000
NODE_2184_length_1535_cov_32.610724	1121	1201	2	7	80	0.0875000
NODE_2184_length_1535_cov_32.610724	1174	1254	0	20	80	0.2500000
NODE_2184_length_1535_cov_32.610724	1174	1254	2	60	80	0.7500000
NODE_2185_length_1535_cov_25.406685	619	699	0	68	80	0.8500000
NODE_2185_length_1535_cov_25.406685	619	699	2	12	80	0.1500000
NODE_2185_length_1535_cov_25.406685	672	752	0	15	80	0.1875000
NODE_2185_length_1535_cov_25.406685	672	752	2	65	80	0.8125000
NODE_2190_length_1534_cov_13.542857	439	519	0	80	80	1.0000000
NODE_2190_length_1534_cov_13.542857	492	567	0	75	75	1.0000000
NODE_2197_length_1531_cov_17.336592	324	404	0	53	80	0.6625000
NODE_2197_length_1531_cov_17.336592	324	404	2	27	80	0.3375000
NODE_2198_length_1531_cov_6.267458	606	686	0	80	80	1.0000000
NODE_2198_length_1531_cov_6.267458	659	739	0	80	80	1.0000000
NODE_2199_length_1530_cov_13.514326	323	403	2	15	80	0.1875000
NODE_2199_length_1530_cov_13.514326	323	403	4	4	80	0.0500000
NODE_2199_length_1530_cov_13.514326	323	403	6	61	80	0.7625000
NODE_2199_length_1530_cov_13.514326	376	456	0	12	80	0.1500000
NODE_2199_length_1530_cov_13.514326	376	456	4	26	80	0.3250000
NODE_2199_length_1530_cov_13.514326	376	456	6	42	80	0.5250000
NODE_2199_length_1530_cov_13.514326	1465	1513	0	48	48	1.0000000
NODE_2200_length_1530_cov_9.012579	637	717	0	80	80	1.0000000
NODE_2200_length_1530_cov_9.012579	690	770	0	80	80	1.0000000
NODE_2203_length_1529_cov_21.061538	983	1063	0	80	80	1.0000000
NODE_2203_length_1529_cov_21.061538	1036	1116	0	80	80	1.0000000
NODE_2205_length_1529_cov_1.380420	219	282	0	7	63	0.1111111
NODE_2205_length_1529_cov_1.380420	219	282	2	32	63	0.5079365
NODE_2205_length_1529_cov_1.380420	219	282	4	24	63	0.3809524
NODE_2205_length_1529_cov_1.380420	272	323	2	19	51	0.3725490
NODE_2205_length_1529_cov_1.380420	272	323	4	32	51	0.6274510
NODE_2206_length_1528_cov_8.578027	449	529	4	7	80	0.0875000
NODE_2206_length_1528_cov_8.578027	449	529	5	64	80	0.8000000
NODE_2206_length_1528_cov_8.578027	449	529	6	9	80	0.1125000
NODE_2206_length_1528_cov_8.578027	502	582	2	27	80	0.3375000
NODE_2206_length_1528_cov_8.578027	502	582	3	21	80	0.2625000
NODE_2206_length_1528_cov_8.578027	502	582	4	7	80	0.0875000
NODE_2206_length_1528_cov_8.578027	502	582	5	16	80	0.2000000
NODE_2206_length_1528_cov_8.578027	502	582	6	9	80	0.1125000
NODE_2210_length_1526_cov_92.265592	986	1066	2	43	80	0.5375000
NODE_2210_length_1526_cov_92.265592	986	1066	4	37	80	0.4625000
NODE_2210_length_1526_cov_92.265592	1039	1119	2	9	80	0.1125000
NODE_2210_length_1526_cov_92.265592	1039	1119	4	71	80	0.8875000
NODE_2211_length_1526_cov_4.051857	291	370	0	8	79	0.1012658
NODE_2211_length_1526_cov_4.051857	291	370	2	71	79	0.8987342
NODE_2213_length_1525_cov_20.232118	1014	1090	139	1	76	0.0131579
NODE_2213_length_1525_cov_20.232118	1014	1090	140	1	76	0.0131579
NODE_2213_length_1525_cov_20.232118	1014	1090	142	1	76	0.0131579
NODE_2213_length_1525_cov_20.232118	1014	1090	145	1	76	0.0131579
NODE_2213_length_1525_cov_20.232118	1014	1090	147	1	76	0.0131579
NODE_2213_length_1525_cov_20.232118	1014	1090	148	1	76	0.0131579
NODE_2213_length_1525_cov_20.232118	1014	1090	149	1	76	0.0131579
NODE_2213_length_1525_cov_20.232118	1014	1090	156	5	76	0.0657895
NODE_2213_length_1525_cov_20.232118	1014	1090	157	2	76	0.0263158
NODE_2213_length_1525_cov_20.232118	1014	1090	160	1	76	0.0131579
NODE_2213_length_1525_cov_20.232118	1014	1090	164	1	76	0.0131579
NODE_2213_length_1525_cov_20.232118	1014	1090	166	1	76	0.0131579
NODE_2213_length_1525_cov_20.232118	1014	1090	167	1	76	0.0131579
NODE_2213_length_1525_cov_20.232118	1014	1090	169	1	76	0.0131579
NODE_2213_length_1525_cov_20.232118	1014	1090	170	2	76	0.0263158
NODE_2213_length_1525_cov_20.232118	1014	1090	171	1	76	0.0131579
NODE_2213_length_1525_cov_20.232118	1014	1090	172	3	76	0.0394737
NODE_2213_length_1525_cov_20.232118	1014	1090	173	1	76	0.0131579
NODE_2213_length_1525_cov_20.232118	1014	1090	174	3	76	0.0394737
NODE_2213_length_1525_cov_20.232118	1014	1090	175	7	76	0.0921053
NODE_2213_length_1525_cov_20.232118	1014	1090	177	1	76	0.0131579
NODE_2213_length_1525_cov_20.232118	1014	1090	179	3	76	0.0394737
NODE_2213_length_1525_cov_20.232118	1014	1090	181	2	76	0.0263158
NODE_2213_length_1525_cov_20.232118	1014	1090	183	2	76	0.0263158
NODE_2213_length_1525_cov_20.232118	1014	1090	187	1	76	0.0131579
NODE_2213_length_1525_cov_20.232118	1014	1090	188	1	76	0.0131579
NODE_2213_length_1525_cov_20.232118	1014	1090	189	1	76	0.0131579
NODE_2213_length_1525_cov_20.232118	1014	1090	190	2	76	0.0263158
NODE_2213_length_1525_cov_20.232118	1014	1090	191	1	76	0.0131579
NODE_2213_length_1525_cov_20.232118	1014	1090	193	3	76	0.0394737
NODE_2213_length_1525_cov_20.232118	1014	1090	195	8	76	0.1052632
NODE_2213_length_1525_cov_20.232118	1014	1090	197	4	76	0.0526316
NODE_2213_length_1525_cov_20.232118	1014	1090	199	5	76	0.0657895
NODE_2213_length_1525_cov_20.232118	1014	1090	201	2	76	0.0263158
NODE_2213_length_1525_cov_20.232118	1014	1090	202	1	76	0.0131579
NODE_2213_length_1525_cov_20.232118	1014	1090	203	3	76	0.0394737
NODE_2213_length_1525_cov_20.232118	1281	1338	0	57	57	1.0000000
NODE_2214_length_1525_cov_11.421459	804	884	0	80	80	1.0000000
NODE_2214_length_1525_cov_11.421459	857	937	0	80	80	1.0000000
NODE_2217_length_1524_cov_130.874386	171	243	122	2	72	0.0277778
NODE_2217_length_1524_cov_130.874386	171	243	124	1	72	0.0138889
NODE_2217_length_1524_cov_130.874386	171	243	130	3	72	0.0416667
NODE_2217_length_1524_cov_130.874386	171	243	134	3	72	0.0416667
NODE_2217_length_1524_cov_130.874386	171	243	138	1	72	0.0138889
NODE_2217_length_1524_cov_130.874386	171	243	142	1	72	0.0138889
NODE_2217_length_1524_cov_130.874386	171	243	152	1	72	0.0138889
NODE_2217_length_1524_cov_130.874386	171	243	154	2	72	0.0277778
NODE_2217_length_1524_cov_130.874386	171	243	156	1	72	0.0138889
NODE_2217_length_1524_cov_130.874386	171	243	158	2	72	0.0277778
NODE_2217_length_1524_cov_130.874386	171	243	162	1	72	0.0138889
NODE_2217_length_1524_cov_130.874386	171	243	169	2	72	0.0277778
NODE_2217_length_1524_cov_130.874386	171	243	173	1	72	0.0138889
NODE_2217_length_1524_cov_130.874386	171	243	192	1	72	0.0138889
NODE_2217_length_1524_cov_130.874386	171	243	200	1	72	0.0138889
NODE_2217_length_1524_cov_130.874386	171	243	206	1	72	0.0138889
NODE_2217_length_1524_cov_130.874386	171	243	208	1	72	0.0138889
NODE_2217_length_1524_cov_130.874386	171	243	210	1	72	0.0138889
NODE_2217_length_1524_cov_130.874386	171	243	211	1	72	0.0138889
NODE_2217_length_1524_cov_130.874386	171	243	222	1	72	0.0138889
NODE_2217_length_1524_cov_130.874386	171	243	223	1	72	0.0138889
NODE_2217_length_1524_cov_130.874386	171	243	225	2	72	0.0277778
NODE_2217_length_1524_cov_130.874386	171	243	228	1	72	0.0138889
NODE_2217_length_1524_cov_130.874386	171	243	229	3	72	0.0416667
NODE_2217_length_1524_cov_130.874386	171	243	230	1	72	0.0138889
NODE_2217_length_1524_cov_130.874386	171	243	231	1	72	0.0138889
NODE_2217_length_1524_cov_130.874386	171	243	232	4	72	0.0555556
NODE_2217_length_1524_cov_130.874386	171	243	238	4	72	0.0555556
NODE_2217_length_1524_cov_130.874386	171	243	240	3	72	0.0416667
NODE_2217_length_1524_cov_130.874386	171	243	241	1	72	0.0138889
NODE_2217_length_1524_cov_130.874386	171	243	242	1	72	0.0138889
NODE_2217_length_1524_cov_130.874386	171	243	243	2	72	0.0277778
NODE_2217_length_1524_cov_130.874386	171	243	244	6	72	0.0833333
NODE_2217_length_1524_cov_130.874386	171	243	245	3	72	0.0416667
NODE_2217_length_1524_cov_130.874386	171	243	246	9	72	0.1250000
NODE_2217_length_1524_cov_130.874386	171	243	248	1	72	0.0138889
NODE_2217_length_1524_cov_130.874386	171	243	250	1	72	0.0138889
NODE_2217_length_1524_cov_130.874386	191	247	173	1	56	0.0178571
NODE_2217_length_1524_cov_130.874386	191	247	192	1	56	0.0178571
NODE_2217_length_1524_cov_130.874386	191	247	200	1	56	0.0178571
NODE_2217_length_1524_cov_130.874386	191	247	206	1	56	0.0178571
NODE_2217_length_1524_cov_130.874386	191	247	208	1	56	0.0178571
NODE_2217_length_1524_cov_130.874386	191	247	210	1	56	0.0178571
NODE_2217_length_1524_cov_130.874386	191	247	211	1	56	0.0178571
NODE_2217_length_1524_cov_130.874386	191	247	222	1	56	0.0178571
NODE_2217_length_1524_cov_130.874386	191	247	223	1	56	0.0178571
NODE_2217_length_1524_cov_130.874386	191	247	225	6	56	0.1071429
NODE_2217_length_1524_cov_130.874386	191	247	228	1	56	0.0178571
NODE_2217_length_1524_cov_130.874386	191	247	229	3	56	0.0535714
NODE_2217_length_1524_cov_130.874386	191	247	230	1	56	0.0178571
NODE_2217_length_1524_cov_130.874386	191	247	231	1	56	0.0178571
NODE_2217_length_1524_cov_130.874386	191	247	232	4	56	0.0714286
NODE_2217_length_1524_cov_130.874386	191	247	238	4	56	0.0714286
NODE_2217_length_1524_cov_130.874386	191	247	240	3	56	0.0535714
NODE_2217_length_1524_cov_130.874386	191	247	241	1	56	0.0178571
NODE_2217_length_1524_cov_130.874386	191	247	242	1	56	0.0178571
NODE_2217_length_1524_cov_130.874386	191	247	243	2	56	0.0357143
NODE_2217_length_1524_cov_130.874386	191	247	244	6	56	0.1071429
NODE_2217_length_1524_cov_130.874386	191	247	245	3	56	0.0535714
NODE_2217_length_1524_cov_130.874386	191	247	246	9	56	0.1607143
NODE_2217_length_1524_cov_130.874386	191	247	248	1	56	0.0178571
NODE_2217_length_1524_cov_130.874386	191	247	250	1	56	0.0178571
NODE_2217_length_1524_cov_130.874386	219	296	99	1	77	0.0129870
NODE_2217_length_1524_cov_130.874386	219	296	106	2	77	0.0259740
NODE_2217_length_1524_cov_130.874386	219	296	120	1	77	0.0129870
NODE_2217_length_1524_cov_130.874386	219	296	122	1	77	0.0129870
NODE_2217_length_1524_cov_130.874386	219	296	128	1	77	0.0129870
NODE_2217_length_1524_cov_130.874386	219	296	130	1	77	0.0129870
NODE_2217_length_1524_cov_130.874386	219	296	134	2	77	0.0259740
NODE_2217_length_1524_cov_130.874386	219	296	137	1	77	0.0129870
NODE_2217_length_1524_cov_130.874386	219	296	145	2	77	0.0259740
NODE_2217_length_1524_cov_130.874386	219	296	161	2	77	0.0259740
NODE_2217_length_1524_cov_130.874386	219	296	167	1	77	0.0129870
NODE_2217_length_1524_cov_130.874386	219	296	169	1	77	0.0129870
NODE_2217_length_1524_cov_130.874386	219	296	172	1	77	0.0129870
NODE_2217_length_1524_cov_130.874386	219	296	174	1	77	0.0129870
NODE_2217_length_1524_cov_130.874386	219	296	178	1	77	0.0129870
NODE_2217_length_1524_cov_130.874386	219	296	183	1	77	0.0129870
NODE_2217_length_1524_cov_130.874386	219	296	184	1	77	0.0129870
NODE_2217_length_1524_cov_130.874386	219	296	187	3	77	0.0389610
NODE_2217_length_1524_cov_130.874386	219	296	189	1	77	0.0129870
NODE_2217_length_1524_cov_130.874386	219	296	191	2	77	0.0259740
NODE_2217_length_1524_cov_130.874386	219	296	195	2	77	0.0259740
NODE_2217_length_1524_cov_130.874386	219	296	197	3	77	0.0389610
NODE_2217_length_1524_cov_130.874386	219	296	199	1	77	0.0129870
NODE_2217_length_1524_cov_130.874386	219	296	205	1	77	0.0129870
NODE_2217_length_1524_cov_130.874386	219	296	208	1	77	0.0129870
NODE_2217_length_1524_cov_130.874386	219	296	209	2	77	0.0259740
NODE_2217_length_1524_cov_130.874386	219	296	210	3	77	0.0389610
NODE_2217_length_1524_cov_130.874386	219	296	211	1	77	0.0129870
NODE_2217_length_1524_cov_130.874386	219	296	215	2	77	0.0259740
NODE_2217_length_1524_cov_130.874386	219	296	217	1	77	0.0129870
NODE_2217_length_1524_cov_130.874386	219	296	221	3	77	0.0389610
NODE_2217_length_1524_cov_130.874386	219	296	223	3	77	0.0389610
NODE_2217_length_1524_cov_130.874386	219	296	225	6	77	0.0779221
NODE_2217_length_1524_cov_130.874386	219	296	229	3	77	0.0389610
NODE_2217_length_1524_cov_130.874386	219	296	230	1	77	0.0129870
NODE_2217_length_1524_cov_130.874386	219	296	231	1	77	0.0129870
NODE_2217_length_1524_cov_130.874386	219	296	232	4	77	0.0519481
NODE_2217_length_1524_cov_130.874386	219	296	238	3	77	0.0389610
NODE_2217_length_1524_cov_130.874386	219	296	240	3	77	0.0389610
NODE_2217_length_1524_cov_130.874386	219	296	241	1	77	0.0129870
NODE_2217_length_1524_cov_130.874386	219	296	242	1	77	0.0129870
NODE_2217_length_1524_cov_130.874386	219	296	243	2	77	0.0259740
NODE_2217_length_1524_cov_130.874386	219	296	244	1	77	0.0129870
NODE_2217_length_1524_cov_130.874386	219	296	245	1	77	0.0129870
NODE_2217_length_1524_cov_130.874386	253	333	30	3	80	0.0375000
NODE_2217_length_1524_cov_130.874386	253	333	32	5	80	0.0625000
NODE_2217_length_1524_cov_130.874386	253	333	33	1	80	0.0125000
NODE_2217_length_1524_cov_130.874386	253	333	35	2	80	0.0250000
NODE_2217_length_1524_cov_130.874386	253	333	38	1	80	0.0125000
NODE_2217_length_1524_cov_130.874386	253	333	44	3	80	0.0375000
NODE_2217_length_1524_cov_130.874386	253	333	45	2	80	0.0250000
NODE_2217_length_1524_cov_130.874386	253	333	50	3	80	0.0375000
NODE_2217_length_1524_cov_130.874386	253	333	54	1	80	0.0125000
NODE_2217_length_1524_cov_130.874386	253	333	56	1	80	0.0125000
NODE_2217_length_1524_cov_130.874386	253	333	60	2	80	0.0250000
NODE_2217_length_1524_cov_130.874386	253	333	66	1	80	0.0125000
NODE_2217_length_1524_cov_130.874386	253	333	68	3	80	0.0375000
NODE_2217_length_1524_cov_130.874386	253	333	74	1	80	0.0125000
NODE_2217_length_1524_cov_130.874386	253	333	78	2	80	0.0250000
NODE_2217_length_1524_cov_130.874386	253	333	97	1	80	0.0125000
NODE_2217_length_1524_cov_130.874386	253	333	99	1	80	0.0125000
NODE_2217_length_1524_cov_130.874386	253	333	101	5	80	0.0625000
NODE_2217_length_1524_cov_130.874386	253	333	106	2	80	0.0250000
NODE_2217_length_1524_cov_130.874386	253	333	120	1	80	0.0125000
NODE_2217_length_1524_cov_130.874386	253	333	122	1	80	0.0125000
NODE_2217_length_1524_cov_130.874386	253	333	128	1	80	0.0125000
NODE_2217_length_1524_cov_130.874386	253	333	130	1	80	0.0125000
NODE_2217_length_1524_cov_130.874386	253	333	134	2	80	0.0250000
NODE_2217_length_1524_cov_130.874386	253	333	137	1	80	0.0125000
NODE_2217_length_1524_cov_130.874386	253	333	145	2	80	0.0250000
NODE_2217_length_1524_cov_130.874386	253	333	161	2	80	0.0250000
NODE_2217_length_1524_cov_130.874386	253	333	167	1	80	0.0125000
NODE_2217_length_1524_cov_130.874386	253	333	169	1	80	0.0125000
NODE_2217_length_1524_cov_130.874386	253	333	172	1	80	0.0125000
NODE_2217_length_1524_cov_130.874386	253	333	174	1	80	0.0125000
NODE_2217_length_1524_cov_130.874386	253	333	178	1	80	0.0125000
NODE_2217_length_1524_cov_130.874386	253	333	183	1	80	0.0125000
NODE_2217_length_1524_cov_130.874386	253	333	184	1	80	0.0125000
NODE_2217_length_1524_cov_130.874386	253	333	187	3	80	0.0375000
NODE_2217_length_1524_cov_130.874386	253	333	189	1	80	0.0125000
NODE_2217_length_1524_cov_130.874386	253	333	191	2	80	0.0250000
NODE_2217_length_1524_cov_130.874386	253	333	195	2	80	0.0250000
NODE_2217_length_1524_cov_130.874386	253	333	197	3	80	0.0375000
NODE_2217_length_1524_cov_130.874386	253	333	199	1	80	0.0125000
NODE_2217_length_1524_cov_130.874386	253	333	205	1	80	0.0125000
NODE_2217_length_1524_cov_130.874386	253	333	208	1	80	0.0125000
NODE_2217_length_1524_cov_130.874386	253	333	209	2	80	0.0250000
NODE_2217_length_1524_cov_130.874386	253	333	210	3	80	0.0375000
NODE_2217_length_1524_cov_130.874386	253	333	211	1	80	0.0125000
NODE_2217_length_1524_cov_130.874386	253	333	215	2	80	0.0250000
NODE_2217_length_1524_cov_130.874386	306	386	9	6	80	0.0750000
NODE_2217_length_1524_cov_130.874386	306	386	11	7	80	0.0875000
NODE_2217_length_1524_cov_130.874386	306	386	12	3	80	0.0375000
NODE_2217_length_1524_cov_130.874386	306	386	14	3	80	0.0375000
NODE_2217_length_1524_cov_130.874386	306	386	15	6	80	0.0750000
NODE_2217_length_1524_cov_130.874386	306	386	17	2	80	0.0250000
NODE_2217_length_1524_cov_130.874386	306	386	19	2	80	0.0250000
NODE_2217_length_1524_cov_130.874386	306	386	23	6	80	0.0750000
NODE_2217_length_1524_cov_130.874386	306	386	25	2	80	0.0250000
NODE_2217_length_1524_cov_130.874386	306	386	27	2	80	0.0250000
NODE_2217_length_1524_cov_130.874386	306	386	29	4	80	0.0500000
NODE_2217_length_1524_cov_130.874386	306	386	30	13	80	0.1625000
NODE_2217_length_1524_cov_130.874386	306	386	32	5	80	0.0625000
NODE_2217_length_1524_cov_130.874386	306	386	33	1	80	0.0125000
NODE_2217_length_1524_cov_130.874386	306	386	35	2	80	0.0250000
NODE_2217_length_1524_cov_130.874386	306	386	38	1	80	0.0125000
NODE_2217_length_1524_cov_130.874386	306	386	44	3	80	0.0375000
NODE_2217_length_1524_cov_130.874386	306	386	45	2	80	0.0250000
NODE_2217_length_1524_cov_130.874386	306	386	50	3	80	0.0375000
NODE_2217_length_1524_cov_130.874386	306	386	54	1	80	0.0125000
NODE_2217_length_1524_cov_130.874386	306	386	56	1	80	0.0125000
NODE_2217_length_1524_cov_130.874386	306	386	60	2	80	0.0250000
NODE_2217_length_1524_cov_130.874386	306	386	66	1	80	0.0125000
NODE_2217_length_1524_cov_130.874386	306	386	68	2	80	0.0250000
NODE_2219_length_1523_cov_24.115169	366	446	0	80	80	1.0000000
NODE_2219_length_1523_cov_24.115169	419	499	0	80	80	1.0000000
NODE_2219_length_1523_cov_24.115169	495	575	0	80	80	1.0000000
NODE_2219_length_1523_cov_24.115169	548	628	0	80	80	1.0000000
NODE_2223_length_1522_cov_13.278988	361	441	0	34	80	0.4250000
NODE_2223_length_1522_cov_13.278988	361	441	2	37	80	0.4625000
NODE_2223_length_1522_cov_13.278988	361	441	4	9	80	0.1125000
NODE_2223_length_1522_cov_13.278988	414	494	2	26	80	0.3250000
NODE_2223_length_1522_cov_13.278988	414	494	4	54	80	0.6750000
NODE_2225_length_1521_cov_20.965541	772	852	0	16	80	0.2000000
NODE_2225_length_1521_cov_20.965541	772	852	2	9	80	0.1125000
NODE_2225_length_1521_cov_20.965541	772	852	4	46	80	0.5750000
NODE_2225_length_1521_cov_20.965541	772	852	6	9	80	0.1125000
NODE_2225_length_1521_cov_20.965541	825	905	2	4	80	0.0500000
NODE_2225_length_1521_cov_20.965541	825	905	4	41	80	0.5125000
NODE_2225_length_1521_cov_20.965541	825	905	6	35	80	0.4375000
NODE_2226_length_1521_cov_15.381153	907	987	0	80	80	1.0000000
NODE_2226_length_1521_cov_15.381153	960	1040	0	80	80	1.0000000
NODE_2226_length_1521_cov_15.381153	988	1040	0	52	52	1.0000000
NODE_2227_length_1521_cov_7.682138	525	605	0	80	80	1.0000000
NODE_2227_length_1521_cov_7.682138	578	658	0	80	80	1.0000000
NODE_2236_length_1519_cov_20.792958	714	794	14	1	80	0.0125000
NODE_2236_length_1519_cov_20.792958	714	794	15	4	80	0.0500000
NODE_2236_length_1519_cov_20.792958	714	794	16	18	80	0.2250000
NODE_2236_length_1519_cov_20.792958	714	794	17	11	80	0.1375000
NODE_2236_length_1519_cov_20.792958	714	794	18	11	80	0.1375000
NODE_2236_length_1519_cov_20.792958	714	794	19	35	80	0.4375000
NODE_2236_length_1519_cov_20.792958	767	847	3	31	80	0.3875000
NODE_2236_length_1519_cov_20.792958	767	847	6	6	80	0.0750000
NODE_2236_length_1519_cov_20.792958	767	847	8	2	80	0.0250000
NODE_2236_length_1519_cov_20.792958	767	847	10	2	80	0.0250000
NODE_2236_length_1519_cov_20.792958	767	847	11	8	80	0.1000000
NODE_2236_length_1519_cov_20.792958	767	847	14	5	80	0.0625000
NODE_2236_length_1519_cov_20.792958	767	847	16	18	80	0.2250000
NODE_2236_length_1519_cov_20.792958	767	847	18	8	80	0.1000000
NODE_2239_length_1517_cov_24.074048	413	450	2	36	37	0.9729730
NODE_2239_length_1517_cov_24.074048	413	450	3	1	37	0.0270270
NODE_2239_length_1517_cov_24.074048	842	922	0	6	80	0.0750000
NODE_2239_length_1517_cov_24.074048	842	922	2	50	80	0.6250000
NODE_2239_length_1517_cov_24.074048	842	922	4	24	80	0.3000000
NODE_2239_length_1517_cov_24.074048	895	975	2	43	80	0.5375000
NODE_2239_length_1517_cov_24.074048	895	975	4	37	80	0.4625000
NODE_2240_length_1517_cov_22.897743	383	463	0	8	80	0.1000000
NODE_2240_length_1517_cov_22.897743	383	463	2	19	80	0.2375000
NODE_2240_length_1517_cov_22.897743	383	463	5	2	80	0.0250000
NODE_2240_length_1517_cov_22.897743	383	463	6	4	80	0.0500000
NODE_2240_length_1517_cov_22.897743	383	463	8	23	80	0.2875000
NODE_2240_length_1517_cov_22.897743	383	463	10	24	80	0.3000000
NODE_2240_length_1517_cov_22.897743	436	516	6	4	80	0.0500000
NODE_2240_length_1517_cov_22.897743	436	516	8	28	80	0.3500000
NODE_2240_length_1517_cov_22.897743	436	516	10	28	80	0.3500000
NODE_2240_length_1517_cov_22.897743	436	516	12	20	80	0.2500000
NODE_2241_length_1517_cov_11.781382	381	461	0	16	80	0.2000000
NODE_2241_length_1517_cov_11.781382	381	461	2	64	80	0.8000000
NODE_2241_length_1517_cov_11.781382	434	514	0	69	80	0.8625000
NODE_2241_length_1517_cov_11.781382	434	514	2	11	80	0.1375000
NODE_2243_length_1517_cov_4.944993	393	473	8	46	80	0.5750000
NODE_2243_length_1517_cov_4.944993	393	473	10	34	80	0.4250000
NODE_2243_length_1517_cov_4.944993	446	526	0	7	80	0.0875000
NODE_2243_length_1517_cov_4.944993	446	526	2	7	80	0.0875000
NODE_2243_length_1517_cov_4.944993	446	526	4	37	80	0.4625000
NODE_2243_length_1517_cov_4.944993	446	526	8	20	80	0.2500000
NODE_2243_length_1517_cov_4.944993	446	526	10	9	80	0.1125000
NODE_2247_length_1516_cov_11.177135	230	310	0	80	80	1.0000000
NODE_2247_length_1516_cov_11.177135	283	363	0	80	80	1.0000000
NODE_2248_length_1516_cov_8.608327	580	660	0	31	80	0.3875000
NODE_2248_length_1516_cov_8.608327	580	660	2	49	80	0.6125000
NODE_2248_length_1516_cov_8.608327	633	713	0	80	80	1.0000000
NODE_2250_length_1515_cov_16.990819	333	413	4	33	80	0.4125000
NODE_2250_length_1515_cov_16.990819	333	413	6	2	80	0.0250000
NODE_2250_length_1515_cov_16.990819	333	413	8	3	80	0.0375000
NODE_2250_length_1515_cov_16.990819	333	413	10	6	80	0.0750000
NODE_2250_length_1515_cov_16.990819	333	413	12	6	80	0.0750000
NODE_2250_length_1515_cov_16.990819	333	413	18	1	80	0.0125000
NODE_2250_length_1515_cov_16.990819	333	413	20	3	80	0.0375000
NODE_2250_length_1515_cov_16.990819	333	413	22	8	80	0.1000000
NODE_2250_length_1515_cov_16.990819	333	413	24	11	80	0.1375000
NODE_2250_length_1515_cov_16.990819	333	413	26	1	80	0.0125000
NODE_2250_length_1515_cov_16.990819	333	413	30	3	80	0.0375000
NODE_2250_length_1515_cov_16.990819	333	413	32	3	80	0.0375000
NODE_2250_length_1515_cov_16.990819	386	448	4	48	62	0.7741935
NODE_2250_length_1515_cov_16.990819	386	448	6	14	62	0.2258064
NODE_2258_length_1512_cov_5.111819	506	560	1	54	54	1.0000000
NODE_2258_length_1512_cov_5.111819	677	698	0	21	21	1.0000000
NODE_2258_length_1512_cov_5.111819	677	698	0	21	21	1.0000000
NODE_2258_length_1512_cov_5.111819	1057	1137	0	50	80	0.6250000
NODE_2258_length_1512_cov_5.111819	1057	1137	2	30	80	0.3750000
NODE_2258_length_1512_cov_5.111819	1110	1190	0	36	80	0.4500000
NODE_2258_length_1512_cov_5.111819	1110	1190	2	44	80	0.5500000
NODE_2258_length_1512_cov_5.111819	1144	1190	0	36	46	0.7826087
NODE_2258_length_1512_cov_5.111819	1144	1190	2	10	46	0.2173913
NODE_2259_length_1512_cov_4.251946	132	204	0	72	72	1.0000000
NODE_2262_length_1511_cov_30.963173	787	867	0	80	80	1.0000000
NODE_2262_length_1511_cov_30.963173	840	920	0	80	80	1.0000000
NODE_2262_length_1511_cov_30.963173	916	996	0	80	80	1.0000000
NODE_2262_length_1511_cov_30.963173	969	1059	0	73	90	0.8111111
NODE_2262_length_1511_cov_30.963173	969	1059	2	17	90	0.1888889
NODE_2265_length_1510_cov_24.184975	434	514	2	20	80	0.2500000
NODE_2265_length_1510_cov_24.184975	434	514	4	60	80	0.7500000
NODE_2265_length_1510_cov_24.184975	487	567	0	20	80	0.2500000
NODE_2265_length_1510_cov_24.184975	487	567	2	31	80	0.3875000
NODE_2265_length_1510_cov_24.184975	487	567	4	29	80	0.3625000
NODE_2265_length_1510_cov_24.184975	563	643	0	80	80	1.0000000
NODE_2265_length_1510_cov_24.184975	616	696	0	80	80	1.0000000
NODE_2269_length_1509_cov_51.836170	655	735	0	80	80	1.0000000
NODE_2269_length_1509_cov_51.836170	708	788	0	59	80	0.7375000
NODE_2269_length_1509_cov_51.836170	708	788	2	21	80	0.2625000
NODE_2269_length_1509_cov_51.836170	784	864	2	17	80	0.2125000
NODE_2269_length_1509_cov_51.836170	784	864	4	15	80	0.1875000
NODE_2269_length_1509_cov_51.836170	784	864	6	36	80	0.4500000
NODE_2269_length_1509_cov_51.836170	784	864	8	12	80	0.1500000
NODE_2269_length_1509_cov_51.836170	837	917	4	48	80	0.6000000
NODE_2269_length_1509_cov_51.836170	837	917	6	28	80	0.3500000
NODE_2269_length_1509_cov_51.836170	837	917	8	4	80	0.0500000
NODE_2270_length_1509_cov_16.010638	497	577	0	80	80	1.0000000
NODE_2270_length_1509_cov_16.010638	550	630	0	80	80	1.0000000
NODE_2270_length_1509_cov_16.010638	626	706	0	80	80	1.0000000
NODE_2270_length_1509_cov_16.010638	679	759	0	80	80	1.0000000
NODE_2271_length_1509_cov_8.883688	252	332	0	28	80	0.3500000
NODE_2271_length_1509_cov_8.883688	252	332	2	52	80	0.6500000
NODE_2271_length_1509_cov_8.883688	305	385	0	80	80	1.0000000
NODE_2271_length_1509_cov_8.883688	327	385	0	58	58	1.0000000
NODE_2271_length_1509_cov_8.883688	381	461	0	80	80	1.0000000
NODE_2271_length_1509_cov_8.883688	434	514	0	80	80	1.0000000
NODE_2272_length_1509_cov_5.826950	1029	1109	0	80	80	1.0000000
NODE_2272_length_1509_cov_5.826950	1082	1162	0	80	80	1.0000000
NODE_2277_length_1508_cov_24.176011	765	845	0	31	80	0.3875000
NODE_2277_length_1508_cov_24.176011	765	845	1	49	80	0.6125000
NODE_2277_length_1508_cov_24.176011	818	898	1	80	80	1.0000000
NODE_2290_length_1504_cov_17.449822	596	676	0	80	80	1.0000000
NODE_2290_length_1504_cov_17.449822	649	729	0	80	80	1.0000000
NODE_2293_length_1502_cov_42.989309	559	639	0	80	80	1.0000000
NODE_2293_length_1502_cov_42.989309	612	692	0	80	80	1.0000000
NODE_2294_length_1501_cov_22.828816	421	500	0	31	79	0.3924051
NODE_2294_length_1501_cov_22.828816	421	500	2	48	79	0.6075949
NODE_2294_length_1501_cov_22.828816	473	553	2	80	80	1.0000000
NODE_2294_length_1501_cov_22.828816	549	629	0	70	80	0.8750000
NODE_2294_length_1501_cov_22.828816	549	629	2	10	80	0.1250000
NODE_2294_length_1501_cov_22.828816	602	682	0	80	80	1.0000000
NODE_2295_length_1501_cov_14.422254	973	1053	2	80	80	1.0000000
NODE_2295_length_1501_cov_14.422254	1026	1106	0	4	80	0.0500000
NODE_2295_length_1501_cov_14.422254	1026	1106	2	76	80	0.9500000
NODE_2296_length_1501_cov_14.060628	225	305	0	41	80	0.5125000
NODE_2296_length_1501_cov_14.060628	225	305	2	39	80	0.4875000
NODE_2296_length_1501_cov_14.060628	278	358	0	24	80	0.3000000
NODE_2296_length_1501_cov_14.060628	278	358	2	56	80	0.7000000
NODE_2296_length_1501_cov_14.060628	986	1066	0	46	80	0.5750000
NODE_2296_length_1501_cov_14.060628	986	1066	2	34	80	0.4250000
NODE_2296_length_1501_cov_14.060628	1039	1119	0	36	80	0.4500000
NODE_2296_length_1501_cov_14.060628	1039	1119	2	44	80	0.5500000
NODE_2300_length_1500_cov_40.056388	619	699	0	80	80	1.0000000
NODE_2300_length_1500_cov_40.056388	672	752	0	80	80	1.0000000
NODE_2305_length_1497_cov_38.344063	1401	1481	14	2	80	0.0250000
NODE_2305_length_1497_cov_38.344063	1401	1481	16	4	80	0.0500000
NODE_2305_length_1497_cov_38.344063	1401	1481	20	1	80	0.0125000
NODE_2305_length_1497_cov_38.344063	1401	1481	23	1	80	0.0125000
NODE_2305_length_1497_cov_38.344063	1401	1481	24	1	80	0.0125000
NODE_2305_length_1497_cov_38.344063	1401	1481	26	9	80	0.1125000
NODE_2305_length_1497_cov_38.344063	1401	1481	28	32	80	0.4000000
NODE_2305_length_1497_cov_38.344063	1401	1481	30	2	80	0.0250000
NODE_2305_length_1497_cov_38.344063	1401	1481	32	6	80	0.0750000
NODE_2305_length_1497_cov_38.344063	1401	1481	33	1	80	0.0125000
NODE_2305_length_1497_cov_38.344063	1401	1481	34	1	80	0.0125000
NODE_2305_length_1497_cov_38.344063	1401	1481	36	2	80	0.0250000
NODE_2305_length_1497_cov_38.344063	1401	1481	42	5	80	0.0625000
NODE_2305_length_1497_cov_38.344063	1401	1481	43	10	80	0.1250000
NODE_2305_length_1497_cov_38.344063	1401	1481	45	1	80	0.0125000
NODE_2305_length_1497_cov_38.344063	1401	1481	47	2	80	0.0250000
NODE_2308_length_1496_cov_3.936292	0	44	0	44	44	1.0000000
NODE_2308_length_1496_cov_3.936292	17	97	0	80	80	1.0000000
NODE_2311_length_1496_cov_1.103794	405	428	0	23	23	1.0000000
NODE_2313_length_1494_cov_65.437276	460	540	2	17	80	0.2125000
NODE_2313_length_1494_cov_65.437276	460	540	6	13	80	0.1625000
NODE_2313_length_1494_cov_65.437276	460	540	7	10	80	0.1250000
NODE_2313_length_1494_cov_65.437276	460	540	8	40	80	0.5000000
NODE_2313_length_1494_cov_65.437276	513	594	0	32	81	0.3950617
NODE_2313_length_1494_cov_65.437276	513	594	2	7	81	0.0864198
NODE_2313_length_1494_cov_65.437276	513	594	6	13	81	0.1604938
NODE_2313_length_1494_cov_65.437276	513	594	8	29	81	0.3580247
NODE_2313_length_1494_cov_65.437276	787	854	4	18	67	0.2686567
NODE_2313_length_1494_cov_65.437276	787	854	6	13	67	0.1940299
NODE_2313_length_1494_cov_65.437276	787	854	10	36	67	0.5373135
NODE_2313_length_1494_cov_65.437276	827	907	4	20	80	0.2500000
NODE_2313_length_1494_cov_65.437276	827	907	6	2	80	0.0250000
NODE_2313_length_1494_cov_65.437276	827	907	10	58	80	0.7250000
NODE_2316_length_1493_cov_100.467719	947	1028	33	7	81	0.0864198
NODE_2316_length_1493_cov_100.467719	947	1028	35	1	81	0.0123457
NODE_2316_length_1493_cov_100.467719	947	1028	37	1	81	0.0123457
NODE_2316_length_1493_cov_100.467719	947	1028	39	1	81	0.0123457
NODE_2316_length_1493_cov_100.467719	947	1028	43	1	81	0.0123457
NODE_2316_length_1493_cov_100.467719	947	1028	45	1	81	0.0123457
NODE_2316_length_1493_cov_100.467719	947	1028	47	2	81	0.0246914
NODE_2316_length_1493_cov_100.467719	947	1028	51	3	81	0.0370370
NODE_2316_length_1493_cov_100.467719	947	1028	53	3	81	0.0370370
NODE_2316_length_1493_cov_100.467719	947	1028	55	1	81	0.0123457
NODE_2316_length_1493_cov_100.467719	947	1028	59	1	81	0.0123457
NODE_2316_length_1493_cov_100.467719	947	1028	60	3	81	0.0370370
NODE_2316_length_1493_cov_100.467719	947	1028	66	3	81	0.0370370
NODE_2316_length_1493_cov_100.467719	947	1028	68	3	81	0.0370370
NODE_2316_length_1493_cov_100.467719	947	1028	76	1	81	0.0123457
NODE_2316_length_1493_cov_100.467719	947	1028	78	1	81	0.0123457
NODE_2316_length_1493_cov_100.467719	947	1028	83	1	81	0.0123457
NODE_2316_length_1493_cov_100.467719	947	1028	90	1	81	0.0123457
NODE_2316_length_1493_cov_100.467719	947	1028	93	1	81	0.0123457
NODE_2316_length_1493_cov_100.467719	947	1028	95	4	81	0.0493827
NODE_2316_length_1493_cov_100.467719	947	1028	99	1	81	0.0123457
NODE_2316_length_1493_cov_100.467719	947	1028	103	2	81	0.0246914
NODE_2316_length_1493_cov_100.467719	947	1028	105	1	81	0.0123457
NODE_2316_length_1493_cov_100.467719	947	1028	107	6	81	0.0740741
NODE_2316_length_1493_cov_100.467719	947	1028	109	1	81	0.0123457
NODE_2316_length_1493_cov_100.467719	947	1028	111	4	81	0.0493827
NODE_2316_length_1493_cov_100.467719	947	1028	115	1	81	0.0123457
NODE_2316_length_1493_cov_100.467719	947	1028	117	1	81	0.0123457
NODE_2316_length_1493_cov_100.467719	947	1028	119	3	81	0.0370370
NODE_2316_length_1493_cov_100.467719	947	1028	121	5	81	0.0617284
NODE_2316_length_1493_cov_100.467719	947	1028	125	2	81	0.0246914
NODE_2316_length_1493_cov_100.467719	947	1028	127	3	81	0.0370370
NODE_2316_length_1493_cov_100.467719	947	1028	129	1	81	0.0123457
NODE_2316_length_1493_cov_100.467719	947	1028	131	1	81	0.0123457
NODE_2316_length_1493_cov_100.467719	947	1028	133	1	81	0.0123457
NODE_2316_length_1493_cov_100.467719	947	1028	134	1	81	0.0123457
NODE_2316_length_1493_cov_100.467719	947	1028	138	1	81	0.0123457
NODE_2316_length_1493_cov_100.467719	947	1028	142	1	81	0.0123457
NODE_2316_length_1493_cov_100.467719	947	1028	143	1	81	0.0123457
NODE_2316_length_1493_cov_100.467719	947	1028	149	2	81	0.0246914
NODE_2316_length_1493_cov_100.467719	947	1028	153	1	81	0.0123457
NODE_2316_length_1493_cov_100.467719	947	1028	156	1	81	0.0123457
NODE_2316_length_1493_cov_100.467719	1001	1071	111	1	70	0.0142857
NODE_2316_length_1493_cov_100.467719	1001	1071	115	1	70	0.0142857
NODE_2316_length_1493_cov_100.467719	1001	1071	117	1	70	0.0142857
NODE_2316_length_1493_cov_100.467719	1001	1071	119	3	70	0.0428571
NODE_2316_length_1493_cov_100.467719	1001	1071	121	5	70	0.0714286
NODE_2316_length_1493_cov_100.467719	1001	1071	125	2	70	0.0285714
NODE_2316_length_1493_cov_100.467719	1001	1071	127	3	70	0.0428571
NODE_2316_length_1493_cov_100.467719	1001	1071	129	1	70	0.0142857
NODE_2316_length_1493_cov_100.467719	1001	1071	131	1	70	0.0142857
NODE_2316_length_1493_cov_100.467719	1001	1071	133	1	70	0.0142857
NODE_2316_length_1493_cov_100.467719	1001	1071	134	1	70	0.0142857
NODE_2316_length_1493_cov_100.467719	1001	1071	138	1	70	0.0142857
NODE_2316_length_1493_cov_100.467719	1001	1071	142	1	70	0.0142857
NODE_2316_length_1493_cov_100.467719	1001	1071	143	1	70	0.0142857
NODE_2316_length_1493_cov_100.467719	1001	1071	149	2	70	0.0285714
NODE_2316_length_1493_cov_100.467719	1001	1071	153	1	70	0.0142857
NODE_2316_length_1493_cov_100.467719	1001	1071	156	1	70	0.0142857
NODE_2316_length_1493_cov_100.467719	1001	1071	164	1	70	0.0142857
NODE_2316_length_1493_cov_100.467719	1001	1071	166	1	70	0.0142857
NODE_2316_length_1493_cov_100.467719	1001	1071	174	1	70	0.0142857
NODE_2316_length_1493_cov_100.467719	1001	1071	176	2	70	0.0285714
NODE_2316_length_1493_cov_100.467719	1001	1071	178	1	70	0.0142857
NODE_2316_length_1493_cov_100.467719	1001	1071	184	1	70	0.0142857
NODE_2316_length_1493_cov_100.467719	1001	1071	188	1	70	0.0142857
NODE_2316_length_1493_cov_100.467719	1001	1071	195	2	70	0.0285714
NODE_2316_length_1493_cov_100.467719	1001	1071	197	2	70	0.0285714
NODE_2316_length_1493_cov_100.467719	1001	1071	199	1	70	0.0142857
NODE_2316_length_1493_cov_100.467719	1001	1071	201	3	70	0.0428571
NODE_2316_length_1493_cov_100.467719	1001	1071	209	1	70	0.0142857
NODE_2316_length_1493_cov_100.467719	1001	1071	213	1	70	0.0142857
NODE_2316_length_1493_cov_100.467719	1001	1071	217	2	70	0.0285714
NODE_2316_length_1493_cov_100.467719	1001	1071	223	1	70	0.0142857
NODE_2316_length_1493_cov_100.467719	1001	1071	231	1	70	0.0142857
NODE_2316_length_1493_cov_100.467719	1001	1071	237	1	70	0.0142857
NODE_2316_length_1493_cov_100.467719	1001	1071	240	2	70	0.0285714
NODE_2316_length_1493_cov_100.467719	1001	1071	242	4	70	0.0571429
NODE_2316_length_1493_cov_100.467719	1001	1071	244	3	70	0.0428571
NODE_2316_length_1493_cov_100.467719	1001	1071	250	1	70	0.0142857
NODE_2316_length_1493_cov_100.467719	1001	1071	256	1	70	0.0142857
NODE_2316_length_1493_cov_100.467719	1001	1071	258	1	70	0.0142857
NODE_2316_length_1493_cov_100.467719	1001	1071	261	2	70	0.0285714
NODE_2316_length_1493_cov_100.467719	1001	1071	264	4	70	0.0571429
NODE_2316_length_1493_cov_100.467719	1001	1071	265	2	70	0.0285714
NODE_2316_length_1493_cov_100.467719	1077	1157	270	1	80	0.0125000
NODE_2316_length_1493_cov_100.467719	1077	1157	272	1	80	0.0125000
NODE_2316_length_1493_cov_100.467719	1077	1157	276	1	80	0.0125000
NODE_2316_length_1493_cov_100.467719	1077	1157	278	1	80	0.0125000
NODE_2316_length_1493_cov_100.467719	1077	1157	282	1	80	0.0125000
NODE_2316_length_1493_cov_100.467719	1077	1157	296	1	80	0.0125000
NODE_2316_length_1493_cov_100.467719	1077	1157	302	1	80	0.0125000
NODE_2316_length_1493_cov_100.467719	1077	1157	304	2	80	0.0250000
NODE_2316_length_1493_cov_100.467719	1077	1157	308	1	80	0.0125000
NODE_2316_length_1493_cov_100.467719	1077	1157	315	1	80	0.0125000
NODE_2316_length_1493_cov_100.467719	1077	1157	316	2	80	0.0250000
NODE_2316_length_1493_cov_100.467719	1077	1157	318	1	80	0.0125000
NODE_2316_length_1493_cov_100.467719	1077	1157	324	1	80	0.0125000
NODE_2316_length_1493_cov_100.467719	1077	1157	325	1	80	0.0125000
NODE_2316_length_1493_cov_100.467719	1077	1157	329	1	80	0.0125000
NODE_2316_length_1493_cov_100.467719	1077	1157	330	1	80	0.0125000
NODE_2316_length_1493_cov_100.467719	1077	1157	332	1	80	0.0125000
NODE_2316_length_1493_cov_100.467719	1077	1157	334	1	80	0.0125000
NODE_2316_length_1493_cov_100.467719	1077	1157	337	1	80	0.0125000
NODE_2316_length_1493_cov_100.467719	1077	1157	338	1	80	0.0125000
NODE_2316_length_1493_cov_100.467719	1077	1157	342	1	80	0.0125000
NODE_2316_length_1493_cov_100.467719	1077	1157	343	1	80	0.0125000
NODE_2316_length_1493_cov_100.467719	1077	1157	355	2	80	0.0250000
NODE_2316_length_1493_cov_100.467719	1077	1157	361	1	80	0.0125000
NODE_2316_length_1493_cov_100.467719	1077	1157	368	1	80	0.0125000
NODE_2316_length_1493_cov_100.467719	1077	1157	381	1	80	0.0125000
NODE_2316_length_1493_cov_100.467719	1077	1157	392	1	80	0.0125000
NODE_2316_length_1493_cov_100.467719	1077	1157	397	1	80	0.0125000
NODE_2316_length_1493_cov_100.467719	1077	1157	398	3	80	0.0375000
NODE_2316_length_1493_cov_100.467719	1077	1157	404	1	80	0.0125000
NODE_2316_length_1493_cov_100.467719	1077	1157	405	2	80	0.0250000
NODE_2316_length_1493_cov_100.467719	1077	1157	406	2	80	0.0250000
NODE_2316_length_1493_cov_100.467719	1077	1157	407	1	80	0.0125000
NODE_2316_length_1493_cov_100.467719	1077	1157	410	1	80	0.0125000
NODE_2316_length_1493_cov_100.467719	1077	1157	412	4	80	0.0500000
NODE_2316_length_1493_cov_100.467719	1077	1157	417	1	80	0.0125000
NODE_2316_length_1493_cov_100.467719	1077	1157	428	3	80	0.0375000
NODE_2316_length_1493_cov_100.467719	1077	1157	444	1	80	0.0125000
NODE_2316_length_1493_cov_100.467719	1077	1157	449	1	80	0.0125000
NODE_2316_length_1493_cov_100.467719	1077	1157	463	1	80	0.0125000
NODE_2316_length_1493_cov_100.467719	1077	1157	464	1	80	0.0125000
NODE_2316_length_1493_cov_100.467719	1077	1157	467	1	80	0.0125000
NODE_2316_length_1493_cov_100.467719	1077	1157	469	1	80	0.0125000
NODE_2316_length_1493_cov_100.467719	1077	1157	483	1	80	0.0125000
NODE_2316_length_1493_cov_100.467719	1077	1157	484	1	80	0.0125000
NODE_2316_length_1493_cov_100.467719	1077	1157	488	2	80	0.0250000
NODE_2316_length_1493_cov_100.467719	1077	1157	489	2	80	0.0250000
NODE_2316_length_1493_cov_100.467719	1077	1157	490	2	80	0.0250000
NODE_2316_length_1493_cov_100.467719	1077	1157	491	3	80	0.0375000
NODE_2316_length_1493_cov_100.467719	1077	1157	493	1	80	0.0125000
NODE_2316_length_1493_cov_100.467719	1077	1157	498	1	80	0.0125000
NODE_2316_length_1493_cov_100.467719	1077	1157	499	1	80	0.0125000
NODE_2316_length_1493_cov_100.467719	1077	1157	506	1	80	0.0125000
NODE_2316_length_1493_cov_100.467719	1077	1157	508	1	80	0.0125000
NODE_2316_length_1493_cov_100.467719	1077	1157	509	1	80	0.0125000
NODE_2316_length_1493_cov_100.467719	1077	1157	510	1	80	0.0125000
NODE_2316_length_1493_cov_100.467719	1077	1157	511	3	80	0.0375000
NODE_2316_length_1493_cov_100.467719	1077	1157	513	1	80	0.0125000
NODE_2316_length_1493_cov_100.467719	1077	1157	514	1	80	0.0125000
NODE_2316_length_1493_cov_100.467719	1077	1157	517	1	80	0.0125000
NODE_2316_length_1493_cov_100.467719	1077	1157	518	1	80	0.0125000
NODE_2316_length_1493_cov_100.467719	1130	1210	467	1	80	0.0125000
NODE_2316_length_1493_cov_100.467719	1130	1210	469	1	80	0.0125000
NODE_2316_length_1493_cov_100.467719	1130	1210	483	1	80	0.0125000
NODE_2316_length_1493_cov_100.467719	1130	1210	484	1	80	0.0125000
NODE_2316_length_1493_cov_100.467719	1130	1210	488	2	80	0.0250000
NODE_2316_length_1493_cov_100.467719	1130	1210	489	3	80	0.0375000
NODE_2316_length_1493_cov_100.467719	1130	1210	490	3	80	0.0375000
NODE_2316_length_1493_cov_100.467719	1130	1210	491	4	80	0.0500000
NODE_2316_length_1493_cov_100.467719	1130	1210	493	2	80	0.0250000
NODE_2316_length_1493_cov_100.467719	1130	1210	496	1	80	0.0125000
NODE_2316_length_1493_cov_100.467719	1130	1210	498	1	80	0.0125000
NODE_2316_length_1493_cov_100.467719	1130	1210	499	1	80	0.0125000
NODE_2316_length_1493_cov_100.467719	1130	1210	500	1	80	0.0125000
NODE_2316_length_1493_cov_100.467719	1130	1210	502	1	80	0.0125000
NODE_2316_length_1493_cov_100.467719	1130	1210	503	2	80	0.0250000
NODE_2316_length_1493_cov_100.467719	1130	1210	505	2	80	0.0250000
NODE_2316_length_1493_cov_100.467719	1130	1210	506	2	80	0.0250000
NODE_2316_length_1493_cov_100.467719	1130	1210	507	1	80	0.0125000
NODE_2316_length_1493_cov_100.467719	1130	1210	508	3	80	0.0375000
NODE_2316_length_1493_cov_100.467719	1130	1210	509	4	80	0.0500000
NODE_2316_length_1493_cov_100.467719	1130	1210	510	2	80	0.0250000
NODE_2316_length_1493_cov_100.467719	1130	1210	511	5	80	0.0625000
NODE_2316_length_1493_cov_100.467719	1130	1210	513	5	80	0.0625000
NODE_2316_length_1493_cov_100.467719	1130	1210	514	3	80	0.0375000
NODE_2316_length_1493_cov_100.467719	1130	1210	517	2	80	0.0250000
NODE_2316_length_1493_cov_100.467719	1130	1210	518	1	80	0.0125000
NODE_2316_length_1493_cov_100.467719	1130	1210	521	1	80	0.0125000
NODE_2316_length_1493_cov_100.467719	1130	1210	522	1	80	0.0125000
NODE_2316_length_1493_cov_100.467719	1130	1210	523	1	80	0.0125000
NODE_2316_length_1493_cov_100.467719	1130	1210	524	1	80	0.0125000
NODE_2316_length_1493_cov_100.467719	1130	1210	526	1	80	0.0125000
NODE_2316_length_1493_cov_100.467719	1130	1210	527	1	80	0.0125000
NODE_2316_length_1493_cov_100.467719	1130	1210	528	2	80	0.0250000
NODE_2316_length_1493_cov_100.467719	1130	1210	529	2	80	0.0250000
NODE_2316_length_1493_cov_100.467719	1130	1210	530	2	80	0.0250000
NODE_2316_length_1493_cov_100.467719	1130	1210	531	1	80	0.0125000
NODE_2316_length_1493_cov_100.467719	1130	1210	532	2	80	0.0250000
NODE_2316_length_1493_cov_100.467719	1130	1210	533	1	80	0.0125000
NODE_2316_length_1493_cov_100.467719	1130	1210	534	3	80	0.0375000
NODE_2316_length_1493_cov_100.467719	1130	1210	537	1	80	0.0125000
NODE_2316_length_1493_cov_100.467719	1130	1210	538	1	80	0.0125000
NODE_2316_length_1493_cov_100.467719	1130	1210	539	3	80	0.0375000
NODE_2316_length_1493_cov_100.467719	1130	1210	542	1	80	0.0125000
NODE_2321_length_1493_cov_1.138451	1341	1420	0	11	79	0.1392405
NODE_2321_length_1493_cov_1.138451	1341	1420	2	32	79	0.4050633
NODE_2321_length_1493_cov_1.138451	1341	1420	4	36	79	0.4556962
NODE_2321_length_1493_cov_1.138451	1341	1420	0	11	79	0.1392405
NODE_2321_length_1493_cov_1.138451	1341	1420	2	32	79	0.4050633
NODE_2321_length_1493_cov_1.138451	1341	1420	4	36	79	0.4556962
NODE_2321_length_1493_cov_1.138451	1393	1459	2	37	66	0.5606061
NODE_2321_length_1493_cov_1.138451	1393	1459	4	29	66	0.4393939
NODE_2332_length_1490_cov_5.726096	233	295	2	12	62	0.1935484
NODE_2332_length_1490_cov_5.726096	233	295	4	7	62	0.1129032
NODE_2332_length_1490_cov_5.726096	233	295	6	19	62	0.3064516
NODE_2332_length_1490_cov_5.726096	233	295	8	24	62	0.3870968
NODE_2332_length_1490_cov_5.726096	1065	1149	0	16	84	0.1904762
NODE_2332_length_1490_cov_5.726096	1065	1149	2	68	84	0.8095238
NODE_2333_length_1490_cov_4.687275	318	399	0	2	81	0.0246914
NODE_2333_length_1490_cov_4.687275	318	399	2	79	81	0.9753087
NODE_2333_length_1490_cov_4.687275	372	452	0	55	80	0.6875000
NODE_2333_length_1490_cov_4.687275	372	452	2	25	80	0.3125000
NODE_2338_length_1488_cov_3.734341	1141	1221	0	80	80	1.0000000
NODE_2340_length_1487_cov_19.332133	673	753	2	50	80	0.6250000
NODE_2340_length_1487_cov_19.332133	673	753	4	30	80	0.3750000
NODE_2340_length_1487_cov_19.332133	726	806	0	5	80	0.0625000
NODE_2340_length_1487_cov_19.332133	726	806	2	55	80	0.6875000
NODE_2340_length_1487_cov_19.332133	726	806	4	20	80	0.2500000
NODE_2348_length_1484_cov_38.342960	706	786	0	80	80	1.0000000
NODE_2348_length_1484_cov_38.342960	759	839	0	80	80	1.0000000
NODE_2349_length_1484_cov_21.260650	348	428	0	80	80	1.0000000
NODE_2349_length_1484_cov_21.260650	401	481	0	80	80	1.0000000
NODE_2349_length_1484_cov_21.260650	978	1058	0	13	80	0.1625000
NODE_2349_length_1484_cov_21.260650	978	1058	4	67	80	0.8375000
NODE_2349_length_1484_cov_21.260650	1031	1111	0	65	80	0.8125000
NODE_2349_length_1484_cov_21.260650	1031	1111	4	15	80	0.1875000
NODE_2350_length_1484_cov_19.243321	952	1032	4	24	80	0.3000000
NODE_2350_length_1484_cov_19.243321	952	1032	6	56	80	0.7000000
NODE_2350_length_1484_cov_19.243321	1005	1085	2	2	80	0.0250000
NODE_2350_length_1484_cov_19.243321	1005	1085	4	15	80	0.1875000
NODE_2350_length_1484_cov_19.243321	1005	1085	6	60	80	0.7500000
NODE_2350_length_1484_cov_19.243321	1005	1085	8	3	80	0.0375000
NODE_2351_length_1484_cov_9.085199	314	394	0	80	80	1.0000000
NODE_2351_length_1484_cov_9.085199	367	447	0	80	80	1.0000000
NODE_2353_length_1483_cov_21.207370	555	635	10	62	80	0.7750000
NODE_2353_length_1483_cov_21.207370	555	635	12	18	80	0.2250000
NODE_2353_length_1483_cov_21.207370	608	688	0	19	80	0.2375000
NODE_2353_length_1483_cov_21.207370	608	688	2	6	80	0.0750000
NODE_2353_length_1483_cov_21.207370	608	688	4	11	80	0.1375000
NODE_2353_length_1483_cov_21.207370	608	688	6	7	80	0.0875000
NODE_2353_length_1483_cov_21.207370	608	688	8	9	80	0.1125000
NODE_2353_length_1483_cov_21.207370	608	688	10	28	80	0.3500000
NODE_2359_length_1482_cov_20.177874	430	510	0	11	80	0.1375000
NODE_2359_length_1482_cov_20.177874	430	510	2	20	80	0.2500000
NODE_2359_length_1482_cov_20.177874	430	510	4	49	80	0.6125000
NODE_2359_length_1482_cov_20.177874	483	563	0	26	80	0.3250000
NODE_2359_length_1482_cov_20.177874	483	563	2	2	80	0.0250000
NODE_2359_length_1482_cov_20.177874	483	563	3	1	80	0.0125000
NODE_2359_length_1482_cov_20.177874	483	563	4	51	80	0.6375000
NODE_2359_length_1482_cov_20.177874	559	639	0	80	80	1.0000000
NODE_2359_length_1482_cov_20.177874	612	692	0	80	80	1.0000000
NODE_2360_length_1482_cov_13.644252	1000	1080	0	22	80	0.2750000
NODE_2360_length_1482_cov_13.644252	1000	1080	2	58	80	0.7250000
NODE_2360_length_1482_cov_13.644252	1053	1133	0	75	80	0.9375000
NODE_2360_length_1482_cov_13.644252	1053	1133	2	5	80	0.0625000
NODE_2361_length_1482_cov_6.157628	525	605	0	61	80	0.7625000
NODE_2361_length_1482_cov_6.157628	525	605	2	19	80	0.2375000
NODE_2361_length_1482_cov_6.157628	578	658	0	8	80	0.1000000
NODE_2361_length_1482_cov_6.157628	578	658	2	72	80	0.9000000
NODE_2361_length_1482_cov_6.157628	1306	1388	6	5	82	0.0609756
NODE_2361_length_1482_cov_6.157628	1306	1388	8	4	82	0.0487805
NODE_2361_length_1482_cov_6.157628	1306	1388	10	15	82	0.1829268
NODE_2361_length_1482_cov_6.157628	1306	1388	12	55	82	0.6707317
NODE_2361_length_1482_cov_6.157628	1306	1388	14	3	82	0.0365854
NODE_2364_length_1481_cov_19.238784	480	560	0	80	80	1.0000000
NODE_2364_length_1481_cov_19.238784	533	613	0	80	80	1.0000000
NODE_2365_length_1481_cov_18.139653	706	786	0	37	80	0.4625000
NODE_2365_length_1481_cov_18.139653	706	786	2	43	80	0.5375000
NODE_2365_length_1481_cov_18.139653	759	839	2	30	80	0.3750000
NODE_2365_length_1481_cov_18.139653	759	839	4	9	80	0.1125000
NODE_2365_length_1481_cov_18.139653	759	839	6	2	80	0.0250000
NODE_2365_length_1481_cov_18.139653	759	839	8	28	80	0.3500000
NODE_2365_length_1481_cov_18.139653	759	839	10	3	80	0.0375000
NODE_2365_length_1481_cov_18.139653	759	839	12	8	80	0.1000000
NODE_2367_length_1480_cov_27.552498	762	842	0	80	80	1.0000000
NODE_2367_length_1480_cov_27.552498	815	895	0	80	80	1.0000000
NODE_2367_length_1480_cov_27.552498	891	971	0	80	80	1.0000000
NODE_2367_length_1480_cov_27.552498	944	1024	0	80	80	1.0000000
NODE_2367_length_1480_cov_27.552498	1171	1222	2	10	51	0.1960784
NODE_2367_length_1480_cov_27.552498	1171	1222	4	2	51	0.0392157
NODE_2367_length_1480_cov_27.552498	1171	1222	5	1	51	0.0196078
NODE_2367_length_1480_cov_27.552498	1171	1222	6	2	51	0.0392157
NODE_2367_length_1480_cov_27.552498	1171	1222	8	2	51	0.0392157
NODE_2367_length_1480_cov_27.552498	1171	1222	11	1	51	0.0196078
NODE_2367_length_1480_cov_27.552498	1171	1222	12	2	51	0.0392157
NODE_2367_length_1480_cov_27.552498	1171	1222	16	1	51	0.0196078
NODE_2367_length_1480_cov_27.552498	1171	1222	21	3	51	0.0588235
NODE_2367_length_1480_cov_27.552498	1171	1222	22	1	51	0.0196078
NODE_2367_length_1480_cov_27.552498	1171	1222	24	1	51	0.0196078
NODE_2367_length_1480_cov_27.552498	1171	1222	26	1	51	0.0196078
NODE_2367_length_1480_cov_27.552498	1171	1222	31	1	51	0.0196078
NODE_2367_length_1480_cov_27.552498	1171	1222	33	1	51	0.0196078
NODE_2367_length_1480_cov_27.552498	1171	1222	36	4	51	0.0784314
NODE_2367_length_1480_cov_27.552498	1171	1222	38	5	51	0.0980392
NODE_2367_length_1480_cov_27.552498	1171	1222	40	1	51	0.0196078
NODE_2367_length_1480_cov_27.552498	1171	1222	42	1	51	0.0196078
NODE_2367_length_1480_cov_27.552498	1171	1222	44	1	51	0.0196078
NODE_2367_length_1480_cov_27.552498	1171	1222	48	1	51	0.0196078
NODE_2367_length_1480_cov_27.552498	1171	1222	54	4	51	0.0784314
NODE_2367_length_1480_cov_27.552498	1171	1222	56	5	51	0.0980392
NODE_2369_length_1480_cov_12.535844	466	546	0	28	80	0.3500000
NODE_2369_length_1480_cov_12.535844	466	546	2	52	80	0.6500000
NODE_2369_length_1480_cov_12.535844	519	599	2	80	80	1.0000000
NODE_2373_length_1479_cov_17.035507	708	788	0	80	80	1.0000000
NODE_2373_length_1479_cov_17.035507	761	841	0	80	80	1.0000000
NODE_2373_length_1479_cov_17.035507	837	917	0	80	80	1.0000000
NODE_2373_length_1479_cov_17.035507	890	970	0	80	80	1.0000000
NODE_2374_length_1479_cov_16.448551	908	988	0	80	80	1.0000000
NODE_2374_length_1479_cov_16.448551	961	1041	0	80	80	1.0000000
NODE_2375_length_1479_cov_5.285507	123	185	8	1	62	0.0161290
NODE_2375_length_1479_cov_5.285507	123	185	12	6	62	0.0967742
NODE_2375_length_1479_cov_5.285507	123	185	16	8	62	0.1290323
NODE_2375_length_1479_cov_5.285507	123	185	18	7	62	0.1129032
NODE_2375_length_1479_cov_5.285507	123	185	20	7	62	0.1129032
NODE_2375_length_1479_cov_5.285507	123	185	24	5	62	0.0806452
NODE_2375_length_1479_cov_5.285507	123	185	28	2	62	0.0322581
NODE_2375_length_1479_cov_5.285507	123	185	32	1	62	0.0161290
NODE_2375_length_1479_cov_5.285507	123	185	38	2	62	0.0322581
NODE_2375_length_1479_cov_5.285507	123	185	40	9	62	0.1451613
NODE_2375_length_1479_cov_5.285507	123	185	42	3	62	0.0483871
NODE_2375_length_1479_cov_5.285507	123	185	44	1	62	0.0161290
NODE_2375_length_1479_cov_5.285507	123	185	46	1	62	0.0161290
NODE_2375_length_1479_cov_5.285507	123	185	48	1	62	0.0161290
NODE_2375_length_1479_cov_5.285507	123	185	54	5	62	0.0806452
NODE_2375_length_1479_cov_5.285507	123	185	56	1	62	0.0161290
NODE_2375_length_1479_cov_5.285507	123	185	58	1	62	0.0161290
NODE_2375_length_1479_cov_5.285507	123	185	60	1	62	0.0161290
NODE_2376_length_1479_cov_2.018841	881	967	0	86	86	1.0000000
NODE_2377_length_1478_cov_32.050761	411	491	2	80	80	1.0000000
NODE_2377_length_1478_cov_32.050761	464	544	0	34	80	0.4250000
NODE_2377_length_1478_cov_32.050761	464	544	2	46	80	0.5750000
NODE_2377_length_1478_cov_32.050761	540	620	0	41	80	0.5125000
NODE_2377_length_1478_cov_32.050761	540	620	2	13	80	0.1625000
NODE_2377_length_1478_cov_32.050761	540	620	4	26	80	0.3250000
NODE_2377_length_1478_cov_32.050761	593	673	2	1	80	0.0125000
NODE_2377_length_1478_cov_32.050761	593	673	3	26	80	0.3250000
NODE_2377_length_1478_cov_32.050761	593	673	4	53	80	0.6625000
NODE_2378_length_1478_cov_27.414793	817	897	0	80	80	1.0000000
NODE_2378_length_1478_cov_27.414793	870	950	0	80	80	1.0000000
NODE_2379_length_1478_cov_23.472081	1212	1241	34	2	29	0.0689655
NODE_2379_length_1478_cov_23.472081	1212	1241	36	4	29	0.1379310
NODE_2379_length_1478_cov_23.472081	1212	1241	38	8	29	0.2758621
NODE_2379_length_1478_cov_23.472081	1212	1241	40	2	29	0.0689655
NODE_2379_length_1478_cov_23.472081	1212	1241	42	3	29	0.1034483
NODE_2379_length_1478_cov_23.472081	1212	1241	44	5	29	0.1724138
NODE_2379_length_1478_cov_23.472081	1212	1241	46	3	29	0.1034483
NODE_2379_length_1478_cov_23.472081	1212	1241	48	2	29	0.0689655
NODE_2380_length_1478_cov_10.746193	678	758	4	32	80	0.4000000
NODE_2380_length_1478_cov_10.746193	678	758	5	17	80	0.2125000
NODE_2380_length_1478_cov_10.746193	678	758	6	31	80	0.3875000
NODE_2380_length_1478_cov_10.746193	731	811	2	51	80	0.6375000
NODE_2380_length_1478_cov_10.746193	731	811	5	5	80	0.0625000
NODE_2380_length_1478_cov_10.746193	731	811	6	24	80	0.3000000
NODE_2380_length_1478_cov_10.746193	807	892	0	1	85	0.0117647
NODE_2380_length_1478_cov_10.746193	807	892	1	22	85	0.2588235
NODE_2380_length_1478_cov_10.746193	807	892	2	62	85	0.7294118
NODE_2380_length_1478_cov_10.746193	860	945	0	54	85	0.6352941
NODE_2380_length_1478_cov_10.746193	860	945	1	22	85	0.2588235
NODE_2380_length_1478_cov_10.746193	860	945	2	9	85	0.1058824
NODE_2384_length_1476_cov_6.522150	791	871	0	80	80	1.0000000
NODE_2384_length_1476_cov_6.522150	844	924	0	80	80	1.0000000
NODE_2392_length_1474_cov_11.209455	515	595	0	80	80	1.0000000
NODE_2392_length_1474_cov_11.209455	568	648	0	80	80	1.0000000
NODE_2397_length_1472_cov_22.159505	428	508	0	14	80	0.1750000
NODE_2397_length_1472_cov_22.159505	428	508	2	15	80	0.1875000
NODE_2397_length_1472_cov_22.159505	428	508	4	16	80	0.2000000
NODE_2397_length_1472_cov_22.159505	428	508	6	35	80	0.4375000
NODE_2397_length_1472_cov_22.159505	428	508	0	14	80	0.1750000
NODE_2397_length_1472_cov_22.159505	428	508	2	15	80	0.1875000
NODE_2397_length_1472_cov_22.159505	428	508	4	16	80	0.2000000
NODE_2397_length_1472_cov_22.159505	428	508	6	35	80	0.4375000
NODE_2397_length_1472_cov_22.159505	481	561	0	21	80	0.2625000
NODE_2397_length_1472_cov_22.159505	481	561	2	43	80	0.5375000
NODE_2397_length_1472_cov_22.159505	481	561	7	2	80	0.0250000
NODE_2397_length_1472_cov_22.159505	481	561	11	4	80	0.0500000
NODE_2397_length_1472_cov_22.159505	481	561	14	1	80	0.0125000
NODE_2397_length_1472_cov_22.159505	481	561	15	3	80	0.0375000
NODE_2397_length_1472_cov_22.159505	481	561	17	1	80	0.0125000
NODE_2397_length_1472_cov_22.159505	481	561	19	1	80	0.0125000
NODE_2397_length_1472_cov_22.159505	481	561	21	4	80	0.0500000
NODE_2397_length_1472_cov_22.159505	913	993	0	80	80	1.0000000
NODE_2397_length_1472_cov_22.159505	966	1046	0	41	80	0.5125000
NODE_2397_length_1472_cov_22.159505	966	1046	2	39	80	0.4875000
NODE_2397_length_1472_cov_22.159505	1042	1122	0	32	80	0.4000000
NODE_2397_length_1472_cov_22.159505	1042	1122	2	48	80	0.6000000
NODE_2397_length_1472_cov_22.159505	1095	1175	0	80	80	1.0000000
NODE_2398_length_1472_cov_22.018208	523	590	23	32	67	0.4776119
NODE_2398_length_1472_cov_22.018208	523	590	24	5	67	0.0746269
NODE_2398_length_1472_cov_22.018208	523	590	25	13	67	0.1940299
NODE_2398_length_1472_cov_22.018208	523	590	26	17	67	0.2537313
NODE_2398_length_1472_cov_22.018208	563	643	0	36	80	0.4500000
NODE_2398_length_1472_cov_22.018208	563	643	22	7	80	0.0875000
NODE_2398_length_1472_cov_22.018208	563	643	23	5	80	0.0625000
NODE_2398_length_1472_cov_22.018208	563	643	24	15	80	0.1875000
NODE_2398_length_1472_cov_22.018208	563	643	26	17	80	0.2125000
NODE_2398_length_1472_cov_22.018208	639	719	0	80	80	1.0000000
NODE_2398_length_1472_cov_22.018208	692	772	0	80	80	1.0000000
NODE_2404_length_1470_cov_7.042305	5	57	0	4	52	0.0769231
NODE_2404_length_1470_cov_7.042305	5	57	6	4	52	0.0769231
NODE_2404_length_1470_cov_7.042305	5	57	8	1	52	0.0192308
NODE_2404_length_1470_cov_7.042305	5	57	10	1	52	0.0192308
NODE_2404_length_1470_cov_7.042305	5	57	12	1	52	0.0192308
NODE_2404_length_1470_cov_7.042305	5	57	14	10	52	0.1923077
NODE_2404_length_1470_cov_7.042305	5	57	16	31	52	0.5961539
NODE_2405_length_1470_cov_2.185266	199	245	4	46	46	1.0000000
NODE_2407_length_1469_cov_5.683942	834	914	0	80	80	1.0000000
NODE_2407_length_1469_cov_5.683942	887	967	0	80	80	1.0000000
NODE_2410_length_1467_cov_31.231725	1048	1131	0	83	83	1.0000000
NODE_2411_length_1467_cov_19.731725	485	565	0	30	80	0.3750000
NODE_2411_length_1467_cov_19.731725	485	565	2	50	80	0.6250000
NODE_2411_length_1467_cov_19.731725	538	618	2	44	80	0.5500000
NODE_2411_length_1467_cov_19.731725	538	618	4	36	80	0.4500000
NODE_2412_length_1467_cov_11.807749	180	242	2	10	62	0.1612903
NODE_2412_length_1467_cov_11.807749	180	242	4	8	62	0.1290323
NODE_2412_length_1467_cov_11.807749	180	242	8	3	62	0.0483871
NODE_2412_length_1467_cov_11.807749	180	242	10	41	62	0.6612903
NODE_2412_length_1467_cov_11.807749	264	293	8	2	29	0.0689655
NODE_2412_length_1467_cov_11.807749	264	293	10	27	29	0.9310345
NODE_2412_length_1467_cov_11.807749	930	1010	4	48	80	0.6000000
NODE_2412_length_1467_cov_11.807749	930	1010	6	32	80	0.4000000
NODE_2412_length_1467_cov_11.807749	983	1063	0	9	80	0.1125000
NODE_2412_length_1467_cov_11.807749	983	1063	2	38	80	0.4750000
NODE_2412_length_1467_cov_11.807749	983	1063	4	4	80	0.0500000
NODE_2412_length_1467_cov_11.807749	983	1063	6	29	80	0.3625000
NODE_2414_length_1466_cov_41.326993	664	744	0	26	80	0.3250000
NODE_2414_length_1466_cov_41.326993	664	744	2	54	80	0.6750000
NODE_2414_length_1466_cov_41.326993	717	797	2	61	80	0.7625000
NODE_2414_length_1466_cov_41.326993	717	797	4	19	80	0.2375000
NODE_2414_length_1466_cov_41.326993	793	873	0	47	80	0.5875000
NODE_2414_length_1466_cov_41.326993	793	873	2	33	80	0.4125000
NODE_2414_length_1466_cov_41.326993	846	926	0	80	80	1.0000000
NODE_2420_length_1464_cov_6.726740	137	204	0	39	67	0.5820895
NODE_2420_length_1464_cov_6.726740	137	204	4	28	67	0.4179105
NODE_2422_length_1464_cov_2.198535	1301	1363	4	6	62	0.0967742
NODE_2422_length_1464_cov_2.198535	1301	1363	6	3	62	0.0483871
NODE_2422_length_1464_cov_2.198535	1301	1363	8	3	62	0.0483871
NODE_2422_length_1464_cov_2.198535	1301	1363	10	2	62	0.0322581
NODE_2422_length_1464_cov_2.198535	1301	1363	14	5	62	0.0806452
NODE_2422_length_1464_cov_2.198535	1301	1363	16	6	62	0.0967742
NODE_2422_length_1464_cov_2.198535	1301	1363	18	1	62	0.0161290
NODE_2422_length_1464_cov_2.198535	1301	1363	20	1	62	0.0161290
NODE_2422_length_1464_cov_2.198535	1301	1363	22	2	62	0.0322581
NODE_2422_length_1464_cov_2.198535	1301	1363	24	11	62	0.1774193
NODE_2422_length_1464_cov_2.198535	1301	1363	26	2	62	0.0322581
NODE_2422_length_1464_cov_2.198535	1301	1363	28	11	62	0.1774193
NODE_2422_length_1464_cov_2.198535	1301	1363	34	9	62	0.1451613
NODE_2425_length_1463_cov_15.345308	314	394	0	8	80	0.1000000
NODE_2425_length_1463_cov_15.345308	314	394	2	72	80	0.9000000
NODE_2425_length_1463_cov_15.345308	367	447	0	7	80	0.0875000
NODE_2425_length_1463_cov_15.345308	367	447	2	73	80	0.9125000
NODE_2427_length_1462_cov_18.082172	418	498	0	37	80	0.4625000
NODE_2427_length_1462_cov_18.082172	418	498	2	25	80	0.3125000
NODE_2427_length_1462_cov_18.082172	418	498	4	18	80	0.2250000
NODE_2427_length_1462_cov_18.082172	471	551	2	33	80	0.4125000
NODE_2427_length_1462_cov_18.082172	471	551	4	47	80	0.5875000
NODE_2427_length_1462_cov_18.082172	1036	1116	0	80	80	1.0000000
NODE_2427_length_1462_cov_18.082172	1089	1169	0	80	80	1.0000000
NODE_2428_length_1462_cov_1.792370	1247	1319	0	72	72	1.0000000
NODE_2428_length_1462_cov_1.792370	1305	1374	0	69	69	1.0000000
NODE_2433_length_1460_cov_23.927994	852	932	12	2	80	0.0250000
NODE_2433_length_1460_cov_23.927994	852	932	14	20	80	0.2500000
NODE_2433_length_1460_cov_23.927994	852	932	16	57	80	0.7125000
NODE_2433_length_1460_cov_23.927994	852	932	18	1	80	0.0125000
NODE_2433_length_1460_cov_23.927994	905	985	2	4	80	0.0500000
NODE_2433_length_1460_cov_23.927994	905	985	4	6	80	0.0750000
NODE_2433_length_1460_cov_23.927994	905	985	6	7	80	0.0875000
NODE_2433_length_1460_cov_23.927994	905	985	8	25	80	0.3125000
NODE_2433_length_1460_cov_23.927994	905	985	12	13	80	0.1625000
NODE_2433_length_1460_cov_23.927994	905	985	14	7	80	0.0875000
NODE_2433_length_1460_cov_23.927994	905	985	16	17	80	0.2125000
NODE_2433_length_1460_cov_23.927994	905	985	18	1	80	0.0125000
NODE_2436_length_1459_cov_43.600000	535	615	2	80	80	1.0000000
NODE_2436_length_1459_cov_43.600000	588	668	0	24	80	0.3000000
NODE_2436_length_1459_cov_43.600000	588	668	1	6	80	0.0750000
NODE_2436_length_1459_cov_43.600000	588	668	2	50	80	0.6250000
NODE_2436_length_1459_cov_43.600000	664	744	2	40	80	0.5000000
NODE_2436_length_1459_cov_43.600000	664	744	6	30	80	0.3750000
NODE_2436_length_1459_cov_43.600000	664	744	8	10	80	0.1250000
NODE_2436_length_1459_cov_43.600000	717	797	2	2	80	0.0250000
NODE_2436_length_1459_cov_43.600000	717	797	3	4	80	0.0500000
NODE_2436_length_1459_cov_43.600000	717	797	6	17	80	0.2125000
NODE_2436_length_1459_cov_43.600000	717	797	7	2	80	0.0250000
NODE_2436_length_1459_cov_43.600000	717	797	8	55	80	0.6875000
NODE_2437_length_1459_cov_32.276471	865	945	0	9	80	0.1125000
NODE_2437_length_1459_cov_32.276471	865	945	2	4	80	0.0500000
NODE_2437_length_1459_cov_32.276471	865	945	4	67	80	0.8375000
NODE_2437_length_1459_cov_32.276471	918	998	0	49	80	0.6125000
NODE_2437_length_1459_cov_32.276471	918	998	2	5	80	0.0625000
NODE_2437_length_1459_cov_32.276471	918	998	4	26	80	0.3250000
NODE_2437_length_1459_cov_32.276471	994	1074	0	80	80	1.0000000
NODE_2437_length_1459_cov_32.276471	1047	1127	0	79	80	0.9875000
NODE_2437_length_1459_cov_32.276471	1047	1127	2	1	80	0.0125000
NODE_2441_length_1458_cov_2.184695	1361	1441	0	17	80	0.2125000
NODE_2441_length_1458_cov_2.184695	1361	1441	2	63	80	0.7875000
NODE_2442_length_1457_cov_19.687040	834	914	0	80	80	1.0000000
NODE_2442_length_1457_cov_19.687040	887	967	0	80	80	1.0000000
NODE_2442_length_1457_cov_19.687040	963	1043	0	80	80	1.0000000
NODE_2442_length_1457_cov_19.687040	1016	1096	0	80	80	1.0000000
NODE_2444_length_1457_cov_14.944772	754	834	0	80	80	1.0000000
NODE_2444_length_1457_cov_14.944772	807	887	0	80	80	1.0000000
NODE_2445_length_1457_cov_10.168630	827	907	2	45	80	0.5625000
NODE_2445_length_1457_cov_10.168630	827	907	4	3	80	0.0375000
NODE_2445_length_1457_cov_10.168630	827	907	6	32	80	0.4000000
NODE_2445_length_1457_cov_10.168630	880	960	4	56	80	0.7000000
NODE_2445_length_1457_cov_10.168630	880	960	6	24	80	0.3000000
NODE_2445_length_1457_cov_10.168630	956	1036	0	28	80	0.3500000
NODE_2445_length_1457_cov_10.168630	956	1036	4	52	80	0.6500000
NODE_2445_length_1457_cov_10.168630	1009	1089	0	80	80	1.0000000
NODE_2448_length_1456_cov_13.675755	557	637	2	80	80	1.0000000
NODE_2448_length_1456_cov_13.675755	610	690	0	52	80	0.6500000
NODE_2448_length_1456_cov_13.675755	610	690	2	28	80	0.3500000
NODE_2449_length_1456_cov_11.109064	951	1031	0	76	80	0.9500000
NODE_2449_length_1456_cov_11.109064	951	1031	4	4	80	0.0500000
NODE_2449_length_1456_cov_11.109064	1004	1084	0	23	80	0.2875000
NODE_2449_length_1456_cov_11.109064	1004	1084	4	57	80	0.7125000
NODE_2452_length_1456_cov_3.137067	374	410	0	14	36	0.3888889
NODE_2452_length_1456_cov_3.137067	374	410	2	2	36	0.0555556
NODE_2452_length_1456_cov_3.137067	374	410	4	4	36	0.1111111
NODE_2452_length_1456_cov_3.137067	374	410	6	16	36	0.4444444
NODE_2454_length_1456_cov_1.889462	35	99	0	64	64	1.0000000
NODE_2456_length_1455_cov_60.874631	369	449	0	80	80	1.0000000
NODE_2456_length_1455_cov_60.874631	422	502	0	80	80	1.0000000
NODE_2456_length_1455_cov_60.874631	498	578	0	38	80	0.4750000
NODE_2456_length_1455_cov_60.874631	498	578	2	42	80	0.5250000
NODE_2456_length_1455_cov_60.874631	551	631	0	50	80	0.6250000
NODE_2456_length_1455_cov_60.874631	551	631	2	30	80	0.3750000
NODE_2458_length_1455_cov_35.253687	615	695	0	80	80	1.0000000
NODE_2458_length_1455_cov_35.253687	668	748	0	80	80	1.0000000
NODE_2458_length_1455_cov_35.253687	744	824	0	33	80	0.4125000
NODE_2458_length_1455_cov_35.253687	744	824	2	14	80	0.1750000
NODE_2458_length_1455_cov_35.253687	744	824	4	19	80	0.2375000
NODE_2458_length_1455_cov_35.253687	744	824	6	14	80	0.1750000
NODE_2458_length_1455_cov_35.253687	797	877	2	10	80	0.1250000
NODE_2458_length_1455_cov_35.253687	797	877	4	24	80	0.3000000
NODE_2458_length_1455_cov_35.253687	797	877	6	46	80	0.5750000
NODE_2465_length_1452_cov_7.101256	976	1056	0	80	80	1.0000000
NODE_2465_length_1452_cov_7.101256	1029	1109	0	80	80	1.0000000
NODE_2465_length_1452_cov_7.101256	1105	1185	0	80	80	1.0000000
NODE_2465_length_1452_cov_7.101256	1158	1238	0	80	80	1.0000000
NODE_2470_length_1451_cov_23.880178	439	520	14	7	81	0.0864198
NODE_2470_length_1451_cov_23.880178	439	520	16	48	81	0.5925926
NODE_2470_length_1451_cov_23.880178	439	520	18	24	81	0.2962963
NODE_2470_length_1451_cov_23.880178	439	520	20	2	81	0.0246914
NODE_2470_length_1451_cov_23.880178	493	573	6	10	80	0.1250000
NODE_2470_length_1451_cov_23.880178	493	573	8	8	80	0.1000000
NODE_2470_length_1451_cov_23.880178	493	573	9	8	80	0.1000000
NODE_2470_length_1451_cov_23.880178	493	573	13	9	80	0.1125000
NODE_2470_length_1451_cov_23.880178	493	573	15	5	80	0.0625000
NODE_2470_length_1451_cov_23.880178	493	573	16	22	80	0.2750000
NODE_2470_length_1451_cov_23.880178	493	573	18	17	80	0.2125000
NODE_2470_length_1451_cov_23.880178	493	573	20	1	80	0.0125000
NODE_2471_length_1451_cov_16.249260	422	502	0	80	80	1.0000000
NODE_2471_length_1451_cov_16.249260	475	555	0	80	80	1.0000000
NODE_2472_length_1451_cov_8.663462	908	988	0	80	80	1.0000000
NODE_2472_length_1451_cov_8.663462	961	1040	0	77	79	0.9746835
NODE_2472_length_1451_cov_8.663462	961	1040	2	2	79	0.0253165
NODE_2474_length_1451_cov_5.219675	897	977	0	80	80	1.0000000
NODE_2474_length_1451_cov_5.219675	950	1030	0	80	80	1.0000000
NODE_2477_length_1450_cov_20.371577	611	691	0	80	80	1.0000000
NODE_2477_length_1450_cov_20.371577	664	744	0	80	80	1.0000000
NODE_2482_length_1449_cov_24.665926	432	512	0	80	80	1.0000000
NODE_2482_length_1449_cov_24.665926	485	565	0	80	80	1.0000000
NODE_2482_length_1449_cov_24.665926	561	643	0	82	82	1.0000000
NODE_2482_length_1449_cov_24.665926	616	696	0	80	80	1.0000000
NODE_2485_length_1448_cov_20.587102	904	984	0	2	80	0.0250000
NODE_2485_length_1448_cov_20.587102	904	984	2	78	80	0.9750000
NODE_2485_length_1448_cov_20.587102	957	1037	0	28	80	0.3500000
NODE_2485_length_1448_cov_20.587102	957	1037	2	52	80	0.6500000
NODE_2487_length_1448_cov_8.693847	537	617	0	24	80	0.3000000
NODE_2487_length_1448_cov_8.693847	537	617	2	24	80	0.3000000
NODE_2487_length_1448_cov_8.693847	537	617	6	32	80	0.4000000
NODE_2487_length_1448_cov_8.693847	590	670	2	7	80	0.0875000
NODE_2487_length_1448_cov_8.693847	590	670	6	42	80	0.5250000
NODE_2487_length_1448_cov_8.693847	590	670	8	31	80	0.3875000
NODE_2488_length_1447_cov_21.391691	519	599	0	80	80	1.0000000
NODE_2488_length_1447_cov_21.391691	572	652	0	80	80	1.0000000
NODE_2488_length_1447_cov_21.391691	648	728	0	80	80	1.0000000
NODE_2488_length_1447_cov_21.391691	701	781	0	80	80	1.0000000
NODE_2491_length_1447_cov_2.262611	1268	1325	4	14	57	0.2456140
NODE_2491_length_1447_cov_2.262611	1268	1325	6	4	57	0.0701754
NODE_2491_length_1447_cov_2.262611	1268	1325	8	1	57	0.0175439
NODE_2491_length_1447_cov_2.262611	1268	1325	10	6	57	0.1052632
NODE_2491_length_1447_cov_2.262611	1268	1325	12	5	57	0.0877193
NODE_2491_length_1447_cov_2.262611	1268	1325	14	1	57	0.0175439
NODE_2491_length_1447_cov_2.262611	1268	1325	16	16	57	0.2807018
NODE_2491_length_1447_cov_2.262611	1268	1325	18	1	57	0.0175439
NODE_2491_length_1447_cov_2.262611	1268	1325	20	9	57	0.1578947
NODE_2491_length_1447_cov_2.262611	1321	1378	12	3	57	0.0526316
NODE_2491_length_1447_cov_2.262611	1321	1378	14	4	57	0.0701754
NODE_2491_length_1447_cov_2.262611	1321	1378	16	2	57	0.0350877
NODE_2491_length_1447_cov_2.262611	1321	1378	18	24	57	0.4210526
NODE_2491_length_1447_cov_2.262611	1321	1378	20	24	57	0.4210526
NODE_2494_length_1445_cov_22.052006	759	839	0	80	80	1.0000000
NODE_2494_length_1445_cov_22.052006	812	892	0	80	80	1.0000000
NODE_2494_length_1445_cov_22.052006	888	968	0	80	80	1.0000000
NODE_2494_length_1445_cov_22.052006	941	1021	0	80	80	1.0000000
NODE_2495_length_1445_cov_13.378900	584	664	0	57	80	0.7125000
NODE_2495_length_1445_cov_13.378900	584	664	2	23	80	0.2875000
NODE_2495_length_1445_cov_13.378900	637	717	0	80	80	1.0000000
NODE_2501_length_1443_cov_7.628720	480	560	0	80	80	1.0000000
NODE_2501_length_1443_cov_7.628720	533	613	0	74	80	0.9250000
NODE_2501_length_1443_cov_7.628720	533	613	2	6	80	0.0750000
NODE_2501_length_1443_cov_7.628720	609	689	2	80	80	1.0000000
NODE_2501_length_1443_cov_7.628720	662	742	0	38	80	0.4750000
NODE_2501_length_1443_cov_7.628720	662	742	2	42	80	0.5250000
NODE_2502_length_1443_cov_4.843006	924	1004	0	80	80	1.0000000
NODE_2502_length_1443_cov_4.843006	977	1057	0	80	80	1.0000000
NODE_2508_length_1442_cov_24.551750	427	507	0	6	80	0.0750000
NODE_2508_length_1442_cov_24.551750	427	507	2	74	80	0.9250000
NODE_2508_length_1442_cov_24.551750	480	560	0	59	80	0.7375000
NODE_2508_length_1442_cov_24.551750	480	560	2	21	80	0.2625000
NODE_2508_length_1442_cov_24.551750	556	636	0	44	80	0.5500000
NODE_2508_length_1442_cov_24.551750	556	636	2	36	80	0.4500000
NODE_2508_length_1442_cov_24.551750	609	689	0	7	80	0.0875000
NODE_2508_length_1442_cov_24.551750	609	689	2	73	80	0.9125000
NODE_2509_length_1442_cov_24.032762	424	504	2	62	80	0.7750000
NODE_2509_length_1442_cov_24.032762	424	504	5	1	80	0.0125000
NODE_2509_length_1442_cov_24.032762	424	504	7	9	80	0.1125000
NODE_2509_length_1442_cov_24.032762	424	504	8	1	80	0.0125000
NODE_2509_length_1442_cov_24.032762	424	504	9	7	80	0.0875000
NODE_2509_length_1442_cov_24.032762	477	557	2	9	80	0.1125000
NODE_2509_length_1442_cov_24.032762	477	557	5	1	80	0.0125000
NODE_2509_length_1442_cov_24.032762	477	557	7	51	80	0.6375000
NODE_2509_length_1442_cov_24.032762	477	557	8	12	80	0.1500000
NODE_2509_length_1442_cov_24.032762	477	557	9	7	80	0.0875000
NODE_2511_length_1441_cov_16.528316	963	1043	4	47	80	0.5875000
NODE_2511_length_1441_cov_16.528316	963	1043	6	4	80	0.0500000
NODE_2511_length_1441_cov_16.528316	963	1043	8	29	80	0.3625000
NODE_2511_length_1441_cov_16.528316	1016	1096	6	5	80	0.0625000
NODE_2511_length_1441_cov_16.528316	1016	1096	8	27	80	0.3375000
NODE_2511_length_1441_cov_16.528316	1016	1096	10	37	80	0.4625000
NODE_2511_length_1441_cov_16.528316	1016	1096	12	11	80	0.1375000
NODE_2512_length_1441_cov_3.781669	80	156	0	76	76	1.0000000
NODE_2512_length_1441_cov_3.781669	129	209	0	80	80	1.0000000
NODE_2515_length_1440_cov_34.523490	446	526	0	80	80	1.0000000
NODE_2515_length_1440_cov_34.523490	499	576	0	77	77	1.0000000
NODE_2515_length_1440_cov_34.523490	576	654	0	40	78	0.5128205
NODE_2515_length_1440_cov_34.523490	576	654	4	7	78	0.0897436
NODE_2515_length_1440_cov_34.523490	576	654	6	15	78	0.1923077
NODE_2515_length_1440_cov_34.523490	576	654	8	16	78	0.2051282
NODE_2515_length_1440_cov_34.523490	627	707	6	20	80	0.2500000
NODE_2515_length_1440_cov_34.523490	627	707	8	60	80	0.7500000
NODE_2516_length_1440_cov_20.372110	776	856	0	80	80	1.0000000
NODE_2516_length_1440_cov_20.372110	829	909	0	80	80	1.0000000
NODE_2516_length_1440_cov_20.372110	905	985	0	80	80	1.0000000
NODE_2516_length_1440_cov_20.372110	958	1038	0	80	80	1.0000000
NODE_2517_length_1440_cov_14.476510	586	615	2	29	29	1.0000000
NODE_2517_length_1440_cov_14.476510	666	695	0	29	29	1.0000000
NODE_2517_length_1440_cov_14.476510	1295	1359	50	1	64	0.0156250
NODE_2517_length_1440_cov_14.476510	1295	1359	52	2	64	0.0312500
NODE_2517_length_1440_cov_14.476510	1295	1359	54	3	64	0.0468750
NODE_2517_length_1440_cov_14.476510	1295	1359	58	1	64	0.0156250
NODE_2517_length_1440_cov_14.476510	1295	1359	60	1	64	0.0156250
NODE_2517_length_1440_cov_14.476510	1295	1359	62	1	64	0.0156250
NODE_2517_length_1440_cov_14.476510	1295	1359	64	1	64	0.0156250
NODE_2517_length_1440_cov_14.476510	1295	1359	66	2	64	0.0312500
NODE_2517_length_1440_cov_14.476510	1295	1359	74	1	64	0.0156250
NODE_2517_length_1440_cov_14.476510	1295	1359	78	15	64	0.2343750
NODE_2517_length_1440_cov_14.476510	1295	1359	80	4	64	0.0625000
NODE_2517_length_1440_cov_14.476510	1295	1359	82	32	64	0.5000000
NODE_2518_length_1440_cov_9.049217	384	464	0	80	80	1.0000000
NODE_2518_length_1440_cov_9.049217	437	517	0	80	80	1.0000000
NODE_2520_length_1439_cov_11.784328	898	978	0	80	80	1.0000000
NODE_2520_length_1439_cov_11.784328	951	1031	0	80	80	1.0000000
NODE_2525_length_1438_cov_41.481703	671	751	0	80	80	1.0000000
NODE_2525_length_1438_cov_41.481703	724	804	0	80	80	1.0000000
NODE_2529_length_1437_cov_14.449178	815	895	0	7	80	0.0875000
NODE_2529_length_1437_cov_14.449178	815	895	2	73	80	0.9125000
NODE_2529_length_1437_cov_14.449178	868	948	2	80	80	1.0000000
NODE_2529_length_1437_cov_14.449178	944	1024	0	69	80	0.8625000
NODE_2529_length_1437_cov_14.449178	944	1024	2	11	80	0.1375000
NODE_2529_length_1437_cov_14.449178	997	1077	0	80	80	1.0000000
NODE_2532_length_1436_cov_96.256545	1145	1225	0	80	80	1.0000000
NODE_2532_length_1436_cov_96.256545	1198	1278	0	80	80	1.0000000
NODE_2532_length_1436_cov_96.256545	1274	1354	0	12	80	0.1500000
NODE_2532_length_1436_cov_96.256545	1274	1354	2	68	80	0.8500000
NODE_2532_length_1436_cov_96.256545	1327	1407	0	51	80	0.6375000
NODE_2532_length_1436_cov_96.256545	1327	1407	2	29	80	0.3625000
NODE_2536_length_1435_cov_21.468563	783	863	0	80	80	1.0000000
NODE_2536_length_1435_cov_21.468563	836	916	0	58	80	0.7250000
NODE_2536_length_1435_cov_21.468563	836	916	2	22	80	0.2750000
NODE_2536_length_1435_cov_21.468563	912	992	2	21	80	0.2625000
NODE_2536_length_1435_cov_21.468563	912	992	4	59	80	0.7375000
NODE_2536_length_1435_cov_21.468563	965	1045	0	1	80	0.0125000
NODE_2536_length_1435_cov_21.468563	965	1045	2	12	80	0.1500000
NODE_2536_length_1435_cov_21.468563	965	1045	4	67	80	0.8375000
NODE_2537_length_1435_cov_18.593563	1123	1203	0	3	80	0.0375000
NODE_2537_length_1435_cov_18.593563	1123	1203	2	7	80	0.0875000
NODE_2537_length_1435_cov_18.593563	1123	1203	4	31	80	0.3875000
NODE_2537_length_1435_cov_18.593563	1123	1203	6	14	80	0.1750000
NODE_2537_length_1435_cov_18.593563	1123	1203	8	6	80	0.0750000
NODE_2537_length_1435_cov_18.593563	1123	1203	10	3	80	0.0375000
NODE_2537_length_1435_cov_18.593563	1123	1203	12	3	80	0.0375000
NODE_2537_length_1435_cov_18.593563	1123	1203	14	13	80	0.1625000
NODE_2537_length_1435_cov_18.593563	1176	1256	0	55	80	0.6875000
NODE_2537_length_1435_cov_18.593563	1176	1256	2	8	80	0.1000000
NODE_2537_length_1435_cov_18.593563	1176	1256	4	17	80	0.2125000
NODE_2538_length_1435_cov_5.828593	299	379	0	80	80	1.0000000
NODE_2538_length_1435_cov_5.828593	352	432	0	80	80	1.0000000
NODE_2540_length_1434_cov_17.610487	1023	1103	0	80	80	1.0000000
NODE_2540_length_1434_cov_17.610487	1076	1156	0	80	80	1.0000000
NODE_2540_length_1434_cov_17.610487	1152	1232	0	80	80	1.0000000
NODE_2540_length_1434_cov_17.610487	1205	1285	0	80	80	1.0000000
NODE_2541_length_1434_cov_9.845693	846	926	0	4	80	0.0500000
NODE_2541_length_1434_cov_9.845693	846	926	2	22	80	0.2750000
NODE_2541_length_1434_cov_9.845693	846	926	12	3	80	0.0375000
NODE_2541_length_1434_cov_9.845693	846	926	14	4	80	0.0500000
NODE_2541_length_1434_cov_9.845693	846	926	15	40	80	0.5000000
NODE_2541_length_1434_cov_9.845693	846	926	17	6	80	0.0750000
NODE_2541_length_1434_cov_9.845693	846	926	19	1	80	0.0125000
NODE_2541_length_1434_cov_9.845693	899	978	6	11	79	0.1392405
NODE_2541_length_1434_cov_9.845693	899	978	15	24	79	0.3037975
NODE_2541_length_1434_cov_9.845693	899	978	17	43	79	0.5443038
NODE_2541_length_1434_cov_9.845693	899	978	19	1	79	0.0126582
NODE_2544_length_1433_cov_36.452774	538	618	0	80	80	1.0000000
NODE_2544_length_1433_cov_36.452774	591	671	0	41	80	0.5125000
NODE_2544_length_1433_cov_36.452774	591	671	1	6	80	0.0750000
NODE_2544_length_1433_cov_36.452774	591	671	3	15	80	0.1875000
NODE_2544_length_1433_cov_36.452774	591	671	5	18	80	0.2250000
NODE_2544_length_1433_cov_36.452774	667	747	3	4	80	0.0500000
NODE_2544_length_1433_cov_36.452774	667	747	5	51	80	0.6375000
NODE_2544_length_1433_cov_36.452774	667	747	7	25	80	0.3125000
NODE_2544_length_1433_cov_36.452774	720	800	1	9	80	0.1125000
NODE_2544_length_1433_cov_36.452774	720	800	3	13	80	0.1625000
NODE_2544_length_1433_cov_36.452774	720	800	4	35	80	0.4375000
NODE_2544_length_1433_cov_36.452774	720	800	5	10	80	0.1250000
NODE_2544_length_1433_cov_36.452774	720	800	7	13	80	0.1625000
NODE_2550_length_1431_cov_7.409159	513	593	0	6	80	0.0750000
NODE_2550_length_1431_cov_7.409159	513	593	2	51	80	0.6375000
NODE_2550_length_1431_cov_7.409159	513	593	3	23	80	0.2875000
NODE_2550_length_1431_cov_7.409159	566	646	0	59	80	0.7375000
NODE_2550_length_1431_cov_7.409159	566	646	2	21	80	0.2625000
NODE_2551_length_1431_cov_6.721471	1074	1154	0	80	80	1.0000000
NODE_2551_length_1431_cov_6.721471	1127	1207	0	80	80	1.0000000
NODE_2552_length_1430_cov_32.643877	753	833	0	61	80	0.7625000
NODE_2552_length_1430_cov_32.643877	753	833	2	19	80	0.2375000
NODE_2552_length_1430_cov_32.643877	806	886	0	13	80	0.1625000
NODE_2552_length_1430_cov_32.643877	806	886	2	67	80	0.8375000
NODE_2552_length_1430_cov_32.643877	882	962	0	44	80	0.5500000
NODE_2552_length_1430_cov_32.643877	882	962	2	36	80	0.4500000
NODE_2552_length_1430_cov_32.643877	935	1016	2	81	81	1.0000000
NODE_2557_length_1428_cov_5.895410	340	416	0	76	76	1.0000000
NODE_2557_length_1428_cov_5.895410	393	476	0	83	83	1.0000000
NODE_2560_length_1427_cov_38.919428	707	787	2	80	80	1.0000000
NODE_2560_length_1427_cov_38.919428	760	840	0	35	80	0.4375000
NODE_2560_length_1427_cov_38.919428	760	840	2	45	80	0.5625000
NODE_2560_length_1427_cov_38.919428	836	916	0	19	80	0.2375000
NODE_2560_length_1427_cov_38.919428	836	916	2	61	80	0.7625000
NODE_2560_length_1427_cov_38.919428	889	969	0	37	80	0.4625000
NODE_2560_length_1427_cov_38.919428	889	969	2	43	80	0.5375000
NODE_2561_length_1427_cov_19.442771	808	888	0	80	80	1.0000000
NODE_2561_length_1427_cov_19.442771	861	941	0	80	80	1.0000000
NODE_2561_length_1427_cov_19.442771	937	1017	0	11	80	0.1375000
NODE_2561_length_1427_cov_19.442771	937	1017	4	7	80	0.0875000
NODE_2561_length_1427_cov_19.442771	937	1017	6	62	80	0.7750000
NODE_2561_length_1427_cov_19.442771	990	1070	0	8	80	0.1000000
NODE_2561_length_1427_cov_19.442771	990	1070	2	17	80	0.2125000
NODE_2561_length_1427_cov_19.442771	990	1070	4	10	80	0.1250000
NODE_2561_length_1427_cov_19.442771	990	1070	6	45	80	0.5625000
NODE_2562_length_1427_cov_10.490964	728	808	0	80	80	1.0000000
NODE_2562_length_1427_cov_10.490964	781	861	0	80	80	1.0000000
NODE_2562_length_1427_cov_10.490964	857	937	0	80	80	1.0000000
NODE_2562_length_1427_cov_10.490964	910	990	0	80	80	1.0000000
NODE_2563_length_1427_cov_9.929217	646	726	0	80	80	1.0000000
NODE_2563_length_1427_cov_9.929217	699	779	0	80	80	1.0000000
NODE_2563_length_1427_cov_9.929217	775	855	0	80	80	1.0000000
NODE_2563_length_1427_cov_9.929217	828	908	0	80	80	1.0000000
NODE_2563_length_1427_cov_9.929217	1248	1324	0	76	76	1.0000000
NODE_2563_length_1427_cov_9.929217	1301	1376	0	75	75	1.0000000
NODE_2564_length_1427_cov_3.122741	1336	1399	0	63	63	1.0000000
NODE_2570_length_1426_cov_36.580256	422	502	0	80	80	1.0000000
NODE_2570_length_1426_cov_36.580256	475	555	0	80	80	1.0000000
NODE_2570_length_1426_cov_36.580256	551	631	0	33	80	0.4125000
NODE_2570_length_1426_cov_36.580256	551	631	2	47	80	0.5875000
NODE_2570_length_1426_cov_36.580256	604	684	0	7	80	0.0875000
NODE_2570_length_1426_cov_36.580256	604	684	2	73	80	0.9125000
NODE_2574_length_1425_cov_25.524133	561	641	4	2	80	0.0250000
NODE_2574_length_1425_cov_25.524133	561	641	6	78	80	0.9750000
NODE_2574_length_1425_cov_25.524133	614	694	2	21	80	0.2625000
NODE_2574_length_1425_cov_25.524133	614	694	4	34	80	0.4250000
NODE_2574_length_1425_cov_25.524133	614	694	6	25	80	0.3125000
NODE_2575_length_1425_cov_10.175716	361	441	2	80	80	1.0000000
NODE_2575_length_1425_cov_10.175716	414	494	1	2	80	0.0250000
NODE_2575_length_1425_cov_10.175716	414	494	2	58	80	0.7250000
NODE_2575_length_1425_cov_10.175716	414	494	3	20	80	0.2500000
NODE_2587_length_1423_cov_31.158610	862	942	4	80	80	1.0000000
NODE_2587_length_1423_cov_31.158610	915	995	0	45	80	0.5625000
NODE_2587_length_1423_cov_31.158610	915	995	4	35	80	0.4375000
NODE_2588_length_1423_cov_30.731873	764	844	0	80	80	1.0000000
NODE_2588_length_1423_cov_30.731873	817	897	0	31	80	0.3875000
NODE_2588_length_1423_cov_30.731873	817	897	2	49	80	0.6125000
NODE_2596_length_1421_cov_8.285930	136	212	48	2	76	0.0263158
NODE_2596_length_1421_cov_8.285930	136	212	50	5	76	0.0657895
NODE_2596_length_1421_cov_8.285930	136	212	52	10	76	0.1315790
NODE_2596_length_1421_cov_8.285930	136	212	53	9	76	0.1184211
NODE_2596_length_1421_cov_8.285930	136	212	58	1	76	0.0131579
NODE_2596_length_1421_cov_8.285930	136	212	60	2	76	0.0263158
NODE_2596_length_1421_cov_8.285930	136	212	64	1	76	0.0131579
NODE_2596_length_1421_cov_8.285930	136	212	66	1	76	0.0131579
NODE_2596_length_1421_cov_8.285930	136	212	68	1	76	0.0131579
NODE_2596_length_1421_cov_8.285930	136	212	70	6	76	0.0789474
NODE_2596_length_1421_cov_8.285930	136	212	72	2	76	0.0263158
NODE_2596_length_1421_cov_8.285930	136	212	74	2	76	0.0263158
NODE_2596_length_1421_cov_8.285930	136	212	76	1	76	0.0131579
NODE_2596_length_1421_cov_8.285930	136	212	78	1	76	0.0131579
NODE_2596_length_1421_cov_8.285930	136	212	80	4	76	0.0526316
NODE_2596_length_1421_cov_8.285930	136	212	90	4	76	0.0526316
NODE_2596_length_1421_cov_8.285930	136	212	92	8	76	0.1052632
NODE_2596_length_1421_cov_8.285930	136	212	94	5	76	0.0657895
NODE_2596_length_1421_cov_8.285930	136	212	96	4	76	0.0526316
NODE_2596_length_1421_cov_8.285930	136	212	100	6	76	0.0789474
NODE_2596_length_1421_cov_8.285930	136	212	102	1	76	0.0131579
NODE_2598_length_1421_cov_2.574130	22	102	0	80	80	1.0000000
NODE_2598_length_1421_cov_2.574130	75	132	0	57	57	1.0000000
NODE_2599_length_1420_cov_256.442846	60	140	0	6	80	0.0750000
NODE_2599_length_1420_cov_256.442846	60	140	2	74	80	0.9250000
NODE_2599_length_1420_cov_256.442846	1294	1360	4	6	66	0.0909091
NODE_2599_length_1420_cov_256.442846	1294	1360	6	7	66	0.1060606
NODE_2599_length_1420_cov_256.442846	1294	1360	8	53	66	0.8030303
NODE_2600_length_1420_cov_7.547313	628	708	0	80	80	1.0000000
NODE_2600_length_1420_cov_7.547313	681	761	0	80	80	1.0000000
NODE_2602_length_1420_cov_2.051476	972	1039	2	67	67	1.0000000
NODE_2604_length_1419_cov_46.997727	1230	1305	0	75	75	1.0000000
NODE_2604_length_1419_cov_46.997727	1278	1332	0	54	54	1.0000000
NODE_2609_length_1418_cov_11.373010	432	512	0	22	80	0.2750000
NODE_2609_length_1418_cov_11.373010	432	512	2	2	80	0.0250000
NODE_2609_length_1418_cov_11.373010	432	512	4	7	80	0.0875000
NODE_2609_length_1418_cov_11.373010	432	512	6	9	80	0.1125000
NODE_2609_length_1418_cov_11.373010	432	512	8	40	80	0.5000000
NODE_2609_length_1418_cov_11.373010	485	556	0	4	71	0.0563380
NODE_2609_length_1418_cov_11.373010	485	556	2	5	71	0.0704225
NODE_2609_length_1418_cov_11.373010	485	556	4	4	71	0.0563380
NODE_2609_length_1418_cov_11.373010	485	556	6	8	71	0.1126761
NODE_2609_length_1418_cov_11.373010	485	556	8	50	71	0.7042254
NODE_2615_length_1417_cov_12.477997	354	399	2	45	45	1.0000000
NODE_2616_length_1417_cov_11.120637	794	874	2	40	80	0.5000000
NODE_2616_length_1417_cov_11.120637	794	874	4	40	80	0.5000000
NODE_2616_length_1417_cov_11.120637	847	927	2	34	80	0.4250000
NODE_2616_length_1417_cov_11.120637	847	927	4	46	80	0.5750000
NODE_2625_length_1415_cov_51.375380	423	503	0	15	80	0.1875000
NODE_2625_length_1415_cov_51.375380	423	503	2	65	80	0.8125000
NODE_2625_length_1415_cov_51.375380	476	556	0	66	80	0.8250000
NODE_2625_length_1415_cov_51.375380	476	556	2	14	80	0.1750000
NODE_2625_length_1415_cov_51.375380	552	632	0	65	80	0.8125000
NODE_2625_length_1415_cov_51.375380	552	632	3	2	80	0.0250000
NODE_2625_length_1415_cov_51.375380	552	632	4	13	80	0.1625000
NODE_2625_length_1415_cov_51.375380	605	683	0	12	78	0.1538462
NODE_2625_length_1415_cov_51.375380	605	683	3	2	78	0.0256410
NODE_2625_length_1415_cov_51.375380	605	683	4	64	78	0.8205128
NODE_2626_length_1415_cov_38.272036	513	593	0	26	80	0.3250000
NODE_2626_length_1415_cov_38.272036	513	593	2	54	80	0.6750000
NODE_2626_length_1415_cov_38.272036	566	646	0	24	80	0.3000000
NODE_2626_length_1415_cov_38.272036	566	646	2	56	80	0.7000000
NODE_2627_length_1415_cov_17.232523	642	722	0	23	80	0.2875000
NODE_2627_length_1415_cov_17.232523	642	722	2	57	80	0.7125000
NODE_2627_length_1415_cov_17.232523	695	775	0	43	80	0.5375000
NODE_2627_length_1415_cov_17.232523	695	775	2	37	80	0.4625000
NODE_2629_length_1414_cov_5.307985	1026	1106	0	17	80	0.2125000
NODE_2629_length_1414_cov_5.307985	1026	1106	2	63	80	0.7875000
NODE_2629_length_1414_cov_5.307985	1079	1159	0	70	80	0.8750000
NODE_2629_length_1414_cov_5.307985	1079	1159	2	10	80	0.1250000
NODE_2637_length_1412_cov_17.723534	875	955	0	80	80	1.0000000
NODE_2637_length_1412_cov_17.723534	928	1008	0	80	80	1.0000000
NODE_2641_length_1411_cov_34.004573	516	596	0	80	80	1.0000000
NODE_2641_length_1411_cov_34.004573	569	649	0	80	80	1.0000000
NODE_2641_length_1411_cov_34.004573	645	725	0	59	80	0.7375000
NODE_2641_length_1411_cov_34.004573	645	725	2	21	80	0.2625000
NODE_2641_length_1411_cov_34.004573	698	778	0	6	80	0.0750000
NODE_2641_length_1411_cov_34.004573	698	778	2	50	80	0.6250000
NODE_2641_length_1411_cov_34.004573	698	778	4	15	80	0.1875000
NODE_2641_length_1411_cov_34.004573	698	778	6	9	80	0.1125000
NODE_2643_length_1409_cov_25.380153	828	908	0	8	80	0.1000000
NODE_2643_length_1409_cov_25.380153	828	908	2	51	80	0.6375000
NODE_2643_length_1409_cov_25.380153	828	908	4	6	80	0.0750000
NODE_2643_length_1409_cov_25.380153	828	908	6	15	80	0.1875000
NODE_2643_length_1409_cov_25.380153	881	961	2	9	80	0.1125000
NODE_2643_length_1409_cov_25.380153	881	961	4	19	80	0.2375000
NODE_2643_length_1409_cov_25.380153	881	961	6	52	80	0.6500000
NODE_2644_length_1409_cov_13.028244	349	405	4	50	56	0.8928571
NODE_2644_length_1409_cov_13.028244	349	405	6	6	56	0.1071429
NODE_2644_length_1409_cov_13.028244	416	482	0	66	66	1.0000000
NODE_2648_length_1408_cov_6.261268	492	572	0	80	80	1.0000000
NODE_2648_length_1408_cov_6.261268	545	625	0	80	80	1.0000000
NODE_2652_length_1407_cov_27.711009	772	852	0	1	80	0.0125000
NODE_2652_length_1407_cov_27.711009	772	852	2	43	80	0.5375000
NODE_2652_length_1407_cov_27.711009	772	852	4	36	80	0.4500000
NODE_2652_length_1407_cov_27.711009	825	905	0	2	80	0.0250000
NODE_2652_length_1407_cov_27.711009	825	905	2	24	80	0.3000000
NODE_2652_length_1407_cov_27.711009	825	905	4	54	80	0.6750000
NODE_2653_length_1407_cov_24.387615	586	666	0	54	80	0.6750000
NODE_2653_length_1407_cov_24.387615	586	666	2	26	80	0.3250000
NODE_2653_length_1407_cov_24.387615	639	719	0	1	80	0.0125000
NODE_2653_length_1407_cov_24.387615	639	719	2	79	80	0.9875000
NODE_2653_length_1407_cov_24.387615	715	795	2	14	80	0.1750000
NODE_2653_length_1407_cov_24.387615	715	795	4	2	80	0.0250000
NODE_2653_length_1407_cov_24.387615	715	795	10	29	80	0.3625000
NODE_2653_length_1407_cov_24.387615	715	795	12	35	80	0.4375000
NODE_2653_length_1407_cov_24.387615	768	848	2	15	80	0.1875000
NODE_2653_length_1407_cov_24.387615	768	848	4	6	80	0.0750000
NODE_2653_length_1407_cov_24.387615	768	848	6	12	80	0.1500000
NODE_2653_length_1407_cov_24.387615	768	848	10	15	80	0.1875000
NODE_2653_length_1407_cov_24.387615	768	848	12	32	80	0.4000000
NODE_2654_length_1407_cov_19.022936	551	629	4	5	78	0.0641026
NODE_2654_length_1407_cov_19.022936	551	629	8	16	78	0.2051282
NODE_2654_length_1407_cov_19.022936	551	629	10	35	78	0.4487180
NODE_2654_length_1407_cov_19.022936	551	629	12	22	78	0.2820513
NODE_2654_length_1407_cov_19.022936	602	665	0	12	63	0.1904762
NODE_2654_length_1407_cov_19.022936	602	665	2	7	63	0.1111111
NODE_2654_length_1407_cov_19.022936	602	665	4	22	63	0.3492064
NODE_2654_length_1407_cov_19.022936	602	665	8	10	63	0.1587302
NODE_2654_length_1407_cov_19.022936	602	665	10	12	63	0.1904762
NODE_2655_length_1407_cov_11.266820	813	893	0	80	80	1.0000000
NODE_2655_length_1407_cov_11.266820	866	946	0	41	80	0.5125000
NODE_2655_length_1407_cov_11.266820	866	946	2	39	80	0.4875000
NODE_2655_length_1407_cov_11.266820	942	1022	0	19	80	0.2375000
NODE_2655_length_1407_cov_11.266820	942	1022	2	61	80	0.7625000
NODE_2655_length_1407_cov_11.266820	995	1075	0	72	80	0.9000000
NODE_2655_length_1407_cov_11.266820	995	1075	2	8	80	0.1000000
NODE_2657_length_1406_cov_7.247896	761	841	0	80	80	1.0000000
NODE_2657_length_1406_cov_7.247896	814	894	0	80	80	1.0000000
NODE_2659_length_1404_cov_23.406130	826	906	0	27	80	0.3375000
NODE_2659_length_1404_cov_23.406130	826	906	2	53	80	0.6625000
NODE_2659_length_1404_cov_23.406130	879	959	0	15	80	0.1875000
NODE_2659_length_1404_cov_23.406130	879	959	2	65	80	0.8125000
NODE_2659_length_1404_cov_23.406130	955	1035	0	68	80	0.8500000
NODE_2659_length_1404_cov_23.406130	955	1035	2	12	80	0.1500000
NODE_2659_length_1404_cov_23.406130	1008	1088	0	15	80	0.1875000
NODE_2659_length_1404_cov_23.406130	1008	1088	2	65	80	0.8125000
NODE_2666_length_1403_cov_14.331288	325	405	0	80	80	1.0000000
NODE_2666_length_1403_cov_14.331288	378	458	0	80	80	1.0000000
NODE_2666_length_1403_cov_14.331288	454	534	0	49	80	0.6125000
NODE_2666_length_1403_cov_14.331288	454	534	2	31	80	0.3875000
NODE_2666_length_1403_cov_14.331288	454	534	0	49	80	0.6125000
NODE_2666_length_1403_cov_14.331288	454	534	2	31	80	0.3875000
NODE_2666_length_1403_cov_14.331288	454	524	0	49	70	0.7000000
NODE_2666_length_1403_cov_14.331288	454	524	2	21	70	0.3000000
NODE_2666_length_1403_cov_14.331288	507	587	2	80	80	1.0000000
NODE_2666_length_1403_cov_14.331288	507	579	2	72	72	1.0000000
NODE_2668_length_1402_cov_29.095165	610	690	0	80	80	1.0000000
NODE_2668_length_1402_cov_29.095165	663	743	0	80	80	1.0000000
NODE_2669_length_1402_cov_23.411358	528	608	0	13	80	0.1625000
NODE_2669_length_1402_cov_23.411358	528	608	2	67	80	0.8375000
NODE_2669_length_1402_cov_23.411358	581	661	0	31	80	0.3875000
NODE_2669_length_1402_cov_23.411358	581	661	2	49	80	0.6125000
NODE_2669_length_1402_cov_23.411358	657	737	0	4	80	0.0500000
NODE_2669_length_1402_cov_23.411358	657	737	2	35	80	0.4375000
NODE_2669_length_1402_cov_23.411358	657	737	4	41	80	0.5125000
NODE_2669_length_1402_cov_23.411358	710	790	0	48	80	0.6000000
NODE_2669_length_1402_cov_23.411358	710	790	2	22	80	0.2750000
NODE_2669_length_1402_cov_23.411358	710	790	4	10	80	0.1250000
NODE_2670_length_1402_cov_11.732924	661	741	2	80	80	1.0000000
NODE_2670_length_1402_cov_11.732924	714	794	0	44	80	0.5500000
NODE_2670_length_1402_cov_11.732924	714	794	2	36	80	0.4500000
NODE_2671_length_1402_cov_9.929394	766	846	0	80	80	1.0000000
NODE_2671_length_1402_cov_9.929394	819	899	0	80	80	1.0000000
NODE_2677_length_1401_cov_35.754992	825	905	0	37	80	0.4625000
NODE_2677_length_1401_cov_35.754992	825	905	2	43	80	0.5375000
NODE_2677_length_1401_cov_35.754992	878	958	2	79	80	0.9875000
NODE_2677_length_1401_cov_35.754992	878	958	4	1	80	0.0125000
NODE_2678_length_1401_cov_10.811828	539	619	0	80	80	1.0000000
NODE_2678_length_1401_cov_10.811828	592	672	0	80	80	1.0000000
NODE_2679_length_1401_cov_5.438556	241	321	0	34	80	0.4250000
NODE_2679_length_1401_cov_5.438556	241	321	2	16	80	0.2000000
NODE_2679_length_1401_cov_5.438556	241	321	4	30	80	0.3750000
NODE_2679_length_1401_cov_5.438556	294	374	4	80	80	1.0000000
NODE_2683_length_1400_cov_16.680246	813	893	0	80	80	1.0000000
NODE_2683_length_1400_cov_16.680246	866	946	0	80	80	1.0000000
NODE_2684_length_1400_cov_8.166795	53	133	2	80	80	1.0000000
NODE_2684_length_1400_cov_8.166795	106	186	0	41	80	0.5125000
NODE_2684_length_1400_cov_8.166795	106	186	2	39	80	0.4875000
NODE_2694_length_1397_cov_25.549307	869	918	11	11	49	0.2244898
NODE_2694_length_1397_cov_25.549307	869	918	13	5	49	0.1020408
NODE_2694_length_1397_cov_25.549307	869	918	15	24	49	0.4897959
NODE_2694_length_1397_cov_25.549307	869	918	17	7	49	0.1428571
NODE_2694_length_1397_cov_25.549307	869	918	18	2	49	0.0408163
NODE_2694_length_1397_cov_25.549307	891	971	12	9	80	0.1125000
NODE_2694_length_1397_cov_25.549307	891	971	14	22	80	0.2750000
NODE_2694_length_1397_cov_25.549307	891	971	15	18	80	0.2250000
NODE_2694_length_1397_cov_25.549307	891	971	16	9	80	0.1125000
NODE_2694_length_1397_cov_25.549307	891	971	17	8	80	0.1000000
NODE_2694_length_1397_cov_25.549307	891	971	18	14	80	0.1750000
NODE_2695_length_1397_cov_14.395223	672	752	0	10	80	0.1250000
NODE_2695_length_1397_cov_14.395223	672	752	2	70	80	0.8750000
NODE_2695_length_1397_cov_14.395223	725	805	0	13	80	0.1625000
NODE_2695_length_1397_cov_14.395223	725	805	2	67	80	0.8375000
NODE_2695_length_1397_cov_14.395223	801	881	0	80	80	1.0000000
NODE_2695_length_1397_cov_14.395223	854	934	0	80	80	1.0000000
NODE_2699_length_1396_cov_21.656130	825	905	0	11	80	0.1375000
NODE_2699_length_1396_cov_21.656130	825	905	2	69	80	0.8625000
NODE_2699_length_1396_cov_21.656130	878	958	0	64	80	0.8000000
NODE_2699_length_1396_cov_21.656130	878	958	2	16	80	0.2000000
NODE_2700_length_1396_cov_18.108712	560	640	0	36	80	0.4500000
NODE_2700_length_1396_cov_18.108712	560	640	4	44	80	0.5500000
NODE_2700_length_1396_cov_18.108712	613	693	0	3	80	0.0375000
NODE_2700_length_1396_cov_18.108712	613	693	4	77	80	0.9625000
NODE_2701_length_1396_cov_16.208944	136	198	0	1	62	0.0161290
NODE_2701_length_1396_cov_16.208944	136	198	4	33	62	0.5322581
NODE_2701_length_1396_cov_16.208944	136	198	6	7	62	0.1129032
NODE_2701_length_1396_cov_16.208944	136	198	8	21	62	0.3387097
NODE_2701_length_1396_cov_16.208944	848	928	2	1	80	0.0125000
NODE_2701_length_1396_cov_16.208944	848	928	4	79	80	0.9875000
NODE_2701_length_1396_cov_16.208944	901	981	2	54	80	0.6750000
NODE_2701_length_1396_cov_16.208944	901	981	4	26	80	0.3250000
NODE_2701_length_1396_cov_16.208944	977	1057	0	30	80	0.3750000
NODE_2701_length_1396_cov_16.208944	977	1057	2	50	80	0.6250000
NODE_2701_length_1396_cov_16.208944	1030	1110	2	80	80	1.0000000
NODE_2702_length_1396_cov_9.196608	428	508	2	80	80	1.0000000
NODE_2702_length_1396_cov_9.196608	481	561	0	45	80	0.5625000
NODE_2702_length_1396_cov_9.196608	481	561	2	35	80	0.4375000
NODE_2712_length_1394_cov_29.602317	349	415	0	66	66	1.0000000
NODE_2712_length_1394_cov_29.602317	349	416	0	67	67	1.0000000
NODE_2712_length_1394_cov_29.602317	1117	1197	0	1	80	0.0125000
NODE_2712_length_1394_cov_29.602317	1117	1197	4	38	80	0.4750000
NODE_2712_length_1394_cov_29.602317	1117	1197	6	14	80	0.1750000
NODE_2712_length_1394_cov_29.602317	1117	1197	8	14	80	0.1750000
NODE_2712_length_1394_cov_29.602317	1117	1197	10	13	80	0.1625000
NODE_2712_length_1394_cov_29.602317	1170	1250	2	6	80	0.0750000
NODE_2712_length_1394_cov_29.602317	1170	1250	4	1	80	0.0125000
NODE_2712_length_1394_cov_29.602317	1170	1250	6	34	80	0.4250000
NODE_2712_length_1394_cov_29.602317	1170	1250	8	14	80	0.1750000
NODE_2712_length_1394_cov_29.602317	1170	1250	10	25	80	0.3125000
NODE_2713_length_1394_cov_6.291892	313	393	0	17	80	0.2125000
NODE_2713_length_1394_cov_6.291892	313	393	5	1	80	0.0125000
NODE_2713_length_1394_cov_6.291892	313	393	6	21	80	0.2625000
NODE_2713_length_1394_cov_6.291892	313	393	8	38	80	0.4750000
NODE_2713_length_1394_cov_6.291892	313	393	10	3	80	0.0375000
NODE_2713_length_1394_cov_6.291892	366	446	8	24	80	0.3000000
NODE_2713_length_1394_cov_6.291892	366	446	9	21	80	0.2625000
NODE_2713_length_1394_cov_6.291892	366	446	10	35	80	0.4375000
NODE_2716_length_1393_cov_14.635240	1286	1339	4	1	53	0.0188679
NODE_2716_length_1393_cov_14.635240	1286	1339	6	1	53	0.0188679
NODE_2716_length_1393_cov_14.635240	1286	1339	8	2	53	0.0377358
NODE_2716_length_1393_cov_14.635240	1286	1339	10	49	53	0.9245283
NODE_2717_length_1393_cov_12.032457	737	817	4	80	80	1.0000000
NODE_2717_length_1393_cov_12.032457	790	870	0	48	80	0.6000000
NODE_2717_length_1393_cov_12.032457	790	870	4	32	80	0.4000000
NODE_2720_length_1392_cov_5.898685	270	350	0	80	80	1.0000000
NODE_2720_length_1392_cov_5.898685	323	399	0	76	76	1.0000000
NODE_2723_length_1391_cov_35.921827	415	495	0	63	80	0.7875000
NODE_2723_length_1391_cov_35.921827	415	495	2	17	80	0.2125000
NODE_2723_length_1391_cov_35.921827	468	548	0	10	80	0.1250000
NODE_2723_length_1391_cov_35.921827	468	548	2	70	80	0.8750000
NODE_2723_length_1391_cov_35.921827	544	624	0	34	80	0.4250000
NODE_2723_length_1391_cov_35.921827	544	624	2	46	80	0.5750000
NODE_2723_length_1391_cov_35.921827	597	677	0	5	80	0.0625000
NODE_2723_length_1391_cov_35.921827	597	677	2	75	80	0.9375000
NODE_2729_length_1390_cov_16.326878	550	630	0	33	80	0.4125000
NODE_2729_length_1390_cov_16.326878	550	630	1	20	80	0.2500000
NODE_2729_length_1390_cov_16.326878	550	630	3	24	80	0.3000000
NODE_2729_length_1390_cov_16.326878	550	630	4	3	80	0.0375000
NODE_2729_length_1390_cov_16.326878	603	683	3	24	80	0.3000000
NODE_2729_length_1390_cov_16.326878	603	683	4	56	80	0.7000000
NODE_2731_length_1389_cov_29.772093	780	860	0	3	80	0.0375000
NODE_2731_length_1389_cov_29.772093	780	860	2	58	80	0.7250000
NODE_2731_length_1389_cov_29.772093	780	860	4	19	80	0.2375000
NODE_2731_length_1389_cov_29.772093	833	913	0	56	80	0.7000000
NODE_2731_length_1389_cov_29.772093	833	913	2	24	80	0.3000000
NODE_2732_length_1389_cov_12.858140	821	901	0	27	80	0.3375000
NODE_2732_length_1389_cov_12.858140	821	901	2	20	80	0.2500000
NODE_2732_length_1389_cov_12.858140	821	901	4	33	80	0.4125000
NODE_2732_length_1389_cov_12.858140	874	954	2	37	80	0.4625000
NODE_2732_length_1389_cov_12.858140	874	954	4	43	80	0.5375000
NODE_2735_length_1388_cov_14.641583	529	610	0	81	81	1.0000000
NODE_2735_length_1388_cov_14.641583	583	660	0	77	77	1.0000000
NODE_2736_length_1388_cov_5.168348	427	499	26	19	72	0.2638889
NODE_2736_length_1388_cov_5.168348	427	499	30	5	72	0.0694444
NODE_2736_length_1388_cov_5.168348	427	499	32	6	72	0.0833333
NODE_2736_length_1388_cov_5.168348	427	499	34	3	72	0.0416667
NODE_2736_length_1388_cov_5.168348	427	499	36	2	72	0.0277778
NODE_2736_length_1388_cov_5.168348	427	499	38	2	72	0.0277778
NODE_2736_length_1388_cov_5.168348	427	499	41	1	72	0.0138889
NODE_2736_length_1388_cov_5.168348	427	499	42	1	72	0.0138889
NODE_2736_length_1388_cov_5.168348	427	499	44	14	72	0.1944444
NODE_2736_length_1388_cov_5.168348	427	499	45	3	72	0.0416667
NODE_2736_length_1388_cov_5.168348	427	499	46	2	72	0.0277778
NODE_2736_length_1388_cov_5.168348	427	499	48	14	72	0.1944444
NODE_2742_length_1386_cov_55.384615	559	639	0	12	80	0.1500000
NODE_2742_length_1386_cov_55.384615	559	639	10	6	80	0.0750000
NODE_2742_length_1386_cov_55.384615	559	639	12	19	80	0.2375000
NODE_2742_length_1386_cov_55.384615	559	639	14	43	80	0.5375000
NODE_2742_length_1386_cov_55.384615	612	692	10	7	80	0.0875000
NODE_2742_length_1386_cov_55.384615	612	692	12	18	80	0.2250000
NODE_2742_length_1386_cov_55.384615	612	692	13	1	80	0.0125000
NODE_2742_length_1386_cov_55.384615	612	692	14	54	80	0.6750000
NODE_2742_length_1386_cov_55.384615	688	768	0	46	80	0.5750000
NODE_2742_length_1386_cov_55.384615	688	768	2	12	80	0.1500000
NODE_2742_length_1386_cov_55.384615	688	768	9	1	80	0.0125000
NODE_2742_length_1386_cov_55.384615	688	768	10	21	80	0.2625000
NODE_2742_length_1386_cov_55.384615	741	821	0	15	80	0.1875000
NODE_2742_length_1386_cov_55.384615	741	821	2	65	80	0.8125000
NODE_2744_length_1386_cov_13.181041	549	629	0	80	80	1.0000000
NODE_2744_length_1386_cov_13.181041	602	682	0	80	80	1.0000000
NODE_2748_length_1385_cov_41.636081	968	1048	2	29	80	0.3625000
NODE_2748_length_1385_cov_41.636081	968	1048	7	10	80	0.1250000
NODE_2748_length_1385_cov_41.636081	968	1048	8	28	80	0.3500000
NODE_2748_length_1385_cov_41.636081	968	1048	9	13	80	0.1625000
NODE_2748_length_1385_cov_41.636081	1021	1101	2	25	80	0.3125000
NODE_2748_length_1385_cov_41.636081	1021	1101	7	9	80	0.1125000
NODE_2748_length_1385_cov_41.636081	1021	1101	8	28	80	0.3500000
NODE_2748_length_1385_cov_41.636081	1021	1101	9	18	80	0.2250000
NODE_2749_length_1385_cov_38.877138	707	787	0	3	80	0.0375000
NODE_2749_length_1385_cov_38.877138	707	787	2	16	80	0.2000000
NODE_2749_length_1385_cov_38.877138	707	787	4	15	80	0.1875000
NODE_2749_length_1385_cov_38.877138	707	787	6	23	80	0.2875000
NODE_2749_length_1385_cov_38.877138	707	787	8	12	80	0.1500000
NODE_2749_length_1385_cov_38.877138	707	787	10	11	80	0.1375000
NODE_2749_length_1385_cov_38.877138	760	840	2	5	80	0.0625000
NODE_2749_length_1385_cov_38.877138	760	840	4	31	80	0.3875000
NODE_2749_length_1385_cov_38.877138	760	840	6	5	80	0.0625000
NODE_2749_length_1385_cov_38.877138	760	840	8	28	80	0.3500000
NODE_2749_length_1385_cov_38.877138	760	840	10	11	80	0.1375000
NODE_2749_length_1385_cov_38.877138	836	916	2	8	80	0.1000000
NODE_2749_length_1385_cov_38.877138	836	916	4	4	80	0.0500000
NODE_2749_length_1385_cov_38.877138	836	916	6	66	80	0.8250000
NODE_2749_length_1385_cov_38.877138	836	916	8	2	80	0.0250000
NODE_2749_length_1385_cov_38.877138	889	969	0	9	80	0.1125000
NODE_2749_length_1385_cov_38.877138	889	969	2	16	80	0.2000000
NODE_2749_length_1385_cov_38.877138	889	969	4	4	80	0.0500000
NODE_2749_length_1385_cov_38.877138	889	969	6	51	80	0.6375000
NODE_2751_length_1385_cov_4.608865	844	904	0	60	60	1.0000000
NODE_2758_length_1384_cov_10.574319	865	922	0	57	57	1.0000000
NODE_2758_length_1384_cov_10.574319	933	1013	0	80	80	1.0000000
NODE_2758_length_1384_cov_10.574319	986	1066	0	80	80	1.0000000
NODE_2759_length_1383_cov_10.710280	414	493	2	19	79	0.2405063
NODE_2759_length_1383_cov_10.710280	414	493	4	27	79	0.3417721
NODE_2759_length_1383_cov_10.710280	414	493	6	33	79	0.4177215
NODE_2759_length_1383_cov_10.710280	466	546	0	17	80	0.2125000
NODE_2759_length_1383_cov_10.710280	466	546	2	55	80	0.6875000
NODE_2759_length_1383_cov_10.710280	466	546	6	8	80	0.1000000
NODE_2763_length_1382_cov_12.521434	837	917	0	68	80	0.8500000
NODE_2763_length_1382_cov_12.521434	837	917	2	12	80	0.1500000
NODE_2763_length_1382_cov_12.521434	890	970	0	80	80	1.0000000
NODE_2764_length_1382_cov_5.074045	1028	1108	0	80	80	1.0000000
NODE_2764_length_1382_cov_5.074045	1081	1161	0	80	80	1.0000000
NODE_2771_length_1381_cov_7.796412	307	387	2	49	80	0.6125000
NODE_2771_length_1381_cov_7.796412	307	387	4	31	80	0.3875000
NODE_2771_length_1381_cov_7.796412	360	440	2	46	80	0.5750000
NODE_2771_length_1381_cov_7.796412	360	440	4	34	80	0.4250000
NODE_2775_length_1380_cov_12.804059	835	915	4	74	80	0.9250000
NODE_2775_length_1380_cov_12.804059	835	915	5	6	80	0.0750000
NODE_2775_length_1380_cov_12.804059	888	968	1	51	80	0.6375000
NODE_2775_length_1380_cov_12.804059	888	968	4	21	80	0.2625000
NODE_2775_length_1380_cov_12.804059	888	968	5	8	80	0.1000000
NODE_2782_length_1378_cov_25.362002	368	448	0	35	80	0.4375000
NODE_2782_length_1378_cov_25.362002	368	448	2	45	80	0.5625000
NODE_2782_length_1378_cov_25.362002	421	501	0	80	80	1.0000000
NODE_2782_length_1378_cov_25.362002	497	577	0	70	80	0.8750000
NODE_2782_length_1378_cov_25.362002	497	577	4	10	80	0.1250000
NODE_2782_length_1378_cov_25.362002	550	630	0	17	80	0.2125000
NODE_2782_length_1378_cov_25.362002	550	630	4	63	80	0.7875000
NODE_2783_length_1378_cov_20.508210	318	338	13	2	20	0.1000000
NODE_2783_length_1378_cov_20.508210	318	338	15	2	20	0.1000000
NODE_2783_length_1378_cov_20.508210	318	338	17	7	20	0.3500000
NODE_2783_length_1378_cov_20.508210	318	338	19	1	20	0.0500000
NODE_2783_length_1378_cov_20.508210	318	338	21	1	20	0.0500000
NODE_2783_length_1378_cov_20.508210	318	338	23	7	20	0.3500000
NODE_2783_length_1378_cov_20.508210	318	391	13	2	73	0.0273973
NODE_2783_length_1378_cov_20.508210	318	391	15	2	73	0.0273973
NODE_2783_length_1378_cov_20.508210	318	391	17	7	73	0.0958904
NODE_2783_length_1378_cov_20.508210	318	391	19	1	73	0.0136986
NODE_2783_length_1378_cov_20.508210	318	391	21	1	73	0.0136986
NODE_2783_length_1378_cov_20.508210	318	391	23	14	73	0.1917808
NODE_2783_length_1378_cov_20.508210	318	391	25	18	73	0.2465753
NODE_2783_length_1378_cov_20.508210	318	391	27	12	73	0.1643836
NODE_2783_length_1378_cov_20.508210	318	391	29	7	73	0.0958904
NODE_2783_length_1378_cov_20.508210	318	391	31	8	73	0.1095890
NODE_2783_length_1378_cov_20.508210	318	391	33	1	73	0.0136986
NODE_2785_length_1377_cov_103.832551	1259	1299	76	1	40	0.0250000
NODE_2785_length_1377_cov_103.832551	1259	1299	80	6	40	0.1500000
NODE_2785_length_1377_cov_103.832551	1259	1299	84	3	40	0.0750000
NODE_2785_length_1377_cov_103.832551	1259	1299	86	1	40	0.0250000
NODE_2785_length_1377_cov_103.832551	1259	1299	88	1	40	0.0250000
NODE_2785_length_1377_cov_103.832551	1259	1299	90	1	40	0.0250000
NODE_2785_length_1377_cov_103.832551	1259	1299	92	1	40	0.0250000
NODE_2785_length_1377_cov_103.832551	1259	1299	94	6	40	0.1500000
NODE_2785_length_1377_cov_103.832551	1259	1299	96	1	40	0.0250000
NODE_2785_length_1377_cov_103.832551	1259	1299	98	2	40	0.0500000
NODE_2785_length_1377_cov_103.832551	1259	1299	100	1	40	0.0250000
NODE_2785_length_1377_cov_103.832551	1259	1299	102	1	40	0.0250000
NODE_2785_length_1377_cov_103.832551	1259	1299	104	4	40	0.1000000
NODE_2785_length_1377_cov_103.832551	1259	1299	108	1	40	0.0250000
NODE_2785_length_1377_cov_103.832551	1259	1299	112	2	40	0.0500000
NODE_2785_length_1377_cov_103.832551	1259	1299	114	2	40	0.0500000
NODE_2785_length_1377_cov_103.832551	1259	1299	116	6	40	0.1500000
NODE_2788_length_1376_cov_7.967110	904	984	0	80	80	1.0000000
NODE_2788_length_1376_cov_7.967110	957	1037	0	80	80	1.0000000
NODE_2798_length_1373_cov_52.691523	524	606	0	4	82	0.0487805
NODE_2798_length_1373_cov_52.691523	524	606	2	30	82	0.3658537
NODE_2798_length_1373_cov_52.691523	524	606	6	4	82	0.0487805
NODE_2798_length_1373_cov_52.691523	524	606	8	30	82	0.3658537
NODE_2798_length_1373_cov_52.691523	524	606	9	2	82	0.0243902
NODE_2798_length_1373_cov_52.691523	524	606	10	12	82	0.1463415
NODE_2798_length_1373_cov_52.691523	579	659	6	57	80	0.7125000
NODE_2798_length_1373_cov_52.691523	579	659	8	9	80	0.1125000
NODE_2798_length_1373_cov_52.691523	579	659	9	2	80	0.0250000
NODE_2798_length_1373_cov_52.691523	579	659	10	12	80	0.1500000
NODE_2799_length_1373_cov_20.880691	987	1067	4	29	80	0.3625000
NODE_2799_length_1373_cov_20.880691	987	1067	6	51	80	0.6375000
NODE_2799_length_1373_cov_20.880691	1116	1195	4	30	79	0.3797468
NODE_2799_length_1373_cov_20.880691	1116	1195	6	22	79	0.2784810
NODE_2799_length_1373_cov_20.880691	1116	1195	8	17	79	0.2151899
NODE_2799_length_1373_cov_20.880691	1116	1195	10	3	79	0.0379747
NODE_2799_length_1373_cov_20.880691	1116	1195	12	7	79	0.0886076
NODE_2799_length_1373_cov_20.880691	1168	1248	4	3	80	0.0375000
NODE_2799_length_1373_cov_20.880691	1168	1248	6	1	80	0.0125000
NODE_2799_length_1373_cov_20.880691	1168	1248	8	37	80	0.4625000
NODE_2799_length_1373_cov_20.880691	1168	1248	10	10	80	0.1250000
NODE_2799_length_1373_cov_20.880691	1168	1248	12	29	80	0.3625000
NODE_2800_length_1373_cov_12.694662	94	167	10	6	73	0.0821918
NODE_2800_length_1373_cov_12.694662	94	167	12	13	73	0.1780822
NODE_2800_length_1373_cov_12.694662	94	167	14	6	73	0.0821918
NODE_2800_length_1373_cov_12.694662	94	167	16	7	73	0.0958904
NODE_2800_length_1373_cov_12.694662	94	167	18	7	73	0.0958904
NODE_2800_length_1373_cov_12.694662	94	167	20	4	73	0.0547945
NODE_2800_length_1373_cov_12.694662	94	167	21	1	73	0.0136986
NODE_2800_length_1373_cov_12.694662	94	167	22	2	73	0.0273973
NODE_2800_length_1373_cov_12.694662	94	167	23	2	73	0.0273973
NODE_2800_length_1373_cov_12.694662	94	167	25	3	73	0.0410959
NODE_2800_length_1373_cov_12.694662	94	167	26	1	73	0.0136986
NODE_2800_length_1373_cov_12.694662	94	167	30	4	73	0.0547945
NODE_2800_length_1373_cov_12.694662	94	167	32	1	73	0.0136986
NODE_2800_length_1373_cov_12.694662	94	167	36	1	73	0.0136986
NODE_2800_length_1373_cov_12.694662	94	167	40	1	73	0.0136986
NODE_2800_length_1373_cov_12.694662	94	167	44	1	73	0.0136986
NODE_2800_length_1373_cov_12.694662	94	167	46	4	73	0.0547945
NODE_2800_length_1373_cov_12.694662	94	167	50	1	73	0.0136986
NODE_2800_length_1373_cov_12.694662	94	167	52	3	73	0.0410959
NODE_2800_length_1373_cov_12.694662	94	167	54	5	73	0.0684932
NODE_2800_length_1373_cov_12.694662	140	224	23	2	84	0.0238095
NODE_2800_length_1373_cov_12.694662	140	224	25	3	84	0.0357143
NODE_2800_length_1373_cov_12.694662	140	224	26	1	84	0.0119048
NODE_2800_length_1373_cov_12.694662	140	224	30	4	84	0.0476190
NODE_2800_length_1373_cov_12.694662	140	224	32	1	84	0.0119048
NODE_2800_length_1373_cov_12.694662	140	224	36	1	84	0.0119048
NODE_2800_length_1373_cov_12.694662	140	224	40	1	84	0.0119048
NODE_2800_length_1373_cov_12.694662	140	224	44	1	84	0.0119048
NODE_2800_length_1373_cov_12.694662	140	224	46	4	84	0.0476190
NODE_2800_length_1373_cov_12.694662	140	224	50	1	84	0.0119048
NODE_2800_length_1373_cov_12.694662	140	224	52	4	84	0.0476190
NODE_2800_length_1373_cov_12.694662	140	224	54	7	84	0.0833333
NODE_2800_length_1373_cov_12.694662	140	224	57	1	84	0.0119048
NODE_2800_length_1373_cov_12.694662	140	224	59	1	84	0.0119048
NODE_2800_length_1373_cov_12.694662	140	224	61	11	84	0.1309524
NODE_2800_length_1373_cov_12.694662	140	224	63	2	84	0.0238095
NODE_2800_length_1373_cov_12.694662	140	224	65	3	84	0.0357143
NODE_2800_length_1373_cov_12.694662	140	224	69	4	84	0.0476190
NODE_2800_length_1373_cov_12.694662	140	224	70	2	84	0.0238095
NODE_2800_length_1373_cov_12.694662	140	224	71	5	84	0.0595238
NODE_2800_length_1373_cov_12.694662	140	224	72	20	84	0.2380952
NODE_2800_length_1373_cov_12.694662	140	224	73	1	84	0.0119048
NODE_2800_length_1373_cov_12.694662	140	224	74	4	84	0.0476190
NODE_2800_length_1373_cov_12.694662	1214	1286	0	72	72	1.0000000
NODE_2800_length_1373_cov_12.694662	1267	1339	0	72	72	1.0000000
NODE_2801_length_1372_cov_25.408484	665	745	2	25	80	0.3125000
NODE_2801_length_1372_cov_25.408484	665	745	4	55	80	0.6875000
NODE_2801_length_1372_cov_25.408484	718	798	0	41	80	0.5125000
NODE_2801_length_1372_cov_25.408484	718	798	2	10	80	0.1250000
NODE_2801_length_1372_cov_25.408484	718	798	4	29	80	0.3625000
NODE_2802_length_1372_cov_17.123331	647	727	0	80	80	1.0000000
NODE_2802_length_1372_cov_17.123331	700	780	0	80	80	1.0000000
NODE_2802_length_1372_cov_17.123331	776	856	0	80	80	1.0000000
NODE_2802_length_1372_cov_17.123331	829	909	0	80	80	1.0000000
NODE_2803_length_1372_cov_14.418696	211	291	0	31	80	0.3875000
NODE_2803_length_1372_cov_14.418696	211	291	2	16	80	0.2000000
NODE_2803_length_1372_cov_14.418696	211	291	4	33	80	0.4125000
NODE_2803_length_1372_cov_14.418696	264	344	0	12	80	0.1500000
NODE_2803_length_1372_cov_14.418696	264	344	2	15	80	0.1875000
NODE_2803_length_1372_cov_14.418696	264	344	4	53	80	0.6625000
NODE_2806_length_1371_cov_39.366352	715	795	2	4	80	0.0500000
NODE_2806_length_1371_cov_39.366352	715	795	4	6	80	0.0750000
NODE_2806_length_1371_cov_39.366352	715	795	6	5	80	0.0625000
NODE_2806_length_1371_cov_39.366352	715	795	8	33	80	0.4125000
NODE_2806_length_1371_cov_39.366352	715	795	10	4	80	0.0500000
NODE_2806_length_1371_cov_39.366352	715	795	14	10	80	0.1250000
NODE_2806_length_1371_cov_39.366352	715	795	16	18	80	0.2250000
NODE_2806_length_1371_cov_39.366352	768	848	14	9	80	0.1125000
NODE_2806_length_1371_cov_39.366352	768	848	16	34	80	0.4250000
NODE_2806_length_1371_cov_39.366352	768	848	18	18	80	0.2250000
NODE_2806_length_1371_cov_39.366352	768	848	20	19	80	0.2375000
NODE_2807_length_1371_cov_36.961478	371	455	1	39	84	0.4642857
NODE_2807_length_1371_cov_36.961478	371	455	3	45	84	0.5357143
NODE_2807_length_1371_cov_36.961478	424	508	1	62	84	0.7380952
NODE_2807_length_1371_cov_36.961478	424	508	2	22	84	0.2619048
NODE_2807_length_1371_cov_36.961478	504	584	1	75	80	0.9375000
NODE_2807_length_1371_cov_36.961478	504	584	2	5	80	0.0625000
NODE_2807_length_1371_cov_36.961478	557	637	0	1	80	0.0125000
NODE_2807_length_1371_cov_36.961478	557	637	1	79	80	0.9875000
NODE_2808_length_1371_cov_16.944182	459	539	0	80	80	1.0000000
NODE_2808_length_1371_cov_16.944182	512	592	0	80	80	1.0000000
NODE_2808_length_1371_cov_16.944182	588	668	0	60	80	0.7500000
NODE_2808_length_1371_cov_16.944182	588	668	2	20	80	0.2500000
NODE_2808_length_1371_cov_16.944182	641	721	0	7	80	0.0875000
NODE_2808_length_1371_cov_16.944182	641	721	2	73	80	0.9125000
NODE_2812_length_1370_cov_11.627065	502	582	0	41	80	0.5125000
NODE_2812_length_1370_cov_11.627065	502	582	2	39	80	0.4875000
NODE_2812_length_1370_cov_11.627065	555	635	0	5	80	0.0625000
NODE_2812_length_1370_cov_11.627065	555	635	2	75	80	0.9375000
NODE_2812_length_1370_cov_11.627065	631	711	0	80	80	1.0000000
NODE_2812_length_1370_cov_11.627065	684	764	0	80	80	1.0000000
NODE_2813_length_1369_cov_27.937795	597	677	0	10	80	0.1250000
NODE_2813_length_1369_cov_27.937795	597	677	2	70	80	0.8750000
NODE_2813_length_1369_cov_27.937795	650	730	2	73	80	0.9125000
NODE_2813_length_1369_cov_27.937795	650	730	4	7	80	0.0875000
NODE_2820_length_1368_cov_35.148148	546	626	0	12	80	0.1500000
NODE_2820_length_1368_cov_35.148148	546	626	3	27	80	0.3375000
NODE_2820_length_1368_cov_35.148148	546	626	4	41	80	0.5125000
NODE_2820_length_1368_cov_35.148148	599	679	0	57	80	0.7125000
NODE_2820_length_1368_cov_35.148148	599	679	2	8	80	0.1000000
NODE_2820_length_1368_cov_35.148148	599	679	3	15	80	0.1875000
NODE_2821_length_1368_cov_27.847912	486	559	0	73	73	1.0000000
NODE_2821_length_1368_cov_27.847912	532	612	0	80	80	1.0000000
NODE_2821_length_1368_cov_27.847912	608	688	0	80	80	1.0000000
NODE_2821_length_1368_cov_27.847912	661	741	0	80	80	1.0000000
NODE_2822_length_1368_cov_26.832151	458	538	0	80	80	1.0000000
NODE_2822_length_1368_cov_26.832151	511	591	0	76	80	0.9500000
NODE_2822_length_1368_cov_26.832151	511	591	2	4	80	0.0500000
NODE_2822_length_1368_cov_26.832151	587	667	2	4	80	0.0500000
NODE_2822_length_1368_cov_26.832151	587	667	6	76	80	0.9500000
NODE_2822_length_1368_cov_26.832151	640	720	0	37	80	0.4625000
NODE_2822_length_1368_cov_26.832151	640	720	4	2	80	0.0250000
NODE_2822_length_1368_cov_26.832151	640	720	6	41	80	0.5125000
NODE_2823_length_1368_cov_18.205674	603	683	2	80	80	1.0000000
NODE_2823_length_1368_cov_18.205674	656	736	0	48	80	0.6000000
NODE_2823_length_1368_cov_18.205674	656	736	2	32	80	0.4000000
NODE_2826_length_1367_cov_576.769716	799	879	69	1	80	0.0125000
NODE_2826_length_1367_cov_576.769716	799	879	70	1	80	0.0125000
NODE_2826_length_1367_cov_576.769716	799	879	71	1	80	0.0125000
NODE_2826_length_1367_cov_576.769716	799	879	72	5	80	0.0625000
NODE_2826_length_1367_cov_576.769716	799	879	73	4	80	0.0500000
NODE_2826_length_1367_cov_576.769716	799	879	74	1	80	0.0125000
NODE_2826_length_1367_cov_576.769716	799	879	75	1	80	0.0125000
NODE_2826_length_1367_cov_576.769716	799	879	76	8	80	0.1000000
NODE_2826_length_1367_cov_576.769716	799	879	77	3	80	0.0375000
NODE_2826_length_1367_cov_576.769716	799	879	82	3	80	0.0375000
NODE_2826_length_1367_cov_576.769716	799	879	85	1	80	0.0125000
NODE_2826_length_1367_cov_576.769716	799	879	87	2	80	0.0250000
NODE_2826_length_1367_cov_576.769716	799	879	88	2	80	0.0250000
NODE_2826_length_1367_cov_576.769716	799	879	93	1	80	0.0125000
NODE_2826_length_1367_cov_576.769716	799	879	95	1	80	0.0125000
NODE_2826_length_1367_cov_576.769716	799	879	98	1	80	0.0125000
NODE_2826_length_1367_cov_576.769716	799	879	99	1	80	0.0125000
NODE_2826_length_1367_cov_576.769716	799	879	103	1	80	0.0125000
NODE_2826_length_1367_cov_576.769716	799	879	104	1	80	0.0125000
NODE_2826_length_1367_cov_576.769716	799	879	106	2	80	0.0250000
NODE_2826_length_1367_cov_576.769716	799	879	107	1	80	0.0125000
NODE_2826_length_1367_cov_576.769716	799	879	110	2	80	0.0250000
NODE_2826_length_1367_cov_576.769716	799	879	111	2	80	0.0250000
NODE_2826_length_1367_cov_576.769716	799	879	115	1	80	0.0125000
NODE_2826_length_1367_cov_576.769716	799	879	117	1	80	0.0125000
NODE_2826_length_1367_cov_576.769716	799	879	119	3	80	0.0375000
NODE_2826_length_1367_cov_576.769716	799	879	121	3	80	0.0375000
NODE_2826_length_1367_cov_576.769716	799	879	134	1	80	0.0125000
NODE_2826_length_1367_cov_576.769716	799	879	162	1	80	0.0125000
NODE_2826_length_1367_cov_576.769716	799	879	174	3	80	0.0375000
NODE_2826_length_1367_cov_576.769716	799	879	179	1	80	0.0125000
NODE_2826_length_1367_cov_576.769716	799	879	183	1	80	0.0125000
NODE_2826_length_1367_cov_576.769716	799	879	201	1	80	0.0125000
NODE_2826_length_1367_cov_576.769716	799	879	208	2	80	0.0250000
NODE_2826_length_1367_cov_576.769716	799	879	214	1	80	0.0125000
NODE_2826_length_1367_cov_576.769716	799	879	222	1	80	0.0125000
NODE_2826_length_1367_cov_576.769716	799	879	223	1	80	0.0125000
NODE_2826_length_1367_cov_576.769716	799	879	234	1	80	0.0125000
NODE_2826_length_1367_cov_576.769716	799	879	249	1	80	0.0125000
NODE_2826_length_1367_cov_576.769716	799	879	259	1	80	0.0125000
NODE_2826_length_1367_cov_576.769716	799	879	266	2	80	0.0250000
NODE_2826_length_1367_cov_576.769716	799	879	267	1	80	0.0125000
NODE_2826_length_1367_cov_576.769716	799	879	269	1	80	0.0125000
NODE_2826_length_1367_cov_576.769716	799	879	270	5	80	0.0625000
NODE_2826_length_1367_cov_576.769716	799	879	271	1	80	0.0125000
NODE_2826_length_1367_cov_576.769716	852	932	110	1	80	0.0125000
NODE_2826_length_1367_cov_576.769716	852	932	134	1	80	0.0125000
NODE_2826_length_1367_cov_576.769716	852	932	162	1	80	0.0125000
NODE_2826_length_1367_cov_576.769716	852	932	174	3	80	0.0375000
NODE_2826_length_1367_cov_576.769716	852	932	179	1	80	0.0125000
NODE_2826_length_1367_cov_576.769716	852	932	183	1	80	0.0125000
NODE_2826_length_1367_cov_576.769716	852	932	201	1	80	0.0125000
NODE_2826_length_1367_cov_576.769716	852	932	208	2	80	0.0250000
NODE_2826_length_1367_cov_576.769716	852	932	214	1	80	0.0125000
NODE_2826_length_1367_cov_576.769716	852	932	222	1	80	0.0125000
NODE_2826_length_1367_cov_576.769716	852	932	223	1	80	0.0125000
NODE_2826_length_1367_cov_576.769716	852	932	234	1	80	0.0125000
NODE_2826_length_1367_cov_576.769716	852	932	249	1	80	0.0125000
NODE_2826_length_1367_cov_576.769716	852	932	259	1	80	0.0125000
NODE_2826_length_1367_cov_576.769716	852	932	266	2	80	0.0250000
NODE_2826_length_1367_cov_576.769716	852	932	267	1	80	0.0125000
NODE_2826_length_1367_cov_576.769716	852	932	269	1	80	0.0125000
NODE_2826_length_1367_cov_576.769716	852	932	270	6	80	0.0750000
NODE_2826_length_1367_cov_576.769716	852	932	271	2	80	0.0250000
NODE_2826_length_1367_cov_576.769716	852	932	279	2	80	0.0250000
NODE_2826_length_1367_cov_576.769716	852	932	281	1	80	0.0125000
NODE_2826_length_1367_cov_576.769716	852	932	287	1	80	0.0125000
NODE_2826_length_1367_cov_576.769716	852	932	289	1	80	0.0125000
NODE_2826_length_1367_cov_576.769716	852	932	302	1	80	0.0125000
NODE_2826_length_1367_cov_576.769716	852	932	309	1	80	0.0125000
NODE_2826_length_1367_cov_576.769716	852	932	326	2	80	0.0250000
NODE_2826_length_1367_cov_576.769716	852	932	328	1	80	0.0125000
NODE_2826_length_1367_cov_576.769716	852	932	334	1	80	0.0125000
NODE_2826_length_1367_cov_576.769716	852	932	344	2	80	0.0250000
NODE_2826_length_1367_cov_576.769716	852	932	345	1	80	0.0125000
NODE_2826_length_1367_cov_576.769716	852	932	347	4	80	0.0500000
NODE_2826_length_1367_cov_576.769716	852	932	348	10	80	0.1250000
NODE_2826_length_1367_cov_576.769716	852	932	350	3	80	0.0375000
NODE_2826_length_1367_cov_576.769716	852	932	351	2	80	0.0250000
NODE_2826_length_1367_cov_576.769716	852	932	353	2	80	0.0250000
NODE_2826_length_1367_cov_576.769716	852	932	354	11	80	0.1375000
NODE_2826_length_1367_cov_576.769716	852	932	355	4	80	0.0500000
NODE_2826_length_1367_cov_576.769716	852	932	356	1	80	0.0125000
NODE_2826_length_1367_cov_576.769716	900	980	263	1	80	0.0125000
NODE_2826_length_1367_cov_576.769716	900	980	279	1	80	0.0125000
NODE_2826_length_1367_cov_576.769716	900	980	283	1	80	0.0125000
NODE_2826_length_1367_cov_576.769716	900	980	289	2	80	0.0250000
NODE_2826_length_1367_cov_576.769716	900	980	291	3	80	0.0375000
NODE_2826_length_1367_cov_576.769716	900	980	292	1	80	0.0125000
NODE_2826_length_1367_cov_576.769716	900	980	294	1	80	0.0125000
NODE_2826_length_1367_cov_576.769716	900	980	295	2	80	0.0250000
NODE_2826_length_1367_cov_576.769716	900	980	296	2	80	0.0250000
NODE_2826_length_1367_cov_576.769716	900	980	297	1	80	0.0125000
NODE_2826_length_1367_cov_576.769716	900	980	298	4	80	0.0500000
NODE_2826_length_1367_cov_576.769716	900	980	301	1	80	0.0125000
NODE_2826_length_1367_cov_576.769716	900	980	302	1	80	0.0125000
NODE_2826_length_1367_cov_576.769716	900	980	304	2	80	0.0250000
NODE_2826_length_1367_cov_576.769716	900	980	306	1	80	0.0125000
NODE_2826_length_1367_cov_576.769716	900	980	308	2	80	0.0250000
NODE_2826_length_1367_cov_576.769716	900	980	310	1	80	0.0125000
NODE_2826_length_1367_cov_576.769716	900	980	316	1	80	0.0125000
NODE_2826_length_1367_cov_576.769716	900	980	320	2	80	0.0250000
NODE_2826_length_1367_cov_576.769716	900	980	321	4	80	0.0500000
NODE_2826_length_1367_cov_576.769716	900	980	325	2	80	0.0250000
NODE_2826_length_1367_cov_576.769716	900	980	329	3	80	0.0375000
NODE_2826_length_1367_cov_576.769716	900	980	333	1	80	0.0125000
NODE_2826_length_1367_cov_576.769716	900	980	334	1	80	0.0125000
NODE_2826_length_1367_cov_576.769716	900	980	340	1	80	0.0125000
NODE_2826_length_1367_cov_576.769716	900	980	341	3	80	0.0375000
NODE_2826_length_1367_cov_576.769716	900	980	344	4	80	0.0500000
NODE_2826_length_1367_cov_576.769716	900	980	345	1	80	0.0125000
NODE_2826_length_1367_cov_576.769716	900	980	347	1	80	0.0125000
NODE_2826_length_1367_cov_576.769716	900	980	348	6	80	0.0750000
NODE_2826_length_1367_cov_576.769716	900	980	350	3	80	0.0375000
NODE_2826_length_1367_cov_576.769716	900	980	351	2	80	0.0250000
NODE_2826_length_1367_cov_576.769716	900	980	353	2	80	0.0250000
NODE_2826_length_1367_cov_576.769716	900	980	354	11	80	0.1375000
NODE_2826_length_1367_cov_576.769716	900	980	355	4	80	0.0500000
NODE_2826_length_1367_cov_576.769716	900	980	356	1	80	0.0125000
NODE_2826_length_1367_cov_576.769716	905	927	348	1	22	0.0454545
NODE_2826_length_1367_cov_576.769716	905	927	350	3	22	0.1363636
NODE_2826_length_1367_cov_576.769716	905	927	353	2	22	0.0909091
NODE_2826_length_1367_cov_576.769716	905	927	354	11	22	0.5000000
NODE_2826_length_1367_cov_576.769716	905	927	355	4	22	0.1818182
NODE_2826_length_1367_cov_576.769716	905	927	356	1	22	0.0454545
NODE_2826_length_1367_cov_576.769716	1051	1131	22	2	80	0.0250000
NODE_2826_length_1367_cov_576.769716	1051	1131	24	2	80	0.0250000
NODE_2826_length_1367_cov_576.769716	1051	1131	26	3	80	0.0375000
NODE_2826_length_1367_cov_576.769716	1051	1131	28	14	80	0.1750000
NODE_2826_length_1367_cov_576.769716	1051	1131	29	6	80	0.0750000
NODE_2826_length_1367_cov_576.769716	1051	1131	30	1	80	0.0125000
NODE_2826_length_1367_cov_576.769716	1051	1131	36	6	80	0.0750000
NODE_2826_length_1367_cov_576.769716	1051	1131	37	1	80	0.0125000
NODE_2826_length_1367_cov_576.769716	1051	1131	38	1	80	0.0125000
NODE_2826_length_1367_cov_576.769716	1051	1131	40	2	80	0.0250000
NODE_2826_length_1367_cov_576.769716	1051	1131	42	6	80	0.0750000
NODE_2826_length_1367_cov_576.769716	1051	1131	47	2	80	0.0250000
NODE_2826_length_1367_cov_576.769716	1051	1131	49	2	80	0.0250000
NODE_2826_length_1367_cov_576.769716	1051	1131	50	5	80	0.0625000
NODE_2826_length_1367_cov_576.769716	1051	1131	51	1	80	0.0125000
NODE_2826_length_1367_cov_576.769716	1051	1131	52	3	80	0.0375000
NODE_2826_length_1367_cov_576.769716	1051	1131	53	4	80	0.0500000
NODE_2826_length_1367_cov_576.769716	1051	1131	54	3	80	0.0375000
NODE_2826_length_1367_cov_576.769716	1051	1131	55	3	80	0.0375000
NODE_2826_length_1367_cov_576.769716	1051	1131	57	1	80	0.0125000
NODE_2826_length_1367_cov_576.769716	1051	1131	58	1	80	0.0125000
NODE_2826_length_1367_cov_576.769716	1051	1131	59	1	80	0.0125000
NODE_2826_length_1367_cov_576.769716	1051	1131	62	1	80	0.0125000
NODE_2826_length_1367_cov_576.769716	1051	1131	63	5	80	0.0625000
NODE_2826_length_1367_cov_576.769716	1051	1131	65	2	80	0.0250000
NODE_2826_length_1367_cov_576.769716	1051	1131	67	2	80	0.0250000
NODE_2826_length_1367_cov_576.769716	1104	1184	50	2	80	0.0250000
NODE_2826_length_1367_cov_576.769716	1104	1184	52	2	80	0.0250000
NODE_2826_length_1367_cov_576.769716	1104	1184	53	4	80	0.0500000
NODE_2826_length_1367_cov_576.769716	1104	1184	54	3	80	0.0375000
NODE_2826_length_1367_cov_576.769716	1104	1184	55	3	80	0.0375000
NODE_2826_length_1367_cov_576.769716	1104	1184	57	1	80	0.0125000
NODE_2826_length_1367_cov_576.769716	1104	1184	58	1	80	0.0125000
NODE_2826_length_1367_cov_576.769716	1104	1184	59	1	80	0.0125000
NODE_2826_length_1367_cov_576.769716	1104	1184	62	1	80	0.0125000
NODE_2826_length_1367_cov_576.769716	1104	1184	63	5	80	0.0625000
NODE_2826_length_1367_cov_576.769716	1104	1184	65	2	80	0.0250000
NODE_2826_length_1367_cov_576.769716	1104	1184	67	2	80	0.0250000
NODE_2826_length_1367_cov_576.769716	1104	1184	68	2	80	0.0250000
NODE_2826_length_1367_cov_576.769716	1104	1184	69	1	80	0.0125000
NODE_2826_length_1367_cov_576.769716	1104	1184	70	3	80	0.0375000
NODE_2826_length_1367_cov_576.769716	1104	1184	73	5	80	0.0625000
NODE_2826_length_1367_cov_576.769716	1104	1184	74	2	80	0.0250000
NODE_2826_length_1367_cov_576.769716	1104	1184	76	3	80	0.0375000
NODE_2826_length_1367_cov_576.769716	1104	1184	77	2	80	0.0250000
NODE_2826_length_1367_cov_576.769716	1104	1184	79	3	80	0.0375000
NODE_2826_length_1367_cov_576.769716	1104	1184	81	1	80	0.0125000
NODE_2826_length_1367_cov_576.769716	1104	1184	83	1	80	0.0125000
NODE_2826_length_1367_cov_576.769716	1104	1184	85	4	80	0.0500000
NODE_2826_length_1367_cov_576.769716	1104	1184	87	7	80	0.0875000
NODE_2826_length_1367_cov_576.769716	1104	1184	89	4	80	0.0500000
NODE_2826_length_1367_cov_576.769716	1104	1184	91	6	80	0.0750000
NODE_2826_length_1367_cov_576.769716	1104	1184	92	2	80	0.0250000
NODE_2826_length_1367_cov_576.769716	1104	1184	95	1	80	0.0125000
NODE_2826_length_1367_cov_576.769716	1104	1184	99	1	80	0.0125000
NODE_2826_length_1367_cov_576.769716	1104	1184	101	1	80	0.0125000
NODE_2826_length_1367_cov_576.769716	1104	1184	105	1	80	0.0125000
NODE_2826_length_1367_cov_576.769716	1104	1184	106	3	80	0.0375000
NODE_2827_length_1367_cov_152.824921	513	593	6	46	80	0.5750000
NODE_2827_length_1367_cov_152.824921	513	593	8	34	80	0.4250000
NODE_2827_length_1367_cov_152.824921	566	646	0	6	80	0.0750000
NODE_2827_length_1367_cov_152.824921	566	646	2	37	80	0.4625000
NODE_2827_length_1367_cov_152.824921	566	646	6	15	80	0.1875000
NODE_2827_length_1367_cov_152.824921	566	646	8	22	80	0.2750000
NODE_2827_length_1367_cov_152.824921	642	722	0	12	80	0.1500000
NODE_2827_length_1367_cov_152.824921	642	722	4	8	80	0.1000000
NODE_2827_length_1367_cov_152.824921	642	722	6	29	80	0.3625000
NODE_2827_length_1367_cov_152.824921	642	722	8	16	80	0.2000000
NODE_2827_length_1367_cov_152.824921	642	722	10	2	80	0.0250000
NODE_2827_length_1367_cov_152.824921	642	722	12	13	80	0.1625000
NODE_2827_length_1367_cov_152.824921	695	775	2	1	80	0.0125000
NODE_2827_length_1367_cov_152.824921	695	775	4	19	80	0.2375000
NODE_2827_length_1367_cov_152.824921	695	775	6	20	80	0.2500000
NODE_2827_length_1367_cov_152.824921	695	775	8	12	80	0.1500000
NODE_2827_length_1367_cov_152.824921	695	775	10	7	80	0.0875000
NODE_2827_length_1367_cov_152.824921	695	775	12	21	80	0.2625000
NODE_2829_length_1367_cov_2.947161	250	326	4	64	76	0.8421053
NODE_2829_length_1367_cov_2.947161	250	326	6	2	76	0.0263158
NODE_2829_length_1367_cov_2.947161	250	326	8	10	76	0.1315790
NODE_2831_length_1366_cov_82.742699	198	278	2	9	80	0.1125000
NODE_2831_length_1366_cov_82.742699	198	278	6	24	80	0.3000000
NODE_2831_length_1366_cov_82.742699	198	278	7	18	80	0.2250000
NODE_2831_length_1366_cov_82.742699	198	278	8	29	80	0.3625000
NODE_2831_length_1366_cov_82.742699	251	331	6	24	80	0.3000000
NODE_2831_length_1366_cov_82.742699	251	331	7	2	80	0.0250000
NODE_2831_length_1366_cov_82.742699	251	331	8	54	80	0.6750000
NODE_2832_length_1366_cov_36.659037	577	657	2	80	80	1.0000000
NODE_2832_length_1366_cov_36.659037	630	710	0	11	80	0.1375000
NODE_2832_length_1366_cov_36.659037	630	710	1	10	80	0.1250000
NODE_2832_length_1366_cov_36.659037	630	710	2	59	80	0.7375000
NODE_2834_length_1366_cov_2.320442	47	116	2	5	69	0.0724638
NODE_2834_length_1366_cov_2.320442	47	116	4	3	69	0.0434783
NODE_2834_length_1366_cov_2.320442	47	116	8	2	69	0.0289855
NODE_2834_length_1366_cov_2.320442	47	116	10	59	69	0.8550724
NODE_2834_length_1366_cov_2.320442	1122	1202	0	10	80	0.1250000
NODE_2834_length_1366_cov_2.320442	1122	1202	1	7	80	0.0875000
NODE_2834_length_1366_cov_2.320442	1122	1202	2	56	80	0.7000000
NODE_2834_length_1366_cov_2.320442	1122	1202	4	7	80	0.0875000
NODE_2834_length_1366_cov_2.320442	1175	1255	2	32	80	0.4000000
NODE_2834_length_1366_cov_2.320442	1175	1255	4	1	80	0.0125000
NODE_2834_length_1366_cov_2.320442	1175	1255	8	3	80	0.0375000
NODE_2834_length_1366_cov_2.320442	1175	1255	12	3	80	0.0375000
NODE_2834_length_1366_cov_2.320442	1175	1255	14	2	80	0.0250000
NODE_2834_length_1366_cov_2.320442	1175	1255	16	4	80	0.0500000
NODE_2834_length_1366_cov_2.320442	1175	1255	18	2	80	0.0250000
NODE_2834_length_1366_cov_2.320442	1175	1255	22	3	80	0.0375000
NODE_2834_length_1366_cov_2.320442	1175	1255	24	4	80	0.0500000
NODE_2834_length_1366_cov_2.320442	1175	1255	28	5	80	0.0625000
NODE_2834_length_1366_cov_2.320442	1175	1255	30	11	80	0.1375000
NODE_2834_length_1366_cov_2.320442	1175	1255	32	4	80	0.0500000
NODE_2834_length_1366_cov_2.320442	1175	1255	34	2	80	0.0250000
NODE_2834_length_1366_cov_2.320442	1175	1255	40	4	80	0.0500000
NODE_2834_length_1366_cov_2.320442	1251	1331	34	6	80	0.0750000
NODE_2834_length_1366_cov_2.320442	1251	1331	36	1	80	0.0125000
NODE_2834_length_1366_cov_2.320442	1251	1331	39	2	80	0.0250000
NODE_2834_length_1366_cov_2.320442	1251	1331	40	4	80	0.0500000
NODE_2834_length_1366_cov_2.320442	1251	1331	41	4	80	0.0500000
NODE_2834_length_1366_cov_2.320442	1251	1331	42	6	80	0.0750000
NODE_2834_length_1366_cov_2.320442	1251	1331	43	1	80	0.0125000
NODE_2834_length_1366_cov_2.320442	1251	1331	44	4	80	0.0500000
NODE_2834_length_1366_cov_2.320442	1251	1331	46	13	80	0.1625000
NODE_2834_length_1366_cov_2.320442	1251	1331	48	1	80	0.0125000
NODE_2834_length_1366_cov_2.320442	1251	1331	50	38	80	0.4750000
NODE_2835_length_1365_cov_25.540284	432	509	0	10	77	0.1298701
NODE_2835_length_1365_cov_25.540284	432	509	4	44	77	0.5714286
NODE_2835_length_1365_cov_25.540284	432	509	6	5	77	0.0649351
NODE_2835_length_1365_cov_25.540284	432	509	8	18	77	0.2337662
NODE_2835_length_1365_cov_25.540284	482	562	4	20	80	0.2500000
NODE_2835_length_1365_cov_25.540284	482	562	6	5	80	0.0625000
NODE_2835_length_1365_cov_25.540284	482	562	8	55	80	0.6875000
NODE_2835_length_1365_cov_25.540284	558	635	0	39	77	0.5064935
NODE_2835_length_1365_cov_25.540284	558	635	2	33	77	0.4285714
NODE_2835_length_1365_cov_25.540284	558	635	4	5	77	0.0649351
NODE_2835_length_1365_cov_25.540284	625	688	0	63	63	1.0000000
NODE_2838_length_1364_cov_15.222134	120	191	12	13	71	0.1830986
NODE_2838_length_1364_cov_15.222134	120	191	14	4	71	0.0563380
NODE_2838_length_1364_cov_15.222134	120	191	15	9	71	0.1267606
NODE_2838_length_1364_cov_15.222134	120	191	16	9	71	0.1267606
NODE_2838_length_1364_cov_15.222134	120	191	17	3	71	0.0422535
NODE_2838_length_1364_cov_15.222134	120	191	18	1	71	0.0140845
NODE_2838_length_1364_cov_15.222134	120	191	19	5	71	0.0704225
NODE_2838_length_1364_cov_15.222134	120	191	22	3	71	0.0422535
NODE_2838_length_1364_cov_15.222134	120	191	24	4	71	0.0563380
NODE_2838_length_1364_cov_15.222134	120	191	26	4	71	0.0563380
NODE_2838_length_1364_cov_15.222134	120	191	30	1	71	0.0140845
NODE_2838_length_1364_cov_15.222134	120	191	36	4	71	0.0563380
NODE_2838_length_1364_cov_15.222134	120	191	38	3	71	0.0422535
NODE_2838_length_1364_cov_15.222134	120	191	42	1	71	0.0140845
NODE_2838_length_1364_cov_15.222134	120	191	46	2	71	0.0281690
NODE_2838_length_1364_cov_15.222134	120	191	48	2	71	0.0281690
NODE_2838_length_1364_cov_15.222134	120	191	52	1	71	0.0140845
NODE_2838_length_1364_cov_15.222134	120	191	54	1	71	0.0140845
NODE_2838_length_1364_cov_15.222134	120	191	56	1	71	0.0140845
NODE_2839_length_1364_cov_7.456917	843	923	0	25	80	0.3125000
NODE_2839_length_1364_cov_7.456917	843	923	4	3	80	0.0375000
NODE_2839_length_1364_cov_7.456917	843	923	8	52	80	0.6500000
NODE_2839_length_1364_cov_7.456917	896	976	0	16	80	0.2000000
NODE_2839_length_1364_cov_7.456917	896	976	4	1	80	0.0125000
NODE_2839_length_1364_cov_7.456917	896	976	8	63	80	0.7875000
NODE_2840_length_1364_cov_5.055336	239	290	0	51	51	1.0000000
NODE_2840_length_1364_cov_5.055336	263	343	0	80	80	1.0000000
NODE_2846_length_1363_cov_19.442247	615	695	2	80	80	1.0000000
NODE_2846_length_1363_cov_19.442247	668	748	0	28	80	0.3500000
NODE_2846_length_1363_cov_19.442247	668	748	2	52	80	0.6500000
NODE_2847_length_1363_cov_13.575949	619	699	0	80	80	1.0000000
NODE_2847_length_1363_cov_13.575949	672	752	0	80	80	1.0000000
NODE_2850_length_1362_cov_15.796516	898	978	0	80	80	1.0000000
NODE_2850_length_1362_cov_15.796516	951	1031	0	80	80	1.0000000
NODE_2855_length_1361_cov_24.574485	528	608	0	46	80	0.5750000
NODE_2855_length_1361_cov_24.574485	528	608	2	34	80	0.4250000
NODE_2855_length_1361_cov_24.574485	581	661	0	9	80	0.1125000
NODE_2855_length_1361_cov_24.574485	581	661	2	71	80	0.8875000
NODE_2856_length_1361_cov_20.148970	866	946	0	80	80	1.0000000
NODE_2856_length_1361_cov_20.148970	919	999	0	80	80	1.0000000
NODE_2858_length_1361_cov_10.530903	1139	1219	2	4	80	0.0500000
NODE_2858_length_1361_cov_10.530903	1139	1219	4	8	80	0.1000000
NODE_2858_length_1361_cov_10.530903	1139	1219	6	60	80	0.7500000
NODE_2858_length_1361_cov_10.530903	1139	1219	8	8	80	0.1000000
NODE_2858_length_1361_cov_10.530903	1139	1219	2	4	80	0.0500000
NODE_2858_length_1361_cov_10.530903	1139	1219	4	8	80	0.1000000
NODE_2858_length_1361_cov_10.530903	1139	1219	6	60	80	0.7500000
NODE_2858_length_1361_cov_10.530903	1139	1219	8	8	80	0.1000000
NODE_2858_length_1361_cov_10.530903	1192	1277	0	47	85	0.5529412
NODE_2858_length_1361_cov_10.530903	1192	1277	2	15	85	0.1764706
NODE_2858_length_1361_cov_10.530903	1192	1277	4	8	85	0.0941176
NODE_2858_length_1361_cov_10.530903	1192	1277	6	15	85	0.1764706
NODE_2858_length_1361_cov_10.530903	1273	1353	0	80	80	1.0000000
NODE_2858_length_1361_cov_10.530903	1273	1353	0	80	80	1.0000000
NODE_2858_length_1361_cov_10.530903	1273	1353	0	80	80	1.0000000
NODE_2858_length_1361_cov_10.530903	1273	1353	0	80	80	1.0000000
NODE_2858_length_1361_cov_10.530903	1273	1353	0	80	80	1.0000000
NODE_2858_length_1361_cov_10.530903	1273	1353	0	80	80	1.0000000
NODE_2859_length_1360_cov_42.789056	351	431	2	12	80	0.1500000
NODE_2859_length_1360_cov_42.789056	351	431	4	50	80	0.6250000
NODE_2859_length_1360_cov_42.789056	351	431	6	18	80	0.2250000
NODE_2859_length_1360_cov_42.789056	404	484	1	1	80	0.0125000
NODE_2859_length_1360_cov_42.789056	404	484	2	3	80	0.0375000
NODE_2859_length_1360_cov_42.789056	404	484	4	18	80	0.2250000
NODE_2859_length_1360_cov_42.789056	404	484	6	58	80	0.7250000
NODE_2860_length_1360_cov_26.407613	531	611	0	9	80	0.1125000
NODE_2860_length_1360_cov_26.407613	531	611	2	12	80	0.1500000
NODE_2860_length_1360_cov_26.407613	531	611	6	59	80	0.7375000
NODE_2860_length_1360_cov_26.407613	584	669	4	12	85	0.1411765
NODE_2860_length_1360_cov_26.407613	584	669	6	73	85	0.8588235
NODE_2861_length_1360_cov_16.182395	796	876	2	80	80	1.0000000
NODE_2861_length_1360_cov_16.182395	849	929	2	60	80	0.7500000
NODE_2861_length_1360_cov_16.182395	849	929	4	20	80	0.2500000
NODE_2861_length_1360_cov_16.182395	925	1005	0	42	80	0.5250000
NODE_2861_length_1360_cov_16.182395	925	1005	2	38	80	0.4750000
NODE_2861_length_1360_cov_16.182395	978	1058	0	80	80	1.0000000
NODE_2862_length_1360_cov_12.763680	582	662	0	80	80	1.0000000
NODE_2862_length_1360_cov_12.763680	635	715	0	80	80	1.0000000
NODE_2866_length_1359_cov_41.324603	674	754	0	80	80	1.0000000
NODE_2866_length_1359_cov_41.324603	727	807	0	80	80	1.0000000
NODE_2866_length_1359_cov_41.324603	803	883	0	4	80	0.0500000
NODE_2866_length_1359_cov_41.324603	803	883	2	8	80	0.1000000
NODE_2866_length_1359_cov_41.324603	803	883	4	68	80	0.8500000
NODE_2866_length_1359_cov_41.324603	856	936	0	43	80	0.5375000
NODE_2866_length_1359_cov_41.324603	856	936	2	6	80	0.0750000
NODE_2866_length_1359_cov_41.324603	856	936	4	31	80	0.3875000
NODE_2871_length_1358_cov_23.427323	292	372	0	43	80	0.5375000
NODE_2871_length_1358_cov_23.427323	292	372	2	29	80	0.3625000
NODE_2871_length_1358_cov_23.427323	292	372	4	8	80	0.1000000
NODE_2871_length_1358_cov_23.427323	345	425	2	19	80	0.2375000
NODE_2871_length_1358_cov_23.427323	345	425	4	61	80	0.7625000
NODE_2872_length_1358_cov_19.489277	411	491	0	22	80	0.2750000
NODE_2872_length_1358_cov_19.489277	411	491	2	58	80	0.7250000
NODE_2872_length_1358_cov_19.489277	464	544	0	16	80	0.2000000
NODE_2872_length_1358_cov_19.489277	464	544	2	64	80	0.8000000
NODE_2875_length_1357_cov_15.962639	732	812	0	80	80	1.0000000
NODE_2875_length_1357_cov_15.962639	785	865	0	80	80	1.0000000
NODE_2879_length_1354_cov_9.854980	735	815	0	63	80	0.7875000
NODE_2879_length_1354_cov_9.854980	735	815	2	17	80	0.2125000
NODE_2879_length_1354_cov_9.854980	788	868	0	10	80	0.1250000
NODE_2879_length_1354_cov_9.854980	788	868	2	70	80	0.8750000
NODE_2882_length_1353_cov_32.982456	708	788	0	20	80	0.2500000
NODE_2882_length_1353_cov_32.982456	708	788	2	12	80	0.1500000
NODE_2882_length_1353_cov_32.982456	708	788	6	48	80	0.6000000
NODE_2882_length_1353_cov_32.982456	761	841	0	26	80	0.3250000
NODE_2882_length_1353_cov_32.982456	761	841	2	16	80	0.2000000
NODE_2882_length_1353_cov_32.982456	761	841	6	38	80	0.4750000
NODE_2883_length_1353_cov_21.775120	493	573	0	22	80	0.2750000
NODE_2883_length_1353_cov_21.775120	493	573	1	2	80	0.0250000
NODE_2883_length_1353_cov_21.775120	493	573	2	56	80	0.7000000
NODE_2883_length_1353_cov_21.775120	546	626	2	80	80	1.0000000
NODE_2884_length_1353_cov_18.201754	696	776	2	31	80	0.3875000
NODE_2884_length_1353_cov_18.201754	696	776	4	49	80	0.6125000
NODE_2884_length_1353_cov_18.201754	749	829	0	42	80	0.5250000
NODE_2884_length_1353_cov_18.201754	749	829	2	25	80	0.3125000
NODE_2884_length_1353_cov_18.201754	749	829	4	13	80	0.1625000
NODE_2888_length_1352_cov_26.942538	455	535	2	8	80	0.1000000
NODE_2888_length_1352_cov_26.942538	455	535	4	48	80	0.6000000
NODE_2888_length_1352_cov_26.942538	455	535	6	24	80	0.3000000
NODE_2888_length_1352_cov_26.942538	508	588	0	8	80	0.1000000
NODE_2888_length_1352_cov_26.942538	508	588	2	5	80	0.0625000
NODE_2888_length_1352_cov_26.942538	508	588	4	23	80	0.2875000
NODE_2888_length_1352_cov_26.942538	508	588	6	44	80	0.5500000
NODE_2889_length_1352_cov_17.189944	717	797	0	22	80	0.2750000
NODE_2889_length_1352_cov_17.189944	717	797	4	58	80	0.7250000
NODE_2889_length_1352_cov_17.189944	770	850	0	24	80	0.3000000
NODE_2889_length_1352_cov_17.189944	770	850	4	56	80	0.7000000
NODE_2890_length_1352_cov_15.752594	640	720	0	80	80	1.0000000
NODE_2890_length_1352_cov_15.752594	693	773	0	80	80	1.0000000
NODE_2891_length_1352_cov_10.699920	237	317	0	49	80	0.6125000
NODE_2891_length_1352_cov_10.699920	237	317	2	31	80	0.3875000
NODE_2891_length_1352_cov_10.699920	290	370	0	80	80	1.0000000
NODE_2894_length_1351_cov_32.325879	561	641	0	22	80	0.2750000
NODE_2894_length_1351_cov_32.325879	561	641	2	30	80	0.3750000
NODE_2894_length_1351_cov_32.325879	561	641	4	28	80	0.3500000
NODE_2894_length_1351_cov_32.325879	614	694	0	11	80	0.1375000
NODE_2894_length_1351_cov_32.325879	614	694	2	21	80	0.2625000
NODE_2894_length_1351_cov_32.325879	614	694	4	48	80	0.6000000
NODE_2895_length_1351_cov_16.861022	97	162	4	3	65	0.0461538
NODE_2895_length_1351_cov_16.861022	97	162	6	11	65	0.1692308
NODE_2895_length_1351_cov_16.861022	97	162	8	51	65	0.7846154
NODE_2896_length_1351_cov_9.894569	331	411	0	43	80	0.5375000
NODE_2896_length_1351_cov_9.894569	331	411	2	28	80	0.3500000
NODE_2896_length_1351_cov_9.894569	331	411	4	9	80	0.1125000
NODE_2896_length_1351_cov_9.894569	384	464	2	18	80	0.2250000
NODE_2896_length_1351_cov_9.894569	384	464	4	62	80	0.7750000
NODE_2897_length_1351_cov_8.699681	1055	1137	0	1	82	0.0121951
NODE_2897_length_1351_cov_8.699681	1055	1137	2	74	82	0.9024390
NODE_2897_length_1351_cov_8.699681	1055	1137	4	7	82	0.0853659
NODE_2897_length_1351_cov_8.699681	1110	1175	0	22	65	0.3384615
NODE_2897_length_1351_cov_8.699681	1110	1175	2	43	65	0.6615385
NODE_2898_length_1351_cov_2.931310	68	148	28	5	80	0.0625000
NODE_2898_length_1351_cov_2.931310	68	148	30	12	80	0.1500000
NODE_2898_length_1351_cov_2.931310	68	148	32	15	80	0.1875000
NODE_2898_length_1351_cov_2.931310	68	148	34	4	80	0.0500000
NODE_2898_length_1351_cov_2.931310	68	148	36	14	80	0.1750000
NODE_2898_length_1351_cov_2.931310	68	148	38	9	80	0.1125000
NODE_2898_length_1351_cov_2.931310	68	148	40	2	80	0.0250000
NODE_2898_length_1351_cov_2.931310	68	148	41	1	80	0.0125000
NODE_2898_length_1351_cov_2.931310	68	148	42	13	80	0.1625000
NODE_2898_length_1351_cov_2.931310	68	148	44	5	80	0.0625000
NODE_2898_length_1351_cov_2.931310	495	528	0	8	33	0.2424242
NODE_2898_length_1351_cov_2.931310	495	528	2	25	33	0.7575758
NODE_2899_length_1350_cov_18.274181	424	504	2	51	80	0.6375000
NODE_2899_length_1350_cov_18.274181	424	504	8	29	80	0.3625000
NODE_2899_length_1350_cov_18.274181	477	557	6	33	80	0.4125000
NODE_2899_length_1350_cov_18.274181	477	557	8	47	80	0.5875000
NODE_2899_length_1350_cov_18.274181	553	633	0	59	80	0.7375000
NODE_2899_length_1350_cov_18.274181	553	633	6	21	80	0.2625000
NODE_2899_length_1350_cov_18.274181	606	686	0	80	80	1.0000000
NODE_2900_length_1350_cov_8.053557	737	817	0	80	80	1.0000000
NODE_2900_length_1350_cov_8.053557	790	870	0	80	80	1.0000000
NODE_2903_length_1349_cov_23.782400	839	919	0	80	80	1.0000000
NODE_2903_length_1349_cov_23.782400	892	972	0	80	80	1.0000000
NODE_2903_length_1349_cov_23.782400	968	1048	0	80	80	1.0000000
NODE_2903_length_1349_cov_23.782400	1021	1101	0	80	80	1.0000000
NODE_2904_length_1349_cov_17.776800	811	891	2	4	80	0.0500000
NODE_2904_length_1349_cov_17.776800	811	891	4	14	80	0.1750000
NODE_2904_length_1349_cov_17.776800	811	891	6	62	80	0.7750000
NODE_2904_length_1349_cov_17.776800	864	944	0	29	80	0.3625000
NODE_2904_length_1349_cov_17.776800	864	944	2	13	80	0.1625000
NODE_2904_length_1349_cov_17.776800	864	944	4	12	80	0.1500000
NODE_2904_length_1349_cov_17.776800	864	944	6	26	80	0.3250000
NODE_2905_length_1349_cov_16.468800	828	908	4	4	80	0.0500000
NODE_2905_length_1349_cov_16.468800	828	908	6	76	80	0.9500000
NODE_2905_length_1349_cov_16.468800	881	961	2	33	80	0.4125000
NODE_2905_length_1349_cov_16.468800	881	961	4	4	80	0.0500000
NODE_2905_length_1349_cov_16.468800	881	961	6	43	80	0.5375000
NODE_2908_length_1348_cov_22.731785	468	548	0	80	80	1.0000000
NODE_2908_length_1348_cov_22.731785	521	601	0	80	80	1.0000000
NODE_2909_length_1348_cov_20.778223	517	597	0	80	80	1.0000000
NODE_2909_length_1348_cov_20.778223	570	650	0	80	80	1.0000000
NODE_2910_length_1348_cov_11.180144	673	753	0	11	80	0.1375000
NODE_2910_length_1348_cov_11.180144	673	753	2	7	80	0.0875000
NODE_2910_length_1348_cov_11.180144	673	753	4	62	80	0.7750000
NODE_2910_length_1348_cov_11.180144	726	806	0	47	80	0.5875000
NODE_2910_length_1348_cov_11.180144	726	806	2	24	80	0.3000000
NODE_2910_length_1348_cov_11.180144	726	806	4	9	80	0.1125000
NODE_2916_length_1347_cov_45.906250	683	763	0	22	80	0.2750000
NODE_2916_length_1347_cov_45.906250	683	763	6	45	80	0.5625000
NODE_2916_length_1347_cov_45.906250	683	763	8	13	80	0.1625000
NODE_2916_length_1347_cov_45.906250	736	816	2	3	80	0.0375000
NODE_2916_length_1347_cov_45.906250	736	816	6	14	80	0.1750000
NODE_2916_length_1347_cov_45.906250	736	816	8	63	80	0.7875000
NODE_2916_length_1347_cov_45.906250	812	892	2	21	80	0.2625000
NODE_2916_length_1347_cov_45.906250	812	892	4	58	80	0.7250000
NODE_2916_length_1347_cov_45.906250	812	892	8	1	80	0.0125000
NODE_2916_length_1347_cov_45.906250	865	945	2	36	80	0.4500000
NODE_2916_length_1347_cov_45.906250	865	945	4	42	80	0.5250000
NODE_2916_length_1347_cov_45.906250	865	945	6	2	80	0.0250000
NODE_2917_length_1347_cov_41.643429	439	519	4	11	80	0.1375000
NODE_2917_length_1347_cov_41.643429	439	519	9	1	80	0.0125000
NODE_2917_length_1347_cov_41.643429	439	519	10	24	80	0.3000000
NODE_2917_length_1347_cov_41.643429	439	519	12	7	80	0.0875000
NODE_2917_length_1347_cov_41.643429	439	519	14	24	80	0.3000000
NODE_2917_length_1347_cov_41.643429	439	519	16	3	80	0.0375000
NODE_2917_length_1347_cov_41.643429	439	519	18	10	80	0.1250000
NODE_2917_length_1347_cov_41.643429	492	572	4	30	80	0.3750000
NODE_2917_length_1347_cov_41.643429	492	572	5	20	80	0.2500000
NODE_2917_length_1347_cov_41.643429	492	572	6	3	80	0.0375000
NODE_2917_length_1347_cov_41.643429	492	572	7	7	80	0.0875000
NODE_2917_length_1347_cov_41.643429	492	572	8	4	80	0.0500000
NODE_2917_length_1347_cov_41.643429	492	572	9	1	80	0.0125000
NODE_2917_length_1347_cov_41.643429	492	572	10	15	80	0.1875000
NODE_2918_length_1347_cov_19.941506	458	538	0	80	80	1.0000000
NODE_2918_length_1347_cov_19.941506	511	591	0	80	80	1.0000000
NODE_2918_length_1347_cov_19.941506	587	667	0	9	80	0.1125000
NODE_2918_length_1347_cov_19.941506	587	667	2	71	80	0.8875000
NODE_2918_length_1347_cov_19.941506	640	720	0	35	80	0.4375000
NODE_2918_length_1347_cov_19.941506	640	720	2	45	80	0.5625000
NODE_2919_length_1347_cov_16.520833	713	793	0	15	80	0.1875000
NODE_2919_length_1347_cov_16.520833	713	793	2	65	80	0.8125000
NODE_2919_length_1347_cov_16.520833	766	846	0	38	80	0.4750000
NODE_2919_length_1347_cov_16.520833	766	846	2	42	80	0.5250000
NODE_2920_length_1347_cov_15.967147	638	718	0	80	80	1.0000000
NODE_2920_length_1347_cov_15.967147	691	771	0	80	80	1.0000000
NODE_2925_length_1346_cov_13.112269	429	509	0	15	80	0.1875000
NODE_2925_length_1346_cov_13.112269	429	509	2	65	80	0.8125000
NODE_2925_length_1346_cov_13.112269	482	562	0	14	80	0.1750000
NODE_2925_length_1346_cov_13.112269	482	562	2	66	80	0.8250000
NODE_2928_length_1345_cov_32.099518	629	709	0	29	80	0.3625000
NODE_2928_length_1345_cov_32.099518	629	709	4	11	80	0.1375000
NODE_2928_length_1345_cov_32.099518	629	709	6	1	80	0.0125000
NODE_2928_length_1345_cov_32.099518	629	709	8	39	80	0.4875000
NODE_2928_length_1345_cov_32.099518	682	762	2	27	80	0.3375000
NODE_2928_length_1345_cov_32.099518	682	762	4	1	80	0.0125000
NODE_2928_length_1345_cov_32.099518	682	762	6	8	80	0.1000000
NODE_2928_length_1345_cov_32.099518	682	762	8	44	80	0.5500000
NODE_2929_length_1345_cov_19.837881	723	803	0	80	80	1.0000000
NODE_2929_length_1345_cov_19.837881	776	856	0	80	80	1.0000000
NODE_2930_length_1345_cov_14.262440	361	441	0	80	80	1.0000000
NODE_2930_length_1345_cov_14.262440	414	494	0	80	80	1.0000000
NODE_2930_length_1345_cov_14.262440	490	570	0	80	80	1.0000000
NODE_2930_length_1345_cov_14.262440	543	623	0	80	80	1.0000000
NODE_2931_length_1345_cov_14.103531	950	1030	0	80	80	1.0000000
NODE_2931_length_1345_cov_14.103531	1003	1083	0	80	80	1.0000000
NODE_2934_length_1344_cov_15.013655	345	425	0	57	80	0.7125000
NODE_2934_length_1344_cov_15.013655	345	425	2	13	80	0.1625000
NODE_2934_length_1344_cov_15.013655	345	425	4	10	80	0.1250000
NODE_2934_length_1344_cov_15.013655	398	478	0	4	80	0.0500000
NODE_2934_length_1344_cov_15.013655	398	478	2	22	80	0.2750000
NODE_2934_length_1344_cov_15.013655	398	478	4	54	80	0.6750000
NODE_2935_length_1344_cov_11.383133	519	599	0	80	80	1.0000000
NODE_2935_length_1344_cov_11.383133	572	652	0	80	80	1.0000000
NODE_2935_length_1344_cov_11.383133	648	728	0	80	80	1.0000000
NODE_2935_length_1344_cov_11.383133	701	781	0	80	80	1.0000000
NODE_2936_length_1344_cov_10.924498	529	609	0	80	80	1.0000000
NODE_2936_length_1344_cov_10.924498	582	662	0	80	80	1.0000000
NODE_2937_length_1344_cov_5.531727	920	975	0	55	55	1.0000000
NODE_2942_length_1343_cov_36.005627	150	230	6	9	80	0.1125000
NODE_2942_length_1343_cov_36.005627	150	230	8	3	80	0.0375000
NODE_2942_length_1343_cov_36.005627	150	230	10	2	80	0.0250000
NODE_2942_length_1343_cov_36.005627	150	230	11	3	80	0.0375000
NODE_2942_length_1343_cov_36.005627	150	230	13	2	80	0.0250000
NODE_2942_length_1343_cov_36.005627	150	230	15	8	80	0.1000000
NODE_2942_length_1343_cov_36.005627	150	230	18	1	80	0.0125000
NODE_2942_length_1343_cov_36.005627	150	230	21	14	80	0.1750000
NODE_2942_length_1343_cov_36.005627	150	230	22	30	80	0.3750000
NODE_2942_length_1343_cov_36.005627	150	230	24	8	80	0.1000000
NODE_2942_length_1343_cov_36.005627	286	366	4	10	80	0.1250000
NODE_2942_length_1343_cov_36.005627	286	366	6	70	80	0.8750000
NODE_2942_length_1343_cov_36.005627	339	419	0	17	80	0.2125000
NODE_2942_length_1343_cov_36.005627	339	419	4	39	80	0.4875000
NODE_2942_length_1343_cov_36.005627	339	419	6	24	80	0.3000000
NODE_2942_length_1343_cov_36.005627	415	495	0	80	80	1.0000000
NODE_2942_length_1343_cov_36.005627	468	548	0	80	80	1.0000000
NODE_2943_length_1343_cov_26.826367	782	862	0	80	80	1.0000000
NODE_2943_length_1343_cov_26.826367	835	915	0	80	80	1.0000000
NODE_2944_length_1343_cov_19.353698	799	879	2	65	80	0.8125000
NODE_2944_length_1343_cov_19.353698	799	879	3	6	80	0.0750000
NODE_2944_length_1343_cov_19.353698	799	879	4	9	80	0.1125000
NODE_2944_length_1343_cov_19.353698	852	932	0	8	80	0.1000000
NODE_2944_length_1343_cov_19.353698	852	932	2	57	80	0.7125000
NODE_2944_length_1343_cov_19.353698	852	932	3	6	80	0.0750000
NODE_2944_length_1343_cov_19.353698	852	932	4	9	80	0.1125000
NODE_2944_length_1343_cov_19.353698	928	1008	0	48	80	0.6000000
NODE_2944_length_1343_cov_19.353698	928	1008	2	32	80	0.4000000
NODE_2944_length_1343_cov_19.353698	981	1061	0	28	80	0.3500000
NODE_2944_length_1343_cov_19.353698	981	1061	2	52	80	0.6500000
NODE_2945_length_1343_cov_15.717846	745	825	0	80	80	1.0000000
NODE_2945_length_1343_cov_15.717846	798	878	0	27	80	0.3375000
NODE_2945_length_1343_cov_15.717846	798	878	2	53	80	0.6625000
NODE_2949_length_1342_cov_30.491553	456	536	0	8	80	0.1000000
NODE_2949_length_1342_cov_30.491553	456	536	1	1	80	0.0125000
NODE_2949_length_1342_cov_30.491553	456	536	2	71	80	0.8875000
NODE_2949_length_1342_cov_30.491553	509	589	0	16	80	0.2000000
NODE_2949_length_1342_cov_30.491553	509	589	2	64	80	0.8000000
NODE_2949_length_1342_cov_30.491553	585	665	2	29	80	0.3625000
NODE_2949_length_1342_cov_30.491553	585	665	4	8	80	0.1000000
NODE_2949_length_1342_cov_30.491553	585	665	6	14	80	0.1750000
NODE_2949_length_1342_cov_30.491553	585	665	8	29	80	0.3625000
NODE_2949_length_1342_cov_30.491553	638	718	2	8	80	0.1000000
NODE_2949_length_1342_cov_30.491553	638	718	4	19	80	0.2375000
NODE_2949_length_1342_cov_30.491553	638	718	6	11	80	0.1375000
NODE_2949_length_1342_cov_30.491553	638	718	8	42	80	0.5250000
NODE_2950_length_1342_cov_26.796460	538	618	0	80	80	1.0000000
NODE_2950_length_1342_cov_26.796460	591	671	0	80	80	1.0000000
NODE_2950_length_1342_cov_26.796460	667	747	0	80	80	1.0000000
NODE_2950_length_1342_cov_26.796460	720	800	0	80	80	1.0000000
NODE_2951_length_1342_cov_22.769912	298	378	0	4	80	0.0500000
NODE_2951_length_1342_cov_22.769912	298	378	2	76	80	0.9500000
NODE_2951_length_1342_cov_22.769912	351	431	0	38	80	0.4750000
NODE_2951_length_1342_cov_22.769912	351	431	2	42	80	0.5250000
NODE_2951_length_1342_cov_22.769912	427	507	0	22	80	0.2750000
NODE_2951_length_1342_cov_22.769912	427	507	4	13	80	0.1625000
NODE_2951_length_1342_cov_22.769912	427	507	5	19	80	0.2375000
NODE_2951_length_1342_cov_22.769912	427	507	6	23	80	0.2875000
NODE_2951_length_1342_cov_22.769912	427	507	7	3	80	0.0375000
NODE_2951_length_1342_cov_22.769912	480	560	3	26	80	0.3250000
NODE_2951_length_1342_cov_22.769912	480	560	5	1	80	0.0125000
NODE_2951_length_1342_cov_22.769912	480	560	6	23	80	0.2875000
NODE_2951_length_1342_cov_22.769912	480	560	7	30	80	0.3750000
NODE_2953_length_1341_cov_22.449275	494	574	2	80	80	1.0000000
NODE_2953_length_1341_cov_22.449275	547	627	0	40	80	0.5000000
NODE_2953_length_1341_cov_22.449275	547	627	2	40	80	0.5000000
NODE_2953_length_1341_cov_22.449275	623	703	0	3	80	0.0375000
NODE_2953_length_1341_cov_22.449275	623	703	2	9	80	0.1125000
NODE_2953_length_1341_cov_22.449275	623	703	4	15	80	0.1875000
NODE_2953_length_1341_cov_22.449275	623	703	6	53	80	0.6625000
NODE_2953_length_1341_cov_22.449275	676	755	0	2	79	0.0253165
NODE_2953_length_1341_cov_22.449275	676	755	2	23	79	0.2911392
NODE_2953_length_1341_cov_22.449275	676	755	4	14	79	0.1772152
NODE_2953_length_1341_cov_22.449275	676	755	6	40	79	0.5063291
NODE_2954_length_1341_cov_14.497585	415	495	0	4	80	0.0500000
NODE_2954_length_1341_cov_14.497585	415	495	2	76	80	0.9500000
NODE_2954_length_1341_cov_14.497585	468	548	0	17	80	0.2125000
NODE_2954_length_1341_cov_14.497585	468	548	2	63	80	0.7875000
NODE_2954_length_1341_cov_14.497585	544	624	0	77	80	0.9625000
NODE_2954_length_1341_cov_14.497585	544	624	2	3	80	0.0375000
NODE_2954_length_1341_cov_14.497585	597	677	0	24	80	0.3000000
NODE_2954_length_1341_cov_14.497585	597	677	2	56	80	0.7000000
NODE_2960_length_1340_cov_9.460113	531	611	0	80	80	1.0000000
NODE_2960_length_1340_cov_9.460113	584	664	0	80	80	1.0000000
NODE_2961_length_1340_cov_6.511684	735	815	0	80	80	1.0000000
NODE_2961_length_1340_cov_6.511684	788	868	0	80	80	1.0000000
NODE_2966_length_1339_cov_22.725000	751	831	0	80	80	1.0000000
NODE_2966_length_1339_cov_22.725000	804	884	0	80	80	1.0000000
NODE_2967_length_1339_cov_9.322581	329	409	0	39	80	0.4875000
NODE_2967_length_1339_cov_9.322581	329	409	2	41	80	0.5125000
NODE_2967_length_1339_cov_9.322581	382	462	2	80	80	1.0000000
NODE_2970_length_1338_cov_31.740920	527	607	0	80	80	1.0000000
NODE_2970_length_1338_cov_31.740920	580	660	0	80	80	1.0000000
NODE_2970_length_1338_cov_31.740920	656	736	0	64	80	0.8000000
NODE_2970_length_1338_cov_31.740920	656	736	2	16	80	0.2000000
NODE_2970_length_1338_cov_31.740920	709	789	0	11	80	0.1375000
NODE_2970_length_1338_cov_31.740920	709	789	2	69	80	0.8625000
NODE_2971_length_1338_cov_21.254237	639	719	0	80	80	1.0000000
NODE_2971_length_1338_cov_21.254237	692	772	0	80	80	1.0000000
NODE_2974_length_1337_cov_32.307754	739	819	10	13	80	0.1625000
NODE_2974_length_1337_cov_32.307754	739	819	11	1	80	0.0125000
NODE_2974_length_1337_cov_32.307754	739	819	12	14	80	0.1750000
NODE_2974_length_1337_cov_32.307754	739	819	14	14	80	0.1750000
NODE_2974_length_1337_cov_32.307754	739	819	16	8	80	0.1000000
NODE_2974_length_1337_cov_32.307754	739	819	18	19	80	0.2375000
NODE_2974_length_1337_cov_32.307754	739	819	20	11	80	0.1375000
NODE_2974_length_1337_cov_32.307754	792	872	7	2	80	0.0250000
NODE_2974_length_1337_cov_32.307754	792	872	8	3	80	0.0375000
NODE_2974_length_1337_cov_32.307754	792	872	10	2	80	0.0250000
NODE_2974_length_1337_cov_32.307754	792	872	12	16	80	0.2000000
NODE_2974_length_1337_cov_32.307754	792	872	13	10	80	0.1250000
NODE_2974_length_1337_cov_32.307754	792	872	14	8	80	0.1000000
NODE_2974_length_1337_cov_32.307754	792	872	15	3	80	0.0375000
NODE_2974_length_1337_cov_32.307754	792	872	18	25	80	0.3125000
NODE_2974_length_1337_cov_32.307754	792	872	20	11	80	0.1375000
NODE_2975_length_1337_cov_30.412763	465	545	0	80	80	1.0000000
NODE_2975_length_1337_cov_30.412763	518	598	0	72	80	0.9000000
NODE_2975_length_1337_cov_30.412763	518	598	2	8	80	0.1000000
NODE_2976_length_1337_cov_12.760905	560	640	0	80	80	1.0000000
NODE_2976_length_1337_cov_12.760905	613	693	0	80	80	1.0000000
NODE_2977_length_1337_cov_9.463651	724	804	2	28	80	0.3500000
NODE_2977_length_1337_cov_9.463651	724	804	4	52	80	0.6500000
NODE_2977_length_1337_cov_9.463651	777	857	0	22	80	0.2750000
NODE_2977_length_1337_cov_9.463651	777	857	1	10	80	0.1250000
NODE_2977_length_1337_cov_9.463651	777	857	2	14	80	0.1750000
NODE_2977_length_1337_cov_9.463651	777	857	4	34	80	0.4250000
NODE_2979_length_1337_cov_4.540388	216	296	0	80	80	1.0000000
NODE_2979_length_1337_cov_4.540388	272	349	0	77	77	1.0000000
NODE_2981_length_1336_cov_28.161681	394	474	0	80	80	1.0000000
NODE_2981_length_1336_cov_28.161681	447	527	0	80	80	1.0000000
NODE_2981_length_1336_cov_28.161681	523	603	0	80	80	1.0000000
NODE_2981_length_1336_cov_28.161681	576	656	0	80	80	1.0000000
NODE_2982_length_1336_cov_7.860954	17	98	0	76	81	0.9382716
NODE_2982_length_1336_cov_7.860954	17	98	2	5	81	0.0617284
NODE_2984_length_1336_cov_1.689572	1229	1289	0	59	60	0.9833333
NODE_2984_length_1336_cov_1.689572	1229	1289	2	1	60	0.0166667
NODE_2984_length_1336_cov_1.689572	1262	1336	0	74	74	1.0000000
NODE_2985_length_1335_cov_19.547735	530	607	0	39	77	0.5064935
NODE_2985_length_1335_cov_19.547735	530	607	1	1	77	0.0129870
NODE_2985_length_1335_cov_19.547735	530	607	2	37	77	0.4805195
NODE_2985_length_1335_cov_19.547735	582	660	0	78	78	1.0000000
NODE_2985_length_1335_cov_19.547735	656	736	0	80	80	1.0000000
NODE_2985_length_1335_cov_19.547735	709	789	0	80	80	1.0000000
NODE_2986_length_1335_cov_15.383495	419	499	0	80	80	1.0000000
NODE_2986_length_1335_cov_15.383495	472	552	0	61	80	0.7625000
NODE_2986_length_1335_cov_15.383495	472	552	2	19	80	0.2375000
NODE_2986_length_1335_cov_15.383495	548	628	0	16	80	0.2000000
NODE_2986_length_1335_cov_15.383495	548	628	2	64	80	0.8000000
NODE_2986_length_1335_cov_15.383495	601	681	0	69	80	0.8625000
NODE_2986_length_1335_cov_15.383495	601	681	2	11	80	0.1375000
NODE_2991_length_1333_cov_27.372771	493	573	0	80	80	1.0000000
NODE_2991_length_1333_cov_27.372771	546	626	0	80	80	1.0000000
NODE_2996_length_1332_cov_18.978913	648	728	3	10	80	0.1250000
NODE_2996_length_1332_cov_18.978913	648	728	5	70	80	0.8750000
NODE_2996_length_1332_cov_18.978913	701	781	0	8	80	0.1000000
NODE_2996_length_1332_cov_18.978913	701	781	1	4	80	0.0500000
NODE_2996_length_1332_cov_18.978913	701	781	2	33	80	0.4125000
NODE_2996_length_1332_cov_18.978913	701	781	3	15	80	0.1875000
NODE_2996_length_1332_cov_18.978913	701	781	5	20	80	0.2500000
NODE_2996_length_1332_cov_18.978913	777	857	0	80	80	1.0000000
NODE_2996_length_1332_cov_18.978913	830	910	0	80	80	1.0000000
NODE_2997_length_1332_cov_3.112733	87	151	2	11	64	0.1718750
NODE_2997_length_1332_cov_3.112733	87	151	4	41	64	0.6406250
NODE_2997_length_1332_cov_3.112733	87	151	6	1	64	0.0156250
NODE_2997_length_1332_cov_3.112733	87	151	10	1	64	0.0156250
NODE_2997_length_1332_cov_3.112733	87	151	12	3	64	0.0468750
NODE_2997_length_1332_cov_3.112733	87	151	14	4	64	0.0625000
NODE_2997_length_1332_cov_3.112733	87	151	16	3	64	0.0468750
NODE_3000_length_1331_cov_16.831981	392	472	0	80	80	1.0000000
NODE_3000_length_1331_cov_16.831981	445	525	0	80	80	1.0000000
NODE_3000_length_1331_cov_16.831981	521	601	0	80	80	1.0000000
NODE_3000_length_1331_cov_16.831981	574	654	0	80	80	1.0000000
NODE_3001_length_1331_cov_12.841721	871	951	0	38	80	0.4750000
NODE_3001_length_1331_cov_12.841721	871	951	2	42	80	0.5250000
NODE_3001_length_1331_cov_12.841721	924	1004	0	46	80	0.5750000
NODE_3001_length_1331_cov_12.841721	924	1004	2	34	80	0.4250000
NODE_3004_length_1331_cov_2.090097	0	76	0	76	76	1.0000000
NODE_3004_length_1331_cov_2.090097	49	98	0	49	49	1.0000000
NODE_3007_length_1330_cov_48.993501	278	358	0	30	80	0.3750000
NODE_3007_length_1330_cov_48.993501	278	358	2	41	80	0.5125000
NODE_3007_length_1330_cov_48.993501	278	358	4	9	80	0.1125000
NODE_3007_length_1330_cov_48.993501	331	411	2	42	80	0.5250000
NODE_3007_length_1330_cov_48.993501	331	411	4	38	80	0.4750000
NODE_3007_length_1330_cov_48.993501	742	822	0	26	80	0.3250000
NODE_3007_length_1330_cov_48.993501	742	822	1	31	80	0.3875000
NODE_3007_length_1330_cov_48.993501	742	822	5	23	80	0.2875000
NODE_3007_length_1330_cov_48.993501	795	875	1	4	80	0.0500000
NODE_3007_length_1330_cov_48.993501	795	875	5	26	80	0.3250000
NODE_3007_length_1330_cov_48.993501	795	875	6	1	80	0.0125000
NODE_3007_length_1330_cov_48.993501	795	875	7	29	80	0.3625000
NODE_3007_length_1330_cov_48.993501	795	875	8	20	80	0.2500000
NODE_3008_length_1330_cov_11.037368	407	487	0	18	80	0.2250000
NODE_3008_length_1330_cov_11.037368	407	487	4	4	80	0.0500000
NODE_3008_length_1330_cov_11.037368	407	487	6	22	80	0.2750000
NODE_3008_length_1330_cov_11.037368	407	487	8	36	80	0.4500000
NODE_3008_length_1330_cov_11.037368	460	540	2	6	80	0.0750000
NODE_3008_length_1330_cov_11.037368	460	540	6	9	80	0.1125000
NODE_3008_length_1330_cov_11.037368	460	540	8	65	80	0.8125000
NODE_3008_length_1330_cov_11.037368	536	617	0	52	81	0.6419753
NODE_3008_length_1330_cov_11.037368	536	617	2	29	81	0.3580247
NODE_3008_length_1330_cov_11.037368	590	670	0	17	80	0.2125000
NODE_3008_length_1330_cov_11.037368	590	670	2	14	80	0.1750000
NODE_3008_length_1330_cov_11.037368	590	670	4	49	80	0.6125000
NODE_3009_length_1330_cov_9.026807	551	631	0	23	80	0.2875000
NODE_3009_length_1330_cov_9.026807	551	631	2	57	80	0.7125000
NODE_3009_length_1330_cov_9.026807	604	684	0	43	80	0.5375000
NODE_3009_length_1330_cov_9.026807	604	684	2	37	80	0.4625000
NODE_3011_length_1329_cov_17.036585	691	771	0	80	80	1.0000000
NODE_3011_length_1329_cov_17.036585	744	824	0	38	80	0.4750000
NODE_3011_length_1329_cov_17.036585	744	824	2	42	80	0.5250000
NODE_3011_length_1329_cov_17.036585	820	900	2	80	80	1.0000000
NODE_3011_length_1329_cov_17.036585	873	953	0	37	80	0.4625000
NODE_3011_length_1329_cov_17.036585	873	953	2	43	80	0.5375000
NODE_3012_length_1329_cov_16.341463	428	476	3	1	48	0.0208333
NODE_3012_length_1329_cov_16.341463	428	476	5	2	48	0.0416667
NODE_3012_length_1329_cov_16.341463	428	476	8	3	48	0.0625000
NODE_3012_length_1329_cov_16.341463	428	476	14	1	48	0.0208333
NODE_3012_length_1329_cov_16.341463	428	476	16	6	48	0.1250000
NODE_3012_length_1329_cov_16.341463	428	476	18	2	48	0.0416667
NODE_3012_length_1329_cov_16.341463	428	476	20	18	48	0.3750000
NODE_3012_length_1329_cov_16.341463	428	476	22	1	48	0.0208333
NODE_3012_length_1329_cov_16.341463	428	476	23	6	48	0.1250000
NODE_3012_length_1329_cov_16.341463	428	476	24	1	48	0.0208333
NODE_3012_length_1329_cov_16.341463	428	476	26	1	48	0.0208333
NODE_3012_length_1329_cov_16.341463	428	476	28	2	48	0.0416667
NODE_3012_length_1329_cov_16.341463	428	476	30	4	48	0.0833333
NODE_3013_length_1329_cov_5.620325	888	955	4	17	67	0.2537313
NODE_3013_length_1329_cov_5.620325	888	955	6	50	67	0.7462686
NODE_3013_length_1329_cov_5.620325	941	999	2	2	58	0.0344828
NODE_3013_length_1329_cov_5.620325	941	999	4	8	58	0.1379310
NODE_3013_length_1329_cov_5.620325	941	999	6	25	58	0.4310345
NODE_3013_length_1329_cov_5.620325	941	999	8	23	58	0.3965517
NODE_3017_length_1328_cov_12.954434	794	874	0	80	80	1.0000000
NODE_3017_length_1328_cov_12.954434	847	927	0	80	80	1.0000000
NODE_3018_length_1328_cov_8.810415	762	842	0	58	80	0.7250000
NODE_3018_length_1328_cov_8.810415	762	842	2	22	80	0.2750000
NODE_3018_length_1328_cov_8.810415	815	895	0	80	80	1.0000000
NODE_3021_length_1327_cov_15.938925	260	340	4	80	80	1.0000000
NODE_3021_length_1327_cov_15.938925	313	393	0	22	80	0.2750000
NODE_3021_length_1327_cov_15.938925	313	393	4	58	80	0.7250000
NODE_3022_length_1327_cov_7.274430	159	235	0	65	76	0.8552632
NODE_3022_length_1327_cov_7.274430	159	235	2	2	76	0.0263158
NODE_3022_length_1327_cov_7.274430	159	235	4	9	76	0.1184211
NODE_3022_length_1327_cov_7.274430	774	854	0	20	80	0.2500000
NODE_3022_length_1327_cov_7.274430	774	854	2	60	80	0.7500000
NODE_3022_length_1327_cov_7.274430	827	890	0	24	63	0.3809524
NODE_3022_length_1327_cov_7.274430	827	890	2	39	63	0.6190476
NODE_3023_length_1327_cov_6.486156	896	976	0	80	80	1.0000000
NODE_3023_length_1327_cov_6.486156	949	1029	0	80	80	1.0000000
NODE_3029_length_1326_cov_32.382233	571	651	0	80	80	1.0000000
NODE_3029_length_1326_cov_32.382233	624	704	0	80	80	1.0000000
NODE_3030_length_1326_cov_30.614507	760	840	0	71	80	0.8875000
NODE_3030_length_1326_cov_30.614507	760	840	2	9	80	0.1125000
NODE_3030_length_1326_cov_30.614507	813	893	0	18	80	0.2250000
NODE_3030_length_1326_cov_30.614507	813	893	2	49	80	0.6125000
NODE_3030_length_1326_cov_30.614507	813	893	4	8	80	0.1000000
NODE_3030_length_1326_cov_30.614507	813	893	6	5	80	0.0625000
NODE_3031_length_1326_cov_30.304808	488	568	4	4	80	0.0500000
NODE_3031_length_1326_cov_30.304808	488	568	8	3	80	0.0375000
NODE_3031_length_1326_cov_30.304808	488	568	10	40	80	0.5000000
NODE_3031_length_1326_cov_30.304808	488	568	12	33	80	0.4125000
NODE_3031_length_1326_cov_30.304808	541	621	0	10	80	0.1250000
NODE_3031_length_1326_cov_30.304808	541	621	2	17	80	0.2125000
NODE_3031_length_1326_cov_30.304808	541	621	4	20	80	0.2500000
NODE_3031_length_1326_cov_30.304808	541	621	6	5	80	0.0625000
NODE_3031_length_1326_cov_30.304808	541	621	10	3	80	0.0375000
NODE_3031_length_1326_cov_30.304808	541	621	12	25	80	0.3125000
NODE_3031_length_1326_cov_30.304808	617	697	0	60	80	0.7500000
NODE_3031_length_1326_cov_30.304808	617	697	2	20	80	0.2500000
NODE_3031_length_1326_cov_30.304808	670	750	0	9	80	0.1125000
NODE_3031_length_1326_cov_30.304808	670	750	2	71	80	0.8875000
NODE_3032_length_1326_cov_10.913610	238	318	0	80	80	1.0000000
NODE_3032_length_1326_cov_10.913610	291	371	0	80	80	1.0000000
NODE_3036_length_1325_cov_38.136215	0	46	0	13	46	0.2826087
NODE_3036_length_1325_cov_38.136215	0	46	4	3	46	0.0652174
NODE_3036_length_1325_cov_38.136215	0	46	8	30	46	0.6521739
NODE_3036_length_1325_cov_38.136215	19	99	8	44	80	0.5500000
NODE_3036_length_1325_cov_38.136215	19	99	10	34	80	0.4250000
NODE_3036_length_1325_cov_38.136215	19	99	16	2	80	0.0250000
NODE_3036_length_1325_cov_38.136215	948	1022	11	7	74	0.0945946
NODE_3036_length_1325_cov_38.136215	948	1022	12	4	74	0.0540541
NODE_3036_length_1325_cov_38.136215	948	1022	14	1	74	0.0135135
NODE_3036_length_1325_cov_38.136215	948	1022	15	12	74	0.1621622
NODE_3036_length_1325_cov_38.136215	948	1022	17	20	74	0.2702703
NODE_3036_length_1325_cov_38.136215	948	1022	19	5	74	0.0675676
NODE_3036_length_1325_cov_38.136215	948	1022	20	1	74	0.0135135
NODE_3036_length_1325_cov_38.136215	948	1022	21	24	74	0.3243243
NODE_3036_length_1325_cov_38.136215	1001	1063	15	7	62	0.1129032
NODE_3036_length_1325_cov_38.136215	1001	1063	17	20	62	0.3225806
NODE_3036_length_1325_cov_38.136215	1001	1063	19	2	62	0.0322581
NODE_3036_length_1325_cov_38.136215	1001	1063	21	5	62	0.0806452
NODE_3036_length_1325_cov_38.136215	1001	1063	22	1	62	0.0161290
NODE_3036_length_1325_cov_38.136215	1001	1063	23	13	62	0.2096774
NODE_3036_length_1325_cov_38.136215	1001	1063	25	7	62	0.1129032
NODE_3036_length_1325_cov_38.136215	1001	1063	31	3	62	0.0483871
NODE_3036_length_1325_cov_38.136215	1001	1063	33	2	62	0.0322581
NODE_3036_length_1325_cov_38.136215	1001	1063	35	2	62	0.0322581
NODE_3037_length_1325_cov_29.201468	613	693	2	49	80	0.6125000
NODE_3037_length_1325_cov_29.201468	613	693	4	31	80	0.3875000
NODE_3037_length_1325_cov_29.201468	666	746	0	25	80	0.3125000
NODE_3037_length_1325_cov_29.201468	666	746	2	42	80	0.5250000
NODE_3037_length_1325_cov_29.201468	666	746	4	13	80	0.1625000
NODE_3038_length_1325_cov_11.902121	697	777	0	32	80	0.4000000
NODE_3038_length_1325_cov_11.902121	697	777	4	48	80	0.6000000
NODE_3038_length_1325_cov_11.902121	750	830	0	16	80	0.2000000
NODE_3038_length_1325_cov_11.902121	750	830	4	64	80	0.8000000
NODE_3039_length_1325_cov_7.876835	645	725	0	80	80	1.0000000
NODE_3039_length_1325_cov_7.876835	698	778	0	80	80	1.0000000
NODE_3040_length_1325_cov_3.774062	1157	1218	0	60	61	0.9836066
NODE_3040_length_1325_cov_3.774062	1157	1218	2	1	61	0.0163934
NODE_3040_length_1325_cov_3.774062	1191	1271	0	80	80	1.0000000
NODE_3041_length_1325_cov_2.896411	0	58	0	49	58	0.8448276
NODE_3041_length_1325_cov_2.896411	0	58	2	9	58	0.1551724
NODE_3041_length_1325_cov_2.896411	8	67	0	41	59	0.6949152
NODE_3041_length_1325_cov_2.896411	8	67	2	18	59	0.3050847
NODE_3046_length_1324_cov_30.340408	939	1019	4	1	80	0.0125000
NODE_3046_length_1324_cov_30.340408	939	1019	6	6	80	0.0750000
NODE_3046_length_1324_cov_30.340408	939	1019	8	30	80	0.3750000
NODE_3046_length_1324_cov_30.340408	939	1019	10	23	80	0.2875000
NODE_3046_length_1324_cov_30.340408	939	1019	12	20	80	0.2500000
NODE_3046_length_1324_cov_30.340408	992	1072	0	21	80	0.2625000
NODE_3046_length_1324_cov_30.340408	992	1072	4	31	80	0.3875000
NODE_3046_length_1324_cov_30.340408	992	1072	6	3	80	0.0375000
NODE_3046_length_1324_cov_30.340408	992	1072	8	1	80	0.0125000
NODE_3046_length_1324_cov_30.340408	992	1072	10	23	80	0.2875000
NODE_3046_length_1324_cov_30.340408	992	1072	12	1	80	0.0125000
NODE_3047_length_1324_cov_7.391020	742	822	0	10	80	0.1250000
NODE_3047_length_1324_cov_7.391020	742	822	2	70	80	0.8750000
NODE_3047_length_1324_cov_7.391020	795	875	0	41	80	0.5125000
NODE_3047_length_1324_cov_7.391020	795	875	2	39	80	0.4875000
NODE_3053_length_1323_cov_30.600490	392	472	0	80	80	1.0000000
NODE_3053_length_1323_cov_30.600490	445	525	0	80	80	1.0000000
NODE_3053_length_1323_cov_30.600490	521	601	0	49	80	0.6125000
NODE_3053_length_1323_cov_30.600490	521	601	2	31	80	0.3875000
NODE_3053_length_1323_cov_30.600490	574	654	0	8	80	0.1000000
NODE_3053_length_1323_cov_30.600490	574	654	2	72	80	0.9000000
NODE_3054_length_1323_cov_20.888889	758	838	0	57	80	0.7125000
NODE_3054_length_1323_cov_20.888889	758	838	2	23	80	0.2875000
NODE_3054_length_1323_cov_20.888889	811	891	0	4	80	0.0500000
NODE_3054_length_1323_cov_20.888889	811	891	2	76	80	0.9500000
NODE_3061_length_1322_cov_8.988553	287	368	1	81	81	1.0000000
NODE_3061_length_1322_cov_8.988553	341	421	0	31	80	0.3875000
NODE_3061_length_1322_cov_8.988553	341	421	1	49	80	0.6125000
NODE_3061_length_1322_cov_8.988553	417	497	0	80	80	1.0000000
NODE_3061_length_1322_cov_8.988553	470	550	0	80	80	1.0000000
NODE_3068_length_1321_cov_57.885434	359	439	0	80	80	1.0000000
NODE_3068_length_1321_cov_57.885434	412	492	0	80	80	1.0000000
NODE_3068_length_1321_cov_57.885434	488	568	0	80	80	1.0000000
NODE_3068_length_1321_cov_57.885434	541	621	0	80	80	1.0000000
NODE_3071_length_1320_cov_70.753481	432	512	2	36	80	0.4500000
NODE_3071_length_1320_cov_70.753481	432	512	4	15	80	0.1875000
NODE_3071_length_1320_cov_70.753481	432	512	8	18	80	0.2250000
NODE_3071_length_1320_cov_70.753481	432	512	9	1	80	0.0125000
NODE_3071_length_1320_cov_70.753481	432	512	10	10	80	0.1250000
NODE_3071_length_1320_cov_70.753481	485	565	6	1	80	0.0125000
NODE_3071_length_1320_cov_70.753481	485	565	8	70	80	0.8750000
NODE_3071_length_1320_cov_70.753481	485	565	10	9	80	0.1125000
NODE_3071_length_1320_cov_70.753481	561	641	4	4	80	0.0500000
NODE_3071_length_1320_cov_70.753481	561	641	6	23	80	0.2875000
NODE_3071_length_1320_cov_70.753481	561	641	8	3	80	0.0375000
NODE_3071_length_1320_cov_70.753481	561	641	10	50	80	0.6250000
NODE_3071_length_1320_cov_70.753481	614	694	8	25	80	0.3125000
NODE_3071_length_1320_cov_70.753481	614	694	10	54	80	0.6750000
NODE_3071_length_1320_cov_70.753481	614	694	12	1	80	0.0125000
NODE_3072_length_1320_cov_39.149058	715	795	0	14	80	0.1750000
NODE_3072_length_1320_cov_39.149058	715	795	2	66	80	0.8250000
NODE_3072_length_1320_cov_39.149058	768	848	0	40	80	0.5000000
NODE_3072_length_1320_cov_39.149058	768	848	2	29	80	0.3625000
NODE_3072_length_1320_cov_39.149058	768	848	4	1	80	0.0125000
NODE_3072_length_1320_cov_39.149058	768	848	5	10	80	0.1250000
NODE_3072_length_1320_cov_39.149058	844	924	5	9	80	0.1125000
NODE_3072_length_1320_cov_39.149058	844	924	7	13	80	0.1625000
NODE_3072_length_1320_cov_39.149058	844	924	8	58	80	0.7250000
NODE_3072_length_1320_cov_39.149058	897	977	0	32	80	0.4000000
NODE_3072_length_1320_cov_39.149058	897	977	2	1	80	0.0125000
NODE_3072_length_1320_cov_39.149058	897	977	8	47	80	0.5875000
NODE_3073_length_1320_cov_19.175266	707	783	2	76	76	1.0000000
NODE_3073_length_1320_cov_19.175266	760	840	0	52	80	0.6500000
NODE_3073_length_1320_cov_19.175266	760	840	2	28	80	0.3500000
NODE_3074_length_1320_cov_11.224406	860	940	0	41	80	0.5125000
NODE_3074_length_1320_cov_11.224406	860	940	2	39	80	0.4875000
NODE_3074_length_1320_cov_11.224406	913	993	2	80	80	1.0000000
NODE_3075_length_1320_cov_11.036036	760	840	0	80	80	1.0000000
NODE_3075_length_1320_cov_11.036036	813	893	0	80	80	1.0000000
NODE_3076_length_1320_cov_8.357084	800	880	0	80	80	1.0000000
NODE_3076_length_1320_cov_8.357084	853	933	0	80	80	1.0000000
NODE_3080_length_1319_cov_27.098361	630	710	0	27	80	0.3375000
NODE_3080_length_1319_cov_27.098361	630	710	2	8	80	0.1000000
NODE_3080_length_1319_cov_27.098361	630	710	4	45	80	0.5625000
NODE_3080_length_1319_cov_27.098361	683	763	0	80	80	1.0000000
NODE_3081_length_1319_cov_22.992623	490	570	2	31	80	0.3875000
NODE_3081_length_1319_cov_22.992623	490	570	4	20	80	0.2500000
NODE_3081_length_1319_cov_22.992623	490	570	6	19	80	0.2375000
NODE_3081_length_1319_cov_22.992623	490	570	8	10	80	0.1250000
NODE_3081_length_1319_cov_22.992623	543	623	6	25	80	0.3125000
NODE_3081_length_1319_cov_22.992623	543	623	8	55	80	0.6875000
NODE_3086_length_1318_cov_13.624282	642	722	0	80	80	1.0000000
NODE_3086_length_1318_cov_13.624282	695	775	0	80	80	1.0000000
NODE_3086_length_1318_cov_13.624282	771	851	0	80	80	1.0000000
NODE_3086_length_1318_cov_13.624282	824	904	0	80	80	1.0000000
NODE_3089_length_1317_cov_162.041872	66	143	2	1	77	0.0129870
NODE_3089_length_1317_cov_162.041872	66	143	3	1	77	0.0129870
NODE_3089_length_1317_cov_162.041872	66	143	4	1	77	0.0129870
NODE_3089_length_1317_cov_162.041872	66	143	8	20	77	0.2597403
NODE_3089_length_1317_cov_162.041872	66	143	10	41	77	0.5324675
NODE_3089_length_1317_cov_162.041872	66	143	12	10	77	0.1298701
NODE_3089_length_1317_cov_162.041872	66	143	54	1	77	0.0129870
NODE_3089_length_1317_cov_162.041872	66	143	69	1	77	0.0129870
NODE_3089_length_1317_cov_162.041872	66	143	76	1	77	0.0129870
NODE_3090_length_1317_cov_19.736453	675	755	0	14	80	0.1750000
NODE_3090_length_1317_cov_19.736453	675	755	3	1	80	0.0125000
NODE_3090_length_1317_cov_19.736453	675	755	4	65	80	0.8125000
NODE_3090_length_1317_cov_19.736453	728	808	4	80	80	1.0000000
NODE_3090_length_1317_cov_19.736453	804	884	2	36	80	0.4500000
NODE_3090_length_1317_cov_19.736453	804	884	4	32	80	0.4000000
NODE_3090_length_1317_cov_19.736453	804	884	6	12	80	0.1500000
NODE_3090_length_1317_cov_19.736453	857	937	2	80	80	1.0000000
NODE_3092_length_1317_cov_2.203612	779	859	0	34	80	0.4250000
NODE_3092_length_1317_cov_2.203612	779	859	2	46	80	0.5750000
NODE_3095_length_1316_cov_25.377157	557	637	0	80	80	1.0000000
NODE_3095_length_1316_cov_25.377157	610	690	0	36	80	0.4500000
NODE_3095_length_1316_cov_25.377157	610	690	2	44	80	0.5500000
NODE_3096_length_1316_cov_15.891537	446	526	0	41	80	0.5125000
NODE_3096_length_1316_cov_15.891537	446	526	2	39	80	0.4875000
NODE_3096_length_1316_cov_15.891537	499	579	2	80	80	1.0000000
NODE_3096_length_1316_cov_15.891537	575	655	0	64	80	0.8000000
NODE_3096_length_1316_cov_15.891537	575	655	2	16	80	0.2000000
NODE_3096_length_1316_cov_15.891537	628	708	0	80	80	1.0000000
NODE_3101_length_1315_cov_24.136513	592	672	0	80	80	1.0000000
NODE_3101_length_1315_cov_24.136513	645	725	0	80	80	1.0000000
NODE_3105_length_1314_cov_38.391770	647	727	2	80	80	1.0000000
NODE_3105_length_1314_cov_38.391770	700	780	0	42	80	0.5250000
NODE_3105_length_1314_cov_38.391770	700	780	2	38	80	0.4750000
NODE_3105_length_1314_cov_38.391770	776	856	0	7	80	0.0875000
NODE_3105_length_1314_cov_38.391770	776	856	2	19	80	0.2375000
NODE_3105_length_1314_cov_38.391770	776	856	4	27	80	0.3375000
NODE_3105_length_1314_cov_38.391770	776	856	6	27	80	0.3375000
NODE_3105_length_1314_cov_38.391770	829	909	0	2	80	0.0250000
NODE_3105_length_1314_cov_38.391770	829	909	2	7	80	0.0875000
NODE_3105_length_1314_cov_38.391770	829	909	4	55	80	0.6875000
NODE_3105_length_1314_cov_38.391770	829	909	6	16	80	0.2000000
NODE_3106_length_1314_cov_30.167078	736	816	4	33	80	0.4125000
NODE_3106_length_1314_cov_30.167078	736	816	6	47	80	0.5875000
NODE_3106_length_1314_cov_30.167078	789	869	0	30	80	0.3750000
NODE_3106_length_1314_cov_30.167078	789	869	2	13	80	0.1625000
NODE_3106_length_1314_cov_30.167078	789	869	4	34	80	0.4250000
NODE_3106_length_1314_cov_30.167078	789	869	6	3	80	0.0375000
NODE_3107_length_1314_cov_11.221399	523	603	4	26	80	0.3250000
NODE_3107_length_1314_cov_11.221399	523	603	6	54	80	0.6750000
NODE_3107_length_1314_cov_11.221399	576	656	4	62	80	0.7750000
NODE_3107_length_1314_cov_11.221399	576	656	6	18	80	0.2250000
NODE_3114_length_1313_cov_29.315486	463	543	8	80	80	1.0000000
NODE_3114_length_1313_cov_29.315486	516	596	0	40	80	0.5000000
NODE_3114_length_1313_cov_29.315486	516	596	8	40	80	0.5000000
NODE_3115_length_1313_cov_25.144975	709	789	0	15	80	0.1875000
NODE_3115_length_1313_cov_25.144975	709	789	2	57	80	0.7125000
NODE_3115_length_1313_cov_25.144975	709	789	4	8	80	0.1000000
NODE_3115_length_1313_cov_25.144975	762	842	2	50	80	0.6250000
NODE_3115_length_1313_cov_25.144975	762	842	4	30	80	0.3750000
NODE_3115_length_1313_cov_25.144975	838	918	0	58	80	0.7250000
NODE_3115_length_1313_cov_25.144975	838	918	2	22	80	0.2750000
NODE_3115_length_1313_cov_25.144975	891	971	0	80	80	1.0000000
NODE_3118_length_1312_cov_20.378401	138	218	0	49	80	0.6125000
NODE_3118_length_1312_cov_20.378401	138	218	1	1	80	0.0125000
NODE_3118_length_1312_cov_20.378401	138	218	2	8	80	0.1000000
NODE_3118_length_1312_cov_20.378401	138	218	4	22	80	0.2750000
NODE_3118_length_1312_cov_20.378401	191	271	2	5	80	0.0625000
NODE_3118_length_1312_cov_20.378401	191	271	4	75	80	0.9375000
NODE_3121_length_1311_cov_38.468647	584	664	0	16	80	0.2000000
NODE_3121_length_1311_cov_38.468647	584	664	2	20	80	0.2500000
NODE_3121_length_1311_cov_38.468647	584	664	4	11	80	0.1375000
NODE_3121_length_1311_cov_38.468647	584	664	6	5	80	0.0625000
NODE_3121_length_1311_cov_38.468647	584	664	10	28	80	0.3500000
NODE_3121_length_1311_cov_38.468647	637	717	0	11	80	0.1375000
NODE_3121_length_1311_cov_38.468647	637	717	2	5	80	0.0625000
NODE_3121_length_1311_cov_38.468647	637	717	4	2	80	0.0250000
NODE_3121_length_1311_cov_38.468647	637	717	6	1	80	0.0125000
NODE_3121_length_1311_cov_38.468647	637	717	8	2	80	0.0250000
NODE_3121_length_1311_cov_38.468647	637	717	10	59	80	0.7375000
NODE_3121_length_1311_cov_38.468647	713	793	0	51	80	0.6375000
NODE_3121_length_1311_cov_38.468647	713	793	2	23	80	0.2875000
NODE_3121_length_1311_cov_38.468647	713	793	4	6	80	0.0750000
NODE_3121_length_1311_cov_38.468647	766	846	2	22	80	0.2750000
NODE_3121_length_1311_cov_38.468647	766	846	4	58	80	0.7250000
NODE_3125_length_1310_cov_37.739884	679	759	4	12	80	0.1500000
NODE_3125_length_1310_cov_37.739884	679	759	8	36	80	0.4500000
NODE_3125_length_1310_cov_37.739884	679	759	12	2	80	0.0250000
NODE_3125_length_1310_cov_37.739884	679	759	14	30	80	0.3750000
NODE_3125_length_1310_cov_37.739884	683	763	4	8	80	0.1000000
NODE_3125_length_1310_cov_37.739884	683	763	8	36	80	0.4500000
NODE_3125_length_1310_cov_37.739884	683	763	12	2	80	0.0250000
NODE_3125_length_1310_cov_37.739884	683	763	14	34	80	0.4250000
NODE_3125_length_1310_cov_37.739884	732	816	4	5	84	0.0595238
NODE_3125_length_1310_cov_37.739884	732	816	6	1	84	0.0119048
NODE_3125_length_1310_cov_37.739884	732	816	10	32	84	0.3809524
NODE_3125_length_1310_cov_37.739884	732	816	14	46	84	0.5476190
NODE_3125_length_1310_cov_37.739884	736	816	4	5	80	0.0625000
NODE_3125_length_1310_cov_37.739884	736	816	6	1	80	0.0125000
NODE_3125_length_1310_cov_37.739884	736	816	10	32	80	0.4000000
NODE_3125_length_1310_cov_37.739884	736	816	14	42	80	0.5250000
NODE_3125_length_1310_cov_37.739884	812	892	2	9	80	0.1125000
NODE_3125_length_1310_cov_37.739884	812	892	4	38	80	0.4750000
NODE_3125_length_1310_cov_37.739884	812	892	6	32	80	0.4000000
NODE_3125_length_1310_cov_37.739884	812	892	8	1	80	0.0125000
NODE_3125_length_1310_cov_37.739884	865	945	4	26	80	0.3250000
NODE_3125_length_1310_cov_37.739884	865	945	6	40	80	0.5000000
NODE_3125_length_1310_cov_37.739884	865	945	8	14	80	0.1750000
NODE_3126_length_1310_cov_12.245252	615	695	0	80	80	1.0000000
NODE_3126_length_1310_cov_12.245252	668	748	0	80	80	1.0000000
NODE_3127_length_1310_cov_10.184971	422	502	0	80	80	1.0000000
NODE_3127_length_1310_cov_10.184971	475	555	0	80	80	1.0000000
NODE_3128_length_1310_cov_3.186623	876	956	0	80	80	1.0000000
NODE_3128_length_1310_cov_3.186623	929	1009	0	80	80	1.0000000
NODE_3131_length_1310_cov_0.757225	1255	1310	0	17	55	0.3090909
NODE_3131_length_1310_cov_0.757225	1255	1310	6	22	55	0.4000000
NODE_3131_length_1310_cov_0.757225	1255	1310	8	2	55	0.0363636
NODE_3131_length_1310_cov_0.757225	1255	1310	10	14	55	0.2545455
NODE_3132_length_1309_cov_34.942149	474	554	0	80	80	1.0000000
NODE_3132_length_1309_cov_34.942149	527	607	0	80	80	1.0000000
NODE_3132_length_1309_cov_34.942149	603	683	0	80	80	1.0000000
NODE_3132_length_1309_cov_34.942149	656	736	0	80	80	1.0000000
NODE_3133_length_1309_cov_10.571074	839	921	0	22	82	0.2682927
NODE_3133_length_1309_cov_10.571074	839	921	2	60	82	0.7317073
NODE_3133_length_1309_cov_10.571074	894	974	0	23	80	0.2875000
NODE_3133_length_1309_cov_10.571074	894	974	2	57	80	0.7125000
NODE_3135_length_1308_cov_43.461538	330	410	0	80	80	1.0000000
NODE_3135_length_1308_cov_43.461538	383	463	0	80	80	1.0000000
NODE_3145_length_1307_cov_11.290563	595	673	0	78	78	1.0000000
NODE_3145_length_1307_cov_11.290563	646	726	0	80	80	1.0000000
NODE_3146_length_1307_cov_8.653146	430	510	0	80	80	1.0000000
NODE_3146_length_1307_cov_8.653146	483	563	0	80	80	1.0000000
NODE_3153_length_1306_cov_26.813587	369	449	0	80	80	1.0000000
NODE_3153_length_1306_cov_26.813587	422	502	0	80	80	1.0000000
NODE_3153_length_1306_cov_26.813587	498	578	0	20	80	0.2500000
NODE_3153_length_1306_cov_26.813587	498	578	2	60	80	0.7500000
NODE_3153_length_1306_cov_26.813587	551	631	0	19	80	0.2375000
NODE_3153_length_1306_cov_26.813587	551	631	2	61	80	0.7625000
NODE_3154_length_1306_cov_24.904722	634	714	0	80	80	1.0000000
NODE_3154_length_1306_cov_24.904722	687	767	0	80	80	1.0000000
NODE_3155_length_1306_cov_18.274234	388	468	0	7	80	0.0875000
NODE_3155_length_1306_cov_18.274234	388	468	2	67	80	0.8375000
NODE_3155_length_1306_cov_18.274234	388	468	4	6	80	0.0750000
NODE_3155_length_1306_cov_18.274234	441	521	2	25	80	0.3125000
NODE_3155_length_1306_cov_18.274234	441	521	4	55	80	0.6875000
NODE_3156_length_1306_cov_15.176471	1214	1294	0	80	80	1.0000000
NODE_3157_length_1306_cov_12.699254	458	538	0	11	80	0.1375000
NODE_3157_length_1306_cov_12.699254	458	538	2	69	80	0.8625000
NODE_3157_length_1306_cov_12.699254	511	591	0	64	80	0.8000000
NODE_3157_length_1306_cov_12.699254	511	591	2	16	80	0.2000000
NODE_3158_length_1306_cov_9.958575	630	710	0	80	80	1.0000000
NODE_3158_length_1306_cov_9.958575	683	764	0	81	81	1.0000000
NODE_3159_length_1306_cov_2.739851	1206	1246	0	40	40	1.0000000
NODE_3168_length_1304_cov_28.444813	511	591	0	5	80	0.0625000
NODE_3168_length_1304_cov_28.444813	511	591	2	75	80	0.9375000
NODE_3168_length_1304_cov_28.444813	564	644	0	5	80	0.0625000
NODE_3168_length_1304_cov_28.444813	564	644	2	75	80	0.9375000
NODE_3168_length_1304_cov_28.444813	640	720	2	56	80	0.7000000
NODE_3168_length_1304_cov_28.444813	640	720	4	24	80	0.3000000
NODE_3168_length_1304_cov_28.444813	693	773	0	10	80	0.1250000
NODE_3168_length_1304_cov_28.444813	693	773	2	70	80	0.8750000
NODE_3169_length_1304_cov_27.137759	575	655	2	80	80	1.0000000
NODE_3169_length_1304_cov_27.137759	628	708	0	34	80	0.4250000
NODE_3169_length_1304_cov_27.137759	628	708	1	1	80	0.0125000
NODE_3169_length_1304_cov_27.137759	628	708	2	45	80	0.5625000
NODE_3169_length_1304_cov_27.137759	704	784	2	4	80	0.0500000
NODE_3169_length_1304_cov_27.137759	704	784	4	18	80	0.2250000
NODE_3169_length_1304_cov_27.137759	704	784	6	3	80	0.0375000
NODE_3169_length_1304_cov_27.137759	704	784	8	1	80	0.0125000
NODE_3169_length_1304_cov_27.137759	704	784	10	9	80	0.1125000
NODE_3169_length_1304_cov_27.137759	704	784	14	45	80	0.5625000
NODE_3169_length_1304_cov_27.137759	757	837	6	5	80	0.0625000
NODE_3169_length_1304_cov_27.137759	757	837	8	6	80	0.0750000
NODE_3169_length_1304_cov_27.137759	757	837	12	3	80	0.0375000
NODE_3169_length_1304_cov_27.137759	757	837	14	51	80	0.6375000
NODE_3169_length_1304_cov_27.137759	757	837	16	15	80	0.1875000
NODE_3171_length_1303_cov_36.546512	458	538	0	26	80	0.3250000
NODE_3171_length_1303_cov_36.546512	458	538	6	54	80	0.6750000
NODE_3171_length_1303_cov_36.546512	511	591	6	74	80	0.9250000
NODE_3171_length_1303_cov_36.546512	511	591	8	6	80	0.0750000
NODE_3171_length_1303_cov_36.546512	587	667	2	11	80	0.1375000
NODE_3171_length_1303_cov_36.546512	587	667	4	60	80	0.7500000
NODE_3171_length_1303_cov_36.546512	587	667	8	9	80	0.1125000
NODE_3171_length_1303_cov_36.546512	640	720	0	46	80	0.5750000
NODE_3171_length_1303_cov_36.546512	640	720	2	10	80	0.1250000
NODE_3171_length_1303_cov_36.546512	640	720	4	24	80	0.3000000
NODE_3174_length_1302_cov_22.265170	747	827	0	39	80	0.4875000
NODE_3174_length_1302_cov_22.265170	747	827	2	41	80	0.5125000
NODE_3174_length_1302_cov_22.265170	800	880	0	80	80	1.0000000
NODE_3175_length_1302_cov_16.199501	480	560	0	11	80	0.1375000
NODE_3175_length_1302_cov_16.199501	480	560	2	51	80	0.6375000
NODE_3175_length_1302_cov_16.199501	480	560	4	18	80	0.2250000
NODE_3175_length_1302_cov_16.199501	533	613	2	62	80	0.7750000
NODE_3175_length_1302_cov_16.199501	533	613	4	18	80	0.2250000
NODE_3176_length_1302_cov_6.953450	687	767	0	19	80	0.2375000
NODE_3176_length_1302_cov_6.953450	687	767	2	61	80	0.7625000
NODE_3176_length_1302_cov_6.953450	740	820	0	2	80	0.0250000
NODE_3176_length_1302_cov_6.953450	740	820	2	78	80	0.9750000
NODE_3179_length_1301_cov_31.711314	401	481	2	29	80	0.3625000
NODE_3179_length_1301_cov_31.711314	401	481	4	51	80	0.6375000
NODE_3179_length_1301_cov_31.711314	454	534	2	43	80	0.5375000
NODE_3179_length_1301_cov_31.711314	454	534	4	37	80	0.4625000
NODE_3181_length_1301_cov_5.529950	246	326	0	80	80	1.0000000
NODE_3181_length_1301_cov_5.529950	299	379	0	63	80	0.7875000
NODE_3181_length_1301_cov_5.529950	299	379	2	17	80	0.2125000
NODE_3186_length_1300_cov_39.109908	602	682	2	19	80	0.2375000
NODE_3186_length_1300_cov_39.109908	602	682	4	61	80	0.7625000
NODE_3186_length_1300_cov_39.109908	655	735	2	42	80	0.5250000
NODE_3186_length_1300_cov_39.109908	655	735	4	38	80	0.4750000
NODE_3187_length_1300_cov_34.360533	586	666	0	22	80	0.2750000
NODE_3187_length_1300_cov_34.360533	586	666	4	23	80	0.2875000
NODE_3187_length_1300_cov_34.360533	586	666	6	35	80	0.4375000
NODE_3187_length_1300_cov_34.360533	639	719	0	30	80	0.3750000
NODE_3187_length_1300_cov_34.360533	639	719	2	17	80	0.2125000
NODE_3187_length_1300_cov_34.360533	639	719	6	33	80	0.4125000
NODE_3188_length_1300_cov_4.659450	454	535	0	81	81	1.0000000
NODE_3188_length_1300_cov_4.659450	508	588	0	80	80	1.0000000
NODE_3189_length_1299_cov_29.071667	452	532	0	2	80	0.0250000
NODE_3189_length_1299_cov_29.071667	452	532	2	36	80	0.4500000
NODE_3189_length_1299_cov_29.071667	452	532	4	9	80	0.1125000
NODE_3189_length_1299_cov_29.071667	452	532	6	17	80	0.2125000
NODE_3189_length_1299_cov_29.071667	452	532	8	16	80	0.2000000
NODE_3190_length_1299_cov_23.600833	818	898	0	72	80	0.9000000
NODE_3190_length_1299_cov_23.600833	818	898	2	8	80	0.1000000
NODE_3190_length_1299_cov_23.600833	871	951	0	27	80	0.3375000
NODE_3190_length_1299_cov_23.600833	871	951	2	53	80	0.6625000
NODE_3191_length_1299_cov_23.169167	625	705	0	80	80	1.0000000
NODE_3191_length_1299_cov_23.169167	678	758	0	80	80	1.0000000
NODE_3191_length_1299_cov_23.169167	754	834	0	80	80	1.0000000
NODE_3191_length_1299_cov_23.169167	807	887	0	80	80	1.0000000
NODE_3192_length_1299_cov_19.315000	306	386	0	80	80	1.0000000
NODE_3192_length_1299_cov_19.315000	359	439	0	80	80	1.0000000
NODE_3192_length_1299_cov_19.315000	435	515	0	58	80	0.7250000
NODE_3192_length_1299_cov_19.315000	435	515	2	22	80	0.2750000
NODE_3192_length_1299_cov_19.315000	488	568	0	5	80	0.0625000
NODE_3192_length_1299_cov_19.315000	488	568	2	75	80	0.9375000
NODE_3193_length_1299_cov_13.691667	540	620	8	80	80	1.0000000
NODE_3193_length_1299_cov_13.691667	593	673	0	7	80	0.0875000
NODE_3193_length_1299_cov_13.691667	593	673	6	1	80	0.0125000
NODE_3193_length_1299_cov_13.691667	593	673	8	72	80	0.9000000
NODE_3195_length_1298_cov_58.277731	679	759	0	80	80	1.0000000
NODE_3195_length_1298_cov_58.277731	732	812	0	80	80	1.0000000
NODE_3195_length_1298_cov_58.277731	808	888	0	80	80	1.0000000
NODE_3195_length_1298_cov_58.277731	861	941	0	80	80	1.0000000
NODE_3196_length_1298_cov_31.319433	375	455	0	80	80	1.0000000
NODE_3196_length_1298_cov_31.319433	428	508	0	80	80	1.0000000
NODE_3196_length_1298_cov_31.319433	504	584	0	80	80	1.0000000
NODE_3196_length_1298_cov_31.319433	557	637	0	80	80	1.0000000
NODE_3197_length_1298_cov_2.158465	294	360	0	66	66	1.0000000
NODE_3201_length_1296_cov_34.778613	620	700	0	20	80	0.2500000
NODE_3201_length_1296_cov_34.778613	620	700	2	25	80	0.3125000
NODE_3201_length_1296_cov_34.778613	620	700	4	10	80	0.1250000
NODE_3201_length_1296_cov_34.778613	620	700	10	23	80	0.2875000
NODE_3201_length_1296_cov_34.778613	620	700	12	2	80	0.0250000
NODE_3201_length_1296_cov_34.778613	673	753	2	15	80	0.1875000
NODE_3201_length_1296_cov_34.778613	673	753	4	2	80	0.0250000
NODE_3201_length_1296_cov_34.778613	673	753	8	6	80	0.0750000
NODE_3201_length_1296_cov_34.778613	673	753	10	52	80	0.6500000
NODE_3201_length_1296_cov_34.778613	673	753	12	5	80	0.0625000
NODE_3202_length_1296_cov_28.726817	671	751	0	80	80	1.0000000
NODE_3202_length_1296_cov_28.726817	724	804	0	80	80	1.0000000
NODE_3202_length_1296_cov_28.726817	800	880	0	35	80	0.4375000
NODE_3202_length_1296_cov_28.726817	800	880	2	45	80	0.5625000
NODE_3202_length_1296_cov_28.726817	853	933	0	19	80	0.2375000
NODE_3202_length_1296_cov_28.726817	853	933	2	61	80	0.7625000
NODE_3205_length_1295_cov_10.661371	818	898	0	68	80	0.8500000
NODE_3205_length_1295_cov_10.661371	818	898	2	12	80	0.1500000
NODE_3205_length_1295_cov_10.661371	871	951	0	15	80	0.1875000
NODE_3205_length_1295_cov_10.661371	871	951	2	65	80	0.8125000
NODE_3211_length_1294_cov_15.098745	353	433	0	13	80	0.1625000
NODE_3211_length_1294_cov_15.098745	353	433	4	18	80	0.2250000
NODE_3211_length_1294_cov_15.098745	353	433	6	49	80	0.6125000
NODE_3211_length_1294_cov_15.098745	406	486	0	9	80	0.1125000
NODE_3211_length_1294_cov_15.098745	406	486	4	36	80	0.4500000
NODE_3211_length_1294_cov_15.098745	406	486	6	35	80	0.4375000
NODE_3216_length_1293_cov_26.580402	595	675	5	80	80	1.0000000
NODE_3216_length_1293_cov_26.580402	648	728	3	24	80	0.3000000
NODE_3216_length_1293_cov_26.580402	648	728	5	54	80	0.6750000
NODE_3216_length_1293_cov_26.580402	648	728	7	2	80	0.0250000
NODE_3216_length_1293_cov_26.580402	724	804	1	22	80	0.2750000
NODE_3216_length_1293_cov_26.580402	724	804	3	12	80	0.1500000
NODE_3216_length_1293_cov_26.580402	724	804	4	16	80	0.2000000
NODE_3216_length_1293_cov_26.580402	724	804	5	30	80	0.3750000
NODE_3216_length_1293_cov_26.580402	777	857	1	75	80	0.9375000
NODE_3216_length_1293_cov_26.580402	777	857	3	5	80	0.0625000
NODE_3217_length_1293_cov_9.252094	1187	1207	0	20	20	1.0000000
NODE_3220_length_1293_cov_2.118090	1131	1195	0	18	64	0.2812500
NODE_3220_length_1293_cov_2.118090	1131	1195	2	46	64	0.7187500
NODE_3220_length_1293_cov_2.118090	1184	1248	0	26	64	0.4062500
NODE_3220_length_1293_cov_2.118090	1184	1248	2	38	64	0.5937500
NODE_3224_length_1292_cov_50.158424	402	482	2	10	80	0.1250000
NODE_3224_length_1292_cov_50.158424	402	482	4	30	80	0.3750000
NODE_3224_length_1292_cov_50.158424	402	482	6	40	80	0.5000000
NODE_3224_length_1292_cov_50.158424	455	535	0	20	80	0.2500000
NODE_3224_length_1292_cov_50.158424	455	535	2	14	80	0.1750000
NODE_3224_length_1292_cov_50.158424	455	535	4	2	80	0.0250000
NODE_3224_length_1292_cov_50.158424	455	535	6	44	80	0.5500000
NODE_3224_length_1292_cov_50.158424	531	611	0	26	80	0.3250000
NODE_3224_length_1292_cov_50.158424	531	611	2	54	80	0.6750000
NODE_3224_length_1292_cov_50.158424	584	664	2	73	80	0.9125000
NODE_3224_length_1292_cov_50.158424	584	664	4	7	80	0.0875000
NODE_3225_length_1292_cov_36.535624	670	750	0	23	80	0.2875000
NODE_3225_length_1292_cov_36.535624	670	750	2	4	80	0.0500000
NODE_3225_length_1292_cov_36.535624	670	750	4	38	80	0.4750000
NODE_3225_length_1292_cov_36.535624	670	750	6	15	80	0.1875000
NODE_3225_length_1292_cov_36.535624	723	803	2	7	80	0.0875000
NODE_3225_length_1292_cov_36.535624	723	803	4	21	80	0.2625000
NODE_3225_length_1292_cov_36.535624	723	803	6	52	80	0.6500000
NODE_3226_length_1292_cov_24.523889	420	500	2	29	80	0.3625000
NODE_3226_length_1292_cov_24.523889	420	500	6	51	80	0.6375000
NODE_3226_length_1292_cov_24.523889	473	553	2	13	80	0.1625000
NODE_3226_length_1292_cov_24.523889	473	553	3	12	80	0.1500000
NODE_3226_length_1292_cov_24.523889	473	553	4	11	80	0.1375000
NODE_3226_length_1292_cov_24.523889	473	553	6	44	80	0.5500000
NODE_3232_length_1291_cov_8.734060	623	703	0	80	80	1.0000000
NODE_3232_length_1291_cov_8.734060	676	756	0	80	80	1.0000000
NODE_3233_length_1291_cov_8.625839	756	836	0	80	80	1.0000000
NODE_3233_length_1291_cov_8.625839	809	889	0	69	80	0.8625000
NODE_3233_length_1291_cov_8.625839	809	889	2	9	80	0.1125000
NODE_3233_length_1291_cov_8.625839	809	889	4	2	80	0.0250000
NODE_3236_length_1290_cov_24.120067	497	577	0	80	80	1.0000000
NODE_3236_length_1290_cov_24.120067	550	630	0	80	80	1.0000000
NODE_3236_length_1290_cov_24.120067	626	706	0	38	80	0.4750000
NODE_3236_length_1290_cov_24.120067	626	706	2	12	80	0.1500000
NODE_3236_length_1290_cov_24.120067	626	706	4	30	80	0.3750000
NODE_3236_length_1290_cov_24.120067	679	759	4	80	80	1.0000000
NODE_3237_length_1290_cov_18.874895	671	751	2	33	80	0.4125000
NODE_3237_length_1290_cov_18.874895	671	751	6	47	80	0.5875000
NODE_3237_length_1290_cov_18.874895	724	804	0	20	80	0.2500000
NODE_3237_length_1290_cov_18.874895	724	804	4	14	80	0.1750000
NODE_3237_length_1290_cov_18.874895	724	804	6	46	80	0.5750000
NODE_3238_length_1290_cov_11.627204	573	653	0	24	80	0.3000000
NODE_3238_length_1290_cov_11.627204	573	653	4	10	80	0.1250000
NODE_3238_length_1290_cov_11.627204	573	653	6	46	80	0.5750000
NODE_3238_length_1290_cov_11.627204	626	706	4	21	80	0.2625000
NODE_3238_length_1290_cov_11.627204	626	706	6	59	80	0.7375000
NODE_3239_length_1290_cov_11.215785	373	453	0	80	80	1.0000000
NODE_3239_length_1290_cov_11.215785	426	506	0	80	80	1.0000000
NODE_3240_length_1290_cov_8.752309	788	868	0	8	80	0.1000000
NODE_3240_length_1290_cov_8.752309	788	868	2	31	80	0.3875000
NODE_3240_length_1290_cov_8.752309	788	868	4	41	80	0.5125000
NODE_3240_length_1290_cov_8.752309	841	921	0	8	80	0.1000000
NODE_3240_length_1290_cov_8.752309	841	921	2	18	80	0.2250000
NODE_3240_length_1290_cov_8.752309	841	921	4	54	80	0.6750000
NODE_3242_length_1289_cov_47.476471	919	999	2	10	80	0.1250000
NODE_3242_length_1289_cov_47.476471	919	999	4	10	80	0.1250000
NODE_3242_length_1289_cov_47.476471	919	999	6	8	80	0.1000000
NODE_3242_length_1289_cov_47.476471	919	999	8	52	80	0.6500000
NODE_3242_length_1289_cov_47.476471	972	1052	0	8	80	0.1000000
NODE_3242_length_1289_cov_47.476471	972	1052	2	32	80	0.4000000
NODE_3242_length_1289_cov_47.476471	972	1052	4	2	80	0.0250000
NODE_3242_length_1289_cov_47.476471	972	1052	6	12	80	0.1500000
NODE_3242_length_1289_cov_47.476471	972	1052	8	26	80	0.3250000
NODE_3243_length_1289_cov_18.497479	688	768	0	23	80	0.2875000
NODE_3243_length_1289_cov_18.497479	688	768	2	57	80	0.7125000
NODE_3243_length_1289_cov_18.497479	741	821	0	76	80	0.9500000
NODE_3243_length_1289_cov_18.497479	741	821	2	4	80	0.0500000
NODE_3243_length_1289_cov_18.497479	817	893	0	76	76	1.0000000
NODE_3243_length_1289_cov_18.497479	878	958	0	80	80	1.0000000
NODE_3244_length_1289_cov_11.692437	574	654	0	80	80	1.0000000
NODE_3244_length_1289_cov_11.692437	627	707	0	80	80	1.0000000
NODE_3244_length_1289_cov_11.692437	703	783	0	12	80	0.1500000
NODE_3244_length_1289_cov_11.692437	703	783	2	68	80	0.8500000
NODE_3244_length_1289_cov_11.692437	756	836	0	41	80	0.5125000
NODE_3244_length_1289_cov_11.692437	756	836	2	39	80	0.4875000
NODE_3249_length_1288_cov_29.369218	711	791	0	78	80	0.9750000
NODE_3249_length_1288_cov_29.369218	711	791	2	2	80	0.0250000
NODE_3249_length_1288_cov_29.369218	764	844	0	25	80	0.3125000
NODE_3249_length_1288_cov_29.369218	764	844	2	55	80	0.6875000
NODE_3250_length_1288_cov_6.207738	735	815	0	43	80	0.5375000
NODE_3250_length_1288_cov_6.207738	735	815	2	37	80	0.4625000
NODE_3250_length_1288_cov_6.207738	788	868	2	34	80	0.4250000
NODE_3250_length_1288_cov_6.207738	788	868	4	46	80	0.5750000
NODE_3255_length_1288_cov_1.731707	1017	1095	4	7	78	0.0897436
NODE_3255_length_1288_cov_1.731707	1017	1095	6	4	78	0.0512821
NODE_3255_length_1288_cov_1.731707	1017	1095	8	18	78	0.2307692
NODE_3255_length_1288_cov_1.731707	1017	1095	10	24	78	0.3076923
NODE_3255_length_1288_cov_1.731707	1017	1095	12	6	78	0.0769231
NODE_3255_length_1288_cov_1.731707	1017	1095	14	19	78	0.2435897
NODE_3261_length_1287_cov_29.186027	730	810	0	80	80	1.0000000
NODE_3261_length_1287_cov_29.186027	783	863	0	80	80	1.0000000
NODE_3262_length_1287_cov_22.747475	168	248	0	28	80	0.3500000
NODE_3262_length_1287_cov_22.747475	168	248	2	52	80	0.6500000
NODE_3262_length_1287_cov_22.747475	221	301	2	68	80	0.8500000
NODE_3262_length_1287_cov_22.747475	221	301	4	12	80	0.1500000
NODE_3263_length_1287_cov_19.478956	575	655	0	13	80	0.1625000
NODE_3263_length_1287_cov_19.478956	575	655	2	67	80	0.8375000
NODE_3263_length_1287_cov_19.478956	628	708	0	66	80	0.8250000
NODE_3263_length_1287_cov_19.478956	628	708	2	14	80	0.1750000
NODE_3266_length_1286_cov_27.128054	428	508	0	24	80	0.3000000
NODE_3266_length_1286_cov_27.128054	428	508	2	56	80	0.7000000
NODE_3266_length_1286_cov_27.128054	481	561	0	56	80	0.7000000
NODE_3266_length_1286_cov_27.128054	481	561	2	3	80	0.0375000
NODE_3266_length_1286_cov_27.128054	481	561	4	21	80	0.2625000
NODE_3266_length_1286_cov_27.128054	557	637	4	80	80	1.0000000
NODE_3266_length_1286_cov_27.128054	610	690	0	45	80	0.5625000
NODE_3266_length_1286_cov_27.128054	610	690	4	35	80	0.4375000
NODE_3267_length_1286_cov_12.192081	647	727	0	11	80	0.1375000
NODE_3267_length_1286_cov_12.192081	647	727	2	69	80	0.8625000
NODE_3267_length_1286_cov_12.192081	700	780	0	43	80	0.5375000
NODE_3267_length_1286_cov_12.192081	700	780	2	37	80	0.4625000
NODE_3267_length_1286_cov_12.192081	776	856	0	80	80	1.0000000
NODE_3267_length_1286_cov_12.192081	829	909	0	34	80	0.4250000
NODE_3267_length_1286_cov_12.192081	829	909	2	42	80	0.5250000
NODE_3267_length_1286_cov_12.192081	829	909	4	4	80	0.0500000
NODE_3268_length_1286_cov_8.338669	577	657	0	39	80	0.4875000
NODE_3268_length_1286_cov_8.338669	577	657	2	14	80	0.1750000
NODE_3268_length_1286_cov_8.338669	577	657	4	27	80	0.3375000
NODE_3268_length_1286_cov_8.338669	630	710	2	9	80	0.1125000
NODE_3268_length_1286_cov_8.338669	630	710	4	71	80	0.8875000
NODE_3273_length_1285_cov_40.282462	751	831	0	47	80	0.5875000
NODE_3273_length_1285_cov_40.282462	751	831	2	33	80	0.4125000
NODE_3273_length_1285_cov_40.282462	804	884	0	1	80	0.0125000
NODE_3273_length_1285_cov_40.282462	804	884	2	79	80	0.9875000
NODE_3274_length_1285_cov_15.422428	647	727	0	80	80	1.0000000
NODE_3274_length_1285_cov_15.422428	700	780	0	42	80	0.5250000
NODE_3274_length_1285_cov_15.422428	700	780	2	38	80	0.4750000
NODE_3275_length_1285_cov_6.620573	589	669	0	8	80	0.1000000
NODE_3275_length_1285_cov_6.620573	589	669	6	26	80	0.3250000
NODE_3275_length_1285_cov_6.620573	589	669	8	46	80	0.5750000
NODE_3275_length_1285_cov_6.620573	642	722	2	31	80	0.3875000
NODE_3275_length_1285_cov_6.620573	642	722	7	1	80	0.0125000
NODE_3275_length_1285_cov_6.620573	642	722	8	48	80	0.6000000
NODE_3279_length_1284_cov_5.637975	294	374	0	80	80	1.0000000
NODE_3279_length_1284_cov_5.637975	347	427	0	80	80	1.0000000
NODE_3283_length_1283_cov_10.070101	408	488	3	80	80	1.0000000
NODE_3283_length_1283_cov_10.070101	461	541	0	4	80	0.0500000
NODE_3283_length_1283_cov_10.070101	461	541	3	76	80	0.9500000
NODE_3288_length_1282_cov_37.786137	649	729	0	35	80	0.4375000
NODE_3288_length_1282_cov_37.786137	649	729	2	2	80	0.0250000
NODE_3288_length_1282_cov_37.786137	649	729	4	43	80	0.5375000
NODE_3288_length_1282_cov_37.786137	702	782	0	4	80	0.0500000
NODE_3288_length_1282_cov_37.786137	702	782	2	31	80	0.3875000
NODE_3288_length_1282_cov_37.786137	702	782	4	45	80	0.5625000
NODE_3288_length_1282_cov_37.786137	778	858	0	16	80	0.2000000
NODE_3288_length_1282_cov_37.786137	778	858	1	10	80	0.1250000
NODE_3288_length_1282_cov_37.786137	778	858	2	54	80	0.6750000
NODE_3288_length_1282_cov_37.786137	831	911	2	77	80	0.9625000
NODE_3288_length_1282_cov_37.786137	831	911	3	2	80	0.0250000
NODE_3288_length_1282_cov_37.786137	831	911	4	1	80	0.0125000
NODE_3289_length_1282_cov_25.900254	85	167	4	5	82	0.0609756
NODE_3289_length_1282_cov_25.900254	85	167	8	2	82	0.0243902
NODE_3289_length_1282_cov_25.900254	85	167	10	2	82	0.0243902
NODE_3289_length_1282_cov_25.900254	85	167	21	8	82	0.0975610
NODE_3289_length_1282_cov_25.900254	85	167	23	5	82	0.0609756
NODE_3289_length_1282_cov_25.900254	85	167	25	9	82	0.1097561
NODE_3289_length_1282_cov_25.900254	85	167	27	6	82	0.0731707
NODE_3289_length_1282_cov_25.900254	85	167	28	1	82	0.0121951
NODE_3289_length_1282_cov_25.900254	85	167	33	4	82	0.0487805
NODE_3289_length_1282_cov_25.900254	85	167	37	6	82	0.0731707
NODE_3289_length_1282_cov_25.900254	85	167	38	10	82	0.1219512
NODE_3289_length_1282_cov_25.900254	85	167	41	24	82	0.2926829
NODE_3289_length_1282_cov_25.900254	140	183	0	1	43	0.0232558
NODE_3289_length_1282_cov_25.900254	140	183	2	15	43	0.3488372
NODE_3289_length_1282_cov_25.900254	140	183	4	5	43	0.1162791
NODE_3289_length_1282_cov_25.900254	140	183	8	2	43	0.0465116
NODE_3289_length_1282_cov_25.900254	140	183	10	2	43	0.0465116
NODE_3289_length_1282_cov_25.900254	140	183	21	8	43	0.1860465
NODE_3289_length_1282_cov_25.900254	140	183	23	5	43	0.1162791
NODE_3289_length_1282_cov_25.900254	140	183	25	5	43	0.1162791
NODE_3289_length_1282_cov_25.900254	1006	1086	2	80	80	1.0000000
NODE_3289_length_1282_cov_25.900254	1006	1086	2	80	80	1.0000000
NODE_3289_length_1282_cov_25.900254	1015	1086	2	71	71	1.0000000
NODE_3290_length_1282_cov_14.600169	429	477	0	48	48	1.0000000
NODE_3290_length_1282_cov_14.600169	708	788	0	80	80	1.0000000
NODE_3291_length_1282_cov_8.017751	343	420	2	18	77	0.2337662
NODE_3291_length_1282_cov_8.017751	343	420	4	59	77	0.7662337
NODE_3292_length_1282_cov_5.092984	239	319	8	3	80	0.0375000
NODE_3292_length_1282_cov_5.092984	239	319	10	35	80	0.4375000
NODE_3292_length_1282_cov_5.092984	239	319	12	30	80	0.3750000
NODE_3292_length_1282_cov_5.092984	239	319	13	7	80	0.0875000
NODE_3292_length_1282_cov_5.092984	239	319	14	5	80	0.0625000
NODE_3292_length_1282_cov_5.092984	292	372	0	46	80	0.5750000
NODE_3292_length_1282_cov_5.092984	292	372	4	6	80	0.0750000
NODE_3292_length_1282_cov_5.092984	292	372	8	4	80	0.0500000
NODE_3292_length_1282_cov_5.092984	292	372	10	24	80	0.3000000
NODE_3295_length_1281_cov_31.342640	470	550	4	62	80	0.7750000
NODE_3295_length_1281_cov_31.342640	470	550	6	18	80	0.2250000
NODE_3295_length_1281_cov_31.342640	523	603	0	11	80	0.1375000
NODE_3295_length_1281_cov_31.342640	523	603	4	69	80	0.8625000
NODE_3295_length_1281_cov_31.342640	599	679	0	80	80	1.0000000
NODE_3295_length_1281_cov_31.342640	652	732	0	80	80	1.0000000
NODE_3296_length_1281_cov_25.482234	474	554	4	3	80	0.0375000
NODE_3296_length_1281_cov_25.482234	474	554	6	1	80	0.0125000
NODE_3296_length_1281_cov_25.482234	474	554	7	11	80	0.1375000
NODE_3296_length_1281_cov_25.482234	474	554	9	28	80	0.3500000
NODE_3296_length_1281_cov_25.482234	474	554	11	37	80	0.4625000
NODE_3296_length_1281_cov_25.482234	527	607	1	9	80	0.1125000
NODE_3296_length_1281_cov_25.482234	527	607	3	5	80	0.0625000
NODE_3296_length_1281_cov_25.482234	527	607	5	19	80	0.2375000
NODE_3296_length_1281_cov_25.482234	527	607	9	27	80	0.3375000
NODE_3296_length_1281_cov_25.482234	527	607	11	20	80	0.2500000
NODE_3297_length_1281_cov_14.617597	809	887	0	78	78	1.0000000
NODE_3297_length_1281_cov_14.617597	860	940	0	80	80	1.0000000
NODE_3298_length_1281_cov_12.065144	655	735	0	3	80	0.0375000
NODE_3298_length_1281_cov_12.065144	655	735	2	77	80	0.9625000
NODE_3298_length_1281_cov_12.065144	708	788	0	12	80	0.1500000
NODE_3298_length_1281_cov_12.065144	708	788	2	68	80	0.8500000
NODE_3299_length_1281_cov_9.235195	408	488	0	18	80	0.2250000
NODE_3299_length_1281_cov_9.235195	408	488	2	21	80	0.2625000
NODE_3299_length_1281_cov_9.235195	408	488	5	2	80	0.0250000
NODE_3299_length_1281_cov_9.235195	408	488	7	39	80	0.4875000
NODE_3299_length_1281_cov_9.235195	461	541	0	2	80	0.0250000
NODE_3299_length_1281_cov_9.235195	461	541	5	1	80	0.0125000
NODE_3299_length_1281_cov_9.235195	461	541	7	77	80	0.9625000
NODE_3300_length_1281_cov_7.153976	469	549	0	61	80	0.7625000
NODE_3300_length_1281_cov_7.153976	469	549	2	19	80	0.2375000
NODE_3300_length_1281_cov_7.153976	522	602	0	80	80	1.0000000
NODE_3307_length_1280_cov_24.231160	418	498	0	10	80	0.1250000
NODE_3307_length_1280_cov_24.231160	418	498	2	70	80	0.8750000
NODE_3307_length_1280_cov_24.231160	471	551	0	35	80	0.4375000
NODE_3307_length_1280_cov_24.231160	471	551	2	45	80	0.5625000
NODE_3307_length_1280_cov_24.231160	547	627	0	80	80	1.0000000
NODE_3307_length_1280_cov_24.231160	600	680	0	80	80	1.0000000
NODE_3308_length_1280_cov_5.908552	1077	1138	18	3	61	0.0491803
NODE_3308_length_1280_cov_5.908552	1077	1138	20	7	61	0.1147541
NODE_3308_length_1280_cov_5.908552	1077	1138	24	1	61	0.0163934
NODE_3308_length_1280_cov_5.908552	1077	1138	28	1	61	0.0163934
NODE_3308_length_1280_cov_5.908552	1077	1138	32	3	61	0.0491803
NODE_3308_length_1280_cov_5.908552	1077	1138	34	2	61	0.0327869
NODE_3308_length_1280_cov_5.908552	1077	1138	38	1	61	0.0163934
NODE_3308_length_1280_cov_5.908552	1077	1138	39	3	61	0.0491803
NODE_3308_length_1280_cov_5.908552	1077	1138	55	2	61	0.0327869
NODE_3308_length_1280_cov_5.908552	1077	1138	57	2	61	0.0327869
NODE_3308_length_1280_cov_5.908552	1077	1138	58	5	61	0.0819672
NODE_3308_length_1280_cov_5.908552	1077	1138	68	5	61	0.0819672
NODE_3308_length_1280_cov_5.908552	1077	1138	70	3	61	0.0491803
NODE_3308_length_1280_cov_5.908552	1077	1138	74	2	61	0.0327869
NODE_3308_length_1280_cov_5.908552	1077	1138	76	2	61	0.0327869
NODE_3308_length_1280_cov_5.908552	1077	1138	78	4	61	0.0655738
NODE_3308_length_1280_cov_5.908552	1077	1138	82	1	61	0.0163934
NODE_3308_length_1280_cov_5.908552	1077	1138	94	3	61	0.0491803
NODE_3308_length_1280_cov_5.908552	1077	1138	96	4	61	0.0655738
NODE_3308_length_1280_cov_5.908552	1077	1138	98	2	61	0.0327869
NODE_3308_length_1280_cov_5.908552	1077	1138	102	1	61	0.0163934
NODE_3308_length_1280_cov_5.908552	1077	1138	104	1	61	0.0163934
NODE_3308_length_1280_cov_5.908552	1077	1138	106	3	61	0.0491803
NODE_3311_length_1279_cov_16.840678	749	829	2	19	80	0.2375000
NODE_3311_length_1279_cov_16.840678	749	829	4	51	80	0.6375000
NODE_3311_length_1279_cov_16.840678	749	829	6	10	80	0.1250000
NODE_3311_length_1279_cov_16.840678	802	882	0	39	80	0.4875000
NODE_3311_length_1279_cov_16.840678	802	882	4	41	80	0.5125000
NODE_3312_length_1279_cov_3.772881	951	981	6	30	30	1.0000000
NODE_3317_length_1278_cov_45.991518	411	491	0	80	80	1.0000000
NODE_3317_length_1278_cov_45.991518	464	530	0	66	66	1.0000000
NODE_3318_length_1278_cov_37.164546	447	527	0	40	80	0.5000000
NODE_3318_length_1278_cov_37.164546	447	527	2	40	80	0.5000000
NODE_3318_length_1278_cov_37.164546	500	580	0	51	80	0.6375000
NODE_3318_length_1278_cov_37.164546	500	580	4	21	80	0.2625000
NODE_3318_length_1278_cov_37.164546	500	580	6	8	80	0.1000000
NODE_3318_length_1278_cov_37.164546	576	656	2	6	80	0.0750000
NODE_3318_length_1278_cov_37.164546	576	656	4	2	80	0.0250000
NODE_3318_length_1278_cov_37.164546	576	656	5	1	80	0.0125000
NODE_3318_length_1278_cov_37.164546	576	656	6	11	80	0.1375000
NODE_3318_length_1278_cov_37.164546	576	656	8	60	80	0.7500000
NODE_3318_length_1278_cov_37.164546	629	709	0	1	80	0.0125000
NODE_3318_length_1278_cov_37.164546	629	709	2	56	80	0.7000000
NODE_3318_length_1278_cov_37.164546	629	709	4	4	80	0.0500000
NODE_3318_length_1278_cov_37.164546	629	709	5	1	80	0.0125000
NODE_3318_length_1278_cov_37.164546	629	709	6	4	80	0.0500000
NODE_3318_length_1278_cov_37.164546	629	709	8	14	80	0.1750000
NODE_3319_length_1278_cov_12.505513	522	602	0	26	80	0.3250000
NODE_3319_length_1278_cov_12.505513	522	602	2	54	80	0.6750000
NODE_3319_length_1278_cov_12.505513	575	655	0	35	80	0.4375000
NODE_3319_length_1278_cov_12.505513	575	655	2	45	80	0.5625000
NODE_3320_length_1278_cov_12.171332	212	292	0	70	80	0.8750000
NODE_3320_length_1278_cov_12.171332	212	292	2	3	80	0.0375000
NODE_3320_length_1278_cov_12.171332	212	292	4	7	80	0.0875000
NODE_3320_length_1278_cov_12.171332	265	344	0	17	79	0.2151899
NODE_3320_length_1278_cov_12.171332	265	344	2	3	79	0.0379747
NODE_3320_length_1278_cov_12.171332	265	344	4	59	79	0.7468355
NODE_3329_length_1277_cov_21.407470	667	717	0	50	50	1.0000000
NODE_3329_length_1277_cov_21.407470	690	770	0	27	80	0.3375000
NODE_3329_length_1277_cov_21.407470	690	770	2	53	80	0.6625000
NODE_3330_length_1277_cov_18.111205	834	914	0	4	80	0.0500000
NODE_3330_length_1277_cov_18.111205	834	914	1	54	80	0.6750000
NODE_3330_length_1277_cov_18.111205	834	914	2	22	80	0.2750000
NODE_3330_length_1277_cov_18.111205	887	967	1	80	80	1.0000000
NODE_3331_length_1277_cov_12.449066	276	356	0	80	80	1.0000000
NODE_3331_length_1277_cov_12.449066	329	409	0	64	80	0.8000000
NODE_3331_length_1277_cov_12.449066	329	409	2	16	80	0.2000000
NODE_3331_length_1277_cov_12.449066	405	485	2	51	80	0.6375000
NODE_3331_length_1277_cov_12.449066	405	485	4	29	80	0.3625000
NODE_3331_length_1277_cov_12.449066	458	538	2	53	80	0.6625000
NODE_3331_length_1277_cov_12.449066	458	538	4	27	80	0.3375000
NODE_3337_length_1276_cov_21.446899	526	606	0	3	80	0.0375000
NODE_3337_length_1276_cov_21.446899	526	606	2	45	80	0.5625000
NODE_3337_length_1276_cov_21.446899	526	606	4	32	80	0.4000000
NODE_3337_length_1276_cov_21.446899	579	659	0	56	80	0.7000000
NODE_3337_length_1276_cov_21.446899	579	659	2	24	80	0.3000000
NODE_3337_length_1276_cov_21.446899	655	735	0	80	80	1.0000000
NODE_3337_length_1276_cov_21.446899	708	788	0	80	80	1.0000000
NODE_3346_length_1275_cov_35.471939	632	712	0	9	80	0.1125000
NODE_3346_length_1275_cov_35.471939	632	712	2	71	80	0.8875000
NODE_3346_length_1275_cov_35.471939	685	765	0	55	80	0.6875000
NODE_3346_length_1275_cov_35.471939	685	765	2	25	80	0.3125000
NODE_3347_length_1275_cov_19.910714	361	441	2	80	80	1.0000000
NODE_3347_length_1275_cov_19.910714	414	494	0	41	80	0.5125000
NODE_3347_length_1275_cov_19.910714	414	494	2	39	80	0.4875000
NODE_3347_length_1275_cov_19.910714	879	949	0	34	70	0.4857143
NODE_3347_length_1275_cov_19.910714	879	949	1	1	70	0.0142857
NODE_3347_length_1275_cov_19.910714	879	949	2	24	70	0.3428572
NODE_3347_length_1275_cov_19.910714	879	949	3	1	70	0.0142857
NODE_3347_length_1275_cov_19.910714	879	949	4	10	70	0.1428571
NODE_3351_length_1274_cov_23.404255	427	507	0	36	80	0.4500000
NODE_3351_length_1274_cov_23.404255	427	507	2	44	80	0.5500000
NODE_3351_length_1274_cov_23.404255	480	560	2	80	80	1.0000000
NODE_3351_length_1274_cov_23.404255	556	636	2	29	80	0.3625000
NODE_3351_length_1274_cov_23.404255	556	636	4	51	80	0.6375000
NODE_3351_length_1274_cov_23.404255	609	689	0	32	80	0.4000000
NODE_3351_length_1274_cov_23.404255	609	689	2	45	80	0.5625000
NODE_3351_length_1274_cov_23.404255	609	689	4	3	80	0.0375000
NODE_3352_length_1274_cov_20.178723	545	625	0	80	80	1.0000000
NODE_3352_length_1274_cov_20.178723	598	678	0	80	80	1.0000000
NODE_3354_length_1274_cov_2.019574	841	907	6	28	66	0.4242424
NODE_3354_length_1274_cov_2.019574	841	907	8	35	66	0.5303030
NODE_3354_length_1274_cov_2.019574	841	907	10	3	66	0.0454545
NODE_3354_length_1274_cov_2.019574	894	961	0	1	67	0.0149254
NODE_3354_length_1274_cov_2.019574	894	961	2	14	67	0.2089552
NODE_3354_length_1274_cov_2.019574	894	961	4	2	67	0.0298507
NODE_3354_length_1274_cov_2.019574	894	961	6	1	67	0.0149254
NODE_3354_length_1274_cov_2.019574	894	961	8	49	67	0.7313433
NODE_3361_length_1273_cov_42.349233	337	417	0	54	80	0.6750000
NODE_3361_length_1273_cov_42.349233	337	417	2	26	80	0.3250000
NODE_3361_length_1273_cov_42.349233	390	470	0	80	80	1.0000000
NODE_3361_length_1273_cov_42.349233	466	546	0	6	80	0.0750000
NODE_3361_length_1273_cov_42.349233	466	546	2	12	80	0.1500000
NODE_3361_length_1273_cov_42.349233	466	546	4	39	80	0.4875000
NODE_3361_length_1273_cov_42.349233	466	546	6	23	80	0.2875000
NODE_3361_length_1273_cov_42.349233	519	599	2	10	80	0.1250000
NODE_3361_length_1273_cov_42.349233	519	599	4	8	80	0.1000000
NODE_3361_length_1273_cov_42.349233	519	599	6	62	80	0.7750000
NODE_3364_length_1273_cov_4.404600	407	487	0	19	80	0.2375000
NODE_3364_length_1273_cov_4.404600	407	487	2	11	80	0.1375000
NODE_3364_length_1273_cov_4.404600	407	487	4	50	80	0.6250000
NODE_3364_length_1273_cov_4.404600	460	540	0	15	80	0.1875000
NODE_3364_length_1273_cov_4.404600	460	540	2	12	80	0.1500000
NODE_3364_length_1273_cov_4.404600	460	540	3	1	80	0.0125000
NODE_3364_length_1273_cov_4.404600	460	540	4	52	80	0.6500000
NODE_3368_length_1272_cov_28.887468	588	668	2	9	80	0.1125000
NODE_3368_length_1272_cov_28.887468	588	668	4	60	80	0.7500000
NODE_3368_length_1272_cov_28.887468	588	668	6	11	80	0.1375000
NODE_3368_length_1272_cov_28.887468	641	721	4	50	80	0.6250000
NODE_3368_length_1272_cov_28.887468	641	721	5	1	80	0.0125000
NODE_3368_length_1272_cov_28.887468	641	721	6	29	80	0.3625000
NODE_3369_length_1272_cov_11.290708	366	447	4	24	81	0.2962963
NODE_3369_length_1272_cov_11.290708	366	447	6	10	81	0.1234568
NODE_3369_length_1272_cov_11.290708	366	447	8	22	81	0.2716049
NODE_3369_length_1272_cov_11.290708	366	447	12	6	81	0.0740741
NODE_3369_length_1272_cov_11.290708	366	447	14	19	81	0.2345679
NODE_3375_length_1270_cov_13.617421	365	445	1	80	80	1.0000000
NODE_3375_length_1270_cov_13.617421	396	473	1	69	77	0.8961039
NODE_3375_length_1270_cov_13.617421	396	473	2	8	77	0.1038961
NODE_3375_length_1270_cov_13.617421	418	498	1	47	80	0.5875000
NODE_3375_length_1270_cov_13.617421	418	498	2	33	80	0.4125000
NODE_3375_length_1270_cov_13.617421	449	473	1	16	24	0.6666667
NODE_3375_length_1270_cov_13.617421	449	473	2	8	24	0.3333333
NODE_3375_length_1270_cov_13.617421	465	498	2	33	33	1.0000000
NODE_3376_length_1270_cov_11.645602	294	374	0	80	80	1.0000000
NODE_3376_length_1270_cov_11.645602	347	427	0	80	80	1.0000000
NODE_3377_length_1270_cov_2.495303	74	131	6	1	57	0.0175439
NODE_3377_length_1270_cov_2.495303	74	131	8	21	57	0.3684210
NODE_3377_length_1270_cov_2.495303	74	131	9	1	57	0.0175439
NODE_3377_length_1270_cov_2.495303	74	131	10	34	57	0.5964912
NODE_3378_length_1269_cov_55.070940	492	569	4	77	77	1.0000000
NODE_3378_length_1269_cov_55.070940	545	625	0	29	80	0.3625000
NODE_3378_length_1269_cov_55.070940	545	625	4	51	80	0.6375000
NODE_3378_length_1269_cov_55.070940	621	701	0	19	80	0.2375000
NODE_3378_length_1269_cov_55.070940	621	701	2	61	80	0.7625000
NODE_3378_length_1269_cov_55.070940	674	754	0	40	80	0.5000000
NODE_3378_length_1269_cov_55.070940	674	754	2	40	80	0.5000000
NODE_3379_length_1269_cov_22.154701	1152	1216	6	64	64	1.0000000
NODE_3379_length_1269_cov_22.154701	1152	1216	6	64	64	1.0000000
NODE_3379_length_1269_cov_22.154701	1152	1216	6	64	64	1.0000000
NODE_3379_length_1269_cov_22.154701	1189	1269	0	10	80	0.1250000
NODE_3379_length_1269_cov_22.154701	1189	1269	4	29	80	0.3625000
NODE_3379_length_1269_cov_22.154701	1189	1269	6	41	80	0.5125000
NODE_3379_length_1269_cov_22.154701	1189	1269	0	10	80	0.1250000
NODE_3379_length_1269_cov_22.154701	1189	1269	4	29	80	0.3625000
NODE_3379_length_1269_cov_22.154701	1189	1269	6	41	80	0.5125000
NODE_3380_length_1269_cov_18.753846	317	398	0	2	81	0.0246914
NODE_3380_length_1269_cov_18.753846	317	398	2	5	81	0.0617284
NODE_3380_length_1269_cov_18.753846	317	398	8	4	81	0.0493827
NODE_3380_length_1269_cov_18.753846	317	398	12	1	81	0.0123457
NODE_3380_length_1269_cov_18.753846	317	398	14	4	81	0.0493827
NODE_3380_length_1269_cov_18.753846	317	398	15	1	81	0.0123457
NODE_3380_length_1269_cov_18.753846	317	398	16	13	81	0.1604938
NODE_3380_length_1269_cov_18.753846	317	398	18	18	81	0.2222222
NODE_3380_length_1269_cov_18.753846	317	398	20	4	81	0.0493827
NODE_3380_length_1269_cov_18.753846	317	398	22	8	81	0.0987654
NODE_3380_length_1269_cov_18.753846	317	398	24	13	81	0.1604938
NODE_3380_length_1269_cov_18.753846	317	398	26	6	81	0.0740741
NODE_3380_length_1269_cov_18.753846	317	398	28	2	81	0.0246914
NODE_3381_length_1269_cov_12.637607	580	660	0	80	80	1.0000000
NODE_3381_length_1269_cov_12.637607	633	713	0	80	80	1.0000000
NODE_3381_length_1269_cov_12.637607	709	729	0	20	20	1.0000000
NODE_3381_length_1269_cov_12.637607	709	789	0	80	80	1.0000000
NODE_3381_length_1269_cov_12.637607	762	842	0	80	80	1.0000000
NODE_3382_length_1269_cov_10.552137	765	845	0	80	80	1.0000000
NODE_3382_length_1269_cov_10.552137	818	898	0	80	80	1.0000000
NODE_3391_length_1268_cov_12.862275	300	350	12	3	50	0.0600000
NODE_3391_length_1268_cov_12.862275	300	350	16	1	50	0.0200000
NODE_3391_length_1268_cov_12.862275	300	350	18	10	50	0.2000000
NODE_3391_length_1268_cov_12.862275	300	350	20	6	50	0.1200000
NODE_3391_length_1268_cov_12.862275	300	350	22	9	50	0.1800000
NODE_3391_length_1268_cov_12.862275	300	350	24	6	50	0.1200000
NODE_3391_length_1268_cov_12.862275	300	350	26	15	50	0.3000000
NODE_3392_length_1268_cov_9.523524	265	345	0	80	80	1.0000000
NODE_3392_length_1268_cov_9.523524	318	398	0	80	80	1.0000000
NODE_3393_length_1267_cov_21.315068	299	379	0	80	80	1.0000000
NODE_3393_length_1267_cov_21.315068	352	432	0	80	80	1.0000000
NODE_3393_length_1267_cov_21.315068	698	778	0	68	80	0.8500000
NODE_3393_length_1267_cov_21.315068	698	778	2	12	80	0.1500000
NODE_3393_length_1267_cov_21.315068	751	831	0	15	80	0.1875000
NODE_3393_length_1267_cov_21.315068	751	831	2	65	80	0.8125000
NODE_3394_length_1267_cov_14.880137	606	686	0	59	80	0.7375000
NODE_3394_length_1267_cov_14.880137	606	686	2	18	80	0.2250000
NODE_3394_length_1267_cov_14.880137	606	686	4	3	80	0.0375000
NODE_3394_length_1267_cov_14.880137	659	739	0	6	80	0.0750000
NODE_3394_length_1267_cov_14.880137	659	739	2	18	80	0.2250000
NODE_3394_length_1267_cov_14.880137	659	739	4	8	80	0.1000000
NODE_3394_length_1267_cov_14.880137	659	739	6	48	80	0.6000000
NODE_3397_length_1266_cov_20.584404	357	437	0	15	80	0.1875000
NODE_3397_length_1266_cov_20.584404	357	437	6	65	80	0.8125000
NODE_3397_length_1266_cov_20.584404	410	490	0	68	80	0.8500000
NODE_3397_length_1266_cov_20.584404	410	490	6	12	80	0.1500000
NODE_3398_length_1266_cov_16.571551	359	435	0	76	76	1.0000000
NODE_3398_length_1266_cov_16.571551	408	488	0	80	80	1.0000000
NODE_3399_length_1266_cov_14.218509	517	595	0	9	78	0.1153846
NODE_3399_length_1266_cov_14.218509	517	595	1	35	78	0.4487180
NODE_3399_length_1266_cov_14.218509	517	595	2	34	78	0.4358974
NODE_3399_length_1266_cov_14.218509	568	648	0	26	80	0.3250000
NODE_3399_length_1266_cov_14.218509	568	648	1	54	80	0.6750000
NODE_3399_length_1266_cov_14.218509	644	724	0	27	80	0.3375000
NODE_3399_length_1266_cov_14.218509	644	724	4	53	80	0.6625000
NODE_3399_length_1266_cov_14.218509	697	777	4	38	80	0.4750000
NODE_3399_length_1266_cov_14.218509	697	777	6	42	80	0.5250000
NODE_3403_length_1265_cov_9.807890	429	509	0	16	80	0.2000000
NODE_3403_length_1265_cov_9.807890	429	509	2	20	80	0.2500000
NODE_3403_length_1265_cov_9.807890	429	509	4	44	80	0.5500000
NODE_3403_length_1265_cov_9.807890	482	562	0	35	80	0.4375000
NODE_3403_length_1265_cov_9.807890	482	562	2	20	80	0.2500000
NODE_3403_length_1265_cov_9.807890	482	562	4	25	80	0.3125000
NODE_3404_length_1265_cov_8.233276	160	207	0	23	47	0.4893617
NODE_3404_length_1265_cov_8.233276	160	207	2	18	47	0.3829787
NODE_3404_length_1265_cov_8.233276	160	207	4	6	47	0.1276596
NODE_3404_length_1265_cov_8.233276	1004	1058	0	54	54	1.0000000
NODE_3406_length_1265_cov_3.941681	503	583	0	80	80	1.0000000
NODE_3406_length_1265_cov_3.941681	556	636	0	80	80	1.0000000
NODE_3408_length_1264_cov_8.024034	290	370	0	60	80	0.7500000
NODE_3408_length_1264_cov_8.024034	290	370	2	20	80	0.2500000
NODE_3408_length_1264_cov_8.024034	343	423	0	21	80	0.2625000
NODE_3408_length_1264_cov_8.024034	343	423	2	59	80	0.7375000
NODE_3413_length_1263_cov_8.566151	698	778	0	31	80	0.3875000
NODE_3413_length_1263_cov_8.566151	698	778	2	49	80	0.6125000
NODE_3413_length_1263_cov_8.566151	751	831	0	11	80	0.1375000
NODE_3413_length_1263_cov_8.566151	751	831	2	69	80	0.8625000
NODE_3413_length_1263_cov_8.566151	833	910	0	77	77	1.0000000
NODE_3413_length_1263_cov_8.566151	883	963	0	80	80	1.0000000
NODE_3414_length_1263_cov_7.376289	1060	1140	0	80	80	1.0000000
NODE_3414_length_1263_cov_7.376289	1113	1213	0	100	100	1.0000000
NODE_3416_length_1263_cov_1.827320	227	307	0	80	80	1.0000000
NODE_3416_length_1263_cov_1.827320	280	360	0	52	80	0.6500000
NODE_3416_length_1263_cov_1.827320	280	360	2	28	80	0.3500000
NODE_3418_length_1262_cov_17.416165	404	484	0	10	80	0.1250000
NODE_3418_length_1262_cov_17.416165	404	484	2	70	80	0.8750000
NODE_3418_length_1262_cov_17.416165	457	537	0	19	80	0.2375000
NODE_3418_length_1262_cov_17.416165	457	537	2	61	80	0.7625000
NODE_3419_length_1262_cov_15.268272	648	728	0	13	80	0.1625000
NODE_3419_length_1262_cov_15.268272	648	728	2	67	80	0.8375000
NODE_3419_length_1262_cov_15.268272	701	781	0	10	80	0.1250000
NODE_3419_length_1262_cov_15.268272	701	781	2	70	80	0.8750000
NODE_3419_length_1262_cov_15.268272	777	857	0	80	80	1.0000000
NODE_3419_length_1262_cov_15.268272	830	910	0	80	80	1.0000000
NODE_3424_length_1261_cov_1.777969	272	318	0	32	46	0.6956522
NODE_3424_length_1261_cov_1.777969	272	318	2	14	46	0.3043478
NODE_3425_length_1260_cov_55.640827	499	579	0	80	80	1.0000000
NODE_3425_length_1260_cov_55.640827	552	632	0	80	80	1.0000000
NODE_3425_length_1260_cov_55.640827	628	708	0	38	80	0.4750000
NODE_3425_length_1260_cov_55.640827	628	708	4	42	80	0.5250000
NODE_3425_length_1260_cov_55.640827	681	761	4	80	80	1.0000000
NODE_3426_length_1260_cov_12.242894	427	507	0	47	80	0.5875000
NODE_3426_length_1260_cov_12.242894	427	507	2	33	80	0.4125000
NODE_3426_length_1260_cov_12.242894	480	560	0	1	80	0.0125000
NODE_3426_length_1260_cov_12.242894	480	560	2	79	80	0.9875000
NODE_3436_length_1259_cov_15.381897	509	589	0	80	80	1.0000000
NODE_3436_length_1259_cov_15.381897	562	642	0	80	80	1.0000000
NODE_3439_length_1258_cov_33.519413	608	688	0	80	80	1.0000000
NODE_3439_length_1258_cov_33.519413	661	741	0	32	80	0.4000000
NODE_3439_length_1258_cov_33.519413	661	741	2	48	80	0.6000000
NODE_3440_length_1258_cov_22.569456	583	663	0	13	80	0.1625000
NODE_3440_length_1258_cov_22.569456	583	663	2	67	80	0.8375000
NODE_3440_length_1258_cov_22.569456	636	716	0	14	80	0.1750000
NODE_3440_length_1258_cov_22.569456	636	716	2	66	80	0.8250000
NODE_3441_length_1258_cov_18.747196	308	388	0	80	80	1.0000000
NODE_3441_length_1258_cov_18.747196	361	441	0	80	80	1.0000000
NODE_3441_length_1258_cov_18.747196	437	517	0	51	80	0.6375000
NODE_3441_length_1258_cov_18.747196	437	517	8	7	80	0.0875000
NODE_3441_length_1258_cov_18.747196	437	517	14	22	80	0.2750000
NODE_3441_length_1258_cov_18.747196	490	570	8	5	80	0.0625000
NODE_3441_length_1258_cov_18.747196	490	570	14	75	80	0.9375000
NODE_3442_length_1258_cov_13.699741	332	412	0	52	80	0.6500000
NODE_3442_length_1258_cov_13.699741	332	412	2	12	80	0.1500000
NODE_3442_length_1258_cov_13.699741	332	412	4	16	80	0.2000000
NODE_3442_length_1258_cov_13.699741	385	465	2	11	80	0.1375000
NODE_3442_length_1258_cov_13.699741	385	465	4	35	80	0.4375000
NODE_3442_length_1258_cov_13.699741	385	465	9	1	80	0.0125000
NODE_3442_length_1258_cov_13.699741	385	465	10	33	80	0.4125000
NODE_3447_length_1257_cov_34.029361	567	647	0	60	80	0.7500000
NODE_3447_length_1257_cov_34.029361	567	647	4	20	80	0.2500000
NODE_3447_length_1257_cov_34.029361	620	700	0	80	80	1.0000000
NODE_3447_length_1257_cov_34.029361	696	776	0	80	80	1.0000000
NODE_3447_length_1257_cov_34.029361	749	829	0	80	80	1.0000000
NODE_3449_length_1257_cov_7.892919	317	397	0	18	80	0.2250000
NODE_3449_length_1257_cov_7.892919	317	397	2	15	80	0.1875000
NODE_3449_length_1257_cov_7.892919	317	397	4	19	80	0.2375000
NODE_3449_length_1257_cov_7.892919	317	397	6	25	80	0.3125000
NODE_3449_length_1257_cov_7.892919	317	397	8	3	80	0.0375000
NODE_3449_length_1257_cov_7.892919	370	450	4	6	80	0.0750000
NODE_3449_length_1257_cov_7.892919	370	450	6	59	80	0.7375000
NODE_3449_length_1257_cov_7.892919	370	450	8	15	80	0.1875000
NODE_3452_length_1256_cov_50.506482	389	469	0	35	80	0.4375000
NODE_3452_length_1256_cov_50.506482	389	469	2	45	80	0.5625000
NODE_3452_length_1256_cov_50.506482	442	522	2	41	80	0.5125000
NODE_3452_length_1256_cov_50.506482	442	522	4	39	80	0.4875000
NODE_3452_length_1256_cov_50.506482	518	598	4	28	80	0.3500000
NODE_3452_length_1256_cov_50.506482	518	598	6	41	80	0.5125000
NODE_3452_length_1256_cov_50.506482	518	598	8	11	80	0.1375000
NODE_3452_length_1256_cov_50.506482	571	651	4	16	80	0.2000000
NODE_3452_length_1256_cov_50.506482	571	651	6	53	80	0.6625000
NODE_3452_length_1256_cov_50.506482	571	651	8	11	80	0.1375000
NODE_3453_length_1256_cov_25.944685	754	834	2	5	80	0.0625000
NODE_3453_length_1256_cov_25.944685	754	834	4	68	80	0.8500000
NODE_3453_length_1256_cov_25.944685	754	834	6	7	80	0.0875000
NODE_3453_length_1256_cov_25.944685	807	887	2	4	80	0.0500000
NODE_3453_length_1256_cov_25.944685	807	887	4	69	80	0.8625000
NODE_3453_length_1256_cov_25.944685	807	887	6	7	80	0.0875000
NODE_3455_length_1256_cov_21.720830	713	793	0	53	80	0.6625000
NODE_3455_length_1256_cov_21.720830	713	793	2	27	80	0.3375000
NODE_3455_length_1256_cov_21.720830	766	846	0	80	80	1.0000000
NODE_3456_length_1256_cov_14.242005	595	675	0	48	80	0.6000000
NODE_3456_length_1256_cov_14.242005	595	675	2	25	80	0.3125000
NODE_3456_length_1256_cov_14.242005	595	675	4	7	80	0.0875000
NODE_3456_length_1256_cov_14.242005	648	728	0	80	80	1.0000000
NODE_3457_length_1256_cov_5.870354	879	959	0	80	80	1.0000000
NODE_3463_length_1255_cov_37.271626	458	538	0	80	80	1.0000000
NODE_3463_length_1255_cov_37.271626	511	591	0	80	80	1.0000000
NODE_3463_length_1255_cov_37.271626	587	667	0	80	80	1.0000000
NODE_3463_length_1255_cov_37.271626	640	720	0	54	80	0.6750000
NODE_3463_length_1255_cov_37.271626	640	720	2	26	80	0.3250000
NODE_3464_length_1255_cov_21.374567	516	596	0	16	80	0.2000000
NODE_3464_length_1255_cov_21.374567	516	596	2	10	80	0.1250000
NODE_3464_length_1255_cov_21.374567	516	596	4	18	80	0.2250000
NODE_3464_length_1255_cov_21.374567	516	596	8	36	80	0.4500000
NODE_3464_length_1255_cov_21.374567	569	649	0	7	80	0.0875000
NODE_3464_length_1255_cov_21.374567	569	649	2	2	80	0.0250000
NODE_3464_length_1255_cov_21.374567	569	649	3	1	80	0.0125000
NODE_3464_length_1255_cov_21.374567	569	649	4	15	80	0.1875000
NODE_3464_length_1255_cov_21.374567	569	649	6	10	80	0.1250000
NODE_3464_length_1255_cov_21.374567	569	649	8	45	80	0.5625000
NODE_3464_length_1255_cov_21.374567	645	725	0	80	80	1.0000000
NODE_3464_length_1255_cov_21.374567	698	778	0	80	80	1.0000000
NODE_3465_length_1255_cov_18.391869	521	601	0	80	80	1.0000000
NODE_3465_length_1255_cov_18.391869	574	654	0	80	80	1.0000000
NODE_3466_length_1255_cov_4.096021	1194	1242	0	48	48	1.0000000
NODE_3469_length_1254_cov_32.470996	612	692	2	42	80	0.5250000
NODE_3469_length_1254_cov_32.470996	612	692	3	36	80	0.4500000
NODE_3469_length_1254_cov_32.470996	612	692	4	2	80	0.0250000
NODE_3469_length_1254_cov_32.470996	665	745	0	33	80	0.4125000
NODE_3469_length_1254_cov_32.470996	665	745	2	13	80	0.1625000
NODE_3469_length_1254_cov_32.470996	665	745	3	34	80	0.4250000
NODE_3470_length_1254_cov_26.449351	488	568	0	80	80	1.0000000
NODE_3470_length_1254_cov_26.449351	541	621	0	80	80	1.0000000
NODE_3471_length_1254_cov_22.032035	531	611	0	80	80	1.0000000
NODE_3471_length_1254_cov_22.032035	584	664	0	80	80	1.0000000
NODE_3479_length_1253_cov_16.916811	651	731	0	80	80	1.0000000
NODE_3479_length_1253_cov_16.916811	704	784	0	80	80	1.0000000
NODE_3479_length_1253_cov_16.916811	780	860	0	34	80	0.4250000
NODE_3479_length_1253_cov_16.916811	780	860	2	46	80	0.5750000
NODE_3479_length_1253_cov_16.916811	833	913	0	18	80	0.2250000
NODE_3479_length_1253_cov_16.916811	833	913	2	62	80	0.7750000
NODE_3480_length_1253_cov_13.816291	811	891	0	1	80	0.0125000
NODE_3480_length_1253_cov_13.816291	811	891	2	57	80	0.7125000
NODE_3480_length_1253_cov_13.816291	811	891	4	22	80	0.2750000
NODE_3481_length_1253_cov_9.067591	306	386	0	80	80	1.0000000
NODE_3481_length_1253_cov_9.067591	359	439	0	36	80	0.4500000
NODE_3481_length_1253_cov_9.067591	359	439	2	44	80	0.5500000
NODE_3487_length_1252_cov_57.745880	477	557	0	12	80	0.1500000
NODE_3487_length_1252_cov_57.745880	477	557	4	68	80	0.8500000
NODE_3487_length_1252_cov_57.745880	530	610	4	80	80	1.0000000
NODE_3487_length_1252_cov_57.745880	606	686	0	30	80	0.3750000
NODE_3487_length_1252_cov_57.745880	606	686	1	16	80	0.2000000
NODE_3487_length_1252_cov_57.745880	606	686	3	8	80	0.1000000
NODE_3487_length_1252_cov_57.745880	606	686	4	26	80	0.3250000
NODE_3487_length_1252_cov_57.745880	659	739	2	7	80	0.0875000
NODE_3487_length_1252_cov_57.745880	659	739	3	5	80	0.0625000
NODE_3487_length_1252_cov_57.745880	659	739	4	68	80	0.8500000
NODE_3488_length_1252_cov_56.694709	594	674	0	80	80	1.0000000
NODE_3488_length_1252_cov_56.694709	647	727	0	75	80	0.9375000
NODE_3488_length_1252_cov_56.694709	647	727	2	5	80	0.0625000
NODE_3488_length_1252_cov_56.694709	723	803	2	46	80	0.5750000
NODE_3488_length_1252_cov_56.694709	723	803	4	5	80	0.0625000
NODE_3488_length_1252_cov_56.694709	723	803	6	29	80	0.3625000
NODE_3488_length_1252_cov_56.694709	785	847	4	11	62	0.1774193
NODE_3488_length_1252_cov_56.694709	785	847	6	51	62	0.8225806
NODE_3489_length_1252_cov_34.023417	468	548	3	41	80	0.5125000
NODE_3489_length_1252_cov_34.023417	468	548	5	39	80	0.4875000
NODE_3489_length_1252_cov_34.023417	521	601	3	3	80	0.0375000
NODE_3489_length_1252_cov_34.023417	521	601	4	15	80	0.1875000
NODE_3489_length_1252_cov_34.023417	521	601	5	38	80	0.4750000
NODE_3489_length_1252_cov_34.023417	521	601	6	24	80	0.3000000
NODE_3489_length_1252_cov_34.023417	597	677	5	22	80	0.2750000
NODE_3489_length_1252_cov_34.023417	597	677	6	5	80	0.0625000
NODE_3489_length_1252_cov_34.023417	597	677	7	53	80	0.6625000
NODE_3489_length_1252_cov_34.023417	650	730	2	18	80	0.2250000
NODE_3489_length_1252_cov_34.023417	650	730	3	32	80	0.4000000
NODE_3489_length_1252_cov_34.023417	650	730	5	6	80	0.0750000
NODE_3489_length_1252_cov_34.023417	650	730	7	24	80	0.3000000
NODE_3490_length_1252_cov_9.316565	573	653	0	5	80	0.0625000
NODE_3490_length_1252_cov_9.316565	573	653	2	1	80	0.0125000
NODE_3490_length_1252_cov_9.316565	573	653	6	28	80	0.3500000
NODE_3490_length_1252_cov_9.316565	573	653	8	46	80	0.5750000
NODE_3490_length_1252_cov_9.316565	626	706	0	36	80	0.4500000
NODE_3490_length_1252_cov_9.316565	626	706	2	1	80	0.0125000
NODE_3490_length_1252_cov_9.316565	626	706	5	1	80	0.0125000
NODE_3490_length_1252_cov_9.316565	626	706	6	8	80	0.1000000
NODE_3490_length_1252_cov_9.316565	626	706	8	34	80	0.4250000
NODE_3491_length_1252_cov_8.295750	602	682	0	47	80	0.5875000
NODE_3491_length_1252_cov_8.295750	602	682	2	33	80	0.4125000
NODE_3491_length_1252_cov_8.295750	655	735	2	80	80	1.0000000
NODE_3494_length_1251_cov_17.513889	579	659	0	80	80	1.0000000
NODE_3494_length_1251_cov_17.513889	632	712	0	80	80	1.0000000
NODE_3494_length_1251_cov_17.513889	708	788	0	9	80	0.1125000
NODE_3494_length_1251_cov_17.513889	708	788	2	30	80	0.3750000
NODE_3494_length_1251_cov_17.513889	708	788	4	4	80	0.0500000
NODE_3494_length_1251_cov_17.513889	708	788	8	6	80	0.0750000
NODE_3494_length_1251_cov_17.513889	708	788	10	31	80	0.3875000
NODE_3494_length_1251_cov_17.513889	761	841	4	14	80	0.1750000
NODE_3494_length_1251_cov_17.513889	761	841	8	30	80	0.3750000
NODE_3494_length_1251_cov_17.513889	761	841	10	36	80	0.4500000
NODE_3497_length_1251_cov_3.139757	0	76	0	76	76	1.0000000
NODE_3497_length_1251_cov_3.139757	49	98	0	47	49	0.9591837
NODE_3497_length_1251_cov_3.139757	49	98	8	2	49	0.0408163
NODE_3501_length_1250_cov_25.133797	325	405	0	80	80	1.0000000
NODE_3501_length_1250_cov_25.133797	378	458	0	80	80	1.0000000
NODE_3503_length_1250_cov_11.471764	652	733	0	43	81	0.5308642
NODE_3503_length_1250_cov_11.471764	652	733	2	38	81	0.4691358
NODE_3503_length_1250_cov_11.471764	706	786	0	80	80	1.0000000
NODE_3505_length_1249_cov_45.772174	543	623	0	80	80	1.0000000
NODE_3505_length_1249_cov_45.772174	596	676	0	80	80	1.0000000
NODE_3505_length_1249_cov_45.772174	672	749	0	6	77	0.0779221
NODE_3505_length_1249_cov_45.772174	672	749	4	18	77	0.2337662
NODE_3505_length_1249_cov_45.772174	672	749	8	43	77	0.5584416
NODE_3505_length_1249_cov_45.772174	672	749	10	1	77	0.0129870
NODE_3505_length_1249_cov_45.772174	672	749	12	9	77	0.1168831
NODE_3505_length_1249_cov_45.772174	729	802	8	15	73	0.2054795
NODE_3505_length_1249_cov_45.772174	729	802	10	1	73	0.0136986
NODE_3505_length_1249_cov_45.772174	729	802	12	57	73	0.7808219
NODE_3506_length_1249_cov_35.670435	515	595	0	80	80	1.0000000
NODE_3506_length_1249_cov_35.670435	568	648	0	80	80	1.0000000
NODE_3506_length_1249_cov_35.670435	644	724	0	80	80	1.0000000
NODE_3506_length_1249_cov_35.670435	697	777	0	80	80	1.0000000
NODE_3507_length_1249_cov_34.616522	576	656	0	23	80	0.2875000
NODE_3507_length_1249_cov_34.616522	576	656	2	20	80	0.2500000
NODE_3507_length_1249_cov_34.616522	576	656	4	37	80	0.4625000
NODE_3507_length_1249_cov_34.616522	629	709	2	11	80	0.1375000
NODE_3507_length_1249_cov_34.616522	629	709	4	69	80	0.8625000
NODE_3507_length_1249_cov_34.616522	705	785	0	55	80	0.6875000
NODE_3507_length_1249_cov_34.616522	705	785	2	25	80	0.3125000
NODE_3507_length_1249_cov_34.616522	758	838	0	64	80	0.8000000
NODE_3507_length_1249_cov_34.616522	758	838	2	16	80	0.2000000
NODE_3508_length_1249_cov_19.592174	461	541	0	80	80	1.0000000
NODE_3508_length_1249_cov_19.592174	514	594	0	80	80	1.0000000
NODE_3508_length_1249_cov_19.592174	860	940	0	80	80	1.0000000
NODE_3508_length_1249_cov_19.592174	913	993	0	80	80	1.0000000
NODE_3509_length_1249_cov_14.926957	1153	1219	0	66	66	1.0000000
NODE_3509_length_1249_cov_14.926957	1192	1249	0	57	57	1.0000000
NODE_3509_length_1249_cov_14.926957	1192	1247	0	55	55	1.0000000
NODE_3509_length_1249_cov_14.926957	1192	1249	0	57	57	1.0000000
NODE_3510_length_1249_cov_7.682609	757	837	0	80	80	1.0000000
NODE_3510_length_1249_cov_7.682609	810	890	0	80	80	1.0000000
NODE_3514_length_1248_cov_14.351610	469	549	0	80	80	1.0000000
NODE_3514_length_1248_cov_14.351610	522	602	0	80	80	1.0000000
NODE_3514_length_1248_cov_14.351610	598	678	0	17	80	0.2125000
NODE_3514_length_1248_cov_14.351610	598	678	2	18	80	0.2250000
NODE_3514_length_1248_cov_14.351610	598	678	4	45	80	0.5625000
NODE_3514_length_1248_cov_14.351610	651	731	0	2	80	0.0250000
NODE_3514_length_1248_cov_14.351610	651	731	2	22	80	0.2750000
NODE_3514_length_1248_cov_14.351610	651	731	4	56	80	0.7000000
NODE_3515_length_1248_cov_11.181027	303	383	0	80	80	1.0000000
NODE_3515_length_1248_cov_11.181027	356	436	0	80	80	1.0000000
NODE_3515_length_1248_cov_11.181027	432	512	0	59	80	0.7375000
NODE_3515_length_1248_cov_11.181027	432	512	2	21	80	0.2625000
NODE_3515_length_1248_cov_11.181027	485	565	0	6	80	0.0750000
NODE_3515_length_1248_cov_11.181027	485	565	2	22	80	0.2750000
NODE_3515_length_1248_cov_11.181027	485	565	4	52	80	0.6500000
NODE_3516_length_1248_cov_4.372498	17	98	0	81	81	1.0000000
NODE_3516_length_1248_cov_4.372498	94	152	0	58	58	1.0000000
NODE_3517_length_1248_cov_2.356832	952	1032	0	80	80	1.0000000
NODE_3517_length_1248_cov_2.356832	1005	1085	0	80	80	1.0000000
NODE_3518_length_1248_cov_2.283725	1102	1151	0	49	49	1.0000000
NODE_3522_length_1247_cov_25.355401	487	567	0	80	80	1.0000000
NODE_3522_length_1247_cov_25.355401	540	620	0	80	80	1.0000000
NODE_3522_length_1247_cov_25.355401	616	696	0	15	80	0.1875000
NODE_3522_length_1247_cov_25.355401	616	696	2	65	80	0.8125000
NODE_3522_length_1247_cov_25.355401	669	749	0	24	80	0.3000000
NODE_3522_length_1247_cov_25.355401	669	749	2	56	80	0.7000000
NODE_3528_length_1246_cov_30.231909	433	513	0	11	80	0.1375000
NODE_3528_length_1246_cov_30.231909	433	513	2	69	80	0.8625000
NODE_3528_length_1246_cov_30.231909	486	566	0	28	80	0.3500000
NODE_3528_length_1246_cov_30.231909	486	566	2	52	80	0.6500000
NODE_3528_length_1246_cov_30.231909	562	642	0	10	80	0.1250000
NODE_3528_length_1246_cov_30.231909	562	642	2	14	80	0.1750000
NODE_3528_length_1246_cov_30.231909	562	642	6	47	80	0.5875000
NODE_3528_length_1246_cov_30.231909	562	642	8	5	80	0.0625000
NODE_3528_length_1246_cov_30.231909	562	642	10	3	80	0.0375000
NODE_3528_length_1246_cov_30.231909	562	642	12	1	80	0.0125000
NODE_3528_length_1246_cov_30.231909	615	695	6	18	80	0.2250000
NODE_3528_length_1246_cov_30.231909	615	695	8	5	80	0.0625000
NODE_3528_length_1246_cov_30.231909	615	695	10	56	80	0.7000000
NODE_3528_length_1246_cov_30.231909	615	695	12	1	80	0.0125000
NODE_3529_length_1246_cov_13.847428	497	577	0	80	80	1.0000000
NODE_3529_length_1246_cov_13.847428	550	630	0	80	80	1.0000000
NODE_3535_length_1245_cov_31.472949	443	523	0	80	80	1.0000000
NODE_3535_length_1245_cov_31.472949	496	576	0	80	80	1.0000000
NODE_3536_length_1245_cov_30.068935	771	841	0	70	70	1.0000000
NODE_3537_length_1245_cov_24.765271	668	748	0	9	80	0.1125000
NODE_3537_length_1245_cov_24.765271	668	748	2	71	80	0.8875000
NODE_3537_length_1245_cov_24.765271	721	801	0	35	80	0.4375000
NODE_3537_length_1245_cov_24.765271	721	801	2	45	80	0.5625000
NODE_3537_length_1245_cov_24.765271	797	877	0	80	80	1.0000000
NODE_3537_length_1245_cov_24.765271	850	930	0	80	80	1.0000000
NODE_3538_length_1245_cov_16.854276	655	735	0	80	80	1.0000000
NODE_3538_length_1245_cov_16.854276	701	771	0	70	70	1.0000000
NODE_3538_length_1245_cov_16.854276	708	788	0	80	80	1.0000000
NODE_3540_length_1245_cov_1.187609	1148	1194	0	46	46	1.0000000
NODE_3540_length_1245_cov_1.187609	1167	1245	0	78	78	1.0000000
NODE_3541_length_1244_cov_52.633188	501	581	0	80	80	1.0000000
NODE_3541_length_1244_cov_52.633188	554	634	0	80	80	1.0000000
NODE_3541_length_1244_cov_52.633188	630	710	0	11	80	0.1375000
NODE_3541_length_1244_cov_52.633188	630	710	2	24	80	0.3000000
NODE_3541_length_1244_cov_52.633188	630	710	4	45	80	0.5625000
NODE_3541_length_1244_cov_52.633188	683	763	0	12	80	0.1500000
NODE_3541_length_1244_cov_52.633188	683	763	2	30	80	0.3750000
NODE_3541_length_1244_cov_52.633188	683	763	4	38	80	0.4750000
NODE_3542_length_1244_cov_33.889956	445	525	0	80	80	1.0000000
NODE_3542_length_1244_cov_33.889956	498	578	0	80	80	1.0000000
NODE_3542_length_1244_cov_33.889956	574	654	0	11	80	0.1375000
NODE_3542_length_1244_cov_33.889956	574	654	2	19	80	0.2375000
NODE_3542_length_1244_cov_33.889956	574	654	4	30	80	0.3750000
NODE_3542_length_1244_cov_33.889956	574	654	6	20	80	0.2500000
NODE_3542_length_1244_cov_33.889956	627	707	2	24	80	0.3000000
NODE_3542_length_1244_cov_33.889956	627	707	4	8	80	0.1000000
NODE_3542_length_1244_cov_33.889956	627	707	6	48	80	0.6000000
NODE_3543_length_1244_cov_16.798253	644	724	2	6	80	0.0750000
NODE_3543_length_1244_cov_16.798253	644	724	4	74	80	0.9250000
NODE_3543_length_1244_cov_16.798253	697	777	0	16	80	0.2000000
NODE_3543_length_1244_cov_16.798253	697	777	2	43	80	0.5375000
NODE_3543_length_1244_cov_16.798253	697	777	4	21	80	0.2625000
NODE_3544_length_1244_cov_1.735371	276	347	0	71	71	1.0000000
NODE_3544_length_1244_cov_1.735371	276	347	0	71	71	1.0000000
NODE_3544_length_1244_cov_1.735371	320	400	0	80	80	1.0000000
NODE_3544_length_1244_cov_1.735371	320	400	0	80	80	1.0000000
NODE_3548_length_1243_cov_34.284965	774	854	0	62	80	0.7750000
NODE_3548_length_1243_cov_34.284965	774	854	2	18	80	0.2250000
NODE_3548_length_1243_cov_34.284965	827	907	0	33	80	0.4125000
NODE_3548_length_1243_cov_34.284965	827	907	2	47	80	0.5875000
NODE_3552_length_1242_cov_29.665792	539	619	0	80	80	1.0000000
NODE_3552_length_1242_cov_29.665792	592	672	0	80	80	1.0000000
NODE_3553_length_1242_cov_28.304462	506	586	0	80	80	1.0000000
NODE_3553_length_1242_cov_28.304462	559	639	0	80	80	1.0000000
NODE_3553_length_1242_cov_28.304462	635	715	0	15	80	0.1875000
NODE_3553_length_1242_cov_28.304462	635	715	2	22	80	0.2750000
NODE_3553_length_1242_cov_28.304462	635	715	4	15	80	0.1875000
NODE_3553_length_1242_cov_28.304462	635	715	6	28	80	0.3500000
NODE_3553_length_1242_cov_28.304462	688	768	6	72	80	0.9000000
NODE_3553_length_1242_cov_28.304462	688	768	8	8	80	0.1000000
NODE_3554_length_1242_cov_16.383202	704	784	0	17	80	0.2125000
NODE_3554_length_1242_cov_16.383202	704	784	2	63	80	0.7875000
NODE_3554_length_1242_cov_16.383202	757	837	2	72	80	0.9000000
NODE_3554_length_1242_cov_16.383202	757	837	4	8	80	0.1000000
NODE_3555_length_1242_cov_8.081365	688	768	0	80	80	1.0000000
NODE_3555_length_1242_cov_8.081365	741	821	0	80	80	1.0000000
NODE_3561_length_1241_cov_36.544658	602	682	0	80	80	1.0000000
NODE_3561_length_1241_cov_36.544658	655	735	0	80	80	1.0000000
NODE_3562_length_1241_cov_19.894921	676	756	0	41	80	0.5125000
NODE_3562_length_1241_cov_19.894921	676	756	1	18	80	0.2250000
NODE_3562_length_1241_cov_19.894921	676	756	3	6	80	0.0750000
NODE_3562_length_1241_cov_19.894921	676	756	4	15	80	0.1875000
NODE_3562_length_1241_cov_19.894921	729	809	1	6	80	0.0750000
NODE_3562_length_1241_cov_19.894921	729	809	3	6	80	0.0750000
NODE_3562_length_1241_cov_19.894921	729	809	4	15	80	0.1875000
NODE_3562_length_1241_cov_19.894921	729	809	6	53	80	0.6625000
NODE_3569_length_1240_cov_38.375110	483	563	0	80	80	1.0000000
NODE_3569_length_1240_cov_38.375110	536	616	0	56	80	0.7000000
NODE_3569_length_1240_cov_38.375110	536	616	2	24	80	0.3000000
NODE_3569_length_1240_cov_38.375110	612	692	2	43	80	0.5375000
NODE_3569_length_1240_cov_38.375110	612	692	4	37	80	0.4625000
NODE_3569_length_1240_cov_38.375110	665	745	2	31	80	0.3875000
NODE_3569_length_1240_cov_38.375110	665	745	4	49	80	0.6125000
NODE_3570_length_1240_cov_24.975460	625	705	0	13	80	0.1625000
NODE_3570_length_1240_cov_24.975460	625	705	2	28	80	0.3500000
NODE_3570_length_1240_cov_24.975460	625	705	6	8	80	0.1000000
NODE_3570_length_1240_cov_24.975460	625	705	8	31	80	0.3875000
NODE_3570_length_1240_cov_24.975460	678	758	0	17	80	0.2125000
NODE_3570_length_1240_cov_24.975460	678	758	4	1	80	0.0125000
NODE_3570_length_1240_cov_24.975460	678	758	6	8	80	0.1000000
NODE_3570_length_1240_cov_24.975460	678	758	8	54	80	0.6750000
NODE_3571_length_1240_cov_23.812445	731	811	0	70	80	0.8750000
NODE_3571_length_1240_cov_23.812445	731	811	2	10	80	0.1250000
NODE_3571_length_1240_cov_23.812445	784	864	0	79	80	0.9875000
NODE_3571_length_1240_cov_23.812445	784	864	2	1	80	0.0125000
NODE_3576_length_1239_cov_37.657895	399	479	0	80	80	1.0000000
NODE_3576_length_1239_cov_37.657895	452	532	0	37	80	0.4625000
NODE_3576_length_1239_cov_37.657895	452	532	2	43	80	0.5375000
NODE_3576_length_1239_cov_37.657895	528	608	2	8	80	0.1000000
NODE_3576_length_1239_cov_37.657895	528	608	4	69	80	0.8625000
NODE_3576_length_1239_cov_37.657895	528	608	6	3	80	0.0375000
NODE_3576_length_1239_cov_37.657895	581	661	0	22	80	0.2750000
NODE_3576_length_1239_cov_37.657895	581	661	2	25	80	0.3125000
NODE_3576_length_1239_cov_37.657895	581	661	4	30	80	0.3750000
NODE_3576_length_1239_cov_37.657895	581	661	6	3	80	0.0375000
NODE_3577_length_1239_cov_14.984211	398	478	0	34	80	0.4250000
NODE_3577_length_1239_cov_14.984211	398	478	2	46	80	0.5750000
NODE_3577_length_1239_cov_14.984211	451	531	2	80	80	1.0000000
NODE_3577_length_1239_cov_14.984211	771	825	0	54	54	1.0000000
NODE_3577_length_1239_cov_14.984211	798	878	0	80	80	1.0000000
NODE_3578_length_1239_cov_13.312281	806	886	0	80	80	1.0000000
NODE_3578_length_1239_cov_13.312281	859	939	0	80	80	1.0000000
NODE_3579_length_1239_cov_7.116667	444	524	0	80	80	1.0000000
NODE_3579_length_1239_cov_7.116667	497	577	0	80	80	1.0000000
NODE_3582_length_1238_cov_33.830553	625	705	0	80	80	1.0000000
NODE_3582_length_1238_cov_33.830553	678	758	0	80	80	1.0000000
NODE_3583_length_1238_cov_8.163301	664	744	0	55	80	0.6875000
NODE_3583_length_1238_cov_8.163301	664	744	2	25	80	0.3125000
NODE_3583_length_1238_cov_8.163301	717	797	0	2	80	0.0250000
NODE_3583_length_1238_cov_8.163301	717	797	2	65	80	0.8125000
NODE_3583_length_1238_cov_8.163301	717	797	4	13	80	0.1625000
NODE_3586_length_1237_cov_24.562390	447	527	0	48	80	0.6000000
NODE_3586_length_1237_cov_24.562390	447	527	1	2	80	0.0250000
NODE_3586_length_1237_cov_24.562390	447	527	3	30	80	0.3750000
NODE_3586_length_1237_cov_24.562390	500	580	3	80	80	1.0000000
NODE_3587_length_1237_cov_9.297012	515	595	2	5	80	0.0625000
NODE_3587_length_1237_cov_9.297012	515	595	4	75	80	0.9375000
NODE_3587_length_1237_cov_9.297012	568	648	0	30	80	0.3750000
NODE_3587_length_1237_cov_9.297012	568	648	2	28	80	0.3500000
NODE_3587_length_1237_cov_9.297012	568	648	4	22	80	0.2750000
NODE_3594_length_1236_cov_46.661390	632	712	6	13	80	0.1625000
NODE_3594_length_1236_cov_46.661390	632	712	8	18	80	0.2250000
NODE_3594_length_1236_cov_46.661390	632	712	10	49	80	0.6125000
NODE_3594_length_1236_cov_46.661390	685	765	0	2	80	0.0250000
NODE_3594_length_1236_cov_46.661390	685	765	2	40	80	0.5000000
NODE_3594_length_1236_cov_46.661390	685	765	6	24	80	0.3000000
NODE_3594_length_1236_cov_46.661390	685	765	8	4	80	0.0500000
NODE_3594_length_1236_cov_46.661390	685	765	10	10	80	0.1250000
NODE_3595_length_1236_cov_8.625330	735	815	3	1	80	0.0125000
NODE_3595_length_1236_cov_8.625330	735	815	5	10	80	0.1250000
NODE_3595_length_1236_cov_8.625330	735	815	6	32	80	0.4000000
NODE_3595_length_1236_cov_8.625330	735	815	8	37	80	0.4625000
NODE_3595_length_1236_cov_8.625330	788	868	1	24	80	0.3000000
NODE_3595_length_1236_cov_8.625330	788	868	3	9	80	0.1125000
NODE_3595_length_1236_cov_8.625330	788	868	5	16	80	0.2000000
NODE_3595_length_1236_cov_8.625330	788	868	8	31	80	0.3875000
NODE_3597_length_1235_cov_31.619718	331	411	0	14	80	0.1750000
NODE_3597_length_1235_cov_31.619718	331	411	2	9	80	0.1125000
NODE_3597_length_1235_cov_31.619718	331	411	4	57	80	0.7125000
NODE_3597_length_1235_cov_31.619718	384	464	0	24	80	0.3000000
NODE_3597_length_1235_cov_31.619718	384	464	2	18	80	0.2250000
NODE_3597_length_1235_cov_31.619718	384	464	4	38	80	0.4750000
NODE_3598_length_1235_cov_20.252641	559	639	0	80	80	1.0000000
NODE_3598_length_1235_cov_20.252641	612	692	0	80	80	1.0000000
NODE_3598_length_1235_cov_20.252641	688	768	0	80	80	1.0000000
NODE_3598_length_1235_cov_20.252641	741	821	0	80	80	1.0000000
NODE_3599_length_1235_cov_18.462148	695	775	0	80	80	1.0000000
NODE_3599_length_1235_cov_18.462148	748	828	0	80	80	1.0000000
NODE_3600_length_1235_cov_8.696303	765	845	0	80	80	1.0000000
NODE_3600_length_1235_cov_8.696303	818	898	0	80	80	1.0000000
NODE_3601_length_1235_cov_5.580106	544	624	0	80	80	1.0000000
NODE_3601_length_1235_cov_5.580106	597	677	0	80	80	1.0000000
NODE_3608_length_1234_cov_27.136564	528	608	0	60	80	0.7500000
NODE_3608_length_1234_cov_27.136564	528	608	4	20	80	0.2500000
NODE_3608_length_1234_cov_27.136564	581	661	0	7	80	0.0875000
NODE_3608_length_1234_cov_27.136564	581	661	2	9	80	0.1125000
NODE_3608_length_1234_cov_27.136564	581	661	4	64	80	0.8000000
NODE_3611_length_1233_cov_64.374780	497	577	13	4	80	0.0500000
NODE_3611_length_1233_cov_64.374780	497	577	22	76	80	0.9500000
NODE_3611_length_1233_cov_64.374780	550	630	0	29	80	0.3625000
NODE_3611_length_1233_cov_64.374780	550	630	2	6	80	0.0750000
NODE_3611_length_1233_cov_64.374780	550	630	22	45	80	0.5625000
NODE_3611_length_1233_cov_64.374780	626	706	0	19	80	0.2375000
NODE_3611_length_1233_cov_64.374780	626	706	2	61	80	0.7625000
NODE_3611_length_1233_cov_64.374780	679	759	0	59	80	0.7375000
NODE_3611_length_1233_cov_64.374780	679	759	2	21	80	0.2625000
NODE_3612_length_1233_cov_52.833333	654	734	0	56	80	0.7000000
NODE_3612_length_1233_cov_52.833333	654	734	2	6	80	0.0750000
NODE_3612_length_1233_cov_52.833333	654	734	4	18	80	0.2250000
NODE_3612_length_1233_cov_52.833333	707	787	0	3	80	0.0375000
NODE_3612_length_1233_cov_52.833333	707	787	2	6	80	0.0750000
NODE_3612_length_1233_cov_52.833333	707	787	4	37	80	0.4625000
NODE_3612_length_1233_cov_52.833333	707	787	6	34	80	0.4250000
NODE_3613_length_1233_cov_18.096120	522	602	2	12	80	0.1500000
NODE_3613_length_1233_cov_18.096120	522	602	4	68	80	0.8500000
NODE_3613_length_1233_cov_18.096120	575	655	2	38	80	0.4750000
NODE_3613_length_1233_cov_18.096120	575	655	4	42	80	0.5250000
NODE_3613_length_1233_cov_18.096120	651	731	0	69	80	0.8625000
NODE_3613_length_1233_cov_18.096120	651	731	2	11	80	0.1375000
NODE_3613_length_1233_cov_18.096120	704	784	0	80	80	1.0000000
NODE_3614_length_1233_cov_15.360670	585	656	0	71	71	1.0000000
NODE_3614_length_1233_cov_15.360670	631	709	0	78	78	1.0000000
NODE_3620_length_1232_cov_62.112974	552	632	0	47	80	0.5875000
NODE_3620_length_1232_cov_62.112974	552	632	2	33	80	0.4125000
NODE_3620_length_1232_cov_62.112974	605	694	0	51	89	0.5730337
NODE_3620_length_1232_cov_62.112974	605	694	2	38	89	0.4269663
NODE_3620_length_1232_cov_62.112974	690	770	0	23	80	0.2875000
NODE_3620_length_1232_cov_62.112974	690	770	2	57	80	0.7125000
NODE_3620_length_1232_cov_62.112974	743	823	0	15	80	0.1875000
NODE_3620_length_1232_cov_62.112974	743	823	2	24	80	0.3000000
NODE_3620_length_1232_cov_62.112974	743	823	4	41	80	0.5125000
NODE_3621_length_1232_cov_34.635481	469	549	0	24	80	0.3000000
NODE_3621_length_1232_cov_34.635481	469	549	4	16	80	0.2000000
NODE_3621_length_1232_cov_34.635481	469	549	6	11	80	0.1375000
NODE_3621_length_1232_cov_34.635481	469	549	8	29	80	0.3625000
NODE_3621_length_1232_cov_34.635481	522	602	2	3	80	0.0375000
NODE_3621_length_1232_cov_34.635481	522	602	4	8	80	0.1000000
NODE_3621_length_1232_cov_34.635481	522	602	8	43	80	0.5375000
NODE_3621_length_1232_cov_34.635481	522	602	10	26	80	0.3250000
NODE_3622_length_1232_cov_16.362754	774	854	0	80	80	1.0000000
NODE_3622_length_1232_cov_16.362754	827	907	0	80	80	1.0000000
NODE_3623_length_1232_cov_13.395410	234	315	0	81	81	1.0000000
NODE_3623_length_1232_cov_13.395410	287	368	0	81	81	1.0000000
NODE_3623_length_1232_cov_13.395410	364	444	0	80	80	1.0000000
NODE_3623_length_1232_cov_13.395410	417	497	0	80	80	1.0000000
NODE_3625_length_1231_cov_47.606890	509	589	0	80	80	1.0000000
NODE_3625_length_1231_cov_47.606890	562	642	0	46	80	0.5750000
NODE_3625_length_1231_cov_47.606890	562	642	2	31	80	0.3875000
NODE_3625_length_1231_cov_47.606890	562	642	5	1	80	0.0125000
NODE_3625_length_1231_cov_47.606890	562	642	6	2	80	0.0250000
NODE_3625_length_1231_cov_47.606890	638	718	2	1	80	0.0125000
NODE_3625_length_1231_cov_47.606890	638	718	5	1	80	0.0125000
NODE_3625_length_1231_cov_47.606890	638	718	6	72	80	0.9000000
NODE_3625_length_1231_cov_47.606890	638	718	8	6	80	0.0750000
NODE_3625_length_1231_cov_47.606890	691	771	0	5	80	0.0625000
NODE_3625_length_1231_cov_47.606890	691	771	2	22	80	0.2750000
NODE_3625_length_1231_cov_47.606890	691	771	5	1	80	0.0125000
NODE_3625_length_1231_cov_47.606890	691	771	6	52	80	0.6500000
NODE_3626_length_1231_cov_27.498233	698	777	0	79	79	1.0000000
NODE_3626_length_1231_cov_27.498233	750	830	0	80	80	1.0000000
NODE_3627_length_1231_cov_21.245583	673	753	2	11	80	0.1375000
NODE_3627_length_1231_cov_21.245583	673	753	4	22	80	0.2750000
NODE_3627_length_1231_cov_21.245583	673	753	8	47	80	0.5875000
NODE_3627_length_1231_cov_21.245583	726	806	6	39	80	0.4875000
NODE_3627_length_1231_cov_21.245583	726	806	8	41	80	0.5125000
NODE_3627_length_1231_cov_21.245583	802	882	0	62	80	0.7750000
NODE_3627_length_1231_cov_21.245583	802	882	4	12	80	0.1500000
NODE_3627_length_1231_cov_21.245583	802	882	6	6	80	0.0750000
NODE_3627_length_1231_cov_21.245583	860	935	0	75	75	1.0000000
NODE_3628_length_1231_cov_9.895760	515	595	2	26	80	0.3250000
NODE_3628_length_1231_cov_9.895760	515	595	4	22	80	0.2750000
NODE_3628_length_1231_cov_9.895760	515	595	6	22	80	0.2750000
NODE_3628_length_1231_cov_9.895760	515	595	8	10	80	0.1250000
NODE_3628_length_1231_cov_9.895760	568	648	6	33	80	0.4125000
NODE_3628_length_1231_cov_9.895760	568	648	8	20	80	0.2500000
NODE_3628_length_1231_cov_9.895760	568	648	10	1	80	0.0125000
NODE_3628_length_1231_cov_9.895760	568	648	12	26	80	0.3250000
NODE_3630_length_1230_cov_43.705570	412	492	2	22	80	0.2750000
NODE_3630_length_1230_cov_43.705570	412	492	4	58	80	0.7250000
NODE_3630_length_1230_cov_43.705570	465	545	0	43	80	0.5375000
NODE_3630_length_1230_cov_43.705570	465	545	2	32	80	0.4000000
NODE_3630_length_1230_cov_43.705570	465	545	4	5	80	0.0625000
NODE_3631_length_1230_cov_43.663130	501	581	6	19	80	0.2375000
NODE_3631_length_1230_cov_43.663130	501	581	7	2	80	0.0250000
NODE_3631_length_1230_cov_43.663130	501	581	8	38	80	0.4750000
NODE_3631_length_1230_cov_43.663130	501	581	9	16	80	0.2000000
NODE_3631_length_1230_cov_43.663130	501	581	10	5	80	0.0625000
NODE_3631_length_1230_cov_43.663130	554	634	0	10	80	0.1250000
NODE_3631_length_1230_cov_43.663130	554	634	2	33	80	0.4125000
NODE_3631_length_1230_cov_43.663130	554	634	4	4	80	0.0500000
NODE_3631_length_1230_cov_43.663130	554	634	6	25	80	0.3125000
NODE_3631_length_1230_cov_43.663130	554	634	8	3	80	0.0375000
NODE_3631_length_1230_cov_43.663130	554	634	10	5	80	0.0625000
NODE_3632_length_1230_cov_33.173298	315	395	0	80	80	1.0000000
NODE_3632_length_1230_cov_33.173298	368	448	0	80	80	1.0000000
NODE_3633_length_1230_cov_12.939876	201	281	2	11	80	0.1375000
NODE_3633_length_1230_cov_12.939876	201	281	3	7	80	0.0875000
NODE_3633_length_1230_cov_12.939876	201	281	4	18	80	0.2250000
NODE_3633_length_1230_cov_12.939876	201	281	6	44	80	0.5500000
NODE_3633_length_1230_cov_12.939876	218	273	3	1	55	0.0181818
NODE_3633_length_1230_cov_12.939876	218	273	4	18	55	0.3272727
NODE_3633_length_1230_cov_12.939876	218	273	6	36	55	0.6545454
NODE_3633_length_1230_cov_12.939876	254	334	2	45	80	0.5625000
NODE_3633_length_1230_cov_12.939876	254	334	4	1	80	0.0125000
NODE_3633_length_1230_cov_12.939876	254	334	6	34	80	0.4250000
NODE_3633_length_1230_cov_12.939876	330	410	0	38	80	0.4750000
NODE_3633_length_1230_cov_12.939876	330	410	2	42	80	0.5250000
NODE_3633_length_1230_cov_12.939876	383	463	0	80	80	1.0000000
NODE_3634_length_1230_cov_5.155615	248	328	0	80	80	1.0000000
NODE_3634_length_1230_cov_5.155615	301	381	0	80	80	1.0000000
NODE_3640_length_1229_cov_30.214159	341	421	0	43	80	0.5375000
NODE_3640_length_1229_cov_30.214159	341	421	2	31	80	0.3875000
NODE_3640_length_1229_cov_30.214159	341	421	4	6	80	0.0750000
NODE_3640_length_1229_cov_30.214159	394	474	0	1	80	0.0125000
NODE_3640_length_1229_cov_30.214159	394	474	2	30	80	0.3750000
NODE_3640_length_1229_cov_30.214159	394	474	4	49	80	0.6125000
NODE_3641_length_1229_cov_23.165487	376	456	0	23	80	0.2875000
NODE_3641_length_1229_cov_23.165487	376	456	2	23	80	0.2875000
NODE_3641_length_1229_cov_23.165487	376	456	4	18	80	0.2250000
NODE_3641_length_1229_cov_23.165487	376	456	6	6	80	0.0750000
NODE_3641_length_1229_cov_23.165487	376	456	8	10	80	0.1250000
NODE_3641_length_1229_cov_23.165487	429	509	4	11	80	0.1375000
NODE_3641_length_1229_cov_23.165487	429	509	6	31	80	0.3875000
NODE_3641_length_1229_cov_23.165487	429	509	8	38	80	0.4750000
NODE_3641_length_1229_cov_23.165487	505	585	4	35	80	0.4375000
NODE_3641_length_1229_cov_23.165487	505	585	6	45	80	0.5625000
NODE_3641_length_1229_cov_23.165487	558	638	0	42	80	0.5250000
NODE_3641_length_1229_cov_23.165487	558	638	2	6	80	0.0750000
NODE_3641_length_1229_cov_23.165487	558	638	4	32	80	0.4000000
NODE_3642_length_1229_cov_19.376991	484	564	0	35	80	0.4375000
NODE_3642_length_1229_cov_19.376991	484	564	8	43	80	0.5375000
NODE_3642_length_1229_cov_19.376991	484	564	10	2	80	0.0250000
NODE_3642_length_1229_cov_19.376991	537	614	2	9	77	0.1168831
NODE_3642_length_1229_cov_19.376991	537	614	4	1	77	0.0129870
NODE_3642_length_1229_cov_19.376991	537	614	5	1	77	0.0129870
NODE_3642_length_1229_cov_19.376991	537	614	6	11	77	0.1428571
NODE_3642_length_1229_cov_19.376991	537	614	8	25	77	0.3246753
NODE_3642_length_1229_cov_19.376991	537	614	10	30	77	0.3896104
NODE_3643_length_1229_cov_11.799115	670	748	0	78	78	1.0000000
NODE_3643_length_1229_cov_11.799115	728	801	0	73	73	1.0000000
NODE_3644_length_1229_cov_8.140708	970	1050	2	7	80	0.0875000
NODE_3644_length_1229_cov_8.140708	970	1050	4	73	80	0.9125000
NODE_3644_length_1229_cov_8.140708	1023	1103	0	39	80	0.4875000
NODE_3644_length_1229_cov_8.140708	1023	1103	2	13	80	0.1625000
NODE_3644_length_1229_cov_8.140708	1023	1103	4	28	80	0.3500000
NODE_3646_length_1229_cov_3.654867	765	840	0	75	75	1.0000000
NODE_3646_length_1229_cov_3.654867	813	893	0	80	80	1.0000000
NODE_3652_length_1229_cov_0.949558	1034	1079	0	25	45	0.5555556
NODE_3652_length_1229_cov_0.949558	1034	1079	2	2	45	0.0444444
NODE_3652_length_1229_cov_0.949558	1034	1079	4	4	45	0.0888889
NODE_3652_length_1229_cov_0.949558	1034	1079	6	14	45	0.3111111
NODE_3652_length_1229_cov_0.949558	1090	1130	6	40	40	1.0000000
NODE_3654_length_1228_cov_22.622675	604	684	0	3	80	0.0375000
NODE_3654_length_1228_cov_22.622675	604	684	4	30	80	0.3750000
NODE_3654_length_1228_cov_22.622675	604	684	7	1	80	0.0125000
NODE_3654_length_1228_cov_22.622675	604	684	8	46	80	0.5750000
NODE_3654_length_1228_cov_22.622675	657	738	0	13	81	0.1604938
NODE_3654_length_1228_cov_22.622675	657	738	2	6	81	0.0740741
NODE_3654_length_1228_cov_22.622675	657	738	3	9	81	0.1111111
NODE_3654_length_1228_cov_22.622675	657	738	4	12	81	0.1481481
NODE_3654_length_1228_cov_22.622675	657	738	8	41	81	0.5061728
NODE_3655_length_1228_cov_17.900797	423	503	0	80	80	1.0000000
NODE_3655_length_1228_cov_17.900797	423	503	0	80	80	1.0000000
NODE_3655_length_1228_cov_17.900797	423	503	0	80	80	1.0000000
NODE_3655_length_1228_cov_17.900797	476	538	0	62	62	1.0000000
NODE_3655_length_1228_cov_17.900797	476	538	0	62	62	1.0000000
NODE_3655_length_1228_cov_17.900797	476	538	0	62	62	1.0000000
NODE_3655_length_1228_cov_17.900797	476	556	0	80	80	1.0000000
NODE_3656_length_1228_cov_14.554473	367	447	0	80	80	1.0000000
NODE_3656_length_1228_cov_14.554473	420	500	0	80	80	1.0000000
NODE_3657_length_1228_cov_10.021258	661	741	0	80	80	1.0000000
NODE_3657_length_1228_cov_10.021258	714	794	0	80	80	1.0000000
NODE_3660_length_1228_cov_3.987600	1139	1219	0	80	80	1.0000000
NODE_3662_length_1227_cov_29.002660	423	503	0	40	80	0.5000000
NODE_3662_length_1227_cov_29.002660	423	503	2	40	80	0.5000000
NODE_3662_length_1227_cov_29.002660	476	556	0	80	80	1.0000000
NODE_3663_length_1227_cov_17.479610	759	839	0	80	80	1.0000000
NODE_3663_length_1227_cov_17.479610	812	892	0	80	80	1.0000000
NODE_3666_length_1227_cov_3.808511	120	186	6	8	66	0.1212121
NODE_3666_length_1227_cov_3.808511	120	186	10	37	66	0.5606061
NODE_3666_length_1227_cov_3.808511	120	186	12	21	66	0.3181818
NODE_3666_length_1227_cov_3.808511	173	239	4	6	66	0.0909091
NODE_3666_length_1227_cov_3.808511	173	239	6	14	66	0.2121212
NODE_3666_length_1227_cov_3.808511	173	239	10	23	66	0.3484848
NODE_3666_length_1227_cov_3.808511	173	239	12	23	66	0.3484848
NODE_3666_length_1227_cov_3.808511	229	299	0	19	70	0.2714286
NODE_3666_length_1227_cov_3.808511	229	299	2	21	70	0.3000000
NODE_3666_length_1227_cov_3.808511	229	299	4	26	70	0.3714286
NODE_3666_length_1227_cov_3.808511	229	299	6	4	70	0.0571429
NODE_3672_length_1226_cov_23.792369	579	659	0	80	80	1.0000000
NODE_3672_length_1226_cov_23.792369	632	712	0	80	80	1.0000000
NODE_3672_length_1226_cov_23.792369	708	788	0	80	80	1.0000000
NODE_3672_length_1226_cov_23.792369	761	839	0	78	78	1.0000000
NODE_3673_length_1226_cov_5.620231	463	543	0	2	80	0.0250000
NODE_3673_length_1226_cov_5.620231	463	543	2	42	80	0.5250000
NODE_3673_length_1226_cov_5.620231	463	543	4	36	80	0.4500000
NODE_3673_length_1226_cov_5.620231	516	596	2	45	80	0.5625000
NODE_3673_length_1226_cov_5.620231	516	596	4	35	80	0.4375000
NODE_3674_length_1226_cov_4.881988	582	662	0	80	80	1.0000000
NODE_3674_length_1226_cov_4.881988	635	715	0	80	80	1.0000000
NODE_3682_length_1225_cov_55.596803	637	717	2	4	80	0.0500000
NODE_3682_length_1225_cov_55.596803	637	717	4	1	80	0.0125000
NODE_3682_length_1225_cov_55.596803	637	717	6	10	80	0.1250000
NODE_3682_length_1225_cov_55.596803	637	717	8	1	80	0.0125000
NODE_3682_length_1225_cov_55.596803	637	717	10	6	80	0.0750000
NODE_3682_length_1225_cov_55.596803	637	717	12	10	80	0.1250000
NODE_3682_length_1225_cov_55.596803	637	717	14	30	80	0.3750000
NODE_3682_length_1225_cov_55.596803	637	717	16	18	80	0.2250000
NODE_3682_length_1225_cov_55.596803	690	770	2	30	80	0.3750000
NODE_3682_length_1225_cov_55.596803	690	770	4	8	80	0.1000000
NODE_3682_length_1225_cov_55.596803	690	770	6	6	80	0.0750000
NODE_3682_length_1225_cov_55.596803	690	770	10	2	80	0.0250000
NODE_3682_length_1225_cov_55.596803	690	770	12	3	80	0.0375000
NODE_3682_length_1225_cov_55.596803	690	770	14	9	80	0.1125000
NODE_3682_length_1225_cov_55.596803	690	770	16	22	80	0.2750000
NODE_3682_length_1225_cov_55.596803	766	846	0	6	80	0.0750000
NODE_3682_length_1225_cov_55.596803	766	846	2	74	80	0.9250000
NODE_3682_length_1225_cov_55.596803	819	899	0	6	80	0.0750000
NODE_3682_length_1225_cov_55.596803	819	899	2	74	80	0.9250000
NODE_3683_length_1225_cov_35.189165	661	742	0	81	81	1.0000000
NODE_3683_length_1225_cov_35.189165	714	795	0	39	81	0.4814815
NODE_3683_length_1225_cov_35.189165	714	795	2	42	81	0.5185185
NODE_3684_length_1225_cov_33.755773	456	535	0	34	79	0.4303797
NODE_3684_length_1225_cov_33.755773	456	535	2	45	79	0.5696203
NODE_3684_length_1225_cov_33.755773	508	588	0	12	80	0.1500000
NODE_3684_length_1225_cov_33.755773	508	588	2	68	80	0.8500000
NODE_3685_length_1225_cov_30.116341	566	646	0	80	80	1.0000000
NODE_3685_length_1225_cov_30.116341	619	699	0	80	80	1.0000000
NODE_3685_length_1225_cov_30.116341	695	775	0	80	80	1.0000000
NODE_3685_length_1225_cov_30.116341	748	828	0	80	80	1.0000000
NODE_3686_length_1225_cov_29.177620	195	275	0	50	80	0.6250000
NODE_3686_length_1225_cov_29.177620	195	275	2	1	80	0.0125000
NODE_3686_length_1225_cov_29.177620	195	275	4	6	80	0.0750000
NODE_3686_length_1225_cov_29.177620	195	275	6	23	80	0.2875000
NODE_3686_length_1225_cov_29.177620	248	328	4	4	80	0.0500000
NODE_3686_length_1225_cov_29.177620	248	328	6	76	80	0.9500000
NODE_3687_length_1225_cov_26.849023	588	668	0	2	80	0.0250000
NODE_3687_length_1225_cov_26.849023	588	668	2	66	80	0.8250000
NODE_3687_length_1225_cov_26.849023	588	668	4	12	80	0.1500000
NODE_3687_length_1225_cov_26.849023	641	721	0	55	80	0.6875000
NODE_3687_length_1225_cov_26.849023	641	721	2	25	80	0.3125000
NODE_3687_length_1225_cov_26.849023	717	797	0	73	80	0.9125000
NODE_3687_length_1225_cov_26.849023	717	797	2	7	80	0.0875000
NODE_3687_length_1225_cov_26.849023	770	850	0	20	80	0.2500000
NODE_3687_length_1225_cov_26.849023	770	850	2	60	80	0.7500000
NODE_3688_length_1225_cov_24.444938	386	466	0	80	80	1.0000000
NODE_3688_length_1225_cov_24.444938	439	519	0	80	80	1.0000000
NODE_3690_length_1225_cov_19.369449	491	571	0	80	80	1.0000000
NODE_3690_length_1225_cov_19.369449	544	624	0	80	80	1.0000000
NODE_3690_length_1225_cov_19.369449	620	700	0	80	80	1.0000000
NODE_3690_length_1225_cov_19.369449	673	753	0	44	80	0.5500000
NODE_3690_length_1225_cov_19.369449	673	753	2	36	80	0.4500000
NODE_3691_length_1225_cov_13.281528	462	542	0	68	80	0.8500000
NODE_3691_length_1225_cov_13.281528	462	542	2	12	80	0.1500000
NODE_3691_length_1225_cov_13.281528	515	595	0	80	80	1.0000000
NODE_3691_length_1225_cov_13.281528	591	671	0	80	80	1.0000000
NODE_3691_length_1225_cov_13.281528	644	724	0	80	80	1.0000000
NODE_3692_length_1225_cov_10.887211	566	646	0	28	80	0.3500000
NODE_3692_length_1225_cov_10.887211	566	646	2	7	80	0.0875000
NODE_3692_length_1225_cov_10.887211	566	646	4	45	80	0.5625000
NODE_3692_length_1225_cov_10.887211	619	699	0	4	80	0.0500000
NODE_3692_length_1225_cov_10.887211	619	699	2	28	80	0.3500000
NODE_3692_length_1225_cov_10.887211	619	699	4	48	80	0.6000000
NODE_3696_length_1224_cov_24.568889	613	693	3	2	80	0.0250000
NODE_3696_length_1224_cov_24.568889	613	693	4	35	80	0.4375000
NODE_3696_length_1224_cov_24.568889	613	693	6	18	80	0.2250000
NODE_3696_length_1224_cov_24.568889	613	693	8	14	80	0.1750000
NODE_3696_length_1224_cov_24.568889	613	693	10	11	80	0.1375000
NODE_3696_length_1224_cov_24.568889	666	746	4	10	80	0.1250000
NODE_3696_length_1224_cov_24.568889	666	746	6	39	80	0.4875000
NODE_3696_length_1224_cov_24.568889	666	746	8	14	80	0.1750000
NODE_3696_length_1224_cov_24.568889	666	746	10	17	80	0.2125000
NODE_3697_length_1224_cov_17.538667	762	842	0	80	80	1.0000000
NODE_3697_length_1224_cov_17.538667	815	895	0	80	80	1.0000000
NODE_3698_length_1224_cov_14.138667	389	469	0	33	80	0.4125000
NODE_3698_length_1224_cov_14.138667	389	469	2	47	80	0.5875000
NODE_3698_length_1224_cov_14.138667	442	522	0	80	80	1.0000000
NODE_3699_length_1224_cov_11.358222	704	784	0	80	80	1.0000000
NODE_3699_length_1224_cov_11.358222	757	837	0	80	80	1.0000000
NODE_3700_length_1224_cov_6.963556	516	581	0	5	65	0.0769231
NODE_3700_length_1224_cov_6.963556	516	581	2	60	65	0.9230769
NODE_3705_length_1223_cov_44.608541	548	630	4	24	82	0.2926829
NODE_3705_length_1223_cov_44.608541	548	630	8	41	82	0.5000000
NODE_3705_length_1223_cov_44.608541	548	630	10	17	82	0.2073171
NODE_3705_length_1223_cov_44.608541	601	683	0	1	82	0.0121951
NODE_3705_length_1223_cov_44.608541	601	683	2	33	82	0.4024390
NODE_3705_length_1223_cov_44.608541	601	683	6	9	82	0.1097561
NODE_3705_length_1223_cov_44.608541	601	683	8	12	82	0.1463415
NODE_3705_length_1223_cov_44.608541	601	683	10	27	82	0.3292683
NODE_3705_length_1223_cov_44.608541	679	759	0	77	80	0.9625000
NODE_3705_length_1223_cov_44.608541	679	759	2	3	80	0.0375000
NODE_3705_length_1223_cov_44.608541	732	812	0	80	80	1.0000000
NODE_3706_length_1223_cov_26.730427	508	588	0	21	80	0.2625000
NODE_3706_length_1223_cov_26.730427	508	588	2	42	80	0.5250000
NODE_3706_length_1223_cov_26.730427	508	588	4	5	80	0.0625000
NODE_3706_length_1223_cov_26.730427	508	588	6	12	80	0.1500000
NODE_3706_length_1223_cov_26.730427	561	641	2	10	80	0.1250000
NODE_3706_length_1223_cov_26.730427	561	641	4	15	80	0.1875000
NODE_3706_length_1223_cov_26.730427	561	641	5	1	80	0.0125000
NODE_3706_length_1223_cov_26.730427	561	641	6	54	80	0.6750000
NODE_3707_length_1223_cov_18.902135	460	540	0	80	80	1.0000000
NODE_3707_length_1223_cov_18.902135	513	593	0	80	80	1.0000000
NODE_3708_length_1223_cov_6.989324	707	778	0	71	71	1.0000000
NODE_3710_length_1223_cov_5.251779	666	746	0	80	80	1.0000000
NODE_3710_length_1223_cov_5.251779	719	799	0	80	80	1.0000000
NODE_3710_length_1223_cov_5.251779	795	875	0	80	80	1.0000000
NODE_3710_length_1223_cov_5.251779	848	928	0	49	80	0.6125000
NODE_3710_length_1223_cov_5.251779	848	928	4	31	80	0.3875000
NODE_3716_length_1222_cov_18.406946	273	353	0	80	80	1.0000000
NODE_3716_length_1222_cov_18.406946	326	406	0	80	80	1.0000000
NODE_3720_length_1221_cov_33.261141	505	577	2	19	72	0.2638889
NODE_3720_length_1221_cov_33.261141	505	577	4	43	72	0.5972222
NODE_3720_length_1221_cov_33.261141	505	577	6	10	72	0.1388889
NODE_3720_length_1221_cov_33.261141	558	637	4	47	79	0.5949367
NODE_3720_length_1221_cov_33.261141	558	637	6	32	79	0.4050633
NODE_3720_length_1221_cov_33.261141	633	713	0	20	80	0.2500000
NODE_3720_length_1221_cov_33.261141	633	713	2	44	80	0.5500000
NODE_3720_length_1221_cov_33.261141	633	713	4	16	80	0.2000000
NODE_3720_length_1221_cov_33.261141	686	766	2	80	80	1.0000000
NODE_3721_length_1221_cov_19.466132	541	621	0	80	80	1.0000000
NODE_3721_length_1221_cov_19.466132	594	674	0	80	80	1.0000000
NODE_3722_length_1221_cov_15.940285	788	868	2	5	80	0.0625000
NODE_3722_length_1221_cov_15.940285	788	868	4	75	80	0.9375000
NODE_3722_length_1221_cov_15.940285	841	921	0	40	80	0.5000000
NODE_3722_length_1221_cov_15.940285	841	921	2	18	80	0.2250000
NODE_3722_length_1221_cov_15.940285	841	921	4	22	80	0.2750000
NODE_3722_length_1221_cov_15.940285	917	997	0	70	80	0.8750000
NODE_3722_length_1221_cov_15.940285	917	997	2	10	80	0.1250000
NODE_3722_length_1221_cov_15.940285	970	1050	0	45	80	0.5625000
NODE_3722_length_1221_cov_15.940285	970	1050	2	35	80	0.4375000
NODE_3723_length_1221_cov_15.796791	484	564	0	40	80	0.5000000
NODE_3723_length_1221_cov_15.796791	484	564	2	40	80	0.5000000
NODE_3723_length_1221_cov_15.796791	537	617	0	28	80	0.3500000
NODE_3723_length_1221_cov_15.796791	537	617	2	52	80	0.6500000
NODE_3724_length_1221_cov_15.312834	342	415	4	5	73	0.0684932
NODE_3724_length_1221_cov_15.312834	342	415	6	21	73	0.2876712
NODE_3724_length_1221_cov_15.312834	342	415	8	47	73	0.6438356
NODE_3724_length_1221_cov_15.312834	395	474	0	39	79	0.4936709
NODE_3724_length_1221_cov_15.312834	395	474	2	11	79	0.1392405
NODE_3724_length_1221_cov_15.312834	395	474	4	8	79	0.1012658
NODE_3724_length_1221_cov_15.312834	395	474	6	13	79	0.1645570
NODE_3724_length_1221_cov_15.312834	395	474	8	8	79	0.1012658
NODE_3725_length_1221_cov_9.695187	988	1068	2	34	80	0.4250000
NODE_3725_length_1221_cov_9.695187	988	1068	4	26	80	0.3250000
NODE_3725_length_1221_cov_9.695187	988	1068	5	7	80	0.0875000
NODE_3725_length_1221_cov_9.695187	988	1068	6	13	80	0.1625000
NODE_3725_length_1221_cov_9.695187	1041	1100	2	1	59	0.0169492
NODE_3725_length_1221_cov_9.695187	1041	1100	4	45	59	0.7627119
NODE_3725_length_1221_cov_9.695187	1041	1100	5	7	59	0.1186441
NODE_3725_length_1221_cov_9.695187	1041	1100	6	6	59	0.1016949
NODE_3726_length_1221_cov_9.043672	695	775	0	80	80	1.0000000
NODE_3726_length_1221_cov_9.043672	748	828	0	80	80	1.0000000
NODE_3727_length_1221_cov_7.946524	147	227	0	31	80	0.3875000
NODE_3727_length_1221_cov_7.946524	147	227	2	28	80	0.3500000
NODE_3727_length_1221_cov_7.946524	147	227	4	21	80	0.2625000
NODE_3727_length_1221_cov_7.946524	200	280	2	6	80	0.0750000
NODE_3727_length_1221_cov_7.946524	200	280	4	74	80	0.9250000
NODE_3728_length_1221_cov_5.122103	248	328	0	58	80	0.7250000
NODE_3728_length_1221_cov_5.122103	248	328	2	22	80	0.2750000
NODE_3728_length_1221_cov_5.122103	301	381	0	80	80	1.0000000
NODE_3736_length_1220_cov_44.501338	319	399	4	5	80	0.0625000
NODE_3736_length_1220_cov_44.501338	319	399	5	73	80	0.9125000
NODE_3736_length_1220_cov_44.501338	319	399	7	2	80	0.0250000
NODE_3736_length_1220_cov_44.501338	372	452	4	11	80	0.1375000
NODE_3736_length_1220_cov_44.501338	372	452	5	25	80	0.3125000
NODE_3736_length_1220_cov_44.501338	372	452	7	3	80	0.0375000
NODE_3736_length_1220_cov_44.501338	372	452	8	23	80	0.2875000
NODE_3736_length_1220_cov_44.501338	372	452	11	1	80	0.0125000
NODE_3736_length_1220_cov_44.501338	372	452	12	17	80	0.2125000
NODE_3736_length_1220_cov_44.501338	448	528	12	12	80	0.1500000
NODE_3736_length_1220_cov_44.501338	448	528	14	1	80	0.0125000
NODE_3736_length_1220_cov_44.501338	448	528	15	42	80	0.5250000
NODE_3736_length_1220_cov_44.501338	448	528	16	7	80	0.0875000
NODE_3736_length_1220_cov_44.501338	448	528	17	12	80	0.1500000
NODE_3736_length_1220_cov_44.501338	448	528	18	6	80	0.0750000
NODE_3736_length_1220_cov_44.501338	501	581	0	25	80	0.3125000
NODE_3736_length_1220_cov_44.501338	501	581	7	1	80	0.0125000
NODE_3736_length_1220_cov_44.501338	501	581	8	3	80	0.0375000
NODE_3736_length_1220_cov_44.501338	501	581	10	2	80	0.0250000
NODE_3736_length_1220_cov_44.501338	501	581	11	12	80	0.1500000
NODE_3736_length_1220_cov_44.501338	501	581	13	3	80	0.0375000
NODE_3736_length_1220_cov_44.501338	501	581	15	34	80	0.4250000
NODE_3737_length_1220_cov_43.868867	720	800	2	39	80	0.4875000
NODE_3737_length_1220_cov_43.868867	720	800	6	13	80	0.1625000
NODE_3737_length_1220_cov_43.868867	720	800	8	3	80	0.0375000
NODE_3737_length_1220_cov_43.868867	720	800	10	13	80	0.1625000
NODE_3737_length_1220_cov_43.868867	720	800	12	12	80	0.1500000
NODE_3737_length_1220_cov_43.868867	773	853	8	16	80	0.2000000
NODE_3737_length_1220_cov_43.868867	773	853	10	52	80	0.6500000
NODE_3737_length_1220_cov_43.868867	773	853	12	12	80	0.1500000
NODE_3738_length_1220_cov_41.900089	593	673	6	5	80	0.0625000
NODE_3738_length_1220_cov_41.900089	593	673	8	28	80	0.3500000
NODE_3738_length_1220_cov_41.900089	593	673	10	47	80	0.5875000
NODE_3738_length_1220_cov_41.900089	646	726	0	13	80	0.1625000
NODE_3738_length_1220_cov_41.900089	646	726	2	23	80	0.2875000
NODE_3738_length_1220_cov_41.900089	646	726	4	14	80	0.1750000
NODE_3738_length_1220_cov_41.900089	646	726	6	8	80	0.1000000
NODE_3738_length_1220_cov_41.900089	646	726	8	13	80	0.1625000
NODE_3738_length_1220_cov_41.900089	646	726	10	9	80	0.1125000
NODE_3738_length_1220_cov_41.900089	722	802	0	41	80	0.5125000
NODE_3738_length_1220_cov_41.900089	722	802	3	1	80	0.0125000
NODE_3738_length_1220_cov_41.900089	722	802	4	38	80	0.4750000
NODE_3738_length_1220_cov_41.900089	775	855	0	80	80	1.0000000
NODE_3739_length_1220_cov_15.485281	395	475	0	13	80	0.1625000
NODE_3739_length_1220_cov_15.485281	395	475	4	66	80	0.8250000
NODE_3739_length_1220_cov_15.485281	395	475	6	1	80	0.0125000
NODE_3739_length_1220_cov_15.485281	448	528	2	6	80	0.0750000
NODE_3739_length_1220_cov_15.485281	448	528	4	26	80	0.3250000
NODE_3739_length_1220_cov_15.485281	448	528	6	48	80	0.6000000
NODE_3745_length_1219_cov_30.493750	643	723	0	80	80	1.0000000
NODE_3745_length_1219_cov_30.493750	696	776	0	80	80	1.0000000
NODE_3745_length_1219_cov_30.493750	772	852	0	80	80	1.0000000
NODE_3745_length_1219_cov_30.493750	825	905	0	80	80	1.0000000
NODE_3746_length_1219_cov_24.991071	566	646	0	80	80	1.0000000
NODE_3746_length_1219_cov_24.991071	619	699	0	80	80	1.0000000
NODE_3746_length_1219_cov_24.991071	695	775	0	15	80	0.1875000
NODE_3746_length_1219_cov_24.991071	695	775	2	9	80	0.1125000
NODE_3746_length_1219_cov_24.991071	695	775	4	56	80	0.7000000
NODE_3746_length_1219_cov_24.991071	748	828	0	30	80	0.3750000
NODE_3746_length_1219_cov_24.991071	748	828	2	14	80	0.1750000
NODE_3746_length_1219_cov_24.991071	748	828	4	36	80	0.4500000
NODE_3747_length_1219_cov_24.728571	465	545	2	24	80	0.3000000
NODE_3747_length_1219_cov_24.728571	465	545	4	48	80	0.6000000
NODE_3747_length_1219_cov_24.728571	465	545	6	8	80	0.1000000
NODE_3747_length_1219_cov_24.728571	518	598	0	50	80	0.6250000
NODE_3747_length_1219_cov_24.728571	518	598	2	27	80	0.3375000
NODE_3747_length_1219_cov_24.728571	518	598	4	3	80	0.0375000
NODE_3747_length_1219_cov_24.728571	594	674	0	61	80	0.7625000
NODE_3747_length_1219_cov_24.728571	594	674	2	19	80	0.2375000
NODE_3747_length_1219_cov_24.728571	647	727	0	8	80	0.1000000
NODE_3747_length_1219_cov_24.728571	647	727	2	72	80	0.9000000
NODE_3748_length_1219_cov_11.130357	535	615	0	16	80	0.2000000
NODE_3748_length_1219_cov_11.130357	535	615	2	5	80	0.0625000
NODE_3748_length_1219_cov_11.130357	535	615	4	29	80	0.3625000
NODE_3748_length_1219_cov_11.130357	535	615	6	30	80	0.3750000
NODE_3748_length_1219_cov_11.130357	588	668	2	30	80	0.3750000
NODE_3748_length_1219_cov_11.130357	588	668	4	7	80	0.0875000
NODE_3748_length_1219_cov_11.130357	588	668	6	43	80	0.5375000
NODE_3749_length_1219_cov_9.696429	734	814	6	14	80	0.1750000
NODE_3749_length_1219_cov_9.696429	734	814	8	66	80	0.8250000
NODE_3749_length_1219_cov_9.696429	787	867	0	8	80	0.1000000
NODE_3749_length_1219_cov_9.696429	787	867	2	28	80	0.3500000
NODE_3749_length_1219_cov_9.696429	787	867	4	14	80	0.1750000
NODE_3749_length_1219_cov_9.696429	787	867	8	30	80	0.3750000
NODE_3754_length_1218_cov_40.159071	554	634	1	34	80	0.4250000
NODE_3754_length_1218_cov_40.159071	554	634	4	46	80	0.5750000
NODE_3754_length_1218_cov_40.159071	607	687	2	46	80	0.5750000
NODE_3754_length_1218_cov_40.159071	607	687	4	34	80	0.4250000
NODE_3754_length_1218_cov_40.159071	683	763	0	25	80	0.3125000
NODE_3754_length_1218_cov_40.159071	683	763	1	34	80	0.4250000
NODE_3754_length_1218_cov_40.159071	683	763	2	21	80	0.2625000
NODE_3754_length_1218_cov_40.159071	736	816	0	78	80	0.9750000
NODE_3754_length_1218_cov_40.159071	736	816	1	2	80	0.0250000
NODE_3765_length_1216_cov_99.538944	44	124	59	2	80	0.0250000
NODE_3765_length_1216_cov_99.538944	44	124	60	1	80	0.0125000
NODE_3765_length_1216_cov_99.538944	44	124	62	1	80	0.0125000
NODE_3765_length_1216_cov_99.538944	44	124	68	2	80	0.0250000
NODE_3765_length_1216_cov_99.538944	44	124	70	4	80	0.0500000
NODE_3765_length_1216_cov_99.538944	44	124	76	2	80	0.0250000
NODE_3765_length_1216_cov_99.538944	44	124	78	3	80	0.0375000
NODE_3765_length_1216_cov_99.538944	44	124	80	1	80	0.0125000
NODE_3765_length_1216_cov_99.538944	44	124	84	1	80	0.0125000
NODE_3765_length_1216_cov_99.538944	44	124	86	2	80	0.0250000
NODE_3765_length_1216_cov_99.538944	44	124	88	2	80	0.0250000
NODE_3765_length_1216_cov_99.538944	44	124	90	1	80	0.0125000
NODE_3765_length_1216_cov_99.538944	44	124	94	3	80	0.0375000
NODE_3765_length_1216_cov_99.538944	44	124	99	1	80	0.0125000
NODE_3765_length_1216_cov_99.538944	44	124	101	2	80	0.0250000
NODE_3765_length_1216_cov_99.538944	44	124	104	2	80	0.0250000
NODE_3765_length_1216_cov_99.538944	44	124	107	2	80	0.0250000
NODE_3765_length_1216_cov_99.538944	44	124	109	1	80	0.0125000
NODE_3765_length_1216_cov_99.538944	44	124	111	4	80	0.0500000
NODE_3765_length_1216_cov_99.538944	44	124	113	4	80	0.0500000
NODE_3765_length_1216_cov_99.538944	44	124	115	4	80	0.0500000
NODE_3765_length_1216_cov_99.538944	44	124	117	1	80	0.0125000
NODE_3765_length_1216_cov_99.538944	44	124	119	2	80	0.0250000
NODE_3765_length_1216_cov_99.538944	44	124	121	1	80	0.0125000
NODE_3765_length_1216_cov_99.538944	44	124	123	2	80	0.0250000
NODE_3765_length_1216_cov_99.538944	44	124	125	8	80	0.1000000
NODE_3765_length_1216_cov_99.538944	44	124	126	1	80	0.0125000
NODE_3765_length_1216_cov_99.538944	44	124	128	1	80	0.0125000
NODE_3765_length_1216_cov_99.538944	44	124	132	1	80	0.0125000
NODE_3765_length_1216_cov_99.538944	44	124	134	3	80	0.0375000
NODE_3765_length_1216_cov_99.538944	44	124	137	2	80	0.0250000
NODE_3765_length_1216_cov_99.538944	44	124	139	5	80	0.0625000
NODE_3765_length_1216_cov_99.538944	44	124	143	1	80	0.0125000
NODE_3765_length_1216_cov_99.538944	44	124	147	2	80	0.0250000
NODE_3765_length_1216_cov_99.538944	44	124	149	2	80	0.0250000
NODE_3765_length_1216_cov_99.538944	44	124	151	3	80	0.0375000
NODE_3765_length_1216_cov_99.538944	97	157	125	6	60	0.1000000
NODE_3765_length_1216_cov_99.538944	97	157	126	1	60	0.0166667
NODE_3765_length_1216_cov_99.538944	97	157	128	1	60	0.0166667
NODE_3765_length_1216_cov_99.538944	97	157	132	1	60	0.0166667
NODE_3765_length_1216_cov_99.538944	97	157	134	3	60	0.0500000
NODE_3765_length_1216_cov_99.538944	97	157	137	2	60	0.0333333
NODE_3765_length_1216_cov_99.538944	97	157	139	5	60	0.0833333
NODE_3765_length_1216_cov_99.538944	97	157	143	1	60	0.0166667
NODE_3765_length_1216_cov_99.538944	97	157	146	5	60	0.0833333
NODE_3765_length_1216_cov_99.538944	97	157	147	4	60	0.0666667
NODE_3765_length_1216_cov_99.538944	97	157	148	1	60	0.0166667
NODE_3765_length_1216_cov_99.538944	97	157	149	5	60	0.0833333
NODE_3765_length_1216_cov_99.538944	97	157	151	11	60	0.1833333
NODE_3765_length_1216_cov_99.538944	97	157	152	4	60	0.0666667
NODE_3765_length_1216_cov_99.538944	97	157	153	4	60	0.0666667
NODE_3765_length_1216_cov_99.538944	97	157	154	1	60	0.0166667
NODE_3765_length_1216_cov_99.538944	97	157	156	1	60	0.0166667
NODE_3765_length_1216_cov_99.538944	97	157	158	1	60	0.0166667
NODE_3765_length_1216_cov_99.538944	97	157	159	2	60	0.0333333
NODE_3765_length_1216_cov_99.538944	97	157	161	1	60	0.0166667
NODE_3765_length_1216_cov_99.538944	824	903	66	2	79	0.0253165
NODE_3765_length_1216_cov_99.538944	824	903	68	1	79	0.0126582
NODE_3765_length_1216_cov_99.538944	824	903	70	4	79	0.0506329
NODE_3765_length_1216_cov_99.538944	824	903	72	4	79	0.0506329
NODE_3765_length_1216_cov_99.538944	824	903	74	3	79	0.0379747
NODE_3765_length_1216_cov_99.538944	824	903	76	5	79	0.0632911
NODE_3765_length_1216_cov_99.538944	824	903	78	3	79	0.0379747
NODE_3765_length_1216_cov_99.538944	824	903	80	2	79	0.0253165
NODE_3765_length_1216_cov_99.538944	824	903	82	2	79	0.0253165
NODE_3765_length_1216_cov_99.538944	824	903	84	5	79	0.0632911
NODE_3765_length_1216_cov_99.538944	824	903	86	4	79	0.0506329
NODE_3765_length_1216_cov_99.538944	824	903	88	4	79	0.0506329
NODE_3765_length_1216_cov_99.538944	824	903	90	6	79	0.0759494
NODE_3765_length_1216_cov_99.538944	824	903	92	4	79	0.0506329
NODE_3765_length_1216_cov_99.538944	824	903	94	2	79	0.0253165
NODE_3765_length_1216_cov_99.538944	824	903	96	2	79	0.0253165
NODE_3765_length_1216_cov_99.538944	824	903	98	3	79	0.0379747
NODE_3765_length_1216_cov_99.538944	824	903	100	7	79	0.0886076
NODE_3765_length_1216_cov_99.538944	824	903	102	2	79	0.0253165
NODE_3765_length_1216_cov_99.538944	824	903	104	2	79	0.0253165
NODE_3765_length_1216_cov_99.538944	824	903	108	1	79	0.0126582
NODE_3765_length_1216_cov_99.538944	824	903	114	2	79	0.0253165
NODE_3765_length_1216_cov_99.538944	824	903	120	1	79	0.0126582
NODE_3765_length_1216_cov_99.538944	824	903	128	1	79	0.0126582
NODE_3765_length_1216_cov_99.538944	824	903	138	1	79	0.0126582
NODE_3765_length_1216_cov_99.538944	824	903	141	1	79	0.0126582
NODE_3765_length_1216_cov_99.538944	824	903	149	1	79	0.0126582
NODE_3765_length_1216_cov_99.538944	824	903	159	1	79	0.0126582
NODE_3765_length_1216_cov_99.538944	824	903	169	2	79	0.0253165
NODE_3765_length_1216_cov_99.538944	824	903	171	1	79	0.0126582
NODE_3766_length_1216_cov_15.855864	668	748	2	24	80	0.3000000
NODE_3766_length_1216_cov_15.855864	668	748	4	56	80	0.7000000
NODE_3766_length_1216_cov_15.855864	721	801	0	17	80	0.2125000
NODE_3766_length_1216_cov_15.855864	721	801	2	20	80	0.2500000
NODE_3766_length_1216_cov_15.855864	721	801	4	43	80	0.5375000
NODE_3767_length_1216_cov_4.128917	720	800	0	80	80	1.0000000
NODE_3767_length_1216_cov_4.128917	773	853	0	80	80	1.0000000
NODE_3774_length_1215_cov_32.293011	411	491	0	26	80	0.3250000
NODE_3774_length_1215_cov_32.293011	411	491	2	54	80	0.6750000
NODE_3774_length_1215_cov_32.293011	464	544	0	32	80	0.4000000
NODE_3774_length_1215_cov_32.293011	464	544	2	48	80	0.6000000
NODE_3775_length_1215_cov_24.177419	729	809	0	80	80	1.0000000
NODE_3775_length_1215_cov_24.177419	782	862	0	57	80	0.7125000
NODE_3775_length_1215_cov_24.177419	782	862	2	23	80	0.2875000
NODE_3776_length_1215_cov_21.566308	645	725	0	10	80	0.1250000
NODE_3776_length_1215_cov_21.566308	645	725	2	49	80	0.6125000
NODE_3776_length_1215_cov_21.566308	645	725	11	2	80	0.0250000
NODE_3776_length_1215_cov_21.566308	645	725	13	19	80	0.2375000
NODE_3776_length_1215_cov_21.566308	698	778	2	6	80	0.0750000
NODE_3776_length_1215_cov_21.566308	698	778	10	2	80	0.0250000
NODE_3776_length_1215_cov_21.566308	698	778	11	2	80	0.0250000
NODE_3776_length_1215_cov_21.566308	698	778	12	14	80	0.1750000
NODE_3776_length_1215_cov_21.566308	698	778	13	53	80	0.6625000
NODE_3776_length_1215_cov_21.566308	698	778	14	3	80	0.0375000
NODE_3777_length_1215_cov_19.278674	630	710	0	80	80	1.0000000
NODE_3777_length_1215_cov_19.278674	683	763	0	80	80	1.0000000
NODE_3778_length_1215_cov_15.074373	664	744	0	21	80	0.2625000
NODE_3778_length_1215_cov_15.074373	664	744	2	27	80	0.3375000
NODE_3778_length_1215_cov_15.074373	664	744	4	5	80	0.0625000
NODE_3778_length_1215_cov_15.074373	664	744	6	27	80	0.3375000
NODE_3778_length_1215_cov_15.074373	717	797	2	32	80	0.4000000
NODE_3778_length_1215_cov_15.074373	717	797	4	4	80	0.0500000
NODE_3778_length_1215_cov_15.074373	717	797	6	44	80	0.5500000
NODE_3779_length_1215_cov_5.932796	507	587	0	80	80	1.0000000
NODE_3779_length_1215_cov_5.932796	560	640	0	80	80	1.0000000
NODE_3787_length_1214_cov_26.771300	420	500	45	2	80	0.0250000
NODE_3787_length_1214_cov_26.771300	420	500	47	1	80	0.0125000
NODE_3787_length_1214_cov_26.771300	420	500	49	1	80	0.0125000
NODE_3787_length_1214_cov_26.771300	420	500	55	2	80	0.0250000
NODE_3787_length_1214_cov_26.771300	420	500	57	1	80	0.0125000
NODE_3787_length_1214_cov_26.771300	420	500	69	1	80	0.0125000
NODE_3787_length_1214_cov_26.771300	420	500	71	1	80	0.0125000
NODE_3787_length_1214_cov_26.771300	420	500	79	1	80	0.0125000
NODE_3787_length_1214_cov_26.771300	420	500	85	1	80	0.0125000
NODE_3787_length_1214_cov_26.771300	420	500	93	1	80	0.0125000
NODE_3787_length_1214_cov_26.771300	420	500	98	1	80	0.0125000
NODE_3787_length_1214_cov_26.771300	420	500	105	1	80	0.0125000
NODE_3787_length_1214_cov_26.771300	420	500	107	1	80	0.0125000
NODE_3787_length_1214_cov_26.771300	420	500	109	1	80	0.0125000
NODE_3787_length_1214_cov_26.771300	420	500	120	2	80	0.0250000
NODE_3787_length_1214_cov_26.771300	420	500	122	1	80	0.0125000
NODE_3787_length_1214_cov_26.771300	420	500	131	1	80	0.0125000
NODE_3787_length_1214_cov_26.771300	420	500	135	1	80	0.0125000
NODE_3787_length_1214_cov_26.771300	420	500	137	1	80	0.0125000
NODE_3787_length_1214_cov_26.771300	420	500	138	1	80	0.0125000
NODE_3787_length_1214_cov_26.771300	420	500	159	1	80	0.0125000
NODE_3787_length_1214_cov_26.771300	420	500	161	1	80	0.0125000
NODE_3787_length_1214_cov_26.771300	420	500	167	1	80	0.0125000
NODE_3787_length_1214_cov_26.771300	420	500	168	1	80	0.0125000
NODE_3787_length_1214_cov_26.771300	420	500	169	1	80	0.0125000
NODE_3787_length_1214_cov_26.771300	420	500	170	1	80	0.0125000
NODE_3787_length_1214_cov_26.771300	420	500	172	1	80	0.0125000
NODE_3787_length_1214_cov_26.771300	420	500	179	3	80	0.0375000
NODE_3787_length_1214_cov_26.771300	420	500	181	1	80	0.0125000
NODE_3787_length_1214_cov_26.771300	420	500	183	1	80	0.0125000
NODE_3787_length_1214_cov_26.771300	420	500	191	1	80	0.0125000
NODE_3787_length_1214_cov_26.771300	420	500	193	1	80	0.0125000
NODE_3787_length_1214_cov_26.771300	420	500	196	1	80	0.0125000
NODE_3787_length_1214_cov_26.771300	420	500	198	1	80	0.0125000
NODE_3787_length_1214_cov_26.771300	420	500	200	3	80	0.0375000
NODE_3787_length_1214_cov_26.771300	420	500	201	4	80	0.0500000
NODE_3787_length_1214_cov_26.771300	420	500	205	5	80	0.0625000
NODE_3787_length_1214_cov_26.771300	420	500	206	8	80	0.1000000
NODE_3787_length_1214_cov_26.771300	420	500	207	2	80	0.0250000
NODE_3787_length_1214_cov_26.771300	420	500	208	19	80	0.2375000
NODE_3787_length_1214_cov_26.771300	473	553	28	1	80	0.0125000
NODE_3787_length_1214_cov_26.771300	473	553	30	1	80	0.0125000
NODE_3787_length_1214_cov_26.771300	473	553	34	1	80	0.0125000
NODE_3787_length_1214_cov_26.771300	473	553	38	1	80	0.0125000
NODE_3787_length_1214_cov_26.771300	473	553	43	2	80	0.0250000
NODE_3787_length_1214_cov_26.771300	473	553	54	1	80	0.0125000
NODE_3787_length_1214_cov_26.771300	473	553	55	2	80	0.0250000
NODE_3787_length_1214_cov_26.771300	473	553	60	1	80	0.0125000
NODE_3787_length_1214_cov_26.771300	473	553	62	1	80	0.0125000
NODE_3787_length_1214_cov_26.771300	473	553	66	1	80	0.0125000
NODE_3787_length_1214_cov_26.771300	473	553	74	1	80	0.0125000
NODE_3787_length_1214_cov_26.771300	473	553	76	1	80	0.0125000
NODE_3787_length_1214_cov_26.771300	473	553	78	1	80	0.0125000
NODE_3787_length_1214_cov_26.771300	473	553	80	3	80	0.0375000
NODE_3787_length_1214_cov_26.771300	473	553	90	2	80	0.0250000
NODE_3787_length_1214_cov_26.771300	473	553	91	2	80	0.0250000
NODE_3787_length_1214_cov_26.771300	473	553	99	2	80	0.0250000
NODE_3787_length_1214_cov_26.771300	473	553	107	1	80	0.0125000
NODE_3787_length_1214_cov_26.771300	473	553	109	1	80	0.0125000
NODE_3787_length_1214_cov_26.771300	473	553	117	1	80	0.0125000
NODE_3787_length_1214_cov_26.771300	473	553	119	1	80	0.0125000
NODE_3787_length_1214_cov_26.771300	473	553	121	1	80	0.0125000
NODE_3787_length_1214_cov_26.771300	473	553	125	1	80	0.0125000
NODE_3787_length_1214_cov_26.771300	473	553	131	1	80	0.0125000
NODE_3787_length_1214_cov_26.771300	473	553	133	1	80	0.0125000
NODE_3787_length_1214_cov_26.771300	473	553	135	3	80	0.0375000
NODE_3787_length_1214_cov_26.771300	473	553	147	1	80	0.0125000
NODE_3787_length_1214_cov_26.771300	473	553	157	2	80	0.0250000
NODE_3787_length_1214_cov_26.771300	473	553	163	1	80	0.0125000
NODE_3787_length_1214_cov_26.771300	473	553	172	1	80	0.0125000
NODE_3787_length_1214_cov_26.771300	473	553	174	4	80	0.0500000
NODE_3787_length_1214_cov_26.771300	473	553	177	1	80	0.0125000
NODE_3787_length_1214_cov_26.771300	473	553	178	2	80	0.0250000
NODE_3787_length_1214_cov_26.771300	473	553	179	1	80	0.0125000
NODE_3787_length_1214_cov_26.771300	473	553	186	2	80	0.0250000
NODE_3787_length_1214_cov_26.771300	473	553	188	1	80	0.0125000
NODE_3787_length_1214_cov_26.771300	473	553	194	1	80	0.0125000
NODE_3787_length_1214_cov_26.771300	473	553	198	2	80	0.0250000
NODE_3787_length_1214_cov_26.771300	473	553	200	3	80	0.0375000
NODE_3787_length_1214_cov_26.771300	473	553	201	1	80	0.0125000
NODE_3787_length_1214_cov_26.771300	473	553	205	5	80	0.0625000
NODE_3787_length_1214_cov_26.771300	473	553	206	4	80	0.0500000
NODE_3787_length_1214_cov_26.771300	473	553	207	2	80	0.0250000
NODE_3787_length_1214_cov_26.771300	473	553	208	11	80	0.1375000
NODE_3788_length_1214_cov_24.555157	480	560	0	80	80	1.0000000
NODE_3788_length_1214_cov_24.555157	533	613	0	80	80	1.0000000
NODE_3789_length_1214_cov_23.167713	623	703	0	19	80	0.2375000
NODE_3789_length_1214_cov_23.167713	623	703	2	47	80	0.5875000
NODE_3789_length_1214_cov_23.167713	623	703	4	14	80	0.1750000
NODE_3789_length_1214_cov_23.167713	676	756	2	47	80	0.5875000
NODE_3789_length_1214_cov_23.167713	676	756	4	33	80	0.4125000
NODE_3790_length_1214_cov_18.452915	555	635	0	80	80	1.0000000
NODE_3790_length_1214_cov_18.452915	608	688	0	80	80	1.0000000
NODE_3790_length_1214_cov_18.452915	684	764	0	80	80	1.0000000
NODE_3790_length_1214_cov_18.452915	737	817	0	29	80	0.3625000
NODE_3790_length_1214_cov_18.452915	737	817	2	51	80	0.6375000
NODE_3791_length_1214_cov_8.906726	206	286	0	80	80	1.0000000
NODE_3791_length_1214_cov_8.906726	259	339	0	80	80	1.0000000
NODE_3792_length_1214_cov_3.686996	415	495	0	80	80	1.0000000
NODE_3792_length_1214_cov_3.686996	468	548	0	80	80	1.0000000
NODE_3799_length_1214_cov_0.967713	1049	1129	122	1	80	0.0125000
NODE_3799_length_1214_cov_0.967713	1049	1129	124	1	80	0.0125000
NODE_3799_length_1214_cov_0.967713	1049	1129	130	1	80	0.0125000
NODE_3799_length_1214_cov_0.967713	1049	1129	154	1	80	0.0125000
NODE_3799_length_1214_cov_0.967713	1049	1129	160	1	80	0.0125000
NODE_3799_length_1214_cov_0.967713	1049	1129	164	3	80	0.0375000
NODE_3799_length_1214_cov_0.967713	1049	1129	180	1	80	0.0125000
NODE_3799_length_1214_cov_0.967713	1049	1129	182	1	80	0.0125000
NODE_3799_length_1214_cov_0.967713	1049	1129	195	1	80	0.0125000
NODE_3799_length_1214_cov_0.967713	1049	1129	198	1	80	0.0125000
NODE_3799_length_1214_cov_0.967713	1049	1129	212	3	80	0.0375000
NODE_3799_length_1214_cov_0.967713	1049	1129	218	3	80	0.0375000
NODE_3799_length_1214_cov_0.967713	1049	1129	220	1	80	0.0125000
NODE_3799_length_1214_cov_0.967713	1049	1129	222	2	80	0.0250000
NODE_3799_length_1214_cov_0.967713	1049	1129	224	1	80	0.0125000
NODE_3799_length_1214_cov_0.967713	1049	1129	226	4	80	0.0500000
NODE_3799_length_1214_cov_0.967713	1049	1129	228	6	80	0.0750000
NODE_3799_length_1214_cov_0.967713	1049	1129	230	1	80	0.0125000
NODE_3799_length_1214_cov_0.967713	1049	1129	232	1	80	0.0125000
NODE_3799_length_1214_cov_0.967713	1049	1129	234	3	80	0.0375000
NODE_3799_length_1214_cov_0.967713	1049	1129	235	1	80	0.0125000
NODE_3799_length_1214_cov_0.967713	1049	1129	236	5	80	0.0625000
NODE_3799_length_1214_cov_0.967713	1049	1129	237	3	80	0.0375000
NODE_3799_length_1214_cov_0.967713	1049	1129	239	3	80	0.0375000
NODE_3799_length_1214_cov_0.967713	1049	1129	244	1	80	0.0125000
NODE_3799_length_1214_cov_0.967713	1049	1129	245	3	80	0.0375000
NODE_3799_length_1214_cov_0.967713	1049	1129	246	2	80	0.0250000
NODE_3799_length_1214_cov_0.967713	1049	1129	247	4	80	0.0500000
NODE_3799_length_1214_cov_0.967713	1049	1129	248	1	80	0.0125000
NODE_3799_length_1214_cov_0.967713	1049	1129	251	1	80	0.0125000
NODE_3799_length_1214_cov_0.967713	1049	1129	252	7	80	0.0875000
NODE_3799_length_1214_cov_0.967713	1049	1129	253	1	80	0.0125000
NODE_3799_length_1214_cov_0.967713	1049	1129	256	2	80	0.0250000
NODE_3799_length_1214_cov_0.967713	1049	1129	257	2	80	0.0250000
NODE_3799_length_1214_cov_0.967713	1049	1129	258	3	80	0.0375000
NODE_3799_length_1214_cov_0.967713	1049	1129	259	1	80	0.0125000
NODE_3799_length_1214_cov_0.967713	1049	1129	261	3	80	0.0375000
NODE_3800_length_1213_cov_19.524237	499	579	2	80	80	1.0000000
NODE_3800_length_1213_cov_19.524237	552	632	2	70	80	0.8750000
NODE_3800_length_1213_cov_19.524237	552	632	4	10	80	0.1250000
NODE_3806_length_1212_cov_32.663073	688	768	0	14	80	0.1750000
NODE_3806_length_1212_cov_32.663073	688	768	2	66	80	0.8250000
NODE_3806_length_1212_cov_32.663073	741	821	0	52	80	0.6500000
NODE_3806_length_1212_cov_32.663073	741	821	2	28	80	0.3500000
NODE_3807_length_1212_cov_15.981132	33	113	2	3	80	0.0375000
NODE_3807_length_1212_cov_15.981132	33	113	4	36	80	0.4500000
NODE_3807_length_1212_cov_15.981132	33	113	6	41	80	0.5125000
NODE_3807_length_1212_cov_15.981132	511	591	0	4	80	0.0500000
NODE_3807_length_1212_cov_15.981132	511	591	2	22	80	0.2750000
NODE_3807_length_1212_cov_15.981132	511	591	4	54	80	0.6750000
NODE_3807_length_1212_cov_15.981132	564	637	4	73	73	1.0000000
NODE_3813_length_1211_cov_30.513489	561	641	2	80	80	1.0000000
NODE_3813_length_1211_cov_30.513489	614	694	0	48	80	0.6000000
NODE_3813_length_1211_cov_30.513489	614	694	2	32	80	0.4000000
NODE_3813_length_1211_cov_30.513489	690	770	0	80	80	1.0000000
NODE_3813_length_1211_cov_30.513489	743	823	0	80	80	1.0000000
NODE_3815_length_1211_cov_10.073741	380	460	2	80	80	1.0000000
NODE_3815_length_1211_cov_10.073741	433	513	0	42	80	0.5250000
NODE_3815_length_1211_cov_10.073741	433	513	2	38	80	0.4750000
NODE_3816_length_1211_cov_7.561151	598	678	0	20	80	0.2500000
NODE_3816_length_1211_cov_7.561151	598	678	2	41	80	0.5125000
NODE_3816_length_1211_cov_7.561151	598	678	4	19	80	0.2375000
NODE_3816_length_1211_cov_7.561151	651	731	2	76	80	0.9500000
NODE_3816_length_1211_cov_7.561151	651	731	4	4	80	0.0500000
NODE_3820_length_1210_cov_49.743474	398	478	0	80	80	1.0000000
NODE_3820_length_1210_cov_49.743474	451	531	0	80	80	1.0000000
NODE_3821_length_1210_cov_15.647165	647	727	0	80	80	1.0000000
NODE_3821_length_1210_cov_15.647165	700	780	0	80	80	1.0000000
NODE_3822_length_1210_cov_11.194419	794	874	0	80	80	1.0000000
NODE_3822_length_1210_cov_11.194419	847	927	0	80	80	1.0000000
NODE_3826_length_1209_cov_24.504505	582	662	0	6	80	0.0750000
NODE_3826_length_1209_cov_24.504505	582	662	2	74	80	0.9250000
NODE_3826_length_1209_cov_24.504505	635	715	0	57	80	0.7125000
NODE_3826_length_1209_cov_24.504505	635	715	2	23	80	0.2875000
NODE_3826_length_1209_cov_24.504505	711	791	0	80	80	1.0000000
NODE_3826_length_1209_cov_24.504505	764	844	0	80	80	1.0000000
NODE_3827_length_1209_cov_21.846847	520	600	0	80	80	1.0000000
NODE_3827_length_1209_cov_21.846847	573	653	0	80	80	1.0000000
NODE_3827_length_1209_cov_21.846847	649	729	0	80	80	1.0000000
NODE_3827_length_1209_cov_21.846847	702	782	0	80	80	1.0000000
NODE_3828_length_1209_cov_9.026126	782	862	0	3	80	0.0375000
NODE_3828_length_1209_cov_9.026126	782	862	4	51	80	0.6375000
NODE_3828_length_1209_cov_9.026126	782	862	6	26	80	0.3250000
NODE_3828_length_1209_cov_9.026126	835	915	2	6	80	0.0750000
NODE_3828_length_1209_cov_9.026126	835	915	4	1	80	0.0125000
NODE_3828_length_1209_cov_9.026126	835	915	6	73	80	0.9125000
NODE_3830_length_1209_cov_5.721622	926	1006	0	80	80	1.0000000
NODE_3830_length_1209_cov_5.721622	979	1059	0	80	80	1.0000000
NODE_3833_length_1208_cov_40.717764	886	966	35	1	80	0.0125000
NODE_3833_length_1208_cov_40.717764	886	966	37	1	80	0.0125000
NODE_3833_length_1208_cov_40.717764	886	966	39	1	80	0.0125000
NODE_3833_length_1208_cov_40.717764	886	966	40	4	80	0.0500000
NODE_3833_length_1208_cov_40.717764	886	966	41	1	80	0.0125000
NODE_3833_length_1208_cov_40.717764	886	966	43	3	80	0.0375000
NODE_3833_length_1208_cov_40.717764	886	966	47	1	80	0.0125000
NODE_3833_length_1208_cov_40.717764	886	966	48	1	80	0.0125000
NODE_3833_length_1208_cov_40.717764	886	966	51	2	80	0.0250000
NODE_3833_length_1208_cov_40.717764	886	966	53	3	80	0.0375000
NODE_3833_length_1208_cov_40.717764	886	966	55	4	80	0.0500000
NODE_3833_length_1208_cov_40.717764	886	966	60	1	80	0.0125000
NODE_3833_length_1208_cov_40.717764	886	966	62	2	80	0.0250000
NODE_3833_length_1208_cov_40.717764	886	966	64	1	80	0.0125000
NODE_3833_length_1208_cov_40.717764	886	966	66	2	80	0.0250000
NODE_3833_length_1208_cov_40.717764	886	966	68	1	80	0.0125000
NODE_3833_length_1208_cov_40.717764	886	966	70	1	80	0.0125000
NODE_3833_length_1208_cov_40.717764	886	966	71	1	80	0.0125000
NODE_3833_length_1208_cov_40.717764	886	966	77	1	80	0.0125000
NODE_3833_length_1208_cov_40.717764	886	966	79	1	80	0.0125000
NODE_3833_length_1208_cov_40.717764	886	966	85	1	80	0.0125000
NODE_3833_length_1208_cov_40.717764	886	966	87	3	80	0.0375000
NODE_3833_length_1208_cov_40.717764	886	966	91	3	80	0.0375000
NODE_3833_length_1208_cov_40.717764	886	966	95	2	80	0.0250000
NODE_3833_length_1208_cov_40.717764	886	966	97	2	80	0.0250000
NODE_3833_length_1208_cov_40.717764	886	966	99	1	80	0.0125000
NODE_3833_length_1208_cov_40.717764	886	966	101	2	80	0.0250000
NODE_3833_length_1208_cov_40.717764	886	966	102	1	80	0.0125000
NODE_3833_length_1208_cov_40.717764	886	966	103	2	80	0.0250000
NODE_3833_length_1208_cov_40.717764	886	966	109	3	80	0.0375000
NODE_3833_length_1208_cov_40.717764	886	966	131	1	80	0.0125000
NODE_3833_length_1208_cov_40.717764	886	966	136	1	80	0.0125000
NODE_3833_length_1208_cov_40.717764	886	966	143	1	80	0.0125000
NODE_3833_length_1208_cov_40.717764	886	966	154	1	80	0.0125000
NODE_3833_length_1208_cov_40.717764	886	966	156	1	80	0.0125000
NODE_3833_length_1208_cov_40.717764	886	966	161	1	80	0.0125000
NODE_3833_length_1208_cov_40.717764	886	966	168	2	80	0.0250000
NODE_3833_length_1208_cov_40.717764	886	966	176	1	80	0.0125000
NODE_3833_length_1208_cov_40.717764	886	966	184	1	80	0.0125000
NODE_3833_length_1208_cov_40.717764	886	966	190	2	80	0.0250000
NODE_3833_length_1208_cov_40.717764	886	966	202	1	80	0.0125000
NODE_3833_length_1208_cov_40.717764	886	966	214	1	80	0.0125000
NODE_3833_length_1208_cov_40.717764	886	966	225	1	80	0.0125000
NODE_3833_length_1208_cov_40.717764	886	966	231	1	80	0.0125000
NODE_3833_length_1208_cov_40.717764	886	966	241	1	80	0.0125000
NODE_3833_length_1208_cov_40.717764	886	966	243	1	80	0.0125000
NODE_3833_length_1208_cov_40.717764	886	966	251	1	80	0.0125000
NODE_3833_length_1208_cov_40.717764	886	966	268	1	80	0.0125000
NODE_3833_length_1208_cov_40.717764	886	966	275	1	80	0.0125000
NODE_3833_length_1208_cov_40.717764	886	966	277	1	80	0.0125000
NODE_3833_length_1208_cov_40.717764	886	966	297	1	80	0.0125000
NODE_3833_length_1208_cov_40.717764	886	966	299	1	80	0.0125000
NODE_3833_length_1208_cov_40.717764	886	966	301	1	80	0.0125000
NODE_3833_length_1208_cov_40.717764	886	966	322	1	80	0.0125000
NODE_3833_length_1208_cov_40.717764	886	966	328	1	80	0.0125000
NODE_3833_length_1208_cov_40.717764	939	985	131	1	46	0.0217391
NODE_3833_length_1208_cov_40.717764	939	985	136	1	46	0.0217391
NODE_3833_length_1208_cov_40.717764	939	985	143	1	46	0.0217391
NODE_3833_length_1208_cov_40.717764	939	985	154	1	46	0.0217391
NODE_3833_length_1208_cov_40.717764	939	985	156	1	46	0.0217391
NODE_3833_length_1208_cov_40.717764	939	985	161	1	46	0.0217391
NODE_3833_length_1208_cov_40.717764	939	985	168	2	46	0.0434783
NODE_3833_length_1208_cov_40.717764	939	985	176	1	46	0.0217391
NODE_3833_length_1208_cov_40.717764	939	985	184	1	46	0.0217391
NODE_3833_length_1208_cov_40.717764	939	985	190	2	46	0.0434783
NODE_3833_length_1208_cov_40.717764	939	985	202	1	46	0.0217391
NODE_3833_length_1208_cov_40.717764	939	985	214	1	46	0.0217391
NODE_3833_length_1208_cov_40.717764	939	985	225	1	46	0.0217391
NODE_3833_length_1208_cov_40.717764	939	985	231	1	46	0.0217391
NODE_3833_length_1208_cov_40.717764	939	985	241	1	46	0.0217391
NODE_3833_length_1208_cov_40.717764	939	985	243	1	46	0.0217391
NODE_3833_length_1208_cov_40.717764	939	985	251	1	46	0.0217391
NODE_3833_length_1208_cov_40.717764	939	985	268	1	46	0.0217391
NODE_3833_length_1208_cov_40.717764	939	985	275	1	46	0.0217391
NODE_3833_length_1208_cov_40.717764	939	985	277	1	46	0.0217391
NODE_3833_length_1208_cov_40.717764	939	985	297	1	46	0.0217391
NODE_3833_length_1208_cov_40.717764	939	985	299	1	46	0.0217391
NODE_3833_length_1208_cov_40.717764	939	985	301	1	46	0.0217391
NODE_3833_length_1208_cov_40.717764	939	985	322	1	46	0.0217391
NODE_3833_length_1208_cov_40.717764	939	985	328	1	46	0.0217391
NODE_3833_length_1208_cov_40.717764	939	985	336	1	46	0.0217391
NODE_3833_length_1208_cov_40.717764	939	985	342	1	46	0.0217391
NODE_3833_length_1208_cov_40.717764	939	985	364	1	46	0.0217391
NODE_3833_length_1208_cov_40.717764	939	985	383	1	46	0.0217391
NODE_3833_length_1208_cov_40.717764	939	985	408	1	46	0.0217391
NODE_3833_length_1208_cov_40.717764	939	985	426	1	46	0.0217391
NODE_3833_length_1208_cov_40.717764	939	985	427	1	46	0.0217391
NODE_3833_length_1208_cov_40.717764	939	985	439	1	46	0.0217391
NODE_3833_length_1208_cov_40.717764	939	985	446	1	46	0.0217391
NODE_3833_length_1208_cov_40.717764	939	985	452	1	46	0.0217391
NODE_3833_length_1208_cov_40.717764	939	985	458	1	46	0.0217391
NODE_3833_length_1208_cov_40.717764	939	985	481	1	46	0.0217391
NODE_3833_length_1208_cov_40.717764	939	985	491	1	46	0.0217391
NODE_3833_length_1208_cov_40.717764	939	985	511	1	46	0.0217391
NODE_3833_length_1208_cov_40.717764	939	985	513	1	46	0.0217391
NODE_3833_length_1208_cov_40.717764	939	985	519	1	46	0.0217391
NODE_3833_length_1208_cov_40.717764	939	985	523	1	46	0.0217391
NODE_3833_length_1208_cov_40.717764	939	985	537	2	46	0.0434783
NODE_3834_length_1208_cov_28.528404	614	694	0	80	80	1.0000000
NODE_3834_length_1208_cov_28.528404	667	747	0	80	80	1.0000000
NODE_3835_length_1208_cov_19.688007	682	762	0	80	80	1.0000000
NODE_3835_length_1208_cov_19.688007	735	815	0	80	80	1.0000000
NODE_3836_length_1208_cov_18.577096	455	535	0	22	80	0.2750000
NODE_3836_length_1208_cov_18.577096	455	535	2	58	80	0.7250000
NODE_3836_length_1208_cov_18.577096	508	588	0	38	80	0.4750000
NODE_3836_length_1208_cov_18.577096	508	588	2	42	80	0.5250000
NODE_3836_length_1208_cov_18.577096	584	664	0	7	80	0.0875000
NODE_3836_length_1208_cov_18.577096	584	664	2	73	80	0.9125000
NODE_3836_length_1208_cov_18.577096	637	717	0	58	80	0.7250000
NODE_3836_length_1208_cov_18.577096	637	717	2	22	80	0.2750000
NODE_3837_length_1208_cov_12.733995	766	846	0	80	80	1.0000000
NODE_3837_length_1208_cov_12.733995	819	899	0	80	80	1.0000000
NODE_3837_length_1208_cov_12.733995	895	975	0	6	80	0.0750000
NODE_3837_length_1208_cov_12.733995	895	975	2	13	80	0.1625000
NODE_3837_length_1208_cov_12.733995	895	975	4	31	80	0.3875000
NODE_3837_length_1208_cov_12.733995	895	975	6	4	80	0.0500000
NODE_3837_length_1208_cov_12.733995	895	975	8	26	80	0.3250000
NODE_3837_length_1208_cov_12.733995	948	1028	2	9	80	0.1125000
NODE_3837_length_1208_cov_12.733995	948	1028	4	2	80	0.0250000
NODE_3837_length_1208_cov_12.733995	948	1028	6	4	80	0.0500000
NODE_3837_length_1208_cov_12.733995	948	1028	8	65	80	0.8125000
NODE_3838_length_1207_cov_20.461191	874	954	0	74	80	0.9250000
NODE_3838_length_1207_cov_20.461191	874	954	2	6	80	0.0750000
NODE_3838_length_1207_cov_20.461191	927	1007	0	80	80	1.0000000
NODE_3846_length_1206_cov_59.851852	540	620	0	8	80	0.1000000
NODE_3846_length_1206_cov_59.851852	540	620	1	53	80	0.6625000
NODE_3846_length_1206_cov_59.851852	540	620	2	19	80	0.2375000
NODE_3846_length_1206_cov_59.851852	593	673	1	8	80	0.1000000
NODE_3846_length_1206_cov_59.851852	593	673	2	72	80	0.9000000
NODE_3846_length_1206_cov_59.851852	669	749	1	51	80	0.6375000
NODE_3846_length_1206_cov_59.851852	669	749	2	29	80	0.3625000
NODE_3846_length_1206_cov_59.851852	722	802	0	51	80	0.6375000
NODE_3846_length_1206_cov_59.851852	722	802	1	29	80	0.3625000
NODE_3847_length_1206_cov_23.752484	669	749	0	34	80	0.4250000
NODE_3847_length_1206_cov_23.752484	669	749	2	46	80	0.5750000
NODE_3847_length_1206_cov_23.752484	722	802	0	25	80	0.3125000
NODE_3847_length_1206_cov_23.752484	722	802	1	1	80	0.0125000
NODE_3847_length_1206_cov_23.752484	722	802	2	54	80	0.6750000
NODE_3848_length_1206_cov_21.226739	585	665	2	21	80	0.2625000
NODE_3848_length_1206_cov_21.226739	585	665	5	1	80	0.0125000
NODE_3848_length_1206_cov_21.226739	585	665	6	32	80	0.4000000
NODE_3848_length_1206_cov_21.226739	585	665	8	26	80	0.3250000
NODE_3848_length_1206_cov_21.226739	638	718	0	14	80	0.1750000
NODE_3848_length_1206_cov_21.226739	638	718	2	33	80	0.4125000
NODE_3848_length_1206_cov_21.226739	638	718	6	31	80	0.3875000
NODE_3848_length_1206_cov_21.226739	638	718	8	2	80	0.0250000
NODE_3855_length_1205_cov_23.990054	355	435	0	80	80	1.0000000
NODE_3855_length_1205_cov_23.990054	408	488	0	80	80	1.0000000
NODE_3856_length_1205_cov_10.473779	780	860	0	47	80	0.5875000
NODE_3856_length_1205_cov_10.473779	780	860	2	5	80	0.0625000
NODE_3856_length_1205_cov_10.473779	780	860	4	28	80	0.3500000
NODE_3856_length_1205_cov_10.473779	833	913	4	80	80	1.0000000
NODE_3863_length_1204_cov_19.396380	537	617	0	80	80	1.0000000
NODE_3863_length_1204_cov_19.396380	590	670	0	80	80	1.0000000
NODE_3864_length_1204_cov_17.716742	448	528	0	13	80	0.1625000
NODE_3864_length_1204_cov_17.716742	448	528	2	41	80	0.5125000
NODE_3864_length_1204_cov_17.716742	448	528	4	26	80	0.3250000
NODE_3864_length_1204_cov_17.716742	501	581	0	18	80	0.2250000
NODE_3864_length_1204_cov_17.716742	501	581	2	26	80	0.3250000
NODE_3864_length_1204_cov_17.716742	501	581	4	36	80	0.4500000
NODE_3865_length_1204_cov_15.206335	426	506	2	25	80	0.3125000
NODE_3865_length_1204_cov_15.206335	426	506	4	55	80	0.6875000
NODE_3865_length_1204_cov_15.206335	479	559	0	16	80	0.2000000
NODE_3865_length_1204_cov_15.206335	479	559	2	62	80	0.7750000
NODE_3865_length_1204_cov_15.206335	479	559	4	2	80	0.0250000
NODE_3866_length_1204_cov_14.097738	632	712	0	17	80	0.2125000
NODE_3866_length_1204_cov_14.097738	632	712	1	63	80	0.7875000
NODE_3866_length_1204_cov_14.097738	685	765	1	80	80	1.0000000
NODE_3867_length_1204_cov_11.971946	549	629	0	80	80	1.0000000
NODE_3867_length_1204_cov_11.971946	602	682	0	80	80	1.0000000
NODE_3867_length_1204_cov_11.971946	678	758	0	80	80	1.0000000
NODE_3867_length_1204_cov_11.971946	731	811	0	80	80	1.0000000
NODE_3868_length_1204_cov_11.665158	499	579	0	80	80	1.0000000
NODE_3868_length_1204_cov_11.665158	552	632	0	80	80	1.0000000
NODE_3869_length_1204_cov_7.028959	637	717	0	80	80	1.0000000
NODE_3869_length_1204_cov_7.028959	690	770	0	80	80	1.0000000
NODE_3870_length_1204_cov_4.677828	807	887	0	80	80	1.0000000
NODE_3870_length_1204_cov_4.677828	860	940	0	80	80	1.0000000
NODE_3873_length_1203_cov_46.789855	515	595	4	19	80	0.2375000
NODE_3873_length_1203_cov_46.789855	515	595	8	61	80	0.7625000
NODE_3873_length_1203_cov_46.789855	568	648	0	7	80	0.0875000
NODE_3873_length_1203_cov_46.789855	568	648	2	36	80	0.4500000
NODE_3873_length_1203_cov_46.789855	568	648	4	29	80	0.3625000
NODE_3873_length_1203_cov_46.789855	568	648	8	8	80	0.1000000
NODE_3873_length_1203_cov_46.789855	644	724	2	48	80	0.6000000
NODE_3873_length_1203_cov_46.789855	644	724	4	32	80	0.4000000
NODE_3873_length_1203_cov_46.789855	697	777	0	41	80	0.5125000
NODE_3873_length_1203_cov_46.789855	697	777	2	39	80	0.4875000
NODE_3874_length_1203_cov_44.029891	471	551	0	80	80	1.0000000
NODE_3874_length_1203_cov_44.029891	524	604	0	80	80	1.0000000
NODE_3874_length_1203_cov_44.029891	600	680	0	10	80	0.1250000
NODE_3874_length_1203_cov_44.029891	600	680	6	70	80	0.8750000
NODE_3874_length_1203_cov_44.029891	653	733	0	6	80	0.0750000
NODE_3874_length_1203_cov_44.029891	653	733	6	74	80	0.9250000
NODE_3875_length_1203_cov_23.790761	308	388	0	80	80	1.0000000
NODE_3875_length_1203_cov_23.790761	361	441	0	80	80	1.0000000
NODE_3875_length_1203_cov_23.790761	437	517	0	80	80	1.0000000
NODE_3875_length_1203_cov_23.790761	490	570	0	80	80	1.0000000
NODE_3876_length_1203_cov_19.498188	336	416	2	80	80	1.0000000
NODE_3876_length_1203_cov_19.498188	389	469	0	20	80	0.2500000
NODE_3876_length_1203_cov_19.498188	389	469	2	60	80	0.7500000
NODE_3877_length_1203_cov_10.996377	317	397	0	35	80	0.4375000
NODE_3877_length_1203_cov_10.996377	317	397	2	43	80	0.5375000
NODE_3877_length_1203_cov_10.996377	317	397	4	2	80	0.0250000
NODE_3877_length_1203_cov_10.996377	370	450	2	52	80	0.6500000
NODE_3877_length_1203_cov_10.996377	370	450	4	28	80	0.3500000
NODE_3878_length_1203_cov_5.747283	725	805	0	80	80	1.0000000
NODE_3878_length_1203_cov_5.747283	778	858	0	80	80	1.0000000
NODE_3881_length_1202_cov_39.333636	475	555	0	80	80	1.0000000
NODE_3881_length_1202_cov_39.333636	528	608	0	80	80	1.0000000
NODE_3881_length_1202_cov_39.333636	604	684	0	13	80	0.1625000
NODE_3881_length_1202_cov_39.333636	604	684	2	40	80	0.5000000
NODE_3881_length_1202_cov_39.333636	604	684	4	27	80	0.3375000
NODE_3881_length_1202_cov_39.333636	657	737	2	34	80	0.4250000
NODE_3881_length_1202_cov_39.333636	657	737	4	46	80	0.5750000
NODE_3882_length_1202_cov_17.556664	599	679	0	28	80	0.3500000
NODE_3882_length_1202_cov_17.556664	599	679	2	8	80	0.1000000
NODE_3882_length_1202_cov_17.556664	599	679	3	3	80	0.0375000
NODE_3882_length_1202_cov_17.556664	599	679	5	19	80	0.2375000
NODE_3882_length_1202_cov_17.556664	599	679	9	9	80	0.1125000
NODE_3882_length_1202_cov_17.556664	599	679	11	13	80	0.1625000
NODE_3882_length_1202_cov_17.556664	652	732	5	5	80	0.0625000
NODE_3882_length_1202_cov_17.556664	652	732	9	9	80	0.1125000
NODE_3882_length_1202_cov_17.556664	652	732	11	18	80	0.2250000
NODE_3882_length_1202_cov_17.556664	652	732	13	20	80	0.2500000
NODE_3882_length_1202_cov_17.556664	652	732	15	28	80	0.3500000
NODE_3883_length_1202_cov_12.338169	634	714	2	13	80	0.1625000
NODE_3883_length_1202_cov_12.338169	634	714	4	67	80	0.8375000
NODE_3883_length_1202_cov_12.338169	687	767	0	49	80	0.6125000
NODE_3883_length_1202_cov_12.338169	687	767	2	16	80	0.2000000
NODE_3883_length_1202_cov_12.338169	687	767	4	15	80	0.1875000
NODE_3884_length_1202_cov_11.800544	520	600	0	80	80	1.0000000
NODE_3884_length_1202_cov_11.800544	573	653	0	34	80	0.4250000
NODE_3884_length_1202_cov_11.800544	573	653	2	31	80	0.3875000
NODE_3884_length_1202_cov_11.800544	573	653	4	15	80	0.1875000
NODE_3887_length_1201_cov_12.161525	434	514	0	79	80	0.9875000
NODE_3887_length_1201_cov_12.161525	434	514	2	1	80	0.0125000
NODE_3887_length_1201_cov_12.161525	487	567	0	26	80	0.3250000
NODE_3887_length_1201_cov_12.161525	487	567	2	54	80	0.6750000
NODE_3888_length_1201_cov_12.046279	643	723	0	52	80	0.6500000
NODE_3888_length_1201_cov_12.046279	643	723	2	28	80	0.3500000
NODE_3888_length_1201_cov_12.046279	696	776	0	8	80	0.1000000
NODE_3888_length_1201_cov_12.046279	696	776	2	72	80	0.9000000
NODE_3891_length_1200_cov_76.694823	630	710	0	80	80	1.0000000
NODE_3891_length_1200_cov_76.694823	683	763	0	80	80	1.0000000
NODE_3891_length_1200_cov_76.694823	759	839	0	75	80	0.9375000
NODE_3891_length_1200_cov_76.694823	759	839	5	1	80	0.0125000
NODE_3891_length_1200_cov_76.694823	759	839	6	4	80	0.0500000
NODE_3891_length_1200_cov_76.694823	812	892	0	22	80	0.2750000
NODE_3891_length_1200_cov_76.694823	812	892	5	1	80	0.0125000
NODE_3891_length_1200_cov_76.694823	812	892	6	57	80	0.7125000
NODE_3892_length_1200_cov_16.881926	827	902	0	21	75	0.2800000
NODE_3892_length_1200_cov_16.881926	827	902	2	6	75	0.0800000
NODE_3892_length_1200_cov_16.881926	827	902	4	17	75	0.2266667
NODE_3892_length_1200_cov_16.881926	827	902	5	5	75	0.0666667
NODE_3892_length_1200_cov_16.881926	827	902	6	1	75	0.0133333
NODE_3892_length_1200_cov_16.881926	827	902	7	9	75	0.1200000
NODE_3892_length_1200_cov_16.881926	827	902	11	13	75	0.1733333
NODE_3892_length_1200_cov_16.881926	827	902	13	1	75	0.0133333
NODE_3892_length_1200_cov_16.881926	827	902	14	2	75	0.0266667
NODE_3892_length_1200_cov_16.881926	828	904	0	20	76	0.2631579
NODE_3892_length_1200_cov_16.881926	828	904	2	6	76	0.0789474
NODE_3892_length_1200_cov_16.881926	828	904	4	17	76	0.2236842
NODE_3892_length_1200_cov_16.881926	828	904	5	5	76	0.0657895
NODE_3892_length_1200_cov_16.881926	828	904	6	1	76	0.0131579
NODE_3892_length_1200_cov_16.881926	828	904	7	9	76	0.1184211
NODE_3892_length_1200_cov_16.881926	828	904	11	13	76	0.1710526
NODE_3892_length_1200_cov_16.881926	828	904	13	1	76	0.0131579
NODE_3892_length_1200_cov_16.881926	828	904	14	4	76	0.0526316
NODE_3892_length_1200_cov_16.881926	841	907	0	7	66	0.1060606
NODE_3892_length_1200_cov_16.881926	841	907	2	6	66	0.0909091
NODE_3892_length_1200_cov_16.881926	841	907	4	17	66	0.2575758
NODE_3892_length_1200_cov_16.881926	841	907	5	5	66	0.0757576
NODE_3892_length_1200_cov_16.881926	841	907	6	1	66	0.0151515
NODE_3892_length_1200_cov_16.881926	841	907	7	9	66	0.1363636
NODE_3892_length_1200_cov_16.881926	841	907	11	13	66	0.1969697
NODE_3892_length_1200_cov_16.881926	841	907	13	1	66	0.0151515
NODE_3892_length_1200_cov_16.881926	841	907	14	7	66	0.1060606
NODE_3892_length_1200_cov_16.881926	880	957	7	6	77	0.0779221
NODE_3892_length_1200_cov_16.881926	880	957	11	13	77	0.1688312
NODE_3892_length_1200_cov_16.881926	880	957	13	1	77	0.0129870
NODE_3892_length_1200_cov_16.881926	880	957	14	15	77	0.1948052
NODE_3892_length_1200_cov_16.881926	880	957	16	8	77	0.1038961
NODE_3892_length_1200_cov_16.881926	880	957	18	7	77	0.0909091
NODE_3892_length_1200_cov_16.881926	880	957	19	17	77	0.2207792
NODE_3892_length_1200_cov_16.881926	880	957	20	2	77	0.0259740
NODE_3892_length_1200_cov_16.881926	880	957	21	8	77	0.1038961
NODE_3892_length_1200_cov_16.881926	880	957	7	6	77	0.0779221
NODE_3892_length_1200_cov_16.881926	880	957	11	13	77	0.1688312
NODE_3892_length_1200_cov_16.881926	880	957	13	1	77	0.0129870
NODE_3892_length_1200_cov_16.881926	880	957	14	15	77	0.1948052
NODE_3892_length_1200_cov_16.881926	880	957	16	8	77	0.1038961
NODE_3892_length_1200_cov_16.881926	880	957	18	7	77	0.0909091
NODE_3892_length_1200_cov_16.881926	880	957	19	17	77	0.2207792
NODE_3892_length_1200_cov_16.881926	880	957	20	2	77	0.0259740
NODE_3892_length_1200_cov_16.881926	880	957	21	8	77	0.1038961
NODE_3892_length_1200_cov_16.881926	880	957	7	6	77	0.0779221
NODE_3892_length_1200_cov_16.881926	880	957	11	13	77	0.1688312
NODE_3892_length_1200_cov_16.881926	880	957	13	1	77	0.0129870
NODE_3892_length_1200_cov_16.881926	880	957	14	15	77	0.1948052
NODE_3892_length_1200_cov_16.881926	880	957	16	8	77	0.1038961
NODE_3892_length_1200_cov_16.881926	880	957	18	7	77	0.0909091
NODE_3892_length_1200_cov_16.881926	880	957	19	17	77	0.2207792
NODE_3892_length_1200_cov_16.881926	880	957	20	2	77	0.0259740
NODE_3892_length_1200_cov_16.881926	880	957	21	8	77	0.1038961
NODE_3893_length_1200_cov_15.374205	605	685	4	35	80	0.4375000
NODE_3893_length_1200_cov_15.374205	605	685	6	6	80	0.0750000
NODE_3893_length_1200_cov_15.374205	605	685	8	39	80	0.4875000
NODE_3893_length_1200_cov_15.374205	658	738	4	46	80	0.5750000
NODE_3893_length_1200_cov_15.374205	658	738	6	9	80	0.1125000
NODE_3893_length_1200_cov_15.374205	658	738	8	25	80	0.3125000
NODE_3894_length_1200_cov_12.953678	486	550	6	4	64	0.0625000
NODE_3894_length_1200_cov_12.953678	486	550	10	1	64	0.0156250
NODE_3894_length_1200_cov_12.953678	486	550	12	2	64	0.0312500
NODE_3894_length_1200_cov_12.953678	486	550	14	57	64	0.8906250
NODE_3899_length_1199_cov_14.843636	222	302	2	7	80	0.0875000
NODE_3899_length_1199_cov_14.843636	222	302	4	10	80	0.1250000
NODE_3899_length_1199_cov_14.843636	222	302	5	10	80	0.1250000
NODE_3899_length_1199_cov_14.843636	222	302	7	4	80	0.0500000
NODE_3899_length_1199_cov_14.843636	222	302	8	16	80	0.2000000
NODE_3899_length_1199_cov_14.843636	222	302	10	26	80	0.3250000
NODE_3899_length_1199_cov_14.843636	222	302	12	7	80	0.0875000
NODE_3899_length_1199_cov_14.843636	275	355	8	4	80	0.0500000
NODE_3899_length_1199_cov_14.843636	275	355	10	69	80	0.8625000
NODE_3899_length_1199_cov_14.843636	275	355	12	7	80	0.0875000
NODE_3900_length_1199_cov_12.005455	383	463	0	80	80	1.0000000
NODE_3900_length_1199_cov_12.005455	436	516	0	48	80	0.6000000
NODE_3900_length_1199_cov_12.005455	436	516	2	32	80	0.4000000
NODE_3900_length_1199_cov_12.005455	512	592	2	25	80	0.3125000
NODE_3900_length_1199_cov_12.005455	512	592	4	55	80	0.6875000
NODE_3900_length_1199_cov_12.005455	565	645	2	28	80	0.3500000
NODE_3900_length_1199_cov_12.005455	565	645	4	52	80	0.6500000
NODE_3902_length_1198_cov_36.830755	619	699	0	80	80	1.0000000
NODE_3902_length_1198_cov_36.830755	672	752	0	80	80	1.0000000
NODE_3903_length_1198_cov_22.864422	719	799	0	80	80	1.0000000
NODE_3903_length_1198_cov_22.864422	772	852	0	80	80	1.0000000
NODE_3904_length_1198_cov_17.619654	260	340	2	14	80	0.1750000
NODE_3904_length_1198_cov_17.619654	260	340	4	13	80	0.1625000
NODE_3904_length_1198_cov_17.619654	260	340	6	53	80	0.6625000
NODE_3904_length_1198_cov_17.619654	313	392	0	5	79	0.0632911
NODE_3904_length_1198_cov_17.619654	313	392	2	12	79	0.1518987
NODE_3904_length_1198_cov_17.619654	313	392	4	12	79	0.1518987
NODE_3904_length_1198_cov_17.619654	313	392	6	50	79	0.6329114
NODE_3905_length_1198_cov_10.148317	718	798	0	54	80	0.6750000
NODE_3905_length_1198_cov_10.148317	718	798	2	26	80	0.3250000
NODE_3905_length_1198_cov_10.148317	771	851	0	1	80	0.0125000
NODE_3905_length_1198_cov_10.148317	771	851	2	79	80	0.9875000
NODE_3906_length_1198_cov_6.733394	549	629	0	80	80	1.0000000
NODE_3906_length_1198_cov_6.733394	602	682	0	80	80	1.0000000
NODE_3912_length_1197_cov_27.653005	417	497	0	80	80	1.0000000
NODE_3912_length_1197_cov_27.653005	470	550	0	80	80	1.0000000
NODE_3912_length_1197_cov_27.653005	546	626	0	77	80	0.9625000
NODE_3912_length_1197_cov_27.653005	546	626	2	3	80	0.0375000
NODE_3912_length_1197_cov_27.653005	599	679	0	46	80	0.5750000
NODE_3912_length_1197_cov_27.653005	599	679	2	34	80	0.4250000
NODE_3913_length_1197_cov_14.653916	490	570	0	80	80	1.0000000
NODE_3913_length_1197_cov_14.653916	543	623	0	80	80	1.0000000
NODE_3921_length_1196_cov_26.169553	298	378	0	10	80	0.1250000
NODE_3921_length_1196_cov_26.169553	298	378	2	8	80	0.1000000
NODE_3921_length_1196_cov_26.169553	298	378	4	62	80	0.7750000
NODE_3921_length_1196_cov_26.169553	351	431	0	10	80	0.1250000
NODE_3921_length_1196_cov_26.169553	351	431	2	36	80	0.4500000
NODE_3921_length_1196_cov_26.169553	351	431	4	34	80	0.4250000
NODE_3921_length_1196_cov_26.169553	427	507	0	32	80	0.4000000
NODE_3921_length_1196_cov_26.169553	427	507	6	48	80	0.6000000
NODE_3921_length_1196_cov_26.169553	480	560	6	80	80	1.0000000
NODE_3922_length_1196_cov_21.755697	521	601	2	80	80	1.0000000
NODE_3922_length_1196_cov_21.755697	574	654	0	45	80	0.5625000
NODE_3922_length_1196_cov_21.755697	574	654	2	35	80	0.4375000
NODE_3922_length_1196_cov_21.755697	650	730	0	24	80	0.3000000
NODE_3922_length_1196_cov_21.755697	650	730	2	56	80	0.7000000
NODE_3922_length_1196_cov_21.755697	703	783	2	80	80	1.0000000
NODE_3923_length_1196_cov_5.966272	556	636	0	80	80	1.0000000
NODE_3923_length_1196_cov_5.966272	609	689	0	80	80	1.0000000
NODE_3927_length_1195_cov_69.056569	474	554	0	12	80	0.1500000
NODE_3927_length_1195_cov_69.056569	474	554	2	68	80	0.8500000
NODE_3927_length_1195_cov_69.056569	527	607	0	15	80	0.1875000
NODE_3927_length_1195_cov_69.056569	527	607	2	52	80	0.6500000
NODE_3927_length_1195_cov_69.056569	527	607	4	13	80	0.1625000
NODE_3927_length_1195_cov_69.056569	603	683	4	22	80	0.2750000
NODE_3927_length_1195_cov_69.056569	603	683	5	25	80	0.3125000
NODE_3927_length_1195_cov_69.056569	603	683	6	1	80	0.0125000
NODE_3927_length_1195_cov_69.056569	603	683	7	28	80	0.3500000
NODE_3927_length_1195_cov_69.056569	603	683	8	4	80	0.0500000
NODE_3927_length_1195_cov_69.056569	656	736	4	21	80	0.2625000
NODE_3927_length_1195_cov_69.056569	656	736	6	46	80	0.5750000
NODE_3927_length_1195_cov_69.056569	656	736	7	9	80	0.1125000
NODE_3927_length_1195_cov_69.056569	656	736	8	4	80	0.0500000
NODE_3928_length_1195_cov_65.062044	579	659	0	80	80	1.0000000
NODE_3928_length_1195_cov_65.062044	632	712	0	80	80	1.0000000
NODE_3928_length_1195_cov_65.062044	708	788	0	8	80	0.1000000
NODE_3928_length_1195_cov_65.062044	708	788	2	4	80	0.0500000
NODE_3928_length_1195_cov_65.062044	708	788	4	6	80	0.0750000
NODE_3928_length_1195_cov_65.062044	708	788	6	16	80	0.2000000
NODE_3928_length_1195_cov_65.062044	708	788	8	46	80	0.5750000
NODE_3928_length_1195_cov_65.062044	761	841	2	7	80	0.0875000
NODE_3928_length_1195_cov_65.062044	761	841	4	29	80	0.3625000
NODE_3928_length_1195_cov_65.062044	761	841	6	2	80	0.0250000
NODE_3928_length_1195_cov_65.062044	761	841	8	42	80	0.5250000
NODE_3929_length_1195_cov_23.187044	460	540	1	13	80	0.1625000
NODE_3929_length_1195_cov_23.187044	460	540	2	10	80	0.1250000
NODE_3929_length_1195_cov_23.187044	460	540	3	25	80	0.3125000
NODE_3929_length_1195_cov_23.187044	460	540	5	7	80	0.0875000
NODE_3929_length_1195_cov_23.187044	460	540	7	25	80	0.3125000
NODE_3929_length_1195_cov_23.187044	513	593	1	4	80	0.0500000
NODE_3929_length_1195_cov_23.187044	513	593	3	13	80	0.1625000
NODE_3929_length_1195_cov_23.187044	513	593	5	12	80	0.1500000
NODE_3929_length_1195_cov_23.187044	513	593	7	51	80	0.6375000
NODE_3930_length_1195_cov_18.983577	521	601	0	80	80	1.0000000
NODE_3930_length_1195_cov_18.983577	574	654	0	80	80	1.0000000
NODE_3931_length_1195_cov_14.119526	726	806	0	80	80	1.0000000
NODE_3931_length_1195_cov_14.119526	779	859	0	80	80	1.0000000
NODE_3931_length_1195_cov_14.119526	855	935	0	80	80	1.0000000
NODE_3931_length_1195_cov_14.119526	908	988	0	80	80	1.0000000
NODE_3932_length_1195_cov_13.805657	759	839	0	80	80	1.0000000
NODE_3932_length_1195_cov_13.805657	812	892	0	80	80	1.0000000
NODE_3938_length_1195_cov_1.969891	912	992	0	38	80	0.4750000
NODE_3938_length_1195_cov_1.969891	912	992	2	42	80	0.5250000
NODE_3938_length_1195_cov_1.969891	912	992	0	38	80	0.4750000
NODE_3938_length_1195_cov_1.969891	912	992	2	42	80	0.5250000
NODE_3941_length_1194_cov_40.157991	237	317	4	37	80	0.4625000
NODE_3941_length_1194_cov_40.157991	237	317	6	9	80	0.1125000
NODE_3941_length_1194_cov_40.157991	237	317	7	15	80	0.1875000
NODE_3941_length_1194_cov_40.157991	237	317	8	3	80	0.0375000
NODE_3941_length_1194_cov_40.157991	237	317	10	16	80	0.2000000
NODE_3941_length_1194_cov_40.157991	290	370	4	2	80	0.0250000
NODE_3941_length_1194_cov_40.157991	290	370	6	43	80	0.5375000
NODE_3941_length_1194_cov_40.157991	290	370	7	8	80	0.1000000
NODE_3941_length_1194_cov_40.157991	290	370	8	3	80	0.0375000
NODE_3941_length_1194_cov_40.157991	290	370	10	24	80	0.3000000
NODE_3946_length_1193_cov_34.295247	443	523	0	80	80	1.0000000
NODE_3946_length_1193_cov_34.295247	496	576	0	80	80	1.0000000
NODE_3947_length_1193_cov_16.930530	124	154	4	4	30	0.1333333
NODE_3947_length_1193_cov_16.930530	124	154	6	26	30	0.8666667
NODE_3947_length_1193_cov_16.930530	390	470	4	14	80	0.1750000
NODE_3947_length_1193_cov_16.930530	390	470	7	1	80	0.0125000
NODE_3947_length_1193_cov_16.930530	390	470	8	11	80	0.1375000
NODE_3947_length_1193_cov_16.930530	390	470	9	11	80	0.1375000
NODE_3947_length_1193_cov_16.930530	390	470	10	21	80	0.2625000
NODE_3947_length_1193_cov_16.930530	390	470	12	22	80	0.2750000
NODE_3947_length_1193_cov_16.930530	443	523	0	1	80	0.0125000
NODE_3947_length_1193_cov_16.930530	443	523	1	12	80	0.1500000
NODE_3947_length_1193_cov_16.930530	443	523	2	9	80	0.1125000
NODE_3947_length_1193_cov_16.930530	443	523	3	19	80	0.2375000
NODE_3947_length_1193_cov_16.930530	443	523	6	2	80	0.0250000
NODE_3947_length_1193_cov_16.930530	443	523	8	18	80	0.2250000
NODE_3947_length_1193_cov_16.930530	443	523	9	11	80	0.1375000
NODE_3947_length_1193_cov_16.930530	443	523	10	4	80	0.0500000
NODE_3947_length_1193_cov_16.930530	443	523	12	4	80	0.0500000
NODE_3949_length_1192_cov_26.803294	205	285	0	80	80	1.0000000
NODE_3949_length_1192_cov_26.803294	258	338	0	75	80	0.9375000
NODE_3949_length_1192_cov_26.803294	258	338	2	5	80	0.0625000
NODE_3949_length_1192_cov_26.803294	334	414	2	70	80	0.8750000
NODE_3949_length_1192_cov_26.803294	334	414	4	10	80	0.1250000
NODE_3949_length_1192_cov_26.803294	387	467	0	29	80	0.3625000
NODE_3949_length_1192_cov_26.803294	387	467	2	41	80	0.5125000
NODE_3949_length_1192_cov_26.803294	387	467	4	10	80	0.1250000
NODE_3950_length_1192_cov_23.228728	487	567	0	80	80	1.0000000
NODE_3950_length_1192_cov_23.228728	540	620	0	70	80	0.8750000
NODE_3950_length_1192_cov_23.228728	540	620	2	10	80	0.1250000
NODE_3950_length_1192_cov_23.228728	616	696	2	76	80	0.9500000
NODE_3950_length_1192_cov_23.228728	616	696	3	4	80	0.0500000
NODE_3950_length_1192_cov_23.228728	669	749	2	35	80	0.4375000
NODE_3950_length_1192_cov_23.228728	669	749	3	10	80	0.1250000
NODE_3950_length_1192_cov_23.228728	669	749	4	35	80	0.4375000
NODE_3951_length_1192_cov_18.314730	613	693	0	55	80	0.6875000
NODE_3951_length_1192_cov_18.314730	613	693	2	25	80	0.3125000
NODE_3951_length_1192_cov_18.314730	666	746	0	80	80	1.0000000
NODE_3951_length_1192_cov_18.314730	742	822	0	80	80	1.0000000
NODE_3951_length_1192_cov_18.314730	795	875	0	80	80	1.0000000
NODE_3952_length_1192_cov_14.888381	622	702	1	43	80	0.5375000
NODE_3952_length_1192_cov_14.888381	622	702	2	26	80	0.3250000
NODE_3952_length_1192_cov_14.888381	622	702	4	11	80	0.1375000
NODE_3952_length_1192_cov_14.888381	675	755	2	16	80	0.2000000
NODE_3952_length_1192_cov_14.888381	675	755	3	8	80	0.1000000
NODE_3952_length_1192_cov_14.888381	675	755	4	56	80	0.7000000
NODE_3952_length_1192_cov_14.888381	751	831	0	16	80	0.2000000
NODE_3952_length_1192_cov_14.888381	751	831	1	20	80	0.2500000
NODE_3952_length_1192_cov_14.888381	751	831	3	44	80	0.5500000
NODE_3952_length_1192_cov_14.888381	804	884	0	69	80	0.8625000
NODE_3952_length_1192_cov_14.888381	804	884	1	11	80	0.1375000
NODE_3953_length_1192_cov_9.995425	161	241	0	80	80	1.0000000
NODE_3953_length_1192_cov_9.995425	214	294	0	80	80	1.0000000
NODE_3954_length_1192_cov_5.078683	749	829	0	24	80	0.3000000
NODE_3954_length_1192_cov_5.078683	749	829	2	56	80	0.7000000
NODE_3954_length_1192_cov_5.078683	802	882	0	33	80	0.4125000
NODE_3954_length_1192_cov_5.078683	802	882	2	47	80	0.5875000
NODE_3960_length_1192_cov_0.614822	1046	1126	0	80	80	1.0000000
NODE_3961_length_1191_cov_55.466117	392	472	0	1	80	0.0125000
NODE_3961_length_1191_cov_55.466117	392	472	2	8	80	0.1000000
NODE_3961_length_1191_cov_55.466117	392	472	6	71	80	0.8875000
NODE_3961_length_1191_cov_55.466117	445	525	0	22	80	0.2750000
NODE_3961_length_1191_cov_55.466117	445	525	4	16	80	0.2000000
NODE_3961_length_1191_cov_55.466117	445	525	6	42	80	0.5250000
NODE_3961_length_1191_cov_55.466117	521	601	0	4	80	0.0500000
NODE_3961_length_1191_cov_55.466117	521	601	2	76	80	0.9500000
NODE_3961_length_1191_cov_55.466117	574	654	0	31	80	0.3875000
NODE_3961_length_1191_cov_55.466117	574	654	2	49	80	0.6125000
NODE_3963_length_1191_cov_20.677656	695	775	0	34	80	0.4250000
NODE_3963_length_1191_cov_20.677656	695	775	2	46	80	0.5750000
NODE_3963_length_1191_cov_20.677656	748	828	2	80	80	1.0000000
NODE_3964_length_1191_cov_9.074176	420	500	0	80	80	1.0000000
NODE_3964_length_1191_cov_9.074176	473	553	0	80	80	1.0000000
NODE_3968_length_1190_cov_40.916590	521	601	0	15	80	0.1875000
NODE_3968_length_1190_cov_40.916590	521	601	1	22	80	0.2750000
NODE_3968_length_1190_cov_40.916590	521	601	2	43	80	0.5375000
NODE_3968_length_1190_cov_40.916590	574	654	0	12	80	0.1500000
NODE_3968_length_1190_cov_40.916590	574	654	1	63	80	0.7875000
NODE_3968_length_1190_cov_40.916590	574	654	2	5	80	0.0625000
NODE_3968_length_1190_cov_40.916590	650	730	0	80	80	1.0000000
NODE_3968_length_1190_cov_40.916590	703	783	0	80	80	1.0000000
NODE_3969_length_1190_cov_20.715857	257	337	0	80	80	1.0000000
NODE_3969_length_1190_cov_20.715857	310	390	0	80	80	1.0000000
NODE_3970_length_1190_cov_19.724106	296	376	0	80	80	1.0000000
NODE_3970_length_1190_cov_19.724106	349	429	0	48	80	0.6000000
NODE_3970_length_1190_cov_19.724106	349	429	2	32	80	0.4000000
NODE_3973_length_1190_cov_2.698442	1022	1070	2	22	48	0.4583333
NODE_3973_length_1190_cov_2.698442	1022	1070	4	26	48	0.5416667
NODE_3973_length_1190_cov_2.698442	1075	1123	4	46	48	0.9583333
NODE_3973_length_1190_cov_2.698442	1075	1123	6	2	48	0.0416667
NODE_3977_length_1189_cov_29.193578	576	656	0	8	80	0.1000000
NODE_3977_length_1189_cov_29.193578	576	656	2	5	80	0.0625000
NODE_3977_length_1189_cov_29.193578	576	656	4	16	80	0.2000000
NODE_3977_length_1189_cov_29.193578	576	656	6	51	80	0.6375000
NODE_3977_length_1189_cov_29.193578	629	709	4	15	80	0.1875000
NODE_3977_length_1189_cov_29.193578	629	709	6	65	80	0.8125000
NODE_3978_length_1189_cov_13.484404	315	341	2	26	26	1.0000000
NODE_3978_length_1189_cov_13.484404	366	446	0	68	80	0.8500000
NODE_3978_length_1189_cov_13.484404	366	446	2	12	80	0.1500000
NODE_3984_length_1188_cov_19.278237	396	476	0	80	80	1.0000000
NODE_3984_length_1188_cov_19.278237	449	529	0	57	80	0.7125000
NODE_3984_length_1188_cov_19.278237	449	529	2	23	80	0.2875000
NODE_3990_length_1187_cov_63.185662	529	609	1	26	80	0.3250000
NODE_3990_length_1187_cov_63.185662	529	609	2	54	80	0.6750000
NODE_3990_length_1187_cov_63.185662	582	662	0	11	80	0.1375000
NODE_3990_length_1187_cov_63.185662	582	662	1	68	80	0.8500000
NODE_3990_length_1187_cov_63.185662	582	662	2	1	80	0.0125000
NODE_3990_length_1187_cov_63.185662	658	738	0	26	80	0.3250000
NODE_3990_length_1187_cov_63.185662	658	738	4	8	80	0.1000000
NODE_3990_length_1187_cov_63.185662	658	738	6	39	80	0.4875000
NODE_3990_length_1187_cov_63.185662	658	738	8	7	80	0.0875000
NODE_3990_length_1187_cov_63.185662	711	791	2	34	80	0.4250000
NODE_3990_length_1187_cov_63.185662	711	791	6	22	80	0.2750000
NODE_3990_length_1187_cov_63.185662	711	791	8	24	80	0.3000000
NODE_3991_length_1187_cov_36.926471	432	512	0	16	80	0.2000000
NODE_3991_length_1187_cov_36.926471	432	512	2	64	80	0.8000000
NODE_3991_length_1187_cov_36.926471	485	565	0	17	80	0.2125000
NODE_3991_length_1187_cov_36.926471	485	565	2	63	80	0.7875000
NODE_3991_length_1187_cov_36.926471	561	641	0	24	80	0.3000000
NODE_3991_length_1187_cov_36.926471	561	641	2	56	80	0.7000000
NODE_3991_length_1187_cov_36.926471	614	694	0	77	80	0.9625000
NODE_3991_length_1187_cov_36.926471	614	694	2	3	80	0.0375000
NODE_3992_length_1187_cov_20.383272	492	572	0	39	80	0.4875000
NODE_3992_length_1187_cov_20.383272	492	572	2	1	80	0.0125000
NODE_3992_length_1187_cov_20.383272	492	572	4	16	80	0.2000000
NODE_3992_length_1187_cov_20.383272	492	572	6	24	80	0.3000000
NODE_3992_length_1187_cov_20.383272	545	625	4	7	80	0.0875000
NODE_3992_length_1187_cov_20.383272	545	625	6	73	80	0.9125000
NODE_3993_length_1187_cov_17.941176	377	457	0	80	80	1.0000000
NODE_3993_length_1187_cov_17.941176	430	510	0	80	80	1.0000000
NODE_3993_length_1187_cov_17.941176	506	586	0	80	80	1.0000000
NODE_3993_length_1187_cov_17.941176	559	639	0	80	80	1.0000000
NODE_3997_length_1186_cov_59.606256	338	418	2	80	80	1.0000000
NODE_3997_length_1186_cov_59.606256	391	471	0	29	80	0.3625000
NODE_3997_length_1186_cov_59.606256	391	471	2	51	80	0.6375000
NODE_3997_length_1186_cov_59.606256	480	551	0	71	71	1.0000000
NODE_3997_length_1186_cov_59.606256	524	604	0	80	80	1.0000000
NODE_3998_length_1186_cov_34.937443	582	662	0	80	80	1.0000000
NODE_3998_length_1186_cov_34.937443	635	715	0	80	80	1.0000000
NODE_3998_length_1186_cov_34.937443	711	791	0	48	80	0.6000000
NODE_3998_length_1186_cov_34.937443	711	791	2	32	80	0.4000000
NODE_3998_length_1186_cov_34.937443	764	844	2	80	80	1.0000000
NODE_3999_length_1186_cov_29.840846	511	591	6	80	80	1.0000000
NODE_3999_length_1186_cov_29.840846	564	644	0	45	80	0.5625000
NODE_3999_length_1186_cov_29.840846	564	644	4	1	80	0.0125000
NODE_3999_length_1186_cov_29.840846	564	644	6	34	80	0.4250000
NODE_3999_length_1186_cov_29.840846	640	720	0	80	80	1.0000000
NODE_3999_length_1186_cov_29.840846	693	773	0	80	80	1.0000000
NODE_4000_length_1186_cov_13.108556	578	658	2	38	80	0.4750000
NODE_4000_length_1186_cov_13.108556	578	658	3	5	80	0.0625000
NODE_4000_length_1186_cov_13.108556	578	658	4	37	80	0.4625000
NODE_4000_length_1186_cov_13.108556	631	711	2	73	80	0.9125000
NODE_4000_length_1186_cov_13.108556	631	711	4	7	80	0.0875000
NODE_4001_length_1186_cov_12.867525	404	484	0	80	80	1.0000000
NODE_4001_length_1186_cov_12.867525	457	534	0	77	77	1.0000000
NODE_4001_length_1186_cov_12.867525	536	613	0	77	77	1.0000000
NODE_4001_length_1186_cov_12.867525	586	666	0	80	80	1.0000000
NODE_4002_length_1186_cov_12.135235	643	723	0	80	80	1.0000000
NODE_4002_length_1186_cov_12.135235	696	776	0	80	80	1.0000000
NODE_4012_length_1185_cov_36.974217	423	503	20	12	80	0.1500000
NODE_4012_length_1185_cov_36.974217	423	503	21	5	80	0.0625000
NODE_4012_length_1185_cov_36.974217	423	503	22	48	80	0.6000000
NODE_4012_length_1185_cov_36.974217	423	503	23	3	80	0.0375000
NODE_4012_length_1185_cov_36.974217	423	503	24	12	80	0.1500000
NODE_4012_length_1185_cov_36.974217	476	556	2	29	80	0.3625000
NODE_4012_length_1185_cov_36.974217	476	556	18	1	80	0.0125000
NODE_4012_length_1185_cov_36.974217	476	556	19	13	80	0.1625000
NODE_4012_length_1185_cov_36.974217	476	556	20	22	80	0.2750000
NODE_4012_length_1185_cov_36.974217	476	556	21	5	80	0.0625000
NODE_4012_length_1185_cov_36.974217	476	556	22	5	80	0.0625000
NODE_4012_length_1185_cov_36.974217	476	556	23	3	80	0.0375000
NODE_4012_length_1185_cov_36.974217	476	556	24	2	80	0.0250000
NODE_4013_length_1185_cov_28.410681	448	528	0	80	80	1.0000000
NODE_4013_length_1185_cov_28.410681	501	581	0	80	80	1.0000000
NODE_4014_length_1185_cov_19.768877	411	491	0	80	80	1.0000000
NODE_4014_length_1185_cov_19.768877	464	544	0	80	80	1.0000000
NODE_4014_length_1185_cov_19.768877	540	620	0	36	80	0.4500000
NODE_4014_length_1185_cov_19.768877	540	620	2	20	80	0.2500000
NODE_4014_length_1185_cov_19.768877	540	620	4	20	80	0.2500000
NODE_4014_length_1185_cov_19.768877	540	620	6	4	80	0.0500000
NODE_4014_length_1185_cov_19.768877	593	673	2	3	80	0.0375000
NODE_4014_length_1185_cov_19.768877	593	673	4	26	80	0.3250000
NODE_4014_length_1185_cov_19.768877	593	673	6	51	80	0.6375000
NODE_4015_length_1185_cov_14.490792	379	459	0	80	80	1.0000000
NODE_4015_length_1185_cov_14.490792	432	512	0	80	80	1.0000000
NODE_4016_length_1185_cov_13.686004	677	757	0	54	80	0.6750000
NODE_4016_length_1185_cov_13.686004	677	757	2	26	80	0.3250000
NODE_4016_length_1185_cov_13.686004	730	810	0	1	80	0.0125000
NODE_4016_length_1185_cov_13.686004	730	810	2	79	80	0.9875000
NODE_4017_length_1185_cov_12.362799	711	791	0	78	80	0.9750000
NODE_4017_length_1185_cov_12.362799	711	791	2	2	80	0.0250000
NODE_4017_length_1185_cov_12.362799	764	844	0	25	80	0.3125000
NODE_4017_length_1185_cov_12.362799	764	844	2	6	80	0.0750000
NODE_4017_length_1185_cov_12.362799	764	844	4	49	80	0.6125000
NODE_4024_length_1184_cov_30.061751	416	497	0	81	81	1.0000000
NODE_4024_length_1184_cov_30.061751	470	550	0	80	80	1.0000000
NODE_4024_length_1184_cov_30.061751	546	627	0	22	81	0.2716049
NODE_4024_length_1184_cov_30.061751	546	627	2	59	81	0.7283950
NODE_4024_length_1184_cov_30.061751	600	680	0	16	80	0.2000000
NODE_4024_length_1184_cov_30.061751	600	680	2	64	80	0.8000000
NODE_4025_length_1184_cov_19.544700	550	630	0	80	80	1.0000000
NODE_4025_length_1184_cov_19.544700	603	683	0	80	80	1.0000000
NODE_4025_length_1184_cov_19.544700	679	759	0	80	80	1.0000000
NODE_4025_length_1184_cov_19.544700	732	812	0	80	80	1.0000000
NODE_4026_length_1184_cov_9.129954	624	704	4	55	80	0.6875000
NODE_4026_length_1184_cov_9.129954	624	704	6	25	80	0.3125000
NODE_4026_length_1184_cov_9.129954	677	757	0	35	80	0.4375000
NODE_4026_length_1184_cov_9.129954	677	757	4	45	80	0.5625000
NODE_4031_length_1183_cov_17.260148	545	625	0	63	80	0.7875000
NODE_4031_length_1183_cov_17.260148	545	625	2	17	80	0.2125000
NODE_4031_length_1183_cov_17.260148	598	678	0	10	80	0.1250000
NODE_4031_length_1183_cov_17.260148	598	678	2	70	80	0.8750000
NODE_4031_length_1183_cov_17.260148	674	754	0	69	80	0.8625000
NODE_4031_length_1183_cov_17.260148	674	754	2	11	80	0.1375000
NODE_4031_length_1183_cov_17.260148	727	807	0	80	80	1.0000000
NODE_4032_length_1183_cov_9.777675	484	564	0	80	80	1.0000000
NODE_4032_length_1183_cov_9.777675	537	617	0	80	80	1.0000000
NODE_4033_length_1183_cov_6.847786	711	791	0	43	80	0.5375000
NODE_4033_length_1183_cov_6.847786	711	791	2	37	80	0.4625000
NODE_4033_length_1183_cov_6.847786	764	844	0	38	80	0.4750000
NODE_4033_length_1183_cov_6.847786	764	844	2	42	80	0.5250000
NODE_4033_length_1183_cov_6.847786	840	920	0	80	80	1.0000000
NODE_4033_length_1183_cov_6.847786	893	973	0	80	80	1.0000000
NODE_4035_length_1183_cov_2.680812	59	139	0	22	80	0.2750000
NODE_4035_length_1183_cov_2.680812	59	139	2	58	80	0.7250000
NODE_4040_length_1182_cov_64.600185	588	668	2	17	80	0.2125000
NODE_4040_length_1182_cov_64.600185	588	668	4	16	80	0.2000000
NODE_4040_length_1182_cov_64.600185	588	668	6	7	80	0.0875000
NODE_4040_length_1182_cov_64.600185	588	668	10	40	80	0.5000000
NODE_4040_length_1182_cov_64.600185	641	721	4	9	80	0.1125000
NODE_4040_length_1182_cov_64.600185	641	721	6	30	80	0.3750000
NODE_4040_length_1182_cov_64.600185	641	721	8	10	80	0.1250000
NODE_4040_length_1182_cov_64.600185	641	721	10	31	80	0.3875000
NODE_4040_length_1182_cov_64.600185	717	797	0	2	80	0.0250000
NODE_4040_length_1182_cov_64.600185	717	797	2	2	80	0.0250000
NODE_4040_length_1182_cov_64.600185	717	797	4	10	80	0.1250000
NODE_4040_length_1182_cov_64.600185	717	797	6	66	80	0.8250000
NODE_4040_length_1182_cov_64.600185	770	849	0	12	79	0.1518987
NODE_4040_length_1182_cov_64.600185	770	849	2	16	79	0.2025317
NODE_4040_length_1182_cov_64.600185	770	849	4	7	79	0.0886076
NODE_4040_length_1182_cov_64.600185	770	849	6	44	79	0.5569620
NODE_4041_length_1182_cov_18.584488	487	557	2	10	70	0.1428571
NODE_4041_length_1182_cov_18.584488	487	557	4	20	70	0.2857143
NODE_4041_length_1182_cov_18.584488	487	557	6	40	70	0.5714286
NODE_4041_length_1182_cov_18.584488	536	612	2	4	76	0.0526316
NODE_4041_length_1182_cov_18.584488	536	612	4	21	76	0.2763158
NODE_4041_length_1182_cov_18.584488	536	612	6	51	76	0.6710526
NODE_4041_length_1182_cov_18.584488	608	688	0	63	80	0.7875000
NODE_4041_length_1182_cov_18.584488	608	688	2	17	80	0.2125000
NODE_4041_length_1182_cov_18.584488	671	741	0	70	70	1.0000000
NODE_4042_length_1182_cov_18.075716	598	678	0	80	80	1.0000000
NODE_4042_length_1182_cov_18.075716	651	731	0	80	80	1.0000000
NODE_4042_length_1182_cov_18.075716	727	807	0	80	80	1.0000000
NODE_4042_length_1182_cov_18.075716	780	860	0	80	80	1.0000000
NODE_4043_length_1182_cov_8.716528	464	544	0	59	80	0.7375000
NODE_4043_length_1182_cov_8.716528	464	544	2	21	80	0.2625000
NODE_4043_length_1182_cov_8.716528	517	597	0	80	80	1.0000000
NODE_4044_length_1182_cov_4.109880	793	873	0	9	80	0.1125000
NODE_4044_length_1182_cov_4.109880	793	873	4	71	80	0.8875000
NODE_4044_length_1182_cov_4.109880	846	926	0	49	80	0.6125000
NODE_4044_length_1182_cov_4.109880	846	926	4	31	80	0.3875000
NODE_4045_length_1182_cov_3.433980	1052	1100	0	48	48	1.0000000
NODE_4050_length_1181_cov_13.856747	687	767	2	2	80	0.0250000
NODE_4050_length_1181_cov_13.856747	687	767	4	46	80	0.5750000
NODE_4050_length_1181_cov_13.856747	687	767	6	32	80	0.4000000
NODE_4050_length_1181_cov_13.856747	740	820	2	18	80	0.2250000
NODE_4050_length_1181_cov_13.856747	740	820	4	9	80	0.1125000
NODE_4050_length_1181_cov_13.856747	740	820	6	53	80	0.6625000
NODE_4051_length_1181_cov_8.239372	735	815	0	80	80	1.0000000
NODE_4059_length_1180_cov_46.345051	695	775	0	72	80	0.9000000
NODE_4059_length_1180_cov_46.345051	695	775	5	8	80	0.1000000
NODE_4059_length_1180_cov_46.345051	748	828	0	19	80	0.2375000
NODE_4059_length_1180_cov_46.345051	748	828	5	36	80	0.4500000
NODE_4059_length_1180_cov_46.345051	748	828	6	25	80	0.3125000
NODE_4066_length_1179_cov_93.272222	660	740	53	4	80	0.0500000
NODE_4066_length_1179_cov_93.272222	660	740	54	6	80	0.0750000
NODE_4066_length_1179_cov_93.272222	660	740	56	10	80	0.1250000
NODE_4066_length_1179_cov_93.272222	660	740	58	10	80	0.1250000
NODE_4066_length_1179_cov_93.272222	660	740	60	7	80	0.0875000
NODE_4066_length_1179_cov_93.272222	660	740	62	7	80	0.0875000
NODE_4066_length_1179_cov_93.272222	660	740	64	3	80	0.0375000
NODE_4066_length_1179_cov_93.272222	660	740	66	13	80	0.1625000
NODE_4066_length_1179_cov_93.272222	660	740	68	7	80	0.0875000
NODE_4066_length_1179_cov_93.272222	660	740	70	12	80	0.1500000
NODE_4066_length_1179_cov_93.272222	660	740	72	1	80	0.0125000
NODE_4066_length_1179_cov_93.272222	713	793	6	2	80	0.0250000
NODE_4066_length_1179_cov_93.272222	713	793	8	5	80	0.0625000
NODE_4066_length_1179_cov_93.272222	713	793	12	1	80	0.0125000
NODE_4066_length_1179_cov_93.272222	713	793	16	1	80	0.0125000
NODE_4066_length_1179_cov_93.272222	713	793	18	2	80	0.0250000
NODE_4066_length_1179_cov_93.272222	713	793	20	1	80	0.0125000
NODE_4066_length_1179_cov_93.272222	713	793	24	1	80	0.0125000
NODE_4066_length_1179_cov_93.272222	713	793	26	1	80	0.0125000
NODE_4066_length_1179_cov_93.272222	713	793	28	1	80	0.0125000
NODE_4066_length_1179_cov_93.272222	713	793	38	1	80	0.0125000
NODE_4066_length_1179_cov_93.272222	713	793	40	2	80	0.0250000
NODE_4066_length_1179_cov_93.272222	713	793	42	3	80	0.0375000
NODE_4066_length_1179_cov_93.272222	713	793	44	2	80	0.0250000
NODE_4066_length_1179_cov_93.272222	713	793	48	2	80	0.0250000
NODE_4066_length_1179_cov_93.272222	713	793	50	8	80	0.1000000
NODE_4066_length_1179_cov_93.272222	713	793	51	1	80	0.0125000
NODE_4066_length_1179_cov_93.272222	713	793	53	23	80	0.2875000
NODE_4066_length_1179_cov_93.272222	713	793	54	6	80	0.0750000
NODE_4066_length_1179_cov_93.272222	713	793	56	10	80	0.1250000
NODE_4066_length_1179_cov_93.272222	713	793	58	7	80	0.0875000
NODE_4067_length_1179_cov_55.355556	547	627	8	5	80	0.0625000
NODE_4067_length_1179_cov_55.355556	547	627	10	24	80	0.3000000
NODE_4067_length_1179_cov_55.355556	547	627	12	3	80	0.0375000
NODE_4067_length_1179_cov_55.355556	547	627	18	1	80	0.0125000
NODE_4067_length_1179_cov_55.355556	547	627	20	24	80	0.3000000
NODE_4067_length_1179_cov_55.355556	547	627	22	4	80	0.0500000
NODE_4067_length_1179_cov_55.355556	547	627	24	10	80	0.1250000
NODE_4067_length_1179_cov_55.355556	547	627	26	5	80	0.0625000
NODE_4067_length_1179_cov_55.355556	547	627	28	4	80	0.0500000
NODE_4067_length_1179_cov_55.355556	600	680	14	3	80	0.0375000
NODE_4067_length_1179_cov_55.355556	600	680	16	3	80	0.0375000
NODE_4067_length_1179_cov_55.355556	600	680	17	1	80	0.0125000
NODE_4067_length_1179_cov_55.355556	600	680	18	15	80	0.1875000
NODE_4067_length_1179_cov_55.355556	600	680	20	3	80	0.0375000
NODE_4067_length_1179_cov_55.355556	600	680	22	7	80	0.0875000
NODE_4067_length_1179_cov_55.355556	600	680	23	1	80	0.0125000
NODE_4067_length_1179_cov_55.355556	600	680	24	25	80	0.3125000
NODE_4067_length_1179_cov_55.355556	600	680	26	6	80	0.0750000
NODE_4067_length_1179_cov_55.355556	600	680	27	10	80	0.1250000
NODE_4067_length_1179_cov_55.355556	600	680	28	6	80	0.0750000
NODE_4068_length_1179_cov_29.712037	613	693	0	80	80	1.0000000
NODE_4068_length_1179_cov_29.712037	666	746	0	80	80	1.0000000
NODE_4069_length_1179_cov_26.767593	483	563	0	18	80	0.2250000
NODE_4069_length_1179_cov_26.767593	483	563	2	62	80	0.7750000
NODE_4069_length_1179_cov_26.767593	536	616	0	34	80	0.4250000
NODE_4069_length_1179_cov_26.767593	536	616	2	46	80	0.5750000
NODE_4069_length_1179_cov_26.767593	612	692	0	80	80	1.0000000
NODE_4069_length_1179_cov_26.767593	665	745	0	80	80	1.0000000
NODE_4070_length_1179_cov_22.249074	581	661	0	80	80	1.0000000
NODE_4070_length_1179_cov_22.249074	634	714	0	80	80	1.0000000
NODE_4071_length_1179_cov_16.538889	498	568	0	5	70	0.0714286
NODE_4071_length_1179_cov_16.538889	498	568	2	7	70	0.1000000
NODE_4071_length_1179_cov_16.538889	498	568	3	1	70	0.0142857
NODE_4071_length_1179_cov_16.538889	498	568	4	24	70	0.3428572
NODE_4071_length_1179_cov_16.538889	498	568	6	10	70	0.1428571
NODE_4071_length_1179_cov_16.538889	498	568	8	23	70	0.3285714
NODE_4072_length_1179_cov_15.442593	535	615	0	80	80	1.0000000
NODE_4072_length_1179_cov_15.442593	588	668	0	80	80	1.0000000
NODE_4076_length_1179_cov_2.419444	1108	1155	0	7	47	0.1489362
NODE_4076_length_1179_cov_2.419444	1108	1155	2	40	47	0.8510638
NODE_4078_length_1179_cov_1.009259	944	1024	0	80	80	1.0000000
NODE_4078_length_1179_cov_1.009259	997	1077	0	80	80	1.0000000
NODE_4079_length_1178_cov_42.484708	423	503	0	80	80	1.0000000
NODE_4079_length_1178_cov_42.484708	476	556	0	80	80	1.0000000
NODE_4079_length_1178_cov_42.484708	552	632	0	30	80	0.3750000
NODE_4079_length_1178_cov_42.484708	552	632	2	46	80	0.5750000
NODE_4079_length_1178_cov_42.484708	552	632	4	4	80	0.0500000
NODE_4079_length_1178_cov_42.484708	605	685	2	30	80	0.3750000
NODE_4079_length_1178_cov_42.484708	605	685	4	50	80	0.6250000
NODE_4080_length_1178_cov_15.332715	215	295	0	80	80	1.0000000
NODE_4080_length_1178_cov_15.332715	268	348	0	80	80	1.0000000
NODE_4081_length_1178_cov_11.403151	527	607	2	22	80	0.2750000
NODE_4081_length_1178_cov_11.403151	527	607	6	58	80	0.7250000
NODE_4081_length_1178_cov_11.403151	580	660	4	27	80	0.3375000
NODE_4081_length_1178_cov_11.403151	580	660	6	53	80	0.6625000
NODE_4084_length_1177_cov_34.920223	369	449	0	80	80	1.0000000
NODE_4084_length_1177_cov_34.920223	422	502	0	80	80	1.0000000
NODE_4084_length_1177_cov_34.920223	498	578	0	43	80	0.5375000
NODE_4084_length_1177_cov_34.920223	498	578	6	37	80	0.4625000
NODE_4084_length_1177_cov_34.920223	551	631	6	80	80	1.0000000
NODE_4085_length_1177_cov_12.186456	481	561	0	58	80	0.7250000
NODE_4085_length_1177_cov_12.186456	481	561	2	22	80	0.2750000
NODE_4085_length_1177_cov_12.186456	534	614	0	80	80	1.0000000
NODE_4085_length_1177_cov_12.186456	610	690	0	80	80	1.0000000
NODE_4085_length_1177_cov_12.186456	663	743	0	80	80	1.0000000
NODE_4086_length_1177_cov_11.926716	443	523	2	19	80	0.2375000
NODE_4086_length_1177_cov_11.926716	443	523	4	2	80	0.0250000
NODE_4086_length_1177_cov_11.926716	443	523	6	15	80	0.1875000
NODE_4086_length_1177_cov_11.926716	443	523	8	44	80	0.5500000
NODE_4086_length_1177_cov_11.926716	496	578	2	9	82	0.1097561
NODE_4086_length_1177_cov_11.926716	496	578	6	43	82	0.5243902
NODE_4086_length_1177_cov_11.926716	496	578	8	30	82	0.3658537
NODE_4088_length_1177_cov_5.923933	358	438	0	80	80	1.0000000
NODE_4088_length_1177_cov_5.923933	411	491	0	80	80	1.0000000
NODE_4089_length_1177_cov_5.775510	760	840	0	12	80	0.1500000
NODE_4089_length_1177_cov_5.775510	760	840	2	68	80	0.8500000
NODE_4089_length_1177_cov_5.775510	813	893	2	58	80	0.7250000
NODE_4089_length_1177_cov_5.775510	813	893	4	22	80	0.2750000
NODE_4096_length_1176_cov_26.994429	377	457	2	44	80	0.5500000
NODE_4096_length_1176_cov_26.994429	377	457	4	36	80	0.4500000
NODE_4096_length_1176_cov_26.994429	430	510	2	38	80	0.4750000
NODE_4096_length_1176_cov_26.994429	430	510	4	42	80	0.5250000
NODE_4096_length_1176_cov_26.994429	506	586	0	11	80	0.1375000
NODE_4096_length_1176_cov_26.994429	506	586	2	44	80	0.5500000
NODE_4096_length_1176_cov_26.994429	506	586	4	25	80	0.3125000
NODE_4096_length_1176_cov_26.994429	559	639	0	2	80	0.0250000
NODE_4096_length_1176_cov_26.994429	559	639	4	78	80	0.9750000
NODE_4097_length_1176_cov_15.766945	531	611	0	80	80	1.0000000
NODE_4097_length_1176_cov_15.766945	584	664	0	80	80	1.0000000
NODE_4098_length_1176_cov_14.882080	628	708	2	42	80	0.5250000
NODE_4098_length_1176_cov_14.882080	628	708	4	38	80	0.4750000
NODE_4098_length_1176_cov_14.882080	681	761	0	30	80	0.3750000
NODE_4098_length_1176_cov_14.882080	681	761	2	35	80	0.4375000
NODE_4098_length_1176_cov_14.882080	681	761	4	15	80	0.1875000
NODE_4099_length_1176_cov_10.692665	392	472	0	51	80	0.6375000
NODE_4099_length_1176_cov_10.692665	392	472	2	29	80	0.3625000
NODE_4099_length_1176_cov_10.692665	445	525	2	80	80	1.0000000
NODE_4106_length_1175_cov_50.754647	526	606	0	21	80	0.2625000
NODE_4106_length_1175_cov_50.754647	526	606	1	26	80	0.3250000
NODE_4106_length_1175_cov_50.754647	526	606	2	33	80	0.4125000
NODE_4106_length_1175_cov_50.754647	579	659	0	74	80	0.9250000
NODE_4106_length_1175_cov_50.754647	579	659	1	6	80	0.0750000
NODE_4107_length_1175_cov_42.638476	327	407	0	21	80	0.2625000
NODE_4107_length_1175_cov_42.638476	327	407	2	43	80	0.5375000
NODE_4107_length_1175_cov_42.638476	327	407	4	16	80	0.2000000
NODE_4107_length_1175_cov_42.638476	380	460	0	4	80	0.0500000
NODE_4107_length_1175_cov_42.638476	380	460	2	47	80	0.5875000
NODE_4107_length_1175_cov_42.638476	380	460	4	29	80	0.3625000
NODE_4107_length_1175_cov_42.638476	456	536	0	80	80	1.0000000
NODE_4107_length_1175_cov_42.638476	509	589	0	80	80	1.0000000
NODE_4108_length_1175_cov_40.217472	437	517	0	80	80	1.0000000
NODE_4108_length_1175_cov_40.217472	490	570	0	80	80	1.0000000
NODE_4108_length_1175_cov_40.217472	566	646	0	80	80	1.0000000
NODE_4108_length_1175_cov_40.217472	619	699	0	80	80	1.0000000
NODE_4109_length_1175_cov_12.834572	775	855	2	32	80	0.4000000
NODE_4109_length_1175_cov_12.834572	775	855	6	48	80	0.6000000
NODE_4109_length_1175_cov_12.834572	828	908	0	30	80	0.3750000
NODE_4109_length_1175_cov_12.834572	828	908	2	50	80	0.6250000
NODE_4115_length_1174_cov_20.569302	433	513	0	60	80	0.7500000
NODE_4115_length_1174_cov_20.569302	433	513	2	20	80	0.2500000
NODE_4115_length_1174_cov_20.569302	486	566	0	15	80	0.1875000
NODE_4115_length_1174_cov_20.569302	486	566	2	65	80	0.8125000
NODE_4115_length_1174_cov_20.569302	562	642	0	12	80	0.1500000
NODE_4115_length_1174_cov_20.569302	562	642	2	68	80	0.8500000
NODE_4115_length_1174_cov_20.569302	615	695	0	48	80	0.6000000
NODE_4115_length_1174_cov_20.569302	615	695	2	32	80	0.4000000
NODE_4116_length_1174_cov_18.797209	578	658	0	80	80	1.0000000
NODE_4116_length_1174_cov_18.797209	631	711	0	80	80	1.0000000
NODE_4117_length_1174_cov_17.486512	589	669	2	7	80	0.0875000
NODE_4117_length_1174_cov_17.486512	589	669	4	12	80	0.1500000
NODE_4117_length_1174_cov_17.486512	589	669	8	61	80	0.7625000
NODE_4117_length_1174_cov_17.486512	642	722	0	2	80	0.0250000
NODE_4117_length_1174_cov_17.486512	642	722	4	23	80	0.2875000
NODE_4117_length_1174_cov_17.486512	642	722	6	6	80	0.0750000
NODE_4117_length_1174_cov_17.486512	642	722	8	49	80	0.6125000
NODE_4118_length_1174_cov_15.888372	570	650	0	80	80	1.0000000
NODE_4118_length_1174_cov_15.888372	623	703	0	80	80	1.0000000
NODE_4118_length_1174_cov_15.888372	699	779	0	80	80	1.0000000
NODE_4118_length_1174_cov_15.888372	752	832	0	80	80	1.0000000
NODE_4124_length_1174_cov_1.536744	1066	1115	0	42	49	0.8571429
NODE_4124_length_1174_cov_1.536744	1066	1115	4	7	49	0.1428571
NODE_4124_length_1174_cov_1.536744	1088	1168	0	80	80	1.0000000
NODE_4128_length_1173_cov_29.562384	455	535	0	78	80	0.9750000
NODE_4128_length_1173_cov_29.562384	455	535	2	2	80	0.0250000
NODE_4128_length_1173_cov_29.562384	508	588	0	25	80	0.3125000
NODE_4128_length_1173_cov_29.562384	508	588	2	55	80	0.6875000
NODE_4128_length_1173_cov_29.562384	584	664	0	9	80	0.1125000
NODE_4128_length_1173_cov_29.562384	584	664	1	34	80	0.4250000
NODE_4128_length_1173_cov_29.562384	584	664	2	37	80	0.4625000
NODE_4128_length_1173_cov_29.562384	637	717	1	80	80	1.0000000
NODE_4129_length_1173_cov_25.206704	395	475	0	80	80	1.0000000
NODE_4129_length_1173_cov_25.206704	448	528	0	80	80	1.0000000
NODE_4130_length_1173_cov_9.486965	693	773	0	80	80	1.0000000
NODE_4130_length_1173_cov_9.486965	746	826	0	80	80	1.0000000
NODE_4131_length_1173_cov_7.946927	201	281	0	80	80	1.0000000
NODE_4131_length_1173_cov_7.946927	254	334	0	80	80	1.0000000
NODE_4136_length_1172_cov_37.177074	527	607	0	45	80	0.5625000
NODE_4136_length_1172_cov_37.177074	527	607	2	35	80	0.4375000
NODE_4136_length_1172_cov_37.177074	580	660	2	70	80	0.8750000
NODE_4136_length_1172_cov_37.177074	580	660	4	10	80	0.1250000
NODE_4137_length_1172_cov_20.397018	677	757	0	20	80	0.2500000
NODE_4137_length_1172_cov_20.397018	677	757	2	60	80	0.7500000
NODE_4137_length_1172_cov_20.397018	730	810	0	26	80	0.3250000
NODE_4137_length_1172_cov_20.397018	730	810	2	54	80	0.6750000
NODE_4138_length_1172_cov_15.018639	460	540	2	3	80	0.0375000
NODE_4138_length_1172_cov_15.018639	460	540	4	21	80	0.2625000
NODE_4138_length_1172_cov_15.018639	460	540	6	13	80	0.1625000
NODE_4138_length_1172_cov_15.018639	460	540	8	43	80	0.5375000
NODE_4138_length_1172_cov_15.018639	513	593	2	29	80	0.3625000
NODE_4138_length_1172_cov_15.018639	513	593	4	26	80	0.3250000
NODE_4138_length_1172_cov_15.018639	513	593	6	6	80	0.0750000
NODE_4138_length_1172_cov_15.018639	513	593	8	19	80	0.2375000
NODE_4139_length_1172_cov_13.199441	622	702	0	80	80	1.0000000
NODE_4139_length_1172_cov_13.199441	675	755	0	56	80	0.7000000
NODE_4139_length_1172_cov_13.199441	675	755	2	24	80	0.3000000
NODE_4140_length_1172_cov_10.720410	499	579	2	7	80	0.0875000
NODE_4140_length_1172_cov_10.720410	499	579	4	73	80	0.9125000
NODE_4140_length_1172_cov_10.720410	552	632	0	25	80	0.3125000
NODE_4140_length_1172_cov_10.720410	552	632	2	35	80	0.4375000
NODE_4140_length_1172_cov_10.720410	552	632	4	20	80	0.2500000
NODE_4140_length_1172_cov_10.720410	628	708	0	80	80	1.0000000
NODE_4140_length_1172_cov_10.720410	681	761	0	80	80	1.0000000
NODE_4141_length_1172_cov_10.574091	951	1021	1	8	70	0.1142857
NODE_4141_length_1172_cov_10.574091	951	1021	3	3	70	0.0428571
NODE_4141_length_1172_cov_10.574091	951	1021	5	4	70	0.0571429
NODE_4141_length_1172_cov_10.574091	951	1021	7	4	70	0.0571429
NODE_4141_length_1172_cov_10.574091	951	1021	9	51	70	0.7285714
NODE_4142_length_1172_cov_9.204101	276	356	0	80	80	1.0000000
NODE_4142_length_1172_cov_9.204101	329	409	0	80	80	1.0000000
NODE_4148_length_1171_cov_13.311567	666	746	0	80	80	1.0000000
NODE_4148_length_1171_cov_13.311567	719	803	0	72	84	0.8571429
NODE_4148_length_1171_cov_13.311567	719	803	2	12	84	0.1428571
NODE_4149_length_1171_cov_9.154851	198	278	0	80	80	1.0000000
NODE_4149_length_1171_cov_9.154851	251	331	0	80	80	1.0000000
NODE_4157_length_1170_cov_65.480859	402	482	0	25	80	0.3125000
NODE_4157_length_1170_cov_65.480859	402	482	2	55	80	0.6875000
NODE_4157_length_1170_cov_65.480859	455	535	0	78	80	0.9750000
NODE_4157_length_1170_cov_65.480859	455	535	2	2	80	0.0250000
NODE_4158_length_1170_cov_35.283847	704	784	4	21	80	0.2625000
NODE_4158_length_1170_cov_35.283847	704	784	7	4	80	0.0500000
NODE_4158_length_1170_cov_35.283847	704	784	8	15	80	0.1875000
NODE_4158_length_1170_cov_35.283847	704	784	10	40	80	0.5000000
NODE_4158_length_1170_cov_35.283847	757	837	6	44	80	0.5500000
NODE_4158_length_1170_cov_35.283847	757	837	7	13	80	0.1625000
NODE_4158_length_1170_cov_35.283847	757	837	8	15	80	0.1875000
NODE_4158_length_1170_cov_35.283847	757	837	10	8	80	0.1000000
NODE_4159_length_1170_cov_23.600373	450	530	0	3	80	0.0375000
NODE_4159_length_1170_cov_23.600373	450	530	4	77	80	0.9625000
NODE_4159_length_1170_cov_23.600373	503	583	0	54	80	0.6750000
NODE_4159_length_1170_cov_23.600373	503	583	4	26	80	0.3250000
NODE_4159_length_1170_cov_23.600373	579	659	0	19	80	0.2375000
NODE_4159_length_1170_cov_23.600373	579	659	2	61	80	0.7625000
NODE_4159_length_1170_cov_23.600373	632	705	0	21	73	0.2876712
NODE_4159_length_1170_cov_23.600373	632	705	2	52	73	0.7123288
NODE_4160_length_1170_cov_19.783380	325	405	0	80	80	1.0000000
NODE_4160_length_1170_cov_19.783380	378	458	0	80	80	1.0000000
NODE_4168_length_1169_cov_61.689720	464	544	8	3	80	0.0375000
NODE_4168_length_1169_cov_61.689720	464	544	10	11	80	0.1375000
NODE_4168_length_1169_cov_61.689720	464	544	12	40	80	0.5000000
NODE_4168_length_1169_cov_61.689720	464	544	14	1	80	0.0125000
NODE_4168_length_1169_cov_61.689720	464	544	16	20	80	0.2500000
NODE_4168_length_1169_cov_61.689720	464	544	18	5	80	0.0625000
NODE_4168_length_1169_cov_61.689720	517	597	6	14	80	0.1750000
NODE_4168_length_1169_cov_61.689720	517	597	8	5	80	0.0625000
NODE_4168_length_1169_cov_61.689720	517	597	10	17	80	0.2125000
NODE_4168_length_1169_cov_61.689720	517	597	12	29	80	0.3625000
NODE_4168_length_1169_cov_61.689720	517	597	14	1	80	0.0125000
NODE_4168_length_1169_cov_61.689720	517	597	16	9	80	0.1125000
NODE_4168_length_1169_cov_61.689720	517	597	18	5	80	0.0625000
NODE_4168_length_1169_cov_61.689720	593	673	0	5	80	0.0625000
NODE_4168_length_1169_cov_61.689720	593	673	2	39	80	0.4875000
NODE_4168_length_1169_cov_61.689720	593	673	4	8	80	0.1000000
NODE_4168_length_1169_cov_61.689720	593	673	6	28	80	0.3500000
NODE_4168_length_1169_cov_61.689720	646	726	2	19	80	0.2375000
NODE_4168_length_1169_cov_61.689720	646	726	4	61	80	0.7625000
NODE_4169_length_1169_cov_55.247664	640	720	0	80	80	1.0000000
NODE_4169_length_1169_cov_55.247664	693	773	0	80	80	1.0000000
NODE_4170_length_1169_cov_39.016822	447	527	0	80	80	1.0000000
NODE_4170_length_1169_cov_39.016822	500	580	0	80	80	1.0000000
NODE_4170_length_1169_cov_39.016822	576	656	0	80	80	1.0000000
NODE_4170_length_1169_cov_39.016822	629	709	0	80	80	1.0000000
NODE_4171_length_1169_cov_35.383178	582	662	2	15	80	0.1875000
NODE_4171_length_1169_cov_35.383178	582	662	4	65	80	0.8125000
NODE_4171_length_1169_cov_35.383178	635	715	0	29	80	0.3625000
NODE_4171_length_1169_cov_35.383178	635	715	2	27	80	0.3375000
NODE_4171_length_1169_cov_35.383178	635	715	4	24	80	0.3000000
NODE_4173_length_1169_cov_12.010280	338	418	0	80	80	1.0000000
NODE_4173_length_1169_cov_12.010280	391	471	0	80	80	1.0000000
NODE_4175_length_1169_cov_4.172897	74	135	0	2	61	0.0327869
NODE_4175_length_1169_cov_4.172897	74	135	2	59	61	0.9672131
NODE_4175_length_1169_cov_4.172897	74	135	0	2	61	0.0327869
NODE_4175_length_1169_cov_4.172897	74	135	2	59	61	0.9672131
NODE_4175_length_1169_cov_4.172897	74	135	0	2	61	0.0327869
NODE_4175_length_1169_cov_4.172897	74	135	2	59	61	0.9672131
NODE_4183_length_1168_cov_27.350795	517	597	0	80	80	1.0000000
NODE_4183_length_1168_cov_27.350795	570	650	0	80	80	1.0000000
NODE_4183_length_1168_cov_27.350795	646	726	0	14	80	0.1750000
NODE_4183_length_1168_cov_27.350795	646	726	4	53	80	0.6625000
NODE_4183_length_1168_cov_27.350795	646	726	12	12	80	0.1500000
NODE_4183_length_1168_cov_27.350795	646	726	13	1	80	0.0125000
NODE_4183_length_1168_cov_27.350795	699	779	4	14	80	0.1750000
NODE_4183_length_1168_cov_27.350795	699	779	10	3	80	0.0375000
NODE_4183_length_1168_cov_27.350795	699	779	12	12	80	0.1500000
NODE_4183_length_1168_cov_27.350795	699	779	13	14	80	0.1750000
NODE_4183_length_1168_cov_27.350795	699	779	14	1	80	0.0125000
NODE_4183_length_1168_cov_27.350795	699	779	15	36	80	0.4500000
NODE_4184_length_1168_cov_25.777362	672	752	0	6	80	0.0750000
NODE_4184_length_1168_cov_25.777362	672	752	2	74	80	0.9250000
NODE_4184_length_1168_cov_25.777362	725	805	2	72	80	0.9000000
NODE_4184_length_1168_cov_25.777362	725	805	4	8	80	0.1000000
NODE_4185_length_1168_cov_25.295603	543	623	0	33	80	0.4125000
NODE_4185_length_1168_cov_25.295603	543	623	2	47	80	0.5875000
NODE_4185_length_1168_cov_25.295603	596	676	0	22	80	0.2750000
NODE_4185_length_1168_cov_25.295603	596	676	2	19	80	0.2375000
NODE_4185_length_1168_cov_25.295603	596	676	4	39	80	0.4875000
NODE_4185_length_1168_cov_25.295603	672	752	4	45	80	0.5625000
NODE_4185_length_1168_cov_25.295603	672	752	6	35	80	0.4375000
NODE_4185_length_1168_cov_25.295603	725	804	0	1	79	0.0126582
NODE_4185_length_1168_cov_25.295603	725	804	2	46	79	0.5822785
NODE_4185_length_1168_cov_25.295603	725	804	4	21	79	0.2658228
NODE_4185_length_1168_cov_25.295603	725	804	6	11	79	0.1392405
NODE_4186_length_1168_cov_20.202058	434	514	0	80	80	1.0000000
NODE_4186_length_1168_cov_20.202058	487	567	0	80	80	1.0000000
NODE_4187_length_1168_cov_16.787652	405	485	2	36	80	0.4500000
NODE_4187_length_1168_cov_16.787652	405	485	4	44	80	0.5500000
NODE_4187_length_1168_cov_16.787652	458	538	0	40	80	0.5000000
NODE_4187_length_1168_cov_16.787652	458	538	2	40	80	0.5000000
NODE_4188_length_1168_cov_10.079514	722	802	4	80	80	1.0000000
NODE_4188_length_1168_cov_10.079514	775	855	0	39	80	0.4875000
NODE_4188_length_1168_cov_10.079514	775	855	4	41	80	0.5125000
NODE_4198_length_1167_cov_27.961610	591	671	4	30	80	0.3750000
NODE_4198_length_1167_cov_27.961610	591	671	6	32	80	0.4000000
NODE_4198_length_1167_cov_27.961610	591	671	8	11	80	0.1375000
NODE_4198_length_1167_cov_27.961610	591	671	10	7	80	0.0875000
NODE_4198_length_1167_cov_27.961610	644	724	4	27	80	0.3375000
NODE_4198_length_1167_cov_27.961610	644	724	6	15	80	0.1875000
NODE_4198_length_1167_cov_27.961610	644	724	8	11	80	0.1375000
NODE_4198_length_1167_cov_27.961610	644	724	10	27	80	0.3375000
NODE_4199_length_1167_cov_12.393258	670	750	0	19	80	0.2375000
NODE_4199_length_1167_cov_12.393258	670	750	2	14	80	0.1750000
NODE_4199_length_1167_cov_12.393258	670	750	4	47	80	0.5875000
NODE_4199_length_1167_cov_12.393258	723	803	0	44	80	0.5500000
NODE_4199_length_1167_cov_12.393258	723	803	2	1	80	0.0125000
NODE_4199_length_1167_cov_12.393258	723	803	4	35	80	0.4375000
NODE_4200_length_1167_cov_11.189139	434	514	2	80	80	1.0000000
NODE_4200_length_1167_cov_11.189139	487	567	0	48	80	0.6000000
NODE_4200_length_1167_cov_11.189139	487	567	2	32	80	0.4000000
NODE_4201_length_1167_cov_7.998127	711	791	0	28	80	0.3500000
NODE_4201_length_1167_cov_7.998127	711	791	1	52	80	0.6500000
NODE_4201_length_1167_cov_7.998127	764	844	1	53	80	0.6625000
NODE_4201_length_1167_cov_7.998127	764	844	2	27	80	0.3375000
NODE_4206_length_1166_cov_313.815370	444	524	58	3	80	0.0375000
NODE_4206_length_1166_cov_313.815370	444	524	59	2	80	0.0250000
NODE_4206_length_1166_cov_313.815370	444	524	60	11	80	0.1375000
NODE_4206_length_1166_cov_313.815370	444	524	67	1	80	0.0125000
NODE_4206_length_1166_cov_313.815370	444	524	68	1	80	0.0125000
NODE_4206_length_1166_cov_313.815370	444	524	69	4	80	0.0500000
NODE_4206_length_1166_cov_313.815370	444	524	71	1	80	0.0125000
NODE_4206_length_1166_cov_313.815370	444	524	88	2	80	0.0250000
NODE_4206_length_1166_cov_313.815370	444	524	90	1	80	0.0125000
NODE_4206_length_1166_cov_313.815370	444	524	91	1	80	0.0125000
NODE_4206_length_1166_cov_313.815370	444	524	100	1	80	0.0125000
NODE_4206_length_1166_cov_313.815370	444	524	104	6	80	0.0750000
NODE_4206_length_1166_cov_313.815370	444	524	112	1	80	0.0125000
NODE_4206_length_1166_cov_313.815370	444	524	113	2	80	0.0250000
NODE_4206_length_1166_cov_313.815370	444	524	118	1	80	0.0125000
NODE_4206_length_1166_cov_313.815370	444	524	122	1	80	0.0125000
NODE_4206_length_1166_cov_313.815370	444	524	124	3	80	0.0375000
NODE_4206_length_1166_cov_313.815370	444	524	127	2	80	0.0250000
NODE_4206_length_1166_cov_313.815370	444	524	135	1	80	0.0125000
NODE_4206_length_1166_cov_313.815370	444	524	139	1	80	0.0125000
NODE_4206_length_1166_cov_313.815370	444	524	141	5	80	0.0625000
NODE_4206_length_1166_cov_313.815370	444	524	143	1	80	0.0125000
NODE_4206_length_1166_cov_313.815370	444	524	151	1	80	0.0125000
NODE_4206_length_1166_cov_313.815370	444	524	153	1	80	0.0125000
NODE_4206_length_1166_cov_313.815370	444	524	154	1	80	0.0125000
NODE_4206_length_1166_cov_313.815370	444	524	156	2	80	0.0250000
NODE_4206_length_1166_cov_313.815370	444	524	159	1	80	0.0125000
NODE_4206_length_1166_cov_313.815370	444	524	171	3	80	0.0375000
NODE_4206_length_1166_cov_313.815370	444	524	172	1	80	0.0125000
NODE_4206_length_1166_cov_313.815370	444	524	173	1	80	0.0125000
NODE_4206_length_1166_cov_313.815370	444	524	174	2	80	0.0250000
NODE_4206_length_1166_cov_313.815370	444	524	177	1	80	0.0125000
NODE_4206_length_1166_cov_313.815370	444	524	178	5	80	0.0625000
NODE_4206_length_1166_cov_313.815370	444	524	180	3	80	0.0375000
NODE_4206_length_1166_cov_313.815370	444	524	181	2	80	0.0250000
NODE_4206_length_1166_cov_313.815370	444	524	183	4	80	0.0500000
NODE_4206_length_1166_cov_313.815370	444	524	58	3	80	0.0375000
NODE_4206_length_1166_cov_313.815370	444	524	59	2	80	0.0250000
NODE_4206_length_1166_cov_313.815370	444	524	60	11	80	0.1375000
NODE_4206_length_1166_cov_313.815370	444	524	67	1	80	0.0125000
NODE_4206_length_1166_cov_313.815370	444	524	68	1	80	0.0125000
NODE_4206_length_1166_cov_313.815370	444	524	69	4	80	0.0500000
NODE_4206_length_1166_cov_313.815370	444	524	71	1	80	0.0125000
NODE_4206_length_1166_cov_313.815370	444	524	88	2	80	0.0250000
NODE_4206_length_1166_cov_313.815370	444	524	90	1	80	0.0125000
NODE_4206_length_1166_cov_313.815370	444	524	91	1	80	0.0125000
NODE_4206_length_1166_cov_313.815370	444	524	100	1	80	0.0125000
NODE_4206_length_1166_cov_313.815370	444	524	104	6	80	0.0750000
NODE_4206_length_1166_cov_313.815370	444	524	112	1	80	0.0125000
NODE_4206_length_1166_cov_313.815370	444	524	113	2	80	0.0250000
NODE_4206_length_1166_cov_313.815370	444	524	118	1	80	0.0125000
NODE_4206_length_1166_cov_313.815370	444	524	122	1	80	0.0125000
NODE_4206_length_1166_cov_313.815370	444	524	124	3	80	0.0375000
NODE_4206_length_1166_cov_313.815370	444	524	127	2	80	0.0250000
NODE_4206_length_1166_cov_313.815370	444	524	135	1	80	0.0125000
NODE_4206_length_1166_cov_313.815370	444	524	139	1	80	0.0125000
NODE_4206_length_1166_cov_313.815370	444	524	141	5	80	0.0625000
NODE_4206_length_1166_cov_313.815370	444	524	143	1	80	0.0125000
NODE_4206_length_1166_cov_313.815370	444	524	151	1	80	0.0125000
NODE_4206_length_1166_cov_313.815370	444	524	153	1	80	0.0125000
NODE_4206_length_1166_cov_313.815370	444	524	154	1	80	0.0125000
NODE_4206_length_1166_cov_313.815370	444	524	156	2	80	0.0250000
NODE_4206_length_1166_cov_313.815370	444	524	159	1	80	0.0125000
NODE_4206_length_1166_cov_313.815370	444	524	171	3	80	0.0375000
NODE_4206_length_1166_cov_313.815370	444	524	172	1	80	0.0125000
NODE_4206_length_1166_cov_313.815370	444	524	173	1	80	0.0125000
NODE_4206_length_1166_cov_313.815370	444	524	174	2	80	0.0250000
NODE_4206_length_1166_cov_313.815370	444	524	177	1	80	0.0125000
NODE_4206_length_1166_cov_313.815370	444	524	178	5	80	0.0625000
NODE_4206_length_1166_cov_313.815370	444	524	180	3	80	0.0375000
NODE_4206_length_1166_cov_313.815370	444	524	181	2	80	0.0250000
NODE_4206_length_1166_cov_313.815370	444	524	183	4	80	0.0500000
NODE_4206_length_1166_cov_313.815370	444	524	58	3	80	0.0375000
NODE_4206_length_1166_cov_313.815370	444	524	59	2	80	0.0250000
NODE_4206_length_1166_cov_313.815370	444	524	60	11	80	0.1375000
NODE_4206_length_1166_cov_313.815370	444	524	67	1	80	0.0125000
NODE_4206_length_1166_cov_313.815370	444	524	68	1	80	0.0125000
NODE_4206_length_1166_cov_313.815370	444	524	69	4	80	0.0500000
NODE_4206_length_1166_cov_313.815370	444	524	71	1	80	0.0125000
NODE_4206_length_1166_cov_313.815370	444	524	88	2	80	0.0250000
NODE_4206_length_1166_cov_313.815370	444	524	90	1	80	0.0125000
NODE_4206_length_1166_cov_313.815370	444	524	91	1	80	0.0125000
NODE_4206_length_1166_cov_313.815370	444	524	100	1	80	0.0125000
NODE_4206_length_1166_cov_313.815370	444	524	104	6	80	0.0750000
NODE_4206_length_1166_cov_313.815370	444	524	112	1	80	0.0125000
NODE_4206_length_1166_cov_313.815370	444	524	113	2	80	0.0250000
NODE_4206_length_1166_cov_313.815370	444	524	118	1	80	0.0125000
NODE_4206_length_1166_cov_313.815370	444	524	122	1	80	0.0125000
NODE_4206_length_1166_cov_313.815370	444	524	124	3	80	0.0375000
NODE_4206_length_1166_cov_313.815370	444	524	127	2	80	0.0250000
NODE_4206_length_1166_cov_313.815370	444	524	135	1	80	0.0125000
NODE_4206_length_1166_cov_313.815370	444	524	139	1	80	0.0125000
NODE_4206_length_1166_cov_313.815370	444	524	141	5	80	0.0625000
NODE_4206_length_1166_cov_313.815370	444	524	143	1	80	0.0125000
NODE_4206_length_1166_cov_313.815370	444	524	151	1	80	0.0125000
NODE_4206_length_1166_cov_313.815370	444	524	153	1	80	0.0125000
NODE_4206_length_1166_cov_313.815370	444	524	154	1	80	0.0125000
NODE_4206_length_1166_cov_313.815370	444	524	156	2	80	0.0250000
NODE_4206_length_1166_cov_313.815370	444	524	159	1	80	0.0125000
NODE_4206_length_1166_cov_313.815370	444	524	171	3	80	0.0375000
NODE_4206_length_1166_cov_313.815370	444	524	172	1	80	0.0125000
NODE_4206_length_1166_cov_313.815370	444	524	173	1	80	0.0125000
NODE_4206_length_1166_cov_313.815370	444	524	174	2	80	0.0250000
NODE_4206_length_1166_cov_313.815370	444	524	177	1	80	0.0125000
NODE_4206_length_1166_cov_313.815370	444	524	178	5	80	0.0625000
NODE_4206_length_1166_cov_313.815370	444	524	180	3	80	0.0375000
NODE_4206_length_1166_cov_313.815370	444	524	181	2	80	0.0250000
NODE_4206_length_1166_cov_313.815370	444	524	183	4	80	0.0500000
NODE_4206_length_1166_cov_313.815370	444	524	58	3	80	0.0375000
NODE_4206_length_1166_cov_313.815370	444	524	59	2	80	0.0250000
NODE_4206_length_1166_cov_313.815370	444	524	60	11	80	0.1375000
NODE_4206_length_1166_cov_313.815370	444	524	67	1	80	0.0125000
NODE_4206_length_1166_cov_313.815370	444	524	68	1	80	0.0125000
NODE_4206_length_1166_cov_313.815370	444	524	69	4	80	0.0500000
NODE_4206_length_1166_cov_313.815370	444	524	71	1	80	0.0125000
NODE_4206_length_1166_cov_313.815370	444	524	88	2	80	0.0250000
NODE_4206_length_1166_cov_313.815370	444	524	90	1	80	0.0125000
NODE_4206_length_1166_cov_313.815370	444	524	91	1	80	0.0125000
NODE_4206_length_1166_cov_313.815370	444	524	100	1	80	0.0125000
NODE_4206_length_1166_cov_313.815370	444	524	104	6	80	0.0750000
NODE_4206_length_1166_cov_313.815370	444	524	112	1	80	0.0125000
NODE_4206_length_1166_cov_313.815370	444	524	113	2	80	0.0250000
NODE_4206_length_1166_cov_313.815370	444	524	118	1	80	0.0125000
NODE_4206_length_1166_cov_313.815370	444	524	122	1	80	0.0125000
NODE_4206_length_1166_cov_313.815370	444	524	124	3	80	0.0375000
NODE_4206_length_1166_cov_313.815370	444	524	127	2	80	0.0250000
NODE_4206_length_1166_cov_313.815370	444	524	135	1	80	0.0125000
NODE_4206_length_1166_cov_313.815370	444	524	139	1	80	0.0125000
NODE_4206_length_1166_cov_313.815370	444	524	141	5	80	0.0625000
NODE_4206_length_1166_cov_313.815370	444	524	143	1	80	0.0125000
NODE_4206_length_1166_cov_313.815370	444	524	151	1	80	0.0125000
NODE_4206_length_1166_cov_313.815370	444	524	153	1	80	0.0125000
NODE_4206_length_1166_cov_313.815370	444	524	154	1	80	0.0125000
NODE_4206_length_1166_cov_313.815370	444	524	156	2	80	0.0250000
NODE_4206_length_1166_cov_313.815370	444	524	159	1	80	0.0125000
NODE_4206_length_1166_cov_313.815370	444	524	171	3	80	0.0375000
NODE_4206_length_1166_cov_313.815370	444	524	172	1	80	0.0125000
NODE_4206_length_1166_cov_313.815370	444	524	173	1	80	0.0125000
NODE_4206_length_1166_cov_313.815370	444	524	174	2	80	0.0250000
NODE_4206_length_1166_cov_313.815370	444	524	177	1	80	0.0125000
NODE_4206_length_1166_cov_313.815370	444	524	178	5	80	0.0625000
NODE_4206_length_1166_cov_313.815370	444	524	180	3	80	0.0375000
NODE_4206_length_1166_cov_313.815370	444	524	181	2	80	0.0250000
NODE_4206_length_1166_cov_313.815370	444	524	183	4	80	0.0500000
NODE_4206_length_1166_cov_313.815370	444	524	58	3	80	0.0375000
NODE_4206_length_1166_cov_313.815370	444	524	59	2	80	0.0250000
NODE_4206_length_1166_cov_313.815370	444	524	60	11	80	0.1375000
NODE_4206_length_1166_cov_313.815370	444	524	67	1	80	0.0125000
NODE_4206_length_1166_cov_313.815370	444	524	68	1	80	0.0125000
NODE_4206_length_1166_cov_313.815370	444	524	69	4	80	0.0500000
NODE_4206_length_1166_cov_313.815370	444	524	71	1	80	0.0125000
NODE_4206_length_1166_cov_313.815370	444	524	88	2	80	0.0250000
NODE_4206_length_1166_cov_313.815370	444	524	90	1	80	0.0125000
NODE_4206_length_1166_cov_313.815370	444	524	91	1	80	0.0125000
NODE_4206_length_1166_cov_313.815370	444	524	100	1	80	0.0125000
NODE_4206_length_1166_cov_313.815370	444	524	104	6	80	0.0750000
NODE_4206_length_1166_cov_313.815370	444	524	112	1	80	0.0125000
NODE_4206_length_1166_cov_313.815370	444	524	113	2	80	0.0250000
NODE_4206_length_1166_cov_313.815370	444	524	118	1	80	0.0125000
NODE_4206_length_1166_cov_313.815370	444	524	122	1	80	0.0125000
NODE_4206_length_1166_cov_313.815370	444	524	124	3	80	0.0375000
NODE_4206_length_1166_cov_313.815370	444	524	127	2	80	0.0250000
NODE_4206_length_1166_cov_313.815370	444	524	135	1	80	0.0125000
NODE_4206_length_1166_cov_313.815370	444	524	139	1	80	0.0125000
NODE_4206_length_1166_cov_313.815370	444	524	141	5	80	0.0625000
NODE_4206_length_1166_cov_313.815370	444	524	143	1	80	0.0125000
NODE_4206_length_1166_cov_313.815370	444	524	151	1	80	0.0125000
NODE_4206_length_1166_cov_313.815370	444	524	153	1	80	0.0125000
NODE_4206_length_1166_cov_313.815370	444	524	154	1	80	0.0125000
NODE_4206_length_1166_cov_313.815370	444	524	156	2	80	0.0250000
NODE_4206_length_1166_cov_313.815370	444	524	159	1	80	0.0125000
NODE_4206_length_1166_cov_313.815370	444	524	171	3	80	0.0375000
NODE_4206_length_1166_cov_313.815370	444	524	172	1	80	0.0125000
NODE_4206_length_1166_cov_313.815370	444	524	173	1	80	0.0125000
NODE_4206_length_1166_cov_313.815370	444	524	174	2	80	0.0250000
NODE_4206_length_1166_cov_313.815370	444	524	177	1	80	0.0125000
NODE_4206_length_1166_cov_313.815370	444	524	178	5	80	0.0625000
NODE_4206_length_1166_cov_313.815370	444	524	180	3	80	0.0375000
NODE_4206_length_1166_cov_313.815370	444	524	181	2	80	0.0250000
NODE_4206_length_1166_cov_313.815370	444	524	183	4	80	0.0500000
NODE_4206_length_1166_cov_313.815370	444	524	58	3	80	0.0375000
NODE_4206_length_1166_cov_313.815370	444	524	59	2	80	0.0250000
NODE_4206_length_1166_cov_313.815370	444	524	60	11	80	0.1375000
NODE_4206_length_1166_cov_313.815370	444	524	67	1	80	0.0125000
NODE_4206_length_1166_cov_313.815370	444	524	68	1	80	0.0125000
NODE_4206_length_1166_cov_313.815370	444	524	69	4	80	0.0500000
NODE_4206_length_1166_cov_313.815370	444	524	71	1	80	0.0125000
NODE_4206_length_1166_cov_313.815370	444	524	88	2	80	0.0250000
NODE_4206_length_1166_cov_313.815370	444	524	90	1	80	0.0125000
NODE_4206_length_1166_cov_313.815370	444	524	91	1	80	0.0125000
NODE_4206_length_1166_cov_313.815370	444	524	100	1	80	0.0125000
NODE_4206_length_1166_cov_313.815370	444	524	104	6	80	0.0750000
NODE_4206_length_1166_cov_313.815370	444	524	112	1	80	0.0125000
NODE_4206_length_1166_cov_313.815370	444	524	113	2	80	0.0250000
NODE_4206_length_1166_cov_313.815370	444	524	118	1	80	0.0125000
NODE_4206_length_1166_cov_313.815370	444	524	122	1	80	0.0125000
NODE_4206_length_1166_cov_313.815370	444	524	124	3	80	0.0375000
NODE_4206_length_1166_cov_313.815370	444	524	127	2	80	0.0250000
NODE_4206_length_1166_cov_313.815370	444	524	135	1	80	0.0125000
NODE_4206_length_1166_cov_313.815370	444	524	139	1	80	0.0125000
NODE_4206_length_1166_cov_313.815370	444	524	141	5	80	0.0625000
NODE_4206_length_1166_cov_313.815370	444	524	143	1	80	0.0125000
NODE_4206_length_1166_cov_313.815370	444	524	151	1	80	0.0125000
NODE_4206_length_1166_cov_313.815370	444	524	153	1	80	0.0125000
NODE_4206_length_1166_cov_313.815370	444	524	154	1	80	0.0125000
NODE_4206_length_1166_cov_313.815370	444	524	156	2	80	0.0250000
NODE_4206_length_1166_cov_313.815370	444	524	159	1	80	0.0125000
NODE_4206_length_1166_cov_313.815370	444	524	171	3	80	0.0375000
NODE_4206_length_1166_cov_313.815370	444	524	172	1	80	0.0125000
NODE_4206_length_1166_cov_313.815370	444	524	173	1	80	0.0125000
NODE_4206_length_1166_cov_313.815370	444	524	174	2	80	0.0250000
NODE_4206_length_1166_cov_313.815370	444	524	177	1	80	0.0125000
NODE_4206_length_1166_cov_313.815370	444	524	178	5	80	0.0625000
NODE_4206_length_1166_cov_313.815370	444	524	180	3	80	0.0375000
NODE_4206_length_1166_cov_313.815370	444	524	181	2	80	0.0250000
NODE_4206_length_1166_cov_313.815370	444	524	183	4	80	0.0500000
NODE_4206_length_1166_cov_313.815370	497	577	151	6	80	0.0750000
NODE_4206_length_1166_cov_313.815370	497	577	153	5	80	0.0625000
NODE_4206_length_1166_cov_313.815370	497	577	154	1	80	0.0125000
NODE_4206_length_1166_cov_313.815370	497	577	156	2	80	0.0250000
NODE_4206_length_1166_cov_313.815370	497	577	157	2	80	0.0250000
NODE_4206_length_1166_cov_313.815370	497	577	159	7	80	0.0875000
NODE_4206_length_1166_cov_313.815370	497	577	160	3	80	0.0375000
NODE_4206_length_1166_cov_313.815370	497	577	161	4	80	0.0500000
NODE_4206_length_1166_cov_313.815370	497	577	162	3	80	0.0375000
NODE_4206_length_1166_cov_313.815370	497	577	163	6	80	0.0750000
NODE_4206_length_1166_cov_313.815370	497	577	164	3	80	0.0375000
NODE_4206_length_1166_cov_313.815370	497	577	166	7	80	0.0875000
NODE_4206_length_1166_cov_313.815370	497	577	168	3	80	0.0375000
NODE_4206_length_1166_cov_313.815370	497	577	169	1	80	0.0125000
NODE_4206_length_1166_cov_313.815370	497	577	171	3	80	0.0375000
NODE_4206_length_1166_cov_313.815370	497	577	172	1	80	0.0125000
NODE_4206_length_1166_cov_313.815370	497	577	173	1	80	0.0125000
NODE_4206_length_1166_cov_313.815370	497	577	174	2	80	0.0250000
NODE_4206_length_1166_cov_313.815370	497	577	177	1	80	0.0125000
NODE_4206_length_1166_cov_313.815370	497	577	178	5	80	0.0625000
NODE_4206_length_1166_cov_313.815370	497	577	180	4	80	0.0500000
NODE_4206_length_1166_cov_313.815370	497	577	181	2	80	0.0250000
NODE_4206_length_1166_cov_313.815370	497	577	182	1	80	0.0125000
NODE_4206_length_1166_cov_313.815370	497	577	183	6	80	0.0750000
NODE_4206_length_1166_cov_313.815370	497	577	184	1	80	0.0125000
NODE_4206_length_1166_cov_313.815370	497	577	151	6	80	0.0750000
NODE_4206_length_1166_cov_313.815370	497	577	153	5	80	0.0625000
NODE_4206_length_1166_cov_313.815370	497	577	154	1	80	0.0125000
NODE_4206_length_1166_cov_313.815370	497	577	156	2	80	0.0250000
NODE_4206_length_1166_cov_313.815370	497	577	157	2	80	0.0250000
NODE_4206_length_1166_cov_313.815370	497	577	159	7	80	0.0875000
NODE_4206_length_1166_cov_313.815370	497	577	160	3	80	0.0375000
NODE_4206_length_1166_cov_313.815370	497	577	161	4	80	0.0500000
NODE_4206_length_1166_cov_313.815370	497	577	162	3	80	0.0375000
NODE_4206_length_1166_cov_313.815370	497	577	163	6	80	0.0750000
NODE_4206_length_1166_cov_313.815370	497	577	164	3	80	0.0375000
NODE_4206_length_1166_cov_313.815370	497	577	166	7	80	0.0875000
NODE_4206_length_1166_cov_313.815370	497	577	168	3	80	0.0375000
NODE_4206_length_1166_cov_313.815370	497	577	169	1	80	0.0125000
NODE_4206_length_1166_cov_313.815370	497	577	171	3	80	0.0375000
NODE_4206_length_1166_cov_313.815370	497	577	172	1	80	0.0125000
NODE_4206_length_1166_cov_313.815370	497	577	173	1	80	0.0125000
NODE_4206_length_1166_cov_313.815370	497	577	174	2	80	0.0250000
NODE_4206_length_1166_cov_313.815370	497	577	177	1	80	0.0125000
NODE_4206_length_1166_cov_313.815370	497	577	178	5	80	0.0625000
NODE_4206_length_1166_cov_313.815370	497	577	180	4	80	0.0500000
NODE_4206_length_1166_cov_313.815370	497	577	181	2	80	0.0250000
NODE_4206_length_1166_cov_313.815370	497	577	182	1	80	0.0125000
NODE_4206_length_1166_cov_313.815370	497	577	183	6	80	0.0750000
NODE_4206_length_1166_cov_313.815370	497	577	184	1	80	0.0125000
NODE_4206_length_1166_cov_313.815370	497	577	151	6	80	0.0750000
NODE_4206_length_1166_cov_313.815370	497	577	153	5	80	0.0625000
NODE_4206_length_1166_cov_313.815370	497	577	154	1	80	0.0125000
NODE_4206_length_1166_cov_313.815370	497	577	156	2	80	0.0250000
NODE_4206_length_1166_cov_313.815370	497	577	157	2	80	0.0250000
NODE_4206_length_1166_cov_313.815370	497	577	159	7	80	0.0875000
NODE_4206_length_1166_cov_313.815370	497	577	160	3	80	0.0375000
NODE_4206_length_1166_cov_313.815370	497	577	161	4	80	0.0500000
NODE_4206_length_1166_cov_313.815370	497	577	162	3	80	0.0375000
NODE_4206_length_1166_cov_313.815370	497	577	163	6	80	0.0750000
NODE_4206_length_1166_cov_313.815370	497	577	164	3	80	0.0375000
NODE_4206_length_1166_cov_313.815370	497	577	166	7	80	0.0875000
NODE_4206_length_1166_cov_313.815370	497	577	168	3	80	0.0375000
NODE_4206_length_1166_cov_313.815370	497	577	169	1	80	0.0125000
NODE_4206_length_1166_cov_313.815370	497	577	171	3	80	0.0375000
NODE_4206_length_1166_cov_313.815370	497	577	172	1	80	0.0125000
NODE_4206_length_1166_cov_313.815370	497	577	173	1	80	0.0125000
NODE_4206_length_1166_cov_313.815370	497	577	174	2	80	0.0250000
NODE_4206_length_1166_cov_313.815370	497	577	177	1	80	0.0125000
NODE_4206_length_1166_cov_313.815370	497	577	178	5	80	0.0625000
NODE_4206_length_1166_cov_313.815370	497	577	180	4	80	0.0500000
NODE_4206_length_1166_cov_313.815370	497	577	181	2	80	0.0250000
NODE_4206_length_1166_cov_313.815370	497	577	182	1	80	0.0125000
NODE_4206_length_1166_cov_313.815370	497	577	183	6	80	0.0750000
NODE_4206_length_1166_cov_313.815370	497	577	184	1	80	0.0125000
NODE_4206_length_1166_cov_313.815370	497	577	151	6	80	0.0750000
NODE_4206_length_1166_cov_313.815370	497	577	153	5	80	0.0625000
NODE_4206_length_1166_cov_313.815370	497	577	154	1	80	0.0125000
NODE_4206_length_1166_cov_313.815370	497	577	156	2	80	0.0250000
NODE_4206_length_1166_cov_313.815370	497	577	157	2	80	0.0250000
NODE_4206_length_1166_cov_313.815370	497	577	159	7	80	0.0875000
NODE_4206_length_1166_cov_313.815370	497	577	160	3	80	0.0375000
NODE_4206_length_1166_cov_313.815370	497	577	161	4	80	0.0500000
NODE_4206_length_1166_cov_313.815370	497	577	162	3	80	0.0375000
NODE_4206_length_1166_cov_313.815370	497	577	163	6	80	0.0750000
NODE_4206_length_1166_cov_313.815370	497	577	164	3	80	0.0375000
NODE_4206_length_1166_cov_313.815370	497	577	166	7	80	0.0875000
NODE_4206_length_1166_cov_313.815370	497	577	168	3	80	0.0375000
NODE_4206_length_1166_cov_313.815370	497	577	169	1	80	0.0125000
NODE_4206_length_1166_cov_313.815370	497	577	171	3	80	0.0375000
NODE_4206_length_1166_cov_313.815370	497	577	172	1	80	0.0125000
NODE_4206_length_1166_cov_313.815370	497	577	173	1	80	0.0125000
NODE_4206_length_1166_cov_313.815370	497	577	174	2	80	0.0250000
NODE_4206_length_1166_cov_313.815370	497	577	177	1	80	0.0125000
NODE_4206_length_1166_cov_313.815370	497	577	178	5	80	0.0625000
NODE_4206_length_1166_cov_313.815370	497	577	180	4	80	0.0500000
NODE_4206_length_1166_cov_313.815370	497	577	181	2	80	0.0250000
NODE_4206_length_1166_cov_313.815370	497	577	182	1	80	0.0125000
NODE_4206_length_1166_cov_313.815370	497	577	183	6	80	0.0750000
NODE_4206_length_1166_cov_313.815370	497	577	184	1	80	0.0125000
NODE_4206_length_1166_cov_313.815370	497	577	151	6	80	0.0750000
NODE_4206_length_1166_cov_313.815370	497	577	153	5	80	0.0625000
NODE_4206_length_1166_cov_313.815370	497	577	154	1	80	0.0125000
NODE_4206_length_1166_cov_313.815370	497	577	156	2	80	0.0250000
NODE_4206_length_1166_cov_313.815370	497	577	157	2	80	0.0250000
NODE_4206_length_1166_cov_313.815370	497	577	159	7	80	0.0875000
NODE_4206_length_1166_cov_313.815370	497	577	160	3	80	0.0375000
NODE_4206_length_1166_cov_313.815370	497	577	161	4	80	0.0500000
NODE_4206_length_1166_cov_313.815370	497	577	162	3	80	0.0375000
NODE_4206_length_1166_cov_313.815370	497	577	163	6	80	0.0750000
NODE_4206_length_1166_cov_313.815370	497	577	164	3	80	0.0375000
NODE_4206_length_1166_cov_313.815370	497	577	166	7	80	0.0875000
NODE_4206_length_1166_cov_313.815370	497	577	168	3	80	0.0375000
NODE_4206_length_1166_cov_313.815370	497	577	169	1	80	0.0125000
NODE_4206_length_1166_cov_313.815370	497	577	171	3	80	0.0375000
NODE_4206_length_1166_cov_313.815370	497	577	172	1	80	0.0125000
NODE_4206_length_1166_cov_313.815370	497	577	173	1	80	0.0125000
NODE_4206_length_1166_cov_313.815370	497	577	174	2	80	0.0250000
NODE_4206_length_1166_cov_313.815370	497	577	177	1	80	0.0125000
NODE_4206_length_1166_cov_313.815370	497	577	178	5	80	0.0625000
NODE_4206_length_1166_cov_313.815370	497	577	180	4	80	0.0500000
NODE_4206_length_1166_cov_313.815370	497	577	181	2	80	0.0250000
NODE_4206_length_1166_cov_313.815370	497	577	182	1	80	0.0125000
NODE_4206_length_1166_cov_313.815370	497	577	183	6	80	0.0750000
NODE_4206_length_1166_cov_313.815370	497	577	184	1	80	0.0125000
NODE_4206_length_1166_cov_313.815370	497	577	151	6	80	0.0750000
NODE_4206_length_1166_cov_313.815370	497	577	153	5	80	0.0625000
NODE_4206_length_1166_cov_313.815370	497	577	154	1	80	0.0125000
NODE_4206_length_1166_cov_313.815370	497	577	156	2	80	0.0250000
NODE_4206_length_1166_cov_313.815370	497	577	157	2	80	0.0250000
NODE_4206_length_1166_cov_313.815370	497	577	159	7	80	0.0875000
NODE_4206_length_1166_cov_313.815370	497	577	160	3	80	0.0375000
NODE_4206_length_1166_cov_313.815370	497	577	161	4	80	0.0500000
NODE_4206_length_1166_cov_313.815370	497	577	162	3	80	0.0375000
NODE_4206_length_1166_cov_313.815370	497	577	163	6	80	0.0750000
NODE_4206_length_1166_cov_313.815370	497	577	164	3	80	0.0375000
NODE_4206_length_1166_cov_313.815370	497	577	166	7	80	0.0875000
NODE_4206_length_1166_cov_313.815370	497	577	168	3	80	0.0375000
NODE_4206_length_1166_cov_313.815370	497	577	169	1	80	0.0125000
NODE_4206_length_1166_cov_313.815370	497	577	171	3	80	0.0375000
NODE_4206_length_1166_cov_313.815370	497	577	172	1	80	0.0125000
NODE_4206_length_1166_cov_313.815370	497	577	173	1	80	0.0125000
NODE_4206_length_1166_cov_313.815370	497	577	174	2	80	0.0250000
NODE_4206_length_1166_cov_313.815370	497	577	177	1	80	0.0125000
NODE_4206_length_1166_cov_313.815370	497	577	178	5	80	0.0625000
NODE_4206_length_1166_cov_313.815370	497	577	180	4	80	0.0500000
NODE_4206_length_1166_cov_313.815370	497	577	181	2	80	0.0250000
NODE_4206_length_1166_cov_313.815370	497	577	182	1	80	0.0125000
NODE_4206_length_1166_cov_313.815370	497	577	183	6	80	0.0750000
NODE_4206_length_1166_cov_313.815370	497	577	184	1	80	0.0125000
NODE_4206_length_1166_cov_313.815370	497	568	151	1	71	0.0140845
NODE_4206_length_1166_cov_313.815370	497	568	153	1	71	0.0140845
NODE_4206_length_1166_cov_313.815370	497	568	154	1	71	0.0140845
NODE_4206_length_1166_cov_313.815370	497	568	156	2	71	0.0281690
NODE_4206_length_1166_cov_313.815370	497	568	157	2	71	0.0281690
NODE_4206_length_1166_cov_313.815370	497	568	159	7	71	0.0985916
NODE_4206_length_1166_cov_313.815370	497	568	160	3	71	0.0422535
NODE_4206_length_1166_cov_313.815370	497	568	161	4	71	0.0563380
NODE_4206_length_1166_cov_313.815370	497	568	162	3	71	0.0422535
NODE_4206_length_1166_cov_313.815370	497	568	163	6	71	0.0845070
NODE_4206_length_1166_cov_313.815370	497	568	164	3	71	0.0422535
NODE_4206_length_1166_cov_313.815370	497	568	166	7	71	0.0985916
NODE_4206_length_1166_cov_313.815370	497	568	168	3	71	0.0422535
NODE_4206_length_1166_cov_313.815370	497	568	169	1	71	0.0140845
NODE_4206_length_1166_cov_313.815370	497	568	171	3	71	0.0422535
NODE_4206_length_1166_cov_313.815370	497	568	172	1	71	0.0140845
NODE_4206_length_1166_cov_313.815370	497	568	173	1	71	0.0140845
NODE_4206_length_1166_cov_313.815370	497	568	174	2	71	0.0281690
NODE_4206_length_1166_cov_313.815370	497	568	177	1	71	0.0140845
NODE_4206_length_1166_cov_313.815370	497	568	178	5	71	0.0704225
NODE_4206_length_1166_cov_313.815370	497	568	180	4	71	0.0563380
NODE_4206_length_1166_cov_313.815370	497	568	181	2	71	0.0281690
NODE_4206_length_1166_cov_313.815370	497	568	182	1	71	0.0140845
NODE_4206_length_1166_cov_313.815370	497	568	183	6	71	0.0845070
NODE_4206_length_1166_cov_313.815370	497	568	184	1	71	0.0140845
NODE_4206_length_1166_cov_313.815370	500	570	151	3	70	0.0428571
NODE_4206_length_1166_cov_313.815370	500	570	156	1	70	0.0142857
NODE_4206_length_1166_cov_313.815370	500	570	157	2	70	0.0285714
NODE_4206_length_1166_cov_313.815370	500	570	159	7	70	0.1000000
NODE_4206_length_1166_cov_313.815370	500	570	160	3	70	0.0428571
NODE_4206_length_1166_cov_313.815370	500	570	161	4	70	0.0571429
NODE_4206_length_1166_cov_313.815370	500	570	162	3	70	0.0428571
NODE_4206_length_1166_cov_313.815370	500	570	163	6	70	0.0857143
NODE_4206_length_1166_cov_313.815370	500	570	164	3	70	0.0428571
NODE_4206_length_1166_cov_313.815370	500	570	166	7	70	0.1000000
NODE_4206_length_1166_cov_313.815370	500	570	168	3	70	0.0428571
NODE_4206_length_1166_cov_313.815370	500	570	169	1	70	0.0142857
NODE_4206_length_1166_cov_313.815370	500	570	171	3	70	0.0428571
NODE_4206_length_1166_cov_313.815370	500	570	172	1	70	0.0142857
NODE_4206_length_1166_cov_313.815370	500	570	173	1	70	0.0142857
NODE_4206_length_1166_cov_313.815370	500	570	174	2	70	0.0285714
NODE_4206_length_1166_cov_313.815370	500	570	177	1	70	0.0142857
NODE_4206_length_1166_cov_313.815370	500	570	178	5	70	0.0714286
NODE_4206_length_1166_cov_313.815370	500	570	180	4	70	0.0571429
NODE_4206_length_1166_cov_313.815370	500	570	181	2	70	0.0285714
NODE_4206_length_1166_cov_313.815370	500	570	182	1	70	0.0142857
NODE_4206_length_1166_cov_313.815370	500	570	183	6	70	0.0857143
NODE_4206_length_1166_cov_313.815370	500	570	184	1	70	0.0142857
NODE_4206_length_1166_cov_313.815370	997	1077	4	2	80	0.0250000
NODE_4206_length_1166_cov_313.815370	997	1077	6	2	80	0.0250000
NODE_4206_length_1166_cov_313.815370	997	1077	8	9	80	0.1125000
NODE_4206_length_1166_cov_313.815370	997	1077	10	3	80	0.0375000
NODE_4206_length_1166_cov_313.815370	997	1077	12	29	80	0.3625000
NODE_4206_length_1166_cov_313.815370	997	1077	14	2	80	0.0250000
NODE_4206_length_1166_cov_313.815370	997	1077	16	11	80	0.1375000
NODE_4206_length_1166_cov_313.815370	997	1077	18	22	80	0.2750000
NODE_4206_length_1166_cov_313.815370	1050	1130	8	19	80	0.2375000
NODE_4206_length_1166_cov_313.815370	1050	1130	10	16	80	0.2000000
NODE_4206_length_1166_cov_313.815370	1050	1130	12	23	80	0.2875000
NODE_4206_length_1166_cov_313.815370	1050	1130	14	1	80	0.0125000
NODE_4206_length_1166_cov_313.815370	1050	1130	16	8	80	0.1000000
NODE_4206_length_1166_cov_313.815370	1050	1130	18	13	80	0.1625000
NODE_4206_length_1166_cov_313.815370	1050	1130	8	19	80	0.2375000
NODE_4206_length_1166_cov_313.815370	1050	1130	10	16	80	0.2000000
NODE_4206_length_1166_cov_313.815370	1050	1130	12	23	80	0.2875000
NODE_4206_length_1166_cov_313.815370	1050	1130	14	1	80	0.0125000
NODE_4206_length_1166_cov_313.815370	1050	1130	16	8	80	0.1000000
NODE_4206_length_1166_cov_313.815370	1050	1130	18	13	80	0.1625000
NODE_4206_length_1166_cov_313.815370	1050	1121	8	10	71	0.1408451
NODE_4206_length_1166_cov_313.815370	1050	1121	10	16	71	0.2253521
NODE_4206_length_1166_cov_313.815370	1050	1121	12	23	71	0.3239437
NODE_4206_length_1166_cov_313.815370	1050	1121	14	1	71	0.0140845
NODE_4206_length_1166_cov_313.815370	1050	1121	16	8	71	0.1126761
NODE_4206_length_1166_cov_313.815370	1050	1121	18	13	71	0.1830986
NODE_4207_length_1166_cov_25.107779	561	641	0	80	80	1.0000000
NODE_4207_length_1166_cov_25.107779	614	694	0	80	80	1.0000000
NODE_4209_length_1166_cov_18.820056	325	405	0	80	80	1.0000000
NODE_4209_length_1166_cov_18.820056	378	458	0	80	80	1.0000000
NODE_4210_length_1166_cov_18.404873	676	756	0	80	80	1.0000000
NODE_4210_length_1166_cov_18.404873	729	809	0	80	80	1.0000000
NODE_4214_length_1166_cov_1.893158	0	71	0	71	71	1.0000000
NODE_4214_length_1166_cov_1.893158	44	99	0	55	55	1.0000000
NODE_4218_length_1165_cov_29.402439	497	577	0	5	80	0.0625000
NODE_4218_length_1165_cov_29.402439	497	577	1	68	80	0.8500000
NODE_4218_length_1165_cov_29.402439	497	577	2	7	80	0.0875000
NODE_4218_length_1165_cov_29.402439	550	630	0	58	80	0.7250000
NODE_4218_length_1165_cov_29.402439	550	630	1	22	80	0.2750000
NODE_4218_length_1165_cov_29.402439	626	706	0	80	80	1.0000000
NODE_4218_length_1165_cov_29.402439	679	759	0	80	80	1.0000000
NODE_4219_length_1165_cov_28.366792	663	743	6	23	80	0.2875000
NODE_4219_length_1165_cov_28.366792	663	743	10	57	80	0.7125000
NODE_4219_length_1165_cov_28.366792	716	796	0	27	80	0.3375000
NODE_4219_length_1165_cov_28.366792	716	796	3	1	80	0.0125000
NODE_4219_length_1165_cov_28.366792	716	796	4	4	80	0.0500000
NODE_4219_length_1165_cov_28.366792	716	796	10	48	80	0.6000000
NODE_4220_length_1165_cov_23.841463	631	711	0	39	80	0.4875000
NODE_4220_length_1165_cov_23.841463	631	711	4	41	80	0.5125000
NODE_4220_length_1165_cov_23.841463	684	765	4	62	81	0.7654321
NODE_4220_length_1165_cov_23.841463	684	765	6	19	81	0.2345679
NODE_4220_length_1165_cov_23.841463	761	841	0	10	80	0.1250000
NODE_4220_length_1165_cov_23.841463	761	841	2	39	80	0.4875000
NODE_4220_length_1165_cov_23.841463	761	841	6	31	80	0.3875000
NODE_4220_length_1165_cov_23.841463	814	894	0	63	80	0.7875000
NODE_4220_length_1165_cov_23.841463	814	894	2	17	80	0.2125000
NODE_4221_length_1165_cov_21.883677	482	562	2	6	80	0.0750000
NODE_4221_length_1165_cov_21.883677	482	562	4	21	80	0.2625000
NODE_4221_length_1165_cov_21.883677	482	562	6	53	80	0.6625000
NODE_4221_length_1165_cov_21.883677	535	615	0	12	80	0.1500000
NODE_4221_length_1165_cov_21.883677	535	615	2	4	80	0.0500000
NODE_4221_length_1165_cov_21.883677	535	615	4	5	80	0.0625000
NODE_4221_length_1165_cov_21.883677	535	615	5	21	80	0.2625000
NODE_4221_length_1165_cov_21.883677	535	615	6	38	80	0.4750000
NODE_4222_length_1165_cov_14.591932	295	375	2	55	80	0.6875000
NODE_4222_length_1165_cov_14.591932	295	375	4	19	80	0.2375000
NODE_4222_length_1165_cov_14.591932	295	375	6	6	80	0.0750000
NODE_4222_length_1165_cov_14.591932	348	428	2	2	80	0.0250000
NODE_4222_length_1165_cov_14.591932	348	428	4	72	80	0.9000000
NODE_4222_length_1165_cov_14.591932	348	428	6	6	80	0.0750000
NODE_4223_length_1165_cov_13.683865	502	582	0	80	80	1.0000000
NODE_4223_length_1165_cov_13.683865	555	635	0	80	80	1.0000000
NODE_4224_length_1165_cov_7.915572	383	463	0	80	80	1.0000000
NODE_4224_length_1165_cov_7.915572	436	516	0	61	80	0.7625000
NODE_4224_length_1165_cov_7.915572	436	516	2	19	80	0.2375000
NODE_4225_length_1165_cov_7.466229	552	632	0	2	80	0.0250000
NODE_4225_length_1165_cov_7.466229	552	632	2	70	80	0.8750000
NODE_4225_length_1165_cov_7.466229	552	632	4	3	80	0.0375000
NODE_4225_length_1165_cov_7.466229	552	632	6	5	80	0.0625000
NODE_4225_length_1165_cov_7.466229	605	685	2	22	80	0.2750000
NODE_4225_length_1165_cov_7.466229	605	685	6	10	80	0.1250000
NODE_4225_length_1165_cov_7.466229	605	685	8	9	80	0.1125000
NODE_4225_length_1165_cov_7.466229	605	685	10	39	80	0.4875000
NODE_4226_length_1165_cov_5.617261	676	756	0	80	80	1.0000000
NODE_4226_length_1165_cov_5.617261	729	809	0	80	80	1.0000000
NODE_4227_length_1165_cov_3.658537	554	602	0	48	48	1.0000000
NODE_4233_length_1164_cov_55.273239	459	539	0	49	80	0.6125000
NODE_4233_length_1164_cov_55.273239	459	539	2	31	80	0.3875000
NODE_4233_length_1164_cov_55.273239	512	592	0	17	80	0.2125000
NODE_4233_length_1164_cov_55.273239	512	592	2	63	80	0.7875000
NODE_4234_length_1164_cov_44.183099	571	651	0	80	80	1.0000000
NODE_4234_length_1164_cov_44.183099	624	704	0	69	80	0.8625000
NODE_4234_length_1164_cov_44.183099	624	704	4	11	80	0.1375000
NODE_4234_length_1164_cov_44.183099	700	780	4	80	80	1.0000000
NODE_4234_length_1164_cov_44.183099	753	833	0	48	80	0.6000000
NODE_4234_length_1164_cov_44.183099	753	833	4	32	80	0.4000000
NODE_4235_length_1164_cov_14.277934	1029	1109	4	8	80	0.1000000
NODE_4235_length_1164_cov_14.277934	1029	1109	6	72	80	0.9000000
NODE_4235_length_1164_cov_14.277934	1097	1162	0	11	65	0.1692308
NODE_4235_length_1164_cov_14.277934	1097	1162	4	28	65	0.4307692
NODE_4235_length_1164_cov_14.277934	1097	1162	6	26	65	0.4000000
NODE_4236_length_1164_cov_12.880751	415	495	0	80	80	1.0000000
NODE_4236_length_1164_cov_12.880751	468	548	0	80	80	1.0000000
NODE_4237_length_1164_cov_6.924883	415	495	0	9	80	0.1125000
NODE_4237_length_1164_cov_6.924883	415	495	2	19	80	0.2375000
NODE_4237_length_1164_cov_6.924883	415	495	4	52	80	0.6500000
NODE_4237_length_1164_cov_6.924883	468	548	0	62	80	0.7750000
NODE_4237_length_1164_cov_6.924883	468	548	2	18	80	0.2250000
NODE_4245_length_1163_cov_36.315789	458	538	0	80	80	1.0000000
NODE_4245_length_1163_cov_36.315789	511	591	0	80	80	1.0000000
NODE_4245_length_1163_cov_36.315789	587	667	0	5	80	0.0625000
NODE_4245_length_1163_cov_36.315789	587	667	2	75	80	0.9375000
NODE_4245_length_1163_cov_36.315789	640	720	0	29	80	0.3625000
NODE_4245_length_1163_cov_36.315789	640	720	2	51	80	0.6375000
NODE_4246_length_1163_cov_29.466165	542	622	0	80	80	1.0000000
NODE_4246_length_1163_cov_29.466165	595	675	0	42	80	0.5250000
NODE_4246_length_1163_cov_29.466165	595	675	2	38	80	0.4750000
NODE_4246_length_1163_cov_29.466165	671	751	2	80	80	1.0000000
NODE_4246_length_1163_cov_29.466165	724	804	0	48	80	0.6000000
NODE_4246_length_1163_cov_29.466165	724	804	2	32	80	0.4000000
NODE_4247_length_1163_cov_15.107143	668	748	0	58	80	0.7250000
NODE_4247_length_1163_cov_15.107143	668	748	2	22	80	0.2750000
NODE_4247_length_1163_cov_15.107143	721	801	0	5	80	0.0625000
NODE_4247_length_1163_cov_15.107143	721	801	2	75	80	0.9375000
NODE_4248_length_1163_cov_14.347744	540	620	0	80	80	1.0000000
NODE_4248_length_1163_cov_14.347744	593	673	0	80	80	1.0000000
NODE_4249_length_1163_cov_11.650376	354	434	0	40	80	0.5000000
NODE_4249_length_1163_cov_11.650376	354	434	2	40	80	0.5000000
NODE_4249_length_1163_cov_11.650376	407	487	0	80	80	1.0000000
NODE_4249_length_1163_cov_11.650376	738	818	0	27	80	0.3375000
NODE_4249_length_1163_cov_11.650376	738	818	2	53	80	0.6625000
NODE_4249_length_1163_cov_11.650376	791	871	0	30	80	0.3750000
NODE_4249_length_1163_cov_11.650376	791	871	2	50	80	0.6250000
NODE_4253_length_1162_cov_30.049859	359	439	3	45	80	0.5625000
NODE_4253_length_1162_cov_30.049859	359	439	4	35	80	0.4375000
NODE_4253_length_1162_cov_30.049859	412	492	0	50	80	0.6250000
NODE_4253_length_1162_cov_30.049859	412	492	3	30	80	0.3750000
NODE_4254_length_1162_cov_25.960489	440	520	0	80	80	1.0000000
NODE_4254_length_1162_cov_25.960489	493	573	0	80	80	1.0000000
NODE_4254_length_1162_cov_25.960489	569	649	0	38	80	0.4750000
NODE_4254_length_1162_cov_25.960489	569	649	2	42	80	0.5250000
NODE_4254_length_1162_cov_25.960489	622	702	0	9	80	0.1125000
NODE_4254_length_1162_cov_25.960489	622	702	2	71	80	0.8875000
NODE_4255_length_1162_cov_24.843838	523	603	0	13	80	0.1625000
NODE_4255_length_1162_cov_24.843838	523	603	2	67	80	0.8375000
NODE_4255_length_1162_cov_24.843838	576	656	0	9	80	0.1125000
NODE_4255_length_1162_cov_24.843838	576	656	2	71	80	0.8875000
NODE_4255_length_1162_cov_24.843838	652	732	0	80	80	1.0000000
NODE_4255_length_1162_cov_24.843838	705	785	0	80	80	1.0000000
NODE_4257_length_1162_cov_17.131703	302	382	0	80	80	1.0000000
NODE_4257_length_1162_cov_17.131703	355	435	0	80	80	1.0000000
NODE_4257_length_1162_cov_17.131703	431	511	0	80	80	1.0000000
NODE_4257_length_1162_cov_17.131703	484	564	0	80	80	1.0000000
NODE_4258_length_1162_cov_14.766698	630	710	2	4	80	0.0500000
NODE_4258_length_1162_cov_14.766698	630	710	4	76	80	0.9500000
NODE_4258_length_1162_cov_14.766698	683	763	0	30	80	0.3750000
NODE_4258_length_1162_cov_14.766698	683	763	2	2	80	0.0250000
NODE_4258_length_1162_cov_14.766698	683	763	4	48	80	0.6000000
NODE_4259_length_1162_cov_13.968015	423	503	0	59	80	0.7375000
NODE_4259_length_1162_cov_13.968015	423	503	4	21	80	0.2625000
NODE_4259_length_1162_cov_13.968015	476	556	0	6	80	0.0750000
NODE_4259_length_1162_cov_13.968015	476	556	4	74	80	0.9250000
NODE_4264_length_1162_cov_1.977422	855	926	0	71	71	1.0000000
NODE_4264_length_1162_cov_1.977422	908	977	0	69	69	1.0000000
NODE_4264_length_1162_cov_1.977422	908	977	0	69	69	1.0000000
NODE_4266_length_1161_cov_33.312618	456	536	0	50	80	0.6250000
NODE_4266_length_1161_cov_33.312618	456	536	2	30	80	0.3750000
NODE_4266_length_1161_cov_33.312618	509	587	2	78	78	1.0000000
NODE_4267_length_1161_cov_30.466102	594	674	2	41	80	0.5125000
NODE_4267_length_1161_cov_30.466102	594	674	4	39	80	0.4875000
NODE_4267_length_1161_cov_30.466102	647	727	0	32	80	0.4000000
NODE_4267_length_1161_cov_30.466102	647	727	2	31	80	0.3875000
NODE_4267_length_1161_cov_30.466102	647	727	4	17	80	0.2125000
NODE_4268_length_1161_cov_29.628060	426	506	0	15	80	0.1875000
NODE_4268_length_1161_cov_29.628060	426	506	2	17	80	0.2125000
NODE_4268_length_1161_cov_29.628060	426	506	4	48	80	0.6000000
NODE_4268_length_1161_cov_29.628060	479	559	0	17	80	0.2125000
NODE_4268_length_1161_cov_29.628060	479	559	2	13	80	0.1625000
NODE_4268_length_1161_cov_29.628060	479	559	4	50	80	0.6250000
NODE_4268_length_1161_cov_29.628060	603	683	0	80	80	1.0000000
NODE_4268_length_1161_cov_29.628060	656	736	0	61	80	0.7625000
NODE_4268_length_1161_cov_29.628060	656	736	2	19	80	0.2375000
NODE_4269_length_1161_cov_22.923729	492	572	2	80	80	1.0000000
NODE_4269_length_1161_cov_22.923729	545	625	0	22	80	0.2750000
NODE_4269_length_1161_cov_22.923729	545	625	2	58	80	0.7250000
NODE_4269_length_1161_cov_22.923729	621	701	0	80	80	1.0000000
NODE_4269_length_1161_cov_22.923729	674	754	0	80	80	1.0000000
NODE_4270_length_1161_cov_20.184557	480	560	0	21	80	0.2625000
NODE_4270_length_1161_cov_20.184557	480	560	2	30	80	0.3750000
NODE_4270_length_1161_cov_20.184557	480	560	4	15	80	0.1875000
NODE_4270_length_1161_cov_20.184557	480	560	5	14	80	0.1750000
NODE_4270_length_1161_cov_20.184557	533	613	0	6	80	0.0750000
NODE_4270_length_1161_cov_20.184557	533	613	2	5	80	0.0625000
NODE_4270_length_1161_cov_20.184557	533	613	4	17	80	0.2125000
NODE_4270_length_1161_cov_20.184557	533	613	5	52	80	0.6500000
NODE_4271_length_1161_cov_17.437853	375	455	0	57	80	0.7125000
NODE_4271_length_1161_cov_17.437853	375	455	2	23	80	0.2875000
NODE_4271_length_1161_cov_17.437853	428	508	0	80	80	1.0000000
NODE_4272_length_1161_cov_14.062147	375	455	0	24	80	0.3000000
NODE_4272_length_1161_cov_14.062147	375	455	2	56	80	0.7000000
NODE_4272_length_1161_cov_14.062147	428	508	2	80	80	1.0000000
NODE_4273_length_1161_cov_12.304143	381	461	0	80	80	1.0000000
NODE_4273_length_1161_cov_12.304143	434	514	0	80	80	1.0000000
NODE_4274_length_1161_cov_10.297552	598	678	2	6	80	0.0750000
NODE_4274_length_1161_cov_10.297552	598	678	4	4	80	0.0500000
NODE_4274_length_1161_cov_10.297552	598	678	6	39	80	0.4875000
NODE_4274_length_1161_cov_10.297552	598	678	8	31	80	0.3875000
NODE_4274_length_1161_cov_10.297552	651	731	2	8	80	0.1000000
NODE_4274_length_1161_cov_10.297552	651	731	4	27	80	0.3375000
NODE_4274_length_1161_cov_10.297552	651	731	6	41	80	0.5125000
NODE_4274_length_1161_cov_10.297552	651	731	8	4	80	0.0500000
NODE_4283_length_1160_cov_86.515551	613	693	0	80	80	1.0000000
NODE_4283_length_1160_cov_86.515551	666	746	0	80	80	1.0000000
NODE_4284_length_1160_cov_29.272385	526	606	0	6	80	0.0750000
NODE_4284_length_1160_cov_29.272385	526	606	2	24	80	0.3000000
NODE_4284_length_1160_cov_29.272385	526	606	6	24	80	0.3000000
NODE_4284_length_1160_cov_29.272385	526	606	8	26	80	0.3250000
NODE_4284_length_1160_cov_29.272385	579	659	0	10	80	0.1250000
NODE_4284_length_1160_cov_29.272385	579	659	2	17	80	0.2125000
NODE_4284_length_1160_cov_29.272385	579	659	6	8	80	0.1000000
NODE_4284_length_1160_cov_29.272385	579	659	8	45	80	0.5625000
NODE_4285_length_1160_cov_21.391140	767	847	0	14	80	0.1750000
NODE_4285_length_1160_cov_21.391140	767	847	2	66	80	0.8250000
NODE_4296_length_1159_cov_147.794340	911	991	222	1	80	0.0125000
NODE_4296_length_1159_cov_147.794340	911	991	232	1	80	0.0125000
NODE_4296_length_1159_cov_147.794340	911	991	237	1	80	0.0125000
NODE_4296_length_1159_cov_147.794340	911	991	243	1	80	0.0125000
NODE_4296_length_1159_cov_147.794340	911	991	246	1	80	0.0125000
NODE_4296_length_1159_cov_147.794340	911	991	256	1	80	0.0125000
NODE_4296_length_1159_cov_147.794340	911	991	260	1	80	0.0125000
NODE_4296_length_1159_cov_147.794340	911	991	270	1	80	0.0125000
NODE_4296_length_1159_cov_147.794340	911	991	272	2	80	0.0250000
NODE_4296_length_1159_cov_147.794340	911	991	273	1	80	0.0125000
NODE_4296_length_1159_cov_147.794340	911	991	274	1	80	0.0125000
NODE_4296_length_1159_cov_147.794340	911	991	275	1	80	0.0125000
NODE_4296_length_1159_cov_147.794340	911	991	276	4	80	0.0500000
NODE_4296_length_1159_cov_147.794340	911	991	277	1	80	0.0125000
NODE_4296_length_1159_cov_147.794340	911	991	278	2	80	0.0250000
NODE_4296_length_1159_cov_147.794340	911	991	279	2	80	0.0250000
NODE_4296_length_1159_cov_147.794340	911	991	281	1	80	0.0125000
NODE_4296_length_1159_cov_147.794340	911	991	282	1	80	0.0125000
NODE_4296_length_1159_cov_147.794340	911	991	286	1	80	0.0125000
NODE_4296_length_1159_cov_147.794340	911	991	288	1	80	0.0125000
NODE_4296_length_1159_cov_147.794340	911	991	290	2	80	0.0250000
NODE_4296_length_1159_cov_147.794340	911	991	292	4	80	0.0500000
NODE_4296_length_1159_cov_147.794340	911	991	293	1	80	0.0125000
NODE_4296_length_1159_cov_147.794340	911	991	294	1	80	0.0125000
NODE_4296_length_1159_cov_147.794340	911	991	295	2	80	0.0250000
NODE_4296_length_1159_cov_147.794340	911	991	296	1	80	0.0125000
NODE_4296_length_1159_cov_147.794340	911	991	297	1	80	0.0125000
NODE_4296_length_1159_cov_147.794340	911	991	299	1	80	0.0125000
NODE_4296_length_1159_cov_147.794340	911	991	301	2	80	0.0250000
NODE_4296_length_1159_cov_147.794340	911	991	303	1	80	0.0125000
NODE_4296_length_1159_cov_147.794340	911	991	304	1	80	0.0125000
NODE_4296_length_1159_cov_147.794340	911	991	307	1	80	0.0125000
NODE_4296_length_1159_cov_147.794340	911	991	311	1	80	0.0125000
NODE_4296_length_1159_cov_147.794340	911	991	313	2	80	0.0250000
NODE_4296_length_1159_cov_147.794340	911	991	317	3	80	0.0375000
NODE_4296_length_1159_cov_147.794340	911	991	319	4	80	0.0500000
NODE_4296_length_1159_cov_147.794340	911	991	321	1	80	0.0125000
NODE_4296_length_1159_cov_147.794340	911	991	323	4	80	0.0500000
NODE_4296_length_1159_cov_147.794340	911	991	324	6	80	0.0750000
NODE_4296_length_1159_cov_147.794340	911	991	325	1	80	0.0125000
NODE_4296_length_1159_cov_147.794340	911	991	326	1	80	0.0125000
NODE_4296_length_1159_cov_147.794340	911	991	327	1	80	0.0125000
NODE_4296_length_1159_cov_147.794340	911	991	329	1	80	0.0125000
NODE_4296_length_1159_cov_147.794340	911	991	330	1	80	0.0125000
NODE_4296_length_1159_cov_147.794340	911	991	331	3	80	0.0375000
NODE_4296_length_1159_cov_147.794340	911	991	334	3	80	0.0375000
NODE_4296_length_1159_cov_147.794340	911	991	336	1	80	0.0125000
NODE_4296_length_1159_cov_147.794340	911	991	337	1	80	0.0125000
NODE_4296_length_1159_cov_147.794340	911	991	340	1	80	0.0125000
NODE_4296_length_1159_cov_147.794340	911	991	345	1	80	0.0125000
NODE_4296_length_1159_cov_147.794340	964	1044	86	1	80	0.0125000
NODE_4296_length_1159_cov_147.794340	964	1044	90	3	80	0.0375000
NODE_4296_length_1159_cov_147.794340	964	1044	91	1	80	0.0125000
NODE_4296_length_1159_cov_147.794340	964	1044	92	2	80	0.0250000
NODE_4296_length_1159_cov_147.794340	964	1044	94	2	80	0.0250000
NODE_4296_length_1159_cov_147.794340	964	1044	97	1	80	0.0125000
NODE_4296_length_1159_cov_147.794340	964	1044	99	1	80	0.0125000
NODE_4296_length_1159_cov_147.794340	964	1044	103	1	80	0.0125000
NODE_4296_length_1159_cov_147.794340	964	1044	109	1	80	0.0125000
NODE_4296_length_1159_cov_147.794340	964	1044	120	1	80	0.0125000
NODE_4296_length_1159_cov_147.794340	964	1044	122	2	80	0.0250000
NODE_4296_length_1159_cov_147.794340	964	1044	124	1	80	0.0125000
NODE_4296_length_1159_cov_147.794340	964	1044	125	2	80	0.0250000
NODE_4296_length_1159_cov_147.794340	964	1044	127	3	80	0.0375000
NODE_4296_length_1159_cov_147.794340	964	1044	129	2	80	0.0250000
NODE_4296_length_1159_cov_147.794340	964	1044	139	4	80	0.0500000
NODE_4296_length_1159_cov_147.794340	964	1044	146	1	80	0.0125000
NODE_4296_length_1159_cov_147.794340	964	1044	166	4	80	0.0500000
NODE_4296_length_1159_cov_147.794340	964	1044	170	1	80	0.0125000
NODE_4296_length_1159_cov_147.794340	964	1044	174	1	80	0.0125000
NODE_4296_length_1159_cov_147.794340	964	1044	179	1	80	0.0125000
NODE_4296_length_1159_cov_147.794340	964	1044	185	1	80	0.0125000
NODE_4296_length_1159_cov_147.794340	964	1044	195	1	80	0.0125000
NODE_4296_length_1159_cov_147.794340	964	1044	203	1	80	0.0125000
NODE_4296_length_1159_cov_147.794340	964	1044	205	1	80	0.0125000
NODE_4296_length_1159_cov_147.794340	964	1044	207	1	80	0.0125000
NODE_4296_length_1159_cov_147.794340	964	1044	210	1	80	0.0125000
NODE_4296_length_1159_cov_147.794340	964	1044	214	1	80	0.0125000
NODE_4296_length_1159_cov_147.794340	964	1044	216	1	80	0.0125000
NODE_4296_length_1159_cov_147.794340	964	1044	220	2	80	0.0250000
NODE_4296_length_1159_cov_147.794340	964	1044	239	1	80	0.0125000
NODE_4296_length_1159_cov_147.794340	964	1044	246	1	80	0.0125000
NODE_4296_length_1159_cov_147.794340	964	1044	250	1	80	0.0125000
NODE_4296_length_1159_cov_147.794340	964	1044	268	3	80	0.0375000
NODE_4296_length_1159_cov_147.794340	964	1044	270	1	80	0.0125000
NODE_4296_length_1159_cov_147.794340	964	1044	272	1	80	0.0125000
NODE_4296_length_1159_cov_147.794340	964	1044	275	1	80	0.0125000
NODE_4296_length_1159_cov_147.794340	964	1044	276	1	80	0.0125000
NODE_4296_length_1159_cov_147.794340	964	1044	277	1	80	0.0125000
NODE_4296_length_1159_cov_147.794340	964	1044	279	2	80	0.0250000
NODE_4296_length_1159_cov_147.794340	964	1044	281	1	80	0.0125000
NODE_4296_length_1159_cov_147.794340	964	1044	288	1	80	0.0125000
NODE_4296_length_1159_cov_147.794340	964	1044	290	1	80	0.0125000
NODE_4296_length_1159_cov_147.794340	964	1044	292	1	80	0.0125000
NODE_4296_length_1159_cov_147.794340	964	1044	294	1	80	0.0125000
NODE_4296_length_1159_cov_147.794340	964	1044	295	2	80	0.0250000
NODE_4296_length_1159_cov_147.794340	964	1044	297	1	80	0.0125000
NODE_4296_length_1159_cov_147.794340	964	1044	301	1	80	0.0125000
NODE_4296_length_1159_cov_147.794340	964	1044	304	1	80	0.0125000
NODE_4296_length_1159_cov_147.794340	964	1044	313	1	80	0.0125000
NODE_4296_length_1159_cov_147.794340	964	1044	317	1	80	0.0125000
NODE_4296_length_1159_cov_147.794340	964	1044	319	1	80	0.0125000
NODE_4296_length_1159_cov_147.794340	964	1044	321	1	80	0.0125000
NODE_4296_length_1159_cov_147.794340	964	1044	323	2	80	0.0250000
NODE_4296_length_1159_cov_147.794340	964	1044	324	1	80	0.0125000
NODE_4296_length_1159_cov_147.794340	964	1044	325	1	80	0.0125000
NODE_4296_length_1159_cov_147.794340	964	1044	327	1	80	0.0125000
NODE_4296_length_1159_cov_147.794340	964	1044	331	2	80	0.0250000
NODE_4297_length_1159_cov_57.566981	457	537	0	32	80	0.4000000
NODE_4297_length_1159_cov_57.566981	457	537	2	48	80	0.6000000
NODE_4297_length_1159_cov_57.566981	510	590	0	23	80	0.2875000
NODE_4297_length_1159_cov_57.566981	510	590	2	57	80	0.7125000
NODE_4297_length_1159_cov_57.566981	586	666	0	6	80	0.0750000
NODE_4297_length_1159_cov_57.566981	586	666	2	48	80	0.6000000
NODE_4297_length_1159_cov_57.566981	586	666	6	12	80	0.1500000
NODE_4297_length_1159_cov_57.566981	586	666	8	14	80	0.1750000
NODE_4297_length_1159_cov_57.566981	639	719	2	1	80	0.0125000
NODE_4297_length_1159_cov_57.566981	639	719	4	3	80	0.0375000
NODE_4297_length_1159_cov_57.566981	639	719	6	46	80	0.5750000
NODE_4297_length_1159_cov_57.566981	639	719	8	30	80	0.3750000
NODE_4298_length_1159_cov_44.053774	329	409	0	80	80	1.0000000
NODE_4298_length_1159_cov_44.053774	382	462	0	80	80	1.0000000
NODE_4298_length_1159_cov_44.053774	458	538	0	78	80	0.9750000
NODE_4298_length_1159_cov_44.053774	458	538	2	2	80	0.0250000
NODE_4298_length_1159_cov_44.053774	511	591	0	25	80	0.3125000
NODE_4298_length_1159_cov_44.053774	511	591	2	55	80	0.6875000
NODE_4299_length_1159_cov_40.194340	391	471	0	38	80	0.4750000
NODE_4299_length_1159_cov_40.194340	391	471	2	16	80	0.2000000
NODE_4299_length_1159_cov_40.194340	391	471	4	26	80	0.3250000
NODE_4299_length_1159_cov_40.194340	444	524	2	1	80	0.0125000
NODE_4299_length_1159_cov_40.194340	444	524	4	79	80	0.9875000
NODE_4301_length_1159_cov_25.919811	456	536	0	23	80	0.2875000
NODE_4301_length_1159_cov_25.919811	456	536	2	3	80	0.0375000
NODE_4301_length_1159_cov_25.919811	456	536	4	43	80	0.5375000
NODE_4301_length_1159_cov_25.919811	456	536	6	4	80	0.0500000
NODE_4301_length_1159_cov_25.919811	456	536	8	7	80	0.0875000
NODE_4301_length_1159_cov_25.919811	509	591	4	53	82	0.6463414
NODE_4301_length_1159_cov_25.919811	509	591	6	8	82	0.0975610
NODE_4301_length_1159_cov_25.919811	509	591	8	21	82	0.2560976
NODE_4302_length_1159_cov_18.306604	538	618	0	80	80	1.0000000
NODE_4302_length_1159_cov_18.306604	591	671	0	80	80	1.0000000
NODE_4303_length_1159_cov_14.457547	358	438	0	70	80	0.8750000
NODE_4303_length_1159_cov_14.457547	358	438	2	8	80	0.1000000
NODE_4303_length_1159_cov_14.457547	358	438	4	2	80	0.0250000
NODE_4303_length_1159_cov_14.457547	411	491	0	17	80	0.2125000
NODE_4303_length_1159_cov_14.457547	411	491	2	8	80	0.1000000
NODE_4303_length_1159_cov_14.457547	411	491	4	55	80	0.6875000
NODE_4304_length_1159_cov_11.566981	625	705	0	17	80	0.2125000
NODE_4304_length_1159_cov_11.566981	625	705	2	63	80	0.7875000
NODE_4304_length_1159_cov_11.566981	678	758	0	45	80	0.5625000
NODE_4304_length_1159_cov_11.566981	678	758	2	35	80	0.4375000
NODE_4305_length_1159_cov_9.927358	278	358	0	80	80	1.0000000
NODE_4305_length_1159_cov_9.927358	331	411	0	80	80	1.0000000
NODE_4314_length_1159_cov_1.568868	513	562	8	7	49	0.1428571
NODE_4314_length_1159_cov_1.568868	513	562	10	11	49	0.2244898
NODE_4314_length_1159_cov_1.568868	513	562	12	1	49	0.0204082
NODE_4314_length_1159_cov_1.568868	513	562	14	30	49	0.6122449
NODE_4316_length_1158_cov_33.529745	357	437	0	38	80	0.4750000
NODE_4316_length_1158_cov_33.529745	357	437	2	42	80	0.5250000
NODE_4316_length_1158_cov_33.529745	410	490	0	25	80	0.3125000
NODE_4316_length_1158_cov_33.529745	410	490	2	55	80	0.6875000
NODE_4316_length_1158_cov_33.529745	486	566	0	60	80	0.7500000
NODE_4316_length_1158_cov_33.529745	486	566	2	20	80	0.2500000
NODE_4316_length_1158_cov_33.529745	539	619	0	7	80	0.0875000
NODE_4316_length_1158_cov_33.529745	539	619	2	73	80	0.9125000
NODE_4317_length_1158_cov_31.368272	416	496	2	33	80	0.4125000
NODE_4317_length_1158_cov_31.368272	416	496	4	47	80	0.5875000
NODE_4317_length_1158_cov_31.368272	469	549	0	18	80	0.2250000
NODE_4317_length_1158_cov_31.368272	469	549	1	1	80	0.0125000
NODE_4317_length_1158_cov_31.368272	469	549	2	39	80	0.4875000
NODE_4317_length_1158_cov_31.368272	469	549	4	22	80	0.2750000
NODE_4317_length_1158_cov_31.368272	545	626	0	6	81	0.0740741
NODE_4317_length_1158_cov_31.368272	545	626	2	75	81	0.9259259
NODE_4317_length_1158_cov_31.368272	599	679	0	31	80	0.3875000
NODE_4317_length_1158_cov_31.368272	599	679	2	49	80	0.6125000
NODE_4318_length_1158_cov_31.240793	430	510	0	80	80	1.0000000
NODE_4318_length_1158_cov_31.240793	483	563	0	30	80	0.3750000
NODE_4318_length_1158_cov_31.240793	483	563	2	4	80	0.0500000
NODE_4318_length_1158_cov_31.240793	483	563	4	2	80	0.0250000
NODE_4318_length_1158_cov_31.240793	483	563	6	34	80	0.4250000
NODE_4318_length_1158_cov_31.240793	483	563	8	10	80	0.1250000
NODE_4318_length_1158_cov_31.240793	559	639	4	10	80	0.1250000
NODE_4318_length_1158_cov_31.240793	559	639	6	17	80	0.2125000
NODE_4318_length_1158_cov_31.240793	559	639	8	53	80	0.6625000
NODE_4318_length_1158_cov_31.240793	612	692	0	32	80	0.4000000
NODE_4318_length_1158_cov_31.240793	612	692	2	8	80	0.1000000
NODE_4318_length_1158_cov_31.240793	612	692	4	23	80	0.2875000
NODE_4318_length_1158_cov_31.240793	612	692	6	17	80	0.2125000
NODE_4319_length_1158_cov_29.216242	405	485	0	80	80	1.0000000
NODE_4319_length_1158_cov_29.216242	458	538	0	80	80	1.0000000
NODE_4320_length_1158_cov_25.245515	500	580	0	80	80	1.0000000
NODE_4320_length_1158_cov_25.245515	553	633	0	80	80	1.0000000
NODE_4320_length_1158_cov_25.245515	629	709	0	7	80	0.0875000
NODE_4320_length_1158_cov_25.245515	629	709	2	21	80	0.2625000
NODE_4320_length_1158_cov_25.245515	629	709	4	29	80	0.3625000
NODE_4320_length_1158_cov_25.245515	629	709	6	23	80	0.2875000
NODE_4320_length_1158_cov_25.245515	682	762	2	5	80	0.0625000
NODE_4320_length_1158_cov_25.245515	682	762	4	24	80	0.3000000
NODE_4320_length_1158_cov_25.245515	682	762	6	34	80	0.4250000
NODE_4320_length_1158_cov_25.245515	682	762	8	17	80	0.2125000
NODE_4321_length_1158_cov_16.566572	396	476	0	47	80	0.5875000
NODE_4321_length_1158_cov_16.566572	396	476	2	33	80	0.4125000
NODE_4321_length_1158_cov_16.566572	449	529	0	6	80	0.0750000
NODE_4321_length_1158_cov_16.566572	449	529	2	74	80	0.9250000
NODE_4322_length_1158_cov_13.092540	372	452	0	80	80	1.0000000
NODE_4322_length_1158_cov_13.092540	425	505	0	60	80	0.7500000
NODE_4322_length_1158_cov_13.092540	425	505	2	20	80	0.2500000
NODE_4322_length_1158_cov_13.092540	735	815	0	80	80	1.0000000
NODE_4322_length_1158_cov_13.092540	788	868	0	80	80	1.0000000
NODE_4323_length_1158_cov_7.408876	656	736	0	2	80	0.0250000
NODE_4323_length_1158_cov_7.408876	656	736	2	78	80	0.9750000
NODE_4323_length_1158_cov_7.408876	709	789	0	39	80	0.4875000
NODE_4323_length_1158_cov_7.408876	709	789	1	7	80	0.0875000
NODE_4323_length_1158_cov_7.408876	709	789	2	34	80	0.4250000
NODE_4324_length_1158_cov_6.242682	239	310	0	71	71	1.0000000
NODE_4325_length_1158_cov_6.043437	531	611	0	12	80	0.1500000
NODE_4325_length_1158_cov_6.043437	531	611	2	68	80	0.8500000
NODE_4325_length_1158_cov_6.043437	584	634	2	50	50	1.0000000
NODE_4326_length_1158_cov_5.855524	324	404	0	80	80	1.0000000
NODE_4326_length_1158_cov_5.855524	377	457	0	80	80	1.0000000
NODE_4329_length_1157_cov_32.233459	472	552	2	15	80	0.1875000
NODE_4329_length_1157_cov_32.233459	472	552	4	60	80	0.7500000
NODE_4329_length_1157_cov_32.233459	472	552	6	5	80	0.0625000
NODE_4329_length_1157_cov_32.233459	525	605	0	2	80	0.0250000
NODE_4329_length_1157_cov_32.233459	525	605	2	66	80	0.8250000
NODE_4329_length_1157_cov_32.233459	525	605	4	12	80	0.1500000
NODE_4329_length_1157_cov_32.233459	601	681	0	59	80	0.7375000
NODE_4329_length_1157_cov_32.233459	601	681	2	21	80	0.2625000
NODE_4329_length_1157_cov_32.233459	654	734	0	8	80	0.1000000
NODE_4329_length_1157_cov_32.233459	654	734	2	72	80	0.9000000
NODE_4330_length_1157_cov_6.438563	765	788	0	23	23	1.0000000
NODE_4332_length_1157_cov_4.068053	221	292	0	71	71	1.0000000
NODE_4333_length_1156_cov_46.381268	328	408	0	80	80	1.0000000
NODE_4333_length_1156_cov_46.381268	381	461	0	80	80	1.0000000
NODE_4333_length_1156_cov_46.381268	457	537	0	36	80	0.4500000
NODE_4333_length_1156_cov_46.381268	457	537	2	5	80	0.0625000
NODE_4333_length_1156_cov_46.381268	457	537	4	35	80	0.4375000
NODE_4333_length_1156_cov_46.381268	457	537	5	4	80	0.0500000
NODE_4333_length_1156_cov_46.381268	510	590	4	26	80	0.3250000
NODE_4333_length_1156_cov_46.381268	510	590	5	10	80	0.1250000
NODE_4333_length_1156_cov_46.381268	510	590	6	44	80	0.5500000
NODE_4334_length_1156_cov_32.198675	378	458	2	7	80	0.0875000
NODE_4334_length_1156_cov_32.198675	378	458	4	48	80	0.6000000
NODE_4334_length_1156_cov_32.198675	378	458	6	25	80	0.3125000
NODE_4334_length_1156_cov_32.198675	431	511	2	14	80	0.1750000
NODE_4334_length_1156_cov_32.198675	431	511	4	35	80	0.4375000
NODE_4334_length_1156_cov_32.198675	431	511	6	31	80	0.3875000
NODE_4334_length_1156_cov_32.198675	507	587	0	11	80	0.1375000
NODE_4334_length_1156_cov_32.198675	507	587	2	69	80	0.8625000
NODE_4334_length_1156_cov_32.198675	560	641	2	66	81	0.8148148
NODE_4334_length_1156_cov_32.198675	560	641	4	15	81	0.1851852
NODE_4335_length_1156_cov_12.683065	593	673	0	34	80	0.4250000
NODE_4335_length_1156_cov_12.683065	593	673	2	46	80	0.5750000
NODE_4335_length_1156_cov_12.683065	646	726	0	25	80	0.3125000
NODE_4335_length_1156_cov_12.683065	646	726	2	55	80	0.6875000
NODE_4336_length_1156_cov_9.287606	680	760	0	30	80	0.3750000
NODE_4336_length_1156_cov_9.287606	680	760	2	50	80	0.6250000
NODE_4336_length_1156_cov_9.287606	733	813	0	80	80	1.0000000
NODE_4339_length_1155_cov_19.570076	437	517	0	80	80	1.0000000
NODE_4339_length_1155_cov_19.570076	490	570	0	80	80	1.0000000
NODE_4340_length_1155_cov_18.666667	332	412	0	3	80	0.0375000
NODE_4340_length_1155_cov_18.666667	332	412	2	77	80	0.9625000
NODE_4340_length_1155_cov_18.666667	385	465	0	56	80	0.7000000
NODE_4340_length_1155_cov_18.666667	385	465	2	24	80	0.3000000
NODE_4346_length_1154_cov_61.769668	488	568	0	80	80	1.0000000
NODE_4346_length_1154_cov_61.769668	541	621	0	80	80	1.0000000
NODE_4347_length_1154_cov_50.909005	409	489	0	38	80	0.4750000
NODE_4347_length_1154_cov_50.909005	409	489	2	42	80	0.5250000
NODE_4347_length_1154_cov_50.909005	462	542	0	80	80	1.0000000
NODE_4347_length_1154_cov_50.909005	538	618	0	48	80	0.6000000
NODE_4347_length_1154_cov_50.909005	538	618	2	32	80	0.4000000
NODE_4347_length_1154_cov_50.909005	591	671	0	16	80	0.2000000
NODE_4347_length_1154_cov_50.909005	591	671	2	64	80	0.8000000
NODE_4348_length_1154_cov_28.941232	695	775	0	80	80	1.0000000
NODE_4348_length_1154_cov_28.941232	748	828	0	80	80	1.0000000
NODE_4349_length_1154_cov_13.765877	322	402	0	16	80	0.2000000
NODE_4349_length_1154_cov_13.765877	322	402	2	7	80	0.0875000
NODE_4349_length_1154_cov_13.765877	322	402	4	57	80	0.7125000
NODE_4349_length_1154_cov_13.765877	375	455	1	21	80	0.2625000
NODE_4349_length_1154_cov_13.765877	375	455	3	18	80	0.2250000
NODE_4349_length_1154_cov_13.765877	375	455	4	31	80	0.3875000
NODE_4349_length_1154_cov_13.765877	375	455	5	10	80	0.1250000
NODE_4351_length_1154_cov_5.930806	497	577	0	80	80	1.0000000
NODE_4351_length_1154_cov_5.930806	550	622	0	72	72	1.0000000
NODE_4357_length_1153_cov_65.486717	416	496	2	3	80	0.0375000
NODE_4357_length_1153_cov_65.486717	416	496	4	69	80	0.8625000
NODE_4357_length_1153_cov_65.486717	416	496	6	8	80	0.1000000
NODE_4357_length_1153_cov_65.486717	469	549	2	56	80	0.7000000
NODE_4357_length_1153_cov_65.486717	469	549	4	24	80	0.3000000
NODE_4357_length_1153_cov_65.486717	545	625	2	72	80	0.9000000
NODE_4357_length_1153_cov_65.486717	545	625	4	8	80	0.1000000
NODE_4357_length_1153_cov_65.486717	598	678	0	41	80	0.5125000
NODE_4357_length_1153_cov_65.486717	598	678	2	39	80	0.4875000
NODE_4358_length_1153_cov_50.733397	404	484	0	2	80	0.0250000
NODE_4358_length_1153_cov_50.733397	404	484	2	69	80	0.8625000
NODE_4358_length_1153_cov_50.733397	404	484	4	8	80	0.1000000
NODE_4358_length_1153_cov_50.733397	404	484	6	1	80	0.0125000
NODE_4358_length_1153_cov_50.733397	457	537	0	55	80	0.6875000
NODE_4358_length_1153_cov_50.733397	457	537	2	25	80	0.3125000
NODE_4358_length_1153_cov_50.733397	533	613	0	39	80	0.4875000
NODE_4358_length_1153_cov_50.733397	533	613	2	41	80	0.5125000
NODE_4358_length_1153_cov_50.733397	586	666	2	80	80	1.0000000
NODE_4359_length_1153_cov_26.131879	493	573	0	22	80	0.2750000
NODE_4359_length_1153_cov_26.131879	493	573	2	58	80	0.7250000
NODE_4359_length_1153_cov_26.131879	546	626	0	75	80	0.9375000
NODE_4359_length_1153_cov_26.131879	546	626	2	5	80	0.0625000
NODE_4360_length_1153_cov_10.195446	500	580	0	80	80	1.0000000
NODE_4360_length_1153_cov_10.195446	553	633	0	80	80	1.0000000
NODE_4361_length_1153_cov_8.286528	558	638	0	80	80	1.0000000
NODE_4361_length_1153_cov_8.286528	611	691	0	52	80	0.6500000
NODE_4361_length_1153_cov_8.286528	611	691	2	28	80	0.3500000
NODE_4368_length_1152_cov_19.800570	553	633	0	4	80	0.0500000
NODE_4368_length_1152_cov_19.800570	553	633	2	76	80	0.9500000
NODE_4368_length_1152_cov_19.800570	606	686	0	57	80	0.7125000
NODE_4368_length_1152_cov_19.800570	606	686	2	23	80	0.2875000
NODE_4369_length_1152_cov_19.365622	490	570	2	80	80	1.0000000
NODE_4369_length_1152_cov_19.365622	543	623	0	27	80	0.3375000
NODE_4369_length_1152_cov_19.365622	543	623	2	53	80	0.6625000
NODE_4370_length_1152_cov_18.654321	594	674	0	80	80	1.0000000
NODE_4370_length_1152_cov_18.654321	647	727	0	80	80	1.0000000
NODE_4371_length_1152_cov_18.075024	377	457	4	18	80	0.2250000
NODE_4371_length_1152_cov_18.075024	377	457	6	13	80	0.1625000
NODE_4371_length_1152_cov_18.075024	377	457	8	4	80	0.0500000
NODE_4371_length_1152_cov_18.075024	377	457	10	16	80	0.2000000
NODE_4371_length_1152_cov_18.075024	377	457	12	3	80	0.0375000
NODE_4371_length_1152_cov_18.075024	377	457	14	26	80	0.3250000
NODE_4371_length_1152_cov_18.075024	430	510	4	4	80	0.0500000
NODE_4371_length_1152_cov_18.075024	430	510	8	14	80	0.1750000
NODE_4371_length_1152_cov_18.075024	430	510	10	4	80	0.0500000
NODE_4371_length_1152_cov_18.075024	430	510	12	17	80	0.2125000
NODE_4371_length_1152_cov_18.075024	430	510	14	41	80	0.5125000
NODE_4371_length_1152_cov_18.075024	506	586	0	66	80	0.8250000
NODE_4371_length_1152_cov_18.075024	506	586	2	4	80	0.0500000
NODE_4371_length_1152_cov_18.075024	506	586	4	10	80	0.1250000
NODE_4371_length_1152_cov_18.075024	559	639	0	80	80	1.0000000
NODE_4373_length_1152_cov_16.047483	543	623	0	80	80	1.0000000
NODE_4373_length_1152_cov_16.047483	596	676	0	80	80	1.0000000
NODE_4373_length_1152_cov_16.047483	672	752	0	80	80	1.0000000
NODE_4373_length_1152_cov_16.047483	725	805	0	80	80	1.0000000
NODE_4374_length_1152_cov_13.981007	583	663	0	80	80	1.0000000
NODE_4374_length_1152_cov_13.981007	636	716	0	80	80	1.0000000
NODE_4380_length_1151_cov_30.469582	479	559	0	44	80	0.5500000
NODE_4380_length_1151_cov_30.469582	479	559	4	36	80	0.4500000
NODE_4380_length_1151_cov_30.469582	532	612	4	80	80	1.0000000
NODE_4381_length_1151_cov_26.650190	567	647	0	80	80	1.0000000
NODE_4381_length_1151_cov_26.650190	620	700	0	80	80	1.0000000
NODE_4382_length_1151_cov_26.375475	441	521	0	80	80	1.0000000
NODE_4382_length_1151_cov_26.375475	494	574	0	80	80	1.0000000
NODE_4382_length_1151_cov_26.375475	570	650	0	80	80	1.0000000
NODE_4382_length_1151_cov_26.375475	623	703	0	80	80	1.0000000
NODE_4383_length_1151_cov_23.614068	590	670	0	40	80	0.5000000
NODE_4383_length_1151_cov_23.614068	590	670	2	40	80	0.5000000
NODE_4383_length_1151_cov_23.614068	643	721	0	78	78	1.0000000
NODE_4384_length_1151_cov_18.693916	355	435	0	30	80	0.3750000
NODE_4384_length_1151_cov_18.693916	355	435	6	50	80	0.6250000
NODE_4384_length_1151_cov_18.693916	408	491	0	83	83	1.0000000
NODE_4385_length_1151_cov_16.093156	474	554	0	80	80	1.0000000
NODE_4385_length_1151_cov_16.093156	527	607	0	80	80	1.0000000
NODE_4386_length_1151_cov_13.782319	400	482	0	82	82	1.0000000
NODE_4386_length_1151_cov_13.782319	450	535	0	50	85	0.5882353
NODE_4386_length_1151_cov_13.782319	450	535	2	35	85	0.4117647
NODE_4392_length_1150_cov_38.601332	563	643	0	80	80	1.0000000
NODE_4392_length_1150_cov_38.601332	616	696	0	80	80	1.0000000
NODE_4392_length_1150_cov_38.601332	692	772	0	80	80	1.0000000
NODE_4392_length_1150_cov_38.601332	745	825	0	80	80	1.0000000
NODE_4393_length_1150_cov_15.741199	497	578	0	60	81	0.7407407
NODE_4393_length_1150_cov_15.741199	497	578	2	5	81	0.0617284
NODE_4393_length_1150_cov_15.741199	497	578	4	16	81	0.1975309
NODE_4393_length_1150_cov_15.741199	550	631	0	7	81	0.0864198
NODE_4393_length_1150_cov_15.741199	550	631	2	5	81	0.0617284
NODE_4393_length_1150_cov_15.741199	550	631	4	69	81	0.8518519
NODE_4394_length_1150_cov_11.132255	795	875	0	23	80	0.2875000
NODE_4394_length_1150_cov_11.132255	795	875	2	17	80	0.2125000
NODE_4394_length_1150_cov_11.132255	795	875	4	40	80	0.5000000
NODE_4394_length_1150_cov_11.132255	848	928	2	11	80	0.1375000
NODE_4394_length_1150_cov_11.132255	848	928	4	45	80	0.5625000
NODE_4394_length_1150_cov_11.132255	848	928	6	24	80	0.3000000
NODE_4395_length_1150_cov_9.253092	583	663	0	80	80	1.0000000
NODE_4395_length_1150_cov_9.253092	636	716	0	80	80	1.0000000
NODE_4398_length_1149_cov_17.289524	644	695	0	51	51	1.0000000
NODE_4399_length_1149_cov_13.805714	584	664	0	22	80	0.2750000
NODE_4399_length_1149_cov_13.805714	584	664	2	58	80	0.7250000
NODE_4399_length_1149_cov_13.805714	637	717	2	43	80	0.5375000
NODE_4399_length_1149_cov_13.805714	637	717	4	37	80	0.4625000
NODE_4399_length_1149_cov_13.805714	713	793	2	57	80	0.7125000
NODE_4399_length_1149_cov_13.805714	713	793	4	23	80	0.2875000
NODE_4399_length_1149_cov_13.805714	766	846	0	7	80	0.0875000
NODE_4399_length_1149_cov_13.805714	766	846	2	60	80	0.7500000
NODE_4399_length_1149_cov_13.805714	766	846	4	13	80	0.1625000
NODE_4407_length_1148_cov_27.674929	387	467	0	80	80	1.0000000
NODE_4407_length_1148_cov_27.674929	440	520	0	80	80	1.0000000
NODE_4408_length_1148_cov_13.275500	136	216	0	2	80	0.0250000
NODE_4408_length_1148_cov_13.275500	136	216	4	76	80	0.9500000
NODE_4408_length_1148_cov_13.275500	136	216	6	2	80	0.0250000
NODE_4408_length_1148_cov_13.275500	189	268	4	25	79	0.3164557
NODE_4408_length_1148_cov_13.275500	189	268	6	25	79	0.3164557
NODE_4408_length_1148_cov_13.275500	189	268	8	16	79	0.2025317
NODE_4408_length_1148_cov_13.275500	189	268	10	13	79	0.1645570
NODE_4409_length_1148_cov_10.613918	506	586	0	80	80	1.0000000
NODE_4409_length_1148_cov_10.613918	559	639	0	80	80	1.0000000
NODE_4415_length_1147_cov_33.543893	378	458	0	40	80	0.5000000
NODE_4415_length_1147_cov_33.543893	378	458	2	16	80	0.2000000
NODE_4415_length_1147_cov_33.543893	378	458	4	23	80	0.2875000
NODE_4415_length_1147_cov_33.543893	378	458	6	1	80	0.0125000
NODE_4415_length_1147_cov_33.543893	431	511	2	3	80	0.0375000
NODE_4415_length_1147_cov_33.543893	431	511	4	29	80	0.3625000
NODE_4415_length_1147_cov_33.543893	431	511	6	48	80	0.6000000
NODE_4416_length_1147_cov_26.858779	254	334	0	80	80	1.0000000
NODE_4416_length_1147_cov_26.858779	307	387	0	80	80	1.0000000
NODE_4416_length_1147_cov_26.858779	383	463	0	80	80	1.0000000
NODE_4416_length_1147_cov_26.858779	436	516	0	80	80	1.0000000
NODE_4417_length_1147_cov_24.227099	606	686	0	80	80	1.0000000
NODE_4417_length_1147_cov_24.227099	659	739	0	80	80	1.0000000
NODE_4417_length_1147_cov_24.227099	735	815	0	80	80	1.0000000
NODE_4417_length_1147_cov_24.227099	788	868	0	80	80	1.0000000
NODE_4418_length_1147_cov_16.559160	417	497	0	80	80	1.0000000
NODE_4418_length_1147_cov_16.559160	470	550	0	80	80	1.0000000
NODE_4428_length_1146_cov_52.393505	411	491	0	80	80	1.0000000
NODE_4428_length_1146_cov_52.393505	464	544	0	80	80	1.0000000
NODE_4428_length_1146_cov_52.393505	540	620	0	14	80	0.1750000
NODE_4428_length_1146_cov_52.393505	540	620	2	66	80	0.8250000
NODE_4428_length_1146_cov_52.393505	593	673	0	63	80	0.7875000
NODE_4428_length_1146_cov_52.393505	593	673	2	17	80	0.2125000
NODE_4429_length_1146_cov_46.364852	233	313	0	28	80	0.3500000
NODE_4429_length_1146_cov_46.364852	233	313	4	52	80	0.6500000
NODE_4429_length_1146_cov_46.364852	286	366	0	28	80	0.3500000
NODE_4429_length_1146_cov_46.364852	286	366	4	52	80	0.6500000
NODE_4430_length_1146_cov_26.159503	476	556	2	33	80	0.4125000
NODE_4430_length_1146_cov_26.159503	476	556	4	47	80	0.5875000
NODE_4430_length_1146_cov_26.159503	529	609	0	21	80	0.2625000
NODE_4430_length_1146_cov_26.159503	529	609	2	46	80	0.5750000
NODE_4430_length_1146_cov_26.159503	529	609	4	13	80	0.1625000
NODE_4430_length_1146_cov_26.159503	605	685	2	80	80	1.0000000
NODE_4430_length_1146_cov_26.159503	658	738	0	38	80	0.4750000
NODE_4430_length_1146_cov_26.159503	658	738	2	42	80	0.5250000
NODE_4431_length_1146_cov_14.210124	343	423	0	80	80	1.0000000
NODE_4431_length_1146_cov_14.210124	396	476	0	80	80	1.0000000
NODE_4432_length_1146_cov_13.479465	425	501	0	76	76	1.0000000
NODE_4432_length_1146_cov_13.479465	505	565	0	60	60	1.0000000
NODE_4432_length_1146_cov_13.479465	561	641	0	80	80	1.0000000
NODE_4432_length_1146_cov_13.479465	614	694	0	80	80	1.0000000
NODE_4438_length_1145_cov_49.566922	395	470	0	27	75	0.3600000
NODE_4438_length_1145_cov_49.566922	395	470	2	48	75	0.6400000
NODE_4438_length_1145_cov_49.566922	443	523	0	6	80	0.0750000
NODE_4438_length_1145_cov_49.566922	443	523	2	74	80	0.9250000
NODE_4439_length_1145_cov_38.191205	497	576	0	73	79	0.9240506
NODE_4439_length_1145_cov_38.191205	497	576	2	6	79	0.0759494
NODE_4439_length_1145_cov_38.191205	549	629	0	21	80	0.2625000
NODE_4439_length_1145_cov_38.191205	549	629	2	59	80	0.7375000
NODE_4440_length_1145_cov_26.929254	468	548	0	80	80	1.0000000
NODE_4440_length_1145_cov_26.929254	521	601	0	80	80	1.0000000
NODE_4441_length_1145_cov_20.121415	508	588	0	67	80	0.8375000
NODE_4441_length_1145_cov_20.121415	508	588	4	13	80	0.1625000
NODE_4441_length_1145_cov_20.121415	561	641	0	33	80	0.4125000
NODE_4441_length_1145_cov_20.121415	561	641	4	47	80	0.5875000
NODE_4442_length_1145_cov_11.753346	527	605	0	78	78	1.0000000
NODE_4442_length_1145_cov_11.753346	578	659	0	81	81	1.0000000
NODE_4443_length_1145_cov_9.571702	93	173	0	80	80	1.0000000
NODE_4443_length_1145_cov_9.571702	146	226	0	80	80	1.0000000
NODE_4455_length_1143_cov_42.255747	380	460	0	80	80	1.0000000
NODE_4455_length_1143_cov_42.255747	433	513	0	60	80	0.7500000
NODE_4455_length_1143_cov_42.255747	433	513	2	20	80	0.2500000
NODE_4455_length_1143_cov_42.255747	509	589	2	24	80	0.3000000
NODE_4455_length_1143_cov_42.255747	509	589	3	10	80	0.1250000
NODE_4455_length_1143_cov_42.255747	509	589	4	46	80	0.5750000
NODE_4455_length_1143_cov_42.255747	562	642	2	55	80	0.6875000
NODE_4455_length_1143_cov_42.255747	562	642	4	25	80	0.3125000
NODE_4456_length_1143_cov_22.076628	526	606	0	3	80	0.0375000
NODE_4456_length_1143_cov_22.076628	526	606	2	75	80	0.9375000
NODE_4456_length_1143_cov_22.076628	526	606	4	2	80	0.0250000
NODE_4456_length_1143_cov_22.076628	579	659	0	56	80	0.7000000
NODE_4456_length_1143_cov_22.076628	579	659	2	24	80	0.3000000
NODE_4457_length_1143_cov_19.106322	565	645	0	16	80	0.2000000
NODE_4457_length_1143_cov_19.106322	565	645	4	19	80	0.2375000
NODE_4457_length_1143_cov_19.106322	565	645	6	45	80	0.5625000
NODE_4457_length_1143_cov_19.106322	618	698	2	19	80	0.2375000
NODE_4457_length_1143_cov_19.106322	618	698	4	15	80	0.1875000
NODE_4457_length_1143_cov_19.106322	618	698	5	1	80	0.0125000
NODE_4457_length_1143_cov_19.106322	618	698	6	45	80	0.5625000
NODE_4458_length_1143_cov_16.223180	638	719	2	56	81	0.6913580
NODE_4458_length_1143_cov_16.223180	638	719	4	25	81	0.3086420
NODE_4458_length_1143_cov_16.223180	692	772	0	4	80	0.0500000
NODE_4458_length_1143_cov_16.223180	692	772	2	76	80	0.9500000
NODE_4459_length_1143_cov_13.961686	634	714	4	10	80	0.1250000
NODE_4459_length_1143_cov_13.961686	634	714	6	46	80	0.5750000
NODE_4459_length_1143_cov_13.961686	634	714	8	22	80	0.2750000
NODE_4459_length_1143_cov_13.961686	634	714	10	2	80	0.0250000
NODE_4459_length_1143_cov_13.961686	687	767	4	38	80	0.4750000
NODE_4459_length_1143_cov_13.961686	687	767	5	8	80	0.1000000
NODE_4459_length_1143_cov_13.961686	687	767	6	28	80	0.3500000
NODE_4459_length_1143_cov_13.961686	687	767	8	6	80	0.0750000
NODE_4459_length_1143_cov_13.961686	763	843	0	57	80	0.7125000
NODE_4459_length_1143_cov_13.961686	763	843	2	10	80	0.1250000
NODE_4459_length_1143_cov_13.961686	763	843	4	13	80	0.1625000
NODE_4459_length_1143_cov_13.961686	816	896	0	61	80	0.7625000
NODE_4459_length_1143_cov_13.961686	816	896	4	19	80	0.2375000
NODE_4460_length_1143_cov_12.782567	328	409	0	29	81	0.3580247
NODE_4460_length_1143_cov_12.782567	328	409	2	52	81	0.6419753
NODE_4460_length_1143_cov_12.782567	381	462	0	81	81	1.0000000
NODE_4460_length_1143_cov_12.782567	458	538	0	80	80	1.0000000
NODE_4460_length_1143_cov_12.782567	511	591	0	80	80	1.0000000
NODE_4461_length_1143_cov_8.287356	692	772	0	80	80	1.0000000
NODE_4461_length_1143_cov_8.287356	745	825	0	80	80	1.0000000
NODE_4463_length_1143_cov_2.197318	988	1057	6	22	69	0.3188406
NODE_4463_length_1143_cov_2.197318	988	1057	8	1	69	0.0144928
NODE_4463_length_1143_cov_2.197318	988	1057	14	16	69	0.2318841
NODE_4463_length_1143_cov_2.197318	988	1057	16	12	69	0.1739130
NODE_4463_length_1143_cov_2.197318	988	1057	18	18	69	0.2608696
NODE_4466_length_1142_cov_28.364334	613	693	0	35	80	0.4375000
NODE_4466_length_1142_cov_28.364334	613	693	2	1	80	0.0125000
NODE_4466_length_1142_cov_28.364334	613	693	4	15	80	0.1875000
NODE_4466_length_1142_cov_28.364334	613	693	6	9	80	0.1125000
NODE_4466_length_1142_cov_28.364334	613	693	8	20	80	0.2500000
NODE_4466_length_1142_cov_28.364334	666	746	6	35	80	0.4375000
NODE_4466_length_1142_cov_28.364334	666	746	8	45	80	0.5625000
NODE_4467_length_1142_cov_21.669223	518	598	3	71	80	0.8875000
NODE_4467_length_1142_cov_21.669223	518	598	4	1	80	0.0125000
NODE_4467_length_1142_cov_21.669223	518	598	6	8	80	0.1000000
NODE_4467_length_1142_cov_21.669223	571	651	2	10	80	0.1250000
NODE_4467_length_1142_cov_21.669223	571	651	3	18	80	0.2250000
NODE_4467_length_1142_cov_21.669223	571	651	4	11	80	0.1375000
NODE_4467_length_1142_cov_21.669223	571	651	5	15	80	0.1875000
NODE_4467_length_1142_cov_21.669223	571	651	6	26	80	0.3250000
NODE_4468_length_1142_cov_19.007670	411	491	2	53	80	0.6625000
NODE_4468_length_1142_cov_19.007670	411	491	6	27	80	0.3375000
NODE_4468_length_1142_cov_19.007670	464	544	4	31	80	0.3875000
NODE_4468_length_1142_cov_19.007670	464	544	5	22	80	0.2750000
NODE_4468_length_1142_cov_19.007670	464	544	6	27	80	0.3375000
NODE_4474_length_1141_cov_12.500960	17	97	2	19	80	0.2375000
NODE_4474_length_1141_cov_12.500960	17	97	4	34	80	0.4250000
NODE_4474_length_1141_cov_12.500960	17	97	5	1	80	0.0125000
NODE_4474_length_1141_cov_12.500960	17	97	6	26	80	0.3250000
NODE_4474_length_1141_cov_12.500960	17	97	2	19	80	0.2375000
NODE_4474_length_1141_cov_12.500960	17	97	4	34	80	0.4250000
NODE_4474_length_1141_cov_12.500960	17	97	5	1	80	0.0125000
NODE_4474_length_1141_cov_12.500960	17	97	6	26	80	0.3250000
NODE_4474_length_1141_cov_12.500960	17	97	2	19	80	0.2375000
NODE_4474_length_1141_cov_12.500960	17	97	4	34	80	0.4250000
NODE_4474_length_1141_cov_12.500960	17	97	5	1	80	0.0125000
NODE_4474_length_1141_cov_12.500960	17	97	6	26	80	0.3250000
NODE_4474_length_1141_cov_12.500960	17	97	2	19	80	0.2375000
NODE_4474_length_1141_cov_12.500960	17	97	4	34	80	0.4250000
NODE_4474_length_1141_cov_12.500960	17	97	5	1	80	0.0125000
NODE_4474_length_1141_cov_12.500960	17	97	6	26	80	0.3250000
NODE_4474_length_1141_cov_12.500960	70	132	0	1	62	0.0161290
NODE_4474_length_1141_cov_12.500960	70	132	2	15	62	0.2419355
NODE_4474_length_1141_cov_12.500960	70	132	4	3	62	0.0483871
NODE_4474_length_1141_cov_12.500960	70	132	5	1	62	0.0161290
NODE_4474_length_1141_cov_12.500960	70	132	6	42	62	0.6774194
NODE_4474_length_1141_cov_12.500960	70	132	0	1	62	0.0161290
NODE_4474_length_1141_cov_12.500960	70	132	2	15	62	0.2419355
NODE_4474_length_1141_cov_12.500960	70	132	4	3	62	0.0483871
NODE_4474_length_1141_cov_12.500960	70	132	5	1	62	0.0161290
NODE_4474_length_1141_cov_12.500960	70	132	6	42	62	0.6774194
NODE_4474_length_1141_cov_12.500960	70	132	0	1	62	0.0161290
NODE_4474_length_1141_cov_12.500960	70	132	2	15	62	0.2419355
NODE_4474_length_1141_cov_12.500960	70	132	4	3	62	0.0483871
NODE_4474_length_1141_cov_12.500960	70	132	5	1	62	0.0161290
NODE_4474_length_1141_cov_12.500960	70	132	6	42	62	0.6774194
NODE_4474_length_1141_cov_12.500960	70	132	0	1	62	0.0161290
NODE_4474_length_1141_cov_12.500960	70	132	2	15	62	0.2419355
NODE_4474_length_1141_cov_12.500960	70	132	4	3	62	0.0483871
NODE_4474_length_1141_cov_12.500960	70	132	5	1	62	0.0161290
NODE_4474_length_1141_cov_12.500960	70	132	6	42	62	0.6774194
NODE_4475_length_1141_cov_7.197697	54	134	0	80	80	1.0000000
NODE_4475_length_1141_cov_7.197697	107	187	0	80	80	1.0000000
NODE_4475_length_1141_cov_7.197697	573	653	0	13	80	0.1625000
NODE_4475_length_1141_cov_7.197697	573	653	2	67	80	0.8375000
NODE_4475_length_1141_cov_7.197697	626	707	0	12	81	0.1481481
NODE_4475_length_1141_cov_7.197697	626	707	2	69	81	0.8518519
NODE_4476_length_1141_cov_5.428023	411	491	0	79	80	0.9875000
NODE_4476_length_1141_cov_5.428023	411	491	2	1	80	0.0125000
NODE_4476_length_1141_cov_5.428023	464	544	0	26	80	0.3250000
NODE_4476_length_1141_cov_5.428023	464	544	2	54	80	0.6750000
NODE_4482_length_1140_cov_39.383285	451	531	2	2	80	0.0250000
NODE_4482_length_1140_cov_39.383285	451	531	4	14	80	0.1750000
NODE_4482_length_1140_cov_39.383285	451	531	6	64	80	0.8000000
NODE_4482_length_1140_cov_39.383285	504	584	0	23	80	0.2875000
NODE_4482_length_1140_cov_39.383285	504	584	2	16	80	0.2000000
NODE_4482_length_1140_cov_39.383285	504	584	4	15	80	0.1875000
NODE_4482_length_1140_cov_39.383285	504	584	6	26	80	0.3250000
NODE_4482_length_1140_cov_39.383285	580	660	0	80	80	1.0000000
NODE_4482_length_1140_cov_39.383285	633	713	0	80	80	1.0000000
NODE_4483_length_1140_cov_19.493756	543	623	0	14	80	0.1750000
NODE_4483_length_1140_cov_19.493756	543	623	2	66	80	0.8250000
NODE_4483_length_1140_cov_19.493756	596	676	0	23	80	0.2875000
NODE_4483_length_1140_cov_19.493756	596	676	2	57	80	0.7125000
NODE_4484_length_1140_cov_18.341018	347	427	0	80	80	1.0000000
NODE_4484_length_1140_cov_18.341018	400	480	0	80	80	1.0000000
NODE_4484_length_1140_cov_18.341018	476	556	0	80	80	1.0000000
NODE_4484_length_1140_cov_18.341018	529	609	0	39	80	0.4875000
NODE_4484_length_1140_cov_18.341018	529	609	2	41	80	0.5125000
NODE_4494_length_1139_cov_26.812500	410	490	0	16	80	0.2000000
NODE_4494_length_1139_cov_26.812500	410	490	2	64	80	0.8000000
NODE_4494_length_1139_cov_26.812500	463	543	0	67	80	0.8375000
NODE_4494_length_1139_cov_26.812500	463	543	2	13	80	0.1625000
NODE_4494_length_1139_cov_26.812500	539	619	0	34	80	0.4250000
NODE_4494_length_1139_cov_26.812500	539	619	2	46	80	0.5750000
NODE_4494_length_1139_cov_26.812500	592	672	2	80	80	1.0000000
NODE_4495_length_1139_cov_26.323077	308	388	0	18	80	0.2250000
NODE_4495_length_1139_cov_26.323077	308	388	2	16	80	0.2000000
NODE_4495_length_1139_cov_26.323077	308	388	4	46	80	0.5750000
NODE_4495_length_1139_cov_26.323077	361	441	2	2	80	0.0250000
NODE_4495_length_1139_cov_26.323077	361	441	4	36	80	0.4500000
NODE_4495_length_1139_cov_26.323077	361	441	6	42	80	0.5250000
NODE_4495_length_1139_cov_26.323077	437	517	2	72	80	0.9000000
NODE_4495_length_1139_cov_26.323077	437	517	4	8	80	0.1000000
NODE_4495_length_1139_cov_26.323077	490	570	2	76	80	0.9500000
NODE_4495_length_1139_cov_26.323077	490	570	4	4	80	0.0500000
NODE_4496_length_1139_cov_15.223077	530	610	0	80	80	1.0000000
NODE_4496_length_1139_cov_15.223077	583	663	0	56	80	0.7000000
NODE_4496_length_1139_cov_15.223077	583	663	2	24	80	0.3000000
NODE_4505_length_1138_cov_74.599615	480	560	2	46	80	0.5750000
NODE_4505_length_1138_cov_74.599615	480	560	4	34	80	0.4250000
NODE_4505_length_1138_cov_74.599615	533	613	0	15	80	0.1875000
NODE_4505_length_1138_cov_74.599615	533	613	2	65	80	0.8125000
NODE_4505_length_1138_cov_74.599615	609	689	0	44	80	0.5500000
NODE_4505_length_1138_cov_74.599615	609	689	2	36	80	0.4500000
NODE_4505_length_1138_cov_74.599615	662	742	2	80	80	1.0000000
NODE_4506_length_1138_cov_29.407122	559	639	0	80	80	1.0000000
NODE_4506_length_1138_cov_29.407122	612	692	0	80	80	1.0000000
NODE_4506_length_1138_cov_29.407122	688	768	0	24	80	0.3000000
NODE_4506_length_1138_cov_29.407122	688	768	2	56	80	0.7000000
NODE_4506_length_1138_cov_29.407122	741	821	0	4	80	0.0500000
NODE_4506_length_1138_cov_29.407122	741	821	2	76	80	0.9500000
NODE_4507_length_1138_cov_18.326275	454	534	0	1	80	0.0125000
NODE_4507_length_1138_cov_18.326275	454	534	2	34	80	0.4250000
NODE_4507_length_1138_cov_18.326275	454	534	4	45	80	0.5625000
NODE_4507_length_1138_cov_18.326275	507	587	0	26	80	0.3250000
NODE_4507_length_1138_cov_18.326275	507	587	2	38	80	0.4750000
NODE_4507_length_1138_cov_18.326275	507	587	4	16	80	0.2000000
NODE_4507_length_1138_cov_18.326275	583	663	0	80	80	1.0000000
NODE_4507_length_1138_cov_18.326275	636	716	0	80	80	1.0000000
NODE_4509_length_1138_cov_11.834456	291	371	0	80	80	1.0000000
NODE_4509_length_1138_cov_11.834456	344	424	0	80	80	1.0000000
NODE_4510_length_1138_cov_10.923003	318	398	0	36	80	0.4500000
NODE_4510_length_1138_cov_10.923003	318	398	2	12	80	0.1500000
NODE_4510_length_1138_cov_10.923003	318	398	4	15	80	0.1875000
NODE_4510_length_1138_cov_10.923003	318	398	6	17	80	0.2125000
NODE_4510_length_1138_cov_10.923003	371	451	4	10	80	0.1250000
NODE_4510_length_1138_cov_10.923003	371	451	6	70	80	0.8750000
NODE_4517_length_1137_cov_23.983622	470	550	0	80	80	1.0000000
NODE_4517_length_1137_cov_23.983622	523	603	0	76	80	0.9500000
NODE_4517_length_1137_cov_23.983622	523	603	2	4	80	0.0500000
NODE_4517_length_1137_cov_23.983622	599	679	2	80	80	1.0000000
NODE_4517_length_1137_cov_23.983622	652	732	0	49	80	0.6125000
NODE_4517_length_1137_cov_23.983622	652	732	2	31	80	0.3875000
NODE_4518_length_1137_cov_22.877649	405	485	2	49	80	0.6125000
NODE_4518_length_1137_cov_22.877649	405	485	4	31	80	0.3875000
NODE_4518_length_1137_cov_22.877649	458	538	0	16	80	0.2000000
NODE_4518_length_1137_cov_22.877649	458	538	2	58	80	0.7250000
NODE_4518_length_1137_cov_22.877649	458	538	4	6	80	0.0750000
NODE_4518_length_1137_cov_22.877649	534	614	0	77	80	0.9625000
NODE_4518_length_1137_cov_22.877649	534	614	2	3	80	0.0375000
NODE_4518_length_1137_cov_22.877649	587	667	0	24	80	0.3000000
NODE_4518_length_1137_cov_22.877649	587	667	2	56	80	0.7000000
NODE_4519_length_1137_cov_21.570328	383	463	0	45	80	0.5625000
NODE_4519_length_1137_cov_21.570328	383	463	2	35	80	0.4375000
NODE_4519_length_1137_cov_21.570328	436	516	2	80	80	1.0000000
NODE_4520_length_1137_cov_18.560694	665	745	0	58	80	0.7250000
NODE_4520_length_1137_cov_18.560694	665	745	2	22	80	0.2750000
NODE_4520_length_1137_cov_18.560694	718	798	0	5	80	0.0625000
NODE_4520_length_1137_cov_18.560694	718	798	2	75	80	0.9375000
NODE_4521_length_1137_cov_18.505780	557	637	0	80	80	1.0000000
NODE_4521_length_1137_cov_18.505780	610	690	0	30	80	0.3750000
NODE_4521_length_1137_cov_18.505780	610	690	2	50	80	0.6250000
NODE_4521_length_1137_cov_18.505780	686	766	0	49	80	0.6125000
NODE_4521_length_1137_cov_18.505780	686	766	2	31	80	0.3875000
NODE_4521_length_1137_cov_18.505780	739	819	0	80	80	1.0000000
NODE_4523_length_1137_cov_11.866089	313	393	0	80	80	1.0000000
NODE_4523_length_1137_cov_11.866089	366	446	0	80	80	1.0000000
NODE_4523_length_1137_cov_11.866089	442	522	0	46	80	0.5750000
NODE_4523_length_1137_cov_11.866089	442	522	2	34	80	0.4250000
NODE_4523_length_1137_cov_11.866089	495	575	0	32	80	0.4000000
NODE_4523_length_1137_cov_11.866089	495	575	2	48	80	0.6000000
NODE_4524_length_1137_cov_5.594412	144	224	0	80	80	1.0000000
NODE_4524_length_1137_cov_5.594412	197	277	0	80	80	1.0000000
NODE_4532_length_1136_cov_42.827387	445	525	0	4	80	0.0500000
NODE_4532_length_1136_cov_42.827387	445	525	2	17	80	0.2125000
NODE_4532_length_1136_cov_42.827387	445	525	4	59	80	0.7375000
NODE_4532_length_1136_cov_42.827387	498	578	0	22	80	0.2750000
NODE_4532_length_1136_cov_42.827387	498	578	2	52	80	0.6500000
NODE_4532_length_1136_cov_42.827387	498	578	4	6	80	0.0750000
NODE_4532_length_1136_cov_42.827387	574	654	2	46	80	0.5750000
NODE_4532_length_1136_cov_42.827387	574	654	4	34	80	0.4250000
NODE_4532_length_1136_cov_42.827387	627	707	0	20	80	0.2500000
NODE_4532_length_1136_cov_42.827387	627	707	2	60	80	0.7500000
NODE_4533_length_1136_cov_30.940212	534	614	0	68	80	0.8500000
NODE_4533_length_1136_cov_30.940212	534	614	2	12	80	0.1500000
NODE_4533_length_1136_cov_30.940212	587	667	0	15	80	0.1875000
NODE_4533_length_1136_cov_30.940212	587	667	2	65	80	0.8125000
NODE_4533_length_1136_cov_30.940212	663	743	0	43	80	0.5375000
NODE_4533_length_1136_cov_30.940212	663	743	2	37	80	0.4625000
NODE_4533_length_1136_cov_30.940212	716	796	0	2	80	0.0250000
NODE_4533_length_1136_cov_30.940212	716	796	2	78	80	0.9750000
NODE_4534_length_1136_cov_30.797493	557	637	0	80	80	1.0000000
NODE_4534_length_1136_cov_30.797493	610	691	0	81	81	1.0000000
NODE_4534_length_1136_cov_30.797493	687	767	0	80	80	1.0000000
NODE_4534_length_1136_cov_30.797493	740	820	0	80	80	1.0000000
NODE_4535_length_1136_cov_23.142719	704	784	2	67	80	0.8375000
NODE_4535_length_1136_cov_23.142719	704	784	4	13	80	0.1625000
NODE_4535_length_1136_cov_23.142719	757	837	2	67	80	0.8375000
NODE_4535_length_1136_cov_23.142719	757	837	4	13	80	0.1625000
NODE_4536_length_1136_cov_21.798457	570	651	0	81	81	1.0000000
NODE_4536_length_1136_cov_21.798457	624	704	0	80	80	1.0000000
NODE_4537_length_1136_cov_21.109932	460	532	0	36	72	0.5000000
NODE_4537_length_1136_cov_21.109932	460	532	1	34	72	0.4722222
NODE_4537_length_1136_cov_21.109932	460	532	2	2	72	0.0277778
NODE_4537_length_1136_cov_21.109932	505	585	0	25	80	0.3125000
NODE_4537_length_1136_cov_21.109932	505	585	2	55	80	0.6875000
NODE_4538_length_1136_cov_20.528447	19	99	0	1	80	0.0125000
NODE_4538_length_1136_cov_20.528447	19	99	2	3	80	0.0375000
NODE_4538_length_1136_cov_20.528447	19	99	5	5	80	0.0625000
NODE_4538_length_1136_cov_20.528447	19	99	6	2	80	0.0250000
NODE_4538_length_1136_cov_20.528447	19	99	7	1	80	0.0125000
NODE_4538_length_1136_cov_20.528447	19	99	9	5	80	0.0625000
NODE_4538_length_1136_cov_20.528447	19	99	11	17	80	0.2125000
NODE_4538_length_1136_cov_20.528447	19	99	13	5	80	0.0625000
NODE_4538_length_1136_cov_20.528447	19	99	14	3	80	0.0375000
NODE_4538_length_1136_cov_20.528447	19	99	16	5	80	0.0625000
NODE_4538_length_1136_cov_20.528447	19	99	18	14	80	0.1750000
NODE_4538_length_1136_cov_20.528447	19	99	20	19	80	0.2375000
NODE_4538_length_1136_cov_20.528447	19	99	0	1	80	0.0125000
NODE_4538_length_1136_cov_20.528447	19	99	2	3	80	0.0375000
NODE_4538_length_1136_cov_20.528447	19	99	5	5	80	0.0625000
NODE_4538_length_1136_cov_20.528447	19	99	6	2	80	0.0250000
NODE_4538_length_1136_cov_20.528447	19	99	7	1	80	0.0125000
NODE_4538_length_1136_cov_20.528447	19	99	9	5	80	0.0625000
NODE_4538_length_1136_cov_20.528447	19	99	11	17	80	0.2125000
NODE_4538_length_1136_cov_20.528447	19	99	13	5	80	0.0625000
NODE_4538_length_1136_cov_20.528447	19	99	14	3	80	0.0375000
NODE_4538_length_1136_cov_20.528447	19	99	16	5	80	0.0625000
NODE_4538_length_1136_cov_20.528447	19	99	18	14	80	0.1750000
NODE_4538_length_1136_cov_20.528447	19	99	20	19	80	0.2375000
NODE_4538_length_1136_cov_20.528447	28	99	6	2	71	0.0281690
NODE_4538_length_1136_cov_20.528447	28	99	7	1	71	0.0140845
NODE_4538_length_1136_cov_20.528447	28	99	9	5	71	0.0704225
NODE_4538_length_1136_cov_20.528447	28	99	11	17	71	0.2394366
NODE_4538_length_1136_cov_20.528447	28	99	13	5	71	0.0704225
NODE_4538_length_1136_cov_20.528447	28	99	14	3	71	0.0422535
NODE_4538_length_1136_cov_20.528447	28	99	16	5	71	0.0704225
NODE_4538_length_1136_cov_20.528447	28	99	18	14	71	0.1971831
NODE_4538_length_1136_cov_20.528447	28	99	20	19	71	0.2676056
NODE_4538_length_1136_cov_20.528447	877	912	0	35	35	1.0000000
NODE_4538_length_1136_cov_20.528447	879	921	0	42	42	1.0000000
NODE_4539_length_1136_cov_14.921890	657	737	0	80	80	1.0000000
NODE_4539_length_1136_cov_14.921890	710	790	0	80	80	1.0000000
NODE_4556_length_1135_cov_100.121622	454	534	4	2	80	0.0250000
NODE_4556_length_1135_cov_100.121622	454	534	5	1	80	0.0125000
NODE_4556_length_1135_cov_100.121622	454	534	6	23	80	0.2875000
NODE_4556_length_1135_cov_100.121622	454	534	8	54	80	0.6750000
NODE_4556_length_1135_cov_100.121622	507	587	0	8	80	0.1000000
NODE_4556_length_1135_cov_100.121622	507	587	2	32	80	0.4000000
NODE_4556_length_1135_cov_100.121622	507	587	4	15	80	0.1875000
NODE_4556_length_1135_cov_100.121622	507	587	5	1	80	0.0125000
NODE_4556_length_1135_cov_100.121622	507	587	6	16	80	0.2000000
NODE_4556_length_1135_cov_100.121622	507	587	8	8	80	0.1000000
NODE_4556_length_1135_cov_100.121622	583	663	0	17	80	0.2125000
NODE_4556_length_1135_cov_100.121622	583	663	4	62	80	0.7750000
NODE_4556_length_1135_cov_100.121622	583	663	6	1	80	0.0125000
NODE_4556_length_1135_cov_100.121622	636	719	4	68	83	0.8192771
NODE_4556_length_1135_cov_100.121622	636	719	6	10	83	0.1204819
NODE_4556_length_1135_cov_100.121622	636	719	8	5	83	0.0602410
NODE_4557_length_1135_cov_34.523166	313	393	2	11	80	0.1375000
NODE_4557_length_1135_cov_34.523166	313	393	4	36	80	0.4500000
NODE_4557_length_1135_cov_34.523166	313	393	6	11	80	0.1375000
NODE_4557_length_1135_cov_34.523166	313	393	8	22	80	0.2750000
NODE_4557_length_1135_cov_34.523166	366	446	4	26	80	0.3250000
NODE_4557_length_1135_cov_34.523166	366	446	6	24	80	0.3000000
NODE_4557_length_1135_cov_34.523166	366	446	8	30	80	0.3750000
NODE_4558_length_1135_cov_20.735521	484	564	0	80	80	1.0000000
NODE_4558_length_1135_cov_20.735521	537	617	0	80	80	1.0000000
NODE_4558_length_1135_cov_20.735521	613	693	0	42	80	0.5250000
NODE_4558_length_1135_cov_20.735521	613	693	2	19	80	0.2375000
NODE_4558_length_1135_cov_20.735521	613	693	4	19	80	0.2375000
NODE_4558_length_1135_cov_20.735521	666	746	2	22	80	0.2750000
NODE_4558_length_1135_cov_20.735521	666	746	4	58	80	0.7250000
NODE_4559_length_1135_cov_9.644788	620	700	0	80	80	1.0000000
NODE_4559_length_1135_cov_9.644788	673	753	0	80	80	1.0000000
NODE_4562_length_1135_cov_2.990347	349	429	0	36	80	0.4500000
NODE_4562_length_1135_cov_2.990347	349	429	2	44	80	0.5500000
NODE_4562_length_1135_cov_2.990347	402	482	2	48	80	0.6000000
NODE_4562_length_1135_cov_2.990347	402	482	4	32	80	0.4000000
NODE_4571_length_1134_cov_34.784541	478	558	0	42	80	0.5250000
NODE_4571_length_1134_cov_34.784541	478	558	2	38	80	0.4750000
NODE_4571_length_1134_cov_34.784541	531	611	0	69	80	0.8625000
NODE_4571_length_1134_cov_34.784541	531	611	2	11	80	0.1375000
NODE_4571_length_1134_cov_34.784541	607	687	2	58	80	0.7250000
NODE_4571_length_1134_cov_34.784541	607	687	4	2	80	0.0250000
NODE_4571_length_1134_cov_34.784541	607	687	6	9	80	0.1125000
NODE_4571_length_1134_cov_34.784541	607	687	8	11	80	0.1375000
NODE_4571_length_1134_cov_34.784541	660	740	2	5	80	0.0625000
NODE_4571_length_1134_cov_34.784541	660	740	4	2	80	0.0250000
NODE_4571_length_1134_cov_34.784541	660	740	6	59	80	0.7375000
NODE_4571_length_1134_cov_34.784541	660	740	8	14	80	0.1750000
NODE_4572_length_1134_cov_28.524638	511	591	2	8	80	0.1000000
NODE_4572_length_1134_cov_28.524638	511	591	4	72	80	0.9000000
NODE_4572_length_1134_cov_28.524638	564	644	0	40	80	0.5000000
NODE_4572_length_1134_cov_28.524638	564	644	2	1	80	0.0125000
NODE_4572_length_1134_cov_28.524638	564	644	4	39	80	0.4875000
NODE_4572_length_1134_cov_28.524638	640	720	0	80	80	1.0000000
NODE_4572_length_1134_cov_28.524638	693	773	0	80	80	1.0000000
NODE_4576_length_1134_cov_2.619324	606	686	0	80	80	1.0000000
NODE_4576_length_1134_cov_2.619324	659	739	0	80	80	1.0000000
NODE_4584_length_1133_cov_5.563830	292	372	0	80	80	1.0000000
NODE_4584_length_1133_cov_5.563830	345	425	0	80	80	1.0000000
NODE_4584_length_1133_cov_5.563830	904	966	1	1	62	0.0161290
NODE_4584_length_1133_cov_5.563830	904	966	2	61	62	0.9838710
NODE_4592_length_1132_cov_23.121007	485	565	0	80	80	1.0000000
NODE_4592_length_1132_cov_23.121007	538	618	0	80	80	1.0000000
NODE_4592_length_1132_cov_23.121007	618	664	0	46	46	1.0000000
NODE_4592_length_1132_cov_23.121007	700	751	0	51	51	1.0000000
NODE_4593_length_1132_cov_19.377541	595	675	0	40	80	0.5000000
NODE_4593_length_1132_cov_19.377541	595	675	2	40	80	0.5000000
NODE_4593_length_1132_cov_19.377541	648	728	0	28	80	0.3500000
NODE_4593_length_1132_cov_19.377541	648	728	2	52	80	0.6500000
NODE_4594_length_1132_cov_18.872217	363	443	0	80	80	1.0000000
NODE_4594_length_1132_cov_18.872217	416	496	0	80	80	1.0000000
NODE_4595_length_1132_cov_11.242982	474	554	2	38	80	0.4750000
NODE_4595_length_1132_cov_11.242982	474	554	4	42	80	0.5250000
NODE_4595_length_1132_cov_11.242982	527	607	2	61	80	0.7625000
NODE_4595_length_1132_cov_11.242982	527	607	4	19	80	0.2375000
NODE_4596_length_1132_cov_7.356244	354	434	0	80	80	1.0000000
NODE_4596_length_1132_cov_7.356244	407	487	0	80	80	1.0000000
NODE_4597_length_1132_cov_6.214908	269	349	0	80	80	1.0000000
NODE_4597_length_1132_cov_6.214908	322	402	0	80	80	1.0000000
NODE_4606_length_1131_cov_36.161822	478	558	2	80	80	1.0000000
NODE_4606_length_1131_cov_36.161822	531	611	0	9	80	0.1125000
NODE_4606_length_1131_cov_36.161822	531	611	2	71	80	0.8875000
NODE_4606_length_1131_cov_36.161822	607	687	0	24	80	0.3000000
NODE_4606_length_1131_cov_36.161822	607	687	2	56	80	0.7000000
NODE_4606_length_1131_cov_36.161822	660	740	0	29	80	0.3625000
NODE_4606_length_1131_cov_36.161822	660	740	2	51	80	0.6375000
NODE_4607_length_1131_cov_31.907946	390	470	0	80	80	1.0000000
NODE_4607_length_1131_cov_31.907946	443	523	0	80	80	1.0000000
NODE_4607_length_1131_cov_31.907946	519	599	0	80	80	1.0000000
NODE_4607_length_1131_cov_31.907946	572	652	0	80	80	1.0000000
NODE_4608_length_1131_cov_26.827519	464	544	0	80	80	1.0000000
NODE_4608_length_1131_cov_26.827519	517	597	0	80	80	1.0000000
NODE_4609_length_1131_cov_20.441860	555	635	0	80	80	1.0000000
NODE_4609_length_1131_cov_20.441860	608	688	0	80	80	1.0000000
NODE_4610_length_1131_cov_12.517442	420	500	0	80	80	1.0000000
NODE_4610_length_1131_cov_12.517442	473	553	0	80	80	1.0000000
NODE_4611_length_1131_cov_10.912791	429	509	0	80	80	1.0000000
NODE_4611_length_1131_cov_10.912791	482	562	0	80	80	1.0000000
NODE_4620_length_1130_cov_43.354995	742	822	0	5	80	0.0625000
NODE_4620_length_1130_cov_43.354995	742	822	4	75	80	0.9375000
NODE_4620_length_1130_cov_43.354995	795	875	2	34	80	0.4250000
NODE_4620_length_1130_cov_43.354995	795	875	4	42	80	0.5250000
NODE_4620_length_1130_cov_43.354995	795	875	6	4	80	0.0500000
NODE_4621_length_1130_cov_13.097963	642	722	0	45	80	0.5625000
NODE_4621_length_1130_cov_13.097963	642	722	2	35	80	0.4375000
NODE_4621_length_1130_cov_13.097963	695	775	2	80	80	1.0000000
NODE_4626_length_1129_cov_31.088350	396	476	0	17	80	0.2125000
NODE_4626_length_1129_cov_31.088350	396	476	2	43	80	0.5375000
NODE_4626_length_1129_cov_31.088350	396	476	4	20	80	0.2500000
NODE_4626_length_1129_cov_31.088350	449	529	0	5	80	0.0625000
NODE_4626_length_1129_cov_31.088350	449	529	2	69	80	0.8625000
NODE_4626_length_1129_cov_31.088350	449	529	4	6	80	0.0750000
NODE_4627_length_1129_cov_20.591262	450	530	0	42	80	0.5250000
NODE_4627_length_1129_cov_20.591262	450	530	2	38	80	0.4750000
NODE_4627_length_1129_cov_20.591262	503	583	0	6	80	0.0750000
NODE_4627_length_1129_cov_20.591262	503	583	2	74	80	0.9250000
NODE_4628_length_1129_cov_16.934951	261	341	0	49	80	0.6125000
NODE_4628_length_1129_cov_16.934951	261	341	2	17	80	0.2125000
NODE_4628_length_1129_cov_16.934951	261	341	4	14	80	0.1750000
NODE_4628_length_1129_cov_16.934951	314	394	2	20	80	0.2500000
NODE_4628_length_1129_cov_16.934951	314	394	4	60	80	0.7500000
NODE_4629_length_1129_cov_9.441748	665	738	0	51	73	0.6986302
NODE_4629_length_1129_cov_9.441748	665	738	2	22	73	0.3013699
NODE_4629_length_1129_cov_9.441748	711	791	0	5	80	0.0625000
NODE_4629_length_1129_cov_9.441748	711	791	2	75	80	0.9375000
NODE_4630_length_1129_cov_9.260194	658	738	0	44	80	0.5500000
NODE_4630_length_1129_cov_9.260194	658	738	2	36	80	0.4500000
NODE_4630_length_1129_cov_9.260194	711	791	0	28	80	0.3500000
NODE_4630_length_1129_cov_9.260194	711	791	2	52	80	0.6500000
NODE_4631_length_1129_cov_5.055340	759	839	0	80	80	1.0000000
NODE_4638_length_1128_cov_48.099125	588	668	0	11	80	0.1375000
NODE_4638_length_1128_cov_48.099125	588	668	2	69	80	0.8625000
NODE_4638_length_1128_cov_48.099125	641	721	0	64	80	0.8000000
NODE_4638_length_1128_cov_48.099125	641	721	2	16	80	0.2000000
NODE_4640_length_1128_cov_26.230321	455	535	0	4	80	0.0500000
NODE_4640_length_1128_cov_26.230321	455	535	4	19	80	0.2375000
NODE_4640_length_1128_cov_26.230321	455	535	6	8	80	0.1000000
NODE_4640_length_1128_cov_26.230321	455	535	8	5	80	0.0625000
NODE_4640_length_1128_cov_26.230321	455	535	10	44	80	0.5500000
NODE_4640_length_1128_cov_26.230321	508	588	0	3	80	0.0375000
NODE_4640_length_1128_cov_26.230321	508	588	2	13	80	0.1625000
NODE_4640_length_1128_cov_26.230321	508	588	4	8	80	0.1000000
NODE_4640_length_1128_cov_26.230321	508	588	10	56	80	0.7000000
NODE_4640_length_1128_cov_26.230321	584	664	4	35	80	0.4375000
NODE_4640_length_1128_cov_26.230321	584	664	6	45	80	0.5625000
NODE_4640_length_1128_cov_26.230321	637	718	0	3	81	0.0370370
NODE_4640_length_1128_cov_26.230321	637	718	2	16	81	0.1975309
NODE_4640_length_1128_cov_26.230321	637	718	4	62	81	0.7654321
NODE_4641_length_1128_cov_26.031098	594	674	1	4	80	0.0500000
NODE_4641_length_1128_cov_26.031098	594	674	2	76	80	0.9500000
NODE_4641_length_1128_cov_26.031098	647	727	0	44	80	0.5500000
NODE_4641_length_1128_cov_26.031098	647	727	1	9	80	0.1125000
NODE_4641_length_1128_cov_26.031098	647	727	2	27	80	0.3375000
NODE_4642_length_1128_cov_25.869776	465	538	0	13	73	0.1780822
NODE_4642_length_1128_cov_25.869776	465	538	4	35	73	0.4794520
NODE_4642_length_1128_cov_25.869776	465	538	5	25	73	0.3424658
NODE_4642_length_1128_cov_25.869776	601	674	0	29	73	0.3972603
NODE_4642_length_1128_cov_25.869776	601	674	1	14	73	0.1917808
NODE_4642_length_1128_cov_25.869776	601	674	3	30	73	0.4109589
NODE_4642_length_1128_cov_25.869776	647	723	3	31	76	0.4078947
NODE_4642_length_1128_cov_25.869776	647	723	5	45	76	0.5921053
NODE_4643_length_1128_cov_24.185617	350	430	0	62	80	0.7750000
NODE_4643_length_1128_cov_24.185617	350	430	2	18	80	0.2250000
NODE_4643_length_1128_cov_24.185617	403	483	0	9	80	0.1125000
NODE_4643_length_1128_cov_24.185617	403	483	2	31	80	0.3875000
NODE_4643_length_1128_cov_24.185617	403	483	4	40	80	0.5000000
NODE_4644_length_1128_cov_18.537415	335	415	0	80	80	1.0000000
NODE_4644_length_1128_cov_18.537415	388	468	0	80	80	1.0000000
NODE_4645_length_1128_cov_9.345967	690	770	0	57	80	0.7125000
NODE_4645_length_1128_cov_9.345967	690	770	2	23	80	0.2875000
NODE_4645_length_1128_cov_9.345967	743	823	0	80	80	1.0000000
NODE_4647_length_1128_cov_3.920311	675	725	0	50	50	1.0000000
NODE_4647_length_1128_cov_3.920311	698	778	0	38	80	0.4750000
NODE_4647_length_1128_cov_3.920311	698	778	2	42	80	0.5250000
NODE_4648_length_1128_cov_3.631681	613	693	0	80	80	1.0000000
NODE_4648_length_1128_cov_3.631681	666	746	0	80	80	1.0000000
NODE_4650_length_1128_cov_3.091351	519	599	0	80	80	1.0000000
NODE_4650_length_1128_cov_3.091351	572	652	0	80	80	1.0000000
NODE_4660_length_1127_cov_38.932879	405	485	0	80	80	1.0000000
NODE_4660_length_1127_cov_38.932879	458	538	0	46	80	0.5750000
NODE_4660_length_1127_cov_38.932879	458	538	2	34	80	0.4250000
NODE_4660_length_1127_cov_38.932879	534	614	2	6	80	0.0750000
NODE_4660_length_1127_cov_38.932879	534	614	4	5	80	0.0625000
NODE_4660_length_1127_cov_38.932879	534	614	6	1	80	0.0125000
NODE_4660_length_1127_cov_38.932879	534	614	8	68	80	0.8500000
NODE_4660_length_1127_cov_38.932879	587	667	2	11	80	0.1375000
NODE_4660_length_1127_cov_38.932879	587	667	4	45	80	0.5625000
NODE_4660_length_1127_cov_38.932879	587	667	6	2	80	0.0250000
NODE_4660_length_1127_cov_38.932879	587	667	8	22	80	0.2750000
NODE_4661_length_1127_cov_37.721790	236	316	2	6	80	0.0750000
NODE_4661_length_1127_cov_37.721790	236	316	4	8	80	0.1000000
NODE_4661_length_1127_cov_37.721790	236	316	6	66	80	0.8250000
NODE_4661_length_1127_cov_37.721790	289	369	2	17	80	0.2125000
NODE_4661_length_1127_cov_37.721790	289	369	3	35	80	0.4375000
NODE_4661_length_1127_cov_37.721790	289	369	4	2	80	0.0250000
NODE_4661_length_1127_cov_37.721790	289	369	5	6	80	0.0750000
NODE_4661_length_1127_cov_37.721790	289	369	6	20	80	0.2500000
NODE_4661_length_1127_cov_37.721790	365	445	3	3	80	0.0375000
NODE_4661_length_1127_cov_37.721790	365	445	6	41	80	0.5125000
NODE_4661_length_1127_cov_37.721790	365	445	8	15	80	0.1875000
NODE_4661_length_1127_cov_37.721790	365	445	10	9	80	0.1125000
NODE_4661_length_1127_cov_37.721790	365	445	12	12	80	0.1500000
NODE_4661_length_1127_cov_37.721790	418	498	7	1	80	0.0125000
NODE_4661_length_1127_cov_37.721790	418	498	8	6	80	0.0750000
NODE_4661_length_1127_cov_37.721790	418	498	9	20	80	0.2500000
NODE_4661_length_1127_cov_37.721790	418	498	10	9	80	0.1125000
NODE_4661_length_1127_cov_37.721790	418	498	11	1	80	0.0125000
NODE_4661_length_1127_cov_37.721790	418	498	12	43	80	0.5375000
NODE_4662_length_1127_cov_31.866732	444	523	0	18	79	0.2278481
NODE_4662_length_1127_cov_31.866732	444	523	2	61	79	0.7721519
NODE_4662_length_1127_cov_31.866732	496	576	0	18	80	0.2250000
NODE_4662_length_1127_cov_31.866732	496	576	2	62	80	0.7750000
NODE_4662_length_1127_cov_31.866732	572	652	0	56	80	0.7000000
NODE_4662_length_1127_cov_31.866732	572	652	2	24	80	0.3000000
NODE_4662_length_1127_cov_31.866732	625	705	0	80	80	1.0000000
NODE_4663_length_1127_cov_25.616732	430	510	0	80	80	1.0000000
NODE_4663_length_1127_cov_25.616732	483	563	0	75	80	0.9375000
NODE_4663_length_1127_cov_25.616732	483	563	2	5	80	0.0625000
NODE_4664_length_1127_cov_21.838521	338	418	2	19	80	0.2375000
NODE_4664_length_1127_cov_21.838521	338	418	4	61	80	0.7625000
NODE_4664_length_1127_cov_21.838521	391	471	2	57	80	0.7125000
NODE_4664_length_1127_cov_21.838521	391	471	4	23	80	0.2875000
NODE_4664_length_1127_cov_21.838521	467	547	2	10	80	0.1250000
NODE_4664_length_1127_cov_21.838521	467	547	4	9	80	0.1125000
NODE_4664_length_1127_cov_21.838521	467	547	5	1	80	0.0125000
NODE_4664_length_1127_cov_21.838521	467	547	6	34	80	0.4250000
NODE_4664_length_1127_cov_21.838521	467	547	10	26	80	0.3250000
NODE_4664_length_1127_cov_21.838521	520	600	6	1	80	0.0125000
NODE_4664_length_1127_cov_21.838521	520	600	8	17	80	0.2125000
NODE_4664_length_1127_cov_21.838521	520	600	10	58	80	0.7250000
NODE_4664_length_1127_cov_21.838521	520	600	12	1	80	0.0125000
NODE_4664_length_1127_cov_21.838521	520	600	14	3	80	0.0375000
NODE_4665_length_1127_cov_15.024319	711	800	2	22	89	0.2471910
NODE_4665_length_1127_cov_15.024319	711	800	3	17	89	0.1910112
NODE_4665_length_1127_cov_15.024319	711	800	5	50	89	0.5617977
NODE_4665_length_1127_cov_15.024319	773	853	2	75	80	0.9375000
NODE_4665_length_1127_cov_15.024319	773	853	5	5	80	0.0625000
NODE_4667_length_1127_cov_4.786965	386	466	4	5	80	0.0625000
NODE_4667_length_1127_cov_4.786965	386	466	6	25	80	0.3125000
NODE_4667_length_1127_cov_4.786965	386	466	7	32	80	0.4000000
NODE_4667_length_1127_cov_4.786965	386	466	8	18	80	0.2250000
NODE_4667_length_1127_cov_4.786965	439	519	1	3	80	0.0375000
NODE_4667_length_1127_cov_4.786965	439	519	3	35	80	0.4375000
NODE_4667_length_1127_cov_4.786965	439	519	5	1	80	0.0125000
NODE_4667_length_1127_cov_4.786965	439	519	6	4	80	0.0500000
NODE_4667_length_1127_cov_4.786965	439	519	7	35	80	0.4375000
NODE_4667_length_1127_cov_4.786965	439	519	8	2	80	0.0250000
NODE_4672_length_1126_cov_51.699124	448	528	0	49	80	0.6125000
NODE_4672_length_1126_cov_51.699124	448	528	4	27	80	0.3375000
NODE_4672_length_1126_cov_51.699124	448	528	8	4	80	0.0500000
NODE_4672_length_1126_cov_51.699124	501	581	4	23	80	0.2875000
NODE_4672_length_1126_cov_51.699124	501	581	8	9	80	0.1125000
NODE_4672_length_1126_cov_51.699124	501	581	10	48	80	0.6000000
NODE_4673_length_1126_cov_38.135346	427	507	0	80	80	1.0000000
NODE_4673_length_1126_cov_38.135346	480	560	0	78	80	0.9750000
NODE_4673_length_1126_cov_38.135346	480	560	4	2	80	0.0250000
NODE_4673_length_1126_cov_38.135346	556	638	0	2	82	0.0243902
NODE_4673_length_1126_cov_38.135346	556	638	4	80	82	0.9756098
NODE_4673_length_1126_cov_38.135346	611	691	0	24	80	0.3000000
NODE_4673_length_1126_cov_38.135346	611	691	4	56	80	0.7000000
NODE_4674_length_1126_cov_34.637780	23	97	2	7	74	0.0945946
NODE_4674_length_1126_cov_34.637780	23	97	4	8	74	0.1081081
NODE_4674_length_1126_cov_34.637780	23	97	6	2	74	0.0270270
NODE_4674_length_1126_cov_34.637780	23	97	10	52	74	0.7027027
NODE_4674_length_1126_cov_34.637780	23	97	12	2	74	0.0270270
NODE_4674_length_1126_cov_34.637780	23	97	14	3	74	0.0405405
NODE_4674_length_1126_cov_34.637780	146	226	20	8	80	0.1000000
NODE_4674_length_1126_cov_34.637780	146	226	22	16	80	0.2000000
NODE_4674_length_1126_cov_34.637780	146	226	23	7	80	0.0875000
NODE_4674_length_1126_cov_34.637780	146	226	24	7	80	0.0875000
NODE_4674_length_1126_cov_34.637780	146	226	26	15	80	0.1875000
NODE_4674_length_1126_cov_34.637780	146	226	27	1	80	0.0125000
NODE_4674_length_1126_cov_34.637780	146	226	28	13	80	0.1625000
NODE_4674_length_1126_cov_34.637780	146	226	29	13	80	0.1625000
NODE_4674_length_1126_cov_34.637780	146	226	20	8	80	0.1000000
NODE_4674_length_1126_cov_34.637780	146	226	22	16	80	0.2000000
NODE_4674_length_1126_cov_34.637780	146	226	23	7	80	0.0875000
NODE_4674_length_1126_cov_34.637780	146	226	24	7	80	0.0875000
NODE_4674_length_1126_cov_34.637780	146	226	26	15	80	0.1875000
NODE_4674_length_1126_cov_34.637780	146	226	27	1	80	0.0125000
NODE_4674_length_1126_cov_34.637780	146	226	28	13	80	0.1625000
NODE_4674_length_1126_cov_34.637780	146	226	29	13	80	0.1625000
NODE_4674_length_1126_cov_34.637780	146	208	22	6	62	0.0967742
NODE_4674_length_1126_cov_34.637780	146	208	23	7	62	0.1129032
NODE_4674_length_1126_cov_34.637780	146	208	24	7	62	0.1129032
NODE_4674_length_1126_cov_34.637780	146	208	26	15	62	0.2419355
NODE_4674_length_1126_cov_34.637780	146	208	27	1	62	0.0161290
NODE_4674_length_1126_cov_34.637780	146	208	28	13	62	0.2096774
NODE_4674_length_1126_cov_34.637780	146	208	29	13	62	0.2096774
NODE_4674_length_1126_cov_34.637780	146	217	22	15	71	0.2112676
NODE_4674_length_1126_cov_34.637780	146	217	23	7	71	0.0985916
NODE_4674_length_1126_cov_34.637780	146	217	24	7	71	0.0985916
NODE_4674_length_1126_cov_34.637780	146	217	26	15	71	0.2112676
NODE_4674_length_1126_cov_34.637780	146	217	27	1	71	0.0140845
NODE_4674_length_1126_cov_34.637780	146	217	28	13	71	0.1830986
NODE_4674_length_1126_cov_34.637780	146	217	29	13	71	0.1830986
NODE_4675_length_1126_cov_21.360273	595	675	0	80	80	1.0000000
NODE_4675_length_1126_cov_21.360273	648	728	0	80	80	1.0000000
NODE_4676_length_1126_cov_17.420643	422	502	0	80	80	1.0000000
NODE_4676_length_1126_cov_17.420643	475	555	0	80	80	1.0000000
NODE_4677_length_1126_cov_15.896787	383	463	0	17	80	0.2125000
NODE_4677_length_1126_cov_15.896787	383	463	2	63	80	0.7875000
NODE_4677_length_1126_cov_15.896787	436	516	0	4	80	0.0500000
NODE_4677_length_1126_cov_15.896787	436	516	2	76	80	0.9500000
NODE_4678_length_1126_cov_8.525803	174	254	2	80	80	1.0000000
NODE_4678_length_1126_cov_8.525803	227	307	0	17	80	0.2125000
NODE_4678_length_1126_cov_8.525803	227	307	2	63	80	0.7875000
NODE_4679_length_1126_cov_5.805258	463	543	0	80	80	1.0000000
NODE_4679_length_1126_cov_5.805258	516	596	0	80	80	1.0000000
NODE_4685_length_1126_cov_1.502434	6	86	0	14	80	0.1750000
NODE_4685_length_1126_cov_1.502434	6	86	2	66	80	0.8250000
NODE_4685_length_1126_cov_1.502434	59	108	2	49	49	1.0000000
NODE_4689_length_1125_cov_34.314815	405	485	6	15	80	0.1875000
NODE_4689_length_1125_cov_34.314815	405	485	8	24	80	0.3000000
NODE_4689_length_1125_cov_34.314815	405	485	9	13	80	0.1625000
NODE_4689_length_1125_cov_34.314815	405	485	10	28	80	0.3500000
NODE_4689_length_1125_cov_34.314815	458	538	2	50	80	0.6250000
NODE_4689_length_1125_cov_34.314815	458	538	6	18	80	0.2250000
NODE_4689_length_1125_cov_34.314815	458	538	8	11	80	0.1375000
NODE_4689_length_1125_cov_34.314815	458	538	10	1	80	0.0125000
NODE_4689_length_1125_cov_34.314815	534	614	0	16	80	0.2000000
NODE_4689_length_1125_cov_34.314815	534	614	1	1	80	0.0125000
NODE_4689_length_1125_cov_34.314815	534	614	2	63	80	0.7875000
NODE_4689_length_1125_cov_34.314815	587	667	2	80	80	1.0000000
NODE_4690_length_1125_cov_33.553606	458	538	0	51	80	0.6375000
NODE_4690_length_1125_cov_33.553606	458	538	2	29	80	0.3625000
NODE_4690_length_1125_cov_33.553606	511	591	0	13	80	0.1625000
NODE_4690_length_1125_cov_33.553606	511	591	2	67	80	0.8375000
NODE_4690_length_1125_cov_33.553606	587	667	0	32	80	0.4000000
NODE_4690_length_1125_cov_33.553606	587	667	4	48	80	0.6000000
NODE_4690_length_1125_cov_33.553606	640	720	0	26	80	0.3250000
NODE_4690_length_1125_cov_33.553606	640	720	4	54	80	0.6750000
NODE_4691_length_1125_cov_33.371345	408	488	0	36	80	0.4500000
NODE_4691_length_1125_cov_33.371345	408	488	1	44	80	0.5500000
NODE_4691_length_1125_cov_33.371345	461	541	1	80	80	1.0000000
NODE_4691_length_1125_cov_33.371345	537	617	0	23	80	0.2875000
NODE_4691_length_1125_cov_33.371345	537	617	1	57	80	0.7125000
NODE_4691_length_1125_cov_33.371345	590	670	0	76	80	0.9500000
NODE_4691_length_1125_cov_33.371345	590	670	1	4	80	0.0500000
NODE_4692_length_1125_cov_22.580897	279	359	0	80	80	1.0000000
NODE_4692_length_1125_cov_22.580897	332	412	0	80	80	1.0000000
NODE_4692_length_1125_cov_22.580897	408	488	0	80	80	1.0000000
NODE_4692_length_1125_cov_22.580897	461	541	0	77	80	0.9625000
NODE_4692_length_1125_cov_22.580897	461	541	1	3	80	0.0375000
NODE_4705_length_1124_cov_52.278049	616	696	2	44	80	0.5500000
NODE_4705_length_1124_cov_52.278049	616	696	4	36	80	0.4500000
NODE_4705_length_1124_cov_52.278049	669	749	2	65	80	0.8125000
NODE_4705_length_1124_cov_52.278049	669	749	4	15	80	0.1875000
NODE_4706_length_1124_cov_25.280000	444	524	0	46	80	0.5750000
NODE_4706_length_1124_cov_25.280000	444	524	2	34	80	0.4250000
NODE_4706_length_1124_cov_25.280000	497	577	2	80	80	1.0000000
NODE_4706_length_1124_cov_25.280000	573	653	0	74	80	0.9250000
NODE_4706_length_1124_cov_25.280000	573	653	2	6	80	0.0750000
NODE_4706_length_1124_cov_25.280000	626	706	0	80	80	1.0000000
NODE_4707_length_1124_cov_18.700488	114	194	0	80	80	1.0000000
NODE_4707_length_1124_cov_18.700488	167	247	0	35	80	0.4375000
NODE_4707_length_1124_cov_18.700488	167	247	2	45	80	0.5625000
NODE_4717_length_1123_cov_26.445312	388	468	0	56	80	0.7000000
NODE_4717_length_1123_cov_26.445312	388	468	2	24	80	0.3000000
NODE_4717_length_1123_cov_26.445312	441	521	0	13	80	0.1625000
NODE_4717_length_1123_cov_26.445312	441	521	2	67	80	0.8375000
NODE_4717_length_1123_cov_26.445312	517	597	0	80	80	1.0000000
NODE_4717_length_1123_cov_26.445312	570	650	0	80	80	1.0000000
NODE_4718_length_1123_cov_18.677734	522	602	0	80	80	1.0000000
NODE_4718_length_1123_cov_18.677734	575	655	0	80	80	1.0000000
NODE_4718_length_1123_cov_18.677734	651	731	0	80	80	1.0000000
NODE_4718_length_1123_cov_18.677734	704	784	0	80	80	1.0000000
NODE_4728_length_1122_cov_38.688172	295	375	0	62	80	0.7750000
NODE_4728_length_1122_cov_38.688172	295	375	2	18	80	0.2250000
NODE_4728_length_1122_cov_38.688172	348	428	0	80	80	1.0000000
NODE_4728_length_1122_cov_38.688172	424	504	0	80	80	1.0000000
NODE_4728_length_1122_cov_38.688172	477	557	0	32	80	0.4000000
NODE_4728_length_1122_cov_38.688172	477	557	2	48	80	0.6000000
NODE_4729_length_1122_cov_32.827957	232	312	0	80	80	1.0000000
NODE_4729_length_1122_cov_32.827957	285	365	0	80	80	1.0000000
NODE_4729_length_1122_cov_32.827957	361	441	0	80	80	1.0000000
NODE_4729_length_1122_cov_32.827957	414	494	0	80	80	1.0000000
NODE_4730_length_1122_cov_12.574780	396	476	0	26	80	0.3250000
NODE_4730_length_1122_cov_12.574780	396	476	2	54	80	0.6750000
NODE_4730_length_1122_cov_12.574780	449	529	0	79	80	0.9875000
NODE_4730_length_1122_cov_12.574780	449	529	2	1	80	0.0125000
NODE_4730_length_1122_cov_12.574780	525	605	0	80	80	1.0000000
NODE_4730_length_1122_cov_12.574780	578	658	0	80	80	1.0000000
NODE_4731_length_1122_cov_8.582600	586	666	0	80	80	1.0000000
NODE_4731_length_1122_cov_8.582600	639	719	0	80	80	1.0000000
NODE_4733_length_1122_cov_3.714565	284	364	0	80	80	1.0000000
NODE_4733_length_1122_cov_3.714565	337	417	0	80	80	1.0000000
NODE_4738_length_1122_cov_1.757576	25	87	0	62	62	1.0000000
NODE_4742_length_1121_cov_39.595890	507	587	2	59	80	0.7375000
NODE_4742_length_1121_cov_39.595890	507	587	4	21	80	0.2625000
NODE_4742_length_1121_cov_39.595890	560	640	0	30	80	0.3750000
NODE_4742_length_1121_cov_39.595890	560	640	2	44	80	0.5500000
NODE_4742_length_1121_cov_39.595890	560	640	4	6	80	0.0750000
NODE_4742_length_1121_cov_39.595890	636	716	0	80	80	1.0000000
NODE_4742_length_1121_cov_39.595890	689	769	0	80	80	1.0000000
NODE_4743_length_1121_cov_23.832681	525	605	0	80	80	1.0000000
NODE_4743_length_1121_cov_23.832681	578	658	0	80	80	1.0000000
NODE_4744_length_1121_cov_18.033268	1	42	0	41	41	1.0000000
NODE_4744_length_1121_cov_18.033268	671	751	0	80	80	1.0000000
NODE_4744_length_1121_cov_18.033268	724	804	0	80	80	1.0000000
NODE_4745_length_1121_cov_8.633072	610	690	0	4	80	0.0500000
NODE_4745_length_1121_cov_8.633072	610	690	2	76	80	0.9500000
NODE_4745_length_1121_cov_8.633072	663	743	0	45	80	0.5625000
NODE_4745_length_1121_cov_8.633072	663	743	2	35	80	0.4375000
NODE_4751_length_1120_cov_34.281097	377	457	0	15	80	0.1875000
NODE_4751_length_1120_cov_34.281097	377	457	4	2	80	0.0250000
NODE_4751_length_1120_cov_34.281097	377	457	6	6	80	0.0750000
NODE_4751_length_1120_cov_34.281097	377	457	8	57	80	0.7125000
NODE_4751_length_1120_cov_34.281097	430	510	0	11	80	0.1375000
NODE_4751_length_1120_cov_34.281097	430	510	2	11	80	0.1375000
NODE_4751_length_1120_cov_34.281097	430	510	4	15	80	0.1875000
NODE_4751_length_1120_cov_34.281097	430	510	6	1	80	0.0125000
NODE_4751_length_1120_cov_34.281097	430	510	7	1	80	0.0125000
NODE_4751_length_1120_cov_34.281097	430	510	8	41	80	0.5125000
NODE_4751_length_1120_cov_34.281097	506	586	0	80	80	1.0000000
NODE_4751_length_1120_cov_34.281097	559	639	0	80	80	1.0000000
NODE_4752_length_1120_cov_31.468168	401	481	0	3	80	0.0375000
NODE_4752_length_1120_cov_31.468168	401	481	2	77	80	0.9625000
NODE_4752_length_1120_cov_31.468168	454	534	0	36	80	0.4500000
NODE_4752_length_1120_cov_31.468168	454	534	2	44	80	0.5500000
NODE_4752_length_1120_cov_31.468168	530	610	0	26	80	0.3250000
NODE_4752_length_1120_cov_31.468168	530	610	2	54	80	0.6750000
NODE_4752_length_1120_cov_31.468168	583	663	0	27	80	0.3375000
NODE_4752_length_1120_cov_31.468168	583	663	2	53	80	0.6625000
NODE_4753_length_1120_cov_28.182174	418	498	0	22	80	0.2750000
NODE_4753_length_1120_cov_28.182174	418	498	2	58	80	0.7250000
NODE_4753_length_1120_cov_28.182174	471	551	0	17	80	0.2125000
NODE_4753_length_1120_cov_28.182174	471	551	2	63	80	0.7875000
NODE_4754_length_1120_cov_25.423115	405	485	0	80	80	1.0000000
NODE_4754_length_1120_cov_25.423115	458	538	0	80	80	1.0000000
NODE_4754_length_1120_cov_25.423115	534	614	0	29	80	0.3625000
NODE_4754_length_1120_cov_25.423115	534	614	2	51	80	0.6375000
NODE_4754_length_1120_cov_25.423115	587	667	0	6	80	0.0750000
NODE_4754_length_1120_cov_25.423115	587	667	2	74	80	0.9250000
NODE_4755_length_1120_cov_24.441724	589	662	0	53	73	0.7260274
NODE_4755_length_1120_cov_24.441724	589	662	2	20	73	0.2739726
NODE_4755_length_1120_cov_24.441724	636	716	0	80	80	1.0000000
NODE_4756_length_1120_cov_18.966699	406	486	0	21	80	0.2625000
NODE_4756_length_1120_cov_18.966699	406	486	2	59	80	0.7375000
NODE_4756_length_1120_cov_18.966699	459	539	0	22	80	0.2750000
NODE_4756_length_1120_cov_18.966699	459	539	2	58	80	0.7250000
NODE_4757_length_1120_cov_16.136141	508	588	0	80	80	1.0000000
NODE_4757_length_1120_cov_16.136141	561	641	0	80	80	1.0000000
NODE_4758_length_1120_cov_15.492654	460	540	0	80	80	1.0000000
NODE_4758_length_1120_cov_15.492654	460	540	0	80	80	1.0000000
NODE_4758_length_1120_cov_15.492654	513	593	0	80	80	1.0000000
NODE_4759_length_1120_cov_8.696376	646	726	0	14	80	0.1750000
NODE_4759_length_1120_cov_8.696376	646	726	2	66	80	0.8250000
NODE_4759_length_1120_cov_8.696376	699	779	0	28	80	0.3500000
NODE_4759_length_1120_cov_8.696376	699	779	2	52	80	0.6500000
NODE_4760_length_1120_cov_7.916748	304	384	0	44	80	0.5500000
NODE_4760_length_1120_cov_7.916748	304	384	2	36	80	0.4500000
NODE_4760_length_1120_cov_7.916748	357	437	0	80	80	1.0000000
NODE_4772_length_1119_cov_32.617647	425	505	0	80	80	1.0000000
NODE_4772_length_1119_cov_32.617647	478	558	0	80	80	1.0000000
NODE_4773_length_1119_cov_24.944118	455	535	0	80	80	1.0000000
NODE_4773_length_1119_cov_24.944118	508	588	0	80	80	1.0000000
NODE_4774_length_1119_cov_22.214706	614	694	2	44	80	0.5500000
NODE_4774_length_1119_cov_22.214706	614	694	3	17	80	0.2125000
NODE_4774_length_1119_cov_22.214706	614	694	4	19	80	0.2375000
NODE_4774_length_1119_cov_22.214706	667	747	0	9	80	0.1125000
NODE_4774_length_1119_cov_22.214706	667	747	2	17	80	0.2125000
NODE_4774_length_1119_cov_22.214706	667	747	3	44	80	0.5500000
NODE_4774_length_1119_cov_22.214706	667	747	4	10	80	0.1250000
NODE_4775_length_1119_cov_21.115686	431	511	0	1	80	0.0125000
NODE_4775_length_1119_cov_21.115686	431	511	4	10	80	0.1250000
NODE_4775_length_1119_cov_21.115686	431	511	6	69	80	0.8625000
NODE_4775_length_1119_cov_21.115686	484	564	0	8	80	0.1000000
NODE_4775_length_1119_cov_21.115686	484	564	2	25	80	0.3125000
NODE_4775_length_1119_cov_21.115686	484	564	6	47	80	0.5875000
NODE_4777_length_1119_cov_11.895098	565	645	2	19	80	0.2375000
NODE_4777_length_1119_cov_11.895098	565	645	3	8	80	0.1000000
NODE_4777_length_1119_cov_11.895098	565	645	4	53	80	0.6625000
NODE_4777_length_1119_cov_11.895098	618	698	2	31	80	0.3875000
NODE_4777_length_1119_cov_11.895098	618	698	4	49	80	0.6125000
NODE_4782_length_1119_cov_2.783333	37	99	4	23	62	0.3709677
NODE_4782_length_1119_cov_2.783333	37	99	6	1	62	0.0161290
NODE_4782_length_1119_cov_2.783333	37	99	8	38	62	0.6129032
NODE_4789_length_1118_cov_35.214917	555	635	0	28	80	0.3500000
NODE_4789_length_1118_cov_35.214917	555	635	2	52	80	0.6500000
NODE_4789_length_1118_cov_35.214917	608	688	0	5	80	0.0625000
NODE_4789_length_1118_cov_35.214917	608	688	2	75	80	0.9375000
NODE_4789_length_1118_cov_35.214917	684	764	2	17	80	0.2125000
NODE_4789_length_1118_cov_35.214917	684	764	4	7	80	0.0875000
NODE_4789_length_1118_cov_35.214917	684	764	5	26	80	0.3250000
NODE_4789_length_1118_cov_35.214917	684	764	6	3	80	0.0375000
NODE_4789_length_1118_cov_35.214917	684	764	8	16	80	0.2000000
NODE_4789_length_1118_cov_35.214917	684	764	10	11	80	0.1375000
NODE_4789_length_1118_cov_35.214917	737	817	6	55	80	0.6875000
NODE_4789_length_1118_cov_35.214917	737	817	8	14	80	0.1750000
NODE_4789_length_1118_cov_35.214917	737	817	10	11	80	0.1375000
NODE_4790_length_1118_cov_23.114818	602	682	0	72	80	0.9000000
NODE_4790_length_1118_cov_23.114818	602	682	2	8	80	0.1000000
NODE_4790_length_1118_cov_23.114818	655	735	0	80	80	1.0000000
NODE_4790_length_1118_cov_23.114818	731	811	0	67	80	0.8375000
NODE_4790_length_1118_cov_23.114818	731	811	2	13	80	0.1625000
NODE_4790_length_1118_cov_23.114818	784	864	0	14	80	0.1750000
NODE_4790_length_1118_cov_23.114818	784	864	2	66	80	0.8250000
NODE_4791_length_1118_cov_18.293425	388	463	0	75	75	1.0000000
NODE_4791_length_1118_cov_18.293425	436	516	0	80	80	1.0000000
NODE_4791_length_1118_cov_18.293425	512	592	0	80	80	1.0000000
NODE_4791_length_1118_cov_18.293425	565	645	0	80	80	1.0000000
NODE_4792_length_1118_cov_17.228656	480	560	0	39	80	0.4875000
NODE_4792_length_1118_cov_17.228656	480	560	4	21	80	0.2625000
NODE_4792_length_1118_cov_17.228656	480	560	6	20	80	0.2500000
NODE_4792_length_1118_cov_17.228656	533	613	4	7	80	0.0875000
NODE_4792_length_1118_cov_17.228656	533	613	6	73	80	0.9125000
NODE_4794_length_1118_cov_14.299313	468	548	0	33	80	0.4125000
NODE_4794_length_1118_cov_14.299313	468	548	2	36	80	0.4500000
NODE_4794_length_1118_cov_14.299313	468	548	4	11	80	0.1375000
NODE_4794_length_1118_cov_14.299313	521	601	2	24	80	0.3000000
NODE_4794_length_1118_cov_14.299313	521	601	4	56	80	0.7000000
NODE_4795_length_1118_cov_10.203140	306	386	0	80	80	1.0000000
NODE_4795_length_1118_cov_10.203140	359	439	0	80	80	1.0000000
NODE_4795_length_1118_cov_10.203140	435	515	0	80	80	1.0000000
NODE_4795_length_1118_cov_10.203140	488	568	0	80	80	1.0000000
NODE_4796_length_1118_cov_2.885182	471	551	0	80	80	1.0000000
NODE_4796_length_1118_cov_2.885182	524	604	0	80	80	1.0000000
NODE_4805_length_1117_cov_19.425344	541	621	0	80	80	1.0000000
NODE_4805_length_1117_cov_19.425344	594	674	0	80	80	1.0000000
NODE_4806_length_1117_cov_16.386051	385	465	0	80	80	1.0000000
NODE_4806_length_1117_cov_16.386051	438	518	0	80	80	1.0000000
NODE_4807_length_1117_cov_10.353635	294	374	2	30	80	0.3750000
NODE_4807_length_1117_cov_10.353635	294	374	4	50	80	0.6250000
NODE_4807_length_1117_cov_10.353635	347	427	2	23	80	0.2875000
NODE_4807_length_1117_cov_10.353635	347	427	4	57	80	0.7125000
NODE_4808_length_1117_cov_7.492141	417	497	0	80	80	1.0000000
NODE_4808_length_1117_cov_7.492141	470	550	0	80	80	1.0000000
NODE_4812_length_1117_cov_3.225933	666	728	0	62	62	1.0000000
NODE_4819_length_1116_cov_30.106195	457	537	0	80	80	1.0000000
NODE_4819_length_1116_cov_30.106195	510	590	0	80	80	1.0000000
NODE_4820_length_1116_cov_25.518191	831	911	0	80	80	1.0000000
NODE_4820_length_1116_cov_25.518191	884	964	0	80	80	1.0000000
NODE_4821_length_1116_cov_20.629302	500	580	2	17	80	0.2125000
NODE_4821_length_1116_cov_20.629302	500	580	4	63	80	0.7875000
NODE_4821_length_1116_cov_20.629302	553	633	0	39	80	0.4875000
NODE_4821_length_1116_cov_20.629302	553	633	2	31	80	0.3875000
NODE_4821_length_1116_cov_20.629302	553	633	4	10	80	0.1250000
NODE_4822_length_1116_cov_16.723697	345	425	0	11	80	0.1375000
NODE_4822_length_1116_cov_16.723697	345	425	2	69	80	0.8625000
NODE_4822_length_1116_cov_16.723697	398	478	0	49	80	0.6125000
NODE_4822_length_1116_cov_16.723697	398	478	2	31	80	0.3875000
NODE_4823_length_1116_cov_16.046214	735	815	2	20	80	0.2500000
NODE_4823_length_1116_cov_16.046214	735	815	4	60	80	0.7500000
NODE_4823_length_1116_cov_16.046214	788	868	0	19	80	0.2375000
NODE_4823_length_1116_cov_16.046214	788	868	2	35	80	0.4375000
NODE_4823_length_1116_cov_16.046214	788	868	4	26	80	0.3250000
NODE_4828_length_1116_cov_1.379548	800	880	0	80	80	1.0000000
NODE_4828_length_1116_cov_1.379548	853	933	0	31	80	0.3875000
NODE_4828_length_1116_cov_1.379548	853	933	4	49	80	0.6125000
NODE_4832_length_1115_cov_30.584646	549	629	0	3	80	0.0375000
NODE_4832_length_1115_cov_30.584646	549	629	7	77	80	0.9625000
NODE_4832_length_1115_cov_30.584646	602	682	0	4	80	0.0500000
NODE_4832_length_1115_cov_30.584646	602	682	7	34	80	0.4250000
NODE_4832_length_1115_cov_30.584646	602	682	8	42	80	0.5250000
NODE_4833_length_1115_cov_15.871063	454	534	2	1	80	0.0125000
NODE_4833_length_1115_cov_15.871063	454	534	4	23	80	0.2875000
NODE_4833_length_1115_cov_15.871063	454	534	6	56	80	0.7000000
NODE_4833_length_1115_cov_15.871063	507	587	0	5	80	0.0625000
NODE_4833_length_1115_cov_15.871063	507	587	2	49	80	0.6125000
NODE_4833_length_1115_cov_15.871063	507	587	4	14	80	0.1750000
NODE_4833_length_1115_cov_15.871063	507	587	6	12	80	0.1500000
NODE_4833_length_1115_cov_15.871063	583	663	0	48	80	0.6000000
NODE_4833_length_1115_cov_15.871063	583	663	2	32	80	0.4000000
NODE_4833_length_1115_cov_15.871063	636	716	0	3	80	0.0375000
NODE_4833_length_1115_cov_15.871063	636	716	2	77	80	0.9625000
NODE_4840_length_1114_cov_20.633498	1034	1114	0	20	80	0.2500000
NODE_4840_length_1114_cov_20.633498	1034	1114	4	29	80	0.3625000
NODE_4840_length_1114_cov_20.633498	1034	1114	6	31	80	0.3875000
NODE_4840_length_1114_cov_20.633498	1034	1114	0	20	80	0.2500000
NODE_4840_length_1114_cov_20.633498	1034	1114	4	29	80	0.3625000
NODE_4840_length_1114_cov_20.633498	1034	1114	6	31	80	0.3875000
NODE_4840_length_1114_cov_20.633498	1034	1114	0	20	80	0.2500000
NODE_4840_length_1114_cov_20.633498	1034	1114	4	29	80	0.3625000
NODE_4840_length_1114_cov_20.633498	1034	1114	6	31	80	0.3875000
NODE_4840_length_1114_cov_20.633498	1034	1114	0	20	80	0.2500000
NODE_4840_length_1114_cov_20.633498	1034	1114	4	29	80	0.3625000
NODE_4840_length_1114_cov_20.633498	1034	1114	6	31	80	0.3875000
NODE_4840_length_1114_cov_20.633498	1034	1114	0	20	80	0.2500000
NODE_4840_length_1114_cov_20.633498	1034	1114	4	29	80	0.3625000
NODE_4840_length_1114_cov_20.633498	1034	1114	6	31	80	0.3875000
NODE_4840_length_1114_cov_20.633498	1043	1114	0	20	71	0.2816902
NODE_4840_length_1114_cov_20.633498	1043	1114	4	29	71	0.4084507
NODE_4840_length_1114_cov_20.633498	1043	1114	6	22	71	0.3098592
NODE_4841_length_1114_cov_17.383251	516	601	0	85	85	1.0000000
NODE_4841_length_1114_cov_17.383251	574	653	0	79	79	1.0000000
NODE_4841_length_1114_cov_17.383251	649	729	0	23	80	0.2875000
NODE_4841_length_1114_cov_17.383251	649	729	2	57	80	0.7125000
NODE_4841_length_1114_cov_17.383251	702	782	2	80	80	1.0000000
NODE_4842_length_1114_cov_5.562562	563	643	0	80	80	1.0000000
NODE_4842_length_1114_cov_5.562562	616	696	0	80	80	1.0000000
NODE_4847_length_1113_cov_51.988166	343	423	2	28	80	0.3500000
NODE_4847_length_1113_cov_51.988166	343	423	4	52	80	0.6500000
NODE_4847_length_1113_cov_51.988166	396	476	2	76	80	0.9500000
NODE_4847_length_1113_cov_51.988166	396	476	4	4	80	0.0500000
NODE_4847_length_1113_cov_51.988166	472	552	0	75	80	0.9375000
NODE_4847_length_1113_cov_51.988166	472	552	2	5	80	0.0625000
NODE_4847_length_1113_cov_51.988166	525	605	0	80	80	1.0000000
NODE_4848_length_1113_cov_35.005917	359	439	0	59	80	0.7375000
NODE_4848_length_1113_cov_35.005917	359	439	2	21	80	0.2625000
NODE_4848_length_1113_cov_35.005917	412	492	0	6	80	0.0750000
NODE_4848_length_1113_cov_35.005917	412	492	2	74	80	0.9250000
NODE_4849_length_1113_cov_28.106509	570	650	0	8	80	0.1000000
NODE_4849_length_1113_cov_28.106509	570	650	2	7	80	0.0875000
NODE_4849_length_1113_cov_28.106509	570	650	4	26	80	0.3250000
NODE_4849_length_1113_cov_28.106509	570	650	6	39	80	0.4875000
NODE_4849_length_1113_cov_28.106509	623	703	0	16	80	0.2000000
NODE_4849_length_1113_cov_28.106509	623	703	2	19	80	0.2375000
NODE_4849_length_1113_cov_28.106509	623	703	4	13	80	0.1625000
NODE_4849_length_1113_cov_28.106509	623	703	6	32	80	0.4000000
NODE_4849_length_1113_cov_28.106509	699	779	0	80	80	1.0000000
NODE_4849_length_1113_cov_28.106509	752	832	0	80	80	1.0000000
NODE_4850_length_1113_cov_18.636095	512	592	0	80	80	1.0000000
NODE_4850_length_1113_cov_18.636095	565	645	0	80	80	1.0000000
NODE_4851_length_1113_cov_16.664694	352	432	0	80	80	1.0000000
NODE_4851_length_1113_cov_16.664694	405	485	0	80	80	1.0000000
NODE_4851_length_1113_cov_16.664694	481	561	0	70	80	0.8750000
NODE_4851_length_1113_cov_16.664694	481	561	2	10	80	0.1250000
NODE_4851_length_1113_cov_16.664694	534	614	0	17	80	0.2125000
NODE_4851_length_1113_cov_16.664694	534	614	2	63	80	0.7875000
NODE_4852_length_1113_cov_14.155819	454	512	0	57	58	0.9827586
NODE_4852_length_1113_cov_14.155819	454	512	2	1	58	0.0172414
NODE_4852_length_1113_cov_14.155819	511	575	2	64	64	1.0000000
NODE_4853_length_1113_cov_10.185404	494	574	0	80	80	1.0000000
NODE_4853_length_1113_cov_10.185404	547	627	0	80	80	1.0000000
NODE_4855_length_1113_cov_4.005917	700	780	0	76	80	0.9500000
NODE_4855_length_1113_cov_4.005917	700	780	2	4	80	0.0500000
NODE_4855_length_1113_cov_4.005917	753	833	0	80	80	1.0000000
NODE_4866_length_1112_cov_14.961500	427	507	2	61	80	0.7625000
NODE_4866_length_1112_cov_14.961500	427	507	4	10	80	0.1250000
NODE_4866_length_1112_cov_14.961500	427	507	6	9	80	0.1125000
NODE_4866_length_1112_cov_14.961500	480	560	0	6	80	0.0750000
NODE_4866_length_1112_cov_14.961500	480	560	2	8	80	0.1000000
NODE_4866_length_1112_cov_14.961500	480	560	3	1	80	0.0125000
NODE_4866_length_1112_cov_14.961500	480	560	4	56	80	0.7000000
NODE_4866_length_1112_cov_14.961500	480	560	6	9	80	0.1125000
NODE_4866_length_1112_cov_14.961500	556	636	0	80	80	1.0000000
NODE_4866_length_1112_cov_14.961500	609	689	0	80	80	1.0000000
NODE_4875_length_1112_cov_1.655479	45	123	2	78	78	1.0000000
NODE_4875_length_1112_cov_1.655479	98	166	0	42	68	0.6176471
NODE_4875_length_1112_cov_1.655479	98	166	2	26	68	0.3823529
NODE_4880_length_1111_cov_37.999012	473	553	0	80	80	1.0000000
NODE_4880_length_1111_cov_37.999012	526	606	0	80	80	1.0000000
NODE_4880_length_1111_cov_37.999012	602	682	0	80	80	1.0000000
NODE_4880_length_1111_cov_37.999012	655	735	0	80	80	1.0000000
NODE_4881_length_1111_cov_24.394269	644	724	1	2	80	0.0250000
NODE_4881_length_1111_cov_24.394269	644	724	2	14	80	0.1750000
NODE_4881_length_1111_cov_24.394269	644	724	3	53	80	0.6625000
NODE_4881_length_1111_cov_24.394269	644	724	5	5	80	0.0625000
NODE_4881_length_1111_cov_24.394269	644	724	7	4	80	0.0500000
NODE_4881_length_1111_cov_24.394269	644	724	8	2	80	0.0250000
NODE_4881_length_1111_cov_24.394269	697	777	3	18	80	0.2250000
NODE_4881_length_1111_cov_24.394269	697	777	5	5	80	0.0625000
NODE_4881_length_1111_cov_24.394269	697	777	6	16	80	0.2000000
NODE_4881_length_1111_cov_24.394269	697	777	7	41	80	0.5125000
NODE_4882_length_1111_cov_23.676877	374	454	0	18	80	0.2250000
NODE_4882_length_1111_cov_23.676877	374	454	2	17	80	0.2125000
NODE_4882_length_1111_cov_23.676877	374	454	4	45	80	0.5625000
NODE_4882_length_1111_cov_23.676877	427	507	2	39	80	0.4875000
NODE_4882_length_1111_cov_23.676877	427	507	4	41	80	0.5125000
NODE_4883_length_1111_cov_17.522727	383	463	0	31	80	0.3875000
NODE_4883_length_1111_cov_17.522727	383	463	2	49	80	0.6125000
NODE_4883_length_1111_cov_17.522727	436	516	0	80	80	1.0000000
NODE_4884_length_1111_cov_16.495059	388	468	0	80	80	1.0000000
NODE_4884_length_1111_cov_16.495059	441	521	0	80	80	1.0000000
NODE_4885_length_1111_cov_15.366601	555	635	0	56	80	0.7000000
NODE_4885_length_1111_cov_15.366601	555	635	2	24	80	0.3000000
NODE_4885_length_1111_cov_15.366601	608	688	0	3	80	0.0375000
NODE_4885_length_1111_cov_15.366601	608	688	2	77	80	0.9625000
NODE_4886_length_1111_cov_15.314229	809	889	0	80	80	1.0000000
NODE_4886_length_1111_cov_15.314229	862	942	0	80	80	1.0000000
NODE_4887_length_1111_cov_9.732213	443	523	0	35	80	0.4375000
NODE_4887_length_1111_cov_9.732213	443	523	2	45	80	0.5625000
NODE_4887_length_1111_cov_9.732213	496	576	2	80	80	1.0000000
NODE_4888_length_1111_cov_4.907115	606	686	0	80	80	1.0000000
NODE_4888_length_1111_cov_4.907115	659	739	0	80	80	1.0000000
NODE_4892_length_1110_cov_23.012859	453	533	0	40	80	0.5000000
NODE_4892_length_1110_cov_23.012859	453	533	2	40	80	0.5000000
NODE_4892_length_1110_cov_23.012859	506	586	0	80	80	1.0000000
NODE_4892_length_1110_cov_23.012859	582	662	0	80	80	1.0000000
NODE_4892_length_1110_cov_23.012859	635	715	0	80	80	1.0000000
NODE_4895_length_1110_cov_5.305638	754	834	0	80	80	1.0000000
NODE_4895_length_1110_cov_5.305638	807	887	0	80	80	1.0000000
NODE_4896_length_1110_cov_3.698318	642	685	0	43	43	1.0000000
NODE_4899_length_1110_cov_1.871414	15	86	0	61	71	0.8591549
NODE_4899_length_1110_cov_1.871414	15	86	8	10	71	0.1408451
NODE_4903_length_1109_cov_35.307921	413	493	0	2	80	0.0250000
NODE_4903_length_1109_cov_35.307921	413	493	7	78	80	0.9750000
NODE_4903_length_1109_cov_35.307921	466	546	7	80	80	1.0000000
NODE_4903_length_1109_cov_35.307921	542	622	0	70	80	0.8750000
NODE_4903_length_1109_cov_35.307921	542	622	7	10	80	0.1250000
NODE_4903_length_1109_cov_35.307921	595	675	0	80	80	1.0000000
NODE_4904_length_1109_cov_27.880198	501	581	0	21	80	0.2625000
NODE_4904_length_1109_cov_27.880198	501	581	2	59	80	0.7375000
NODE_4904_length_1109_cov_27.880198	554	634	0	56	80	0.7000000
NODE_4904_length_1109_cov_27.880198	554	634	2	24	80	0.3000000
NODE_4904_length_1109_cov_27.880198	630	710	0	18	80	0.2250000
NODE_4904_length_1109_cov_27.880198	630	710	2	62	80	0.7750000
NODE_4904_length_1109_cov_27.880198	683	763	0	40	80	0.5000000
NODE_4904_length_1109_cov_27.880198	683	763	2	40	80	0.5000000
NODE_4905_length_1109_cov_21.858416	571	651	0	80	80	1.0000000
NODE_4905_length_1109_cov_21.858416	624	704	0	80	80	1.0000000
NODE_4912_length_1108_cov_59.921705	386	466	0	4	80	0.0500000
NODE_4912_length_1108_cov_59.921705	386	466	2	15	80	0.1875000
NODE_4912_length_1108_cov_59.921705	386	466	4	61	80	0.7625000
NODE_4912_length_1108_cov_59.921705	439	519	0	38	80	0.4750000
NODE_4912_length_1108_cov_59.921705	439	519	2	17	80	0.2125000
NODE_4912_length_1108_cov_59.921705	439	519	4	25	80	0.3125000
NODE_4912_length_1108_cov_59.921705	515	595	0	58	80	0.7250000
NODE_4912_length_1108_cov_59.921705	515	595	4	22	80	0.2750000
NODE_4912_length_1108_cov_59.921705	568	648	0	5	80	0.0625000
NODE_4912_length_1108_cov_59.921705	568	648	3	41	80	0.5125000
NODE_4912_length_1108_cov_59.921705	568	648	4	34	80	0.4250000
NODE_4914_length_1108_cov_16.069376	513	593	0	80	80	1.0000000
NODE_4914_length_1108_cov_16.069376	566	646	0	80	80	1.0000000
NODE_4916_length_1108_cov_11.656095	333	413	2	21	80	0.2625000
NODE_4916_length_1108_cov_11.656095	333	413	3	5	80	0.0625000
NODE_4916_length_1108_cov_11.656095	333	413	5	4	80	0.0500000
NODE_4916_length_1108_cov_11.656095	333	413	6	47	80	0.5875000
NODE_4916_length_1108_cov_11.656095	333	413	8	3	80	0.0375000
NODE_4916_length_1108_cov_11.656095	386	466	4	6	80	0.0750000
NODE_4916_length_1108_cov_11.656095	386	466	6	37	80	0.4625000
NODE_4916_length_1108_cov_11.656095	386	466	8	37	80	0.4625000
NODE_4917_length_1108_cov_10.266601	431	511	0	6	80	0.0750000
NODE_4917_length_1108_cov_10.266601	431	511	2	28	80	0.3500000
NODE_4917_length_1108_cov_10.266601	431	511	4	46	80	0.5750000
NODE_4917_length_1108_cov_10.266601	484	564	0	12	80	0.1500000
NODE_4917_length_1108_cov_10.266601	484	564	2	42	80	0.5250000
NODE_4917_length_1108_cov_10.266601	484	564	4	26	80	0.3250000
NODE_4918_length_1108_cov_8.895937	635	715	0	53	80	0.6625000
NODE_4918_length_1108_cov_8.895937	635	715	2	27	80	0.3375000
NODE_4918_length_1108_cov_8.895937	688	768	2	80	80	1.0000000
NODE_4920_length_1108_cov_5.682854	577	657	2	6	80	0.0750000
NODE_4920_length_1108_cov_5.682854	577	657	4	2	80	0.0250000
NODE_4920_length_1108_cov_5.682854	577	657	6	38	80	0.4750000
NODE_4920_length_1108_cov_5.682854	577	657	8	34	80	0.4250000
NODE_4920_length_1108_cov_5.682854	630	710	0	15	80	0.1875000
NODE_4920_length_1108_cov_5.682854	630	710	2	44	80	0.5500000
NODE_4920_length_1108_cov_5.682854	630	710	4	2	80	0.0250000
NODE_4920_length_1108_cov_5.682854	630	710	6	15	80	0.1875000
NODE_4920_length_1108_cov_5.682854	630	710	8	4	80	0.0500000
NODE_4927_length_1107_cov_35.050595	423	503	0	42	80	0.5250000
NODE_4927_length_1107_cov_35.050595	423	503	2	38	80	0.4750000
NODE_4927_length_1107_cov_35.050595	476	556	0	24	80	0.3000000
NODE_4927_length_1107_cov_35.050595	476	556	2	56	80	0.7000000
NODE_4927_length_1107_cov_35.050595	552	632	0	80	80	1.0000000
NODE_4927_length_1107_cov_35.050595	605	685	0	80	80	1.0000000
NODE_4928_length_1107_cov_31.386905	422	502	0	45	80	0.5625000
NODE_4928_length_1107_cov_31.386905	422	502	2	3	80	0.0375000
NODE_4928_length_1107_cov_31.386905	422	502	4	29	80	0.3625000
NODE_4928_length_1107_cov_31.386905	422	502	6	3	80	0.0375000
NODE_4928_length_1107_cov_31.386905	475	555	4	51	80	0.6375000
NODE_4928_length_1107_cov_31.386905	475	555	6	29	80	0.3625000
NODE_4929_length_1107_cov_29.178571	577	657	0	80	80	1.0000000
NODE_4929_length_1107_cov_29.178571	630	710	0	50	80	0.6250000
NODE_4929_length_1107_cov_29.178571	630	710	2	30	80	0.3750000
NODE_4929_length_1107_cov_29.178571	934	1000	2	10	66	0.1515152
NODE_4929_length_1107_cov_29.178571	934	1000	4	31	66	0.4696970
NODE_4929_length_1107_cov_29.178571	934	1000	6	25	66	0.3787879
NODE_4929_length_1107_cov_29.178571	934	1005	2	10	71	0.1408451
NODE_4929_length_1107_cov_29.178571	934	1005	4	31	71	0.4366197
NODE_4929_length_1107_cov_29.178571	934	1005	6	30	71	0.4225352
NODE_4930_length_1107_cov_16.038690	574	654	0	80	80	1.0000000
NODE_4930_length_1107_cov_16.038690	627	707	0	80	80	1.0000000
NODE_4931_length_1107_cov_15.472222	78	158	87	1	80	0.0125000
NODE_4931_length_1107_cov_15.472222	78	158	89	2	80	0.0250000
NODE_4931_length_1107_cov_15.472222	78	158	94	2	80	0.0250000
NODE_4931_length_1107_cov_15.472222	78	158	98	4	80	0.0500000
NODE_4931_length_1107_cov_15.472222	78	158	100	1	80	0.0125000
NODE_4931_length_1107_cov_15.472222	78	158	102	1	80	0.0125000
NODE_4931_length_1107_cov_15.472222	78	158	106	1	80	0.0125000
NODE_4931_length_1107_cov_15.472222	78	158	112	7	80	0.0875000
NODE_4931_length_1107_cov_15.472222	78	158	114	5	80	0.0625000
NODE_4931_length_1107_cov_15.472222	78	158	118	8	80	0.1000000
NODE_4931_length_1107_cov_15.472222	78	158	120	1	80	0.0125000
NODE_4931_length_1107_cov_15.472222	78	158	124	5	80	0.0625000
NODE_4931_length_1107_cov_15.472222	78	158	126	3	80	0.0375000
NODE_4931_length_1107_cov_15.472222	78	158	128	2	80	0.0250000
NODE_4931_length_1107_cov_15.472222	78	158	129	1	80	0.0125000
NODE_4931_length_1107_cov_15.472222	78	158	130	3	80	0.0375000
NODE_4931_length_1107_cov_15.472222	78	158	132	2	80	0.0250000
NODE_4931_length_1107_cov_15.472222	78	158	133	1	80	0.0125000
NODE_4931_length_1107_cov_15.472222	78	158	134	2	80	0.0250000
NODE_4931_length_1107_cov_15.472222	78	158	135	1	80	0.0125000
NODE_4931_length_1107_cov_15.472222	78	158	136	1	80	0.0125000
NODE_4931_length_1107_cov_15.472222	78	158	137	1	80	0.0125000
NODE_4931_length_1107_cov_15.472222	78	158	138	5	80	0.0625000
NODE_4931_length_1107_cov_15.472222	78	158	139	6	80	0.0750000
NODE_4931_length_1107_cov_15.472222	78	158	141	1	80	0.0125000
NODE_4931_length_1107_cov_15.472222	78	158	142	13	80	0.1625000
NODE_4931_length_1107_cov_15.472222	131	194	0	2	63	0.0317460
NODE_4931_length_1107_cov_15.472222	131	194	2	1	63	0.0158730
NODE_4931_length_1107_cov_15.472222	131	194	4	2	63	0.0317460
NODE_4931_length_1107_cov_15.472222	131	194	6	2	63	0.0317460
NODE_4931_length_1107_cov_15.472222	131	194	8	1	63	0.0158730
NODE_4931_length_1107_cov_15.472222	131	194	12	1	63	0.0158730
NODE_4931_length_1107_cov_15.472222	131	194	14	1	63	0.0158730
NODE_4931_length_1107_cov_15.472222	131	194	18	2	63	0.0317460
NODE_4931_length_1107_cov_15.472222	131	194	20	1	63	0.0158730
NODE_4931_length_1107_cov_15.472222	131	194	24	2	63	0.0317460
NODE_4931_length_1107_cov_15.472222	131	194	26	1	63	0.0158730
NODE_4931_length_1107_cov_15.472222	131	194	28	3	63	0.0476190
NODE_4931_length_1107_cov_15.472222	131	194	34	1	63	0.0158730
NODE_4931_length_1107_cov_15.472222	131	194	36	2	63	0.0317460
NODE_4931_length_1107_cov_15.472222	131	194	48	2	63	0.0317460
NODE_4931_length_1107_cov_15.472222	131	194	52	1	63	0.0158730
NODE_4931_length_1107_cov_15.472222	131	194	53	1	63	0.0158730
NODE_4931_length_1107_cov_15.472222	131	194	61	1	63	0.0158730
NODE_4931_length_1107_cov_15.472222	131	194	67	1	63	0.0158730
NODE_4931_length_1107_cov_15.472222	131	194	71	1	63	0.0158730
NODE_4931_length_1107_cov_15.472222	131	194	81	2	63	0.0317460
NODE_4931_length_1107_cov_15.472222	131	194	83	3	63	0.0476190
NODE_4931_length_1107_cov_15.472222	131	194	85	2	63	0.0317460
NODE_4931_length_1107_cov_15.472222	131	194	87	1	63	0.0158730
NODE_4931_length_1107_cov_15.472222	131	194	89	2	63	0.0317460
NODE_4931_length_1107_cov_15.472222	131	194	94	2	63	0.0317460
NODE_4931_length_1107_cov_15.472222	131	194	98	4	63	0.0634921
NODE_4931_length_1107_cov_15.472222	131	194	100	1	63	0.0158730
NODE_4931_length_1107_cov_15.472222	131	194	102	1	63	0.0158730
NODE_4931_length_1107_cov_15.472222	131	194	106	1	63	0.0158730
NODE_4931_length_1107_cov_15.472222	131	194	112	7	63	0.1111111
NODE_4931_length_1107_cov_15.472222	131	194	114	5	63	0.0793651
NODE_4931_length_1107_cov_15.472222	131	194	118	3	63	0.0476190
NODE_4931_length_1107_cov_15.472222	952	995	0	5	43	0.1162791
NODE_4931_length_1107_cov_15.472222	952	995	2	28	43	0.6511628
NODE_4931_length_1107_cov_15.472222	952	995	6	10	43	0.2325581
NODE_4931_length_1107_cov_15.472222	968	1052	2	17	84	0.2023810
NODE_4931_length_1107_cov_15.472222	968	1052	6	16	84	0.1904762
NODE_4931_length_1107_cov_15.472222	968	1052	8	51	84	0.6071429
NODE_4932_length_1107_cov_13.911706	502	582	0	10	80	0.1250000
NODE_4932_length_1107_cov_13.911706	502	582	2	70	80	0.8750000
NODE_4932_length_1107_cov_13.911706	555	635	0	40	80	0.5000000
NODE_4932_length_1107_cov_13.911706	555	635	1	1	80	0.0125000
NODE_4932_length_1107_cov_13.911706	555	635	2	39	80	0.4875000
NODE_4933_length_1107_cov_11.701389	520	600	0	80	80	1.0000000
NODE_4933_length_1107_cov_11.701389	573	653	0	80	80	1.0000000
NODE_4944_length_1106_cov_59.617676	452	532	0	80	80	1.0000000
NODE_4944_length_1106_cov_59.617676	505	585	0	80	80	1.0000000
NODE_4944_length_1106_cov_59.617676	581	661	0	22	80	0.2750000
NODE_4944_length_1106_cov_59.617676	581	661	2	19	80	0.2375000
NODE_4944_length_1106_cov_59.617676	581	661	4	39	80	0.4875000
NODE_4944_length_1106_cov_59.617676	634	714	0	14	80	0.1750000
NODE_4944_length_1106_cov_59.617676	634	714	2	1	80	0.0125000
NODE_4944_length_1106_cov_59.617676	634	714	4	65	80	0.8125000
NODE_4945_length_1106_cov_40.808342	439	504	0	65	65	1.0000000
NODE_4945_length_1106_cov_40.808342	471	511	0	40	40	1.0000000
NODE_4945_length_1106_cov_40.808342	503	569	0	66	66	1.0000000
NODE_4945_length_1106_cov_40.808342	536	601	0	65	65	1.0000000
NODE_4945_length_1106_cov_40.808342	568	648	0	48	80	0.6000000
NODE_4945_length_1106_cov_40.808342	568	648	2	32	80	0.4000000
NODE_4945_length_1106_cov_40.808342	621	682	2	61	61	1.0000000
NODE_4946_length_1106_cov_23.186693	560	640	2	16	80	0.2000000
NODE_4946_length_1106_cov_23.186693	560	640	3	18	80	0.2250000
NODE_4946_length_1106_cov_23.186693	560	640	4	33	80	0.4125000
NODE_4946_length_1106_cov_23.186693	560	640	6	13	80	0.1625000
NODE_4946_length_1106_cov_23.186693	613	693	2	67	80	0.8375000
NODE_4946_length_1106_cov_23.186693	613	693	3	13	80	0.1625000
NODE_4947_length_1106_cov_14.570010	466	546	0	80	80	1.0000000
NODE_4947_length_1106_cov_14.570010	519	599	0	80	80	1.0000000
NODE_4948_length_1106_cov_14.039722	487	567	0	28	80	0.3500000
NODE_4948_length_1106_cov_14.039722	487	567	2	52	80	0.6500000
NODE_4948_length_1106_cov_14.039722	540	620	0	33	80	0.4125000
NODE_4948_length_1106_cov_14.039722	540	620	2	47	80	0.5875000
NODE_4949_length_1106_cov_8.872890	328	408	0	80	80	1.0000000
NODE_4949_length_1106_cov_8.872890	381	461	0	80	80	1.0000000
NODE_4950_length_1106_cov_7.157895	332	412	0	19	80	0.2375000
NODE_4950_length_1106_cov_7.157895	332	412	2	9	80	0.1125000
NODE_4950_length_1106_cov_7.157895	332	412	4	33	80	0.4125000
NODE_4950_length_1106_cov_7.157895	332	412	9	19	80	0.2375000
NODE_4950_length_1106_cov_7.157895	385	465	4	8	80	0.1000000
NODE_4950_length_1106_cov_7.157895	385	465	5	19	80	0.2375000
NODE_4950_length_1106_cov_7.157895	385	465	7	22	80	0.2750000
NODE_4950_length_1106_cov_7.157895	385	465	9	31	80	0.3875000
NODE_4951_length_1106_cov_6.530288	513	593	0	80	80	1.0000000
NODE_4951_length_1106_cov_6.530288	566	646	0	80	80	1.0000000
NODE_4959_length_1105_cov_28.126243	253	333	0	21	80	0.2625000
NODE_4959_length_1105_cov_28.126243	253	333	2	5	80	0.0625000
NODE_4959_length_1105_cov_28.126243	253	333	4	18	80	0.2250000
NODE_4959_length_1105_cov_28.126243	253	333	6	9	80	0.1125000
NODE_4959_length_1105_cov_28.126243	253	333	8	27	80	0.3375000
NODE_4959_length_1105_cov_28.126243	306	386	4	2	80	0.0250000
NODE_4959_length_1105_cov_28.126243	306	386	6	2	80	0.0250000
NODE_4959_length_1105_cov_28.126243	306	386	8	76	80	0.9500000
NODE_4960_length_1105_cov_24.994036	549	629	0	80	80	1.0000000
NODE_4960_length_1105_cov_24.994036	602	682	0	80	80	1.0000000
NODE_4961_length_1105_cov_17.635189	442	522	0	34	80	0.4250000
NODE_4961_length_1105_cov_17.635189	442	522	2	46	80	0.5750000
NODE_4961_length_1105_cov_17.635189	495	575	0	3	80	0.0375000
NODE_4961_length_1105_cov_17.635189	495	575	2	77	80	0.9625000
NODE_4963_length_1105_cov_10.114314	438	518	0	80	80	1.0000000
NODE_4963_length_1105_cov_10.114314	491	571	0	71	80	0.8875000
NODE_4963_length_1105_cov_10.114314	491	571	2	9	80	0.1125000
NODE_4964_length_1105_cov_8.403579	507	587	0	80	80	1.0000000
NODE_4964_length_1105_cov_8.403579	560	640	0	80	80	1.0000000
NODE_4966_length_1105_cov_6.682903	467	547	0	80	80	1.0000000
NODE_4966_length_1105_cov_6.682903	520	600	0	44	80	0.5500000
NODE_4966_length_1105_cov_6.682903	520	600	2	36	80	0.4500000
NODE_4966_length_1105_cov_6.682903	596	676	0	6	80	0.0750000
NODE_4966_length_1105_cov_6.682903	596	676	2	74	80	0.9250000
NODE_4966_length_1105_cov_6.682903	649	729	0	59	80	0.7375000
NODE_4966_length_1105_cov_6.682903	649	729	2	21	80	0.2625000
NODE_4974_length_1104_cov_27.599005	388	468	0	71	80	0.8875000
NODE_4974_length_1104_cov_27.599005	388	468	2	9	80	0.1125000
NODE_4974_length_1104_cov_27.599005	441	521	0	18	80	0.2250000
NODE_4974_length_1104_cov_27.599005	441	521	2	62	80	0.7750000
NODE_4984_length_1103_cov_2.787849	620	682	0	62	62	1.0000000
NODE_4986_length_1102_cov_34.484546	667	747	0	33	80	0.4125000
NODE_4986_length_1102_cov_34.484546	667	747	2	47	80	0.5875000
NODE_4986_length_1102_cov_34.484546	720	800	0	23	80	0.2875000
NODE_4986_length_1102_cov_34.484546	720	800	2	57	80	0.7125000
NODE_4987_length_1102_cov_17.631107	511	587	0	76	76	1.0000000
NODE_4987_length_1102_cov_17.631107	560	640	0	80	80	1.0000000
NODE_4998_length_1101_cov_35.638723	414	491	6	46	77	0.5974026
NODE_4998_length_1101_cov_35.638723	414	491	8	18	77	0.2337662
NODE_4998_length_1101_cov_35.638723	414	491	10	2	77	0.0259740
NODE_4998_length_1101_cov_35.638723	414	491	12	11	77	0.1428571
NODE_4998_length_1101_cov_35.638723	414	491	6	46	77	0.5974026
NODE_4998_length_1101_cov_35.638723	414	491	8	18	77	0.2337662
NODE_4998_length_1101_cov_35.638723	414	491	10	2	77	0.0259740
NODE_4998_length_1101_cov_35.638723	414	491	12	11	77	0.1428571
NODE_4998_length_1101_cov_35.638723	488	544	8	10	56	0.1785714
NODE_4998_length_1101_cov_35.638723	488	544	10	20	56	0.3571429
NODE_4998_length_1101_cov_35.638723	488	544	12	18	56	0.3214286
NODE_4998_length_1101_cov_35.638723	488	544	14	8	56	0.1428571
NODE_4998_length_1101_cov_35.638723	752	832	0	40	80	0.5000000
NODE_4998_length_1101_cov_35.638723	752	832	2	40	80	0.5000000
NODE_4998_length_1101_cov_35.638723	805	885	0	80	80	1.0000000
NODE_4998_length_1101_cov_35.638723	881	961	0	37	80	0.4625000
NODE_4998_length_1101_cov_35.638723	881	961	12	43	80	0.5375000
NODE_4998_length_1101_cov_35.638723	934	1014	12	80	80	1.0000000
NODE_4999_length_1101_cov_28.366267	452	532	0	6	80	0.0750000
NODE_4999_length_1101_cov_28.366267	452	532	2	74	80	0.9250000
NODE_4999_length_1101_cov_28.366267	505	585	0	42	80	0.5250000
NODE_4999_length_1101_cov_28.366267	505	585	2	38	80	0.4750000
NODE_5000_length_1101_cov_24.513972	475	555	0	80	80	1.0000000
NODE_5000_length_1101_cov_24.513972	528	608	0	80	80	1.0000000
NODE_5001_length_1101_cov_22.315369	335	415	0	17	80	0.2125000
NODE_5001_length_1101_cov_22.315369	335	415	3	1	80	0.0125000
NODE_5001_length_1101_cov_22.315369	335	415	4	62	80	0.7750000
NODE_5001_length_1101_cov_22.315369	388	468	0	12	80	0.1500000
NODE_5001_length_1101_cov_22.315369	388	468	2	25	80	0.3125000
NODE_5001_length_1101_cov_22.315369	388	468	3	1	80	0.0125000
NODE_5001_length_1101_cov_22.315369	388	468	4	42	80	0.5250000
NODE_5001_length_1101_cov_22.315369	464	544	2	17	80	0.2125000
NODE_5001_length_1101_cov_22.315369	464	544	4	20	80	0.2500000
NODE_5001_length_1101_cov_22.315369	464	544	8	43	80	0.5375000
NODE_5001_length_1101_cov_22.315369	517	597	4	28	80	0.3500000
NODE_5001_length_1101_cov_22.315369	517	597	6	19	80	0.2375000
NODE_5001_length_1101_cov_22.315369	517	597	8	33	80	0.4125000
NODE_5002_length_1101_cov_22.070858	419	499	0	80	80	1.0000000
NODE_5002_length_1101_cov_22.070858	472	552	0	80	80	1.0000000
NODE_5002_length_1101_cov_22.070858	548	628	0	62	80	0.7750000
NODE_5002_length_1101_cov_22.070858	548	628	4	18	80	0.2250000
NODE_5002_length_1101_cov_22.070858	601	681	0	9	80	0.1125000
NODE_5002_length_1101_cov_22.070858	601	681	4	71	80	0.8875000
NODE_5003_length_1101_cov_18.821357	469	549	0	24	80	0.3000000
NODE_5003_length_1101_cov_18.821357	469	549	1	56	80	0.7000000
NODE_5003_length_1101_cov_18.821357	522	602	1	80	80	1.0000000
NODE_5004_length_1101_cov_17.151697	502	582	0	1	80	0.0125000
NODE_5004_length_1101_cov_17.151697	502	582	2	7	80	0.0875000
NODE_5004_length_1101_cov_17.151697	502	582	4	72	80	0.9000000
NODE_5004_length_1101_cov_17.151697	555	635	2	37	80	0.4625000
NODE_5004_length_1101_cov_17.151697	555	635	4	43	80	0.5375000
NODE_5005_length_1101_cov_8.371257	968	1048	9	1	80	0.0125000
NODE_5005_length_1101_cov_8.371257	968	1048	13	2	80	0.0250000
NODE_5005_length_1101_cov_8.371257	968	1048	14	15	80	0.1875000
NODE_5005_length_1101_cov_8.371257	968	1048	16	49	80	0.6125000
NODE_5005_length_1101_cov_8.371257	968	1048	18	13	80	0.1625000
NODE_5010_length_1100_cov_42.528472	582	662	0	80	80	1.0000000
NODE_5010_length_1100_cov_42.528472	635	715	0	80	80	1.0000000
NODE_5010_length_1100_cov_42.528472	711	791	0	80	80	1.0000000
NODE_5010_length_1100_cov_42.528472	764	844	0	80	80	1.0000000
NODE_5011_length_1100_cov_40.883117	324	404	0	80	80	1.0000000
NODE_5011_length_1100_cov_40.883117	377	457	0	80	80	1.0000000
NODE_5011_length_1100_cov_40.883117	453	533	0	34	80	0.4250000
NODE_5011_length_1100_cov_40.883117	453	533	2	42	80	0.5250000
NODE_5011_length_1100_cov_40.883117	453	533	4	4	80	0.0500000
NODE_5011_length_1100_cov_40.883117	506	586	2	23	80	0.2875000
NODE_5011_length_1100_cov_40.883117	506	586	4	29	80	0.3625000
NODE_5011_length_1100_cov_40.883117	506	586	6	28	80	0.3500000
NODE_5012_length_1100_cov_23.160839	524	604	0	53	80	0.6625000
NODE_5012_length_1100_cov_23.160839	524	604	2	27	80	0.3375000
NODE_5012_length_1100_cov_23.160839	577	657	0	25	80	0.3125000
NODE_5012_length_1100_cov_23.160839	577	657	2	55	80	0.6875000
NODE_5012_length_1100_cov_23.160839	653	733	0	45	80	0.5625000
NODE_5012_length_1100_cov_23.160839	653	733	4	19	80	0.2375000
NODE_5012_length_1100_cov_23.160839	653	733	6	16	80	0.2000000
NODE_5012_length_1100_cov_23.160839	706	786	4	11	80	0.1375000
NODE_5012_length_1100_cov_23.160839	706	786	6	69	80	0.8625000
NODE_5013_length_1100_cov_22.200799	485	565	0	80	80	1.0000000
NODE_5013_length_1100_cov_22.200799	538	618	0	80	80	1.0000000
NODE_5013_length_1100_cov_22.200799	614	694	0	74	80	0.9250000
NODE_5013_length_1100_cov_22.200799	614	694	2	6	80	0.0750000
NODE_5013_length_1100_cov_22.200799	667	745	0	21	78	0.2692308
NODE_5013_length_1100_cov_22.200799	667	745	2	57	78	0.7307692
NODE_5014_length_1100_cov_15.353646	472	552	2	38	80	0.4750000
NODE_5014_length_1100_cov_15.353646	472	552	4	42	80	0.5250000
NODE_5014_length_1100_cov_15.353646	525	605	0	21	80	0.2625000
NODE_5014_length_1100_cov_15.353646	525	605	2	31	80	0.3875000
NODE_5014_length_1100_cov_15.353646	525	605	4	28	80	0.3500000
NODE_5015_length_1100_cov_14.584416	673	753	0	3	80	0.0375000
NODE_5015_length_1100_cov_14.584416	673	753	2	77	80	0.9625000
NODE_5015_length_1100_cov_14.584416	726	806	0	22	80	0.2750000
NODE_5015_length_1100_cov_14.584416	726	806	2	49	80	0.6125000
NODE_5015_length_1100_cov_14.584416	726	806	8	9	80	0.1125000
NODE_5029_length_1099_cov_85.893000	464	544	6	39	80	0.4875000
NODE_5029_length_1099_cov_85.893000	464	544	8	41	80	0.5125000
NODE_5029_length_1099_cov_85.893000	517	597	4	24	80	0.3000000
NODE_5029_length_1099_cov_85.893000	517	597	6	33	80	0.4125000
NODE_5029_length_1099_cov_85.893000	517	597	8	23	80	0.2875000
NODE_5029_length_1099_cov_85.893000	593	673	0	74	80	0.9250000
NODE_5029_length_1099_cov_85.893000	593	673	2	2	80	0.0250000
NODE_5029_length_1099_cov_85.893000	593	673	4	4	80	0.0500000
NODE_5029_length_1099_cov_85.893000	646	726	0	50	80	0.6250000
NODE_5029_length_1099_cov_85.893000	646	726	2	30	80	0.3750000
NODE_5030_length_1099_cov_45.874000	521	601	0	14	80	0.1750000
NODE_5030_length_1099_cov_45.874000	521	601	2	66	80	0.8250000
NODE_5030_length_1099_cov_45.874000	574	654	2	65	80	0.8125000
NODE_5030_length_1099_cov_45.874000	574	654	4	15	80	0.1875000
NODE_5030_length_1099_cov_45.874000	650	730	2	62	80	0.7750000
NODE_5030_length_1099_cov_45.874000	650	730	4	18	80	0.2250000
NODE_5030_length_1099_cov_45.874000	703	783	0	46	80	0.5750000
NODE_5030_length_1099_cov_45.874000	703	783	2	34	80	0.4250000
NODE_5031_length_1099_cov_25.192000	526	606	0	4	80	0.0500000
NODE_5031_length_1099_cov_25.192000	526	606	2	76	80	0.9500000
NODE_5031_length_1099_cov_25.192000	579	659	0	48	80	0.6000000
NODE_5031_length_1099_cov_25.192000	579	659	2	32	80	0.4000000
NODE_5032_length_1099_cov_11.846000	565	645	0	39	80	0.4875000
NODE_5032_length_1099_cov_11.846000	565	645	2	41	80	0.5125000
NODE_5032_length_1099_cov_11.846000	618	698	2	80	80	1.0000000
NODE_5033_length_1099_cov_9.527000	495	575	4	19	80	0.2375000
NODE_5033_length_1099_cov_9.527000	495	575	6	61	80	0.7625000
NODE_5033_length_1099_cov_9.527000	548	628	0	40	80	0.5000000
NODE_5033_length_1099_cov_9.527000	548	628	2	6	80	0.0750000
NODE_5033_length_1099_cov_9.527000	548	628	4	12	80	0.1500000
NODE_5033_length_1099_cov_9.527000	548	628	6	22	80	0.2750000
NODE_5034_length_1099_cov_8.993000	464	544	0	80	80	1.0000000
NODE_5034_length_1099_cov_8.993000	517	597	0	80	80	1.0000000
NODE_5039_length_1099_cov_2.286000	273	353	0	80	80	1.0000000
NODE_5045_length_1098_cov_44.988989	360	440	0	80	80	1.0000000
NODE_5045_length_1098_cov_44.988989	413	493	0	80	80	1.0000000
NODE_5046_length_1098_cov_35.192192	452	532	0	25	80	0.3125000
NODE_5046_length_1098_cov_35.192192	452	532	2	34	80	0.4250000
NODE_5046_length_1098_cov_35.192192	452	532	6	21	80	0.2625000
NODE_5046_length_1098_cov_35.192192	505	585	2	6	80	0.0750000
NODE_5046_length_1098_cov_35.192192	505	585	4	27	80	0.3375000
NODE_5046_length_1098_cov_35.192192	505	585	6	47	80	0.5875000
NODE_5046_length_1098_cov_35.192192	581	661	0	24	80	0.3000000
NODE_5046_length_1098_cov_35.192192	581	661	2	6	80	0.0750000
NODE_5046_length_1098_cov_35.192192	581	661	4	12	80	0.1500000
NODE_5046_length_1098_cov_35.192192	581	661	8	3	80	0.0375000
NODE_5046_length_1098_cov_35.192192	581	661	10	35	80	0.4375000
NODE_5046_length_1098_cov_35.192192	634	714	8	4	80	0.0500000
NODE_5046_length_1098_cov_35.192192	634	714	10	76	80	0.9500000
NODE_5047_length_1098_cov_28.743744	449	529	2	45	80	0.5625000
NODE_5047_length_1098_cov_28.743744	449	529	4	1	80	0.0125000
NODE_5047_length_1098_cov_28.743744	449	529	6	34	80	0.4250000
NODE_5047_length_1098_cov_28.743744	502	582	4	54	80	0.6750000
NODE_5047_length_1098_cov_28.743744	502	582	6	26	80	0.3250000
NODE_5047_length_1098_cov_28.743744	578	658	4	72	80	0.9000000
NODE_5047_length_1098_cov_28.743744	578	658	6	7	80	0.0875000
NODE_5047_length_1098_cov_28.743744	578	658	8	1	80	0.0125000
NODE_5047_length_1098_cov_28.743744	631	711	2	6	80	0.0750000
NODE_5047_length_1098_cov_28.743744	631	711	4	36	80	0.4500000
NODE_5047_length_1098_cov_28.743744	631	711	6	38	80	0.4750000
NODE_5048_length_1098_cov_28.230230	477	557	2	80	80	1.0000000
NODE_5048_length_1098_cov_28.230230	530	610	0	28	80	0.3500000
NODE_5048_length_1098_cov_28.230230	530	610	2	52	80	0.6500000
NODE_5048_length_1098_cov_28.230230	606	686	0	42	80	0.5250000
NODE_5048_length_1098_cov_28.230230	606	686	2	38	80	0.4750000
NODE_5048_length_1098_cov_28.230230	659	739	2	80	80	1.0000000
NODE_5049_length_1098_cov_26.131131	494	574	0	80	80	1.0000000
NODE_5049_length_1098_cov_26.131131	547	627	0	80	80	1.0000000
NODE_5050_length_1098_cov_21.355355	599	679	2	19	80	0.2375000
NODE_5050_length_1098_cov_21.355355	599	679	4	17	80	0.2125000
NODE_5050_length_1098_cov_21.355355	599	679	6	44	80	0.5500000
NODE_5050_length_1098_cov_21.355355	652	732	0	9	80	0.1125000
NODE_5050_length_1098_cov_21.355355	652	732	2	2	80	0.0250000
NODE_5050_length_1098_cov_21.355355	652	732	4	16	80	0.2000000
NODE_5050_length_1098_cov_21.355355	652	732	6	53	80	0.6625000
NODE_5051_length_1098_cov_17.087087	541	621	0	29	80	0.3625000
NODE_5051_length_1098_cov_17.087087	541	621	2	51	80	0.6375000
NODE_5051_length_1098_cov_17.087087	594	674	0	31	80	0.3875000
NODE_5051_length_1098_cov_17.087087	594	674	2	49	80	0.6125000
NODE_5051_length_1098_cov_17.087087	670	750	0	52	80	0.6500000
NODE_5051_length_1098_cov_17.087087	670	750	2	3	80	0.0375000
NODE_5051_length_1098_cov_17.087087	670	750	4	9	80	0.1125000
NODE_5051_length_1098_cov_17.087087	670	750	6	16	80	0.2000000
NODE_5051_length_1098_cov_17.087087	723	803	2	2	80	0.0250000
NODE_5051_length_1098_cov_17.087087	723	803	4	9	80	0.1125000
NODE_5051_length_1098_cov_17.087087	723	803	6	18	80	0.2250000
NODE_5051_length_1098_cov_17.087087	723	803	8	51	80	0.6375000
NODE_5052_length_1098_cov_15.455455	545	625	0	80	80	1.0000000
NODE_5052_length_1098_cov_15.455455	598	678	0	80	80	1.0000000
NODE_5052_length_1098_cov_15.455455	674	754	0	80	80	1.0000000
NODE_5052_length_1098_cov_15.455455	727	807	0	80	80	1.0000000
NODE_5054_length_1097_cov_37.103206	438	518	0	18	80	0.2250000
NODE_5054_length_1097_cov_37.103206	438	518	2	62	80	0.7750000
NODE_5054_length_1097_cov_37.103206	491	571	0	71	80	0.8875000
NODE_5054_length_1097_cov_37.103206	491	571	2	9	80	0.1125000
NODE_5054_length_1097_cov_37.103206	567	647	0	23	80	0.2875000
NODE_5054_length_1097_cov_37.103206	567	647	2	57	80	0.7125000
NODE_5054_length_1097_cov_37.103206	620	700	0	38	80	0.4750000
NODE_5054_length_1097_cov_37.103206	620	700	2	42	80	0.5250000
NODE_5055_length_1097_cov_32.624248	501	581	4	15	80	0.1875000
NODE_5055_length_1097_cov_32.624248	501	581	8	8	80	0.1000000
NODE_5055_length_1097_cov_32.624248	501	581	10	20	80	0.2500000
NODE_5055_length_1097_cov_32.624248	501	581	12	37	80	0.4625000
NODE_5055_length_1097_cov_32.624248	554	634	0	12	80	0.1500000
NODE_5055_length_1097_cov_32.624248	554	634	2	29	80	0.3625000
NODE_5055_length_1097_cov_32.624248	554	634	4	27	80	0.3375000
NODE_5055_length_1097_cov_32.624248	554	634	8	8	80	0.1000000
NODE_5055_length_1097_cov_32.624248	554	634	12	4	80	0.0500000
NODE_5056_length_1097_cov_25.240481	401	480	0	79	79	1.0000000
NODE_5056_length_1097_cov_25.240481	453	533	0	80	80	1.0000000
NODE_5056_length_1097_cov_25.240481	529	609	0	80	80	1.0000000
NODE_5056_length_1097_cov_25.240481	582	662	0	80	80	1.0000000
NODE_5057_length_1097_cov_21.221443	484	564	0	80	80	1.0000000
NODE_5057_length_1097_cov_21.221443	537	617	0	80	80	1.0000000
NODE_5057_length_1097_cov_21.221443	613	693	0	80	80	1.0000000
NODE_5057_length_1097_cov_21.221443	666	746	0	80	80	1.0000000
NODE_5058_length_1097_cov_20.968938	515	595	0	2	80	0.0250000
NODE_5058_length_1097_cov_20.968938	515	595	2	78	80	0.9750000
NODE_5058_length_1097_cov_20.968938	568	648	0	27	80	0.3375000
NODE_5058_length_1097_cov_20.968938	568	648	2	53	80	0.6625000
NODE_5059_length_1097_cov_13.136273	697	779	0	82	82	1.0000000
NODE_5059_length_1097_cov_13.136273	752	832	0	80	80	1.0000000
NODE_5060_length_1097_cov_6.376754	442	522	0	55	80	0.6875000
NODE_5060_length_1097_cov_6.376754	442	522	2	25	80	0.3125000
NODE_5060_length_1097_cov_6.376754	495	575	0	7	80	0.0875000
NODE_5060_length_1097_cov_6.376754	495	575	2	73	80	0.9125000
NODE_5061_length_1097_cov_6.068136	299	379	0	80	80	1.0000000
NODE_5061_length_1097_cov_6.068136	352	432	0	80	80	1.0000000
NODE_5072_length_1096_cov_55.816449	430	510	0	51	80	0.6375000
NODE_5072_length_1096_cov_55.816449	430	510	2	29	80	0.3625000
NODE_5072_length_1096_cov_55.816449	483	563	0	8	80	0.1000000
NODE_5072_length_1096_cov_55.816449	483	563	2	72	80	0.9000000
NODE_5072_length_1096_cov_55.816449	559	639	0	6	80	0.0750000
NODE_5072_length_1096_cov_55.816449	559	639	2	11	80	0.1375000
NODE_5072_length_1096_cov_55.816449	559	639	4	18	80	0.2250000
NODE_5072_length_1096_cov_55.816449	559	639	8	45	80	0.5625000
NODE_5072_length_1096_cov_55.816449	612	692	0	5	80	0.0625000
NODE_5072_length_1096_cov_55.816449	612	692	2	3	80	0.0375000
NODE_5072_length_1096_cov_55.816449	612	692	6	39	80	0.4875000
NODE_5072_length_1096_cov_55.816449	612	692	8	33	80	0.4125000
NODE_5073_length_1096_cov_24.672016	431	511	0	80	80	1.0000000
NODE_5073_length_1096_cov_24.672016	484	564	0	80	80	1.0000000
NODE_5073_length_1096_cov_24.672016	560	640	0	80	80	1.0000000
NODE_5073_length_1096_cov_24.672016	613	693	0	80	80	1.0000000
NODE_5074_length_1096_cov_22.980943	372	452	4	12	80	0.1500000
NODE_5074_length_1096_cov_22.980943	372	452	6	68	80	0.8500000
NODE_5074_length_1096_cov_22.980943	425	505	2	28	80	0.3500000
NODE_5074_length_1096_cov_22.980943	425	505	4	3	80	0.0375000
NODE_5074_length_1096_cov_22.980943	425	505	6	49	80	0.6125000
NODE_5075_length_1096_cov_16.649950	486	566	0	76	80	0.9500000
NODE_5075_length_1096_cov_16.649950	486	566	2	4	80	0.0500000
NODE_5075_length_1096_cov_16.649950	539	619	0	23	80	0.2875000
NODE_5075_length_1096_cov_16.649950	539	619	2	57	80	0.7125000
NODE_5076_length_1096_cov_16.433300	443	523	0	68	80	0.8500000
NODE_5076_length_1096_cov_16.433300	443	523	2	12	80	0.1500000
NODE_5076_length_1096_cov_16.433300	496	576	0	15	80	0.1875000
NODE_5076_length_1096_cov_16.433300	496	576	2	65	80	0.8125000
NODE_5076_length_1096_cov_16.433300	886	966	0	36	80	0.4500000
NODE_5076_length_1096_cov_16.433300	886	966	2	44	80	0.5500000
NODE_5076_length_1096_cov_16.433300	939	1018	0	73	79	0.9240506
NODE_5076_length_1096_cov_16.433300	939	1018	2	6	79	0.0759494
NODE_5077_length_1096_cov_13.398195	670	750	0	80	80	1.0000000
NODE_5077_length_1096_cov_13.398195	723	803	0	80	80	1.0000000
NODE_5080_length_1095_cov_25.390562	520	600	0	6	80	0.0750000
NODE_5080_length_1095_cov_25.390562	520	600	2	74	80	0.9250000
NODE_5080_length_1095_cov_25.390562	573	653	0	32	80	0.4000000
NODE_5080_length_1095_cov_25.390562	573	653	2	48	80	0.6000000
NODE_5080_length_1095_cov_25.390562	649	729	0	27	80	0.3375000
NODE_5080_length_1095_cov_25.390562	649	729	2	53	80	0.6625000
NODE_5080_length_1095_cov_25.390562	702	782	0	26	80	0.3250000
NODE_5080_length_1095_cov_25.390562	702	782	2	54	80	0.6750000
NODE_5081_length_1095_cov_13.832329	549	629	2	32	80	0.4000000
NODE_5081_length_1095_cov_13.832329	549	629	4	48	80	0.6000000
NODE_5081_length_1095_cov_13.832329	602	682	0	6	80	0.0750000
NODE_5081_length_1095_cov_13.832329	602	682	1	11	80	0.1375000
NODE_5081_length_1095_cov_13.832329	602	682	2	5	80	0.0625000
NODE_5081_length_1095_cov_13.832329	602	682	3	1	80	0.0125000
NODE_5081_length_1095_cov_13.832329	602	682	4	57	80	0.7125000
NODE_5082_length_1095_cov_13.017068	497	577	0	21	80	0.2625000
NODE_5082_length_1095_cov_13.017068	497	577	2	59	80	0.7375000
NODE_5082_length_1095_cov_13.017068	550	630	0	1	80	0.0125000
NODE_5082_length_1095_cov_13.017068	550	630	2	79	80	0.9875000
NODE_5083_length_1095_cov_7.640562	627	707	0	30	80	0.3750000
NODE_5083_length_1095_cov_7.640562	627	707	2	17	80	0.2125000
NODE_5083_length_1095_cov_7.640562	627	707	4	33	80	0.4125000
NODE_5083_length_1095_cov_7.640562	680	760	0	44	80	0.5500000
NODE_5083_length_1095_cov_7.640562	680	760	2	4	80	0.0500000
NODE_5083_length_1095_cov_7.640562	680	760	4	32	80	0.4000000
NODE_5085_length_1095_cov_4.664659	307	387	4	54	80	0.6750000
NODE_5085_length_1095_cov_4.664659	307	387	6	26	80	0.3250000
NODE_5089_length_1094_cov_35.850251	409	489	0	80	80	1.0000000
NODE_5089_length_1094_cov_35.850251	462	542	0	80	80	1.0000000
NODE_5089_length_1094_cov_35.850251	538	618	0	5	80	0.0625000
NODE_5089_length_1094_cov_35.850251	538	618	2	28	80	0.3500000
NODE_5089_length_1094_cov_35.850251	538	618	4	42	80	0.5250000
NODE_5089_length_1094_cov_35.850251	538	618	6	5	80	0.0625000
NODE_5089_length_1094_cov_35.850251	591	671	4	22	80	0.2750000
NODE_5089_length_1094_cov_35.850251	591	671	6	48	80	0.6000000
NODE_5089_length_1094_cov_35.850251	591	671	8	10	80	0.1250000
NODE_5090_length_1094_cov_27.197990	462	542	0	80	80	1.0000000
NODE_5090_length_1094_cov_27.197990	515	595	0	80	80	1.0000000
NODE_5091_length_1094_cov_19.282412	451	531	0	4	80	0.0500000
NODE_5091_length_1094_cov_19.282412	451	531	2	34	80	0.4250000
NODE_5091_length_1094_cov_19.282412	451	531	4	42	80	0.5250000
NODE_5091_length_1094_cov_19.282412	504	584	0	8	80	0.1000000
NODE_5091_length_1094_cov_19.282412	504	584	2	12	80	0.1500000
NODE_5091_length_1094_cov_19.282412	504	584	4	60	80	0.7500000
NODE_5092_length_1094_cov_16.084422	558	614	0	56	56	1.0000000
NODE_5092_length_1094_cov_16.084422	587	667	0	80	80	1.0000000
NODE_5093_length_1094_cov_11.335678	384	464	4	36	80	0.4500000
NODE_5093_length_1094_cov_11.335678	384	464	6	20	80	0.2500000
NODE_5093_length_1094_cov_11.335678	384	464	8	24	80	0.3000000
NODE_5093_length_1094_cov_11.335678	437	517	0	42	80	0.5250000
NODE_5093_length_1094_cov_11.335678	437	517	2	6	80	0.0750000
NODE_5093_length_1094_cov_11.335678	437	517	4	32	80	0.4000000
NODE_5094_length_1094_cov_10.767839	396	476	0	80	80	1.0000000
NODE_5094_length_1094_cov_10.767839	449	529	0	80	80	1.0000000
NODE_5095_length_1094_cov_9.527638	579	659	0	10	80	0.1250000
NODE_5095_length_1094_cov_9.527638	579	659	2	70	80	0.8750000
NODE_5095_length_1094_cov_9.527638	632	712	0	31	80	0.3875000
NODE_5095_length_1094_cov_9.527638	632	712	2	49	80	0.6125000
NODE_5096_length_1094_cov_9.166834	527	607	6	80	80	1.0000000
NODE_5096_length_1094_cov_9.166834	580	660	6	80	80	1.0000000
NODE_5097_length_1094_cov_5.632161	708	768	0	60	60	1.0000000
NODE_5097_length_1094_cov_5.632161	761	821	0	20	60	0.3333333
NODE_5097_length_1094_cov_5.632161	761	821	2	19	60	0.3166667
NODE_5097_length_1094_cov_5.632161	761	821	6	21	60	0.3500000
NODE_5108_length_1093_cov_28.531187	374	454	4	80	80	1.0000000
NODE_5108_length_1093_cov_28.531187	427	507	0	34	80	0.4250000
NODE_5108_length_1093_cov_28.531187	427	507	2	6	80	0.0750000
NODE_5108_length_1093_cov_28.531187	427	507	4	40	80	0.5000000
NODE_5109_length_1093_cov_22.744467	516	596	0	31	80	0.3875000
NODE_5109_length_1093_cov_22.744467	516	596	2	49	80	0.6125000
NODE_5109_length_1093_cov_22.744467	569	649	0	47	80	0.5875000
NODE_5109_length_1093_cov_22.744467	569	649	2	33	80	0.4125000
NODE_5109_length_1093_cov_22.744467	645	725	2	71	80	0.8875000
NODE_5109_length_1093_cov_22.744467	645	725	4	9	80	0.1125000
NODE_5109_length_1093_cov_22.744467	698	778	2	66	80	0.8250000
NODE_5109_length_1093_cov_22.744467	698	778	4	14	80	0.1750000
NODE_5110_length_1093_cov_11.637827	282	362	0	80	80	1.0000000
NODE_5110_length_1093_cov_11.637827	335	415	0	80	80	1.0000000
NODE_5111_length_1093_cov_9.047284	660	740	0	15	80	0.1875000
NODE_5111_length_1093_cov_9.047284	660	740	2	65	80	0.8125000
NODE_5111_length_1093_cov_9.047284	713	793	0	28	80	0.3500000
NODE_5111_length_1093_cov_9.047284	713	793	2	52	80	0.6500000
NODE_5112_length_1093_cov_6.857143	658	738	2	80	80	1.0000000
NODE_5112_length_1093_cov_6.857143	711	791	0	27	80	0.3375000
NODE_5112_length_1093_cov_6.857143	711	791	2	53	80	0.6625000
NODE_5113_length_1093_cov_5.311871	587	667	0	80	80	1.0000000
NODE_5113_length_1093_cov_5.311871	640	720	0	80	80	1.0000000
NODE_5118_length_1092_cov_105.542800	682	768	26	2	86	0.0232558
NODE_5118_length_1092_cov_105.542800	682	768	28	1	86	0.0116279
NODE_5118_length_1092_cov_105.542800	682	768	32	1	86	0.0116279
NODE_5118_length_1092_cov_105.542800	682	768	36	2	86	0.0232558
NODE_5118_length_1092_cov_105.542800	682	768	50	1	86	0.0116279
NODE_5118_length_1092_cov_105.542800	682	768	52	1	86	0.0116279
NODE_5118_length_1092_cov_105.542800	682	768	57	3	86	0.0348837
NODE_5118_length_1092_cov_105.542800	682	768	59	4	86	0.0465116
NODE_5118_length_1092_cov_105.542800	682	768	67	2	86	0.0232558
NODE_5118_length_1092_cov_105.542800	682	768	71	1	86	0.0116279
NODE_5118_length_1092_cov_105.542800	682	768	73	1	86	0.0116279
NODE_5118_length_1092_cov_105.542800	682	768	79	1	86	0.0116279
NODE_5118_length_1092_cov_105.542800	682	768	91	4	86	0.0465116
NODE_5118_length_1092_cov_105.542800	682	768	95	2	86	0.0232558
NODE_5118_length_1092_cov_105.542800	682	768	100	1	86	0.0116279
NODE_5118_length_1092_cov_105.542800	682	768	105	2	86	0.0232558
NODE_5118_length_1092_cov_105.542800	682	768	106	1	86	0.0116279
NODE_5118_length_1092_cov_105.542800	682	768	107	2	86	0.0232558
NODE_5118_length_1092_cov_105.542800	682	768	109	1	86	0.0116279
NODE_5118_length_1092_cov_105.542800	682	768	113	1	86	0.0116279
NODE_5118_length_1092_cov_105.542800	682	768	119	1	86	0.0116279
NODE_5118_length_1092_cov_105.542800	682	768	127	1	86	0.0116279
NODE_5118_length_1092_cov_105.542800	682	768	129	1	86	0.0116279
NODE_5118_length_1092_cov_105.542800	682	768	131	2	86	0.0232558
NODE_5118_length_1092_cov_105.542800	682	768	133	2	86	0.0232558
NODE_5118_length_1092_cov_105.542800	682	768	140	1	86	0.0116279
NODE_5118_length_1092_cov_105.542800	682	768	144	1	86	0.0116279
NODE_5118_length_1092_cov_105.542800	682	768	146	1	86	0.0116279
NODE_5118_length_1092_cov_105.542800	682	768	147	1	86	0.0116279
NODE_5118_length_1092_cov_105.542800	682	768	149	1	86	0.0116279
NODE_5118_length_1092_cov_105.542800	682	768	150	1	86	0.0116279
NODE_5118_length_1092_cov_105.542800	682	768	152	1	86	0.0116279
NODE_5118_length_1092_cov_105.542800	682	768	162	1	86	0.0116279
NODE_5118_length_1092_cov_105.542800	682	768	173	1	86	0.0116279
NODE_5118_length_1092_cov_105.542800	682	768	177	4	86	0.0465116
NODE_5118_length_1092_cov_105.542800	682	768	183	6	86	0.0697674
NODE_5118_length_1092_cov_105.542800	682	768	184	2	86	0.0232558
NODE_5118_length_1092_cov_105.542800	682	768	185	11	86	0.1279070
NODE_5118_length_1092_cov_105.542800	682	768	186	6	86	0.0697674
NODE_5118_length_1092_cov_105.542800	682	768	187	1	86	0.0116279
NODE_5118_length_1092_cov_105.542800	682	768	188	4	86	0.0465116
NODE_5118_length_1092_cov_105.542800	682	768	189	1	86	0.0116279
NODE_5118_length_1092_cov_105.542800	682	768	190	1	86	0.0116279
NODE_5118_length_1092_cov_105.542800	745	807	103	2	62	0.0322581
NODE_5118_length_1092_cov_105.542800	745	807	104	1	62	0.0161290
NODE_5118_length_1092_cov_105.542800	745	807	106	2	62	0.0322581
NODE_5118_length_1092_cov_105.542800	745	807	108	1	62	0.0161290
NODE_5118_length_1092_cov_105.542800	745	807	112	1	62	0.0161290
NODE_5118_length_1092_cov_105.542800	745	807	118	3	62	0.0483871
NODE_5118_length_1092_cov_105.542800	745	807	127	1	62	0.0161290
NODE_5118_length_1092_cov_105.542800	745	807	129	2	62	0.0322581
NODE_5118_length_1092_cov_105.542800	745	807	139	2	62	0.0322581
NODE_5118_length_1092_cov_105.542800	745	807	149	1	62	0.0161290
NODE_5118_length_1092_cov_105.542800	745	807	150	3	62	0.0483871
NODE_5118_length_1092_cov_105.542800	745	807	159	2	62	0.0322581
NODE_5118_length_1092_cov_105.542800	745	807	165	1	62	0.0161290
NODE_5118_length_1092_cov_105.542800	745	807	173	1	62	0.0161290
NODE_5118_length_1092_cov_105.542800	745	807	178	6	62	0.0967742
NODE_5118_length_1092_cov_105.542800	745	807	179	1	62	0.0161290
NODE_5118_length_1092_cov_105.542800	745	807	180	3	62	0.0483871
NODE_5118_length_1092_cov_105.542800	745	807	182	1	62	0.0161290
NODE_5118_length_1092_cov_105.542800	745	807	183	7	62	0.1129032
NODE_5118_length_1092_cov_105.542800	745	807	184	3	62	0.0483871
NODE_5118_length_1092_cov_105.542800	745	807	185	6	62	0.0967742
NODE_5118_length_1092_cov_105.542800	745	807	186	6	62	0.0967742
NODE_5118_length_1092_cov_105.542800	745	807	188	4	62	0.0645161
NODE_5118_length_1092_cov_105.542800	745	807	189	1	62	0.0161290
NODE_5118_length_1092_cov_105.542800	745	807	190	1	62	0.0161290
NODE_5119_length_1092_cov_30.957704	610	690	2	80	80	1.0000000
NODE_5119_length_1092_cov_30.957704	663	743	2	63	80	0.7875000
NODE_5119_length_1092_cov_30.957704	663	743	4	17	80	0.2125000
NODE_5121_length_1092_cov_16.737160	725	805	1	13	80	0.1625000
NODE_5121_length_1092_cov_16.737160	725	805	2	5	80	0.0625000
NODE_5121_length_1092_cov_16.737160	725	805	4	26	80	0.3250000
NODE_5121_length_1092_cov_16.737160	725	805	6	36	80	0.4500000
NODE_5121_length_1092_cov_16.737160	778	858	1	66	80	0.8250000
NODE_5121_length_1092_cov_16.737160	778	858	2	5	80	0.0625000
NODE_5121_length_1092_cov_16.737160	778	858	4	9	80	0.1125000
NODE_5123_length_1092_cov_11.193353	335	415	0	47	80	0.5875000
NODE_5123_length_1092_cov_11.193353	335	415	2	21	80	0.2625000
NODE_5123_length_1092_cov_11.193353	335	415	4	12	80	0.1500000
NODE_5123_length_1092_cov_11.193353	388	468	2	29	80	0.3625000
NODE_5123_length_1092_cov_11.193353	388	468	4	51	80	0.6375000
NODE_5124_length_1092_cov_9.348439	489	569	0	80	80	1.0000000
NODE_5124_length_1092_cov_9.348439	542	622	0	80	80	1.0000000
NODE_5125_length_1092_cov_7.533736	243	323	0	80	80	1.0000000
NODE_5125_length_1092_cov_7.533736	296	376	0	80	80	1.0000000
NODE_5126_length_1092_cov_6.968781	470	550	0	80	80	1.0000000
NODE_5126_length_1092_cov_6.968781	523	603	0	80	80	1.0000000
NODE_5134_length_1091_cov_54.234879	417	497	0	4	80	0.0500000
NODE_5134_length_1091_cov_54.234879	417	497	4	32	80	0.4000000
NODE_5134_length_1091_cov_54.234879	417	497	6	44	80	0.5500000
NODE_5134_length_1091_cov_54.234879	470	550	2	19	80	0.2375000
NODE_5134_length_1091_cov_54.234879	470	550	4	15	80	0.1875000
NODE_5134_length_1091_cov_54.234879	470	550	6	30	80	0.3750000
NODE_5134_length_1091_cov_54.234879	470	550	8	16	80	0.2000000
NODE_5134_length_1091_cov_54.234879	546	626	2	11	80	0.1375000
NODE_5134_length_1091_cov_54.234879	546	626	3	69	80	0.8625000
NODE_5134_length_1091_cov_54.234879	599	679	1	49	80	0.6125000
NODE_5134_length_1091_cov_54.234879	599	679	3	31	80	0.3875000
NODE_5135_length_1091_cov_35.045363	384	464	0	70	80	0.8750000
NODE_5135_length_1091_cov_35.045363	384	464	2	10	80	0.1250000
NODE_5135_length_1091_cov_35.045363	437	517	0	17	80	0.2125000
NODE_5135_length_1091_cov_35.045363	437	517	2	63	80	0.7875000
NODE_5135_length_1091_cov_35.045363	513	593	2	9	80	0.1125000
NODE_5135_length_1091_cov_35.045363	513	593	4	51	80	0.6375000
NODE_5135_length_1091_cov_35.045363	513	593	6	20	80	0.2500000
NODE_5135_length_1091_cov_35.045363	566	646	0	30	80	0.3750000
NODE_5135_length_1091_cov_35.045363	566	646	2	20	80	0.2500000
NODE_5135_length_1091_cov_35.045363	566	646	4	30	80	0.3750000
NODE_5136_length_1091_cov_28.490927	329	409	0	80	80	1.0000000
NODE_5136_length_1091_cov_28.490927	382	462	0	80	80	1.0000000
NODE_5136_length_1091_cov_28.490927	618	698	0	20	80	0.2500000
NODE_5136_length_1091_cov_28.490927	618	698	4	60	80	0.7500000
NODE_5136_length_1091_cov_28.490927	671	751	0	73	80	0.9125000
NODE_5136_length_1091_cov_28.490927	671	751	4	7	80	0.0875000
NODE_5137_length_1091_cov_23.733871	514	594	2	15	80	0.1875000
NODE_5137_length_1091_cov_23.733871	514	594	3	10	80	0.1250000
NODE_5137_length_1091_cov_23.733871	514	594	4	55	80	0.6875000
NODE_5137_length_1091_cov_23.733871	567	647	2	4	80	0.0500000
NODE_5137_length_1091_cov_23.733871	567	647	4	56	80	0.7000000
NODE_5137_length_1091_cov_23.733871	567	647	6	10	80	0.1250000
NODE_5137_length_1091_cov_23.733871	567	647	8	10	80	0.1250000
NODE_5138_length_1091_cov_13.065524	444	524	0	16	80	0.2000000
NODE_5138_length_1091_cov_13.065524	444	524	2	64	80	0.8000000
NODE_5138_length_1091_cov_13.065524	497	577	0	10	80	0.1250000
NODE_5138_length_1091_cov_13.065524	497	577	2	70	80	0.8750000
NODE_5139_length_1091_cov_10.961694	582	646	0	3	64	0.0468750
NODE_5139_length_1091_cov_10.961694	582	646	2	39	64	0.6093750
NODE_5139_length_1091_cov_10.961694	582	646	4	22	64	0.3437500
NODE_5140_length_1091_cov_8.166331	299	379	0	61	80	0.7625000
NODE_5140_length_1091_cov_8.166331	299	379	2	19	80	0.2375000
NODE_5140_length_1091_cov_8.166331	352	432	0	46	80	0.5750000
NODE_5140_length_1091_cov_8.166331	352	432	2	34	80	0.4250000
NODE_5141_length_1091_cov_7.006048	617	697	0	11	80	0.1375000
NODE_5141_length_1091_cov_7.006048	617	697	2	69	80	0.8625000
NODE_5141_length_1091_cov_7.006048	670	750	0	23	80	0.2875000
NODE_5141_length_1091_cov_7.006048	670	750	2	57	80	0.7125000
NODE_5151_length_1090_cov_73.781029	352	432	0	11	80	0.1375000
NODE_5151_length_1090_cov_73.781029	352	432	2	1	80	0.0125000
NODE_5151_length_1090_cov_73.781029	352	432	4	31	80	0.3875000
NODE_5151_length_1090_cov_73.781029	352	432	6	37	80	0.4625000
NODE_5151_length_1090_cov_73.781029	405	485	0	15	80	0.1875000
NODE_5151_length_1090_cov_73.781029	405	485	4	34	80	0.4250000
NODE_5151_length_1090_cov_73.781029	405	485	5	3	80	0.0375000
NODE_5151_length_1090_cov_73.781029	405	485	6	28	80	0.3500000
NODE_5151_length_1090_cov_73.781029	481	567	0	48	86	0.5581396
NODE_5151_length_1090_cov_73.781029	481	567	4	5	86	0.0581395
NODE_5151_length_1090_cov_73.781029	481	567	6	4	86	0.0465116
NODE_5151_length_1090_cov_73.781029	481	567	8	29	86	0.3372093
NODE_5151_length_1090_cov_73.781029	540	620	6	26	80	0.3250000
NODE_5151_length_1090_cov_73.781029	540	620	8	54	80	0.6750000
NODE_5152_length_1090_cov_42.394551	530	610	0	80	80	1.0000000
NODE_5152_length_1090_cov_42.394551	583	663	0	80	80	1.0000000
NODE_5153_length_1090_cov_37.643794	436	516	6	80	80	1.0000000
NODE_5153_length_1090_cov_37.643794	489	569	0	30	80	0.3750000
NODE_5153_length_1090_cov_37.643794	489	569	6	50	80	0.6250000
NODE_5153_length_1090_cov_37.643794	565	645	0	80	80	1.0000000
NODE_5153_length_1090_cov_37.643794	618	698	0	80	80	1.0000000
NODE_5154_length_1090_cov_32.876892	487	567	2	11	80	0.1375000
NODE_5154_length_1090_cov_32.876892	487	567	4	22	80	0.2750000
NODE_5154_length_1090_cov_32.876892	487	567	6	47	80	0.5875000
NODE_5154_length_1090_cov_32.876892	540	620	0	32	80	0.4000000
NODE_5154_length_1090_cov_32.876892	540	620	2	32	80	0.4000000
NODE_5154_length_1090_cov_32.876892	540	620	4	3	80	0.0375000
NODE_5154_length_1090_cov_32.876892	540	620	6	13	80	0.1625000
NODE_5155_length_1090_cov_25.373360	486	566	0	10	80	0.1250000
NODE_5155_length_1090_cov_25.373360	486	566	2	70	80	0.8750000
NODE_5155_length_1090_cov_25.373360	539	619	0	61	80	0.7625000
NODE_5155_length_1090_cov_25.373360	539	619	2	19	80	0.2375000
NODE_5156_length_1090_cov_21.290616	422	502	2	80	80	1.0000000
NODE_5156_length_1090_cov_21.290616	475	555	0	13	80	0.1625000
NODE_5156_length_1090_cov_21.290616	475	555	2	67	80	0.8375000
NODE_5156_length_1090_cov_21.290616	551	631	0	80	80	1.0000000
NODE_5156_length_1090_cov_21.290616	604	684	0	80	80	1.0000000
NODE_5157_length_1090_cov_16.040363	666	746	0	80	80	1.0000000
NODE_5157_length_1090_cov_16.040363	719	799	0	80	80	1.0000000
NODE_5158_length_1090_cov_14.826438	393	473	0	80	80	1.0000000
NODE_5158_length_1090_cov_14.826438	446	526	0	80	80	1.0000000
NODE_5159_length_1090_cov_13.721493	498	578	0	80	80	1.0000000
NODE_5159_length_1090_cov_13.721493	551	631	0	80	80	1.0000000
NODE_5160_length_1090_cov_12.365288	386	467	0	81	81	1.0000000
NODE_5160_length_1090_cov_12.365288	440	520	0	80	80	1.0000000
NODE_5160_length_1090_cov_12.365288	516	596	0	80	80	1.0000000
NODE_5160_length_1090_cov_12.365288	569	649	0	80	80	1.0000000
NODE_5161_length_1090_cov_5.348133	0	80	0	8	80	0.1000000
NODE_5161_length_1090_cov_5.348133	0	80	2	6	80	0.0750000
NODE_5161_length_1090_cov_5.348133	0	80	4	13	80	0.1625000
NODE_5161_length_1090_cov_5.348133	0	80	6	12	80	0.1500000
NODE_5161_length_1090_cov_5.348133	0	80	8	18	80	0.2250000
NODE_5161_length_1090_cov_5.348133	0	80	14	1	80	0.0125000
NODE_5161_length_1090_cov_5.348133	0	80	18	12	80	0.1500000
NODE_5161_length_1090_cov_5.348133	0	80	20	2	80	0.0250000
NODE_5161_length_1090_cov_5.348133	0	80	22	8	80	0.1000000
NODE_5161_length_1090_cov_5.348133	53	99	8	4	46	0.0869565
NODE_5161_length_1090_cov_5.348133	53	99	14	1	46	0.0217391
NODE_5161_length_1090_cov_5.348133	53	99	18	12	46	0.2608696
NODE_5161_length_1090_cov_5.348133	53	99	20	2	46	0.0434783
NODE_5161_length_1090_cov_5.348133	53	99	22	15	46	0.3260870
NODE_5161_length_1090_cov_5.348133	53	99	26	4	46	0.0869565
NODE_5161_length_1090_cov_5.348133	53	99	28	3	46	0.0652174
NODE_5161_length_1090_cov_5.348133	53	99	30	1	46	0.0217391
NODE_5161_length_1090_cov_5.348133	53	99	32	4	46	0.0869565
NODE_5163_length_1090_cov_3.598385	300	340	6	2	40	0.0500000
NODE_5163_length_1090_cov_3.598385	300	340	8	1	40	0.0250000
NODE_5163_length_1090_cov_3.598385	300	340	10	2	40	0.0500000
NODE_5163_length_1090_cov_3.598385	300	340	12	4	40	0.1000000
NODE_5163_length_1090_cov_3.598385	300	340	14	1	40	0.0250000
NODE_5163_length_1090_cov_3.598385	300	340	16	2	40	0.0500000
NODE_5163_length_1090_cov_3.598385	300	340	20	6	40	0.1500000
NODE_5163_length_1090_cov_3.598385	300	340	22	2	40	0.0500000
NODE_5163_length_1090_cov_3.598385	300	340	26	3	40	0.0750000
NODE_5163_length_1090_cov_3.598385	300	340	28	1	40	0.0250000
NODE_5163_length_1090_cov_3.598385	300	340	30	3	40	0.0750000
NODE_5163_length_1090_cov_3.598385	300	340	32	6	40	0.1500000
NODE_5163_length_1090_cov_3.598385	300	340	36	1	40	0.0250000
NODE_5163_length_1090_cov_3.598385	300	340	38	1	40	0.0250000
NODE_5163_length_1090_cov_3.598385	300	340	40	2	40	0.0500000
NODE_5163_length_1090_cov_3.598385	300	340	42	3	40	0.0750000
NODE_5170_length_1089_cov_55.374747	515	594	0	79	79	1.0000000
NODE_5170_length_1089_cov_55.374747	567	647	0	80	80	1.0000000
NODE_5170_length_1089_cov_55.374747	643	723	0	13	80	0.1625000
NODE_5170_length_1089_cov_55.374747	643	723	4	20	80	0.2500000
NODE_5170_length_1089_cov_55.374747	643	723	6	47	80	0.5875000
NODE_5170_length_1089_cov_55.374747	696	776	4	22	80	0.2750000
NODE_5170_length_1089_cov_55.374747	696	776	6	58	80	0.7250000
NODE_5171_length_1089_cov_38.506061	458	538	0	80	80	1.0000000
NODE_5171_length_1089_cov_38.506061	511	591	0	80	80	1.0000000
NODE_5171_length_1089_cov_38.506061	587	667	0	80	80	1.0000000
NODE_5171_length_1089_cov_38.506061	640	720	0	80	80	1.0000000
NODE_5172_length_1089_cov_22.657576	379	459	2	19	80	0.2375000
NODE_5172_length_1089_cov_22.657576	379	459	4	13	80	0.1625000
NODE_5172_length_1089_cov_22.657576	379	459	8	6	80	0.0750000
NODE_5172_length_1089_cov_22.657576	379	459	10	42	80	0.5250000
NODE_5172_length_1089_cov_22.657576	432	512	2	27	80	0.3375000
NODE_5172_length_1089_cov_22.657576	432	512	4	3	80	0.0375000
NODE_5172_length_1089_cov_22.657576	432	512	8	5	80	0.0625000
NODE_5172_length_1089_cov_22.657576	432	512	9	8	80	0.1000000
NODE_5172_length_1089_cov_22.657576	432	512	10	37	80	0.4625000
NODE_5173_length_1089_cov_21.180808	547	627	0	39	80	0.4875000
NODE_5173_length_1089_cov_21.180808	547	627	4	5	80	0.0625000
NODE_5173_length_1089_cov_21.180808	547	627	6	36	80	0.4500000
NODE_5173_length_1089_cov_21.180808	600	680	0	4	80	0.0500000
NODE_5173_length_1089_cov_21.180808	600	680	4	10	80	0.1250000
NODE_5173_length_1089_cov_21.180808	600	680	6	66	80	0.8250000
NODE_5174_length_1089_cov_18.713131	431	511	2	4	80	0.0500000
NODE_5174_length_1089_cov_18.713131	431	511	4	26	80	0.3250000
NODE_5174_length_1089_cov_18.713131	431	511	6	50	80	0.6250000
NODE_5174_length_1089_cov_18.713131	484	564	0	15	80	0.1875000
NODE_5174_length_1089_cov_18.713131	484	564	2	25	80	0.3125000
NODE_5174_length_1089_cov_18.713131	484	564	4	7	80	0.0875000
NODE_5174_length_1089_cov_18.713131	484	564	6	33	80	0.4125000
NODE_5174_length_1089_cov_18.713131	560	640	0	80	80	1.0000000
NODE_5174_length_1089_cov_18.713131	613	693	0	80	80	1.0000000
NODE_5175_length_1089_cov_17.382828	376	456	0	80	80	1.0000000
NODE_5175_length_1089_cov_17.382828	429	509	0	80	80	1.0000000
NODE_5175_length_1089_cov_17.382828	505	585	0	80	80	1.0000000
NODE_5175_length_1089_cov_17.382828	558	638	0	80	80	1.0000000
NODE_5176_length_1089_cov_14.540404	610	690	0	22	80	0.2750000
NODE_5176_length_1089_cov_14.540404	610	690	2	58	80	0.7250000
NODE_5176_length_1089_cov_14.540404	663	743	0	21	80	0.2625000
NODE_5176_length_1089_cov_14.540404	663	743	2	59	80	0.7375000
NODE_5182_length_1088_cov_10.603640	504	584	2	80	80	1.0000000
NODE_5182_length_1088_cov_10.603640	557	632	0	9	75	0.1200000
NODE_5182_length_1088_cov_10.603640	557	632	1	14	75	0.1866667
NODE_5182_length_1088_cov_10.603640	557	632	2	52	75	0.6933333
NODE_5194_length_1088_cov_0.759353	0	59	0	59	59	1.0000000
NODE_5194_length_1088_cov_0.759353	32	97	0	65	65	1.0000000
NODE_5195_length_1087_cov_51.676113	457	537	2	15	80	0.1875000
NODE_5195_length_1087_cov_51.676113	457	537	4	47	80	0.5875000
NODE_5195_length_1087_cov_51.676113	457	537	6	18	80	0.2250000
NODE_5195_length_1087_cov_51.676113	510	590	0	32	80	0.4000000
NODE_5195_length_1087_cov_51.676113	510	590	2	36	80	0.4500000
NODE_5195_length_1087_cov_51.676113	510	590	4	12	80	0.1500000
NODE_5195_length_1087_cov_51.676113	586	666	0	80	80	1.0000000
NODE_5195_length_1087_cov_51.676113	639	719	0	80	80	1.0000000
NODE_5196_length_1087_cov_47.144737	214	276	20	4	62	0.0645161
NODE_5196_length_1087_cov_47.144737	214	276	22	1	62	0.0161290
NODE_5196_length_1087_cov_47.144737	214	276	26	1	62	0.0161290
NODE_5196_length_1087_cov_47.144737	214	276	28	1	62	0.0161290
NODE_5196_length_1087_cov_47.144737	214	276	30	12	62	0.1935484
NODE_5196_length_1087_cov_47.144737	214	276	32	2	62	0.0322581
NODE_5196_length_1087_cov_47.144737	214	276	34	2	62	0.0322581
NODE_5196_length_1087_cov_47.144737	214	276	36	2	62	0.0322581
NODE_5196_length_1087_cov_47.144737	214	276	40	2	62	0.0322581
NODE_5196_length_1087_cov_47.144737	214	276	42	4	62	0.0645161
NODE_5196_length_1087_cov_47.144737	214	276	44	3	62	0.0483871
NODE_5196_length_1087_cov_47.144737	214	276	46	2	62	0.0322581
NODE_5196_length_1087_cov_47.144737	214	276	48	3	62	0.0483871
NODE_5196_length_1087_cov_47.144737	214	276	50	8	62	0.1290323
NODE_5196_length_1087_cov_47.144737	214	276	52	2	62	0.0322581
NODE_5196_length_1087_cov_47.144737	214	276	54	9	62	0.1451613
NODE_5196_length_1087_cov_47.144737	214	276	56	4	62	0.0645161
NODE_5196_length_1087_cov_47.144737	630	710	0	14	80	0.1750000
NODE_5196_length_1087_cov_47.144737	630	710	2	66	80	0.8250000
NODE_5196_length_1087_cov_47.144737	683	763	0	16	80	0.2000000
NODE_5196_length_1087_cov_47.144737	683	763	2	64	80	0.8000000
NODE_5197_length_1087_cov_46.633603	871	951	0	80	80	1.0000000
NODE_5197_length_1087_cov_46.633603	924	999	0	75	75	1.0000000
NODE_5198_length_1087_cov_30.577935	528	608	0	11	80	0.1375000
NODE_5198_length_1087_cov_30.577935	528	608	2	69	80	0.8625000
NODE_5198_length_1087_cov_30.577935	581	661	0	64	80	0.8000000
NODE_5198_length_1087_cov_30.577935	581	661	2	16	80	0.2000000
NODE_5199_length_1087_cov_30.205466	515	591	2	43	76	0.5657895
NODE_5199_length_1087_cov_30.205466	515	591	3	1	76	0.0131579
NODE_5199_length_1087_cov_30.205466	515	591	4	32	76	0.4210526
NODE_5199_length_1087_cov_30.205466	564	644	2	8	80	0.1000000
NODE_5199_length_1087_cov_30.205466	564	644	3	1	80	0.0125000
NODE_5199_length_1087_cov_30.205466	564	644	4	39	80	0.4875000
NODE_5199_length_1087_cov_30.205466	564	644	6	32	80	0.4000000
NODE_5200_length_1087_cov_29.595142	568	648	0	43	80	0.5375000
NODE_5200_length_1087_cov_29.595142	568	648	2	37	80	0.4625000
NODE_5200_length_1087_cov_29.595142	621	701	0	3	80	0.0375000
NODE_5200_length_1087_cov_29.595142	621	701	2	77	80	0.9625000
NODE_5201_length_1087_cov_11.600202	374	454	0	80	80	1.0000000
NODE_5201_length_1087_cov_11.600202	427	507	0	80	80	1.0000000
NODE_5202_length_1087_cov_7.746964	436	516	0	80	80	1.0000000
NODE_5202_length_1087_cov_7.746964	489	569	0	80	80	1.0000000
NODE_5211_length_1086_cov_35.748734	406	486	0	29	80	0.3625000
NODE_5211_length_1086_cov_35.748734	406	486	2	14	80	0.1750000
NODE_5211_length_1086_cov_35.748734	406	486	4	37	80	0.4625000
NODE_5211_length_1086_cov_35.748734	459	539	0	80	80	1.0000000
NODE_5212_length_1086_cov_18.445795	325	405	0	18	80	0.2250000
NODE_5212_length_1086_cov_18.445795	325	405	2	62	80	0.7750000
NODE_5212_length_1086_cov_18.445795	378	458	0	31	80	0.3875000
NODE_5212_length_1086_cov_18.445795	378	458	2	49	80	0.6125000
NODE_5213_length_1086_cov_16.878419	528	608	0	6	80	0.0750000
NODE_5213_length_1086_cov_16.878419	528	608	2	38	80	0.4750000
NODE_5213_length_1086_cov_16.878419	528	608	4	7	80	0.0875000
NODE_5213_length_1086_cov_16.878419	528	608	6	29	80	0.3625000
NODE_5213_length_1086_cov_16.878419	581	661	4	37	80	0.4625000
NODE_5213_length_1086_cov_16.878419	581	661	6	43	80	0.5375000
NODE_5214_length_1086_cov_10.700101	498	578	0	80	80	1.0000000
NODE_5214_length_1086_cov_10.700101	551	631	0	80	80	1.0000000
NODE_5215_length_1086_cov_10.656535	277	357	0	80	80	1.0000000
NODE_5215_length_1086_cov_10.656535	330	410	0	80	80	1.0000000
NODE_5216_length_1086_cov_6.873354	374	454	0	14	80	0.1750000
NODE_5216_length_1086_cov_6.873354	374	454	2	66	80	0.8250000
NODE_5216_length_1086_cov_6.873354	427	507	2	62	80	0.7750000
NODE_5216_length_1086_cov_6.873354	427	507	4	18	80	0.2250000
NODE_5217_length_1086_cov_5.225937	869	949	0	80	80	1.0000000
NODE_5217_length_1086_cov_5.225937	922	1002	0	80	80	1.0000000
NODE_5229_length_1085_cov_30.599391	515	595	0	38	80	0.4750000
NODE_5229_length_1085_cov_30.599391	515	595	2	42	80	0.5250000
NODE_5229_length_1085_cov_30.599391	568	648	0	23	80	0.2875000
NODE_5229_length_1085_cov_30.599391	568	648	2	57	80	0.7125000
NODE_5231_length_1085_cov_13.723124	558	638	0	10	80	0.1250000
NODE_5231_length_1085_cov_13.723124	558	638	2	65	80	0.8125000
NODE_5231_length_1085_cov_13.723124	558	638	6	5	80	0.0625000
NODE_5231_length_1085_cov_13.723124	611	691	2	22	80	0.2750000
NODE_5231_length_1085_cov_13.723124	611	691	6	53	80	0.6625000
NODE_5231_length_1085_cov_13.723124	611	691	8	5	80	0.0625000
NODE_5232_length_1085_cov_12.481744	576	656	0	80	80	1.0000000
NODE_5232_length_1085_cov_12.481744	629	709	0	80	80	1.0000000
NODE_5233_length_1085_cov_11.570994	553	633	0	80	80	1.0000000
NODE_5233_length_1085_cov_11.570994	606	686	0	80	80	1.0000000
NODE_5234_length_1085_cov_10.730223	273	353	0	80	80	1.0000000
NODE_5234_length_1085_cov_10.730223	326	406	0	80	80	1.0000000
NODE_5234_length_1085_cov_10.730223	402	482	0	35	80	0.4375000
NODE_5234_length_1085_cov_10.730223	402	482	2	45	80	0.5625000
NODE_5234_length_1085_cov_10.730223	455	535	0	37	80	0.4625000
NODE_5234_length_1085_cov_10.730223	455	535	2	43	80	0.5375000
NODE_5234_length_1085_cov_10.730223	832	908	4	12	76	0.1578947
NODE_5234_length_1085_cov_10.730223	832	908	8	14	76	0.1842105
NODE_5234_length_1085_cov_10.730223	832	908	10	1	76	0.0131579
NODE_5234_length_1085_cov_10.730223	832	908	12	4	76	0.0526316
NODE_5234_length_1085_cov_10.730223	832	908	14	1	76	0.0131579
NODE_5234_length_1085_cov_10.730223	832	908	16	3	76	0.0394737
NODE_5234_length_1085_cov_10.730223	832	908	18	13	76	0.1710526
NODE_5234_length_1085_cov_10.730223	832	908	22	5	76	0.0657895
NODE_5234_length_1085_cov_10.730223	832	908	24	1	76	0.0131579
NODE_5234_length_1085_cov_10.730223	832	908	26	15	76	0.1973684
NODE_5234_length_1085_cov_10.730223	832	908	28	1	76	0.0131579
NODE_5234_length_1085_cov_10.730223	832	908	30	6	76	0.0789474
NODE_5236_length_1085_cov_8.309331	400	480	0	80	80	1.0000000
NODE_5236_length_1085_cov_8.309331	453	533	0	80	80	1.0000000
NODE_5248_length_1084_cov_60.255838	446	524	3	19	78	0.2435897
NODE_5248_length_1084_cov_60.255838	446	524	4	2	78	0.0256410
NODE_5248_length_1084_cov_60.255838	446	524	5	56	78	0.7179487
NODE_5248_length_1084_cov_60.255838	446	524	7	1	78	0.0128205
NODE_5248_length_1084_cov_60.255838	497	577	3	7	80	0.0875000
NODE_5248_length_1084_cov_60.255838	497	577	5	73	80	0.9125000
NODE_5249_length_1084_cov_33.332995	445	525	2	12	80	0.1500000
NODE_5249_length_1084_cov_33.332995	445	525	4	68	80	0.8500000
NODE_5249_length_1084_cov_33.332995	498	578	0	45	80	0.5625000
NODE_5249_length_1084_cov_33.332995	498	578	2	14	80	0.1750000
NODE_5249_length_1084_cov_33.332995	498	578	4	21	80	0.2625000
NODE_5250_length_1084_cov_11.004061	757	837	2	35	80	0.4375000
NODE_5250_length_1084_cov_11.004061	757	837	4	45	80	0.5625000
NODE_5250_length_1084_cov_11.004061	810	890	0	42	80	0.5250000
NODE_5250_length_1084_cov_11.004061	810	890	2	38	80	0.4750000
NODE_5258_length_1083_cov_42.182927	451	531	0	80	80	1.0000000
NODE_5258_length_1083_cov_42.182927	504	584	0	62	80	0.7750000
NODE_5258_length_1083_cov_42.182927	504	584	2	18	80	0.2250000
NODE_5258_length_1083_cov_42.182927	580	660	2	80	80	1.0000000
NODE_5258_length_1083_cov_42.182927	633	713	0	10	80	0.1250000
NODE_5258_length_1083_cov_42.182927	633	713	2	70	80	0.8750000
NODE_5259_length_1083_cov_41.163618	275	355	0	80	80	1.0000000
NODE_5259_length_1083_cov_41.163618	328	408	0	45	80	0.5625000
NODE_5259_length_1083_cov_41.163618	328	408	2	26	80	0.3250000
NODE_5259_length_1083_cov_41.163618	328	408	4	9	80	0.1125000
NODE_5259_length_1083_cov_41.163618	404	484	4	10	80	0.1250000
NODE_5259_length_1083_cov_41.163618	404	484	8	70	80	0.8750000
NODE_5259_length_1083_cov_41.163618	457	537	0	39	80	0.4875000
NODE_5259_length_1083_cov_41.163618	457	537	2	4	80	0.0500000
NODE_5259_length_1083_cov_41.163618	457	537	6	9	80	0.1125000
NODE_5259_length_1083_cov_41.163618	457	537	8	28	80	0.3500000
NODE_5260_length_1083_cov_39.798780	527	607	2	18	80	0.2250000
NODE_5260_length_1083_cov_39.798780	527	607	4	3	80	0.0375000
NODE_5260_length_1083_cov_39.798780	527	607	6	59	80	0.7375000
NODE_5260_length_1083_cov_39.798780	580	660	2	36	80	0.4500000
NODE_5260_length_1083_cov_39.798780	580	660	4	19	80	0.2375000
NODE_5260_length_1083_cov_39.798780	580	660	6	25	80	0.3125000
NODE_5261_length_1083_cov_34.261179	475	555	2	22	80	0.2750000
NODE_5261_length_1083_cov_34.261179	475	555	4	15	80	0.1875000
NODE_5261_length_1083_cov_34.261179	475	555	8	43	80	0.5375000
NODE_5261_length_1083_cov_34.261179	528	608	4	34	80	0.4250000
NODE_5261_length_1083_cov_34.261179	528	608	6	1	80	0.0125000
NODE_5261_length_1083_cov_34.261179	528	608	8	45	80	0.5625000
NODE_5262_length_1083_cov_33.573171	486	566	0	49	80	0.6125000
NODE_5262_length_1083_cov_33.573171	486	566	1	1	80	0.0125000
NODE_5262_length_1083_cov_33.573171	486	566	5	2	80	0.0250000
NODE_5262_length_1083_cov_33.573171	486	566	7	28	80	0.3500000
NODE_5262_length_1083_cov_33.573171	539	619	1	12	80	0.1500000
NODE_5262_length_1083_cov_33.573171	539	619	5	28	80	0.3500000
NODE_5262_length_1083_cov_33.573171	539	619	7	40	80	0.5000000
NODE_5262_length_1083_cov_33.573171	615	695	0	11	80	0.1375000
NODE_5262_length_1083_cov_33.573171	615	695	1	14	80	0.1750000
NODE_5262_length_1083_cov_33.573171	615	695	2	2	80	0.0250000
NODE_5262_length_1083_cov_33.573171	615	695	6	19	80	0.2375000
NODE_5262_length_1083_cov_33.573171	615	695	8	28	80	0.3500000
NODE_5262_length_1083_cov_33.573171	615	695	9	1	80	0.0125000
NODE_5262_length_1083_cov_33.573171	615	695	10	5	80	0.0625000
NODE_5262_length_1083_cov_33.573171	668	748	4	17	80	0.2125000
NODE_5262_length_1083_cov_33.573171	668	748	7	1	80	0.0125000
NODE_5262_length_1083_cov_33.573171	668	748	8	36	80	0.4500000
NODE_5262_length_1083_cov_33.573171	668	748	9	1	80	0.0125000
NODE_5262_length_1083_cov_33.573171	668	748	10	25	80	0.3125000
NODE_5263_length_1083_cov_33.091463	452	532	0	21	80	0.2625000
NODE_5263_length_1083_cov_33.091463	452	532	2	1	80	0.0125000
NODE_5263_length_1083_cov_33.091463	452	532	4	58	80	0.7250000
NODE_5263_length_1083_cov_33.091463	505	585	0	4	80	0.0500000
NODE_5263_length_1083_cov_33.091463	505	585	2	25	80	0.3125000
NODE_5263_length_1083_cov_33.091463	505	585	4	51	80	0.6375000
NODE_5264_length_1083_cov_30.982724	550	630	4	6	80	0.0750000
NODE_5264_length_1083_cov_30.982724	550	630	6	35	80	0.4375000
NODE_5264_length_1083_cov_30.982724	550	630	8	39	80	0.4875000
NODE_5264_length_1083_cov_30.982724	603	683	0	37	80	0.4625000
NODE_5264_length_1083_cov_30.982724	603	683	2	16	80	0.2000000
NODE_5264_length_1083_cov_30.982724	603	683	4	6	80	0.0750000
NODE_5264_length_1083_cov_30.982724	603	683	6	9	80	0.1125000
NODE_5264_length_1083_cov_30.982724	603	683	8	12	80	0.1500000
NODE_5265_length_1083_cov_18.819106	586	666	2	8	80	0.1000000
NODE_5265_length_1083_cov_18.819106	586	666	4	4	80	0.0500000
NODE_5265_length_1083_cov_18.819106	586	666	6	68	80	0.8500000
NODE_5265_length_1083_cov_18.819106	639	719	0	17	80	0.2125000
NODE_5265_length_1083_cov_18.819106	639	719	2	14	80	0.1750000
NODE_5265_length_1083_cov_18.819106	639	719	6	49	80	0.6125000
NODE_5266_length_1083_cov_17.278455	408	488	0	80	80	1.0000000
NODE_5266_length_1083_cov_17.278455	461	541	0	80	80	1.0000000
NODE_5267_length_1083_cov_13.862805	481	561	0	52	80	0.6500000
NODE_5267_length_1083_cov_13.862805	481	561	4	12	80	0.1500000
NODE_5267_length_1083_cov_13.862805	481	561	6	9	80	0.1125000
NODE_5267_length_1083_cov_13.862805	481	561	7	7	80	0.0875000
NODE_5267_length_1083_cov_13.862805	534	614	4	11	80	0.1375000
NODE_5267_length_1083_cov_13.862805	534	614	6	11	80	0.1375000
NODE_5267_length_1083_cov_13.862805	534	614	7	16	80	0.2000000
NODE_5267_length_1083_cov_13.862805	534	614	8	6	80	0.0750000
NODE_5267_length_1083_cov_13.862805	534	614	10	36	80	0.4500000
NODE_5268_length_1083_cov_13.083333	522	602	0	43	80	0.5375000
NODE_5268_length_1083_cov_13.083333	522	602	2	16	80	0.2000000
NODE_5268_length_1083_cov_13.083333	522	602	4	21	80	0.2625000
NODE_5268_length_1083_cov_13.083333	575	655	0	1	80	0.0125000
NODE_5268_length_1083_cov_13.083333	575	655	2	10	80	0.1250000
NODE_5268_length_1083_cov_13.083333	575	655	4	69	80	0.8625000
NODE_5269_length_1083_cov_11.824187	242	322	2	80	80	1.0000000
NODE_5269_length_1083_cov_11.824187	295	375	0	46	80	0.5750000
NODE_5269_length_1083_cov_11.824187	295	375	2	34	80	0.4250000
NODE_5271_length_1083_cov_3.025407	359	439	0	80	80	1.0000000
NODE_5271_length_1083_cov_3.025407	412	489	0	77	77	1.0000000
NODE_5277_length_1082_cov_34.664293	461	541	0	80	80	1.0000000
NODE_5277_length_1082_cov_34.664293	514	594	0	80	80	1.0000000
NODE_5278_length_1082_cov_17.422177	406	486	0	31	80	0.3875000
NODE_5278_length_1082_cov_17.422177	406	486	2	14	80	0.1750000
NODE_5278_length_1082_cov_17.422177	406	486	3	22	80	0.2750000
NODE_5278_length_1082_cov_17.422177	406	486	7	13	80	0.1625000
NODE_5278_length_1082_cov_17.422177	459	539	3	14	80	0.1750000
NODE_5278_length_1082_cov_17.422177	459	539	4	31	80	0.3875000
NODE_5278_length_1082_cov_17.422177	459	539	7	35	80	0.4375000
NODE_5279_length_1082_cov_15.906409	442	522	2	30	80	0.3750000
NODE_5279_length_1082_cov_15.906409	442	522	4	50	80	0.6250000
NODE_5279_length_1082_cov_15.906409	495	575	2	76	80	0.9500000
NODE_5279_length_1082_cov_15.906409	495	575	4	4	80	0.0500000
NODE_5280_length_1082_cov_13.703967	324	404	0	7	80	0.0875000
NODE_5280_length_1082_cov_13.703967	324	404	2	32	80	0.4000000
NODE_5280_length_1082_cov_13.703967	324	404	3	2	80	0.0250000
NODE_5280_length_1082_cov_13.703967	324	404	4	39	80	0.4875000
NODE_5280_length_1082_cov_13.703967	377	457	0	5	80	0.0625000
NODE_5280_length_1082_cov_13.703967	377	457	2	11	80	0.1375000
NODE_5280_length_1082_cov_13.703967	377	457	4	64	80	0.8000000
NODE_5281_length_1082_cov_6.478128	159	205	4	5	46	0.1086956
NODE_5281_length_1082_cov_6.478128	159	205	6	25	46	0.5434783
NODE_5281_length_1082_cov_6.478128	159	205	8	11	46	0.2391304
NODE_5281_length_1082_cov_6.478128	159	205	10	5	46	0.1086956
NODE_5281_length_1082_cov_6.478128	203	283	2	21	80	0.2625000
NODE_5281_length_1082_cov_6.478128	203	283	4	22	80	0.2750000
NODE_5281_length_1082_cov_6.478128	203	283	6	37	80	0.4625000
NODE_5281_length_1082_cov_6.478128	256	336	0	11	80	0.1375000
NODE_5281_length_1082_cov_6.478128	256	336	2	3	80	0.0375000
NODE_5281_length_1082_cov_6.478128	256	336	4	1	80	0.0125000
NODE_5281_length_1082_cov_6.478128	256	336	6	65	80	0.8125000
NODE_5281_length_1082_cov_6.478128	861	941	2	80	80	1.0000000
NODE_5282_length_1082_cov_4.218718	982	1062	30	3	80	0.0375000
NODE_5282_length_1082_cov_4.218718	982	1062	34	1	80	0.0125000
NODE_5282_length_1082_cov_4.218718	982	1062	38	1	80	0.0125000
NODE_5282_length_1082_cov_4.218718	982	1062	39	1	80	0.0125000
NODE_5282_length_1082_cov_4.218718	982	1062	41	1	80	0.0125000
NODE_5282_length_1082_cov_4.218718	982	1062	42	1	80	0.0125000
NODE_5282_length_1082_cov_4.218718	982	1062	44	1	80	0.0125000
NODE_5282_length_1082_cov_4.218718	982	1062	48	3	80	0.0375000
NODE_5282_length_1082_cov_4.218718	982	1062	52	3	80	0.0375000
NODE_5282_length_1082_cov_4.218718	982	1062	54	1	80	0.0125000
NODE_5282_length_1082_cov_4.218718	982	1062	60	1	80	0.0125000
NODE_5282_length_1082_cov_4.218718	982	1062	63	1	80	0.0125000
NODE_5282_length_1082_cov_4.218718	982	1062	69	1	80	0.0125000
NODE_5282_length_1082_cov_4.218718	982	1062	71	1	80	0.0125000
NODE_5282_length_1082_cov_4.218718	982	1062	72	1	80	0.0125000
NODE_5282_length_1082_cov_4.218718	982	1062	83	1	80	0.0125000
NODE_5282_length_1082_cov_4.218718	982	1062	87	2	80	0.0250000
NODE_5282_length_1082_cov_4.218718	982	1062	92	1	80	0.0125000
NODE_5282_length_1082_cov_4.218718	982	1062	105	2	80	0.0250000
NODE_5282_length_1082_cov_4.218718	982	1062	107	4	80	0.0500000
NODE_5282_length_1082_cov_4.218718	982	1062	108	2	80	0.0250000
NODE_5282_length_1082_cov_4.218718	982	1062	110	1	80	0.0125000
NODE_5282_length_1082_cov_4.218718	982	1062	114	1	80	0.0125000
NODE_5282_length_1082_cov_4.218718	982	1062	116	1	80	0.0125000
NODE_5282_length_1082_cov_4.218718	982	1062	118	1	80	0.0125000
NODE_5282_length_1082_cov_4.218718	982	1062	120	1	80	0.0125000
NODE_5282_length_1082_cov_4.218718	982	1062	126	2	80	0.0250000
NODE_5282_length_1082_cov_4.218718	982	1062	129	1	80	0.0125000
NODE_5282_length_1082_cov_4.218718	982	1062	130	2	80	0.0250000
NODE_5282_length_1082_cov_4.218718	982	1062	132	1	80	0.0125000
NODE_5282_length_1082_cov_4.218718	982	1062	138	1	80	0.0125000
NODE_5282_length_1082_cov_4.218718	982	1062	139	1	80	0.0125000
NODE_5282_length_1082_cov_4.218718	982	1062	142	3	80	0.0375000
NODE_5282_length_1082_cov_4.218718	982	1062	144	1	80	0.0125000
NODE_5282_length_1082_cov_4.218718	982	1062	146	2	80	0.0250000
NODE_5282_length_1082_cov_4.218718	982	1062	148	4	80	0.0500000
NODE_5282_length_1082_cov_4.218718	982	1062	152	2	80	0.0250000
NODE_5282_length_1082_cov_4.218718	982	1062	158	4	80	0.0500000
NODE_5282_length_1082_cov_4.218718	982	1062	164	1	80	0.0125000
NODE_5282_length_1082_cov_4.218718	982	1062	170	2	80	0.0250000
NODE_5282_length_1082_cov_4.218718	982	1062	180	2	80	0.0250000
NODE_5282_length_1082_cov_4.218718	982	1062	182	1	80	0.0125000
NODE_5282_length_1082_cov_4.218718	982	1062	184	1	80	0.0125000
NODE_5282_length_1082_cov_4.218718	982	1062	188	5	80	0.0625000
NODE_5282_length_1082_cov_4.218718	982	1062	190	6	80	0.0750000
NODE_5291_length_1081_cov_45.308554	510	590	0	35	80	0.4375000
NODE_5291_length_1081_cov_45.308554	510	590	6	45	80	0.5625000
NODE_5291_length_1081_cov_45.308554	563	643	0	80	80	1.0000000
NODE_5292_length_1081_cov_39.581466	476	556	2	4	80	0.0500000
NODE_5292_length_1081_cov_39.581466	476	556	12	70	80	0.8750000
NODE_5292_length_1081_cov_39.581466	476	556	14	6	80	0.0750000
NODE_5292_length_1081_cov_39.581466	529	609	0	48	80	0.6000000
NODE_5292_length_1081_cov_39.581466	529	609	2	9	80	0.1125000
NODE_5292_length_1081_cov_39.581466	529	609	12	23	80	0.2875000
NODE_5292_length_1081_cov_39.581466	605	685	0	80	80	1.0000000
NODE_5292_length_1081_cov_39.581466	658	738	0	80	80	1.0000000
NODE_5293_length_1081_cov_39.457230	373	453	0	28	80	0.3500000
NODE_5293_length_1081_cov_39.457230	373	453	2	52	80	0.6500000
NODE_5293_length_1081_cov_39.457230	426	506	0	80	80	1.0000000
NODE_5294_length_1081_cov_20.415479	376	451	0	75	75	1.0000000
NODE_5294_length_1081_cov_20.415479	436	511	0	75	75	1.0000000
NODE_5294_length_1081_cov_20.415479	496	571	0	75	75	1.0000000
NODE_5294_length_1081_cov_20.415479	544	624	0	35	80	0.4375000
NODE_5294_length_1081_cov_20.415479	544	624	2	45	80	0.5625000
NODE_5295_length_1081_cov_19.985743	378	458	0	23	80	0.2875000
NODE_5295_length_1081_cov_19.985743	378	458	2	2	80	0.0250000
NODE_5295_length_1081_cov_19.985743	378	458	4	55	80	0.6875000
NODE_5295_length_1081_cov_19.985743	431	511	0	24	80	0.3000000
NODE_5295_length_1081_cov_19.985743	431	511	2	11	80	0.1375000
NODE_5295_length_1081_cov_19.985743	431	511	4	45	80	0.5625000
NODE_5295_length_1081_cov_19.985743	507	587	0	28	80	0.3500000
NODE_5295_length_1081_cov_19.985743	507	587	2	52	80	0.6500000
NODE_5295_length_1081_cov_19.985743	560	640	0	40	80	0.5000000
NODE_5295_length_1081_cov_19.985743	560	640	2	40	80	0.5000000
NODE_5296_length_1081_cov_12.658859	468	548	0	80	80	1.0000000
NODE_5296_length_1081_cov_12.658859	521	601	0	59	80	0.7375000
NODE_5296_length_1081_cov_12.658859	521	601	2	21	80	0.2625000
NODE_5299_length_1081_cov_2.586558	7	44	0	37	37	1.0000000
NODE_5304_length_1080_cov_27.857288	261	341	0	53	80	0.6625000
NODE_5304_length_1080_cov_27.857288	261	341	2	27	80	0.3375000
NODE_5304_length_1080_cov_27.857288	314	394	0	11	80	0.1375000
NODE_5304_length_1080_cov_27.857288	314	394	2	69	80	0.8625000
NODE_5305_length_1080_cov_24.258919	321	401	4	32	80	0.4000000
NODE_5305_length_1080_cov_24.258919	321	401	8	48	80	0.6000000
NODE_5305_length_1080_cov_24.258919	374	454	0	29	80	0.3625000
NODE_5305_length_1080_cov_24.258919	374	454	2	20	80	0.2500000
NODE_5305_length_1080_cov_24.258919	374	454	4	31	80	0.3875000
NODE_5305_length_1080_cov_24.258919	450	530	0	80	80	1.0000000
NODE_5305_length_1080_cov_24.258919	503	583	0	80	80	1.0000000
NODE_5306_length_1080_cov_22.589195	446	526	0	80	80	1.0000000
NODE_5306_length_1080_cov_22.589195	499	579	0	80	80	1.0000000
NODE_5306_length_1080_cov_22.589195	575	655	0	4	80	0.0500000
NODE_5306_length_1080_cov_22.589195	575	655	2	21	80	0.2625000
NODE_5306_length_1080_cov_22.589195	575	655	4	55	80	0.6875000
NODE_5306_length_1080_cov_22.589195	628	708	0	17	80	0.2125000
NODE_5306_length_1080_cov_22.589195	628	708	2	32	80	0.4000000
NODE_5306_length_1080_cov_22.589195	628	708	4	31	80	0.3875000
NODE_5307_length_1080_cov_15.544343	599	679	0	80	80	1.0000000
NODE_5307_length_1080_cov_15.544343	652	732	0	80	80	1.0000000
NODE_5308_length_1080_cov_10.416922	321	401	0	39	80	0.4875000
NODE_5308_length_1080_cov_10.416922	321	401	2	17	80	0.2125000
NODE_5308_length_1080_cov_10.416922	321	401	4	24	80	0.3000000
NODE_5308_length_1080_cov_10.416922	374	454	2	9	80	0.1125000
NODE_5308_length_1080_cov_10.416922	374	454	4	71	80	0.8875000
NODE_5315_length_1079_cov_55.352041	367	447	0	31	80	0.3875000
NODE_5315_length_1079_cov_55.352041	367	447	4	49	80	0.6125000
NODE_5315_length_1079_cov_55.352041	420	500	0	24	80	0.3000000
NODE_5315_length_1079_cov_55.352041	420	500	4	56	80	0.7000000
NODE_5315_length_1079_cov_55.352041	496	576	0	80	80	1.0000000
NODE_5315_length_1079_cov_55.352041	549	629	0	80	80	1.0000000
NODE_5316_length_1079_cov_46.879592	444	524	0	14	80	0.1750000
NODE_5316_length_1079_cov_46.879592	444	524	1	1	80	0.0125000
NODE_5316_length_1079_cov_46.879592	444	524	6	4	80	0.0500000
NODE_5316_length_1079_cov_46.879592	444	524	8	6	80	0.0750000
NODE_5316_length_1079_cov_46.879592	444	524	10	13	80	0.1625000
NODE_5316_length_1079_cov_46.879592	444	524	12	13	80	0.1625000
NODE_5316_length_1079_cov_46.879592	444	524	14	16	80	0.2000000
NODE_5316_length_1079_cov_46.879592	444	524	16	13	80	0.1625000
NODE_5316_length_1079_cov_46.879592	497	577	8	10	80	0.1250000
NODE_5316_length_1079_cov_46.879592	497	577	10	8	80	0.1000000
NODE_5316_length_1079_cov_46.879592	497	577	12	14	80	0.1750000
NODE_5316_length_1079_cov_46.879592	497	577	14	37	80	0.4625000
NODE_5316_length_1079_cov_46.879592	497	577	16	11	80	0.1375000
NODE_5316_length_1079_cov_46.879592	573	652	6	29	79	0.3670886
NODE_5316_length_1079_cov_46.879592	573	652	8	9	79	0.1139240
NODE_5316_length_1079_cov_46.879592	573	652	10	19	79	0.2405063
NODE_5316_length_1079_cov_46.879592	573	652	12	22	79	0.2784810
NODE_5316_length_1079_cov_46.879592	625	703	4	6	78	0.0769231
NODE_5316_length_1079_cov_46.879592	625	703	6	7	78	0.0897436
NODE_5316_length_1079_cov_46.879592	625	703	8	29	78	0.3717949
NODE_5316_length_1079_cov_46.879592	625	703	10	26	78	0.3333333
NODE_5316_length_1079_cov_46.879592	625	703	12	10	78	0.1282051
NODE_5317_length_1079_cov_13.708163	611	691	0	80	80	1.0000000
NODE_5317_length_1079_cov_13.708163	664	744	0	80	80	1.0000000
NODE_5318_length_1079_cov_8.632653	416	496	0	80	80	1.0000000
NODE_5318_length_1079_cov_8.632653	469	549	0	80	80	1.0000000
NODE_5325_length_1078_cov_27.804903	357	437	0	8	80	0.1000000
NODE_5325_length_1078_cov_27.804903	357	437	2	39	80	0.4875000
NODE_5325_length_1078_cov_27.804903	357	437	4	33	80	0.4125000
NODE_5325_length_1078_cov_27.804903	410	490	2	80	80	1.0000000
NODE_5326_length_1078_cov_26.071502	459	539	0	80	80	1.0000000
NODE_5326_length_1078_cov_26.071502	512	592	0	80	80	1.0000000
NODE_5326_length_1078_cov_26.071502	588	668	0	10	80	0.1250000
NODE_5326_length_1078_cov_26.071502	588	668	2	70	80	0.8750000
NODE_5326_length_1078_cov_26.071502	641	718	0	23	77	0.2987013
NODE_5326_length_1078_cov_26.071502	641	718	2	54	77	0.7012987
NODE_5327_length_1078_cov_14.985700	495	575	4	80	80	1.0000000
NODE_5327_length_1078_cov_14.985700	548	628	0	13	80	0.1625000
NODE_5327_length_1078_cov_14.985700	548	628	2	25	80	0.3125000
NODE_5327_length_1078_cov_14.985700	548	628	4	42	80	0.5250000
NODE_5333_length_1077_cov_23.876278	546	626	1	80	80	1.0000000
NODE_5333_length_1077_cov_23.876278	599	679	0	36	80	0.4500000
NODE_5333_length_1077_cov_23.876278	599	679	1	44	80	0.5500000
NODE_5334_length_1077_cov_16.067485	532	612	0	4	80	0.0500000
NODE_5334_length_1077_cov_16.067485	532	612	2	51	80	0.6375000
NODE_5334_length_1077_cov_16.067485	532	612	4	25	80	0.3125000
NODE_5334_length_1077_cov_16.067485	585	665	2	11	80	0.1375000
NODE_5334_length_1077_cov_16.067485	585	665	4	67	80	0.8375000
NODE_5334_length_1077_cov_16.067485	585	665	6	2	80	0.0250000
NODE_5335_length_1077_cov_14.568507	556	636	0	1	80	0.0125000
NODE_5335_length_1077_cov_14.568507	556	636	2	79	80	0.9875000
NODE_5335_length_1077_cov_14.568507	609	689	0	46	80	0.5750000
NODE_5335_length_1077_cov_14.568507	609	689	2	34	80	0.4250000
NODE_5336_length_1077_cov_9.507157	496	576	0	80	80	1.0000000
NODE_5336_length_1077_cov_9.507157	549	629	0	80	80	1.0000000
NODE_5342_length_1077_cov_1.781186	252	274	0	22	22	1.0000000
NODE_5345_length_1076_cov_20.592631	534	614	0	80	80	1.0000000
NODE_5345_length_1076_cov_20.592631	587	667	0	80	80	1.0000000
NODE_5346_length_1076_cov_14.788127	427	507	0	8	80	0.1000000
NODE_5346_length_1076_cov_14.788127	427	507	2	72	80	0.9000000
NODE_5346_length_1076_cov_14.788127	480	560	0	13	80	0.1625000
NODE_5346_length_1076_cov_14.788127	480	560	2	67	80	0.8375000
NODE_5348_length_1076_cov_6.306039	883	961	0	17	78	0.2179487
NODE_5348_length_1076_cov_6.306039	883	961	2	61	78	0.7820513
NODE_5348_length_1076_cov_6.306039	936	1014	0	22	78	0.2820513
NODE_5348_length_1076_cov_6.306039	936	1014	2	56	78	0.7179487
NODE_5357_length_1075_cov_37.941598	550	630	4	3	80	0.0375000
NODE_5357_length_1075_cov_37.941598	550	630	6	8	80	0.1000000
NODE_5357_length_1075_cov_37.941598	550	630	10	69	80	0.8625000
NODE_5357_length_1075_cov_37.941598	603	685	0	45	82	0.5487805
NODE_5357_length_1075_cov_37.941598	603	685	4	13	82	0.1585366
NODE_5357_length_1075_cov_37.941598	603	685	6	8	82	0.0975610
NODE_5357_length_1075_cov_37.941598	603	685	10	16	82	0.1951219
NODE_5357_length_1075_cov_37.941598	681	761	0	80	80	1.0000000
NODE_5357_length_1075_cov_37.941598	734	814	0	80	80	1.0000000
NODE_5358_length_1075_cov_32.224385	397	477	2	14	80	0.1750000
NODE_5358_length_1075_cov_32.224385	397	477	4	63	80	0.7875000
NODE_5358_length_1075_cov_32.224385	397	477	6	3	80	0.0375000
NODE_5358_length_1075_cov_32.224385	450	530	0	2	80	0.0250000
NODE_5358_length_1075_cov_32.224385	450	530	2	25	80	0.3125000
NODE_5358_length_1075_cov_32.224385	450	530	4	53	80	0.6625000
NODE_5359_length_1075_cov_9.626025	440	520	0	3	80	0.0375000
NODE_5359_length_1075_cov_9.626025	440	520	4	24	80	0.3000000
NODE_5359_length_1075_cov_9.626025	440	520	5	31	80	0.3875000
NODE_5359_length_1075_cov_9.626025	440	520	6	22	80	0.2750000
NODE_5359_length_1075_cov_9.626025	493	573	0	26	80	0.3250000
NODE_5359_length_1075_cov_9.626025	493	573	2	8	80	0.1000000
NODE_5359_length_1075_cov_9.626025	493	573	4	1	80	0.0125000
NODE_5359_length_1075_cov_9.626025	493	573	5	45	80	0.5625000
NODE_5362_length_1075_cov_2.926230	38	99	0	61	61	1.0000000
NODE_5372_length_1074_cov_19.034872	568	648	0	80	80	1.0000000
NODE_5372_length_1074_cov_19.034872	621	701	0	49	80	0.6125000
NODE_5372_length_1074_cov_19.034872	621	701	2	31	80	0.3875000
NODE_5372_length_1074_cov_19.034872	697	777	0	28	80	0.3500000
NODE_5372_length_1074_cov_19.034872	697	777	2	52	80	0.6500000
NODE_5372_length_1074_cov_19.034872	750	830	0	80	80	1.0000000
NODE_5373_length_1074_cov_9.450256	577	657	0	16	80	0.2000000
NODE_5373_length_1074_cov_9.450256	577	657	2	47	80	0.5875000
NODE_5373_length_1074_cov_9.450256	577	657	4	17	80	0.2125000
NODE_5373_length_1074_cov_9.450256	630	710	0	67	80	0.8375000
NODE_5373_length_1074_cov_9.450256	630	710	2	13	80	0.1625000
NODE_5374_length_1074_cov_9.155897	526	606	0	80	80	1.0000000
NODE_5374_length_1074_cov_9.155897	579	659	0	80	80	1.0000000
NODE_5374_length_1074_cov_9.155897	655	735	0	24	80	0.3000000
NODE_5374_length_1074_cov_9.155897	655	735	2	56	80	0.7000000
NODE_5374_length_1074_cov_9.155897	708	788	0	45	80	0.5625000
NODE_5374_length_1074_cov_9.155897	708	788	2	35	80	0.4375000
NODE_5375_length_1074_cov_4.600000	606	686	0	80	80	1.0000000
NODE_5375_length_1074_cov_4.600000	659	739	0	80	80	1.0000000
NODE_5376_length_1074_cov_4.328205	32	112	12	2	80	0.0250000
NODE_5376_length_1074_cov_4.328205	32	112	14	13	80	0.1625000
NODE_5376_length_1074_cov_4.328205	32	112	16	23	80	0.2875000
NODE_5376_length_1074_cov_4.328205	32	112	18	11	80	0.1375000
NODE_5376_length_1074_cov_4.328205	32	112	20	31	80	0.3875000
NODE_5380_length_1073_cov_60.012320	448	528	0	12	80	0.1500000
NODE_5380_length_1073_cov_60.012320	448	528	2	29	80	0.3625000
NODE_5380_length_1073_cov_60.012320	448	528	4	39	80	0.4875000
NODE_5380_length_1073_cov_60.012320	501	581	0	26	80	0.3250000
NODE_5380_length_1073_cov_60.012320	501	581	2	15	80	0.1875000
NODE_5380_length_1073_cov_60.012320	501	581	4	39	80	0.4875000
NODE_5382_length_1073_cov_26.415811	529	609	0	80	80	1.0000000
NODE_5382_length_1073_cov_26.415811	582	662	0	80	80	1.0000000
NODE_5383_length_1073_cov_19.062628	571	651	2	2	80	0.0250000
NODE_5383_length_1073_cov_19.062628	571	651	5	2	80	0.0250000
NODE_5383_length_1073_cov_19.062628	571	651	6	1	80	0.0125000
NODE_5383_length_1073_cov_19.062628	571	651	8	51	80	0.6375000
NODE_5383_length_1073_cov_19.062628	571	651	10	24	80	0.3000000
NODE_5383_length_1073_cov_19.062628	624	704	2	2	80	0.0250000
NODE_5383_length_1073_cov_19.062628	624	704	4	11	80	0.1375000
NODE_5383_length_1073_cov_19.062628	624	704	6	34	80	0.4250000
NODE_5383_length_1073_cov_19.062628	624	704	8	32	80	0.4000000
NODE_5383_length_1073_cov_19.062628	624	704	10	1	80	0.0125000
NODE_5384_length_1073_cov_18.536961	447	527	0	50	80	0.6250000
NODE_5384_length_1073_cov_18.536961	447	527	2	30	80	0.3750000
NODE_5384_length_1073_cov_18.536961	500	580	2	80	80	1.0000000
NODE_5384_length_1073_cov_18.536961	576	656	0	65	80	0.8125000
NODE_5384_length_1073_cov_18.536961	576	656	2	15	80	0.1875000
NODE_5384_length_1073_cov_18.536961	629	709	0	80	80	1.0000000
NODE_5385_length_1073_cov_15.318275	712	792	0	42	80	0.5250000
NODE_5385_length_1073_cov_15.318275	712	792	2	38	80	0.4750000
NODE_5385_length_1073_cov_15.318275	765	845	0	7	80	0.0875000
NODE_5385_length_1073_cov_15.318275	765	845	2	73	80	0.9125000
NODE_5386_length_1073_cov_8.376797	287	367	0	59	80	0.7375000
NODE_5386_length_1073_cov_8.376797	287	367	2	1	80	0.0125000
NODE_5386_length_1073_cov_8.376797	287	367	3	1	80	0.0125000
NODE_5386_length_1073_cov_8.376797	287	367	4	19	80	0.2375000
NODE_5386_length_1073_cov_8.376797	340	420	0	6	80	0.0750000
NODE_5386_length_1073_cov_8.376797	340	420	2	1	80	0.0125000
NODE_5386_length_1073_cov_8.376797	340	420	3	1	80	0.0125000
NODE_5386_length_1073_cov_8.376797	340	420	4	72	80	0.9000000
NODE_5387_length_1073_cov_5.749487	257	337	0	80	80	1.0000000
NODE_5387_length_1073_cov_5.749487	310	390	0	80	80	1.0000000
NODE_5388_length_1073_cov_5.156057	408	444	4	36	36	1.0000000
NODE_5390_length_1073_cov_3.019507	1	69	0	68	68	1.0000000
NODE_5390_length_1073_cov_3.019507	42	122	0	80	80	1.0000000
NODE_5399_length_1072_cov_62.729702	351	431	2	43	80	0.5375000
NODE_5399_length_1072_cov_62.729702	351	431	4	18	80	0.2250000
NODE_5399_length_1072_cov_62.729702	351	431	6	8	80	0.1000000
NODE_5399_length_1072_cov_62.729702	351	431	12	7	80	0.0875000
NODE_5399_length_1072_cov_62.729702	351	431	16	4	80	0.0500000
NODE_5399_length_1072_cov_62.729702	404	484	4	8	80	0.1000000
NODE_5399_length_1072_cov_62.729702	404	484	6	8	80	0.1000000
NODE_5399_length_1072_cov_62.729702	404	484	12	7	80	0.0875000
NODE_5399_length_1072_cov_62.729702	404	484	14	23	80	0.2875000
NODE_5399_length_1072_cov_62.729702	404	484	16	34	80	0.4250000
NODE_5399_length_1072_cov_62.729702	480	560	0	11	80	0.1375000
NODE_5399_length_1072_cov_62.729702	480	560	2	49	80	0.6125000
NODE_5399_length_1072_cov_62.729702	480	560	6	4	80	0.0500000
NODE_5399_length_1072_cov_62.729702	480	560	8	4	80	0.0500000
NODE_5399_length_1072_cov_62.729702	480	560	12	3	80	0.0375000
NODE_5399_length_1072_cov_62.729702	480	560	14	9	80	0.1125000
NODE_5399_length_1072_cov_62.729702	533	613	0	28	80	0.3500000
NODE_5399_length_1072_cov_62.729702	533	613	2	52	80	0.6500000
NODE_5400_length_1072_cov_34.045221	430	510	2	80	80	1.0000000
NODE_5400_length_1072_cov_34.045221	483	563	0	51	80	0.6375000
NODE_5400_length_1072_cov_34.045221	483	563	2	29	80	0.3625000
NODE_5401_length_1072_cov_34.006166	342	423	0	39	81	0.4814815
NODE_5401_length_1072_cov_34.006166	342	423	2	42	81	0.5185185
NODE_5401_length_1072_cov_34.006166	396	476	0	17	80	0.2125000
NODE_5401_length_1072_cov_34.006166	396	476	2	63	80	0.7875000
NODE_5401_length_1072_cov_34.006166	472	552	0	80	80	1.0000000
NODE_5401_length_1072_cov_34.006166	525	605	0	68	80	0.8500000
NODE_5401_length_1072_cov_34.006166	525	605	2	12	80	0.1500000
NODE_5403_length_1072_cov_21.852004	300	380	0	62	80	0.7750000
NODE_5403_length_1072_cov_21.852004	300	380	2	18	80	0.2250000
NODE_5403_length_1072_cov_21.852004	353	433	0	9	80	0.1125000
NODE_5403_length_1072_cov_21.852004	353	433	2	60	80	0.7500000
NODE_5403_length_1072_cov_21.852004	353	433	4	11	80	0.1375000
NODE_5404_length_1072_cov_21.532374	476	556	0	23	80	0.2875000
NODE_5404_length_1072_cov_21.532374	476	556	2	21	80	0.2625000
NODE_5404_length_1072_cov_21.532374	476	556	4	36	80	0.4500000
NODE_5404_length_1072_cov_21.532374	529	609	0	6	80	0.0750000
NODE_5404_length_1072_cov_21.532374	529	609	2	1	80	0.0125000
NODE_5404_length_1072_cov_21.532374	529	609	4	73	80	0.9125000
NODE_5405_length_1072_cov_17.018499	415	495	0	80	80	1.0000000
NODE_5405_length_1072_cov_17.018499	468	548	0	80	80	1.0000000
NODE_5410_length_1072_cov_3.302158	388	449	2	7	61	0.1147541
NODE_5410_length_1072_cov_3.302158	388	449	4	54	61	0.8852459
NODE_5410_length_1072_cov_3.302158	422	502	0	21	80	0.2625000
NODE_5410_length_1072_cov_3.302158	422	502	2	39	80	0.4875000
NODE_5410_length_1072_cov_3.302158	422	502	4	20	80	0.2500000
NODE_5414_length_1072_cov_1.773895	114	176	2	3	62	0.0483871
NODE_5414_length_1072_cov_1.773895	114	176	4	5	62	0.0806452
NODE_5414_length_1072_cov_1.773895	114	176	6	16	62	0.2580645
NODE_5414_length_1072_cov_1.773895	114	176	8	5	62	0.0806452
NODE_5414_length_1072_cov_1.773895	114	176	10	4	62	0.0645161
NODE_5414_length_1072_cov_1.773895	114	176	13	1	62	0.0161290
NODE_5414_length_1072_cov_1.773895	114	176	14	28	62	0.4516129
NODE_5417_length_1071_cov_27.565844	312	392	0	80	80	1.0000000
NODE_5417_length_1071_cov_27.565844	365	445	0	80	80	1.0000000
NODE_5419_length_1071_cov_12.666667	480	560	0	80	80	1.0000000
NODE_5419_length_1071_cov_12.666667	533	613	0	80	80	1.0000000
NODE_5421_length_1071_cov_8.942387	418	498	0	80	80	1.0000000
NODE_5421_length_1071_cov_8.942387	471	551	0	39	80	0.4875000
NODE_5421_length_1071_cov_8.942387	471	551	4	41	80	0.5125000
NODE_5427_length_1070_cov_39.255407	591	671	0	80	80	1.0000000
NODE_5427_length_1070_cov_39.255407	644	724	0	80	80	1.0000000
NODE_5428_length_1070_cov_21.903193	430	510	0	80	80	1.0000000
NODE_5428_length_1070_cov_21.903193	483	563	0	80	80	1.0000000
NODE_5428_length_1070_cov_21.903193	559	639	0	80	80	1.0000000
NODE_5428_length_1070_cov_21.903193	612	692	0	32	80	0.4000000
NODE_5428_length_1070_cov_21.903193	612	692	2	48	80	0.6000000
NODE_5429_length_1070_cov_8.963955	871	900	0	2	29	0.0689655
NODE_5429_length_1070_cov_8.963955	871	900	4	3	29	0.1034483
NODE_5429_length_1070_cov_8.963955	871	900	6	1	29	0.0344828
NODE_5429_length_1070_cov_8.963955	871	900	10	1	29	0.0344828
NODE_5429_length_1070_cov_8.963955	871	900	12	1	29	0.0344828
NODE_5429_length_1070_cov_8.963955	871	900	14	1	29	0.0344828
NODE_5429_length_1070_cov_8.963955	871	900	18	1	29	0.0344828
NODE_5429_length_1070_cov_8.963955	871	900	20	1	29	0.0344828
NODE_5429_length_1070_cov_8.963955	871	900	22	2	29	0.0689655
NODE_5429_length_1070_cov_8.963955	871	900	24	4	29	0.1379310
NODE_5429_length_1070_cov_8.963955	871	900	28	2	29	0.0689655
NODE_5429_length_1070_cov_8.963955	871	900	32	3	29	0.1034483
NODE_5429_length_1070_cov_8.963955	871	900	34	1	29	0.0344828
NODE_5429_length_1070_cov_8.963955	871	900	41	1	29	0.0344828
NODE_5429_length_1070_cov_8.963955	871	900	42	2	29	0.0689655
NODE_5429_length_1070_cov_8.963955	871	900	44	1	29	0.0344828
NODE_5429_length_1070_cov_8.963955	871	900	46	1	29	0.0344828
NODE_5429_length_1070_cov_8.963955	871	900	50	1	29	0.0344828
NODE_5429_length_1070_cov_8.963955	873	953	4	3	80	0.0375000
NODE_5429_length_1070_cov_8.963955	873	953	6	1	80	0.0125000
NODE_5429_length_1070_cov_8.963955	873	953	10	1	80	0.0125000
NODE_5429_length_1070_cov_8.963955	873	953	12	1	80	0.0125000
NODE_5429_length_1070_cov_8.963955	873	953	14	1	80	0.0125000
NODE_5429_length_1070_cov_8.963955	873	953	18	1	80	0.0125000
NODE_5429_length_1070_cov_8.963955	873	953	20	1	80	0.0125000
NODE_5429_length_1070_cov_8.963955	873	953	22	2	80	0.0250000
NODE_5429_length_1070_cov_8.963955	873	953	24	4	80	0.0500000
NODE_5429_length_1070_cov_8.963955	873	953	28	2	80	0.0250000
NODE_5429_length_1070_cov_8.963955	873	953	32	3	80	0.0375000
NODE_5429_length_1070_cov_8.963955	873	953	34	1	80	0.0125000
NODE_5429_length_1070_cov_8.963955	873	953	41	1	80	0.0125000
NODE_5429_length_1070_cov_8.963955	873	953	42	2	80	0.0250000
NODE_5429_length_1070_cov_8.963955	873	953	44	1	80	0.0125000
NODE_5429_length_1070_cov_8.963955	873	953	46	1	80	0.0125000
NODE_5429_length_1070_cov_8.963955	873	953	50	1	80	0.0125000
NODE_5429_length_1070_cov_8.963955	873	953	52	1	80	0.0125000
NODE_5429_length_1070_cov_8.963955	873	953	61	2	80	0.0250000
NODE_5429_length_1070_cov_8.963955	873	953	63	1	80	0.0125000
NODE_5429_length_1070_cov_8.963955	873	953	71	2	80	0.0250000
NODE_5429_length_1070_cov_8.963955	873	953	74	2	80	0.0250000
NODE_5429_length_1070_cov_8.963955	873	953	82	2	80	0.0250000
NODE_5429_length_1070_cov_8.963955	873	953	84	1	80	0.0125000
NODE_5429_length_1070_cov_8.963955	873	953	89	1	80	0.0125000
NODE_5429_length_1070_cov_8.963955	873	953	93	1	80	0.0125000
NODE_5429_length_1070_cov_8.963955	873	953	99	1	80	0.0125000
NODE_5429_length_1070_cov_8.963955	873	953	104	2	80	0.0250000
NODE_5429_length_1070_cov_8.963955	873	953	108	1	80	0.0125000
NODE_5429_length_1070_cov_8.963955	873	953	110	1	80	0.0125000
NODE_5429_length_1070_cov_8.963955	873	953	114	1	80	0.0125000
NODE_5429_length_1070_cov_8.963955	873	953	116	5	80	0.0625000
NODE_5429_length_1070_cov_8.963955	873	953	118	2	80	0.0250000
NODE_5429_length_1070_cov_8.963955	873	953	120	3	80	0.0375000
NODE_5429_length_1070_cov_8.963955	873	953	124	4	80	0.0500000
NODE_5429_length_1070_cov_8.963955	873	953	128	2	80	0.0250000
NODE_5429_length_1070_cov_8.963955	873	953	130	1	80	0.0125000
NODE_5429_length_1070_cov_8.963955	873	953	134	2	80	0.0250000
NODE_5429_length_1070_cov_8.963955	873	953	136	12	80	0.1500000
NODE_5429_length_1070_cov_8.963955	873	953	137	1	80	0.0125000
NODE_5429_length_1070_cov_8.963955	873	953	138	2	80	0.0250000
NODE_5433_length_1070_cov_1.659114	1027	1046	2	19	19	1.0000000
NODE_5439_length_1069_cov_40.277320	451	531	0	15	80	0.1875000
NODE_5439_length_1069_cov_40.277320	451	531	2	5	80	0.0625000
NODE_5439_length_1069_cov_40.277320	451	531	4	6	80	0.0750000
NODE_5439_length_1069_cov_40.277320	451	531	6	37	80	0.4625000
NODE_5439_length_1069_cov_40.277320	451	531	8	17	80	0.2125000
NODE_5439_length_1069_cov_40.277320	504	584	4	38	80	0.4750000
NODE_5439_length_1069_cov_40.277320	504	584	6	18	80	0.2250000
NODE_5439_length_1069_cov_40.277320	504	584	8	18	80	0.2250000
NODE_5439_length_1069_cov_40.277320	504	584	10	6	80	0.0750000
NODE_5440_length_1069_cov_23.571134	274	354	2	80	80	1.0000000
NODE_5440_length_1069_cov_23.571134	327	407	0	45	80	0.5625000
NODE_5440_length_1069_cov_23.571134	327	407	2	35	80	0.4375000
NODE_5441_length_1069_cov_22.436082	185	265	0	35	80	0.4375000
NODE_5441_length_1069_cov_22.436082	185	265	1	15	80	0.1875000
NODE_5441_length_1069_cov_22.436082	185	265	2	30	80	0.3750000
NODE_5441_length_1069_cov_22.436082	238	318	0	28	80	0.3500000
NODE_5441_length_1069_cov_22.436082	238	318	2	52	80	0.6500000
NODE_5442_length_1069_cov_18.207216	436	516	0	38	80	0.4750000
NODE_5442_length_1069_cov_18.207216	436	516	2	4	80	0.0500000
NODE_5442_length_1069_cov_18.207216	436	516	6	9	80	0.1125000
NODE_5442_length_1069_cov_18.207216	436	516	8	4	80	0.0500000
NODE_5442_length_1069_cov_18.207216	436	516	10	10	80	0.1250000
NODE_5442_length_1069_cov_18.207216	436	516	12	15	80	0.1875000
NODE_5442_length_1069_cov_18.207216	489	569	6	11	80	0.1375000
NODE_5442_length_1069_cov_18.207216	489	569	8	9	80	0.1125000
NODE_5442_length_1069_cov_18.207216	489	569	10	16	80	0.2000000
NODE_5442_length_1069_cov_18.207216	489	569	12	44	80	0.5500000
NODE_5443_length_1069_cov_17.601031	596	676	0	34	80	0.4250000
NODE_5443_length_1069_cov_17.601031	596	676	2	46	80	0.5750000
NODE_5443_length_1069_cov_17.601031	649	729	2	80	80	1.0000000
NODE_5444_length_1069_cov_16.318557	353	433	0	80	80	1.0000000
NODE_5444_length_1069_cov_16.318557	406	486	0	80	80	1.0000000
NODE_5444_length_1069_cov_16.318557	482	562	0	80	80	1.0000000
NODE_5444_length_1069_cov_16.318557	535	615	0	80	80	1.0000000
NODE_5445_length_1069_cov_13.349485	471	551	0	46	80	0.5750000
NODE_5445_length_1069_cov_13.349485	471	551	2	7	80	0.0875000
NODE_5445_length_1069_cov_13.349485	471	551	4	27	80	0.3375000
NODE_5445_length_1069_cov_13.349485	524	604	2	11	80	0.1375000
NODE_5445_length_1069_cov_13.349485	524	604	4	69	80	0.8625000
NODE_5446_length_1069_cov_13.050515	314	394	4	46	80	0.5750000
NODE_5446_length_1069_cov_13.050515	314	394	6	34	80	0.4250000
NODE_5446_length_1069_cov_13.050515	367	447	0	32	80	0.4000000
NODE_5446_length_1069_cov_13.050515	367	447	4	48	80	0.6000000
NODE_5447_length_1069_cov_12.818557	240	320	0	80	80	1.0000000
NODE_5447_length_1069_cov_12.818557	293	373	0	80	80	1.0000000
NODE_5448_length_1069_cov_11.985567	554	634	0	28	80	0.3500000
NODE_5448_length_1069_cov_11.985567	554	634	11	2	80	0.0250000
NODE_5448_length_1069_cov_11.985567	554	634	12	50	80	0.6250000
NODE_5448_length_1069_cov_11.985567	607	687	12	80	80	1.0000000
NODE_5449_length_1069_cov_10.812371	366	446	0	47	80	0.5875000
NODE_5449_length_1069_cov_10.812371	366	446	1	1	80	0.0125000
NODE_5449_length_1069_cov_10.812371	366	446	2	32	80	0.4000000
NODE_5449_length_1069_cov_10.812371	419	499	0	15	80	0.1875000
NODE_5449_length_1069_cov_10.812371	419	499	2	65	80	0.8125000
NODE_5450_length_1069_cov_7.729897	482	562	2	73	80	0.9125000
NODE_5450_length_1069_cov_7.729897	482	562	4	7	80	0.0875000
NODE_5450_length_1069_cov_7.729897	535	615	0	44	80	0.5500000
NODE_5450_length_1069_cov_7.729897	535	615	2	36	80	0.4500000
NODE_5456_length_1068_cov_31.692466	314	394	0	80	80	1.0000000
NODE_5456_length_1068_cov_31.692466	367	447	0	80	80	1.0000000
NODE_5456_length_1068_cov_31.692466	443	523	0	80	80	1.0000000
NODE_5456_length_1068_cov_31.692466	496	576	0	80	80	1.0000000
NODE_5457_length_1068_cov_29.579979	347	427	0	80	80	1.0000000
NODE_5457_length_1068_cov_29.579979	400	480	0	80	80	1.0000000
NODE_5459_length_1068_cov_23.020640	476	556	0	69	80	0.8625000
NODE_5459_length_1068_cov_23.020640	476	556	4	11	80	0.1375000
NODE_5459_length_1068_cov_23.020640	529	609	0	16	80	0.2000000
NODE_5459_length_1068_cov_23.020640	529	609	4	12	80	0.1500000
NODE_5459_length_1068_cov_23.020640	529	609	6	27	80	0.3375000
NODE_5459_length_1068_cov_23.020640	529	609	8	25	80	0.3125000
NODE_5460_length_1068_cov_15.272446	546	626	0	80	80	1.0000000
NODE_5460_length_1068_cov_15.272446	599	679	0	80	80	1.0000000
NODE_5461_length_1068_cov_13.557276	674	754	0	22	80	0.2750000
NODE_5461_length_1068_cov_13.557276	674	754	4	58	80	0.7250000
NODE_5461_length_1068_cov_13.557276	727	807	0	21	80	0.2625000
NODE_5461_length_1068_cov_13.557276	727	807	4	59	80	0.7375000
NODE_5479_length_1067_cov_48.282025	429	509	0	80	80	1.0000000
NODE_5479_length_1067_cov_48.282025	482	562	0	80	80	1.0000000
NODE_5480_length_1067_cov_41.111570	460	540	2	46	80	0.5750000
NODE_5480_length_1067_cov_41.111570	460	540	4	34	80	0.4250000
NODE_5480_length_1067_cov_41.111570	513	593	0	15	80	0.1875000
NODE_5480_length_1067_cov_41.111570	513	593	2	8	80	0.1000000
NODE_5480_length_1067_cov_41.111570	513	593	4	57	80	0.7125000
NODE_5481_length_1067_cov_39.109504	295	375	0	80	80	1.0000000
NODE_5481_length_1067_cov_39.109504	348	428	0	66	80	0.8250000
NODE_5481_length_1067_cov_39.109504	348	428	2	14	80	0.1750000
NODE_5481_length_1067_cov_39.109504	424	504	2	51	80	0.6375000
NODE_5481_length_1067_cov_39.109504	424	504	4	29	80	0.3625000
NODE_5481_length_1067_cov_39.109504	477	557	2	50	80	0.6250000
NODE_5481_length_1067_cov_39.109504	477	557	4	30	80	0.3750000
NODE_5482_length_1067_cov_35.426653	252	332	2	25	80	0.3125000
NODE_5482_length_1067_cov_35.426653	252	332	4	55	80	0.6875000
NODE_5482_length_1067_cov_35.426653	305	385	0	7	80	0.0875000
NODE_5482_length_1067_cov_35.426653	305	385	2	3	80	0.0375000
NODE_5482_length_1067_cov_35.426653	305	385	4	70	80	0.8750000
NODE_5483_length_1067_cov_29.467975	412	492	2	34	80	0.4250000
NODE_5483_length_1067_cov_29.467975	412	492	4	2	80	0.0250000
NODE_5483_length_1067_cov_29.467975	412	492	6	44	80	0.5500000
NODE_5483_length_1067_cov_29.467975	465	545	0	2	80	0.0250000
NODE_5483_length_1067_cov_29.467975	465	545	2	22	80	0.2750000
NODE_5483_length_1067_cov_29.467975	465	545	4	14	80	0.1750000
NODE_5483_length_1067_cov_29.467975	465	545	6	42	80	0.5250000
NODE_5484_length_1067_cov_20.738636	579	645	10	7	66	0.1060606
NODE_5484_length_1067_cov_20.738636	579	645	13	1	66	0.0151515
NODE_5484_length_1067_cov_20.738636	579	645	15	19	66	0.2878788
NODE_5484_length_1067_cov_20.738636	579	645	16	1	66	0.0151515
NODE_5484_length_1067_cov_20.738636	579	645	18	4	66	0.0606061
NODE_5484_length_1067_cov_20.738636	579	645	20	1	66	0.0151515
NODE_5484_length_1067_cov_20.738636	579	645	24	3	66	0.0454545
NODE_5484_length_1067_cov_20.738636	579	645	26	3	66	0.0454545
NODE_5484_length_1067_cov_20.738636	579	645	28	1	66	0.0151515
NODE_5484_length_1067_cov_20.738636	579	645	32	11	66	0.1666667
NODE_5484_length_1067_cov_20.738636	579	645	34	15	66	0.2272727
NODE_5484_length_1067_cov_20.738636	618	698	28	1	80	0.0125000
NODE_5484_length_1067_cov_20.738636	618	698	32	11	80	0.1375000
NODE_5484_length_1067_cov_20.738636	618	698	34	22	80	0.2750000
NODE_5484_length_1067_cov_20.738636	618	698	36	8	80	0.1000000
NODE_5484_length_1067_cov_20.738636	618	698	40	1	80	0.0125000
NODE_5484_length_1067_cov_20.738636	618	698	42	1	80	0.0125000
NODE_5484_length_1067_cov_20.738636	618	698	44	1	80	0.0125000
NODE_5484_length_1067_cov_20.738636	618	698	45	1	80	0.0125000
NODE_5484_length_1067_cov_20.738636	618	698	46	7	80	0.0875000
NODE_5484_length_1067_cov_20.738636	618	698	48	7	80	0.0875000
NODE_5484_length_1067_cov_20.738636	618	698	50	19	80	0.2375000
NODE_5484_length_1067_cov_20.738636	618	698	52	1	80	0.0125000
NODE_5485_length_1067_cov_15.280992	538	617	0	79	79	1.0000000
NODE_5485_length_1067_cov_15.280992	590	670	0	80	80	1.0000000
NODE_5486_length_1067_cov_13.708678	478	558	0	80	80	1.0000000
NODE_5486_length_1067_cov_13.708678	531	611	0	80	80	1.0000000
NODE_5488_length_1067_cov_9.070248	625	705	0	63	80	0.7875000
NODE_5488_length_1067_cov_9.070248	625	705	2	17	80	0.2125000
NODE_5488_length_1067_cov_9.070248	678	758	0	10	80	0.1250000
NODE_5488_length_1067_cov_9.070248	678	758	2	70	80	0.8750000
NODE_5494_length_1067_cov_1.946281	765	812	0	43	47	0.9148936
NODE_5494_length_1067_cov_1.946281	765	812	2	4	47	0.0851064
NODE_5501_length_1066_cov_54.227508	395	475	0	13	80	0.1625000
NODE_5501_length_1066_cov_54.227508	395	475	4	29	80	0.3625000
NODE_5501_length_1066_cov_54.227508	395	475	6	22	80	0.2750000
NODE_5501_length_1066_cov_54.227508	395	475	8	16	80	0.2000000
NODE_5501_length_1066_cov_54.227508	448	528	2	15	80	0.1875000
NODE_5501_length_1066_cov_54.227508	448	528	4	5	80	0.0625000
NODE_5501_length_1066_cov_54.227508	448	528	6	44	80	0.5500000
NODE_5501_length_1066_cov_54.227508	448	528	8	16	80	0.2000000
NODE_5502_length_1066_cov_33.501551	357	437	2	44	80	0.5500000
NODE_5502_length_1066_cov_33.501551	357	437	4	16	80	0.2000000
NODE_5502_length_1066_cov_33.501551	357	437	6	4	80	0.0500000
NODE_5502_length_1066_cov_33.501551	357	437	8	16	80	0.2000000
NODE_5502_length_1066_cov_33.501551	410	490	4	7	80	0.0875000
NODE_5502_length_1066_cov_33.501551	410	490	6	4	80	0.0500000
NODE_5502_length_1066_cov_33.501551	410	490	8	69	80	0.8625000
NODE_5503_length_1066_cov_33.115822	397	477	0	4	80	0.0500000
NODE_5503_length_1066_cov_33.115822	397	477	2	46	80	0.5750000
NODE_5503_length_1066_cov_33.115822	397	477	4	17	80	0.2125000
NODE_5503_length_1066_cov_33.115822	397	477	5	2	80	0.0250000
NODE_5503_length_1066_cov_33.115822	397	477	6	11	80	0.1375000
NODE_5503_length_1066_cov_33.115822	450	530	4	25	80	0.3125000
NODE_5503_length_1066_cov_33.115822	450	530	5	2	80	0.0250000
NODE_5503_length_1066_cov_33.115822	450	530	6	53	80	0.6625000
NODE_5504_length_1066_cov_26.517063	215	285	172	3	70	0.0428571
NODE_5504_length_1066_cov_26.517063	215	285	174	1	70	0.0142857
NODE_5504_length_1066_cov_26.517063	215	285	175	1	70	0.0142857
NODE_5504_length_1066_cov_26.517063	215	285	176	1	70	0.0142857
NODE_5504_length_1066_cov_26.517063	215	285	178	1	70	0.0142857
NODE_5504_length_1066_cov_26.517063	215	285	180	1	70	0.0142857
NODE_5504_length_1066_cov_26.517063	215	285	181	4	70	0.0571429
NODE_5504_length_1066_cov_26.517063	215	285	184	2	70	0.0285714
NODE_5504_length_1066_cov_26.517063	215	285	188	1	70	0.0142857
NODE_5504_length_1066_cov_26.517063	215	285	191	2	70	0.0285714
NODE_5504_length_1066_cov_26.517063	215	285	193	2	70	0.0285714
NODE_5504_length_1066_cov_26.517063	215	285	195	1	70	0.0142857
NODE_5504_length_1066_cov_26.517063	215	285	198	1	70	0.0142857
NODE_5504_length_1066_cov_26.517063	215	285	199	2	70	0.0285714
NODE_5504_length_1066_cov_26.517063	215	285	201	2	70	0.0285714
NODE_5504_length_1066_cov_26.517063	215	285	203	1	70	0.0142857
NODE_5504_length_1066_cov_26.517063	215	285	209	1	70	0.0142857
NODE_5504_length_1066_cov_26.517063	215	285	213	2	70	0.0285714
NODE_5504_length_1066_cov_26.517063	215	285	215	3	70	0.0428571
NODE_5504_length_1066_cov_26.517063	215	285	217	2	70	0.0285714
NODE_5504_length_1066_cov_26.517063	215	285	218	1	70	0.0142857
NODE_5504_length_1066_cov_26.517063	215	285	219	2	70	0.0285714
NODE_5504_length_1066_cov_26.517063	215	285	222	1	70	0.0142857
NODE_5504_length_1066_cov_26.517063	215	285	223	1	70	0.0142857
NODE_5504_length_1066_cov_26.517063	215	285	229	1	70	0.0142857
NODE_5504_length_1066_cov_26.517063	215	285	230	1	70	0.0142857
NODE_5504_length_1066_cov_26.517063	215	285	249	1	70	0.0142857
NODE_5504_length_1066_cov_26.517063	215	285	253	1	70	0.0142857
NODE_5504_length_1066_cov_26.517063	215	285	255	1	70	0.0142857
NODE_5504_length_1066_cov_26.517063	215	285	263	1	70	0.0142857
NODE_5504_length_1066_cov_26.517063	215	285	269	1	70	0.0142857
NODE_5504_length_1066_cov_26.517063	215	285	292	1	70	0.0142857
NODE_5504_length_1066_cov_26.517063	215	285	299	1	70	0.0142857
NODE_5504_length_1066_cov_26.517063	215	285	301	2	70	0.0285714
NODE_5504_length_1066_cov_26.517063	215	285	303	5	70	0.0714286
NODE_5504_length_1066_cov_26.517063	215	285	305	3	70	0.0428571
NODE_5504_length_1066_cov_26.517063	215	285	306	4	70	0.0571429
NODE_5504_length_1066_cov_26.517063	215	285	307	1	70	0.0142857
NODE_5504_length_1066_cov_26.517063	215	285	310	3	70	0.0428571
NODE_5504_length_1066_cov_26.517063	215	285	311	1	70	0.0142857
NODE_5504_length_1066_cov_26.517063	215	285	313	1	70	0.0142857
NODE_5504_length_1066_cov_26.517063	215	285	317	1	70	0.0142857
NODE_5504_length_1066_cov_26.517063	215	285	319	1	70	0.0142857
NODE_5505_length_1066_cov_16.906929	526	606	0	80	80	1.0000000
NODE_5505_length_1066_cov_16.906929	579	659	0	80	80	1.0000000
NODE_5506_length_1066_cov_16.190279	298	378	0	54	80	0.6750000
NODE_5506_length_1066_cov_16.190279	298	378	2	8	80	0.1000000
NODE_5506_length_1066_cov_16.190279	298	378	4	12	80	0.1500000
NODE_5506_length_1066_cov_16.190279	298	378	6	6	80	0.0750000
NODE_5506_length_1066_cov_16.190279	351	432	0	1	81	0.0123457
NODE_5506_length_1066_cov_16.190279	351	432	2	8	81	0.0987654
NODE_5506_length_1066_cov_16.190279	351	432	4	12	81	0.1481481
NODE_5506_length_1066_cov_16.190279	351	432	6	60	81	0.7407407
NODE_5507_length_1066_cov_15.444674	582	662	4	1	80	0.0125000
NODE_5507_length_1066_cov_15.444674	582	662	6	1	80	0.0125000
NODE_5507_length_1066_cov_15.444674	582	662	8	18	80	0.2250000
NODE_5507_length_1066_cov_15.444674	582	662	10	13	80	0.1625000
NODE_5507_length_1066_cov_15.444674	582	662	12	47	80	0.5875000
NODE_5507_length_1066_cov_15.444674	635	715	0	13	80	0.1625000
NODE_5507_length_1066_cov_15.444674	635	715	2	34	80	0.4250000
NODE_5507_length_1066_cov_15.444674	635	715	4	7	80	0.0875000
NODE_5507_length_1066_cov_15.444674	635	715	6	1	80	0.0125000
NODE_5507_length_1066_cov_15.444674	635	715	8	18	80	0.2250000
NODE_5507_length_1066_cov_15.444674	635	715	10	7	80	0.0875000
NODE_5516_length_1065_cov_51.693582	480	560	0	34	80	0.4250000
NODE_5516_length_1065_cov_51.693582	480	560	2	46	80	0.5750000
NODE_5516_length_1065_cov_51.693582	533	613	0	80	80	1.0000000
NODE_5517_length_1065_cov_33.428571	422	502	5	40	80	0.5000000
NODE_5517_length_1065_cov_33.428571	422	502	6	40	80	0.5000000
NODE_5517_length_1065_cov_33.428571	422	502	5	40	80	0.5000000
NODE_5517_length_1065_cov_33.428571	422	502	6	40	80	0.5000000
NODE_5517_length_1065_cov_33.428571	422	502	5	40	80	0.5000000
NODE_5517_length_1065_cov_33.428571	422	502	6	40	80	0.5000000
NODE_5517_length_1065_cov_33.428571	475	555	1	12	80	0.1500000
NODE_5517_length_1065_cov_33.428571	475	555	3	1	80	0.0125000
NODE_5517_length_1065_cov_33.428571	475	555	4	4	80	0.0500000
NODE_5517_length_1065_cov_33.428571	475	555	5	37	80	0.4625000
NODE_5517_length_1065_cov_33.428571	475	555	6	25	80	0.3125000
NODE_5517_length_1065_cov_33.428571	475	555	7	1	80	0.0125000
NODE_5517_length_1065_cov_33.428571	475	555	1	12	80	0.1500000
NODE_5517_length_1065_cov_33.428571	475	555	3	1	80	0.0125000
NODE_5517_length_1065_cov_33.428571	475	555	4	4	80	0.0500000
NODE_5517_length_1065_cov_33.428571	475	555	5	37	80	0.4625000
NODE_5517_length_1065_cov_33.428571	475	555	6	25	80	0.3125000
NODE_5517_length_1065_cov_33.428571	475	555	7	1	80	0.0125000
NODE_5517_length_1065_cov_33.428571	551	631	6	14	80	0.1750000
NODE_5517_length_1065_cov_33.428571	551	631	7	3	80	0.0375000
NODE_5517_length_1065_cov_33.428571	551	631	8	36	80	0.4500000
NODE_5517_length_1065_cov_33.428571	551	631	9	6	80	0.0750000
NODE_5517_length_1065_cov_33.428571	551	631	11	21	80	0.2625000
NODE_5517_length_1065_cov_33.428571	551	631	6	14	80	0.1750000
NODE_5517_length_1065_cov_33.428571	551	631	7	3	80	0.0375000
NODE_5517_length_1065_cov_33.428571	551	631	8	36	80	0.4500000
NODE_5517_length_1065_cov_33.428571	551	631	9	6	80	0.0750000
NODE_5517_length_1065_cov_33.428571	551	631	11	21	80	0.2625000
NODE_5517_length_1065_cov_33.428571	551	572	6	4	21	0.1904762
NODE_5517_length_1065_cov_33.428571	551	572	7	1	21	0.0476190
NODE_5517_length_1065_cov_33.428571	551	572	8	16	21	0.7619048
NODE_5517_length_1065_cov_33.428571	604	666	6	44	62	0.7096774
NODE_5517_length_1065_cov_33.428571	604	666	7	2	62	0.0322581
NODE_5517_length_1065_cov_33.428571	604	666	8	12	62	0.1935484
NODE_5517_length_1065_cov_33.428571	604	666	11	4	62	0.0645161
NODE_5517_length_1065_cov_33.428571	604	684	6	62	80	0.7750000
NODE_5517_length_1065_cov_33.428571	604	684	7	2	80	0.0250000
NODE_5517_length_1065_cov_33.428571	604	684	8	12	80	0.1500000
NODE_5517_length_1065_cov_33.428571	604	684	11	4	80	0.0500000
NODE_5518_length_1065_cov_31.874741	255	335	0	80	80	1.0000000
NODE_5518_length_1065_cov_31.874741	308	388	0	80	80	1.0000000
NODE_5519_length_1065_cov_21.762940	234	314	0	61	80	0.7625000
NODE_5519_length_1065_cov_21.762940	234	314	4	19	80	0.2375000
NODE_5519_length_1065_cov_21.762940	287	367	0	8	80	0.1000000
NODE_5519_length_1065_cov_21.762940	287	367	4	72	80	0.9000000
NODE_5520_length_1065_cov_19.947205	447	527	0	80	80	1.0000000
NODE_5520_length_1065_cov_19.947205	500	580	0	80	80	1.0000000
NODE_5521_length_1065_cov_14.590062	343	423	2	30	80	0.3750000
NODE_5521_length_1065_cov_14.590062	343	423	4	50	80	0.6250000
NODE_5521_length_1065_cov_14.590062	396	476	0	37	80	0.4625000
NODE_5521_length_1065_cov_14.590062	396	476	2	28	80	0.3500000
NODE_5521_length_1065_cov_14.590062	396	476	4	15	80	0.1875000
NODE_5522_length_1065_cov_13.232919	243	323	0	80	80	1.0000000
NODE_5522_length_1065_cov_13.232919	296	376	0	80	80	1.0000000
NODE_5523_length_1065_cov_10.670807	481	561	0	77	80	0.9625000
NODE_5523_length_1065_cov_10.670807	481	561	2	3	80	0.0375000
NODE_5523_length_1065_cov_10.670807	534	614	0	24	80	0.3000000
NODE_5523_length_1065_cov_10.670807	534	614	2	56	80	0.7000000
NODE_5524_length_1065_cov_10.473085	496	576	0	80	80	1.0000000
NODE_5524_length_1065_cov_10.473085	549	629	0	80	80	1.0000000
NODE_5525_length_1065_cov_9.711180	286	360	0	74	74	1.0000000
NODE_5525_length_1065_cov_9.711180	339	419	0	80	80	1.0000000
NODE_5534_length_1064_cov_59.929534	457	537	0	80	80	1.0000000
NODE_5534_length_1064_cov_59.929534	510	590	0	80	80	1.0000000
NODE_5534_length_1064_cov_59.929534	586	666	0	80	80	1.0000000
NODE_5534_length_1064_cov_59.929534	639	719	0	80	80	1.0000000
NODE_5535_length_1064_cov_36.480829	367	447	0	80	80	1.0000000
NODE_5535_length_1064_cov_36.480829	420	500	0	80	80	1.0000000
NODE_5535_length_1064_cov_36.480829	496	576	0	53	80	0.6625000
NODE_5535_length_1064_cov_36.480829	496	576	2	27	80	0.3375000
NODE_5535_length_1064_cov_36.480829	549	629	0	12	80	0.1500000
NODE_5535_length_1064_cov_36.480829	549	629	2	68	80	0.8500000
NODE_5536_length_1064_cov_32.307772	547	627	0	41	80	0.5125000
NODE_5536_length_1064_cov_32.307772	547	627	2	3	80	0.0375000
NODE_5536_length_1064_cov_32.307772	547	627	4	21	80	0.2625000
NODE_5536_length_1064_cov_32.307772	547	627	6	15	80	0.1875000
NODE_5536_length_1064_cov_32.307772	600	680	4	12	80	0.1500000
NODE_5536_length_1064_cov_32.307772	600	680	6	23	80	0.2875000
NODE_5536_length_1064_cov_32.307772	600	680	8	45	80	0.5625000
NODE_5537_length_1064_cov_25.255959	462	542	2	80	80	1.0000000
NODE_5537_length_1064_cov_25.255959	515	595	0	32	80	0.4000000
NODE_5537_length_1064_cov_25.255959	515	595	2	48	80	0.6000000
NODE_5537_length_1064_cov_25.255959	591	671	0	45	80	0.5625000
NODE_5537_length_1064_cov_25.255959	591	671	2	28	80	0.3500000
NODE_5537_length_1064_cov_25.255959	591	671	4	7	80	0.0875000
NODE_5537_length_1064_cov_25.255959	644	724	2	20	80	0.2500000
NODE_5537_length_1064_cov_25.255959	644	724	4	60	80	0.7500000
NODE_5538_length_1064_cov_23.053886	343	423	0	80	80	1.0000000
NODE_5538_length_1064_cov_23.053886	396	476	0	80	80	1.0000000
NODE_5538_length_1064_cov_23.053886	472	552	0	80	80	1.0000000
NODE_5538_length_1064_cov_23.053886	525	605	0	80	80	1.0000000
NODE_5539_length_1064_cov_22.018653	479	559	0	80	80	1.0000000
NODE_5539_length_1064_cov_22.018653	532	612	0	80	80	1.0000000
NODE_5540_length_1064_cov_12.868394	424	504	0	80	80	1.0000000
NODE_5540_length_1064_cov_12.868394	477	557	0	80	80	1.0000000
NODE_5541_length_1064_cov_10.098446	467	547	0	80	80	1.0000000
NODE_5541_length_1064_cov_10.098446	520	600	0	80	80	1.0000000
NODE_5543_length_1064_cov_2.925389	173	245	2	8	72	0.1111111
NODE_5543_length_1064_cov_2.925389	173	245	6	24	72	0.3333333
NODE_5543_length_1064_cov_2.925389	173	245	8	16	72	0.2222222
NODE_5543_length_1064_cov_2.925389	173	245	10	12	72	0.1666667
NODE_5543_length_1064_cov_2.925389	173	245	12	4	72	0.0555556
NODE_5543_length_1064_cov_2.925389	173	245	14	8	72	0.1111111
NODE_5551_length_1063_cov_104.615145	504	584	2	28	80	0.3500000
NODE_5551_length_1063_cov_104.615145	504	584	4	23	80	0.2875000
NODE_5551_length_1063_cov_104.615145	504	584	6	5	80	0.0625000
NODE_5551_length_1063_cov_104.615145	504	584	8	24	80	0.3000000
NODE_5551_length_1063_cov_104.615145	557	637	0	36	80	0.4500000
NODE_5551_length_1063_cov_104.615145	557	637	2	44	80	0.5500000
NODE_5552_length_1063_cov_36.515560	482	562	0	80	80	1.0000000
NODE_5552_length_1063_cov_36.515560	535	615	0	80	80	1.0000000
NODE_5552_length_1063_cov_36.515560	611	691	0	80	80	1.0000000
NODE_5552_length_1063_cov_36.515560	664	744	0	80	80	1.0000000
NODE_5553_length_1063_cov_30.700207	470	550	0	3	80	0.0375000
NODE_5553_length_1063_cov_30.700207	470	550	2	16	80	0.2000000
NODE_5553_length_1063_cov_30.700207	470	550	4	61	80	0.7625000
NODE_5553_length_1063_cov_30.700207	523	603	0	48	80	0.6000000
NODE_5553_length_1063_cov_30.700207	523	603	2	11	80	0.1375000
NODE_5553_length_1063_cov_30.700207	523	603	4	21	80	0.2625000
NODE_5553_length_1063_cov_30.700207	599	679	0	80	80	1.0000000
NODE_5553_length_1063_cov_30.700207	652	732	0	80	80	1.0000000
NODE_5554_length_1063_cov_24.552905	362	442	0	80	80	1.0000000
NODE_5554_length_1063_cov_24.552905	415	495	0	45	80	0.5625000
NODE_5554_length_1063_cov_24.552905	415	495	2	35	80	0.4375000
NODE_5555_length_1063_cov_21.985477	407	487	0	80	80	1.0000000
NODE_5555_length_1063_cov_21.985477	460	540	0	80	80	1.0000000
NODE_5555_length_1063_cov_21.985477	536	616	0	25	80	0.3125000
NODE_5555_length_1063_cov_21.985477	536	616	4	52	80	0.6500000
NODE_5555_length_1063_cov_21.985477	536	616	6	3	80	0.0375000
NODE_5555_length_1063_cov_21.985477	589	670	2	12	81	0.1481481
NODE_5555_length_1063_cov_21.985477	589	670	4	24	81	0.2962963
NODE_5555_length_1063_cov_21.985477	589	670	6	45	81	0.5555556
NODE_5557_length_1063_cov_15.400415	685	765	0	60	80	0.7500000
NODE_5557_length_1063_cov_15.400415	685	765	2	20	80	0.2500000
NODE_5557_length_1063_cov_15.400415	738	818	0	80	80	1.0000000
NODE_5558_length_1063_cov_13.282158	510	590	0	80	80	1.0000000
NODE_5558_length_1063_cov_13.282158	563	643	0	80	80	1.0000000
NODE_5559_length_1063_cov_12.970954	417	495	0	78	78	1.0000000
NODE_5559_length_1063_cov_12.970954	468	548	0	80	80	1.0000000
NODE_5560_length_1063_cov_7.917012	639	719	0	80	80	1.0000000
NODE_5560_length_1063_cov_7.917012	692	772	0	80	80	1.0000000
NODE_5569_length_1063_cov_1.695021	893	947	8	2	54	0.0370370
NODE_5569_length_1063_cov_1.695021	893	947	10	44	54	0.8148148
NODE_5569_length_1063_cov_1.695021	893	947	12	8	54	0.1481481
NODE_5574_length_1062_cov_43.399792	272	352	0	80	80	1.0000000
NODE_5574_length_1062_cov_43.399792	325	405	0	80	80	1.0000000
NODE_5576_length_1062_cov_19.778816	401	481	0	80	80	1.0000000
NODE_5576_length_1062_cov_19.778816	454	534	0	80	80	1.0000000
NODE_5577_length_1062_cov_16.034268	628	708	0	16	80	0.2000000
NODE_5577_length_1062_cov_16.034268	628	708	2	64	80	0.8000000
NODE_5577_length_1062_cov_16.034268	681	761	0	54	80	0.6750000
NODE_5577_length_1062_cov_16.034268	681	761	2	26	80	0.3250000
NODE_5578_length_1062_cov_13.346833	623	703	0	80	80	1.0000000
NODE_5578_length_1062_cov_13.346833	676	756	0	80	80	1.0000000
NODE_5579_length_1062_cov_9.886812	670	750	0	80	80	1.0000000
NODE_5579_length_1062_cov_9.886812	723	803	0	80	80	1.0000000
NODE_5580_length_1062_cov_9.078920	525	604	0	46	79	0.5822785
NODE_5580_length_1062_cov_9.078920	525	604	2	33	79	0.4177215
NODE_5580_length_1062_cov_9.078920	577	657	2	48	80	0.6000000
NODE_5580_length_1062_cov_9.078920	577	657	4	32	80	0.4000000
NODE_5581_length_1062_cov_8.934579	203	283	0	80	80	1.0000000
NODE_5581_length_1062_cov_8.934579	256	336	0	80	80	1.0000000
NODE_5588_length_1061_cov_22.637214	418	498	0	52	80	0.6500000
NODE_5588_length_1061_cov_22.637214	418	498	2	28	80	0.3500000
NODE_5588_length_1061_cov_22.637214	471	551	0	80	80	1.0000000
NODE_5589_length_1061_cov_22.338877	479	559	0	80	80	1.0000000
NODE_5589_length_1061_cov_22.338877	532	612	0	80	80	1.0000000
NODE_5597_length_1060_cov_31.595213	394	473	2	26	79	0.3291139
NODE_5597_length_1060_cov_31.595213	394	473	4	53	79	0.6708861
NODE_5597_length_1060_cov_31.595213	446	526	2	21	80	0.2625000
NODE_5597_length_1060_cov_31.595213	446	526	4	59	80	0.7375000
NODE_5597_length_1060_cov_31.595213	522	602	0	53	80	0.6625000
NODE_5597_length_1060_cov_31.595213	522	602	2	27	80	0.3375000
NODE_5597_length_1060_cov_31.595213	575	655	0	80	80	1.0000000
NODE_5598_length_1060_cov_26.136316	486	566	0	14	80	0.1750000
NODE_5598_length_1060_cov_26.136316	486	566	2	66	80	0.8250000
NODE_5598_length_1060_cov_26.136316	539	619	2	64	80	0.8000000
NODE_5598_length_1060_cov_26.136316	539	619	4	16	80	0.2000000
NODE_5598_length_1060_cov_26.136316	615	695	2	28	80	0.3500000
NODE_5598_length_1060_cov_26.136316	615	695	4	52	80	0.6500000
NODE_5598_length_1060_cov_26.136316	668	748	0	10	80	0.1250000
NODE_5598_length_1060_cov_26.136316	668	748	2	15	80	0.1875000
NODE_5598_length_1060_cov_26.136316	668	748	4	55	80	0.6875000
NODE_5599_length_1060_cov_25.329865	370	450	0	80	80	1.0000000
NODE_5599_length_1060_cov_25.329865	423	503	0	80	80	1.0000000
NODE_5600_length_1060_cov_16.881374	539	611	0	34	72	0.4722222
NODE_5600_length_1060_cov_16.881374	539	611	3	1	72	0.0138889
NODE_5600_length_1060_cov_16.881374	539	611	4	37	72	0.5138889
NODE_5601_length_1060_cov_14.789802	406	486	0	80	80	1.0000000
NODE_5601_length_1060_cov_14.789802	459	539	0	80	80	1.0000000
NODE_5603_length_1060_cov_5.900104	517	597	0	1	80	0.0125000
NODE_5603_length_1060_cov_5.900104	517	597	2	79	80	0.9875000
NODE_5603_length_1060_cov_5.900104	570	650	0	54	80	0.6750000
NODE_5603_length_1060_cov_5.900104	570	650	2	26	80	0.3250000
NODE_5611_length_1059_cov_16.630208	412	492	0	28	80	0.3500000
NODE_5611_length_1059_cov_16.630208	412	492	2	52	80	0.6500000
NODE_5611_length_1059_cov_16.630208	465	552	0	24	87	0.2758621
NODE_5611_length_1059_cov_16.630208	465	552	2	63	87	0.7241379
NODE_5611_length_1059_cov_16.630208	548	628	0	80	80	1.0000000
NODE_5611_length_1059_cov_16.630208	601	681	0	80	80	1.0000000
NODE_5621_length_1058_cov_60.155370	395	475	0	80	80	1.0000000
NODE_5621_length_1058_cov_60.155370	448	528	0	80	80	1.0000000
NODE_5621_length_1058_cov_60.155370	524	604	0	20	80	0.2500000
NODE_5621_length_1058_cov_60.155370	524	604	1	5	80	0.0625000
NODE_5621_length_1058_cov_60.155370	524	604	2	55	80	0.6875000
NODE_5621_length_1058_cov_60.155370	577	657	2	80	80	1.0000000
NODE_5622_length_1058_cov_31.253389	475	555	2	52	80	0.6500000
NODE_5622_length_1058_cov_31.253389	475	555	4	28	80	0.3500000
NODE_5622_length_1058_cov_31.253389	475	555	2	52	80	0.6500000
NODE_5622_length_1058_cov_31.253389	475	555	4	28	80	0.3500000
NODE_5622_length_1058_cov_31.253389	528	608	0	1	80	0.0125000
NODE_5622_length_1058_cov_31.253389	528	608	2	72	80	0.9000000
NODE_5622_length_1058_cov_31.253389	528	608	4	7	80	0.0875000
NODE_5622_length_1058_cov_31.253389	533	608	0	1	75	0.0133333
NODE_5622_length_1058_cov_31.253389	533	608	2	72	75	0.9600000
NODE_5622_length_1058_cov_31.253389	533	608	4	2	75	0.0266667
NODE_5623_length_1058_cov_24.520334	264	344	3	14	80	0.1750000
NODE_5623_length_1058_cov_24.520334	264	344	5	66	80	0.8250000
NODE_5623_length_1058_cov_24.520334	317	397	0	47	80	0.5875000
NODE_5623_length_1058_cov_24.520334	317	397	1	2	80	0.0250000
NODE_5623_length_1058_cov_24.520334	317	397	3	3	80	0.0375000
NODE_5623_length_1058_cov_24.520334	317	397	5	28	80	0.3500000
NODE_5624_length_1058_cov_24.211679	297	377	0	80	80	1.0000000
NODE_5624_length_1058_cov_24.211679	350	430	0	80	80	1.0000000
NODE_5625_length_1058_cov_18.100104	454	534	1	31	80	0.3875000
NODE_5625_length_1058_cov_18.100104	454	534	2	49	80	0.6125000
NODE_5625_length_1058_cov_18.100104	507	587	1	52	80	0.6500000
NODE_5625_length_1058_cov_18.100104	507	587	3	28	80	0.3500000
NODE_5626_length_1058_cov_11.645464	476	556	0	13	80	0.1625000
NODE_5626_length_1058_cov_11.645464	476	556	2	67	80	0.8375000
NODE_5626_length_1058_cov_11.645464	529	609	0	66	80	0.8250000
NODE_5626_length_1058_cov_11.645464	529	609	2	14	80	0.1750000
NODE_5627_length_1058_cov_9.953076	621	712	0	30	91	0.3296703
NODE_5627_length_1058_cov_9.953076	621	712	2	61	91	0.6703297
NODE_5627_length_1058_cov_9.953076	685	765	0	48	80	0.6000000
NODE_5627_length_1058_cov_9.953076	685	765	2	32	80	0.4000000
NODE_5628_length_1058_cov_6.294056	819	899	2	20	80	0.2500000
NODE_5628_length_1058_cov_6.294056	819	899	4	60	80	0.7500000
NODE_5628_length_1058_cov_6.294056	875	952	0	6	77	0.0779221
NODE_5628_length_1058_cov_6.294056	875	952	2	21	77	0.2727273
NODE_5628_length_1058_cov_6.294056	875	952	4	50	77	0.6493506
NODE_5637_length_1057_cov_43.191023	413	493	0	43	80	0.5375000
NODE_5637_length_1057_cov_43.191023	413	493	2	37	80	0.4625000
NODE_5637_length_1057_cov_43.191023	466	546	0	5	80	0.0625000
NODE_5637_length_1057_cov_43.191023	466	546	2	75	80	0.9375000
NODE_5637_length_1057_cov_43.191023	542	622	0	80	80	1.0000000
NODE_5637_length_1057_cov_43.191023	595	675	0	80	80	1.0000000
NODE_5638_length_1057_cov_27.387265	486	566	0	1	80	0.0125000
NODE_5638_length_1057_cov_27.387265	486	566	2	79	80	0.9875000
NODE_5638_length_1057_cov_27.387265	539	619	0	54	80	0.6750000
NODE_5638_length_1057_cov_27.387265	539	619	2	26	80	0.3250000
NODE_5639_length_1057_cov_16.489562	416	496	0	62	80	0.7750000
NODE_5639_length_1057_cov_16.489562	416	496	2	18	80	0.2250000
NODE_5639_length_1057_cov_16.489562	469	549	0	9	80	0.1125000
NODE_5639_length_1057_cov_16.489562	469	549	2	38	80	0.4750000
NODE_5639_length_1057_cov_16.489562	469	549	4	33	80	0.4125000
NODE_5640_length_1057_cov_13.605428	631	711	2	51	80	0.6375000
NODE_5640_length_1057_cov_13.605428	631	711	4	29	80	0.3625000
NODE_5640_length_1057_cov_13.605428	684	764	0	44	80	0.5500000
NODE_5640_length_1057_cov_13.605428	684	764	2	36	80	0.4500000
NODE_5641_length_1057_cov_12.768267	518	598	2	4	80	0.0500000
NODE_5641_length_1057_cov_12.768267	518	598	4	76	80	0.9500000
NODE_5641_length_1057_cov_12.768267	571	651	0	24	80	0.3000000
NODE_5641_length_1057_cov_12.768267	571	651	2	31	80	0.3875000
NODE_5641_length_1057_cov_12.768267	571	651	4	25	80	0.3125000
NODE_5644_length_1057_cov_7.692067	706	786	0	80	80	1.0000000
NODE_5644_length_1057_cov_7.692067	759	839	0	80	80	1.0000000
NODE_5645_length_1057_cov_6.697286	561	641	0	80	80	1.0000000
NODE_5645_length_1057_cov_6.697286	614	694	0	80	80	1.0000000
NODE_5654_length_1056_cov_57.539185	462	542	0	77	80	0.9625000
NODE_5654_length_1056_cov_57.539185	462	542	2	3	80	0.0375000
NODE_5654_length_1056_cov_57.539185	515	595	0	24	80	0.3000000
NODE_5654_length_1056_cov_57.539185	515	595	2	56	80	0.7000000
NODE_5655_length_1056_cov_35.751306	421	501	0	80	80	1.0000000
NODE_5655_length_1056_cov_35.751306	474	554	0	80	80	1.0000000
NODE_5656_length_1056_cov_29.749216	415	490	0	29	75	0.3866667
NODE_5656_length_1056_cov_29.749216	415	490	2	46	75	0.6133333
NODE_5656_length_1056_cov_29.749216	416	495	0	34	79	0.4303797
NODE_5656_length_1056_cov_29.749216	416	495	2	45	79	0.5696203
NODE_5656_length_1056_cov_29.749216	448	495	0	34	47	0.7234042
NODE_5656_length_1056_cov_29.749216	448	495	2	13	47	0.2765957
NODE_5656_length_1056_cov_29.749216	468	548	0	80	80	1.0000000
NODE_5656_length_1056_cov_29.749216	468	548	0	80	80	1.0000000
NODE_5656_length_1056_cov_29.749216	468	548	0	80	80	1.0000000
NODE_5657_length_1056_cov_25.342738	297	377	0	80	80	1.0000000
NODE_5657_length_1056_cov_25.342738	350	430	0	80	80	1.0000000
NODE_5657_length_1056_cov_25.342738	426	506	0	80	80	1.0000000
NODE_5657_length_1056_cov_25.342738	479	559	0	80	80	1.0000000
NODE_5658_length_1056_cov_24.094044	535	615	2	80	80	1.0000000
NODE_5658_length_1056_cov_24.094044	588	668	1	45	80	0.5625000
NODE_5658_length_1056_cov_24.094044	588	668	2	35	80	0.4375000
NODE_5659_length_1056_cov_20.700104	570	650	4	9	80	0.1125000
NODE_5659_length_1056_cov_20.700104	570	650	6	71	80	0.8875000
NODE_5659_length_1056_cov_20.700104	623	703	0	15	80	0.1875000
NODE_5659_length_1056_cov_20.700104	623	703	2	7	80	0.0875000
NODE_5659_length_1056_cov_20.700104	623	703	4	31	80	0.3875000
NODE_5659_length_1056_cov_20.700104	623	703	6	27	80	0.3375000
NODE_5660_length_1056_cov_14.215256	349	429	0	80	80	1.0000000
NODE_5660_length_1056_cov_14.215256	402	482	0	80	80	1.0000000
NODE_5660_length_1056_cov_14.215256	478	558	0	35	80	0.4375000
NODE_5660_length_1056_cov_14.215256	478	558	2	45	80	0.5625000
NODE_5660_length_1056_cov_14.215256	531	611	0	3	80	0.0375000
NODE_5660_length_1056_cov_14.215256	531	611	2	77	80	0.9625000
NODE_5661_length_1056_cov_13.782654	563	643	0	80	80	1.0000000
NODE_5661_length_1056_cov_13.782654	616	696	0	80	80	1.0000000
NODE_5663_length_1056_cov_9.298851	373	453	0	80	80	1.0000000
NODE_5663_length_1056_cov_9.298851	426	503	0	77	77	1.0000000
NODE_5665_length_1056_cov_6.157785	396	476	0	70	80	0.8750000
NODE_5665_length_1056_cov_6.157785	396	476	2	10	80	0.1250000
NODE_5665_length_1056_cov_6.157785	449	529	0	17	80	0.2125000
NODE_5665_length_1056_cov_6.157785	449	529	2	63	80	0.7875000
NODE_5666_length_1056_cov_6.034483	287	367	2	80	80	1.0000000
NODE_5666_length_1056_cov_6.034483	340	420	0	43	80	0.5375000
NODE_5666_length_1056_cov_6.034483	340	420	2	37	80	0.4625000
NODE_5667_length_1056_cov_3.259143	371	410	0	39	39	1.0000000
NODE_5667_length_1056_cov_3.259143	424	463	2	39	39	1.0000000
NODE_5668_length_1056_cov_2.362591	234	314	0	80	80	1.0000000
NODE_5672_length_1055_cov_36.460251	468	548	0	21	80	0.2625000
NODE_5672_length_1055_cov_36.460251	468	548	2	14	80	0.1750000
NODE_5672_length_1055_cov_36.460251	468	548	4	11	80	0.1375000
NODE_5672_length_1055_cov_36.460251	468	548	6	34	80	0.4250000
NODE_5672_length_1055_cov_36.460251	521	601	4	21	80	0.2625000
NODE_5672_length_1055_cov_36.460251	521	601	6	59	80	0.7375000
NODE_5673_length_1055_cov_31.235356	502	582	0	80	80	1.0000000
NODE_5673_length_1055_cov_31.235356	555	635	0	80	80	1.0000000
NODE_5674_length_1055_cov_23.330544	403	483	0	80	80	1.0000000
NODE_5674_length_1055_cov_23.330544	456	536	0	59	80	0.7375000
NODE_5674_length_1055_cov_23.330544	456	536	2	21	80	0.2625000
NODE_5674_length_1055_cov_23.330544	532	612	0	6	80	0.0750000
NODE_5674_length_1055_cov_23.330544	532	612	2	74	80	0.9250000
NODE_5674_length_1055_cov_23.330544	585	665	0	59	80	0.7375000
NODE_5674_length_1055_cov_23.330544	585	665	2	21	80	0.2625000
NODE_5675_length_1055_cov_19.541841	321	401	0	80	80	1.0000000
NODE_5675_length_1055_cov_19.541841	374	454	0	80	80	1.0000000
NODE_5676_length_1055_cov_15.744770	525	605	2	80	80	1.0000000
NODE_5676_length_1055_cov_15.744770	578	658	0	48	80	0.6000000
NODE_5676_length_1055_cov_15.744770	578	658	2	32	80	0.4000000
NODE_5677_length_1055_cov_10.729079	335	415	0	6	80	0.0750000
NODE_5677_length_1055_cov_10.729079	335	415	4	35	80	0.4375000
NODE_5677_length_1055_cov_10.729079	335	415	8	34	80	0.4250000
NODE_5677_length_1055_cov_10.729079	335	415	10	5	80	0.0625000
NODE_5677_length_1055_cov_10.729079	388	468	5	8	80	0.1000000
NODE_5677_length_1055_cov_10.729079	388	468	6	40	80	0.5000000
NODE_5677_length_1055_cov_10.729079	388	468	8	22	80	0.2750000
NODE_5677_length_1055_cov_10.729079	388	468	10	10	80	0.1250000
NODE_5678_length_1055_cov_7.525105	575	655	0	80	80	1.0000000
NODE_5678_length_1055_cov_7.525105	628	708	0	80	80	1.0000000
NODE_5688_length_1054_cov_45.920419	371	451	0	34	80	0.4250000
NODE_5688_length_1054_cov_45.920419	371	451	2	46	80	0.5750000
NODE_5688_length_1054_cov_45.920419	424	505	0	32	81	0.3950617
NODE_5688_length_1054_cov_45.920419	424	505	2	49	81	0.6049383
NODE_5689_length_1054_cov_30.545550	499	578	0	79	79	1.0000000
NODE_5689_length_1054_cov_30.545550	552	631	0	79	79	1.0000000
NODE_5689_length_1054_cov_30.545550	627	707	0	80	80	1.0000000
NODE_5689_length_1054_cov_30.545550	680	760	0	80	80	1.0000000
NODE_5690_length_1054_cov_16.606283	347	427	0	32	80	0.4000000
NODE_5690_length_1054_cov_16.606283	347	427	4	9	80	0.1125000
NODE_5690_length_1054_cov_16.606283	347	427	6	39	80	0.4875000
NODE_5690_length_1054_cov_16.606283	400	480	0	62	80	0.7750000
NODE_5690_length_1054_cov_16.606283	400	480	2	18	80	0.2250000
NODE_5691_length_1054_cov_11.637696	244	316	0	72	72	1.0000000
NODE_5691_length_1054_cov_11.637696	312	392	0	23	80	0.2875000
NODE_5691_length_1054_cov_11.637696	312	392	2	57	80	0.7125000
NODE_5691_length_1054_cov_11.637696	365	445	0	23	80	0.2875000
NODE_5691_length_1054_cov_11.637696	365	445	2	57	80	0.7125000
NODE_5692_length_1054_cov_10.381152	493	573	0	80	80	1.0000000
NODE_5692_length_1054_cov_10.381152	546	626	0	80	80	1.0000000
NODE_5703_length_1053_cov_57.660377	445	527	2	15	82	0.1829268
NODE_5703_length_1053_cov_57.660377	445	527	4	55	82	0.6707317
NODE_5703_length_1053_cov_57.660377	445	527	6	12	82	0.1463415
NODE_5703_length_1053_cov_57.660377	500	580	0	26	80	0.3250000
NODE_5703_length_1053_cov_57.660377	500	580	2	42	80	0.5250000
NODE_5703_length_1053_cov_57.660377	500	580	6	12	80	0.1500000
NODE_5704_length_1053_cov_33.518868	329	409	0	80	80	1.0000000
NODE_5704_length_1053_cov_33.518868	382	462	0	80	80	1.0000000
NODE_5704_length_1053_cov_33.518868	458	538	0	80	80	1.0000000
NODE_5704_length_1053_cov_33.518868	511	591	0	80	80	1.0000000
NODE_5705_length_1053_cov_32.412998	375	455	0	8	80	0.1000000
NODE_5705_length_1053_cov_32.412998	375	455	2	27	80	0.3375000
NODE_5705_length_1053_cov_32.412998	375	455	4	45	80	0.5625000
NODE_5705_length_1053_cov_32.412998	428	508	2	28	80	0.3500000
NODE_5705_length_1053_cov_32.412998	428	508	3	1	80	0.0125000
NODE_5705_length_1053_cov_32.412998	428	508	4	34	80	0.4250000
NODE_5705_length_1053_cov_32.412998	428	508	5	17	80	0.2125000
NODE_5705_length_1053_cov_32.412998	504	584	5	5	80	0.0625000
NODE_5705_length_1053_cov_32.412998	504	584	6	15	80	0.1875000
NODE_5705_length_1053_cov_32.412998	504	584	8	40	80	0.5000000
NODE_5705_length_1053_cov_32.412998	504	584	12	20	80	0.2500000
NODE_5705_length_1053_cov_32.412998	557	637	8	20	80	0.2500000
NODE_5705_length_1053_cov_32.412998	557	637	12	60	80	0.7500000
NODE_5706_length_1053_cov_26.545073	456	536	0	41	80	0.5125000
NODE_5706_length_1053_cov_26.545073	456	536	4	16	80	0.2000000
NODE_5706_length_1053_cov_26.545073	456	536	6	23	80	0.2875000
NODE_5706_length_1053_cov_26.545073	509	589	2	13	80	0.1625000
NODE_5706_length_1053_cov_26.545073	509	589	4	10	80	0.1250000
NODE_5706_length_1053_cov_26.545073	509	589	6	57	80	0.7125000
NODE_5706_length_1053_cov_26.545073	585	665	0	15	80	0.1875000
NODE_5706_length_1053_cov_26.545073	585	665	2	65	80	0.8125000
NODE_5706_length_1053_cov_26.545073	638	718	0	68	80	0.8500000
NODE_5706_length_1053_cov_26.545073	638	718	2	12	80	0.1500000
NODE_5707_length_1053_cov_20.346960	543	623	0	15	80	0.1875000
NODE_5707_length_1053_cov_20.346960	543	623	2	65	80	0.8125000
NODE_5707_length_1053_cov_20.346960	596	677	0	69	81	0.8518519
NODE_5707_length_1053_cov_20.346960	596	677	2	12	81	0.1481481
NODE_5708_length_1053_cov_11.655136	393	473	0	80	80	1.0000000
NODE_5708_length_1053_cov_11.655136	446	526	0	80	80	1.0000000
NODE_5710_length_1053_cov_4.771488	84	149	0	3	65	0.0461538
NODE_5710_length_1053_cov_4.771488	84	149	2	62	65	0.9538462
NODE_5718_length_1052_cov_18.469045	448	528	0	80	80	1.0000000
NODE_5718_length_1052_cov_18.469045	501	581	0	80	80	1.0000000
NODE_5719_length_1052_cov_13.136411	425	505	0	80	80	1.0000000
NODE_5719_length_1052_cov_13.136411	478	558	0	80	80	1.0000000
NODE_5722_length_1052_cov_3.082896	607	687	0	80	80	1.0000000
NODE_5722_length_1052_cov_3.082896	660	740	0	80	80	1.0000000
NODE_5729_length_1051_cov_34.868697	472	552	0	6	80	0.0750000
NODE_5729_length_1051_cov_34.868697	472	552	2	16	80	0.2000000
NODE_5729_length_1051_cov_34.868697	472	552	4	20	80	0.2500000
NODE_5729_length_1051_cov_34.868697	472	552	8	28	80	0.3500000
NODE_5729_length_1051_cov_34.868697	472	552	10	10	80	0.1250000
NODE_5729_length_1051_cov_34.868697	525	605	2	1	80	0.0125000
NODE_5729_length_1051_cov_34.868697	525	605	6	23	80	0.2875000
NODE_5729_length_1051_cov_34.868697	525	605	8	39	80	0.4875000
NODE_5729_length_1051_cov_34.868697	525	605	10	17	80	0.2125000
NODE_5730_length_1051_cov_19.446429	549	629	0	80	80	1.0000000
NODE_5730_length_1051_cov_19.446429	602	682	0	80	80	1.0000000
NODE_5731_length_1051_cov_4.022059	600	680	0	73	80	0.9125000
NODE_5731_length_1051_cov_4.022059	600	680	4	7	80	0.0875000
NODE_5736_length_1050_cov_31.556257	429	509	0	80	80	1.0000000
NODE_5736_length_1050_cov_31.556257	482	562	0	80	80	1.0000000
NODE_5736_length_1050_cov_31.556257	558	638	0	80	80	1.0000000
NODE_5736_length_1050_cov_31.556257	611	691	0	80	80	1.0000000
NODE_5737_length_1050_cov_16.337539	398	478	0	80	80	1.0000000
NODE_5737_length_1050_cov_16.337539	451	531	0	80	80	1.0000000
NODE_5738_length_1050_cov_13.290221	507	587	0	56	80	0.7000000
NODE_5738_length_1050_cov_13.290221	507	587	2	24	80	0.3000000
NODE_5738_length_1050_cov_13.290221	560	640	0	3	80	0.0375000
NODE_5738_length_1050_cov_13.290221	560	640	2	77	80	0.9625000
NODE_5739_length_1050_cov_11.389064	532	612	0	80	80	1.0000000
NODE_5739_length_1050_cov_11.389064	585	665	0	80	80	1.0000000
NODE_5740_length_1050_cov_11.091483	259	321	0	62	62	1.0000000
NODE_5740_length_1050_cov_11.091483	294	374	0	48	80	0.6000000
NODE_5740_length_1050_cov_11.091483	294	374	2	32	80	0.4000000
NODE_5740_length_1050_cov_11.091483	370	450	0	14	80	0.1750000
NODE_5740_length_1050_cov_11.091483	370	450	2	66	80	0.8250000
NODE_5740_length_1050_cov_11.091483	423	503	0	32	80	0.4000000
NODE_5740_length_1050_cov_11.091483	423	503	2	48	80	0.6000000
NODE_5742_length_1050_cov_2.201893	928	990	6	46	62	0.7419355
NODE_5742_length_1050_cov_2.201893	928	990	8	1	62	0.0161290
NODE_5742_length_1050_cov_2.201893	928	990	10	1	62	0.0161290
NODE_5742_length_1050_cov_2.201893	928	990	12	14	62	0.2258064
NODE_5742_length_1050_cov_2.201893	981	1043	6	9	62	0.1451613
NODE_5742_length_1050_cov_2.201893	981	1043	8	41	62	0.6612903
NODE_5742_length_1050_cov_2.201893	981	1043	12	12	62	0.1935484
NODE_5748_length_1050_cov_1.241851	935	990	16	5	55	0.0909091
NODE_5748_length_1050_cov_1.241851	935	990	20	1	55	0.0181818
NODE_5748_length_1050_cov_1.241851	935	990	21	1	55	0.0181818
NODE_5748_length_1050_cov_1.241851	935	990	23	1	55	0.0181818
NODE_5748_length_1050_cov_1.241851	935	990	27	2	55	0.0363636
NODE_5748_length_1050_cov_1.241851	935	990	29	2	55	0.0363636
NODE_5748_length_1050_cov_1.241851	935	990	34	3	55	0.0545455
NODE_5748_length_1050_cov_1.241851	935	990	36	1	55	0.0181818
NODE_5748_length_1050_cov_1.241851	935	990	38	1	55	0.0181818
NODE_5748_length_1050_cov_1.241851	935	990	40	9	55	0.1636364
NODE_5748_length_1050_cov_1.241851	935	990	42	2	55	0.0363636
NODE_5748_length_1050_cov_1.241851	935	990	44	3	55	0.0545455
NODE_5748_length_1050_cov_1.241851	935	990	48	3	55	0.0545455
NODE_5748_length_1050_cov_1.241851	935	990	54	5	55	0.0909091
NODE_5748_length_1050_cov_1.241851	935	990	56	16	55	0.2909091
NODE_5748_length_1050_cov_1.241851	956	1036	31	5	80	0.0625000
NODE_5748_length_1050_cov_1.241851	956	1036	35	2	80	0.0250000
NODE_5748_length_1050_cov_1.241851	956	1036	40	5	80	0.0625000
NODE_5748_length_1050_cov_1.241851	956	1036	41	1	80	0.0125000
NODE_5748_length_1050_cov_1.241851	956	1036	42	2	80	0.0250000
NODE_5748_length_1050_cov_1.241851	956	1036	44	3	80	0.0375000
NODE_5748_length_1050_cov_1.241851	956	1036	45	1	80	0.0125000
NODE_5748_length_1050_cov_1.241851	956	1036	47	3	80	0.0375000
NODE_5748_length_1050_cov_1.241851	956	1036	48	7	80	0.0875000
NODE_5748_length_1050_cov_1.241851	956	1036	50	2	80	0.0250000
NODE_5748_length_1050_cov_1.241851	956	1036	52	6	80	0.0750000
NODE_5748_length_1050_cov_1.241851	956	1036	54	6	80	0.0750000
NODE_5748_length_1050_cov_1.241851	956	1036	55	1	80	0.0125000
NODE_5748_length_1050_cov_1.241851	956	1036	56	36	80	0.4500000
NODE_5752_length_1049_cov_28.174737	446	526	0	80	80	1.0000000
NODE_5752_length_1049_cov_28.174737	499	579	0	80	80	1.0000000
NODE_5753_length_1049_cov_23.186316	389	469	4	80	80	1.0000000
NODE_5753_length_1049_cov_23.186316	442	522	0	27	80	0.3375000
NODE_5753_length_1049_cov_23.186316	442	522	4	53	80	0.6625000
NODE_5753_length_1049_cov_23.186316	518	595	0	77	77	1.0000000
NODE_5753_length_1049_cov_23.186316	568	648	0	80	80	1.0000000
NODE_5754_length_1049_cov_21.097895	532	612	0	5	80	0.0625000
NODE_5754_length_1049_cov_21.097895	532	612	2	46	80	0.5750000
NODE_5754_length_1049_cov_21.097895	532	612	4	29	80	0.3625000
NODE_5754_length_1049_cov_21.097895	585	665	2	29	80	0.3625000
NODE_5754_length_1049_cov_21.097895	585	665	4	51	80	0.6375000
NODE_5755_length_1049_cov_18.964211	375	466	0	87	91	0.9560440
NODE_5755_length_1049_cov_18.964211	375	466	1	4	91	0.0439560
NODE_5755_length_1049_cov_18.964211	439	519	0	80	80	1.0000000
NODE_5755_length_1049_cov_18.964211	515	595	0	10	80	0.1250000
NODE_5755_length_1049_cov_18.964211	515	595	1	70	80	0.8750000
NODE_5755_length_1049_cov_18.964211	568	648	1	80	80	1.0000000
NODE_5756_length_1049_cov_18.075789	437	517	0	28	80	0.3500000
NODE_5756_length_1049_cov_18.075789	437	517	2	52	80	0.6500000
NODE_5756_length_1049_cov_18.075789	490	570	0	18	80	0.2250000
NODE_5756_length_1049_cov_18.075789	490	570	2	41	80	0.5125000
NODE_5756_length_1049_cov_18.075789	490	570	4	21	80	0.2625000
NODE_5756_length_1049_cov_18.075789	566	644	4	78	78	1.0000000
NODE_5756_length_1049_cov_18.075789	620	695	0	22	75	0.2933333
NODE_5756_length_1049_cov_18.075789	620	695	3	1	75	0.0133333
NODE_5756_length_1049_cov_18.075789	620	695	4	52	75	0.6933333
NODE_5757_length_1049_cov_16.194737	569	650	0	81	81	1.0000000
NODE_5757_length_1049_cov_16.194737	623	703	0	80	80	1.0000000
NODE_5757_length_1049_cov_16.194737	699	779	0	80	80	1.0000000
NODE_5757_length_1049_cov_16.194737	752	832	0	80	80	1.0000000
NODE_5759_length_1049_cov_6.323158	588	668	0	80	80	1.0000000
NODE_5759_length_1049_cov_6.323158	641	721	0	80	80	1.0000000
NODE_5770_length_1048_cov_73.887250	535	615	0	65	80	0.8125000
NODE_5770_length_1048_cov_73.887250	535	615	2	15	80	0.1875000
NODE_5770_length_1048_cov_73.887250	588	668	0	12	80	0.1500000
NODE_5770_length_1048_cov_73.887250	588	668	2	68	80	0.8500000
NODE_5770_length_1048_cov_73.887250	664	744	0	41	80	0.5125000
NODE_5770_length_1048_cov_73.887250	664	744	2	39	80	0.4875000
NODE_5770_length_1048_cov_73.887250	717	797	0	80	80	1.0000000
NODE_5770_length_1048_cov_73.887250	899	979	0	80	80	1.0000000
NODE_5771_length_1048_cov_48.242360	407	487	0	80	80	1.0000000
NODE_5771_length_1048_cov_48.242360	460	540	0	80	80	1.0000000
NODE_5771_length_1048_cov_48.242360	536	616	0	80	80	1.0000000
NODE_5771_length_1048_cov_48.242360	589	669	0	80	80	1.0000000
NODE_5772_length_1048_cov_38.430980	352	432	0	80	80	1.0000000
NODE_5772_length_1048_cov_38.430980	405	485	0	80	80	1.0000000
NODE_5773_length_1048_cov_28.179136	548	628	2	45	80	0.5625000
NODE_5773_length_1048_cov_28.179136	548	628	4	3	80	0.0375000
NODE_5773_length_1048_cov_28.179136	548	628	6	32	80	0.4000000
NODE_5773_length_1048_cov_28.179136	601	681	0	4	80	0.0500000
NODE_5773_length_1048_cov_28.179136	601	681	2	76	80	0.9500000
NODE_5773_length_1048_cov_28.179136	677	757	0	26	80	0.3250000
NODE_5773_length_1048_cov_28.179136	677	757	2	3	80	0.0375000
NODE_5773_length_1048_cov_28.179136	677	757	4	51	80	0.6375000
NODE_5773_length_1048_cov_28.179136	730	810	0	30	80	0.3750000
NODE_5773_length_1048_cov_28.179136	730	810	2	17	80	0.2125000
NODE_5773_length_1048_cov_28.179136	730	810	4	33	80	0.4125000
NODE_5774_length_1048_cov_22.985248	409	489	0	80	80	1.0000000
NODE_5774_length_1048_cov_22.985248	462	542	0	80	80	1.0000000
NODE_5774_length_1048_cov_22.985248	538	618	0	79	80	0.9875000
NODE_5774_length_1048_cov_22.985248	538	618	1	1	80	0.0125000
NODE_5774_length_1048_cov_22.985248	591	671	0	26	80	0.3250000
NODE_5774_length_1048_cov_22.985248	591	671	1	1	80	0.0125000
NODE_5774_length_1048_cov_22.985248	591	671	2	53	80	0.6625000
NODE_5775_length_1048_cov_17.883035	500	580	2	80	80	1.0000000
NODE_5775_length_1048_cov_17.883035	553	633	0	52	80	0.6500000
NODE_5775_length_1048_cov_17.883035	553	633	2	28	80	0.3500000
NODE_5776_length_1048_cov_17.444679	377	457	0	31	80	0.3875000
NODE_5776_length_1048_cov_17.444679	377	457	2	49	80	0.6125000
NODE_5776_length_1048_cov_17.444679	430	510	0	9	80	0.1125000
NODE_5776_length_1048_cov_17.444679	430	510	2	71	80	0.8875000
NODE_5777_length_1048_cov_13.387777	518	598	0	3	80	0.0375000
NODE_5777_length_1048_cov_13.387777	518	598	4	77	80	0.9625000
NODE_5777_length_1048_cov_13.387777	571	651	0	45	80	0.5625000
NODE_5777_length_1048_cov_13.387777	571	651	4	35	80	0.4375000
NODE_5778_length_1048_cov_12.934668	716	796	0	76	80	0.9500000
NODE_5778_length_1048_cov_12.934668	716	796	1	2	80	0.0250000
NODE_5778_length_1048_cov_12.934668	716	796	2	2	80	0.0250000
NODE_5778_length_1048_cov_12.934668	769	849	0	80	80	1.0000000
NODE_5778_length_1048_cov_12.934668	845	925	0	80	80	1.0000000
NODE_5778_length_1048_cov_12.934668	898	975	0	77	77	1.0000000
NODE_5779_length_1048_cov_12.712329	330	410	6	4	80	0.0500000
NODE_5779_length_1048_cov_12.712329	330	410	8	76	80	0.9500000
NODE_5779_length_1048_cov_12.712329	384	463	0	38	79	0.4810127
NODE_5779_length_1048_cov_12.712329	384	463	6	8	79	0.1012658
NODE_5779_length_1048_cov_12.712329	384	463	8	33	79	0.4177215
NODE_5779_length_1048_cov_12.712329	459	539	0	77	80	0.9625000
NODE_5779_length_1048_cov_12.712329	459	539	2	3	80	0.0375000
NODE_5779_length_1048_cov_12.712329	512	592	0	24	80	0.3000000
NODE_5779_length_1048_cov_12.712329	512	592	2	56	80	0.7000000
NODE_5780_length_1048_cov_9.232877	305	355	0	50	50	1.0000000
NODE_5786_length_1047_cov_79.917722	540	620	0	80	80	1.0000000
NODE_5786_length_1047_cov_79.917722	593	673	0	80	80	1.0000000
NODE_5787_length_1047_cov_28.527426	582	662	0	45	80	0.5625000
NODE_5787_length_1047_cov_28.527426	582	662	2	35	80	0.4375000
NODE_5787_length_1047_cov_28.527426	635	715	0	5	80	0.0625000
NODE_5787_length_1047_cov_28.527426	635	715	2	75	80	0.9375000
NODE_5788_length_1047_cov_26.068565	372	452	3	31	80	0.3875000
NODE_5788_length_1047_cov_26.068565	372	452	4	22	80	0.2750000
NODE_5788_length_1047_cov_26.068565	372	452	5	27	80	0.3375000
NODE_5788_length_1047_cov_26.068565	425	505	1	8	80	0.1000000
NODE_5788_length_1047_cov_26.068565	425	505	2	5	80	0.0625000
NODE_5788_length_1047_cov_26.068565	425	505	3	5	80	0.0625000
NODE_5788_length_1047_cov_26.068565	425	505	4	62	80	0.7750000
NODE_5789_length_1047_cov_25.946203	424	504	0	80	80	1.0000000
NODE_5789_length_1047_cov_25.946203	477	557	0	80	80	1.0000000
NODE_5790_length_1047_cov_19.255274	458	538	0	72	80	0.9000000
NODE_5790_length_1047_cov_19.255274	458	538	2	8	80	0.1000000
NODE_5790_length_1047_cov_19.255274	511	591	0	80	80	1.0000000
NODE_5791_length_1047_cov_16.618143	467	547	2	80	80	1.0000000
NODE_5791_length_1047_cov_16.618143	520	600	0	15	80	0.1875000
NODE_5791_length_1047_cov_16.618143	520	600	1	16	80	0.2000000
NODE_5791_length_1047_cov_16.618143	520	600	2	49	80	0.6125000
NODE_5792_length_1047_cov_14.246835	643	723	0	38	80	0.4750000
NODE_5792_length_1047_cov_14.246835	643	723	4	42	80	0.5250000
NODE_5792_length_1047_cov_14.246835	696	776	4	80	80	1.0000000
NODE_5793_length_1047_cov_9.869198	414	494	0	38	80	0.4750000
NODE_5793_length_1047_cov_9.869198	414	494	4	4	80	0.0500000
NODE_5793_length_1047_cov_9.869198	414	494	6	38	80	0.4750000
NODE_5793_length_1047_cov_9.869198	467	547	4	10	80	0.1250000
NODE_5793_length_1047_cov_9.869198	467	547	6	70	80	0.8750000
NODE_5794_length_1047_cov_8.513713	300	380	0	80	80	1.0000000
NODE_5794_length_1047_cov_8.513713	353	433	0	80	80	1.0000000
NODE_5795_length_1047_cov_7.412447	442	522	0	27	80	0.3375000
NODE_5795_length_1047_cov_7.412447	442	522	2	53	80	0.6625000
NODE_5795_length_1047_cov_7.412447	495	575	2	80	80	1.0000000
NODE_5803_length_1046_cov_41.392819	587	667	0	5	80	0.0625000
NODE_5803_length_1046_cov_41.392819	587	667	2	75	80	0.9375000
NODE_5803_length_1046_cov_41.392819	640	720	0	54	80	0.6750000
NODE_5803_length_1046_cov_41.392819	640	720	2	26	80	0.3250000
NODE_5804_length_1046_cov_30.317846	382	462	2	36	80	0.4500000
NODE_5804_length_1046_cov_30.317846	382	462	8	44	80	0.5500000
NODE_5804_length_1046_cov_30.317846	435	515	6	42	80	0.5250000
NODE_5804_length_1046_cov_30.317846	435	515	8	38	80	0.4750000
NODE_5805_length_1046_cov_28.184794	346	426	4	3	80	0.0375000
NODE_5805_length_1046_cov_28.184794	346	426	6	42	80	0.5250000
NODE_5805_length_1046_cov_28.184794	346	426	8	35	80	0.4375000
NODE_5805_length_1046_cov_28.184794	399	479	2	31	80	0.3875000
NODE_5805_length_1046_cov_28.184794	399	479	4	25	80	0.3125000
NODE_5805_length_1046_cov_28.184794	399	479	6	12	80	0.1500000
NODE_5805_length_1046_cov_28.184794	399	479	8	12	80	0.1500000
NODE_5806_length_1046_cov_24.595565	501	581	1	27	80	0.3375000
NODE_5806_length_1046_cov_24.595565	501	581	2	53	80	0.6625000
NODE_5806_length_1046_cov_24.595565	554	634	0	16	80	0.2000000
NODE_5806_length_1046_cov_24.595565	554	634	1	64	80	0.8000000
NODE_5807_length_1046_cov_17.958817	447	527	4	23	80	0.2875000
NODE_5807_length_1046_cov_17.958817	447	527	6	57	80	0.7125000
NODE_5807_length_1046_cov_17.958817	500	580	0	12	80	0.1500000
NODE_5807_length_1046_cov_17.958817	500	580	2	41	80	0.5125000
NODE_5807_length_1046_cov_17.958817	500	580	6	27	80	0.3375000
NODE_5808_length_1046_cov_15.494192	385	465	0	80	80	1.0000000
NODE_5808_length_1046_cov_15.494192	438	518	0	80	80	1.0000000
NODE_5809_length_1046_cov_12.639916	554	634	0	15	80	0.1875000
NODE_5809_length_1046_cov_12.639916	554	634	4	65	80	0.8125000
NODE_5809_length_1046_cov_12.639916	607	687	0	15	80	0.1875000
NODE_5809_length_1046_cov_12.639916	607	687	2	5	80	0.0625000
NODE_5809_length_1046_cov_12.639916	607	687	4	60	80	0.7500000
NODE_5810_length_1046_cov_11.238648	471	551	0	59	80	0.7375000
NODE_5810_length_1046_cov_11.238648	471	551	2	21	80	0.2625000
NODE_5810_length_1046_cov_11.238648	524	604	0	26	80	0.3250000
NODE_5810_length_1046_cov_11.238648	524	604	2	54	80	0.6750000
NODE_5811_length_1046_cov_10.744456	459	539	0	80	80	1.0000000
NODE_5811_length_1046_cov_10.744456	512	592	0	80	80	1.0000000
NODE_5812_length_1046_cov_8.689546	302	382	0	20	80	0.2500000
NODE_5812_length_1046_cov_8.689546	302	382	1	1	80	0.0125000
NODE_5812_length_1046_cov_8.689546	302	382	2	59	80	0.7375000
NODE_5812_length_1046_cov_8.689546	355	435	0	73	80	0.9125000
NODE_5812_length_1046_cov_8.689546	355	435	1	1	80	0.0125000
NODE_5812_length_1046_cov_8.689546	355	435	2	6	80	0.0750000
NODE_5823_length_1045_cov_75.975687	359	440	2	81	81	1.0000000
NODE_5823_length_1045_cov_75.975687	412	493	0	30	81	0.3703704
NODE_5823_length_1045_cov_75.975687	412	493	2	51	81	0.6296296
NODE_5823_length_1045_cov_75.975687	489	569	0	53	80	0.6625000
NODE_5823_length_1045_cov_75.975687	489	569	2	27	80	0.3375000
NODE_5823_length_1045_cov_75.975687	542	622	2	80	80	1.0000000
NODE_5824_length_1045_cov_54.419662	434	514	0	80	80	1.0000000
NODE_5824_length_1045_cov_54.419662	487	567	0	80	80	1.0000000
NODE_5824_length_1045_cov_54.419662	563	639	0	26	76	0.3421053
NODE_5824_length_1045_cov_54.419662	563	639	2	50	76	0.6578947
NODE_5824_length_1045_cov_54.419662	616	696	2	80	80	1.0000000
NODE_5825_length_1045_cov_23.188161	395	475	0	33	80	0.4125000
NODE_5825_length_1045_cov_23.188161	395	475	2	23	80	0.2875000
NODE_5825_length_1045_cov_23.188161	395	475	4	9	80	0.1125000
NODE_5825_length_1045_cov_23.188161	395	475	6	15	80	0.1875000
NODE_5825_length_1045_cov_23.188161	448	528	2	3	80	0.0375000
NODE_5825_length_1045_cov_23.188161	448	528	4	22	80	0.2750000
NODE_5825_length_1045_cov_23.188161	448	528	6	55	80	0.6875000
NODE_5826_length_1045_cov_19.686047	571	651	2	23	80	0.2875000
NODE_5826_length_1045_cov_19.686047	571	651	4	28	80	0.3500000
NODE_5826_length_1045_cov_19.686047	571	651	6	29	80	0.3625000
NODE_5826_length_1045_cov_19.686047	624	704	0	21	80	0.2625000
NODE_5826_length_1045_cov_19.686047	624	704	2	55	80	0.6875000
NODE_5826_length_1045_cov_19.686047	624	704	4	4	80	0.0500000
NODE_5827_length_1045_cov_19.378436	478	558	2	2	80	0.0250000
NODE_5827_length_1045_cov_19.378436	478	558	4	59	80	0.7375000
NODE_5827_length_1045_cov_19.378436	478	558	6	19	80	0.2375000
NODE_5827_length_1045_cov_19.378436	531	611	2	27	80	0.3375000
NODE_5827_length_1045_cov_19.378436	531	611	4	15	80	0.1875000
NODE_5827_length_1045_cov_19.378436	531	611	6	38	80	0.4750000
NODE_5828_length_1045_cov_17.601480	359	439	0	2	80	0.0250000
NODE_5828_length_1045_cov_17.601480	359	439	2	78	80	0.9750000
NODE_5828_length_1045_cov_17.601480	412	492	0	55	80	0.6875000
NODE_5828_length_1045_cov_17.601480	412	492	2	25	80	0.3125000
NODE_5829_length_1045_cov_17.372093	633	713	0	53	80	0.6625000
NODE_5829_length_1045_cov_17.372093	633	713	2	27	80	0.3375000
NODE_5829_length_1045_cov_17.372093	686	766	2	80	80	1.0000000
NODE_5830_length_1045_cov_14.828753	433	513	0	80	80	1.0000000
NODE_5830_length_1045_cov_14.828753	486	566	0	47	80	0.5875000
NODE_5830_length_1045_cov_14.828753	486	566	1	15	80	0.1875000
NODE_5830_length_1045_cov_14.828753	486	566	2	18	80	0.2250000
NODE_5831_length_1045_cov_11.673362	664	744	0	80	80	1.0000000
NODE_5831_length_1045_cov_11.673362	717	797	0	80	80	1.0000000
NODE_5843_length_1044_cov_42.600000	344	424	0	80	80	1.0000000
NODE_5843_length_1044_cov_42.600000	397	477	0	80	80	1.0000000
NODE_5844_length_1044_cov_27.653968	454	534	1	21	80	0.2625000
NODE_5844_length_1044_cov_27.653968	454	534	3	15	80	0.1875000
NODE_5844_length_1044_cov_27.653968	454	534	7	14	80	0.1750000
NODE_5844_length_1044_cov_27.653968	454	534	8	30	80	0.3750000
NODE_5844_length_1044_cov_27.653968	507	587	2	16	80	0.2000000
NODE_5844_length_1044_cov_27.653968	507	587	3	10	80	0.1250000
NODE_5844_length_1044_cov_27.653968	507	587	4	6	80	0.0750000
NODE_5844_length_1044_cov_27.653968	507	587	8	48	80	0.6000000
NODE_5845_length_1044_cov_24.561905	297	375	0	78	78	1.0000000
NODE_5845_length_1044_cov_24.561905	348	428	0	80	80	1.0000000
NODE_5845_length_1044_cov_24.561905	424	504	0	80	80	1.0000000
NODE_5845_length_1044_cov_24.561905	477	557	0	80	80	1.0000000
NODE_5846_length_1044_cov_23.720635	294	374	0	12	80	0.1500000
NODE_5846_length_1044_cov_23.720635	294	374	2	68	80	0.8500000
NODE_5846_length_1044_cov_23.720635	347	427	0	58	80	0.7250000
NODE_5846_length_1044_cov_23.720635	347	427	2	22	80	0.2750000
NODE_5846_length_1044_cov_23.720635	423	503	0	15	80	0.1875000
NODE_5846_length_1044_cov_23.720635	423	503	2	65	80	0.8125000
NODE_5846_length_1044_cov_23.720635	476	556	0	36	80	0.4500000
NODE_5846_length_1044_cov_23.720635	476	556	2	44	80	0.5500000
NODE_5847_length_1044_cov_20.871958	462	542	0	4	80	0.0500000
NODE_5847_length_1044_cov_20.871958	462	542	2	2	80	0.0250000
NODE_5847_length_1044_cov_20.871958	462	542	4	74	80	0.9250000
NODE_5847_length_1044_cov_20.871958	515	595	0	57	80	0.7125000
NODE_5847_length_1044_cov_20.871958	515	595	2	2	80	0.0250000
NODE_5847_length_1044_cov_20.871958	515	595	4	21	80	0.2625000
NODE_5847_length_1044_cov_20.871958	591	671	0	80	80	1.0000000
NODE_5847_length_1044_cov_20.871958	644	724	0	54	80	0.6750000
NODE_5847_length_1044_cov_20.871958	644	724	2	26	80	0.3250000
NODE_5848_length_1044_cov_18.596825	433	513	0	80	80	1.0000000
NODE_5848_length_1044_cov_18.596825	486	566	0	80	80	1.0000000
NODE_5849_length_1044_cov_16.102646	414	494	0	80	80	1.0000000
NODE_5849_length_1044_cov_16.102646	467	547	0	80	80	1.0000000
NODE_5850_length_1044_cov_12.156614	578	658	0	12	80	0.1500000
NODE_5850_length_1044_cov_12.156614	578	658	2	68	80	0.8500000
NODE_5850_length_1044_cov_12.156614	631	711	0	25	80	0.3125000
NODE_5850_length_1044_cov_12.156614	631	711	2	55	80	0.6875000
NODE_5851_length_1044_cov_10.661376	506	586	0	14	80	0.1750000
NODE_5851_length_1044_cov_10.661376	506	586	1	40	80	0.5000000
NODE_5851_length_1044_cov_10.661376	506	586	2	26	80	0.3250000
NODE_5851_length_1044_cov_10.661376	559	639	1	1	80	0.0125000
NODE_5851_length_1044_cov_10.661376	559	639	2	79	80	0.9875000
NODE_5852_length_1044_cov_9.534392	461	541	0	80	80	1.0000000
NODE_5852_length_1044_cov_9.534392	514	594	0	80	80	1.0000000
NODE_5853_length_1044_cov_5.517460	434	514	0	80	80	1.0000000
NODE_5853_length_1044_cov_5.517460	487	567	0	80	80	1.0000000
NODE_5856_length_1044_cov_1.502646	769	845	0	76	76	1.0000000
NODE_5860_length_1043_cov_42.288136	452	532	2	1	80	0.0125000
NODE_5860_length_1043_cov_42.288136	452	532	4	79	80	0.9875000
NODE_5860_length_1043_cov_42.288136	505	585	0	33	80	0.4125000
NODE_5860_length_1043_cov_42.288136	505	585	2	21	80	0.2625000
NODE_5860_length_1043_cov_42.288136	505	585	4	26	80	0.3250000
NODE_5861_length_1043_cov_25.987288	350	430	0	16	80	0.2000000
NODE_5861_length_1043_cov_25.987288	350	430	2	7	80	0.0875000
NODE_5861_length_1043_cov_25.987288	350	430	4	2	80	0.0250000
NODE_5861_length_1043_cov_25.987288	350	430	6	55	80	0.6875000
NODE_5861_length_1043_cov_25.987288	403	483	0	4	80	0.0500000
NODE_5861_length_1043_cov_25.987288	403	483	2	8	80	0.1000000
NODE_5861_length_1043_cov_25.987288	403	483	4	10	80	0.1250000
NODE_5861_length_1043_cov_25.987288	403	483	6	58	80	0.7250000
NODE_5861_length_1043_cov_25.987288	479	559	6	18	80	0.2250000
NODE_5861_length_1043_cov_25.987288	479	559	8	11	80	0.1375000
NODE_5861_length_1043_cov_25.987288	479	559	10	7	80	0.0875000
NODE_5861_length_1043_cov_25.987288	479	559	11	3	80	0.0375000
NODE_5861_length_1043_cov_25.987288	479	559	12	25	80	0.3125000
NODE_5861_length_1043_cov_25.987288	479	559	14	13	80	0.1625000
NODE_5861_length_1043_cov_25.987288	479	559	16	3	80	0.0375000
NODE_5861_length_1043_cov_25.987288	532	612	8	6	80	0.0750000
NODE_5861_length_1043_cov_25.987288	532	612	10	5	80	0.0625000
NODE_5861_length_1043_cov_25.987288	532	612	12	51	80	0.6375000
NODE_5861_length_1043_cov_25.987288	532	612	14	15	80	0.1875000
NODE_5861_length_1043_cov_25.987288	532	612	16	3	80	0.0375000
NODE_5862_length_1043_cov_20.838983	561	641	0	80	80	1.0000000
NODE_5862_length_1043_cov_20.838983	614	694	0	80	80	1.0000000
NODE_5863_length_1043_cov_20.312500	489	569	0	80	80	1.0000000
NODE_5863_length_1043_cov_20.312500	542	622	0	80	80	1.0000000
NODE_5864_length_1043_cov_16.320975	569	649	4	80	80	1.0000000
NODE_5864_length_1043_cov_16.320975	622	702	0	51	80	0.6375000
NODE_5864_length_1043_cov_16.320975	622	702	4	29	80	0.3625000
NODE_5865_length_1043_cov_11.176907	521	601	0	80	80	1.0000000
NODE_5865_length_1043_cov_11.176907	574	654	0	80	80	1.0000000
NODE_5866_length_1043_cov_8.146186	530	596	0	66	66	1.0000000
NODE_5866_length_1043_cov_8.146186	569	649	0	80	80	1.0000000
NODE_5868_length_1043_cov_5.347458	646	726	0	80	80	1.0000000
NODE_5868_length_1043_cov_5.347458	699	779	0	80	80	1.0000000
NODE_5879_length_1042_cov_242.728526	820	900	45	1	80	0.0125000
NODE_5879_length_1042_cov_242.728526	820	900	48	1	80	0.0125000
NODE_5879_length_1042_cov_242.728526	820	900	49	4	80	0.0500000
NODE_5879_length_1042_cov_242.728526	820	900	51	1	80	0.0125000
NODE_5879_length_1042_cov_242.728526	820	900	52	1	80	0.0125000
NODE_5879_length_1042_cov_242.728526	820	900	61	1	80	0.0125000
NODE_5879_length_1042_cov_242.728526	820	900	66	1	80	0.0125000
NODE_5879_length_1042_cov_242.728526	820	900	69	1	80	0.0125000
NODE_5879_length_1042_cov_242.728526	820	900	71	1	80	0.0125000
NODE_5879_length_1042_cov_242.728526	820	900	72	1	80	0.0125000
NODE_5879_length_1042_cov_242.728526	820	900	73	3	80	0.0375000
NODE_5879_length_1042_cov_242.728526	820	900	74	2	80	0.0250000
NODE_5879_length_1042_cov_242.728526	820	900	76	3	80	0.0375000
NODE_5879_length_1042_cov_242.728526	820	900	78	1	80	0.0125000
NODE_5879_length_1042_cov_242.728526	820	900	79	1	80	0.0125000
NODE_5879_length_1042_cov_242.728526	820	900	80	4	80	0.0500000
NODE_5879_length_1042_cov_242.728526	820	900	82	3	80	0.0375000
NODE_5879_length_1042_cov_242.728526	820	900	84	2	80	0.0250000
NODE_5879_length_1042_cov_242.728526	820	900	85	3	80	0.0375000
NODE_5879_length_1042_cov_242.728526	820	900	89	2	80	0.0250000
NODE_5879_length_1042_cov_242.728526	820	900	93	7	80	0.0875000
NODE_5879_length_1042_cov_242.728526	820	900	95	3	80	0.0375000
NODE_5879_length_1042_cov_242.728526	820	900	97	1	80	0.0125000
NODE_5879_length_1042_cov_242.728526	820	900	99	5	80	0.0625000
NODE_5879_length_1042_cov_242.728526	820	900	101	1	80	0.0125000
NODE_5879_length_1042_cov_242.728526	820	900	103	1	80	0.0125000
NODE_5879_length_1042_cov_242.728526	820	900	104	1	80	0.0125000
NODE_5879_length_1042_cov_242.728526	820	900	105	2	80	0.0250000
NODE_5879_length_1042_cov_242.728526	820	900	112	2	80	0.0250000
NODE_5879_length_1042_cov_242.728526	820	900	114	2	80	0.0250000
NODE_5879_length_1042_cov_242.728526	820	900	123	2	80	0.0250000
NODE_5879_length_1042_cov_242.728526	820	900	124	4	80	0.0500000
NODE_5879_length_1042_cov_242.728526	820	900	126	2	80	0.0250000
NODE_5879_length_1042_cov_242.728526	820	900	130	1	80	0.0125000
NODE_5879_length_1042_cov_242.728526	820	900	132	3	80	0.0375000
NODE_5879_length_1042_cov_242.728526	820	900	136	6	80	0.0750000
NODE_5879_length_1042_cov_242.728526	873	903	101	1	30	0.0333333
NODE_5879_length_1042_cov_242.728526	873	903	103	1	30	0.0333333
NODE_5879_length_1042_cov_242.728526	873	903	104	1	30	0.0333333
NODE_5879_length_1042_cov_242.728526	873	903	105	2	30	0.0666667
NODE_5879_length_1042_cov_242.728526	873	903	112	2	30	0.0666667
NODE_5879_length_1042_cov_242.728526	873	903	114	2	30	0.0666667
NODE_5879_length_1042_cov_242.728526	873	903	123	2	30	0.0666667
NODE_5879_length_1042_cov_242.728526	873	903	124	4	30	0.1333333
NODE_5879_length_1042_cov_242.728526	873	903	126	2	30	0.0666667
NODE_5879_length_1042_cov_242.728526	873	903	130	1	30	0.0333333
NODE_5879_length_1042_cov_242.728526	873	903	132	3	30	0.1000000
NODE_5879_length_1042_cov_242.728526	873	903	135	1	30	0.0333333
NODE_5879_length_1042_cov_242.728526	873	903	136	8	30	0.2666667
NODE_5880_length_1042_cov_63.214210	355	435	0	19	80	0.2375000
NODE_5880_length_1042_cov_63.214210	355	435	4	61	80	0.7625000
NODE_5880_length_1042_cov_63.214210	408	488	0	7	80	0.0875000
NODE_5880_length_1042_cov_63.214210	408	488	2	22	80	0.2750000
NODE_5880_length_1042_cov_63.214210	408	488	4	51	80	0.6375000
NODE_5881_length_1042_cov_29.581124	497	577	0	80	80	1.0000000
NODE_5881_length_1042_cov_29.581124	550	630	0	80	80	1.0000000
NODE_5882_length_1042_cov_23.861082	519	599	0	80	80	1.0000000
NODE_5882_length_1042_cov_23.861082	572	652	0	80	80	1.0000000
NODE_5882_length_1042_cov_23.861082	648	728	0	37	80	0.4625000
NODE_5882_length_1042_cov_23.861082	648	728	2	43	80	0.5375000
NODE_5882_length_1042_cov_23.861082	701	781	2	80	80	1.0000000
NODE_5883_length_1042_cov_22.247084	555	635	0	64	80	0.8000000
NODE_5883_length_1042_cov_22.247084	555	635	2	8	80	0.1000000
NODE_5883_length_1042_cov_22.247084	555	635	4	8	80	0.1000000
NODE_5883_length_1042_cov_22.247084	608	688	0	21	80	0.2625000
NODE_5883_length_1042_cov_22.247084	608	688	4	59	80	0.7375000
NODE_5884_length_1042_cov_22.117709	335	415	0	24	80	0.3000000
NODE_5884_length_1042_cov_22.117709	335	415	2	56	80	0.7000000
NODE_5884_length_1042_cov_22.117709	388	468	0	18	80	0.2250000
NODE_5884_length_1042_cov_22.117709	388	468	2	62	80	0.7750000
NODE_5884_length_1042_cov_22.117709	464	544	0	80	80	1.0000000
NODE_5884_length_1042_cov_22.117709	517	597	0	80	80	1.0000000
NODE_5885_length_1042_cov_16.831389	27	97	6	48	70	0.6857143
NODE_5885_length_1042_cov_16.831389	27	97	8	22	70	0.3142857
NODE_5885_length_1042_cov_16.831389	372	452	0	72	80	0.9000000
NODE_5885_length_1042_cov_16.831389	372	452	4	8	80	0.1000000
NODE_5885_length_1042_cov_16.831389	425	505	0	19	80	0.2375000
NODE_5885_length_1042_cov_16.831389	425	505	4	61	80	0.7625000
NODE_5886_length_1042_cov_16.662778	416	496	0	80	80	1.0000000
NODE_5886_length_1042_cov_16.662778	469	549	0	80	80	1.0000000
NODE_5887_length_1042_cov_9.474019	361	441	0	38	80	0.4750000
NODE_5887_length_1042_cov_9.474019	361	441	4	42	80	0.5250000
NODE_5887_length_1042_cov_9.474019	414	494	4	80	80	1.0000000
NODE_5888_length_1042_cov_6.725345	356	419	0	63	63	1.0000000
NODE_5888_length_1042_cov_6.725345	392	472	0	80	80	1.0000000
NODE_5896_length_1041_cov_42.960722	335	415	0	80	80	1.0000000
NODE_5896_length_1041_cov_42.960722	388	468	0	80	80	1.0000000
NODE_5896_length_1041_cov_42.960722	464	544	0	80	80	1.0000000
NODE_5896_length_1041_cov_42.960722	517	597	0	80	80	1.0000000
NODE_5897_length_1041_cov_37.331210	513	593	3	1	80	0.0125000
NODE_5897_length_1041_cov_37.331210	513	593	4	4	80	0.0500000
NODE_5897_length_1041_cov_37.331210	513	593	5	7	80	0.0875000
NODE_5897_length_1041_cov_37.331210	513	593	6	9	80	0.1125000
NODE_5897_length_1041_cov_37.331210	513	593	7	41	80	0.5125000
NODE_5897_length_1041_cov_37.331210	513	593	8	18	80	0.2250000
NODE_5897_length_1041_cov_37.331210	566	646	1	11	80	0.1375000
NODE_5897_length_1041_cov_37.331210	566	646	3	43	80	0.5375000
NODE_5897_length_1041_cov_37.331210	566	646	5	7	80	0.0875000
NODE_5897_length_1041_cov_37.331210	566	646	7	19	80	0.2375000
NODE_5897_length_1041_cov_37.331210	642	722	0	69	80	0.8625000
NODE_5897_length_1041_cov_37.331210	642	722	1	11	80	0.1375000
NODE_5897_length_1041_cov_37.331210	695	775	0	80	80	1.0000000
NODE_5898_length_1041_cov_36.477707	455	535	2	13	80	0.1625000
NODE_5898_length_1041_cov_36.477707	455	535	6	39	80	0.4875000
NODE_5898_length_1041_cov_36.477707	455	535	8	28	80	0.3500000
NODE_5898_length_1041_cov_36.477707	508	588	0	20	80	0.2500000
NODE_5898_length_1041_cov_36.477707	508	588	6	60	80	0.7500000
NODE_5898_length_1041_cov_36.477707	584	664	0	80	80	1.0000000
NODE_5898_length_1041_cov_36.477707	637	717	0	80	80	1.0000000
NODE_5898_length_1041_cov_36.477707	753	799	0	46	46	1.0000000
NODE_5899_length_1041_cov_19.286624	468	548	0	37	80	0.4625000
NODE_5899_length_1041_cov_19.286624	468	548	2	43	80	0.5375000
NODE_5899_length_1041_cov_19.286624	521	601	2	80	80	1.0000000
NODE_5900_length_1041_cov_17.072187	578	658	0	23	80	0.2875000
NODE_5900_length_1041_cov_17.072187	578	658	2	16	80	0.2000000
NODE_5900_length_1041_cov_17.072187	578	658	4	41	80	0.5125000
NODE_5900_length_1041_cov_17.072187	631	711	0	60	80	0.7500000
NODE_5900_length_1041_cov_17.072187	631	711	2	4	80	0.0500000
NODE_5900_length_1041_cov_17.072187	631	711	4	16	80	0.2000000
NODE_5901_length_1041_cov_11.887473	437	517	0	3	80	0.0375000
NODE_5901_length_1041_cov_11.887473	437	517	4	77	80	0.9625000
NODE_5901_length_1041_cov_11.887473	490	570	0	31	80	0.3875000
NODE_5901_length_1041_cov_11.887473	490	570	4	49	80	0.6125000
NODE_5902_length_1041_cov_6.957537	354	434	0	62	80	0.7750000
NODE_5902_length_1041_cov_6.957537	354	434	2	18	80	0.2250000
NODE_5902_length_1041_cov_6.957537	407	487	0	80	80	1.0000000
NODE_5913_length_1040_cov_34.618491	478	558	0	77	80	0.9625000
NODE_5913_length_1040_cov_34.618491	478	558	2	3	80	0.0375000
NODE_5913_length_1040_cov_34.618491	531	611	0	24	80	0.3000000
NODE_5913_length_1040_cov_34.618491	531	611	2	20	80	0.2500000
NODE_5913_length_1040_cov_34.618491	531	611	4	36	80	0.4500000
NODE_5914_length_1040_cov_33.061637	485	565	2	33	80	0.4125000
NODE_5914_length_1040_cov_33.061637	485	565	4	41	80	0.5125000
NODE_5914_length_1040_cov_33.061637	485	565	5	1	80	0.0125000
NODE_5914_length_1040_cov_33.061637	485	565	6	5	80	0.0625000
NODE_5914_length_1040_cov_33.061637	538	618	2	3	80	0.0375000
NODE_5914_length_1040_cov_33.061637	538	618	3	10	80	0.1250000
NODE_5914_length_1040_cov_33.061637	538	618	4	21	80	0.2625000
NODE_5914_length_1040_cov_33.061637	538	618	5	41	80	0.5125000
NODE_5914_length_1040_cov_33.061637	538	618	6	5	80	0.0625000
NODE_5915_length_1040_cov_27.818278	402	482	0	4	80	0.0500000
NODE_5915_length_1040_cov_27.818278	402	482	2	20	80	0.2500000
NODE_5915_length_1040_cov_27.818278	402	482	4	19	80	0.2375000
NODE_5915_length_1040_cov_27.818278	402	482	7	16	80	0.2000000
NODE_5915_length_1040_cov_27.818278	402	482	10	21	80	0.2625000
NODE_5915_length_1040_cov_27.818278	455	535	0	4	80	0.0500000
NODE_5915_length_1040_cov_27.818278	455	535	2	47	80	0.5875000
NODE_5915_length_1040_cov_27.818278	455	535	4	29	80	0.3625000
NODE_5916_length_1040_cov_17.933050	487	567	2	68	80	0.8500000
NODE_5916_length_1040_cov_17.933050	487	567	4	12	80	0.1500000
NODE_5916_length_1040_cov_17.933050	540	620	2	23	80	0.2875000
NODE_5916_length_1040_cov_17.933050	540	620	4	12	80	0.1500000
NODE_5916_length_1040_cov_17.933050	540	620	6	45	80	0.5625000
NODE_5917_length_1040_cov_14.327311	237	317	0	80	80	1.0000000
NODE_5917_length_1040_cov_14.327311	290	370	0	79	80	0.9875000
NODE_5917_length_1040_cov_14.327311	290	370	2	1	80	0.0125000
NODE_5917_length_1040_cov_14.327311	366	446	0	3	80	0.0375000
NODE_5917_length_1040_cov_14.327311	366	446	2	77	80	0.9625000
NODE_5917_length_1040_cov_14.327311	419	499	0	31	80	0.3875000
NODE_5917_length_1040_cov_14.327311	419	499	2	49	80	0.6125000
NODE_5918_length_1040_cov_11.910733	369	449	0	37	80	0.4625000
NODE_5918_length_1040_cov_11.910733	369	449	2	27	80	0.3375000
NODE_5918_length_1040_cov_11.910733	369	449	3	16	80	0.2000000
NODE_5918_length_1040_cov_11.910733	422	502	1	20	80	0.2500000
NODE_5918_length_1040_cov_11.910733	422	502	2	11	80	0.1375000
NODE_5918_length_1040_cov_11.910733	422	502	3	49	80	0.6125000
NODE_5919_length_1040_cov_11.521785	355	435	0	80	80	1.0000000
NODE_5919_length_1040_cov_11.521785	408	488	0	80	80	1.0000000
NODE_5920_length_1040_cov_9.573858	632	712	0	27	80	0.3375000
NODE_5920_length_1040_cov_9.573858	632	712	2	8	80	0.1000000
NODE_5920_length_1040_cov_9.573858	632	712	4	45	80	0.5625000
NODE_5920_length_1040_cov_9.573858	685	765	0	28	80	0.3500000
NODE_5920_length_1040_cov_9.573858	685	765	4	52	80	0.6500000
NODE_5921_length_1040_cov_8.148778	349	429	2	37	80	0.4625000
NODE_5921_length_1040_cov_8.148778	349	429	4	43	80	0.5375000
NODE_5921_length_1040_cov_8.148778	402	482	0	9	80	0.1125000
NODE_5921_length_1040_cov_8.148778	402	482	2	32	80	0.4000000
NODE_5921_length_1040_cov_8.148778	402	482	4	39	80	0.4875000
NODE_5922_length_1040_cov_7.927736	282	362	2	80	80	1.0000000
NODE_5922_length_1040_cov_7.927736	335	415	0	47	80	0.5875000
NODE_5922_length_1040_cov_7.927736	335	415	2	33	80	0.4125000
NODE_5927_length_1040_cov_2.317747	2	78	2	41	76	0.5394737
NODE_5927_length_1040_cov_2.317747	2	78	4	35	76	0.4605263
NODE_5934_length_1039_cov_40.150000	487	567	0	3	80	0.0375000
NODE_5934_length_1039_cov_40.150000	487	567	2	8	80	0.1000000
NODE_5934_length_1039_cov_40.150000	487	567	4	69	80	0.8625000
NODE_5934_length_1039_cov_40.150000	540	620	0	42	80	0.5250000
NODE_5934_length_1039_cov_40.150000	540	620	2	22	80	0.2750000
NODE_5934_length_1039_cov_40.150000	540	620	4	16	80	0.2000000
NODE_5934_length_1039_cov_40.150000	616	696	2	5	80	0.0625000
NODE_5934_length_1039_cov_40.150000	616	696	4	1	80	0.0125000
NODE_5934_length_1039_cov_40.150000	616	696	6	13	80	0.1625000
NODE_5934_length_1039_cov_40.150000	616	696	8	61	80	0.7625000
NODE_5934_length_1039_cov_40.150000	669	739	4	18	70	0.2571429
NODE_5934_length_1039_cov_40.150000	669	739	6	25	70	0.3571429
NODE_5934_length_1039_cov_40.150000	669	739	8	27	70	0.3857143
NODE_5935_length_1039_cov_37.940426	175	255	0	19	80	0.2375000
NODE_5935_length_1039_cov_37.940426	175	255	2	13	80	0.1625000
NODE_5935_length_1039_cov_37.940426	175	255	6	31	80	0.3875000
NODE_5935_length_1039_cov_37.940426	175	255	8	17	80	0.2125000
NODE_5935_length_1039_cov_37.940426	228	308	6	42	80	0.5250000
NODE_5935_length_1039_cov_37.940426	228	308	8	38	80	0.4750000
NODE_5935_length_1039_cov_37.940426	304	384	2	40	80	0.5000000
NODE_5935_length_1039_cov_37.940426	304	384	4	3	80	0.0375000
NODE_5935_length_1039_cov_37.940426	304	384	6	13	80	0.1625000
NODE_5935_length_1039_cov_37.940426	304	384	7	1	80	0.0125000
NODE_5935_length_1039_cov_37.940426	304	384	8	23	80	0.2875000
NODE_5935_length_1039_cov_37.940426	357	437	0	24	80	0.3000000
NODE_5935_length_1039_cov_37.940426	357	437	2	56	80	0.7000000
NODE_5936_length_1039_cov_24.567021	371	451	0	80	80	1.0000000
NODE_5936_length_1039_cov_24.567021	424	504	0	80	80	1.0000000
NODE_5937_length_1039_cov_15.790426	293	373	0	15	80	0.1875000
NODE_5937_length_1039_cov_15.790426	293	373	4	33	80	0.4125000
NODE_5937_length_1039_cov_15.790426	293	373	6	32	80	0.4000000
NODE_5937_length_1039_cov_15.790426	346	426	2	25	80	0.3125000
NODE_5937_length_1039_cov_15.790426	346	426	6	55	80	0.6875000
NODE_5938_length_1039_cov_14.670213	591	671	0	80	80	1.0000000
NODE_5938_length_1039_cov_14.670213	644	724	0	80	80	1.0000000
NODE_5939_length_1039_cov_11.568085	439	519	0	55	80	0.6875000
NODE_5939_length_1039_cov_11.568085	439	519	2	25	80	0.3125000
NODE_5939_length_1039_cov_11.568085	492	571	0	2	79	0.0253165
NODE_5939_length_1039_cov_11.568085	492	571	2	77	79	0.9746835
NODE_5947_length_1038_cov_17.191693	549	629	0	51	80	0.6375000
NODE_5947_length_1038_cov_17.191693	549	629	2	29	80	0.3625000
NODE_5947_length_1038_cov_17.191693	602	682	0	4	80	0.0500000
NODE_5947_length_1038_cov_17.191693	602	682	2	76	80	0.9500000
NODE_5948_length_1038_cov_13.520767	516	596	0	80	80	1.0000000
NODE_5948_length_1038_cov_13.520767	569	649	0	80	80	1.0000000
NODE_5949_length_1038_cov_10.541001	487	567	0	80	80	1.0000000
NODE_5949_length_1038_cov_10.541001	540	620	0	80	80	1.0000000
NODE_5950_length_1038_cov_8.826411	432	512	0	3	80	0.0375000
NODE_5950_length_1038_cov_8.826411	432	512	2	77	80	0.9625000
NODE_5950_length_1038_cov_8.826411	485	565	0	56	80	0.7000000
NODE_5950_length_1038_cov_8.826411	485	565	2	24	80	0.3000000
NODE_5952_length_1038_cov_2.587859	673	753	0	67	80	0.8375000
NODE_5952_length_1038_cov_2.587859	673	753	2	13	80	0.1625000
NODE_5952_length_1038_cov_2.587859	726	806	0	14	80	0.1750000
NODE_5952_length_1038_cov_2.587859	726	806	2	66	80	0.8250000
NODE_5963_length_1037_cov_66.968017	402	482	0	22	80	0.2750000
NODE_5963_length_1037_cov_66.968017	402	482	2	58	80	0.7250000
NODE_5963_length_1037_cov_66.968017	455	535	0	31	80	0.3875000
NODE_5963_length_1037_cov_66.968017	455	535	2	49	80	0.6125000
NODE_5964_length_1037_cov_53.639659	527	607	0	30	80	0.3750000
NODE_5964_length_1037_cov_53.639659	527	607	2	3	80	0.0375000
NODE_5964_length_1037_cov_53.639659	527	607	3	2	80	0.0250000
NODE_5964_length_1037_cov_53.639659	527	607	4	7	80	0.0875000
NODE_5964_length_1037_cov_53.639659	527	607	9	9	80	0.1125000
NODE_5964_length_1037_cov_53.639659	527	607	16	22	80	0.2750000
NODE_5964_length_1037_cov_53.639659	527	607	18	7	80	0.0875000
NODE_5964_length_1037_cov_53.639659	580	660	16	24	80	0.3000000
NODE_5964_length_1037_cov_53.639659	580	660	17	25	80	0.3125000
NODE_5964_length_1037_cov_53.639659	580	660	18	14	80	0.1750000
NODE_5964_length_1037_cov_53.639659	580	660	19	17	80	0.2125000
NODE_5965_length_1037_cov_45.353945	542	622	0	13	80	0.1625000
NODE_5965_length_1037_cov_45.353945	542	622	2	67	80	0.8375000
NODE_5965_length_1037_cov_45.353945	595	675	0	23	80	0.2875000
NODE_5965_length_1037_cov_45.353945	595	675	2	57	80	0.7125000
NODE_5966_length_1037_cov_31.078891	356	436	1	8	80	0.1000000
NODE_5966_length_1037_cov_31.078891	356	436	3	72	80	0.9000000
NODE_5966_length_1037_cov_31.078891	409	489	0	30	80	0.3750000
NODE_5966_length_1037_cov_31.078891	409	489	2	5	80	0.0625000
NODE_5966_length_1037_cov_31.078891	409	489	3	45	80	0.5625000
NODE_5967_length_1037_cov_25.453092	421	501	6	1	80	0.0125000
NODE_5967_length_1037_cov_25.453092	421	501	8	6	80	0.0750000
NODE_5967_length_1037_cov_25.453092	421	501	12	52	80	0.6500000
NODE_5967_length_1037_cov_25.453092	421	501	14	21	80	0.2625000
NODE_5967_length_1037_cov_25.453092	474	554	1	4	80	0.0500000
NODE_5967_length_1037_cov_25.453092	474	554	5	15	80	0.1875000
NODE_5967_length_1037_cov_25.453092	474	554	6	26	80	0.3250000
NODE_5967_length_1037_cov_25.453092	474	554	10	8	80	0.1000000
NODE_5967_length_1037_cov_25.453092	474	554	12	11	80	0.1375000
NODE_5967_length_1037_cov_25.453092	474	554	14	16	80	0.2000000
NODE_5967_length_1037_cov_25.453092	550	573	0	12	23	0.5217391
NODE_5967_length_1037_cov_25.453092	550	573	1	11	23	0.4782609
NODE_5968_length_1037_cov_13.740938	348	428	0	80	80	1.0000000
NODE_5968_length_1037_cov_13.740938	401	481	0	80	80	1.0000000
NODE_5969_length_1037_cov_12.632196	564	644	0	80	80	1.0000000
NODE_5969_length_1037_cov_12.632196	617	697	0	80	80	1.0000000
NODE_5970_length_1037_cov_8.904051	640	720	0	3	80	0.0375000
NODE_5970_length_1037_cov_8.904051	640	720	2	77	80	0.9625000
NODE_5970_length_1037_cov_8.904051	693	773	0	50	80	0.6250000
NODE_5970_length_1037_cov_8.904051	693	773	2	30	80	0.3750000
NODE_5978_length_1037_cov_1.859275	31	91	0	60	60	1.0000000
NODE_5986_length_1036_cov_52.270011	493	573	0	10	80	0.1250000
NODE_5986_length_1036_cov_52.270011	493	573	2	34	80	0.4250000
NODE_5986_length_1036_cov_52.270011	493	573	4	36	80	0.4500000
NODE_5986_length_1036_cov_52.270011	546	626	0	16	80	0.2000000
NODE_5986_length_1036_cov_52.270011	546	626	2	1	80	0.0125000
NODE_5986_length_1036_cov_52.270011	546	626	4	63	80	0.7875000
NODE_5987_length_1036_cov_24.080043	369	449	0	67	80	0.8375000
NODE_5987_length_1036_cov_24.080043	369	449	2	13	80	0.1625000
NODE_5987_length_1036_cov_24.080043	422	502	0	14	80	0.1750000
NODE_5987_length_1036_cov_24.080043	422	502	2	61	80	0.7625000
NODE_5987_length_1036_cov_24.080043	422	502	4	5	80	0.0625000
NODE_5988_length_1036_cov_20.533618	513	593	0	14	80	0.1750000
NODE_5988_length_1036_cov_20.533618	513	593	2	66	80	0.8250000
NODE_5988_length_1036_cov_20.533618	566	645	0	66	79	0.8354430
NODE_5988_length_1036_cov_20.533618	566	645	2	13	79	0.1645570
NODE_5988_length_1036_cov_20.533618	648	728	0	80	80	1.0000000
NODE_5988_length_1036_cov_20.533618	701	781	0	80	80	1.0000000
NODE_5989_length_1036_cov_19.715048	467	547	0	11	80	0.1375000
NODE_5989_length_1036_cov_19.715048	467	547	2	69	80	0.8625000
NODE_5989_length_1036_cov_19.715048	520	600	0	14	80	0.1750000
NODE_5989_length_1036_cov_19.715048	520	600	2	66	80	0.8250000
NODE_5990_length_1036_cov_19.452508	399	479	0	80	80	1.0000000
NODE_5990_length_1036_cov_19.452508	452	532	0	80	80	1.0000000
NODE_5990_length_1036_cov_19.452508	528	608	0	37	80	0.4625000
NODE_5990_length_1036_cov_19.452508	528	608	2	43	80	0.5375000
NODE_5990_length_1036_cov_19.452508	581	661	2	80	80	1.0000000
NODE_5991_length_1036_cov_13.840982	635	715	2	80	80	1.0000000
NODE_5991_length_1036_cov_13.840982	688	768	0	35	80	0.4375000
NODE_5991_length_1036_cov_13.840982	688	768	2	45	80	0.5625000
NODE_5992_length_1036_cov_6.913554	424	504	0	80	80	1.0000000
NODE_5992_length_1036_cov_6.913554	477	557	0	50	80	0.6250000
NODE_5992_length_1036_cov_6.913554	477	557	2	30	80	0.3750000
NODE_5993_length_1036_cov_5.880470	436	516	0	80	80	1.0000000
NODE_5993_length_1036_cov_5.880470	489	569	0	80	80	1.0000000
NODE_5994_length_1036_cov_4.638207	531	611	2	80	80	1.0000000
NODE_5994_length_1036_cov_4.638207	584	664	0	18	80	0.2250000
NODE_5994_length_1036_cov_4.638207	584	664	2	62	80	0.7750000
NODE_5998_length_1036_cov_1.293490	19	69	0	50	50	1.0000000
NODE_6001_length_1035_cov_31.941239	590	670	0	19	80	0.2375000
NODE_6001_length_1035_cov_31.941239	590	670	2	9	80	0.1125000
NODE_6001_length_1035_cov_31.941239	590	670	4	52	80	0.6500000
NODE_6001_length_1035_cov_31.941239	643	723	2	17	80	0.2125000
NODE_6001_length_1035_cov_31.941239	643	723	4	63	80	0.7875000
NODE_6002_length_1035_cov_14.917735	396	476	0	49	80	0.6125000
NODE_6002_length_1035_cov_14.917735	396	476	2	31	80	0.3875000
NODE_6002_length_1035_cov_14.917735	449	529	0	19	80	0.2375000
NODE_6002_length_1035_cov_14.917735	449	529	2	61	80	0.7625000
NODE_6003_length_1035_cov_12.552350	467	547	0	80	80	1.0000000
NODE_6003_length_1035_cov_12.552350	520	600	0	80	80	1.0000000
NODE_6004_length_1035_cov_12.050214	40	103	6	7	63	0.1111111
NODE_6004_length_1035_cov_12.050214	40	103	7	4	63	0.0634921
NODE_6004_length_1035_cov_12.050214	40	103	8	6	63	0.0952381
NODE_6004_length_1035_cov_12.050214	40	103	9	2	63	0.0317460
NODE_6004_length_1035_cov_12.050214	40	103	17	22	63	0.3492064
NODE_6004_length_1035_cov_12.050214	40	103	19	5	63	0.0793651
NODE_6004_length_1035_cov_12.050214	40	103	20	1	63	0.0158730
NODE_6004_length_1035_cov_12.050214	40	103	21	8	63	0.1269841
NODE_6004_length_1035_cov_12.050214	40	103	23	8	63	0.1269841
NODE_6004_length_1035_cov_12.050214	138	219	2	1	81	0.0123457
NODE_6004_length_1035_cov_12.050214	138	219	4	2	81	0.0246914
NODE_6004_length_1035_cov_12.050214	138	219	10	1	81	0.0123457
NODE_6004_length_1035_cov_12.050214	138	219	18	1	81	0.0123457
NODE_6004_length_1035_cov_12.050214	138	219	20	1	81	0.0123457
NODE_6004_length_1035_cov_12.050214	138	219	26	6	81	0.0740741
NODE_6004_length_1035_cov_12.050214	138	219	27	6	81	0.0740741
NODE_6004_length_1035_cov_12.050214	138	219	29	9	81	0.1111111
NODE_6004_length_1035_cov_12.050214	138	219	31	1	81	0.0123457
NODE_6004_length_1035_cov_12.050214	138	219	38	2	81	0.0246914
NODE_6004_length_1035_cov_12.050214	138	219	40	5	81	0.0617284
NODE_6004_length_1035_cov_12.050214	138	219	42	2	81	0.0246914
NODE_6004_length_1035_cov_12.050214	138	219	44	24	81	0.2962963
NODE_6004_length_1035_cov_12.050214	138	219	45	2	81	0.0246914
NODE_6004_length_1035_cov_12.050214	138	219	46	9	81	0.1111111
NODE_6004_length_1035_cov_12.050214	138	219	47	9	81	0.1111111
NODE_6005_length_1035_cov_7.020299	350	430	0	80	80	1.0000000
NODE_6005_length_1035_cov_7.020299	403	483	0	80	80	1.0000000
NODE_6006_length_1035_cov_4.726496	531	611	0	15	80	0.1875000
NODE_6006_length_1035_cov_4.726496	531	611	2	65	80	0.8125000
NODE_6006_length_1035_cov_4.726496	584	664	0	38	80	0.4750000
NODE_6006_length_1035_cov_4.726496	584	664	2	42	80	0.5250000
NODE_6018_length_1034_cov_26.810695	322	402	0	80	80	1.0000000
NODE_6018_length_1034_cov_26.810695	375	455	0	80	80	1.0000000
NODE_6018_length_1034_cov_26.810695	451	531	0	35	80	0.4375000
NODE_6018_length_1034_cov_26.810695	451	531	2	45	80	0.5625000
NODE_6018_length_1034_cov_26.810695	504	584	0	21	80	0.2625000
NODE_6018_length_1034_cov_26.810695	504	584	2	59	80	0.7375000
NODE_6032_length_1033_cov_42.574946	462	542	0	24	80	0.3000000
NODE_6032_length_1033_cov_42.574946	462	542	2	2	80	0.0250000
NODE_6032_length_1033_cov_42.574946	462	542	3	6	80	0.0750000
NODE_6032_length_1033_cov_42.574946	462	542	4	6	80	0.0750000
NODE_6032_length_1033_cov_42.574946	462	542	5	42	80	0.5250000
NODE_6032_length_1033_cov_42.574946	515	595	2	15	80	0.1875000
NODE_6032_length_1033_cov_42.574946	515	595	4	6	80	0.0750000
NODE_6032_length_1033_cov_42.574946	515	595	5	35	80	0.4375000
NODE_6032_length_1033_cov_42.574946	515	595	7	24	80	0.3000000
NODE_6033_length_1033_cov_17.073876	464	544	0	44	80	0.5500000
NODE_6033_length_1033_cov_17.073876	464	544	2	36	80	0.4500000
NODE_6033_length_1033_cov_17.073876	517	597	0	9	80	0.1125000
NODE_6033_length_1033_cov_17.073876	517	597	2	71	80	0.8875000
NODE_6034_length_1033_cov_15.791221	309	386	2	38	77	0.4935065
NODE_6034_length_1033_cov_15.791221	309	386	4	17	77	0.2207792
NODE_6034_length_1033_cov_15.791221	309	386	6	22	77	0.2857143
NODE_6034_length_1033_cov_15.791221	359	439	4	24	80	0.3000000
NODE_6034_length_1033_cov_15.791221	359	439	6	56	80	0.7000000
NODE_6035_length_1033_cov_11.340471	437	517	0	80	80	1.0000000
NODE_6035_length_1033_cov_11.340471	490	570	0	80	80	1.0000000
NODE_6045_length_1032_cov_56.511254	466	546	0	1	80	0.0125000
NODE_6045_length_1032_cov_56.511254	466	546	4	42	80	0.5250000
NODE_6045_length_1032_cov_56.511254	466	546	6	23	80	0.2875000
NODE_6045_length_1032_cov_56.511254	466	546	8	2	80	0.0250000
NODE_6045_length_1032_cov_56.511254	466	546	10	12	80	0.1500000
NODE_6045_length_1032_cov_56.511254	519	599	4	12	80	0.1500000
NODE_6045_length_1032_cov_56.511254	519	599	6	35	80	0.4375000
NODE_6045_length_1032_cov_56.511254	519	599	8	2	80	0.0250000
NODE_6045_length_1032_cov_56.511254	519	599	10	31	80	0.3875000
NODE_6046_length_1032_cov_20.752412	479	559	0	80	80	1.0000000
NODE_6046_length_1032_cov_20.752412	532	612	0	80	80	1.0000000
NODE_6047_length_1032_cov_8.166131	257	337	0	80	80	1.0000000
NODE_6047_length_1032_cov_8.166131	310	390	0	80	80	1.0000000
NODE_6048_length_1032_cov_7.991426	277	357	0	80	80	1.0000000
NODE_6048_length_1032_cov_7.991426	330	410	0	80	80	1.0000000
NODE_6049_length_1032_cov_5.276527	371	451	0	80	80	1.0000000
NODE_6049_length_1032_cov_5.276527	424	504	0	80	80	1.0000000
NODE_6055_length_1031_cov_71.154506	586	654	8	10	68	0.1470588
NODE_6055_length_1031_cov_71.154506	586	654	12	6	68	0.0882353
NODE_6055_length_1031_cov_71.154506	586	654	14	12	68	0.1764706
NODE_6055_length_1031_cov_71.154506	586	654	16	19	68	0.2794118
NODE_6055_length_1031_cov_71.154506	586	654	18	18	68	0.2647059
NODE_6055_length_1031_cov_71.154506	586	654	20	3	68	0.0441176
NODE_6055_length_1031_cov_71.154506	616	696	8	11	80	0.1375000
NODE_6055_length_1031_cov_71.154506	616	696	14	3	80	0.0375000
NODE_6055_length_1031_cov_71.154506	616	696	16	17	80	0.2125000
NODE_6055_length_1031_cov_71.154506	616	696	18	28	80	0.3500000
NODE_6055_length_1031_cov_71.154506	616	696	20	21	80	0.2625000
NODE_6055_length_1031_cov_71.154506	669	749	0	4	80	0.0500000
NODE_6055_length_1031_cov_71.154506	669	749	4	43	80	0.5375000
NODE_6055_length_1031_cov_71.154506	669	749	6	6	80	0.0750000
NODE_6055_length_1031_cov_71.154506	669	749	8	11	80	0.1375000
NODE_6055_length_1031_cov_71.154506	669	749	14	3	80	0.0375000
NODE_6055_length_1031_cov_71.154506	669	749	18	10	80	0.1250000
NODE_6055_length_1031_cov_71.154506	669	749	20	3	80	0.0375000
NODE_6056_length_1031_cov_70.221030	409	489	4	15	80	0.1875000
NODE_6056_length_1031_cov_70.221030	409	489	6	23	80	0.2875000
NODE_6056_length_1031_cov_70.221030	409	489	8	3	80	0.0375000
NODE_6056_length_1031_cov_70.221030	409	489	9	37	80	0.4625000
NODE_6056_length_1031_cov_70.221030	409	489	11	2	80	0.0250000
NODE_6056_length_1031_cov_70.221030	462	542	8	4	80	0.0500000
NODE_6056_length_1031_cov_70.221030	462	542	9	25	80	0.3125000
NODE_6056_length_1031_cov_70.221030	462	542	10	21	80	0.2625000
NODE_6056_length_1031_cov_70.221030	462	542	11	23	80	0.2875000
NODE_6056_length_1031_cov_70.221030	462	542	12	7	80	0.0875000
NODE_6056_length_1031_cov_70.221030	538	618	3	3	80	0.0375000
NODE_6056_length_1031_cov_70.221030	538	618	5	15	80	0.1875000
NODE_6056_length_1031_cov_70.221030	538	618	6	3	80	0.0375000
NODE_6056_length_1031_cov_70.221030	538	618	8	47	80	0.5875000
NODE_6056_length_1031_cov_70.221030	538	618	10	12	80	0.1500000
NODE_6056_length_1031_cov_70.221030	591	671	0	11	80	0.1375000
NODE_6056_length_1031_cov_70.221030	591	671	1	37	80	0.4625000
NODE_6056_length_1031_cov_70.221030	591	671	3	8	80	0.1000000
NODE_6056_length_1031_cov_70.221030	591	671	5	15	80	0.1875000
NODE_6056_length_1031_cov_70.221030	591	671	6	3	80	0.0375000
NODE_6056_length_1031_cov_70.221030	591	671	8	6	80	0.0750000
NODE_6057_length_1031_cov_43.618026	462	542	0	80	80	1.0000000
NODE_6057_length_1031_cov_43.618026	515	595	0	80	80	1.0000000
NODE_6058_length_1031_cov_43.581545	303	383	0	80	80	1.0000000
NODE_6058_length_1031_cov_43.581545	356	436	0	48	80	0.6000000
NODE_6058_length_1031_cov_43.581545	356	436	2	32	80	0.4000000
NODE_6058_length_1031_cov_43.581545	432	512	0	34	80	0.4250000
NODE_6058_length_1031_cov_43.581545	432	512	2	46	80	0.5750000
NODE_6058_length_1031_cov_43.581545	485	565	0	80	80	1.0000000
NODE_6059_length_1031_cov_22.310086	382	462	0	80	80	1.0000000
NODE_6059_length_1031_cov_22.310086	435	515	0	80	80	1.0000000
NODE_6060_length_1031_cov_11.547210	481	561	0	64	80	0.8000000
NODE_6060_length_1031_cov_11.547210	481	561	2	16	80	0.2000000
NODE_6060_length_1031_cov_11.547210	534	614	0	11	80	0.1375000
NODE_6060_length_1031_cov_11.547210	534	614	2	69	80	0.8625000
NODE_6066_length_1030_cov_54.380236	363	443	0	80	80	1.0000000
NODE_6066_length_1030_cov_54.380236	416	496	0	45	80	0.5625000
NODE_6066_length_1030_cov_54.380236	416	496	2	35	80	0.4375000
NODE_6066_length_1030_cov_54.380236	492	572	2	37	80	0.4625000
NODE_6066_length_1030_cov_54.380236	492	572	4	13	80	0.1625000
NODE_6066_length_1030_cov_54.380236	492	572	5	5	80	0.0625000
NODE_6066_length_1030_cov_54.380236	492	572	6	25	80	0.3125000
NODE_6066_length_1030_cov_54.380236	545	625	0	14	80	0.1750000
NODE_6066_length_1030_cov_54.380236	545	625	2	12	80	0.1500000
NODE_6066_length_1030_cov_54.380236	545	625	3	1	80	0.0125000
NODE_6066_length_1030_cov_54.380236	545	625	4	32	80	0.4000000
NODE_6066_length_1030_cov_54.380236	545	625	6	21	80	0.2625000
NODE_6067_length_1030_cov_45.040816	334	414	0	27	80	0.3375000
NODE_6067_length_1030_cov_45.040816	334	414	2	53	80	0.6625000
NODE_6067_length_1030_cov_45.040816	387	467	0	80	80	1.0000000
NODE_6067_length_1030_cov_45.040816	463	543	0	80	80	1.0000000
NODE_6067_length_1030_cov_45.040816	516	596	0	80	80	1.0000000
NODE_6068_length_1030_cov_20.491944	511	591	0	80	80	1.0000000
NODE_6068_length_1030_cov_20.491944	564	644	0	80	80	1.0000000
NODE_6069_length_1030_cov_17.253491	524	604	0	80	80	1.0000000
NODE_6069_length_1030_cov_17.253491	577	657	0	80	80	1.0000000
NODE_6070_length_1030_cov_14.337272	564	644	2	7	80	0.0875000
NODE_6070_length_1030_cov_14.337272	564	644	8	13	80	0.1625000
NODE_6070_length_1030_cov_14.337272	564	644	10	18	80	0.2250000
NODE_6070_length_1030_cov_14.337272	564	644	12	42	80	0.5250000
NODE_6070_length_1030_cov_14.337272	617	697	0	31	80	0.3875000
NODE_6070_length_1030_cov_14.337272	617	697	2	29	80	0.3625000
NODE_6070_length_1030_cov_14.337272	617	697	8	13	80	0.1625000
NODE_6070_length_1030_cov_14.337272	617	697	12	7	80	0.0875000
NODE_6071_length_1030_cov_5.742213	474	554	0	80	80	1.0000000
NODE_6071_length_1030_cov_5.742213	527	607	0	50	80	0.6250000
NODE_6071_length_1030_cov_5.742213	527	607	2	30	80	0.3750000
NODE_6073_length_1030_cov_5.208378	978	1030	0	40	52	0.7692308
NODE_6073_length_1030_cov_5.208378	978	1030	2	12	52	0.2307692
NODE_6077_length_1030_cov_2.146079	979	1010	0	31	31	1.0000000
NODE_6083_length_1029_cov_236.527957	584	666	11	13	82	0.1585366
NODE_6083_length_1029_cov_236.527957	584	666	12	16	82	0.1951219
NODE_6083_length_1029_cov_236.527957	584	666	14	1	82	0.0121951
NODE_6083_length_1029_cov_236.527957	584	666	16	6	82	0.0731707
NODE_6083_length_1029_cov_236.527957	584	666	20	4	82	0.0487805
NODE_6083_length_1029_cov_236.527957	584	666	22	14	82	0.1707317
NODE_6083_length_1029_cov_236.527957	584	666	24	28	82	0.3414634
NODE_6083_length_1029_cov_236.527957	639	702	18	12	63	0.1904762
NODE_6083_length_1029_cov_236.527957	639	702	20	3	63	0.0476190
NODE_6083_length_1029_cov_236.527957	639	702	22	1	63	0.0158730
NODE_6083_length_1029_cov_236.527957	639	702	24	47	63	0.7460318
NODE_6084_length_1029_cov_41.650538	364	444	0	80	80	1.0000000
NODE_6084_length_1029_cov_41.650538	417	497	0	80	80	1.0000000
NODE_6084_length_1029_cov_41.650538	493	573	0	30	80	0.3750000
NODE_6084_length_1029_cov_41.650538	493	573	2	50	80	0.6250000
NODE_6084_length_1029_cov_41.650538	546	626	0	39	80	0.4875000
NODE_6084_length_1029_cov_41.650538	546	626	2	41	80	0.5125000
NODE_6085_length_1029_cov_34.940860	314	360	0	46	46	1.0000000
NODE_6085_length_1029_cov_34.940860	371	451	0	80	80	1.0000000
NODE_6085_length_1029_cov_34.940860	424	502	0	78	78	1.0000000
NODE_6086_length_1029_cov_28.752688	255	335	0	80	80	1.0000000
NODE_6086_length_1029_cov_28.752688	308	388	0	80	80	1.0000000
NODE_6086_length_1029_cov_28.752688	384	464	0	80	80	1.0000000
NODE_6086_length_1029_cov_28.752688	437	517	0	80	80	1.0000000
NODE_6087_length_1029_cov_28.523656	409	489	2	29	80	0.3625000
NODE_6087_length_1029_cov_28.523656	409	489	4	5	80	0.0625000
NODE_6087_length_1029_cov_28.523656	409	489	6	1	80	0.0125000
NODE_6087_length_1029_cov_28.523656	409	489	8	45	80	0.5625000
NODE_6087_length_1029_cov_28.523656	462	542	0	13	80	0.1625000
NODE_6087_length_1029_cov_28.523656	462	542	2	6	80	0.0750000
NODE_6087_length_1029_cov_28.523656	462	542	4	7	80	0.0875000
NODE_6087_length_1029_cov_28.523656	462	542	6	1	80	0.0125000
NODE_6087_length_1029_cov_28.523656	462	542	8	53	80	0.6625000
NODE_6088_length_1029_cov_28.283871	281	361	0	80	80	1.0000000
NODE_6088_length_1029_cov_28.283871	334	414	0	80	80	1.0000000
NODE_6088_length_1029_cov_28.283871	410	490	0	26	80	0.3250000
NODE_6088_length_1029_cov_28.283871	410	490	1	32	80	0.4000000
NODE_6088_length_1029_cov_28.283871	410	490	3	22	80	0.2750000
NODE_6088_length_1029_cov_28.283871	463	546	1	5	83	0.0602410
NODE_6088_length_1029_cov_28.283871	463	546	3	78	83	0.9397590
NODE_6089_length_1029_cov_26.883871	434	514	0	44	80	0.5500000
NODE_6089_length_1029_cov_26.883871	434	514	4	36	80	0.4500000
NODE_6089_length_1029_cov_26.883871	487	567	4	80	80	1.0000000
NODE_6090_length_1029_cov_23.552688	305	385	0	48	80	0.6000000
NODE_6090_length_1029_cov_23.552688	305	385	2	32	80	0.4000000
NODE_6090_length_1029_cov_23.552688	358	438	0	2	80	0.0250000
NODE_6090_length_1029_cov_23.552688	358	438	2	78	80	0.9750000
NODE_6090_length_1029_cov_23.552688	434	514	0	78	80	0.9750000
NODE_6090_length_1029_cov_23.552688	434	514	2	2	80	0.0250000
NODE_6090_length_1029_cov_23.552688	487	567	0	71	80	0.8875000
NODE_6090_length_1029_cov_23.552688	487	567	2	9	80	0.1125000
NODE_6091_length_1029_cov_22.520430	434	514	0	19	80	0.2375000
NODE_6091_length_1029_cov_22.520430	434	514	2	61	80	0.7625000
NODE_6091_length_1029_cov_22.520430	487	567	0	2	80	0.0250000
NODE_6091_length_1029_cov_22.520430	487	567	2	78	80	0.9750000
NODE_6092_length_1029_cov_21.924731	335	415	0	80	80	1.0000000
NODE_6092_length_1029_cov_21.924731	388	468	0	80	80	1.0000000
NODE_6093_length_1029_cov_17.101075	501	581	0	28	80	0.3500000
NODE_6093_length_1029_cov_17.101075	501	581	2	52	80	0.6500000
NODE_6093_length_1029_cov_17.101075	554	634	0	80	80	1.0000000
NODE_6093_length_1029_cov_17.101075	630	710	0	80	80	1.0000000
NODE_6093_length_1029_cov_17.101075	683	755	0	72	72	1.0000000
NODE_6094_length_1029_cov_14.052688	405	485	0	41	80	0.5125000
NODE_6094_length_1029_cov_14.052688	405	485	2	16	80	0.2000000
NODE_6094_length_1029_cov_14.052688	405	485	6	23	80	0.2875000
NODE_6094_length_1029_cov_14.052688	458	538	2	4	80	0.0500000
NODE_6094_length_1029_cov_14.052688	458	538	3	10	80	0.1250000
NODE_6094_length_1029_cov_14.052688	458	538	5	7	80	0.0875000
NODE_6094_length_1029_cov_14.052688	458	538	6	59	80	0.7375000
NODE_6095_length_1029_cov_11.119355	291	369	1	12	78	0.1538462
NODE_6095_length_1029_cov_11.119355	291	369	3	66	78	0.8461539
NODE_6095_length_1029_cov_11.119355	342	422	0	9	80	0.1125000
NODE_6095_length_1029_cov_11.119355	342	422	1	44	80	0.5500000
NODE_6095_length_1029_cov_11.119355	342	422	3	27	80	0.3375000
NODE_6097_length_1029_cov_3.850538	231	311	0	45	80	0.5625000
NODE_6097_length_1029_cov_3.850538	231	311	2	35	80	0.4375000
NODE_6097_length_1029_cov_3.850538	284	364	0	23	80	0.2875000
NODE_6097_length_1029_cov_3.850538	284	364	2	57	80	0.7125000
NODE_6104_length_1028_cov_19.625404	495	575	0	80	80	1.0000000
NODE_6104_length_1028_cov_19.625404	548	628	0	54	80	0.6750000
NODE_6104_length_1028_cov_19.625404	548	628	2	26	80	0.3250000
NODE_6105_length_1028_cov_17.497309	533	613	1	12	80	0.1500000
NODE_6105_length_1028_cov_17.497309	533	613	3	68	80	0.8500000
NODE_6105_length_1028_cov_17.497309	586	666	3	35	80	0.4375000
NODE_6105_length_1028_cov_17.497309	586	666	4	15	80	0.1875000
NODE_6105_length_1028_cov_17.497309	586	666	5	25	80	0.3125000
NODE_6105_length_1028_cov_17.497309	586	666	7	5	80	0.0625000
NODE_6106_length_1028_cov_16.528525	497	577	0	49	80	0.6125000
NODE_6106_length_1028_cov_16.528525	497	577	2	31	80	0.3875000
NODE_6106_length_1028_cov_16.528525	550	630	0	16	80	0.2000000
NODE_6106_length_1028_cov_16.528525	550	630	2	64	80	0.8000000
NODE_6107_length_1028_cov_10.212056	463	543	2	80	80	1.0000000
NODE_6107_length_1028_cov_10.212056	516	596	0	42	80	0.5250000
NODE_6107_length_1028_cov_10.212056	516	596	2	38	80	0.4750000
NODE_6108_length_1028_cov_10.131324	399	479	0	19	80	0.2375000
NODE_6108_length_1028_cov_10.131324	399	479	2	61	80	0.7625000
NODE_6108_length_1028_cov_10.131324	452	532	0	72	80	0.9000000
NODE_6108_length_1028_cov_10.131324	452	532	2	8	80	0.1000000
NODE_6109_length_1028_cov_9.773950	482	562	0	80	80	1.0000000
NODE_6109_length_1028_cov_9.773950	535	615	0	80	80	1.0000000
NODE_6110_length_1028_cov_8.079656	399	479	0	6	80	0.0750000
NODE_6110_length_1028_cov_8.079656	399	479	2	11	80	0.1375000
NODE_6110_length_1028_cov_8.079656	399	479	4	63	80	0.7875000
NODE_6110_length_1028_cov_8.079656	452	532	2	13	80	0.1625000
NODE_6110_length_1028_cov_8.079656	452	532	4	67	80	0.8375000
NODE_6111_length_1028_cov_7.092573	439	519	2	80	80	1.0000000
NODE_6111_length_1028_cov_7.092573	492	572	0	52	80	0.6500000
NODE_6111_length_1028_cov_7.092573	492	572	2	28	80	0.3500000
NODE_6112_length_1028_cov_4.727664	416	488	2	38	72	0.5277778
NODE_6112_length_1028_cov_4.727664	416	488	4	34	72	0.4722222
NODE_6112_length_1028_cov_4.727664	461	541	0	9	80	0.1125000
NODE_6112_length_1028_cov_4.727664	461	541	2	51	80	0.6375000
NODE_6112_length_1028_cov_4.727664	461	541	4	20	80	0.2500000
NODE_6125_length_1027_cov_51.341595	399	479	0	80	80	1.0000000
NODE_6125_length_1027_cov_51.341595	452	532	0	80	80	1.0000000
NODE_6125_length_1027_cov_51.341595	528	608	0	26	80	0.3250000
NODE_6125_length_1027_cov_51.341595	528	608	4	23	80	0.2875000
NODE_6125_length_1027_cov_51.341595	528	608	6	30	80	0.3750000
NODE_6125_length_1027_cov_51.341595	528	608	10	1	80	0.0125000
NODE_6125_length_1027_cov_51.341595	581	661	4	17	80	0.2125000
NODE_6125_length_1027_cov_51.341595	581	661	6	32	80	0.4000000
NODE_6125_length_1027_cov_51.341595	581	661	10	31	80	0.3875000
NODE_6126_length_1027_cov_45.613147	347	427	0	44	80	0.5500000
NODE_6126_length_1027_cov_45.613147	347	427	2	36	80	0.4500000
NODE_6126_length_1027_cov_45.613147	400	480	0	55	80	0.6875000
NODE_6126_length_1027_cov_45.613147	400	480	4	25	80	0.3125000
NODE_6126_length_1027_cov_45.613147	476	556	4	9	80	0.1125000
NODE_6126_length_1027_cov_45.613147	476	556	6	19	80	0.2375000
NODE_6126_length_1027_cov_45.613147	476	556	8	42	80	0.5250000
NODE_6126_length_1027_cov_45.613147	476	556	12	10	80	0.1250000
NODE_6126_length_1027_cov_45.613147	529	609	4	10	80	0.1250000
NODE_6126_length_1027_cov_45.613147	529	609	6	28	80	0.3500000
NODE_6126_length_1027_cov_45.613147	529	609	8	32	80	0.4000000
NODE_6126_length_1027_cov_45.613147	529	609	12	10	80	0.1250000
NODE_6127_length_1027_cov_35.435345	431	511	6	13	80	0.1625000
NODE_6127_length_1027_cov_35.435345	431	511	8	21	80	0.2625000
NODE_6127_length_1027_cov_35.435345	431	511	9	1	80	0.0125000
NODE_6127_length_1027_cov_35.435345	431	511	10	19	80	0.2375000
NODE_6127_length_1027_cov_35.435345	431	511	11	12	80	0.1500000
NODE_6127_length_1027_cov_35.435345	431	511	12	14	80	0.1750000
NODE_6127_length_1027_cov_35.435345	484	564	6	2	80	0.0250000
NODE_6127_length_1027_cov_35.435345	484	564	10	41	80	0.5125000
NODE_6127_length_1027_cov_35.435345	484	564	11	23	80	0.2875000
NODE_6127_length_1027_cov_35.435345	484	564	12	14	80	0.1750000
NODE_6135_length_1026_cov_39.737864	374	454	1	39	80	0.4875000
NODE_6135_length_1026_cov_39.737864	374	454	2	41	80	0.5125000
NODE_6135_length_1026_cov_39.737864	427	509	0	28	82	0.3414634
NODE_6135_length_1026_cov_39.737864	427	509	1	54	82	0.6585366
NODE_6135_length_1026_cov_39.737864	505	585	0	80	80	1.0000000
NODE_6135_length_1026_cov_39.737864	558	638	0	80	80	1.0000000
NODE_6136_length_1026_cov_26.400216	423	503	0	80	80	1.0000000
NODE_6136_length_1026_cov_26.400216	476	556	0	80	80	1.0000000
NODE_6137_length_1026_cov_25.325782	477	557	0	80	80	1.0000000
NODE_6137_length_1026_cov_25.325782	530	610	0	80	80	1.0000000
NODE_6137_length_1026_cov_25.325782	606	686	0	80	80	1.0000000
NODE_6137_length_1026_cov_25.325782	659	739	0	80	80	1.0000000
NODE_6138_length_1026_cov_22.218986	408	488	0	5	80	0.0625000
NODE_6138_length_1026_cov_22.218986	408	488	2	6	80	0.0750000
NODE_6138_length_1026_cov_22.218986	408	488	4	69	80	0.8625000
NODE_6138_length_1026_cov_22.218986	461	541	0	58	80	0.7250000
NODE_6138_length_1026_cov_22.218986	461	541	2	6	80	0.0750000
NODE_6138_length_1026_cov_22.218986	461	541	4	16	80	0.2000000
NODE_6138_length_1026_cov_22.218986	537	617	0	80	80	1.0000000
NODE_6138_length_1026_cov_22.218986	590	670	0	80	80	1.0000000
NODE_6139_length_1026_cov_15.640777	450	530	0	80	80	1.0000000
NODE_6139_length_1026_cov_15.640777	503	583	0	80	80	1.0000000
NODE_6140_length_1026_cov_12.062567	165	245	0	70	80	0.8750000
NODE_6140_length_1026_cov_12.062567	165	245	2	2	80	0.0250000
NODE_6140_length_1026_cov_12.062567	165	245	4	8	80	0.1000000
NODE_6140_length_1026_cov_12.062567	218	298	0	17	80	0.2125000
NODE_6140_length_1026_cov_12.062567	218	298	2	2	80	0.0250000
NODE_6140_length_1026_cov_12.062567	218	298	4	61	80	0.7625000
NODE_6142_length_1026_cov_5.002157	335	415	0	80	80	1.0000000
NODE_6142_length_1026_cov_5.002157	388	468	0	80	80	1.0000000
NODE_6155_length_1025_cov_52.053996	366	446	0	24	80	0.3000000
NODE_6155_length_1025_cov_52.053996	366	446	2	38	80	0.4750000
NODE_6155_length_1025_cov_52.053996	366	446	4	18	80	0.2250000
NODE_6155_length_1025_cov_52.053996	419	499	2	16	80	0.2000000
NODE_6155_length_1025_cov_52.053996	419	499	3	7	80	0.0875000
NODE_6155_length_1025_cov_52.053996	419	499	4	57	80	0.7125000
NODE_6155_length_1025_cov_52.053996	495	575	1	32	80	0.4000000
NODE_6155_length_1025_cov_52.053996	495	575	2	30	80	0.3750000
NODE_6155_length_1025_cov_52.053996	495	575	3	4	80	0.0500000
NODE_6155_length_1025_cov_52.053996	495	575	4	14	80	0.1750000
NODE_6155_length_1025_cov_52.053996	548	628	2	13	80	0.1625000
NODE_6155_length_1025_cov_52.053996	548	628	4	67	80	0.8375000
NODE_6156_length_1025_cov_35.980562	318	375	0	43	57	0.7543859
NODE_6156_length_1025_cov_35.980562	318	375	1	14	57	0.2456140
NODE_6156_length_1025_cov_35.980562	348	428	0	34	80	0.4250000
NODE_6156_length_1025_cov_35.980562	348	428	2	18	80	0.2250000
NODE_6156_length_1025_cov_35.980562	348	428	4	8	80	0.1000000
NODE_6156_length_1025_cov_35.980562	348	428	6	10	80	0.1250000
NODE_6156_length_1025_cov_35.980562	348	428	8	10	80	0.1250000
NODE_6156_length_1025_cov_35.980562	425	482	8	57	57	1.0000000
NODE_6156_length_1025_cov_35.980562	455	521	0	2	66	0.0303030
NODE_6156_length_1025_cov_35.980562	455	521	2	15	66	0.2272727
NODE_6156_length_1025_cov_35.980562	455	521	4	2	66	0.0303030
NODE_6156_length_1025_cov_35.980562	455	521	6	7	66	0.1060606
NODE_6156_length_1025_cov_35.980562	455	521	8	40	66	0.6060606
NODE_6157_length_1025_cov_26.954644	607	687	0	52	80	0.6500000
NODE_6157_length_1025_cov_26.954644	607	687	2	28	80	0.3500000
NODE_6157_length_1025_cov_26.954644	660	740	0	80	80	1.0000000
NODE_6158_length_1025_cov_20.576674	428	508	4	11	80	0.1375000
NODE_6158_length_1025_cov_20.576674	428	508	6	27	80	0.3375000
NODE_6158_length_1025_cov_20.576674	428	508	8	23	80	0.2875000
NODE_6158_length_1025_cov_20.576674	428	508	10	19	80	0.2375000
NODE_6158_length_1025_cov_20.576674	481	561	0	15	80	0.1875000
NODE_6158_length_1025_cov_20.576674	481	561	2	36	80	0.4500000
NODE_6158_length_1025_cov_20.576674	481	561	4	13	80	0.1625000
NODE_6158_length_1025_cov_20.576674	481	561	6	16	80	0.2000000
NODE_6159_length_1025_cov_15.525918	415	495	0	2	80	0.0250000
NODE_6159_length_1025_cov_15.525918	415	495	2	61	80	0.7625000
NODE_6159_length_1025_cov_15.525918	415	495	4	17	80	0.2125000
NODE_6159_length_1025_cov_15.525918	468	548	0	55	80	0.6875000
NODE_6159_length_1025_cov_15.525918	468	548	2	25	80	0.3125000
NODE_6160_length_1025_cov_7.044276	240	320	0	80	80	1.0000000
NODE_6161_length_1025_cov_6.688985	334	414	0	80	80	1.0000000
NODE_6161_length_1025_cov_6.688985	387	467	0	68	80	0.8500000
NODE_6161_length_1025_cov_6.688985	387	467	2	12	80	0.1500000
NODE_6170_length_1024_cov_28.681081	264	344	0	80	80	1.0000000
NODE_6170_length_1024_cov_28.681081	317	397	0	80	80	1.0000000
NODE_6170_length_1024_cov_28.681081	393	477	0	84	84	1.0000000
NODE_6171_length_1024_cov_17.922162	324	404	2	51	80	0.6375000
NODE_6171_length_1024_cov_17.922162	324	404	4	29	80	0.3625000
NODE_6171_length_1024_cov_17.922162	377	457	2	56	80	0.7000000
NODE_6171_length_1024_cov_17.922162	377	457	4	24	80	0.3000000
NODE_6173_length_1024_cov_12.018378	368	448	0	9	80	0.1125000
NODE_6173_length_1024_cov_12.018378	368	448	2	71	80	0.8875000
NODE_6173_length_1024_cov_12.018378	421	501	0	23	80	0.2875000
NODE_6173_length_1024_cov_12.018378	421	501	2	57	80	0.7125000
NODE_6174_length_1024_cov_8.800000	517	597	2	59	80	0.7375000
NODE_6174_length_1024_cov_8.800000	517	597	4	21	80	0.2625000
NODE_6174_length_1024_cov_8.800000	570	650	2	63	80	0.7875000
NODE_6174_length_1024_cov_8.800000	570	650	4	17	80	0.2125000
NODE_6175_length_1024_cov_6.207568	318	398	0	80	80	1.0000000
NODE_6175_length_1024_cov_6.207568	371	451	0	80	80	1.0000000
NODE_6178_length_1024_cov_2.468108	274	324	0	50	50	1.0000000
NODE_6178_length_1024_cov_2.468108	274	322	0	48	48	1.0000000
NODE_6178_length_1024_cov_2.468108	274	324	0	50	50	1.0000000
NODE_6178_length_1024_cov_2.468108	274	323	0	49	49	1.0000000
NODE_6178_length_1024_cov_2.468108	274	322	0	48	48	1.0000000
NODE_6185_length_1023_cov_100.366883	441	521	4	46	80	0.5750000
NODE_6185_length_1023_cov_100.366883	441	521	8	34	80	0.4250000
NODE_6185_length_1023_cov_100.366883	494	574	0	39	80	0.4875000
NODE_6185_length_1023_cov_100.366883	494	574	4	41	80	0.5125000
NODE_6186_length_1023_cov_64.271645	349	429	0	4	80	0.0500000
NODE_6186_length_1023_cov_64.271645	349	429	4	76	80	0.9500000
NODE_6186_length_1023_cov_64.271645	402	482	0	57	80	0.7125000
NODE_6186_length_1023_cov_64.271645	402	482	4	23	80	0.2875000
NODE_6186_length_1023_cov_64.271645	478	558	0	41	80	0.5125000
NODE_6186_length_1023_cov_64.271645	478	558	2	21	80	0.2625000
NODE_6186_length_1023_cov_64.271645	478	558	4	18	80	0.2250000
NODE_6186_length_1023_cov_64.271645	531	611	2	9	80	0.1125000
NODE_6186_length_1023_cov_64.271645	531	611	4	29	80	0.3625000
NODE_6186_length_1023_cov_64.271645	531	611	8	14	80	0.1750000
NODE_6186_length_1023_cov_64.271645	531	611	10	28	80	0.3500000
NODE_6187_length_1023_cov_32.695887	318	398	2	80	80	1.0000000
NODE_6187_length_1023_cov_32.695887	371	451	0	43	80	0.5375000
NODE_6187_length_1023_cov_32.695887	371	451	2	37	80	0.4625000
NODE_6187_length_1023_cov_32.695887	447	527	0	80	80	1.0000000
NODE_6187_length_1023_cov_32.695887	500	580	0	80	80	1.0000000
NODE_6188_length_1023_cov_16.244589	601	681	0	27	80	0.3375000
NODE_6188_length_1023_cov_16.244589	601	681	2	53	80	0.6625000
NODE_6188_length_1023_cov_16.244589	654	734	0	12	80	0.1500000
NODE_6188_length_1023_cov_16.244589	654	734	2	68	80	0.8500000
NODE_6189_length_1023_cov_15.876623	371	451	0	80	80	1.0000000
NODE_6189_length_1023_cov_15.876623	424	504	0	80	80	1.0000000
NODE_6189_length_1023_cov_15.876623	500	580	0	80	80	1.0000000
NODE_6189_length_1023_cov_15.876623	553	633	0	80	80	1.0000000
NODE_6190_length_1023_cov_14.678571	555	635	0	46	80	0.5750000
NODE_6190_length_1023_cov_14.678571	555	635	2	34	80	0.4250000
NODE_6190_length_1023_cov_14.678571	608	688	0	11	80	0.1375000
NODE_6190_length_1023_cov_14.678571	608	688	2	69	80	0.8625000
NODE_6191_length_1023_cov_14.443723	406	486	0	80	80	1.0000000
NODE_6191_length_1023_cov_14.443723	459	539	0	80	80	1.0000000
NODE_6192_length_1023_cov_10.984848	590	670	0	80	80	1.0000000
NODE_6192_length_1023_cov_10.984848	643	723	0	80	80	1.0000000
NODE_6202_length_1022_cov_42.952329	555	636	0	19	81	0.2345679
NODE_6202_length_1022_cov_42.952329	555	636	2	62	81	0.7654321
NODE_6202_length_1022_cov_42.952329	609	689	0	39	80	0.4875000
NODE_6202_length_1022_cov_42.952329	609	689	2	41	80	0.5125000
NODE_6202_length_1022_cov_42.952329	685	765	0	80	80	1.0000000
NODE_6202_length_1022_cov_42.952329	738	818	0	80	80	1.0000000
NODE_6203_length_1022_cov_29.949079	510	590	0	80	80	1.0000000
NODE_6203_length_1022_cov_29.949079	563	643	0	80	80	1.0000000
NODE_6204_length_1022_cov_7.672806	461	541	0	80	80	1.0000000
NODE_6204_length_1022_cov_7.672806	514	594	0	80	80	1.0000000
NODE_6213_length_1021_cov_47.379610	341	421	6	26	80	0.3250000
NODE_6213_length_1021_cov_47.379610	341	421	8	54	80	0.6750000
NODE_6213_length_1021_cov_47.379610	394	474	2	18	80	0.2250000
NODE_6213_length_1021_cov_47.379610	394	474	4	10	80	0.1250000
NODE_6213_length_1021_cov_47.379610	394	474	6	51	80	0.6375000
NODE_6213_length_1021_cov_47.379610	394	474	8	1	80	0.0125000
NODE_6213_length_1021_cov_47.379610	470	550	0	35	80	0.4375000
NODE_6213_length_1021_cov_47.379610	470	550	2	10	80	0.1250000
NODE_6213_length_1021_cov_47.379610	470	550	4	13	80	0.1625000
NODE_6213_length_1021_cov_47.379610	470	550	7	1	80	0.0125000
NODE_6213_length_1021_cov_47.379610	470	550	8	21	80	0.2625000
NODE_6213_length_1021_cov_47.379610	523	603	4	34	80	0.4250000
NODE_6213_length_1021_cov_47.379610	523	603	7	1	80	0.0125000
NODE_6213_length_1021_cov_47.379610	523	603	8	45	80	0.5625000
NODE_6214_length_1021_cov_33.255965	588	668	1	5	80	0.0625000
NODE_6214_length_1021_cov_33.255965	588	668	2	28	80	0.3500000
NODE_6214_length_1021_cov_33.255965	588	668	3	47	80	0.5875000
NODE_6214_length_1021_cov_33.255965	641	721	1	58	80	0.7250000
NODE_6214_length_1021_cov_33.255965	641	721	3	22	80	0.2750000
NODE_6227_length_1020_cov_24.565689	485	565	0	80	80	1.0000000
NODE_6227_length_1020_cov_24.565689	538	618	0	80	80	1.0000000
NODE_6228_length_1020_cov_20.825190	395	475	2	21	80	0.2625000
NODE_6228_length_1020_cov_20.825190	395	475	4	59	80	0.7375000
NODE_6228_length_1020_cov_20.825190	448	528	0	45	80	0.5625000
NODE_6228_length_1020_cov_20.825190	448	528	2	29	80	0.3625000
NODE_6228_length_1020_cov_20.825190	448	528	4	6	80	0.0750000
NODE_6229_length_1020_cov_20.305103	285	365	0	80	80	1.0000000
NODE_6229_length_1020_cov_20.305103	338	418	0	80	80	1.0000000
NODE_6229_length_1020_cov_20.305103	414	494	0	80	80	1.0000000
NODE_6229_length_1020_cov_20.305103	467	548	0	81	81	1.0000000
NODE_6230_length_1020_cov_17.919653	408	488	2	77	80	0.9625000
NODE_6230_length_1020_cov_17.919653	408	488	4	3	80	0.0375000
NODE_6230_length_1020_cov_17.919653	461	541	0	27	80	0.3375000
NODE_6230_length_1020_cov_17.919653	461	541	2	53	80	0.6625000
NODE_6231_length_1020_cov_13.972856	436	516	0	80	80	1.0000000
NODE_6231_length_1020_cov_13.972856	489	569	0	80	80	1.0000000
NODE_6232_length_1020_cov_10.472313	407	487	2	75	80	0.9375000
NODE_6232_length_1020_cov_10.472313	407	487	4	5	80	0.0625000
NODE_6232_length_1020_cov_10.472313	460	540	2	52	80	0.6500000
NODE_6232_length_1020_cov_10.472313	460	540	4	28	80	0.3500000
NODE_6235_length_1020_cov_3.707926	821	901	0	80	80	1.0000000
NODE_6235_length_1020_cov_3.707926	874	954	0	80	80	1.0000000
NODE_6238_length_1020_cov_2.648208	0	70	0	70	70	1.0000000
NODE_6238_length_1020_cov_2.648208	43	88	0	45	45	1.0000000
NODE_6248_length_1019_cov_30.164130	476	556	4	80	80	1.0000000
NODE_6248_length_1019_cov_30.164130	529	609	0	22	80	0.2750000
NODE_6248_length_1019_cov_30.164130	529	609	2	27	80	0.3375000
NODE_6248_length_1019_cov_30.164130	529	609	4	31	80	0.3875000
NODE_6248_length_1019_cov_30.164130	605	685	0	80	80	1.0000000
NODE_6248_length_1019_cov_30.164130	658	738	0	80	80	1.0000000
NODE_6249_length_1019_cov_22.845652	343	423	2	80	80	1.0000000
NODE_6249_length_1019_cov_22.845652	396	476	0	45	80	0.5625000
NODE_6249_length_1019_cov_22.845652	396	476	1	1	80	0.0125000
NODE_6249_length_1019_cov_22.845652	396	476	2	34	80	0.4250000
NODE_6249_length_1019_cov_22.845652	472	552	0	14	80	0.1750000
NODE_6249_length_1019_cov_22.845652	472	552	2	38	80	0.4750000
NODE_6249_length_1019_cov_22.845652	472	552	4	28	80	0.3500000
NODE_6249_length_1019_cov_22.845652	525	605	0	40	80	0.5000000
NODE_6249_length_1019_cov_22.845652	525	605	2	8	80	0.1000000
NODE_6249_length_1019_cov_22.845652	525	605	4	32	80	0.4000000
NODE_6250_length_1019_cov_8.098913	523	601	0	20	78	0.2564103
NODE_6250_length_1019_cov_8.098913	523	601	2	58	78	0.7435898
NODE_6250_length_1019_cov_8.098913	574	654	2	73	80	0.9125000
NODE_6250_length_1019_cov_8.098913	574	654	4	7	80	0.0875000
NODE_6251_length_1019_cov_7.896739	423	503	0	80	80	1.0000000
NODE_6251_length_1019_cov_7.896739	476	556	0	80	80	1.0000000
NODE_6252_length_1019_cov_4.597826	625	696	3	10	71	0.1408451
NODE_6252_length_1019_cov_4.597826	625	696	5	11	71	0.1549296
NODE_6252_length_1019_cov_4.597826	625	696	7	11	71	0.1549296
NODE_6252_length_1019_cov_4.597826	625	696	10	39	71	0.5492958
NODE_6263_length_1019_cov_1.139130	89	165	0	36	76	0.4736842
NODE_6263_length_1019_cov_1.139130	89	165	2	2	76	0.0263158
NODE_6263_length_1019_cov_1.139130	89	165	4	1	76	0.0131579
NODE_6263_length_1019_cov_1.139130	89	165	6	37	76	0.4868421
NODE_6265_length_1018_cov_33.494015	212	292	12	6	80	0.0750000
NODE_6265_length_1018_cov_33.494015	212	292	14	1	80	0.0125000
NODE_6265_length_1018_cov_33.494015	212	292	16	2	80	0.0250000
NODE_6265_length_1018_cov_33.494015	212	292	20	1	80	0.0125000
NODE_6265_length_1018_cov_33.494015	212	292	22	4	80	0.0500000
NODE_6265_length_1018_cov_33.494015	212	292	24	6	80	0.0750000
NODE_6265_length_1018_cov_33.494015	212	292	26	1	80	0.0125000
NODE_6265_length_1018_cov_33.494015	212	292	28	3	80	0.0375000
NODE_6265_length_1018_cov_33.494015	212	292	30	22	80	0.2750000
NODE_6265_length_1018_cov_33.494015	212	292	32	34	80	0.4250000
NODE_6265_length_1018_cov_33.494015	265	345	2	3	80	0.0375000
NODE_6265_length_1018_cov_33.494015	265	345	4	6	80	0.0750000
NODE_6265_length_1018_cov_33.494015	265	345	8	37	80	0.4625000
NODE_6265_length_1018_cov_33.494015	265	345	11	2	80	0.0250000
NODE_6265_length_1018_cov_33.494015	265	345	12	11	80	0.1375000
NODE_6265_length_1018_cov_33.494015	265	345	14	1	80	0.0125000
NODE_6265_length_1018_cov_33.494015	265	345	16	2	80	0.0250000
NODE_6265_length_1018_cov_33.494015	265	345	20	1	80	0.0125000
NODE_6265_length_1018_cov_33.494015	265	345	22	4	80	0.0500000
NODE_6265_length_1018_cov_33.494015	265	345	24	6	80	0.0750000
NODE_6265_length_1018_cov_33.494015	265	345	26	1	80	0.0125000
NODE_6265_length_1018_cov_33.494015	265	345	28	3	80	0.0375000
NODE_6265_length_1018_cov_33.494015	265	345	32	3	80	0.0375000
NODE_6266_length_1018_cov_22.776931	372	452	0	80	80	1.0000000
NODE_6266_length_1018_cov_22.776931	425	505	0	80	80	1.0000000
NODE_6268_length_1018_cov_8.486398	404	484	0	80	80	1.0000000
NODE_6268_length_1018_cov_8.486398	457	537	0	80	80	1.0000000
NODE_6270_length_1018_cov_7.737758	357	437	2	74	80	0.9250000
NODE_6270_length_1018_cov_7.737758	357	437	4	6	80	0.0750000
NODE_6270_length_1018_cov_7.737758	410	490	0	40	80	0.5000000
NODE_6270_length_1018_cov_7.737758	410	490	2	40	80	0.5000000
NODE_6286_length_1017_cov_207.523965	0	41	10	13	41	0.3170732
NODE_6286_length_1017_cov_207.523965	0	41	12	7	41	0.1707317
NODE_6286_length_1017_cov_207.523965	0	41	14	5	41	0.1219512
NODE_6286_length_1017_cov_207.523965	0	41	16	3	41	0.0731707
NODE_6286_length_1017_cov_207.523965	0	41	18	1	41	0.0243902
NODE_6286_length_1017_cov_207.523965	0	41	20	11	41	0.2682927
NODE_6286_length_1017_cov_207.523965	0	41	21	1	41	0.0243902
NODE_6286_length_1017_cov_207.523965	14	94	12	6	80	0.0750000
NODE_6286_length_1017_cov_207.523965	14	94	14	5	80	0.0625000
NODE_6286_length_1017_cov_207.523965	14	94	16	3	80	0.0375000
NODE_6286_length_1017_cov_207.523965	14	94	18	1	80	0.0125000
NODE_6286_length_1017_cov_207.523965	14	94	20	11	80	0.1375000
NODE_6286_length_1017_cov_207.523965	14	94	21	1	80	0.0125000
NODE_6286_length_1017_cov_207.523965	14	94	23	5	80	0.0625000
NODE_6286_length_1017_cov_207.523965	14	94	25	13	80	0.1625000
NODE_6286_length_1017_cov_207.523965	14	94	26	5	80	0.0625000
NODE_6286_length_1017_cov_207.523965	14	94	28	12	80	0.1500000
NODE_6286_length_1017_cov_207.523965	14	94	30	18	80	0.2250000
NODE_6287_length_1017_cov_18.824619	490	570	0	80	80	1.0000000
NODE_6287_length_1017_cov_18.824619	543	623	0	80	80	1.0000000
NODE_6288_length_1017_cov_14.794118	428	508	0	80	80	1.0000000
NODE_6288_length_1017_cov_14.794118	481	561	0	80	80	1.0000000
NODE_6288_length_1017_cov_14.794118	557	637	0	80	80	1.0000000
NODE_6288_length_1017_cov_14.794118	610	690	0	80	80	1.0000000
NODE_6297_length_1016_cov_22.267176	577	657	0	3	80	0.0375000
NODE_6297_length_1016_cov_22.267176	577	657	2	77	80	0.9625000
NODE_6297_length_1016_cov_22.267176	630	710	0	44	80	0.5500000
NODE_6297_length_1016_cov_22.267176	630	710	2	36	80	0.4500000
NODE_6298_length_1016_cov_21.134133	625	705	0	8	80	0.1000000
NODE_6298_length_1016_cov_21.134133	625	705	2	72	80	0.9000000
NODE_6298_length_1016_cov_21.134133	678	758	0	59	80	0.7375000
NODE_6298_length_1016_cov_21.134133	678	758	2	21	80	0.2625000
NODE_6299_length_1016_cov_20.392585	504	584	0	80	80	1.0000000
NODE_6299_length_1016_cov_20.392585	557	637	0	80	80	1.0000000
NODE_6299_length_1016_cov_20.392585	633	713	0	10	80	0.1250000
NODE_6299_length_1016_cov_20.392585	633	713	2	70	80	0.8750000
NODE_6299_length_1016_cov_20.392585	686	766	0	37	80	0.4625000
NODE_6299_length_1016_cov_20.392585	686	766	2	43	80	0.5375000
NODE_6300_length_1016_cov_16.917121	524	604	0	15	80	0.1875000
NODE_6300_length_1016_cov_16.917121	524	604	2	1	80	0.0125000
NODE_6300_length_1016_cov_16.917121	524	604	3	8	80	0.1000000
NODE_6300_length_1016_cov_16.917121	524	604	4	56	80	0.7000000
NODE_6300_length_1016_cov_16.917121	577	657	2	30	80	0.3750000
NODE_6300_length_1016_cov_16.917121	577	657	4	50	80	0.6250000
NODE_6301_length_1016_cov_8.243184	438	518	2	80	80	1.0000000
NODE_6301_length_1016_cov_8.243184	491	571	0	21	80	0.2625000
NODE_6301_length_1016_cov_8.243184	491	571	2	59	80	0.7375000
NODE_6301_length_1016_cov_8.243184	567	647	0	80	80	1.0000000
NODE_6301_length_1016_cov_8.243184	620	700	0	80	80	1.0000000
NODE_6302_length_1016_cov_8.141767	166	256	2	23	90	0.2555556
NODE_6302_length_1016_cov_8.141767	166	256	6	37	90	0.4111111
NODE_6302_length_1016_cov_8.141767	166	256	8	6	90	0.0666667
NODE_6302_length_1016_cov_8.141767	166	256	10	13	90	0.1444445
NODE_6302_length_1016_cov_8.141767	166	256	12	11	90	0.1222222
NODE_6303_length_1016_cov_7.466739	576	656	0	31	80	0.3875000
NODE_6303_length_1016_cov_7.466739	576	656	2	49	80	0.6125000
NODE_6303_length_1016_cov_7.466739	629	709	0	80	80	1.0000000
NODE_6318_length_1015_cov_24.680131	459	539	0	77	80	0.9625000
NODE_6318_length_1015_cov_24.680131	459	539	2	3	80	0.0375000
NODE_6318_length_1015_cov_24.680131	512	592	0	24	80	0.3000000
NODE_6318_length_1015_cov_24.680131	512	592	2	56	80	0.7000000
NODE_6318_length_1015_cov_24.680131	588	668	2	9	80	0.1125000
NODE_6318_length_1015_cov_24.680131	588	668	6	30	80	0.3750000
NODE_6318_length_1015_cov_24.680131	588	668	8	41	80	0.5125000
NODE_6318_length_1015_cov_24.680131	641	721	2	48	80	0.6000000
NODE_6318_length_1015_cov_24.680131	641	721	6	17	80	0.2125000
NODE_6318_length_1015_cov_24.680131	641	721	8	15	80	0.1875000
NODE_6319_length_1015_cov_23.198690	407	487	0	80	80	1.0000000
NODE_6319_length_1015_cov_23.198690	460	540	0	80	80	1.0000000
NODE_6319_length_1015_cov_23.198690	536	616	0	61	80	0.7625000
NODE_6319_length_1015_cov_23.198690	536	616	4	19	80	0.2375000
NODE_6319_length_1015_cov_23.198690	589	669	0	8	80	0.1000000
NODE_6319_length_1015_cov_23.198690	589	669	4	72	80	0.9000000
NODE_6320_length_1015_cov_22.544760	490	570	2	13	80	0.1625000
NODE_6320_length_1015_cov_22.544760	490	570	4	67	80	0.8375000
NODE_6320_length_1015_cov_22.544760	543	623	0	37	80	0.4625000
NODE_6320_length_1015_cov_22.544760	543	623	2	29	80	0.3625000
NODE_6320_length_1015_cov_22.544760	543	623	4	14	80	0.1750000
NODE_6321_length_1015_cov_17.994541	510	590	0	50	80	0.6250000
NODE_6321_length_1015_cov_17.994541	510	590	2	4	80	0.0500000
NODE_6321_length_1015_cov_17.994541	510	590	4	13	80	0.1625000
NODE_6321_length_1015_cov_17.994541	510	590	6	13	80	0.1625000
NODE_6321_length_1015_cov_17.994541	563	643	2	1	80	0.0125000
NODE_6321_length_1015_cov_17.994541	563	643	4	31	80	0.3875000
NODE_6321_length_1015_cov_17.994541	563	643	6	48	80	0.6000000
NODE_6322_length_1015_cov_16.594978	437	517	0	7	80	0.0875000
NODE_6322_length_1015_cov_16.594978	437	517	2	18	80	0.2250000
NODE_6322_length_1015_cov_16.594978	437	517	8	24	80	0.3000000
NODE_6322_length_1015_cov_16.594978	437	517	10	31	80	0.3875000
NODE_6322_length_1015_cov_16.594978	490	570	0	2	80	0.0250000
NODE_6322_length_1015_cov_16.594978	490	570	2	11	80	0.1375000
NODE_6322_length_1015_cov_16.594978	490	570	8	17	80	0.2125000
NODE_6322_length_1015_cov_16.594978	490	570	10	50	80	0.6250000
NODE_6323_length_1015_cov_14.000000	505	585	0	80	80	1.0000000
NODE_6323_length_1015_cov_14.000000	558	638	0	80	80	1.0000000
NODE_6324_length_1015_cov_9.978166	345	425	0	80	80	1.0000000
NODE_6324_length_1015_cov_9.978166	398	478	0	80	80	1.0000000
NODE_6325_length_1015_cov_6.844978	393	473	6	7	80	0.0875000
NODE_6325_length_1015_cov_6.844978	393	473	7	33	80	0.4125000
NODE_6325_length_1015_cov_6.844978	393	473	8	20	80	0.2500000
NODE_6325_length_1015_cov_6.844978	393	473	9	20	80	0.2500000
NODE_6325_length_1015_cov_6.844978	446	526	0	4	80	0.0500000
NODE_6325_length_1015_cov_6.844978	446	526	2	24	80	0.3000000
NODE_6325_length_1015_cov_6.844978	446	526	6	32	80	0.4000000
NODE_6325_length_1015_cov_6.844978	446	526	8	10	80	0.1250000
NODE_6325_length_1015_cov_6.844978	446	526	9	10	80	0.1250000
NODE_6337_length_1014_cov_95.709290	259	335	0	76	76	1.0000000
NODE_6337_length_1014_cov_95.709290	310	390	0	67	80	0.8375000
NODE_6337_length_1014_cov_95.709290	310	390	2	13	80	0.1625000
NODE_6337_length_1014_cov_95.709290	386	466	2	68	80	0.8500000
NODE_6337_length_1014_cov_95.709290	386	466	4	12	80	0.1500000
NODE_6337_length_1014_cov_95.709290	439	519	2	20	80	0.2500000
NODE_6337_length_1014_cov_95.709290	439	519	4	60	80	0.7500000
NODE_6338_length_1014_cov_67.918033	182	262	0	5	80	0.0625000
NODE_6338_length_1014_cov_67.918033	182	262	2	3	80	0.0375000
NODE_6338_length_1014_cov_67.918033	182	262	3	34	80	0.4250000
NODE_6338_length_1014_cov_67.918033	182	262	4	38	80	0.4750000
NODE_6338_length_1014_cov_67.918033	235	315	0	18	80	0.2250000
NODE_6338_length_1014_cov_67.918033	235	315	3	36	80	0.4500000
NODE_6338_length_1014_cov_67.918033	235	315	4	26	80	0.3250000
NODE_6338_length_1014_cov_67.918033	311	391	0	80	80	1.0000000
NODE_6338_length_1014_cov_67.918033	364	444	0	80	80	1.0000000
NODE_6339_length_1014_cov_44.802186	418	498	0	80	80	1.0000000
NODE_6339_length_1014_cov_44.802186	471	551	0	80	80	1.0000000
NODE_6340_length_1014_cov_36.349727	369	449	0	80	80	1.0000000
NODE_6340_length_1014_cov_36.349727	422	502	0	80	80	1.0000000
NODE_6340_length_1014_cov_36.349727	498	578	0	80	80	1.0000000
NODE_6340_length_1014_cov_36.349727	551	631	0	80	80	1.0000000
NODE_6341_length_1014_cov_35.547541	363	441	0	2	78	0.0256410
NODE_6341_length_1014_cov_35.547541	363	441	2	29	78	0.3717949
NODE_6341_length_1014_cov_35.547541	363	441	4	47	78	0.6025641
NODE_6341_length_1014_cov_35.547541	416	494	0	18	78	0.2307692
NODE_6341_length_1014_cov_35.547541	416	494	2	18	78	0.2307692
NODE_6341_length_1014_cov_35.547541	416	494	4	42	78	0.5384616
NODE_6342_length_1014_cov_32.266667	428	508	0	22	80	0.2750000
NODE_6342_length_1014_cov_32.266667	428	508	2	58	80	0.7250000
NODE_6342_length_1014_cov_32.266667	481	561	0	46	80	0.5750000
NODE_6342_length_1014_cov_32.266667	481	561	2	34	80	0.4250000
NODE_6343_length_1014_cov_28.493989	480	560	0	80	80	1.0000000
NODE_6343_length_1014_cov_28.493989	533	613	0	80	80	1.0000000
NODE_6343_length_1014_cov_28.493989	609	689	0	80	80	1.0000000
NODE_6343_length_1014_cov_28.493989	662	742	0	80	80	1.0000000
NODE_6344_length_1014_cov_25.171585	500	580	2	80	80	1.0000000
NODE_6344_length_1014_cov_25.171585	553	633	0	15	80	0.1875000
NODE_6344_length_1014_cov_25.171585	553	633	2	65	80	0.8125000
NODE_6345_length_1014_cov_22.437158	534	614	0	80	80	1.0000000
NODE_6345_length_1014_cov_22.437158	587	667	0	80	80	1.0000000
NODE_6346_length_1014_cov_19.238251	379	459	0	2	80	0.0250000
NODE_6346_length_1014_cov_19.238251	379	459	2	78	80	0.9750000
NODE_6346_length_1014_cov_19.238251	432	512	0	18	80	0.2250000
NODE_6346_length_1014_cov_19.238251	432	512	2	62	80	0.7750000
NODE_6346_length_1014_cov_19.238251	508	585	0	10	77	0.1298701
NODE_6346_length_1014_cov_19.238251	508	585	2	67	77	0.8701299
NODE_6346_length_1014_cov_19.238251	558	638	0	25	80	0.3125000
NODE_6346_length_1014_cov_19.238251	558	638	2	55	80	0.6875000
NODE_6347_length_1014_cov_15.926776	594	674	0	49	80	0.6125000
NODE_6347_length_1014_cov_15.926776	594	674	4	31	80	0.3875000
NODE_6347_length_1014_cov_15.926776	647	727	4	80	80	1.0000000
NODE_6348_length_1014_cov_8.691803	285	365	0	80	80	1.0000000
NODE_6348_length_1014_cov_8.691803	338	418	0	80	80	1.0000000
NODE_6349_length_1014_cov_7.959563	531	611	0	80	80	1.0000000
NODE_6349_length_1014_cov_7.959563	584	664	0	46	80	0.5750000
NODE_6349_length_1014_cov_7.959563	584	664	2	34	80	0.4250000
NODE_6351_length_1014_cov_7.608743	298	378	2	80	80	1.0000000
NODE_6351_length_1014_cov_7.608743	351	431	2	78	80	0.9750000
NODE_6351_length_1014_cov_7.608743	351	431	4	2	80	0.0250000
NODE_6352_length_1014_cov_6.209836	321	401	0	80	80	1.0000000
NODE_6352_length_1014_cov_6.209836	374	454	0	80	80	1.0000000
NODE_6364_length_1013_cov_32.695842	423	503	0	20	80	0.2500000
NODE_6364_length_1013_cov_32.695842	423	503	2	60	80	0.7500000
NODE_6364_length_1013_cov_32.695842	476	556	0	30	80	0.3750000
NODE_6364_length_1013_cov_32.695842	476	556	2	50	80	0.6250000
NODE_6364_length_1013_cov_32.695842	552	632	0	80	80	1.0000000
NODE_6364_length_1013_cov_32.695842	605	685	0	80	80	1.0000000
NODE_6365_length_1013_cov_21.935449	424	503	0	79	79	1.0000000
NODE_6365_length_1013_cov_21.935449	476	556	0	80	80	1.0000000
NODE_6366_length_1013_cov_17.532823	440	520	0	80	80	1.0000000
NODE_6366_length_1013_cov_17.532823	493	573	0	80	80	1.0000000
NODE_6367_length_1013_cov_14.555799	478	558	0	80	80	1.0000000
NODE_6367_length_1013_cov_14.555799	531	611	0	80	80	1.0000000
NODE_6368_length_1013_cov_13.142232	476	556	0	18	80	0.2250000
NODE_6368_length_1013_cov_13.142232	476	556	2	62	80	0.7750000
NODE_6368_length_1013_cov_13.142232	529	609	0	23	80	0.2875000
NODE_6368_length_1013_cov_13.142232	529	609	2	57	80	0.7125000
NODE_6369_length_1013_cov_7.756018	538	618	0	80	80	1.0000000
NODE_6369_length_1013_cov_7.756018	591	671	0	80	80	1.0000000
NODE_6371_length_1013_cov_4.368709	550	630	0	29	80	0.3625000
NODE_6371_length_1013_cov_4.368709	550	630	2	51	80	0.6375000
NODE_6371_length_1013_cov_4.368709	603	683	0	21	80	0.2625000
NODE_6371_length_1013_cov_4.368709	603	683	2	59	80	0.7375000
NODE_6380_length_1012_cov_91.547645	378	458	0	47	80	0.5875000
NODE_6380_length_1012_cov_91.547645	378	458	2	33	80	0.4125000
NODE_6380_length_1012_cov_91.547645	431	511	0	10	80	0.1250000
NODE_6380_length_1012_cov_91.547645	431	511	2	70	80	0.8750000
NODE_6380_length_1012_cov_91.547645	507	587	0	3	80	0.0375000
NODE_6380_length_1012_cov_91.547645	507	587	2	27	80	0.3375000
NODE_6380_length_1012_cov_91.547645	507	587	4	7	80	0.0875000
NODE_6380_length_1012_cov_91.547645	507	587	6	20	80	0.2500000
NODE_6380_length_1012_cov_91.547645	507	587	10	23	80	0.2875000
NODE_6380_length_1012_cov_91.547645	560	640	0	12	80	0.1500000
NODE_6380_length_1012_cov_91.547645	560	640	4	3	80	0.0375000
NODE_6380_length_1012_cov_91.547645	560	640	6	11	80	0.1375000
NODE_6380_length_1012_cov_91.547645	560	640	8	22	80	0.2750000
NODE_6380_length_1012_cov_91.547645	560	640	10	32	80	0.4000000
NODE_6381_length_1012_cov_64.409639	345	425	0	34	80	0.4250000
NODE_6381_length_1012_cov_64.409639	345	425	2	46	80	0.5750000
NODE_6381_length_1012_cov_64.409639	398	478	0	7	80	0.0875000
NODE_6381_length_1012_cov_64.409639	398	478	2	73	80	0.9125000
NODE_6382_length_1012_cov_63.035049	438	518	2	7	80	0.0875000
NODE_6382_length_1012_cov_63.035049	438	518	4	4	80	0.0500000
NODE_6382_length_1012_cov_63.035049	438	518	6	42	80	0.5250000
NODE_6382_length_1012_cov_63.035049	438	518	8	27	80	0.3375000
NODE_6382_length_1012_cov_63.035049	491	571	2	24	80	0.3000000
NODE_6382_length_1012_cov_63.035049	491	571	4	40	80	0.5000000
NODE_6382_length_1012_cov_63.035049	491	571	8	16	80	0.2000000
NODE_6383_length_1012_cov_53.686747	276	356	1	7	80	0.0875000
NODE_6383_length_1012_cov_53.686747	276	356	3	73	80	0.9125000
NODE_6383_length_1012_cov_53.686747	329	409	0	42	80	0.5250000
NODE_6383_length_1012_cov_53.686747	329	409	1	18	80	0.2250000
NODE_6383_length_1012_cov_53.686747	329	409	3	20	80	0.2500000
NODE_6383_length_1012_cov_53.686747	405	485	0	28	80	0.3500000
NODE_6383_length_1012_cov_53.686747	405	485	2	52	80	0.6500000
NODE_6383_length_1012_cov_53.686747	458	538	0	26	80	0.3250000
NODE_6383_length_1012_cov_53.686747	458	538	2	54	80	0.6750000
NODE_6384_length_1012_cov_35.861993	453	533	0	80	80	1.0000000
NODE_6384_length_1012_cov_35.861993	506	581	0	75	75	1.0000000
NODE_6385_length_1012_cov_16.125958	510	590	0	80	80	1.0000000
NODE_6385_length_1012_cov_16.125958	563	643	0	80	80	1.0000000
NODE_6386_length_1012_cov_15.395400	501	581	0	13	80	0.1625000
NODE_6386_length_1012_cov_15.395400	501	581	2	67	80	0.8375000
NODE_6386_length_1012_cov_15.395400	554	634	0	66	80	0.8250000
NODE_6386_length_1012_cov_15.395400	554	634	2	14	80	0.1750000
NODE_6388_length_1012_cov_6.409639	528	608	0	80	80	1.0000000
NODE_6388_length_1012_cov_6.409639	581	661	0	80	80	1.0000000
NODE_6398_length_1011_cov_53.032895	515	595	8	30	80	0.3750000
NODE_6398_length_1011_cov_53.032895	515	595	10	50	80	0.6250000
NODE_6398_length_1011_cov_53.032895	568	648	0	26	80	0.3250000
NODE_6398_length_1011_cov_53.032895	568	648	4	25	80	0.3125000
NODE_6398_length_1011_cov_53.032895	568	648	6	2	80	0.0250000
NODE_6398_length_1011_cov_53.032895	568	648	8	22	80	0.2750000
NODE_6398_length_1011_cov_53.032895	568	648	10	5	80	0.0625000
NODE_6399_length_1011_cov_25.838816	366	446	0	80	80	1.0000000
NODE_6399_length_1011_cov_25.838816	419	499	0	80	80	1.0000000
NODE_6400_length_1011_cov_22.734649	426	506	0	80	80	1.0000000
NODE_6400_length_1011_cov_22.734649	479	559	0	80	80	1.0000000
NODE_6400_length_1011_cov_22.734649	555	636	0	81	81	1.0000000
NODE_6400_length_1011_cov_22.734649	609	689	0	80	80	1.0000000
NODE_6401_length_1011_cov_18.127193	389	469	0	80	80	1.0000000
NODE_6401_length_1011_cov_18.127193	442	520	0	78	78	1.0000000
NODE_6401_length_1011_cov_18.127193	516	596	0	80	80	1.0000000
NODE_6401_length_1011_cov_18.127193	569	649	0	80	80	1.0000000
NODE_6402_length_1011_cov_12.709430	309	389	0	16	80	0.2000000
NODE_6402_length_1011_cov_12.709430	309	389	2	64	80	0.8000000
NODE_6402_length_1011_cov_12.709430	362	442	2	80	80	1.0000000
NODE_6403_length_1011_cov_8.731360	441	521	0	80	80	1.0000000
NODE_6403_length_1011_cov_8.731360	494	574	0	80	80	1.0000000
NODE_6405_length_1011_cov_7.212719	219	299	0	6	80	0.0750000
NODE_6405_length_1011_cov_7.212719	219	299	2	15	80	0.1875000
NODE_6405_length_1011_cov_7.212719	219	299	4	59	80	0.7375000
NODE_6408_length_1011_cov_3.569079	173	253	0	58	80	0.7250000
NODE_6408_length_1011_cov_3.569079	173	253	1	22	80	0.2750000
NODE_6408_length_1011_cov_3.569079	226	306	0	5	80	0.0625000
NODE_6408_length_1011_cov_3.569079	226	306	1	71	80	0.8875000
NODE_6408_length_1011_cov_3.569079	226	306	3	4	80	0.0500000
NODE_6409_length_1011_cov_1.703947	779	851	2	1	72	0.0138889
NODE_6409_length_1011_cov_1.703947	779	851	6	1	72	0.0138889
NODE_6409_length_1011_cov_1.703947	779	851	8	5	72	0.0694444
NODE_6409_length_1011_cov_1.703947	779	851	10	1	72	0.0138889
NODE_6409_length_1011_cov_1.703947	779	851	12	1	72	0.0138889
NODE_6409_length_1011_cov_1.703947	779	851	14	11	72	0.1527778
NODE_6409_length_1011_cov_1.703947	779	851	16	17	72	0.2361111
NODE_6409_length_1011_cov_1.703947	779	851	18	8	72	0.1111111
NODE_6409_length_1011_cov_1.703947	779	851	20	1	72	0.0138889
NODE_6409_length_1011_cov_1.703947	779	851	22	10	72	0.1388889
NODE_6409_length_1011_cov_1.703947	779	851	23	1	72	0.0138889
NODE_6409_length_1011_cov_1.703947	779	851	24	14	72	0.1944444
NODE_6409_length_1011_cov_1.703947	779	851	26	1	72	0.0138889
NODE_6416_length_1010_cov_51.841932	335	415	0	80	80	1.0000000
NODE_6416_length_1010_cov_51.841932	388	468	0	80	80	1.0000000
NODE_6417_length_1010_cov_35.860593	576	656	8	47	80	0.5875000
NODE_6417_length_1010_cov_35.860593	576	656	10	33	80	0.4125000
NODE_6417_length_1010_cov_35.860593	629	709	4	4	80	0.0500000
NODE_6417_length_1010_cov_35.860593	629	709	6	20	80	0.2500000
NODE_6417_length_1010_cov_35.860593	629	709	8	26	80	0.3250000
NODE_6417_length_1010_cov_35.860593	629	709	10	29	80	0.3625000
NODE_6417_length_1010_cov_35.860593	629	709	12	1	80	0.0125000
NODE_6418_length_1010_cov_30.043908	509	589	0	44	80	0.5500000
NODE_6418_length_1010_cov_30.043908	509	589	2	13	80	0.1625000
NODE_6418_length_1010_cov_30.043908	509	589	4	23	80	0.2875000
NODE_6418_length_1010_cov_30.043908	562	642	2	20	80	0.2500000
NODE_6418_length_1010_cov_30.043908	562	642	4	60	80	0.7500000
NODE_6418_length_1010_cov_30.043908	638	718	0	14	80	0.1750000
NODE_6418_length_1010_cov_30.043908	638	718	2	66	80	0.8250000
NODE_6418_length_1010_cov_30.043908	691	771	0	16	80	0.2000000
NODE_6418_length_1010_cov_30.043908	691	771	2	64	80	0.8000000
NODE_6420_length_1010_cov_15.156970	364	444	0	80	80	1.0000000
NODE_6420_length_1010_cov_15.156970	417	497	0	80	80	1.0000000
NODE_6421_length_1010_cov_13.546652	385	465	0	64	80	0.8000000
NODE_6421_length_1010_cov_13.546652	385	465	2	16	80	0.2000000
NODE_6421_length_1010_cov_13.546652	438	518	0	80	80	1.0000000
NODE_6422_length_1010_cov_13.317234	480	560	0	80	80	1.0000000
NODE_6422_length_1010_cov_13.317234	533	613	0	80	80	1.0000000
NODE_6423_length_1010_cov_12.900110	427	507	0	80	80	1.0000000
NODE_6423_length_1010_cov_12.900110	480	560	0	80	80	1.0000000
NODE_6424_length_1010_cov_11.423710	631	711	0	15	80	0.1875000
NODE_6424_length_1010_cov_11.423710	631	711	2	65	80	0.8125000
NODE_6424_length_1010_cov_11.423710	684	764	0	68	80	0.8500000
NODE_6424_length_1010_cov_11.423710	684	764	2	12	80	0.1500000
NODE_6425_length_1010_cov_11.256861	492	572	0	40	80	0.5000000
NODE_6425_length_1010_cov_11.256861	492	572	4	40	80	0.5000000
NODE_6425_length_1010_cov_11.256861	545	625	0	6	80	0.0750000
NODE_6425_length_1010_cov_11.256861	545	625	4	74	80	0.9250000
NODE_6426_length_1010_cov_11.000000	455	535	0	50	80	0.6250000
NODE_6426_length_1010_cov_11.000000	455	535	2	30	80	0.3750000
NODE_6426_length_1010_cov_11.000000	508	588	0	80	80	1.0000000
NODE_6428_length_1010_cov_4.990121	476	556	0	8	80	0.1000000
NODE_6428_length_1010_cov_4.990121	476	556	2	72	80	0.9000000
NODE_6428_length_1010_cov_4.990121	529	609	0	31	80	0.3875000
NODE_6428_length_1010_cov_4.990121	529	609	2	23	80	0.2875000
NODE_6428_length_1010_cov_4.990121	529	609	4	26	80	0.3250000
NODE_6430_length_1010_cov_4.892426	476	556	0	80	80	1.0000000
NODE_6430_length_1010_cov_4.892426	529	609	0	80	80	1.0000000
NODE_6431_length_1010_cov_3.624588	157	196	2	39	39	1.0000000
NODE_6435_length_1010_cov_1.440176	1	58	0	57	57	1.0000000
NODE_6436_length_1009_cov_44.626374	288	362	0	74	74	1.0000000
NODE_6436_length_1009_cov_44.626374	335	415	0	80	80	1.0000000
NODE_6436_length_1009_cov_44.626374	411	491	0	53	80	0.6625000
NODE_6436_length_1009_cov_44.626374	411	491	2	27	80	0.3375000
NODE_6436_length_1009_cov_44.626374	464	544	0	4	80	0.0500000
NODE_6436_length_1009_cov_44.626374	464	544	2	76	80	0.9500000
NODE_6437_length_1009_cov_31.828571	412	492	0	32	80	0.4000000
NODE_6437_length_1009_cov_31.828571	412	492	2	48	80	0.6000000
NODE_6437_length_1009_cov_31.828571	465	545	0	36	80	0.4500000
NODE_6437_length_1009_cov_31.828571	465	545	2	44	80	0.5500000
NODE_6438_length_1009_cov_28.539560	571	651	0	80	80	1.0000000
NODE_6438_length_1009_cov_28.539560	624	704	0	80	80	1.0000000
NODE_6439_length_1009_cov_20.281319	577	657	3	2	80	0.0250000
NODE_6439_length_1009_cov_20.281319	577	657	4	22	80	0.2750000
NODE_6439_length_1009_cov_20.281319	577	657	6	35	80	0.4375000
NODE_6439_length_1009_cov_20.281319	577	657	10	6	80	0.0750000
NODE_6439_length_1009_cov_20.281319	577	657	11	7	80	0.0875000
NODE_6439_length_1009_cov_20.281319	577	657	12	8	80	0.1000000
NODE_6439_length_1009_cov_20.281319	630	710	6	6	80	0.0750000
NODE_6439_length_1009_cov_20.281319	630	710	9	6	80	0.0750000
NODE_6439_length_1009_cov_20.281319	630	710	10	13	80	0.1625000
NODE_6439_length_1009_cov_20.281319	630	710	11	7	80	0.0875000
NODE_6439_length_1009_cov_20.281319	630	710	12	48	80	0.6000000
NODE_6440_length_1009_cov_18.649451	430	510	0	3	80	0.0375000
NODE_6440_length_1009_cov_18.649451	430	510	2	77	80	0.9625000
NODE_6440_length_1009_cov_18.649451	483	563	0	32	80	0.4000000
NODE_6440_length_1009_cov_18.649451	483	563	2	48	80	0.6000000
NODE_6442_length_1009_cov_3.767033	647	727	0	80	80	1.0000000
NODE_6442_length_1009_cov_3.767033	700	780	0	80	80	1.0000000
NODE_6443_length_1009_cov_2.903297	36	63	0	27	27	1.0000000
NODE_6451_length_1008_cov_44.825083	399	479	1	53	80	0.6625000
NODE_6451_length_1008_cov_44.825083	399	479	2	27	80	0.3375000
NODE_6451_length_1008_cov_44.825083	452	532	1	2	80	0.0250000
NODE_6451_length_1008_cov_44.825083	452	532	2	78	80	0.9750000
NODE_6452_length_1008_cov_41.030803	280	360	0	80	80	1.0000000
NODE_6452_length_1008_cov_41.030803	333	413	0	80	80	1.0000000
NODE_6452_length_1008_cov_41.030803	409	489	0	29	80	0.3625000
NODE_6452_length_1008_cov_41.030803	409	489	2	51	80	0.6375000
NODE_6452_length_1008_cov_41.030803	462	542	0	28	80	0.3500000
NODE_6452_length_1008_cov_41.030803	462	542	2	52	80	0.6500000
NODE_6453_length_1008_cov_39.377338	311	391	0	30	80	0.3750000
NODE_6453_length_1008_cov_39.377338	311	391	2	50	80	0.6250000
NODE_6453_length_1008_cov_39.377338	364	444	0	2	80	0.0250000
NODE_6453_length_1008_cov_39.377338	364	444	2	78	80	0.9750000
NODE_6453_length_1008_cov_39.377338	440	520	0	78	80	0.9750000
NODE_6453_length_1008_cov_39.377338	440	520	2	2	80	0.0250000
NODE_6453_length_1008_cov_39.377338	493	573	0	80	80	1.0000000
NODE_6454_length_1008_cov_27.836084	405	485	0	1	80	0.0125000
NODE_6454_length_1008_cov_27.836084	405	485	2	79	80	0.9875000
NODE_6454_length_1008_cov_27.836084	458	538	0	54	80	0.6750000
NODE_6454_length_1008_cov_27.836084	458	538	2	26	80	0.3250000
NODE_6454_length_1008_cov_27.836084	534	614	0	80	80	1.0000000
NODE_6454_length_1008_cov_27.836084	587	667	0	80	80	1.0000000
NODE_6455_length_1008_cov_24.741474	485	565	0	80	80	1.0000000
NODE_6455_length_1008_cov_24.741474	538	618	0	80	80	1.0000000
NODE_6456_length_1008_cov_20.278328	401	481	2	9	80	0.1125000
NODE_6456_length_1008_cov_20.278328	401	481	4	10	80	0.1250000
NODE_6456_length_1008_cov_20.278328	401	481	6	61	80	0.7625000
NODE_6456_length_1008_cov_20.278328	454	534	0	11	80	0.1375000
NODE_6456_length_1008_cov_20.278328	454	534	2	24	80	0.3000000
NODE_6456_length_1008_cov_20.278328	454	534	4	1	80	0.0125000
NODE_6456_length_1008_cov_20.278328	454	534	6	44	80	0.5500000
NODE_6457_length_1008_cov_6.071507	460	540	2	71	80	0.8875000
NODE_6457_length_1008_cov_6.071507	460	540	4	1	80	0.0125000
NODE_6457_length_1008_cov_6.071507	460	540	6	8	80	0.1000000
NODE_6457_length_1008_cov_6.071507	513	593	2	18	80	0.2250000
NODE_6457_length_1008_cov_6.071507	513	593	4	54	80	0.6750000
NODE_6457_length_1008_cov_6.071507	513	593	6	8	80	0.1000000
NODE_6466_length_1008_cov_1.798680	0	64	0	34	64	0.5312500
NODE_6466_length_1008_cov_1.798680	0	64	2	14	64	0.2187500
NODE_6466_length_1008_cov_1.798680	0	64	4	16	64	0.2500000
NODE_6466_length_1008_cov_1.798680	37	104	2	12	67	0.1791045
NODE_6466_length_1008_cov_1.798680	37	104	4	55	67	0.8208955
NODE_6473_length_1007_cov_27.011013	294	371	0	15	77	0.1948052
NODE_6473_length_1007_cov_27.011013	294	371	4	62	77	0.8051948
NODE_6473_length_1007_cov_27.011013	347	424	0	34	77	0.4415585
NODE_6473_length_1007_cov_27.011013	347	424	4	43	77	0.5584416
NODE_6474_length_1007_cov_24.668502	369	449	2	80	80	1.0000000
NODE_6474_length_1007_cov_24.668502	422	502	0	29	80	0.3625000
NODE_6474_length_1007_cov_24.668502	422	502	2	51	80	0.6375000
NODE_6474_length_1007_cov_24.668502	498	578	0	80	80	1.0000000
NODE_6474_length_1007_cov_24.668502	551	631	0	80	80	1.0000000
NODE_6475_length_1007_cov_21.729075	454	534	4	15	80	0.1875000
NODE_6475_length_1007_cov_21.729075	454	534	8	18	80	0.2250000
NODE_6475_length_1007_cov_21.729075	454	534	10	11	80	0.1375000
NODE_6475_length_1007_cov_21.729075	454	534	12	36	80	0.4500000
NODE_6475_length_1007_cov_21.729075	507	587	0	29	80	0.3625000
NODE_6475_length_1007_cov_21.729075	507	587	4	7	80	0.0875000
NODE_6475_length_1007_cov_21.729075	507	587	8	16	80	0.2000000
NODE_6475_length_1007_cov_21.729075	507	587	10	12	80	0.1500000
NODE_6475_length_1007_cov_21.729075	507	587	12	16	80	0.2000000
NODE_6475_length_1007_cov_21.729075	583	663	0	7	80	0.0875000
NODE_6475_length_1007_cov_21.729075	583	663	2	73	80	0.9125000
NODE_6475_length_1007_cov_21.729075	636	716	0	25	80	0.3125000
NODE_6475_length_1007_cov_21.729075	636	716	2	55	80	0.6875000
NODE_6476_length_1007_cov_14.515419	400	480	4	23	80	0.2875000
NODE_6476_length_1007_cov_14.515419	400	480	6	6	80	0.0750000
NODE_6476_length_1007_cov_14.515419	400	480	8	51	80	0.6375000
NODE_6476_length_1007_cov_14.515419	453	533	2	4	80	0.0500000
NODE_6476_length_1007_cov_14.515419	453	533	4	23	80	0.2875000
NODE_6476_length_1007_cov_14.515419	453	533	6	20	80	0.2500000
NODE_6476_length_1007_cov_14.515419	453	533	8	33	80	0.4125000
NODE_6477_length_1007_cov_13.685022	376	456	0	80	80	1.0000000
NODE_6477_length_1007_cov_13.685022	429	509	0	80	80	1.0000000
NODE_6478_length_1007_cov_9.189427	438	518	0	80	80	1.0000000
NODE_6478_length_1007_cov_9.189427	491	571	0	32	80	0.4000000
NODE_6478_length_1007_cov_9.189427	491	571	2	48	80	0.6000000
NODE_6491_length_1006_cov_59.773980	379	459	0	15	80	0.1875000
NODE_6491_length_1006_cov_59.773980	379	459	2	65	80	0.8125000
NODE_6491_length_1006_cov_59.773980	432	512	0	36	80	0.4500000
NODE_6491_length_1006_cov_59.773980	432	512	2	44	80	0.5500000
NODE_6491_length_1006_cov_59.773980	508	588	0	80	80	1.0000000
NODE_6491_length_1006_cov_59.773980	561	641	0	80	80	1.0000000
NODE_6492_length_1006_cov_34.762955	482	562	0	74	80	0.9250000
NODE_6492_length_1006_cov_34.762955	482	562	2	6	80	0.0750000
NODE_6492_length_1006_cov_34.762955	535	615	0	80	80	1.0000000
NODE_6493_length_1006_cov_21.776185	516	596	0	80	80	1.0000000
NODE_6493_length_1006_cov_21.776185	569	649	0	80	80	1.0000000
NODE_6494_length_1006_cov_19.690187	371	451	0	80	80	1.0000000
NODE_6494_length_1006_cov_19.690187	424	504	0	80	80	1.0000000
NODE_6495_length_1006_cov_19.299890	495	575	0	26	80	0.3250000
NODE_6495_length_1006_cov_19.299890	495	575	2	54	80	0.6750000
NODE_6495_length_1006_cov_19.299890	548	628	0	79	80	0.9875000
NODE_6495_length_1006_cov_19.299890	548	628	2	1	80	0.0125000
NODE_6496_length_1006_cov_13.187431	245	325	0	80	80	1.0000000
NODE_6496_length_1006_cov_13.187431	298	378	0	80	80	1.0000000
NODE_6497_length_1006_cov_12.862183	383	463	0	80	80	1.0000000
NODE_6497_length_1006_cov_12.862183	436	516	0	80	80	1.0000000
NODE_6498_length_1006_cov_10.986770	762	842	0	75	80	0.9375000
NODE_6498_length_1006_cov_10.986770	762	842	2	5	80	0.0625000
NODE_6498_length_1006_cov_10.986770	815	895	0	80	80	1.0000000
NODE_6499_length_1006_cov_8.633958	314	394	0	41	80	0.5125000
NODE_6499_length_1006_cov_8.633958	314	394	2	8	80	0.1000000
NODE_6499_length_1006_cov_8.633958	314	394	4	7	80	0.0875000
NODE_6499_length_1006_cov_8.633958	314	394	5	24	80	0.3000000
NODE_6499_length_1006_cov_8.633958	367	447	4	16	80	0.2000000
NODE_6499_length_1006_cov_8.633958	367	447	5	37	80	0.4625000
NODE_6499_length_1006_cov_8.633958	367	447	6	27	80	0.3375000
NODE_6515_length_1005_cov_80.271523	509	589	12	2	80	0.0250000
NODE_6515_length_1005_cov_80.271523	509	589	13	10	80	0.1250000
NODE_6515_length_1005_cov_80.271523	509	589	14	9	80	0.1125000
NODE_6515_length_1005_cov_80.271523	509	589	15	13	80	0.1625000
NODE_6515_length_1005_cov_80.271523	509	589	16	46	80	0.5750000
NODE_6515_length_1005_cov_80.271523	562	642	4	4	80	0.0500000
NODE_6515_length_1005_cov_80.271523	562	642	5	6	80	0.0750000
NODE_6515_length_1005_cov_80.271523	562	642	7	30	80	0.3750000
NODE_6515_length_1005_cov_80.271523	562	642	9	7	80	0.0875000
NODE_6515_length_1005_cov_80.271523	562	642	13	16	80	0.2000000
NODE_6515_length_1005_cov_80.271523	562	642	14	4	80	0.0500000
NODE_6515_length_1005_cov_80.271523	562	642	15	13	80	0.1625000
NODE_6516_length_1005_cov_45.008830	357	437	0	80	80	1.0000000
NODE_6516_length_1005_cov_45.008830	410	490	0	80	80	1.0000000
NODE_6517_length_1005_cov_36.636865	567	647	0	24	80	0.3000000
NODE_6517_length_1005_cov_36.636865	567	647	2	12	80	0.1500000
NODE_6517_length_1005_cov_36.636865	567	647	4	44	80	0.5500000
NODE_6517_length_1005_cov_36.636865	620	700	0	19	80	0.2375000
NODE_6517_length_1005_cov_36.636865	620	700	2	15	80	0.1875000
NODE_6517_length_1005_cov_36.636865	620	700	4	46	80	0.5750000
NODE_6518_length_1005_cov_21.222958	389	409	4	20	20	1.0000000
NODE_6518_length_1005_cov_21.222958	451	519	3	5	68	0.0735294
NODE_6518_length_1005_cov_21.222958	451	519	4	8	68	0.1176471
NODE_6518_length_1005_cov_21.222958	451	519	6	55	68	0.8088235
NODE_6518_length_1005_cov_21.222958	515	595	0	66	80	0.8250000
NODE_6518_length_1005_cov_21.222958	515	595	2	1	80	0.0125000
NODE_6518_length_1005_cov_21.222958	515	595	3	13	80	0.1625000
NODE_6518_length_1005_cov_21.222958	568	648	0	65	80	0.8125000
NODE_6518_length_1005_cov_21.222958	568	648	2	15	80	0.1875000
NODE_6520_length_1005_cov_14.278146	480	560	0	80	80	1.0000000
NODE_6520_length_1005_cov_14.278146	533	613	0	80	80	1.0000000
NODE_6521_length_1005_cov_13.215232	511	591	0	80	80	1.0000000
NODE_6521_length_1005_cov_13.215232	564	644	0	80	80	1.0000000
NODE_6523_length_1005_cov_5.579470	534	614	0	20	80	0.2500000
NODE_6523_length_1005_cov_5.579470	534	614	2	60	80	0.7500000
NODE_6523_length_1005_cov_5.579470	587	667	0	11	80	0.1375000
NODE_6523_length_1005_cov_5.579470	587	667	2	69	80	0.8625000
NODE_6536_length_1004_cov_45.470718	343	423	0	80	80	1.0000000
NODE_6536_length_1004_cov_45.470718	396	476	0	80	80	1.0000000
NODE_6536_length_1004_cov_45.470718	472	552	0	80	80	1.0000000
NODE_6536_length_1004_cov_45.470718	525	605	0	80	80	1.0000000
NODE_6537_length_1004_cov_34.565746	419	499	2	40	80	0.5000000
NODE_6537_length_1004_cov_34.565746	419	499	6	40	80	0.5000000
NODE_6537_length_1004_cov_34.565746	472	552	4	9	80	0.1125000
NODE_6537_length_1004_cov_34.565746	472	552	6	71	80	0.8875000
NODE_6538_length_1004_cov_28.710497	385	465	0	28	80	0.3500000
NODE_6538_length_1004_cov_28.710497	385	465	2	52	80	0.6500000
NODE_6538_length_1004_cov_28.710497	438	518	0	41	80	0.5125000
NODE_6538_length_1004_cov_28.710497	438	518	2	39	80	0.4875000
NODE_6538_length_1004_cov_28.710497	514	594	0	38	80	0.4750000
NODE_6538_length_1004_cov_28.710497	514	594	2	42	80	0.5250000
NODE_6538_length_1004_cov_28.710497	567	647	2	80	80	1.0000000
NODE_6539_length_1004_cov_12.745856	432	512	0	80	80	1.0000000
NODE_6539_length_1004_cov_12.745856	485	565	0	80	80	1.0000000
NODE_6550_length_1003_cov_47.014381	383	463	2	57	80	0.7125000
NODE_6550_length_1003_cov_47.014381	383	463	4	23	80	0.2875000
NODE_6550_length_1003_cov_47.014381	436	516	0	7	80	0.0875000
NODE_6550_length_1003_cov_47.014381	436	516	2	59	80	0.7375000
NODE_6550_length_1003_cov_47.014381	436	516	4	14	80	0.1750000
NODE_6550_length_1003_cov_47.014381	512	592	0	80	80	1.0000000
NODE_6550_length_1003_cov_47.014381	565	645	0	35	80	0.4375000
NODE_6550_length_1003_cov_47.014381	565	645	2	45	80	0.5625000
NODE_6551_length_1003_cov_35.329646	372	452	0	16	80	0.2000000
NODE_6551_length_1003_cov_35.329646	372	452	2	25	80	0.3125000
NODE_6551_length_1003_cov_35.329646	372	452	4	39	80	0.4875000
NODE_6551_length_1003_cov_35.329646	425	505	0	31	80	0.3875000
NODE_6551_length_1003_cov_35.329646	425	505	2	29	80	0.3625000
NODE_6551_length_1003_cov_35.329646	425	505	4	20	80	0.2500000
NODE_6552_length_1003_cov_32.721239	357	437	0	54	80	0.6750000
NODE_6552_length_1003_cov_32.721239	357	437	2	26	80	0.3250000
NODE_6552_length_1003_cov_32.721239	410	490	0	1	80	0.0125000
NODE_6552_length_1003_cov_32.721239	410	490	2	79	80	0.9875000
NODE_6553_length_1003_cov_23.758850	467	547	0	2	80	0.0250000
NODE_6553_length_1003_cov_23.758850	467	547	2	78	80	0.9750000
NODE_6553_length_1003_cov_23.758850	520	600	0	55	80	0.6875000
NODE_6553_length_1003_cov_23.758850	520	600	2	25	80	0.3125000
NODE_6554_length_1003_cov_19.939159	240	320	0	80	80	1.0000000
NODE_6554_length_1003_cov_19.939159	293	373	0	80	80	1.0000000
NODE_6555_length_1003_cov_16.618363	524	604	0	38	80	0.4750000
NODE_6555_length_1003_cov_16.618363	524	604	2	42	80	0.5250000
NODE_6555_length_1003_cov_16.618363	577	657	2	80	80	1.0000000
NODE_6555_length_1003_cov_16.618363	653	733	0	55	80	0.6875000
NODE_6555_length_1003_cov_16.618363	653	733	2	25	80	0.3125000
NODE_6555_length_1003_cov_16.618363	706	786	0	80	80	1.0000000
NODE_6556_length_1003_cov_13.863938	537	617	0	80	80	1.0000000
NODE_6556_length_1003_cov_13.863938	590	670	0	80	80	1.0000000
NODE_6557_length_1003_cov_12.363938	529	609	0	41	80	0.5125000
NODE_6557_length_1003_cov_12.363938	529	609	2	25	80	0.3125000
NODE_6557_length_1003_cov_12.363938	529	609	4	14	80	0.1750000
NODE_6557_length_1003_cov_12.363938	582	662	0	6	80	0.0750000
NODE_6557_length_1003_cov_12.363938	582	662	2	7	80	0.0875000
NODE_6557_length_1003_cov_12.363938	582	662	4	67	80	0.8375000
NODE_6567_length_1002_cov_65.513843	387	467	2	80	80	1.0000000
NODE_6567_length_1002_cov_65.513843	440	520	0	50	80	0.6250000
NODE_6567_length_1002_cov_65.513843	440	520	1	1	80	0.0125000
NODE_6567_length_1002_cov_65.513843	440	520	2	29	80	0.3625000
NODE_6567_length_1002_cov_65.513843	516	596	0	64	80	0.8000000
NODE_6567_length_1002_cov_65.513843	516	596	2	11	80	0.1375000
NODE_6567_length_1002_cov_65.513843	516	596	4	3	80	0.0375000
NODE_6567_length_1002_cov_65.513843	516	596	8	2	80	0.0250000
NODE_6567_length_1002_cov_65.513843	569	649	0	11	80	0.1375000
NODE_6567_length_1002_cov_65.513843	569	649	2	11	80	0.1375000
NODE_6567_length_1002_cov_65.513843	569	649	4	3	80	0.0375000
NODE_6567_length_1002_cov_65.513843	569	649	8	55	80	0.6875000
NODE_6568_length_1002_cov_41.995570	408	488	0	2	80	0.0250000
NODE_6568_length_1002_cov_41.995570	408	488	2	78	80	0.9750000
NODE_6568_length_1002_cov_41.995570	461	541	0	46	80	0.5750000
NODE_6568_length_1002_cov_41.995570	461	541	2	34	80	0.4250000
NODE_6569_length_1002_cov_19.966777	401	481	0	48	80	0.6000000
NODE_6569_length_1002_cov_19.966777	401	481	2	32	80	0.4000000
NODE_6569_length_1002_cov_19.966777	454	534	0	11	80	0.1375000
NODE_6569_length_1002_cov_19.966777	454	534	2	69	80	0.8625000
NODE_6570_length_1002_cov_19.539313	334	414	0	80	80	1.0000000
NODE_6570_length_1002_cov_19.539313	335	414	0	79	79	1.0000000
NODE_6570_length_1002_cov_19.539313	387	467	0	78	80	0.9750000
NODE_6570_length_1002_cov_19.539313	387	467	1	2	80	0.0250000
NODE_6570_length_1002_cov_19.539313	387	467	0	78	80	0.9750000
NODE_6570_length_1002_cov_19.539313	387	467	1	2	80	0.0250000
NODE_6570_length_1002_cov_19.539313	396	467	0	69	71	0.9718310
NODE_6570_length_1002_cov_19.539313	396	467	1	2	71	0.0281690
NODE_6570_length_1002_cov_19.539313	463	543	0	2	80	0.0250000
NODE_6570_length_1002_cov_19.539313	463	543	1	78	80	0.9750000
NODE_6570_length_1002_cov_19.539313	516	596	1	80	80	1.0000000
NODE_6571_length_1002_cov_17.780731	631	711	0	8	80	0.1000000
NODE_6571_length_1002_cov_17.780731	631	711	2	19	80	0.2375000
NODE_6571_length_1002_cov_17.780731	631	711	4	53	80	0.6625000
NODE_6571_length_1002_cov_17.780731	684	764	0	21	80	0.2625000
NODE_6571_length_1002_cov_17.780731	684	764	2	5	80	0.0625000
NODE_6571_length_1002_cov_17.780731	684	764	4	54	80	0.6750000
NODE_6572_length_1002_cov_17.590255	0	58	0	58	58	1.0000000
NODE_6572_length_1002_cov_17.590255	31	77	0	46	46	1.0000000
NODE_6573_length_1002_cov_17.105205	522	602	0	24	80	0.3000000
NODE_6573_length_1002_cov_17.105205	522	602	2	56	80	0.7000000
NODE_6573_length_1002_cov_17.105205	575	655	0	16	80	0.2000000
NODE_6573_length_1002_cov_17.105205	575	655	2	64	80	0.8000000
NODE_6574_length_1002_cov_11.954596	480	560	0	45	80	0.5625000
NODE_6574_length_1002_cov_11.954596	480	560	2	35	80	0.4375000
NODE_6574_length_1002_cov_11.954596	533	613	2	45	80	0.5625000
NODE_6574_length_1002_cov_11.954596	533	613	4	35	80	0.4375000
NODE_6575_length_1002_cov_11.823920	471	551	0	25	80	0.3125000
NODE_6575_length_1002_cov_11.823920	471	551	1	7	80	0.0875000
NODE_6575_length_1002_cov_11.823920	471	551	2	48	80	0.6000000
NODE_6575_length_1002_cov_11.823920	524	614	0	1	90	0.0111111
NODE_6575_length_1002_cov_11.823920	524	614	2	89	90	0.9888889
NODE_6577_length_1002_cov_6.596899	422	502	0	80	80	1.0000000
NODE_6577_length_1002_cov_6.596899	475	555	0	80	80	1.0000000
NODE_6588_length_1002_cov_2.102990	29	110	0	81	81	1.0000000
NODE_6596_length_1001_cov_41.914634	549	629	0	80	80	1.0000000
NODE_6596_length_1001_cov_41.914634	602	682	0	80	80	1.0000000
NODE_6597_length_1001_cov_30.378049	306	386	0	80	80	1.0000000
NODE_6597_length_1001_cov_30.378049	359	439	0	30	80	0.3750000
NODE_6597_length_1001_cov_30.378049	359	439	2	44	80	0.5500000
NODE_6597_length_1001_cov_30.378049	359	439	4	6	80	0.0750000
NODE_6597_length_1001_cov_30.378049	369	439	0	20	70	0.2857143
NODE_6597_length_1001_cov_30.378049	369	439	2	44	70	0.6285715
NODE_6597_length_1001_cov_30.378049	369	439	4	6	70	0.0857143
NODE_6597_length_1001_cov_30.378049	435	515	2	26	80	0.3250000
NODE_6597_length_1001_cov_30.378049	435	515	4	54	80	0.6750000
NODE_6597_length_1001_cov_30.378049	488	568	0	33	80	0.4125000
NODE_6597_length_1001_cov_30.378049	488	568	2	16	80	0.2000000
NODE_6597_length_1001_cov_30.378049	488	568	4	31	80	0.3875000
NODE_6598_length_1001_cov_22.517738	536	616	0	80	80	1.0000000
NODE_6598_length_1001_cov_22.517738	589	670	0	58	81	0.7160494
NODE_6598_length_1001_cov_22.517738	589	670	2	23	81	0.2839506
NODE_6599_length_1001_cov_17.996674	414	456	0	5	42	0.1190476
NODE_6599_length_1001_cov_17.996674	414	456	2	37	42	0.8809524
NODE_6599_length_1001_cov_17.996674	429	509	2	80	80	1.0000000
NODE_6599_length_1001_cov_17.996674	505	585	0	72	80	0.9000000
NODE_6599_length_1001_cov_17.996674	505	585	2	8	80	0.1000000
NODE_6599_length_1001_cov_17.996674	558	638	0	80	80	1.0000000
NODE_6600_length_1001_cov_16.798226	422	502	0	15	80	0.1875000
NODE_6600_length_1001_cov_16.798226	422	502	4	65	80	0.8125000
NODE_6600_length_1001_cov_16.798226	475	555	0	68	80	0.8500000
NODE_6600_length_1001_cov_16.798226	475	555	4	12	80	0.1500000
NODE_6600_length_1001_cov_16.798226	551	631	0	15	80	0.1875000
NODE_6600_length_1001_cov_16.798226	551	631	2	65	80	0.8125000
NODE_6600_length_1001_cov_16.798226	604	684	0	5	80	0.0625000
NODE_6600_length_1001_cov_16.798226	604	684	2	75	80	0.9375000
NODE_6601_length_1001_cov_12.778271	348	428	0	35	80	0.4375000
NODE_6601_length_1001_cov_12.778271	348	428	2	45	80	0.5625000
NODE_6601_length_1001_cov_12.778271	401	481	0	80	80	1.0000000
NODE_6602_length_1001_cov_12.305987	255	335	0	80	80	1.0000000
NODE_6602_length_1001_cov_12.305987	308	388	0	80	80	1.0000000
NODE_6603_length_1001_cov_11.955654	485	569	0	70	84	0.8333333
NODE_6603_length_1001_cov_11.955654	485	569	2	14	84	0.1666667
NODE_6603_length_1001_cov_11.955654	542	622	0	13	80	0.1625000
NODE_6603_length_1001_cov_11.955654	542	622	2	67	80	0.8375000
NODE_6604_length_1001_cov_10.156319	587	667	0	80	80	1.0000000
NODE_6604_length_1001_cov_10.156319	640	720	0	80	80	1.0000000
NODE_6605_length_1001_cov_9.754989	377	457	0	80	80	1.0000000
NODE_6605_length_1001_cov_9.754989	430	510	0	80	80	1.0000000
NODE_6607_length_1001_cov_4.616408	408	488	0	80	80	1.0000000
NODE_6607_length_1001_cov_4.616408	461	541	0	80	80	1.0000000
NODE_6616_length_1000_cov_55.578246	393	473	0	80	80	1.0000000
NODE_6616_length_1000_cov_55.578246	446	526	0	58	80	0.7250000
NODE_6616_length_1000_cov_55.578246	446	526	2	16	80	0.2000000
NODE_6616_length_1000_cov_55.578246	446	526	4	6	80	0.0750000
NODE_6616_length_1000_cov_55.578246	522	598	0	3	76	0.0394737
NODE_6616_length_1000_cov_55.578246	522	598	2	12	76	0.1578947
NODE_6616_length_1000_cov_55.578246	522	598	3	1	76	0.0131579
NODE_6616_length_1000_cov_55.578246	522	598	4	60	76	0.7894737
NODE_6616_length_1000_cov_55.578246	575	649	0	4	74	0.0540541
NODE_6616_length_1000_cov_55.578246	575	649	2	62	74	0.8378378
NODE_6616_length_1000_cov_55.578246	575	649	3	1	74	0.0135135
NODE_6616_length_1000_cov_55.578246	575	649	4	7	74	0.0945946
NODE_6617_length_1000_cov_51.534961	432	512	0	80	80	1.0000000
NODE_6617_length_1000_cov_51.534961	485	565	0	80	80	1.0000000
NODE_6617_length_1000_cov_51.534961	561	641	0	7	80	0.0875000
NODE_6617_length_1000_cov_51.534961	561	641	2	46	80	0.5750000
NODE_6617_length_1000_cov_51.534961	561	641	6	17	80	0.2125000
NODE_6617_length_1000_cov_51.534961	561	641	10	10	80	0.1250000
NODE_6617_length_1000_cov_51.534961	614	694	6	17	80	0.2125000
NODE_6617_length_1000_cov_51.534961	614	694	8	13	80	0.1625000
NODE_6617_length_1000_cov_51.534961	614	694	10	50	80	0.6250000
NODE_6618_length_1000_cov_39.011099	186	266	0	80	80	1.0000000
NODE_6618_length_1000_cov_39.011099	239	319	0	80	80	1.0000000
NODE_6619_length_1000_cov_19.897891	451	531	0	80	80	1.0000000
NODE_6619_length_1000_cov_19.897891	504	584	0	80	80	1.0000000
NODE_6619_length_1000_cov_19.897891	580	660	0	6	80	0.0750000
NODE_6619_length_1000_cov_19.897891	580	660	2	74	80	0.9250000
NODE_6619_length_1000_cov_19.897891	633	713	0	13	80	0.1625000
NODE_6619_length_1000_cov_19.897891	633	713	2	67	80	0.8375000
NODE_6620_length_1000_cov_13.349612	324	404	0	80	80	1.0000000
NODE_6620_length_1000_cov_13.349612	377	457	0	80	80	1.0000000
NODE_6621_length_1000_cov_11.463929	382	462	0	22	80	0.2750000
NODE_6621_length_1000_cov_11.463929	382	462	2	58	80	0.7250000
NODE_6621_length_1000_cov_11.463929	435	515	0	75	80	0.9375000
NODE_6621_length_1000_cov_11.463929	435	515	2	5	80	0.0625000
NODE_6622_length_1000_cov_9.675916	625	705	0	80	80	1.0000000
NODE_6622_length_1000_cov_9.675916	678	758	0	80	80	1.0000000
NODE_6623_length_1000_cov_7.051054	358	438	0	22	80	0.2750000
NODE_6623_length_1000_cov_7.051054	358	438	2	58	80	0.7250000
NODE_6623_length_1000_cov_7.051054	411	491	2	32	80	0.4000000
NODE_6623_length_1000_cov_7.051054	411	491	4	47	80	0.5875000
NODE_6623_length_1000_cov_7.051054	411	491	6	1	80	0.0125000
NODE_6626_length_1000_cov_3.652608	203	265	0	62	62	1.0000000
NODE_6639_length_999_cov_47.442222	604	684	2	25	80	0.3125000
NODE_6639_length_999_cov_47.442222	604	684	4	21	80	0.2625000
NODE_6639_length_999_cov_47.442222	604	684	9	1	80	0.0125000
NODE_6639_length_999_cov_47.442222	604	684	10	33	80	0.4125000
NODE_6639_length_999_cov_47.442222	657	723	7	12	66	0.1818182
NODE_6639_length_999_cov_47.442222	657	723	9	26	66	0.3939394
NODE_6639_length_999_cov_47.442222	657	723	10	28	66	0.4242424
NODE_6640_length_999_cov_33.055556	458	540	0	19	82	0.2317073
NODE_6640_length_999_cov_33.055556	458	540	4	36	82	0.4390244
NODE_6640_length_999_cov_33.055556	458	540	6	27	82	0.3292683
NODE_6640_length_999_cov_33.055556	513	593	2	30	80	0.3750000
NODE_6640_length_999_cov_33.055556	513	593	6	50	80	0.6250000
NODE_6641_length_999_cov_22.755556	493	573	0	42	80	0.5250000
NODE_6641_length_999_cov_22.755556	493	573	2	38	80	0.4750000
NODE_6641_length_999_cov_22.755556	546	626	2	31	80	0.3875000
NODE_6641_length_999_cov_22.755556	546	626	6	49	80	0.6125000
NODE_6642_length_999_cov_21.842222	359	439	0	33	80	0.4125000
NODE_6642_length_999_cov_21.842222	359	439	2	47	80	0.5875000
NODE_6642_length_999_cov_21.842222	412	492	0	29	80	0.3625000
NODE_6642_length_999_cov_21.842222	412	492	2	51	80	0.6375000
NODE_6643_length_999_cov_20.006667	361	441	0	80	80	1.0000000
NODE_6643_length_999_cov_20.006667	414	494	0	27	80	0.3375000
NODE_6643_length_999_cov_20.006667	414	494	3	2	80	0.0250000
NODE_6643_length_999_cov_20.006667	414	494	4	51	80	0.6375000
NODE_6643_length_999_cov_20.006667	490	570	4	46	80	0.5750000
NODE_6643_length_999_cov_20.006667	490	570	8	34	80	0.4250000
NODE_6643_length_999_cov_20.006667	543	623	0	7	80	0.0875000
NODE_6643_length_999_cov_20.006667	543	623	4	73	80	0.9125000
NODE_6645_length_999_cov_16.794444	438	518	0	80	80	1.0000000
NODE_6645_length_999_cov_16.794444	491	571	0	80	80	1.0000000
NODE_6646_length_999_cov_15.146667	464	544	0	80	80	1.0000000
NODE_6646_length_999_cov_15.146667	517	597	0	80	80	1.0000000
NODE_6648_length_999_cov_8.771111	361	441	0	80	80	1.0000000
NODE_6648_length_999_cov_8.771111	414	492	0	78	78	1.0000000
NODE_6649_length_999_cov_5.171111	417	497	0	80	80	1.0000000
NODE_6649_length_999_cov_5.171111	470	550	0	69	80	0.8625000
NODE_6649_length_999_cov_5.171111	470	550	4	11	80	0.1375000
NODE_6650_length_999_cov_2.854444	35	101	6	62	66	0.9393939
NODE_6650_length_999_cov_2.854444	35	101	7	4	66	0.0606061
NODE_6657_length_998_cov_30.697442	404	484	0	69	80	0.8625000
NODE_6657_length_998_cov_30.697442	404	484	2	11	80	0.1375000
NODE_6657_length_998_cov_30.697442	457	537	0	80	80	1.0000000
NODE_6657_length_998_cov_30.697442	533	613	0	19	80	0.2375000
NODE_6657_length_998_cov_30.697442	533	613	2	16	80	0.2000000
NODE_6657_length_998_cov_30.697442	533	613	4	8	80	0.1000000
NODE_6657_length_998_cov_30.697442	533	613	6	37	80	0.4625000
NODE_6657_length_998_cov_30.697442	586	666	0	1	80	0.0125000
NODE_6657_length_998_cov_30.697442	586	666	2	14	80	0.1750000
NODE_6657_length_998_cov_30.697442	586	666	4	5	80	0.0625000
NODE_6657_length_998_cov_30.697442	586	666	6	60	80	0.7500000
NODE_6658_length_998_cov_23.703003	235	315	0	9	80	0.1125000
NODE_6658_length_998_cov_23.703003	235	315	2	8	80	0.1000000
NODE_6658_length_998_cov_23.703003	235	315	4	63	80	0.7875000
NODE_6658_length_998_cov_23.703003	288	368	0	25	80	0.3125000
NODE_6658_length_998_cov_23.703003	288	368	2	34	80	0.4250000
NODE_6658_length_998_cov_23.703003	288	368	4	21	80	0.2625000
NODE_6659_length_998_cov_22.692992	531	611	0	18	80	0.2250000
NODE_6659_length_998_cov_22.692992	531	611	2	62	80	0.7750000
NODE_6659_length_998_cov_22.692992	584	664	0	71	80	0.8875000
NODE_6659_length_998_cov_22.692992	584	664	2	9	80	0.1125000
NODE_6660_length_998_cov_11.152392	514	594	0	32	80	0.4000000
NODE_6660_length_998_cov_11.152392	514	594	2	48	80	0.6000000
NODE_6660_length_998_cov_11.152392	567	640	0	73	73	1.0000000
NODE_6660_length_998_cov_11.152392	636	716	0	80	80	1.0000000
NODE_6660_length_998_cov_11.152392	689	769	0	80	80	1.0000000
NODE_6661_length_998_cov_10.061179	422	502	0	27	80	0.3375000
NODE_6661_length_998_cov_10.061179	422	502	2	53	80	0.6625000
NODE_6661_length_998_cov_10.061179	475	555	2	80	80	1.0000000
NODE_6662_length_998_cov_7.126808	353	430	0	75	77	0.9740260
NODE_6662_length_998_cov_7.126808	353	430	2	2	77	0.0259740
NODE_6662_length_998_cov_7.126808	403	483	0	27	80	0.3375000
NODE_6662_length_998_cov_7.126808	403	483	2	53	80	0.6625000
NODE_6669_length_997_cov_48.518931	445	525	0	5	80	0.0625000
NODE_6669_length_997_cov_48.518931	445	525	2	4	80	0.0500000
NODE_6669_length_997_cov_48.518931	445	525	4	20	80	0.2500000
NODE_6669_length_997_cov_48.518931	445	525	6	51	80	0.6375000
NODE_6669_length_997_cov_48.518931	498	578	0	21	80	0.2625000
NODE_6669_length_997_cov_48.518931	498	578	2	11	80	0.1375000
NODE_6669_length_997_cov_48.518931	498	578	4	17	80	0.2125000
NODE_6669_length_997_cov_48.518931	498	578	6	31	80	0.3875000
NODE_6670_length_997_cov_36.721604	400	480	0	3	80	0.0375000
NODE_6670_length_997_cov_36.721604	400	480	2	18	80	0.2250000
NODE_6670_length_997_cov_36.721604	400	480	3	59	80	0.7375000
NODE_6670_length_997_cov_36.721604	453	533	1	27	80	0.3375000
NODE_6670_length_997_cov_36.721604	453	533	3	53	80	0.6625000
NODE_6671_length_997_cov_22.646993	328	408	0	43	80	0.5375000
NODE_6671_length_997_cov_22.646993	328	408	2	37	80	0.4625000
NODE_6671_length_997_cov_22.646993	381	461	0	7	80	0.0875000
NODE_6671_length_997_cov_22.646993	381	461	2	73	80	0.9125000
NODE_6672_length_997_cov_19.709354	420	500	0	80	80	1.0000000
NODE_6672_length_997_cov_19.709354	473	553	0	80	80	1.0000000
NODE_6672_length_997_cov_19.709354	549	629	0	27	80	0.3375000
NODE_6672_length_997_cov_19.709354	549	629	2	53	80	0.6625000
NODE_6672_length_997_cov_19.709354	602	682	0	19	80	0.2375000
NODE_6672_length_997_cov_19.709354	602	682	2	61	80	0.7625000
NODE_6673_length_997_cov_17.947661	465	545	0	80	80	1.0000000
NODE_6673_length_997_cov_17.947661	518	598	0	80	80	1.0000000
NODE_6673_length_997_cov_17.947661	594	674	0	23	80	0.2875000
NODE_6673_length_997_cov_17.947661	594	674	2	57	80	0.7125000
NODE_6673_length_997_cov_17.947661	647	727	2	80	80	1.0000000
NODE_6674_length_997_cov_14.718263	388	468	0	70	80	0.8750000
NODE_6674_length_997_cov_14.718263	388	468	2	10	80	0.1250000
NODE_6674_length_997_cov_14.718263	441	521	0	17	80	0.2125000
NODE_6674_length_997_cov_14.718263	441	521	2	63	80	0.7875000
NODE_6675_length_997_cov_7.114699	307	387	2	2	80	0.0250000
NODE_6675_length_997_cov_7.114699	307	387	4	78	80	0.9750000
NODE_6675_length_997_cov_7.114699	360	440	2	22	80	0.2750000
NODE_6675_length_997_cov_7.114699	360	440	4	54	80	0.6750000
NODE_6675_length_997_cov_7.114699	360	440	6	4	80	0.0500000
NODE_6694_length_996_cov_59.568562	387	467	0	67	80	0.8375000
NODE_6694_length_996_cov_59.568562	387	467	2	13	80	0.1625000
NODE_6694_length_996_cov_59.568562	440	520	0	14	80	0.1750000
NODE_6694_length_996_cov_59.568562	440	520	2	29	80	0.3625000
NODE_6694_length_996_cov_59.568562	440	520	4	37	80	0.4625000
NODE_6695_length_996_cov_32.462653	503	583	2	2	80	0.0250000
NODE_6695_length_996_cov_32.462653	503	583	4	16	80	0.2000000
NODE_6695_length_996_cov_32.462653	503	583	6	62	80	0.7750000
NODE_6695_length_996_cov_32.462653	556	636	6	80	80	1.0000000
NODE_6696_length_996_cov_23.312152	571	651	0	46	80	0.5750000
NODE_6696_length_996_cov_23.312152	571	651	2	19	80	0.2375000
NODE_6696_length_996_cov_23.312152	571	651	6	6	80	0.0750000
NODE_6696_length_996_cov_23.312152	571	651	8	9	80	0.1125000
NODE_6696_length_996_cov_23.312152	624	704	2	12	80	0.1500000
NODE_6696_length_996_cov_23.312152	624	704	6	6	80	0.0750000
NODE_6696_length_996_cov_23.312152	624	704	8	62	80	0.7750000
NODE_6697_length_996_cov_20.979933	533	613	0	80	80	1.0000000
NODE_6697_length_996_cov_20.979933	586	666	0	80	80	1.0000000
NODE_6698_length_996_cov_17.865106	535	615	0	7	80	0.0875000
NODE_6698_length_996_cov_17.865106	535	615	2	20	80	0.2500000
NODE_6698_length_996_cov_17.865106	535	615	4	53	80	0.6625000
NODE_6698_length_996_cov_17.865106	588	668	0	20	80	0.2500000
NODE_6698_length_996_cov_17.865106	588	668	2	8	80	0.1000000
NODE_6698_length_996_cov_17.865106	588	668	4	52	80	0.6500000
NODE_6699_length_996_cov_10.297659	499	579	4	7	80	0.0875000
NODE_6699_length_996_cov_10.297659	499	579	9	1	80	0.0125000
NODE_6699_length_996_cov_10.297659	499	579	10	6	80	0.0750000
NODE_6699_length_996_cov_10.297659	499	579	12	66	80	0.8250000
NODE_6699_length_996_cov_10.297659	552	630	0	17	78	0.2179487
NODE_6699_length_996_cov_10.297659	552	630	6	9	78	0.1153846
NODE_6699_length_996_cov_10.297659	552	630	10	9	78	0.1153846
NODE_6699_length_996_cov_10.297659	552	630	12	43	78	0.5512820
NODE_6702_length_996_cov_3.205128	499	555	0	49	56	0.8750000
NODE_6702_length_996_cov_3.205128	499	555	2	7	56	0.1250000
NODE_6707_length_995_cov_26.131696	543	623	0	23	80	0.2875000
NODE_6707_length_995_cov_26.131696	543	623	5	21	80	0.2625000
NODE_6707_length_995_cov_26.131696	543	623	6	17	80	0.2125000
NODE_6707_length_995_cov_26.131696	543	623	7	19	80	0.2375000
NODE_6707_length_995_cov_26.131696	596	676	0	76	80	0.9500000
NODE_6707_length_995_cov_26.131696	596	676	5	4	80	0.0500000
NODE_6708_length_995_cov_20.262277	457	537	0	80	80	1.0000000
NODE_6708_length_995_cov_20.262277	510	590	0	80	80	1.0000000
NODE_6709_length_995_cov_19.382812	457	537	0	80	80	1.0000000
NODE_6709_length_995_cov_19.382812	510	590	0	80	80	1.0000000
NODE_6710_length_995_cov_19.034598	453	533	0	80	80	1.0000000
NODE_6710_length_995_cov_19.034598	506	586	0	80	80	1.0000000
NODE_6711_length_995_cov_9.734375	222	323	0	101	101	1.0000000
NODE_6711_length_995_cov_9.734375	296	376	0	80	80	1.0000000
NODE_6723_length_994_cov_74.678212	362	442	2	37	80	0.4625000
NODE_6723_length_994_cov_74.678212	362	442	4	43	80	0.5375000
NODE_6723_length_994_cov_74.678212	415	495	0	37	80	0.4625000
NODE_6723_length_994_cov_74.678212	415	495	2	43	80	0.5375000
NODE_6723_length_994_cov_74.678212	491	571	0	80	80	1.0000000
NODE_6723_length_994_cov_74.678212	544	624	0	80	80	1.0000000
NODE_6724_length_994_cov_26.045810	442	522	0	80	80	1.0000000
NODE_6724_length_994_cov_26.045810	495	575	0	80	80	1.0000000
NODE_6725_length_994_cov_25.240223	504	584	2	8	80	0.1000000
NODE_6725_length_994_cov_25.240223	504	584	4	27	80	0.3375000
NODE_6725_length_994_cov_25.240223	504	584	7	12	80	0.1500000
NODE_6725_length_994_cov_25.240223	504	584	9	33	80	0.4125000
NODE_6725_length_994_cov_25.240223	557	637	2	22	80	0.2750000
NODE_6725_length_994_cov_25.240223	557	637	4	58	80	0.7250000
NODE_6726_length_994_cov_24.615642	422	502	0	80	80	1.0000000
NODE_6726_length_994_cov_24.615642	475	555	0	68	80	0.8500000
NODE_6726_length_994_cov_24.615642	475	555	2	12	80	0.1500000
NODE_6726_length_994_cov_24.615642	551	631	2	80	80	1.0000000
NODE_6726_length_994_cov_24.615642	604	684	0	46	80	0.5750000
NODE_6726_length_994_cov_24.615642	604	684	2	34	80	0.4250000
NODE_6727_length_994_cov_22.593296	323	403	0	80	80	1.0000000
NODE_6727_length_994_cov_22.593296	376	456	0	80	80	1.0000000
NODE_6727_length_994_cov_22.593296	452	532	0	80	80	1.0000000
NODE_6727_length_994_cov_22.593296	505	585	0	80	80	1.0000000
NODE_6728_length_994_cov_6.985475	0	58	0	58	58	1.0000000
NODE_6728_length_994_cov_6.985475	15	95	0	80	80	1.0000000
NODE_6728_length_994_cov_6.985475	68	148	0	38	80	0.4750000
NODE_6728_length_994_cov_6.985475	68	148	2	42	80	0.5250000
NODE_6740_length_993_cov_56.321029	266	346	0	80	80	1.0000000
NODE_6740_length_993_cov_56.321029	319	399	0	80	80	1.0000000
NODE_6740_length_993_cov_56.321029	400	470	0	70	70	1.0000000
NODE_6740_length_993_cov_56.321029	443	523	0	80	80	1.0000000
NODE_6741_length_993_cov_44.695749	385	465	0	80	80	1.0000000
NODE_6741_length_993_cov_44.695749	438	518	0	80	80	1.0000000
NODE_6742_length_993_cov_40.574944	417	497	0	30	80	0.3750000
NODE_6742_length_993_cov_40.574944	417	497	4	50	80	0.6250000
NODE_6742_length_993_cov_40.574944	470	550	4	80	80	1.0000000
NODE_6742_length_993_cov_40.574944	546	628	0	21	82	0.2560976
NODE_6742_length_993_cov_40.574944	546	628	2	52	82	0.6341463
NODE_6742_length_993_cov_40.574944	546	628	4	9	82	0.1097561
NODE_6742_length_993_cov_40.574944	601	681	0	25	80	0.3125000
NODE_6742_length_993_cov_40.574944	601	681	2	55	80	0.6875000
NODE_6743_length_993_cov_39.817673	3	83	0	80	80	1.0000000
NODE_6744_length_993_cov_30.128635	477	557	0	33	80	0.4125000
NODE_6744_length_993_cov_30.128635	477	557	2	33	80	0.4125000
NODE_6744_length_993_cov_30.128635	477	557	4	14	80	0.1750000
NODE_6744_length_993_cov_30.128635	530	610	2	39	80	0.4875000
NODE_6744_length_993_cov_30.128635	530	610	4	41	80	0.5125000
NODE_6745_length_993_cov_17.435123	573	653	0	77	80	0.9625000
NODE_6745_length_993_cov_17.435123	573	653	2	3	80	0.0375000
NODE_6745_length_993_cov_17.435123	626	706	0	24	80	0.3000000
NODE_6745_length_993_cov_17.435123	626	706	2	51	80	0.6375000
NODE_6745_length_993_cov_17.435123	626	706	4	5	80	0.0625000
NODE_6746_length_993_cov_13.074944	483	563	0	18	80	0.2250000
NODE_6746_length_993_cov_13.074944	483	563	2	62	80	0.7750000
NODE_6746_length_993_cov_13.074944	536	616	0	32	80	0.4000000
NODE_6746_length_993_cov_13.074944	536	616	2	48	80	0.6000000
NODE_6747_length_993_cov_10.190157	500	580	0	18	80	0.2250000
NODE_6747_length_993_cov_10.190157	500	580	2	62	80	0.7750000
NODE_6747_length_993_cov_10.190157	553	633	0	52	80	0.6500000
NODE_6747_length_993_cov_10.190157	553	633	2	28	80	0.3500000
NODE_6756_length_993_cov_0.909396	16	73	0	57	57	1.0000000
NODE_6757_length_992_cov_36.119821	354	434	0	56	80	0.7000000
NODE_6757_length_992_cov_36.119821	354	434	2	8	80	0.1000000
NODE_6757_length_992_cov_36.119821	354	434	4	16	80	0.2000000
NODE_6757_length_992_cov_36.119821	407	487	0	3	80	0.0375000
NODE_6757_length_992_cov_36.119821	407	487	2	11	80	0.1375000
NODE_6757_length_992_cov_36.119821	407	487	4	66	80	0.8250000
NODE_6757_length_992_cov_36.119821	483	563	0	64	80	0.8000000
NODE_6757_length_992_cov_36.119821	483	563	2	15	80	0.1875000
NODE_6757_length_992_cov_36.119821	483	563	4	1	80	0.0125000
NODE_6757_length_992_cov_36.119821	536	616	0	80	80	1.0000000
NODE_6758_length_992_cov_34.802912	443	523	2	80	80	1.0000000
NODE_6758_length_992_cov_34.802912	496	576	0	49	80	0.6125000
NODE_6758_length_992_cov_34.802912	496	576	2	31	80	0.3875000
NODE_6759_length_992_cov_33.047032	381	461	2	16	80	0.2000000
NODE_6759_length_992_cov_33.047032	381	461	4	27	80	0.3375000
NODE_6759_length_992_cov_33.047032	381	461	10	18	80	0.2250000
NODE_6759_length_992_cov_33.047032	381	461	11	2	80	0.0250000
NODE_6759_length_992_cov_33.047032	381	461	12	17	80	0.2125000
NODE_6759_length_992_cov_33.047032	434	514	0	6	80	0.0750000
NODE_6759_length_992_cov_33.047032	434	514	10	18	80	0.2250000
NODE_6759_length_992_cov_33.047032	434	514	11	2	80	0.0250000
NODE_6759_length_992_cov_33.047032	434	514	12	24	80	0.3000000
NODE_6759_length_992_cov_33.047032	434	514	13	2	80	0.0250000
NODE_6759_length_992_cov_33.047032	434	514	14	28	80	0.3500000
NODE_6759_length_992_cov_33.047032	510	590	0	80	80	1.0000000
NODE_6759_length_992_cov_33.047032	563	643	0	80	80	1.0000000
NODE_6760_length_992_cov_23.543113	435	515	0	80	80	1.0000000
NODE_6760_length_992_cov_23.543113	488	568	0	80	80	1.0000000
NODE_6761_length_992_cov_22.608063	440	520	2	13	80	0.1625000
NODE_6761_length_992_cov_22.608063	440	520	4	35	80	0.4375000
NODE_6761_length_992_cov_22.608063	440	520	5	8	80	0.1000000
NODE_6761_length_992_cov_22.608063	440	520	6	24	80	0.3000000
NODE_6761_length_992_cov_22.608063	493	573	0	14	80	0.1750000
NODE_6761_length_992_cov_22.608063	493	573	2	52	80	0.6500000
NODE_6761_length_992_cov_22.608063	493	573	4	14	80	0.1750000
NODE_6762_length_992_cov_21.427772	216	296	0	80	80	1.0000000
NODE_6762_length_992_cov_21.427772	269	349	0	80	80	1.0000000
NODE_6763_length_992_cov_20.010078	312	392	0	80	80	1.0000000
NODE_6763_length_992_cov_20.010078	365	445	0	80	80	1.0000000
NODE_6764_length_992_cov_16.524076	465	545	0	80	80	1.0000000
NODE_6764_length_992_cov_16.524076	518	598	0	80	80	1.0000000
NODE_6765_length_992_cov_16.266517	396	476	0	4	80	0.0500000
NODE_6765_length_992_cov_16.266517	396	476	2	76	80	0.9500000
NODE_6765_length_992_cov_16.266517	449	529	0	30	80	0.3750000
NODE_6765_length_992_cov_16.266517	449	529	2	50	80	0.6250000
NODE_6766_length_992_cov_16.146697	272	352	0	80	80	1.0000000
NODE_6766_length_992_cov_16.146697	325	405	0	35	80	0.4375000
NODE_6766_length_992_cov_16.146697	325	405	2	45	80	0.5625000
NODE_6767_length_992_cov_15.212766	354	434	0	80	80	1.0000000
NODE_6767_length_992_cov_15.212766	407	487	0	80	80	1.0000000
NODE_6767_length_992_cov_15.212766	483	563	0	78	80	0.9750000
NODE_6767_length_992_cov_15.212766	483	563	1	2	80	0.0250000
NODE_6767_length_992_cov_15.212766	536	616	0	25	80	0.3125000
NODE_6767_length_992_cov_15.212766	536	616	1	7	80	0.0875000
NODE_6767_length_992_cov_15.212766	536	616	3	48	80	0.6000000
NODE_6781_length_991_cov_48.582960	451	531	6	34	80	0.4250000
NODE_6781_length_991_cov_48.582960	451	531	8	32	80	0.4000000
NODE_6781_length_991_cov_48.582960	451	531	10	14	80	0.1750000
NODE_6781_length_991_cov_48.582960	504	584	2	15	80	0.1875000
NODE_6781_length_991_cov_48.582960	504	584	4	2	80	0.0250000
NODE_6781_length_991_cov_48.582960	504	584	8	19	80	0.2375000
NODE_6781_length_991_cov_48.582960	504	584	10	44	80	0.5500000
NODE_6782_length_991_cov_25.891256	340	420	0	80	80	1.0000000
NODE_6782_length_991_cov_25.891256	393	473	0	80	80	1.0000000
NODE_6782_length_991_cov_25.891256	469	549	0	80	80	1.0000000
NODE_6782_length_991_cov_25.891256	522	602	0	80	80	1.0000000
NODE_6783_length_991_cov_25.392377	377	457	0	80	80	1.0000000
NODE_6783_length_991_cov_25.392377	430	510	0	38	80	0.4750000
NODE_6783_length_991_cov_25.392377	430	510	2	42	80	0.5250000
NODE_6783_length_991_cov_25.392377	506	586	0	14	80	0.1750000
NODE_6783_length_991_cov_25.392377	506	586	2	66	80	0.8250000
NODE_6783_length_991_cov_25.392377	559	639	0	67	80	0.8375000
NODE_6783_length_991_cov_25.392377	559	639	2	13	80	0.1625000
NODE_6784_length_991_cov_22.210762	421	501	0	45	80	0.5625000
NODE_6784_length_991_cov_22.210762	421	501	1	35	80	0.4375000
NODE_6784_length_991_cov_22.210762	474	554	1	80	80	1.0000000
NODE_6785_length_991_cov_18.008969	366	446	0	80	80	1.0000000
NODE_6785_length_991_cov_18.008969	419	499	0	80	80	1.0000000
NODE_6785_length_991_cov_18.008969	495	575	0	80	80	1.0000000
NODE_6785_length_991_cov_18.008969	548	629	0	81	81	1.0000000
NODE_6786_length_991_cov_14.727578	426	506	0	8	80	0.1000000
NODE_6786_length_991_cov_14.727578	426	506	2	7	80	0.0875000
NODE_6786_length_991_cov_14.727578	426	506	4	7	80	0.0875000
NODE_6786_length_991_cov_14.727578	426	506	6	4	80	0.0500000
NODE_6786_length_991_cov_14.727578	426	506	7	6	80	0.0750000
NODE_6786_length_991_cov_14.727578	426	506	8	48	80	0.6000000
NODE_6786_length_991_cov_14.727578	479	559	0	3	80	0.0375000
NODE_6786_length_991_cov_14.727578	479	559	2	2	80	0.0250000
NODE_6786_length_991_cov_14.727578	479	559	6	49	80	0.6125000
NODE_6786_length_991_cov_14.727578	479	559	8	26	80	0.3250000
NODE_6787_length_991_cov_13.081839	240	320	0	27	80	0.3375000
NODE_6787_length_991_cov_13.081839	240	320	2	53	80	0.6625000
NODE_6787_length_991_cov_13.081839	293	373	0	34	80	0.4250000
NODE_6787_length_991_cov_13.081839	293	373	2	46	80	0.5750000
NODE_6788_length_991_cov_12.693946	425	505	0	29	80	0.3625000
NODE_6788_length_991_cov_12.693946	425	505	1	51	80	0.6375000
NODE_6788_length_991_cov_12.693946	478	558	1	80	80	1.0000000
NODE_6789_length_991_cov_9.647982	436	516	0	60	80	0.7500000
NODE_6789_length_991_cov_9.647982	436	516	2	20	80	0.2500000
NODE_6789_length_991_cov_9.647982	489	569	0	80	80	1.0000000
NODE_6790_length_991_cov_5.176009	538	618	0	80	80	1.0000000
NODE_6790_length_991_cov_5.176009	591	671	0	80	80	1.0000000
NODE_6801_length_990_cov_39.386083	402	482	0	37	80	0.4625000
NODE_6801_length_990_cov_39.386083	402	482	2	43	80	0.5375000
NODE_6801_length_990_cov_39.386083	455	535	0	24	80	0.3000000
NODE_6801_length_990_cov_39.386083	455	535	2	56	80	0.7000000
NODE_6802_length_990_cov_35.993266	321	401	0	80	80	1.0000000
NODE_6802_length_990_cov_35.993266	374	454	0	80	80	1.0000000
NODE_6802_length_990_cov_35.993266	450	530	0	27	80	0.3375000
NODE_6802_length_990_cov_35.993266	450	530	2	53	80	0.6625000
NODE_6802_length_990_cov_35.993266	503	583	2	80	80	1.0000000
NODE_6803_length_990_cov_24.445567	588	668	10	1	80	0.0125000
NODE_6803_length_990_cov_24.445567	588	668	12	12	80	0.1500000
NODE_6803_length_990_cov_24.445567	588	668	14	67	80	0.8375000
NODE_6803_length_990_cov_24.445567	641	721	0	34	80	0.4250000
NODE_6803_length_990_cov_24.445567	641	721	4	9	80	0.1125000
NODE_6803_length_990_cov_24.445567	641	721	8	7	80	0.0875000
NODE_6803_length_990_cov_24.445567	641	721	10	4	80	0.0500000
NODE_6803_length_990_cov_24.445567	641	721	14	26	80	0.3250000
NODE_6805_length_990_cov_22.378227	430	510	0	39	80	0.4875000
NODE_6805_length_990_cov_22.378227	430	510	2	41	80	0.5125000
NODE_6805_length_990_cov_22.378227	483	563	0	80	80	1.0000000
NODE_6806_length_990_cov_20.150393	408	488	0	18	80	0.2250000
NODE_6806_length_990_cov_20.150393	408	488	2	62	80	0.7750000
NODE_6806_length_990_cov_20.150393	461	541	2	80	80	1.0000000
NODE_6807_length_990_cov_18.154882	434	514	0	80	80	1.0000000
NODE_6807_length_990_cov_18.154882	487	567	0	80	80	1.0000000
NODE_6808_length_990_cov_17.250281	329	409	0	80	80	1.0000000
NODE_6808_length_990_cov_17.250281	382	462	0	80	80	1.0000000
NODE_6808_length_990_cov_17.250281	458	538	0	33	80	0.4125000
NODE_6808_length_990_cov_17.250281	458	538	4	22	80	0.2750000
NODE_6808_length_990_cov_17.250281	458	538	6	25	80	0.3125000
NODE_6808_length_990_cov_17.250281	511	591	4	10	80	0.1250000
NODE_6808_length_990_cov_17.250281	511	591	6	38	80	0.4750000
NODE_6808_length_990_cov_17.250281	511	591	8	32	80	0.4000000
NODE_6809_length_990_cov_14.977553	448	528	0	80	80	1.0000000
NODE_6809_length_990_cov_14.977553	501	581	0	76	80	0.9500000
NODE_6809_length_990_cov_14.977553	501	581	2	4	80	0.0500000
NODE_6810_length_990_cov_13.846240	482	562	2	39	80	0.4875000
NODE_6810_length_990_cov_13.846240	482	562	4	19	80	0.2375000
NODE_6810_length_990_cov_13.846240	482	562	5	2	80	0.0250000
NODE_6810_length_990_cov_13.846240	482	562	6	20	80	0.2500000
NODE_6810_length_990_cov_13.846240	535	615	0	7	80	0.0875000
NODE_6810_length_990_cov_13.846240	535	615	1	22	80	0.2750000
NODE_6810_length_990_cov_13.846240	535	615	3	4	80	0.0500000
NODE_6810_length_990_cov_13.846240	535	615	4	5	80	0.0625000
NODE_6810_length_990_cov_13.846240	535	615	5	22	80	0.2750000
NODE_6810_length_990_cov_13.846240	535	615	6	20	80	0.2500000
NODE_6821_length_990_cov_0.978676	79	151	5	30	72	0.4166667
NODE_6821_length_990_cov_0.978676	79	151	6	42	72	0.5833333
NODE_6821_length_990_cov_0.978676	82	152	0	1	70	0.0142857
NODE_6821_length_990_cov_0.978676	82	152	5	30	70	0.4285714
NODE_6821_length_990_cov_0.978676	82	152	6	39	70	0.5571429
NODE_6823_length_989_cov_45.902247	47	127	4	1	80	0.0125000
NODE_6823_length_989_cov_45.902247	47	127	8	2	80	0.0250000
NODE_6823_length_989_cov_45.902247	47	127	16	1	80	0.0125000
NODE_6823_length_989_cov_45.902247	47	127	18	3	80	0.0375000
NODE_6823_length_989_cov_45.902247	47	127	23	1	80	0.0125000
NODE_6823_length_989_cov_45.902247	47	127	24	3	80	0.0375000
NODE_6823_length_989_cov_45.902247	47	127	26	6	80	0.0750000
NODE_6823_length_989_cov_45.902247	47	127	32	1	80	0.0125000
NODE_6823_length_989_cov_45.902247	47	127	38	1	80	0.0125000
NODE_6823_length_989_cov_45.902247	47	127	40	3	80	0.0375000
NODE_6823_length_989_cov_45.902247	47	127	42	5	80	0.0625000
NODE_6823_length_989_cov_45.902247	47	127	43	3	80	0.0375000
NODE_6823_length_989_cov_45.902247	47	127	44	50	80	0.6250000
NODE_6823_length_989_cov_45.902247	330	410	0	80	80	1.0000000
NODE_6823_length_989_cov_45.902247	383	463	0	80	80	1.0000000
NODE_6824_length_989_cov_35.430337	412	492	4	55	80	0.6875000
NODE_6824_length_989_cov_35.430337	412	492	6	25	80	0.3125000
NODE_6824_length_989_cov_35.430337	465	545	0	21	80	0.2625000
NODE_6824_length_989_cov_35.430337	465	545	2	16	80	0.2000000
NODE_6824_length_989_cov_35.430337	465	545	4	43	80	0.5375000
NODE_6825_length_989_cov_30.124719	477	557	2	8	80	0.1000000
NODE_6825_length_989_cov_30.124719	477	557	4	14	80	0.1750000
NODE_6825_length_989_cov_30.124719	477	557	6	58	80	0.7250000
NODE_6825_length_989_cov_30.124719	530	610	0	14	80	0.1750000
NODE_6825_length_989_cov_30.124719	530	610	4	53	80	0.6625000
NODE_6825_length_989_cov_30.124719	530	610	6	13	80	0.1625000
NODE_6826_length_989_cov_29.347191	447	527	0	11	80	0.1375000
NODE_6826_length_989_cov_29.347191	447	527	2	69	80	0.8625000
NODE_6826_length_989_cov_29.347191	500	580	0	21	80	0.2625000
NODE_6826_length_989_cov_29.347191	500	580	2	59	80	0.7375000
NODE_6826_length_989_cov_29.347191	576	656	0	80	80	1.0000000
NODE_6826_length_989_cov_29.347191	629	709	0	80	80	1.0000000
NODE_6827_length_989_cov_27.886517	245	325	0	7	80	0.0875000
NODE_6827_length_989_cov_27.886517	245	325	2	73	80	0.9125000
NODE_6827_length_989_cov_27.886517	298	378	2	47	80	0.5875000
NODE_6827_length_989_cov_27.886517	298	378	4	5	80	0.0625000
NODE_6827_length_989_cov_27.886517	298	378	6	28	80	0.3500000
NODE_6827_length_989_cov_27.886517	374	454	0	7	80	0.0875000
NODE_6827_length_989_cov_27.886517	374	454	4	73	80	0.9125000
NODE_6827_length_989_cov_27.886517	427	507	0	60	80	0.7500000
NODE_6827_length_989_cov_27.886517	427	507	4	20	80	0.2500000
NODE_6828_length_989_cov_27.515730	393	473	0	53	80	0.6625000
NODE_6828_length_989_cov_27.515730	393	473	2	27	80	0.3375000
NODE_6828_length_989_cov_27.515730	446	526	2	39	80	0.4875000
NODE_6828_length_989_cov_27.515730	446	526	3	31	80	0.3875000
NODE_6828_length_989_cov_27.515730	446	526	4	10	80	0.1250000
NODE_6828_length_989_cov_27.515730	522	602	1	56	80	0.7000000
NODE_6828_length_989_cov_27.515730	522	602	3	24	80	0.3000000
NODE_6828_length_989_cov_27.515730	575	655	0	3	80	0.0375000
NODE_6828_length_989_cov_27.515730	575	655	1	77	80	0.9625000
NODE_6829_length_989_cov_23.844944	312	392	0	5	80	0.0625000
NODE_6829_length_989_cov_23.844944	312	392	2	16	80	0.2000000
NODE_6829_length_989_cov_23.844944	312	392	4	7	80	0.0875000
NODE_6829_length_989_cov_23.844944	312	392	6	30	80	0.3750000
NODE_6829_length_989_cov_23.844944	312	392	10	22	80	0.2750000
NODE_6829_length_989_cov_23.844944	365	445	6	5	80	0.0625000
NODE_6829_length_989_cov_23.844944	365	445	10	53	80	0.6625000
NODE_6829_length_989_cov_23.844944	365	445	12	22	80	0.2750000
NODE_6830_length_989_cov_23.131461	475	555	0	80	80	1.0000000
NODE_6830_length_989_cov_23.131461	528	608	0	80	80	1.0000000
NODE_6831_length_989_cov_20.189888	500	580	4	65	80	0.8125000
NODE_6831_length_989_cov_20.189888	500	580	6	15	80	0.1875000
NODE_6831_length_989_cov_20.189888	553	633	4	80	80	1.0000000
NODE_6832_length_989_cov_18.429213	190	270	0	80	80	1.0000000
NODE_6832_length_989_cov_18.429213	258	323	0	52	65	0.8000000
NODE_6832_length_989_cov_18.429213	258	323	2	13	65	0.2000000
NODE_6832_length_989_cov_18.429213	319	399	2	41	80	0.5125000
NODE_6832_length_989_cov_18.429213	319	399	4	39	80	0.4875000
NODE_6832_length_989_cov_18.429213	372	412	2	10	40	0.2500000
NODE_6832_length_989_cov_18.429213	372	412	4	30	40	0.7500000
NODE_6833_length_989_cov_10.307865	433	513	0	36	80	0.4500000
NODE_6833_length_989_cov_10.307865	433	513	1	16	80	0.2000000
NODE_6833_length_989_cov_10.307865	433	513	2	28	80	0.3500000
NODE_6833_length_989_cov_10.307865	486	570	2	84	84	1.0000000
NODE_6833_length_989_cov_10.307865	566	642	1	1	76	0.0131579
NODE_6833_length_989_cov_10.307865	566	642	2	49	76	0.6447368
NODE_6833_length_989_cov_10.307865	566	642	6	11	76	0.1447368
NODE_6833_length_989_cov_10.307865	566	642	7	15	76	0.1973684
NODE_6833_length_989_cov_10.307865	615	695	1	1	80	0.0125000
NODE_6833_length_989_cov_10.307865	615	695	2	5	80	0.0625000
NODE_6833_length_989_cov_10.307865	615	695	6	18	80	0.2250000
NODE_6833_length_989_cov_10.307865	615	695	7	15	80	0.1875000
NODE_6833_length_989_cov_10.307865	615	695	8	41	80	0.5125000
NODE_6834_length_989_cov_8.941573	528	608	0	80	80	1.0000000
NODE_6834_length_989_cov_8.941573	581	661	0	80	80	1.0000000
NODE_6835_length_989_cov_5.132584	459	524	0	65	65	1.0000000
NODE_6838_length_989_cov_2.540449	703	783	0	80	80	1.0000000
NODE_6845_length_988_cov_52.168729	361	441	0	80	80	1.0000000
NODE_6845_length_988_cov_52.168729	414	494	0	80	80	1.0000000
NODE_6845_length_988_cov_52.168729	490	570	0	22	80	0.2750000
NODE_6845_length_988_cov_52.168729	490	570	2	3	80	0.0375000
NODE_6845_length_988_cov_52.168729	490	570	4	55	80	0.6875000
NODE_6845_length_988_cov_52.168729	543	623	0	8	80	0.1000000
NODE_6845_length_988_cov_52.168729	543	623	2	33	80	0.4125000
NODE_6845_length_988_cov_52.168729	543	623	4	39	80	0.4875000
NODE_6846_length_988_cov_36.733408	390	470	0	26	80	0.3250000
NODE_6846_length_988_cov_36.733408	390	470	2	10	80	0.1250000
NODE_6846_length_988_cov_36.733408	390	470	4	44	80	0.5500000
NODE_6846_length_988_cov_36.733408	443	523	0	22	80	0.2750000
NODE_6846_length_988_cov_36.733408	443	523	2	17	80	0.2125000
NODE_6846_length_988_cov_36.733408	443	523	4	26	80	0.3250000
NODE_6846_length_988_cov_36.733408	443	523	6	15	80	0.1875000
NODE_6847_length_988_cov_36.221597	478	558	0	80	80	1.0000000
NODE_6847_length_988_cov_36.221597	531	611	0	80	80	1.0000000
NODE_6848_length_988_cov_25.895388	389	469	0	7	80	0.0875000
NODE_6848_length_988_cov_25.895388	389	469	4	73	80	0.9125000
NODE_6848_length_988_cov_25.895388	442	522	0	60	80	0.7500000
NODE_6848_length_988_cov_25.895388	442	522	4	20	80	0.2500000
NODE_6848_length_988_cov_25.895388	518	598	0	80	80	1.0000000
NODE_6848_length_988_cov_25.895388	571	651	0	80	80	1.0000000
NODE_6849_length_988_cov_20.250844	423	503	0	6	80	0.0750000
NODE_6849_length_988_cov_20.250844	423	503	2	69	80	0.8625000
NODE_6849_length_988_cov_20.250844	423	503	4	5	80	0.0625000
NODE_6849_length_988_cov_20.250844	476	556	0	6	80	0.0750000
NODE_6849_length_988_cov_20.250844	476	556	2	74	80	0.9250000
NODE_6850_length_988_cov_15.812148	474	554	0	71	80	0.8875000
NODE_6850_length_988_cov_15.812148	474	554	2	9	80	0.1125000
NODE_6850_length_988_cov_15.812148	527	607	0	18	80	0.2250000
NODE_6850_length_988_cov_15.812148	527	607	2	11	80	0.1375000
NODE_6850_length_988_cov_15.812148	527	607	4	51	80	0.6375000
NODE_6851_length_988_cov_15.082115	435	517	0	82	82	1.0000000
NODE_6851_length_988_cov_15.082115	490	570	0	80	80	1.0000000
NODE_6852_length_988_cov_14.697413	467	547	0	75	80	0.9375000
NODE_6852_length_988_cov_14.697413	467	547	2	5	80	0.0625000
NODE_6852_length_988_cov_14.697413	520	600	0	80	80	1.0000000
NODE_6853_length_988_cov_7.730034	562	642	0	80	80	1.0000000
NODE_6853_length_988_cov_7.730034	615	695	0	80	80	1.0000000
NODE_6862_length_987_cov_42.784910	383	476	0	14	93	0.1505376
NODE_6862_length_987_cov_42.784910	383	476	2	4	93	0.0430108
NODE_6862_length_987_cov_42.784910	383	476	4	28	93	0.3010753
NODE_6862_length_987_cov_42.784910	383	476	6	47	93	0.5053763
NODE_6862_length_987_cov_42.784910	449	529	0	9	80	0.1125000
NODE_6862_length_987_cov_42.784910	449	529	2	32	80	0.4000000
NODE_6862_length_987_cov_42.784910	449	529	4	10	80	0.1250000
NODE_6862_length_987_cov_42.784910	449	529	6	29	80	0.3625000
NODE_6863_length_987_cov_39.716216	290	370	0	80	80	1.0000000
NODE_6863_length_987_cov_39.716216	343	423	0	80	80	1.0000000
NODE_6863_length_987_cov_39.716216	419	499	0	5	80	0.0625000
NODE_6863_length_987_cov_39.716216	419	499	2	59	80	0.7375000
NODE_6863_length_987_cov_39.716216	419	499	4	16	80	0.2000000
NODE_6863_length_987_cov_39.716216	472	552	2	11	80	0.1375000
NODE_6863_length_987_cov_39.716216	472	552	4	25	80	0.3125000
NODE_6863_length_987_cov_39.716216	472	552	6	44	80	0.5500000
NODE_6864_length_987_cov_28.171171	406	486	0	79	80	0.9875000
NODE_6864_length_987_cov_28.171171	406	486	2	1	80	0.0125000
NODE_6864_length_987_cov_28.171171	459	539	0	73	80	0.9125000
NODE_6864_length_987_cov_28.171171	459	539	2	7	80	0.0875000
NODE_6864_length_987_cov_28.171171	535	615	2	67	80	0.8375000
NODE_6864_length_987_cov_28.171171	535	615	4	13	80	0.1625000
NODE_6864_length_987_cov_28.171171	588	668	2	42	80	0.5250000
NODE_6864_length_987_cov_28.171171	588	668	4	38	80	0.4750000
NODE_6865_length_987_cov_23.627252	331	411	0	80	80	1.0000000
NODE_6865_length_987_cov_23.627252	384	464	0	80	80	1.0000000
NODE_6866_length_987_cov_18.797297	437	517	0	80	80	1.0000000
NODE_6866_length_987_cov_18.797297	490	570	0	80	80	1.0000000
NODE_6867_length_987_cov_15.628378	369	449	0	47	80	0.5875000
NODE_6867_length_987_cov_15.628378	369	449	2	32	80	0.4000000
NODE_6867_length_987_cov_15.628378	369	449	4	1	80	0.0125000
NODE_6867_length_987_cov_15.628378	422	502	2	44	80	0.5500000
NODE_6867_length_987_cov_15.628378	422	502	4	36	80	0.4500000
NODE_6868_length_987_cov_15.439189	438	518	0	12	80	0.1500000
NODE_6868_length_987_cov_15.439189	438	518	2	10	80	0.1250000
NODE_6868_length_987_cov_15.439189	438	518	4	58	80	0.7250000
NODE_6868_length_987_cov_15.439189	491	571	0	22	80	0.2750000
NODE_6868_length_987_cov_15.439189	491	571	2	4	80	0.0500000
NODE_6868_length_987_cov_15.439189	491	571	4	54	80	0.6750000
NODE_6869_length_987_cov_14.343468	506	586	0	80	80	1.0000000
NODE_6869_length_987_cov_14.343468	559	639	0	80	80	1.0000000
NODE_6870_length_987_cov_13.515766	475	555	0	80	80	1.0000000
NODE_6870_length_987_cov_13.515766	528	608	0	80	80	1.0000000
NODE_6871_length_987_cov_9.521396	408	482	0	37	74	0.5000000
NODE_6871_length_987_cov_9.521396	408	482	2	37	74	0.5000000
NODE_6871_length_987_cov_9.521396	455	535	2	80	80	1.0000000
NODE_6872_length_987_cov_9.054054	440	520	0	80	80	1.0000000
NODE_6872_length_987_cov_9.054054	493	573	0	31	80	0.3875000
NODE_6872_length_987_cov_9.054054	493	573	2	49	80	0.6125000
NODE_6875_length_987_cov_5.378378	509	589	0	39	80	0.4875000
NODE_6875_length_987_cov_5.378378	509	589	2	41	80	0.5125000
NODE_6875_length_987_cov_5.378378	562	642	2	80	80	1.0000000
NODE_6889_length_986_cov_36.937993	327	407	0	80	80	1.0000000
NODE_6889_length_986_cov_36.937993	380	460	0	80	80	1.0000000
NODE_6889_length_986_cov_36.937993	456	536	0	80	80	1.0000000
NODE_6889_length_986_cov_36.937993	509	589	0	80	80	1.0000000
NODE_6890_length_986_cov_35.130778	325	405	0	80	80	1.0000000
NODE_6890_length_986_cov_35.130778	378	458	0	80	80	1.0000000
NODE_6890_length_986_cov_35.130778	454	534	0	46	80	0.5750000
NODE_6890_length_986_cov_35.130778	454	534	2	4	80	0.0500000
NODE_6890_length_986_cov_35.130778	454	534	6	30	80	0.3750000
NODE_6890_length_986_cov_35.130778	507	587	3	13	80	0.1625000
NODE_6890_length_986_cov_35.130778	507	587	5	7	80	0.0875000
NODE_6890_length_986_cov_35.130778	507	587	6	60	80	0.7500000
NODE_6891_length_986_cov_24.037204	602	682	0	80	80	1.0000000
NODE_6891_length_986_cov_24.037204	655	735	0	68	80	0.8500000
NODE_6891_length_986_cov_24.037204	655	735	2	12	80	0.1500000
NODE_6891_length_986_cov_24.037204	731	811	0	9	80	0.1125000
NODE_6891_length_986_cov_24.037204	731	811	2	71	80	0.8875000
NODE_6891_length_986_cov_24.037204	784	864	0	62	80	0.7750000
NODE_6891_length_986_cov_24.037204	784	864	2	18	80	0.2250000
NODE_6892_length_986_cov_20.591883	395	475	2	80	80	1.0000000
NODE_6892_length_986_cov_20.591883	448	528	0	48	80	0.6000000
NODE_6892_length_986_cov_20.591883	448	528	2	32	80	0.4000000
NODE_6893_length_986_cov_16.815107	389	469	2	16	80	0.2000000
NODE_6893_length_986_cov_16.815107	389	469	4	64	80	0.8000000
NODE_6893_length_986_cov_16.815107	442	522	0	17	80	0.2125000
NODE_6893_length_986_cov_16.815107	442	522	1	2	80	0.0250000
NODE_6893_length_986_cov_16.815107	442	522	2	50	80	0.6250000
NODE_6893_length_986_cov_16.815107	442	522	4	11	80	0.1375000
NODE_6894_length_986_cov_11.021421	474	554	0	80	80	1.0000000
NODE_6894_length_986_cov_11.021421	527	607	0	80	80	1.0000000
NODE_6905_length_985_cov_41.707675	443	523	0	35	80	0.4375000
NODE_6905_length_985_cov_41.707675	443	523	2	45	80	0.5625000
NODE_6905_length_985_cov_41.707675	496	576	0	13	80	0.1625000
NODE_6905_length_985_cov_41.707675	496	576	2	67	80	0.8375000
NODE_6911_length_984_cov_64.531073	412	481	0	69	69	1.0000000
NODE_6911_length_984_cov_64.531073	454	534	0	80	80	1.0000000
NODE_6911_length_984_cov_64.531073	475	555	0	80	80	1.0000000
NODE_6911_length_984_cov_64.531073	528	608	0	80	80	1.0000000
NODE_6911_length_984_cov_64.531073	549	629	0	80	80	1.0000000
NODE_6912_length_984_cov_28.832768	430	510	0	36	80	0.4500000
NODE_6912_length_984_cov_28.832768	430	510	2	9	80	0.1125000
NODE_6912_length_984_cov_28.832768	430	510	4	4	80	0.0500000
NODE_6912_length_984_cov_28.832768	430	510	6	31	80	0.3875000
NODE_6912_length_984_cov_28.832768	483	563	2	1	80	0.0125000
NODE_6912_length_984_cov_28.832768	483	563	4	42	80	0.5250000
NODE_6912_length_984_cov_28.832768	483	563	6	37	80	0.4625000
NODE_6913_length_984_cov_27.247458	203	283	0	80	80	1.0000000
NODE_6913_length_984_cov_27.247458	256	336	0	71	80	0.8875000
NODE_6913_length_984_cov_27.247458	256	336	2	9	80	0.1125000
NODE_6913_length_984_cov_27.247458	332	412	0	11	80	0.1375000
NODE_6913_length_984_cov_27.247458	332	412	2	69	80	0.8625000
NODE_6913_length_984_cov_27.247458	385	465	0	39	80	0.4875000
NODE_6913_length_984_cov_27.247458	385	465	2	41	80	0.5125000
NODE_6914_length_984_cov_25.944633	483	563	2	44	80	0.5500000
NODE_6914_length_984_cov_25.944633	483	563	4	36	80	0.4500000
NODE_6914_length_984_cov_25.944633	536	616	0	44	80	0.5500000
NODE_6914_length_984_cov_25.944633	536	616	2	36	80	0.4500000
NODE_6915_length_984_cov_16.611299	351	431	0	10	80	0.1250000
NODE_6915_length_984_cov_16.611299	351	431	2	70	80	0.8750000
NODE_6915_length_984_cov_16.611299	404	484	0	52	80	0.6500000
NODE_6915_length_984_cov_16.611299	404	484	2	28	80	0.3500000
NODE_6917_length_984_cov_6.414689	415	495	2	40	80	0.5000000
NODE_6917_length_984_cov_6.414689	415	495	4	40	80	0.5000000
NODE_6917_length_984_cov_6.414689	468	548	2	80	80	1.0000000
NODE_6918_length_984_cov_4.720904	494	574	0	32	80	0.4000000
NODE_6918_length_984_cov_4.720904	494	574	2	48	80	0.6000000
NODE_6918_length_984_cov_4.720904	547	627	0	80	80	1.0000000
NODE_6927_length_984_cov_1.333333	922	971	0	28	49	0.5714286
NODE_6927_length_984_cov_1.333333	922	971	2	8	49	0.1632653
NODE_6927_length_984_cov_1.333333	922	971	5	3	49	0.0612245
NODE_6927_length_984_cov_1.333333	922	971	6	10	49	0.2040816
NODE_6931_length_983_cov_34.566742	466	546	0	45	80	0.5625000
NODE_6931_length_983_cov_34.566742	466	546	2	35	80	0.4375000
NODE_6931_length_983_cov_34.566742	519	599	2	80	80	1.0000000
NODE_6932_length_983_cov_26.011312	449	529	0	5	80	0.0625000
NODE_6932_length_983_cov_26.011312	449	529	2	75	80	0.9375000
NODE_6932_length_983_cov_26.011312	502	582	0	58	80	0.7250000
NODE_6932_length_983_cov_26.011312	502	582	2	22	80	0.2750000
NODE_6932_length_983_cov_26.011312	578	658	0	80	80	1.0000000
NODE_6932_length_983_cov_26.011312	631	711	0	80	80	1.0000000
NODE_6933_length_983_cov_24.694570	539	619	0	80	80	1.0000000
NODE_6933_length_983_cov_24.694570	592	672	0	80	80	1.0000000
NODE_6934_length_983_cov_22.214932	395	475	2	80	80	1.0000000
NODE_6934_length_983_cov_22.214932	448	528	0	48	80	0.6000000
NODE_6934_length_983_cov_22.214932	448	528	2	32	80	0.4000000
NODE_6935_length_983_cov_19.132353	377	457	0	65	80	0.8125000
NODE_6935_length_983_cov_19.132353	377	457	2	15	80	0.1875000
NODE_6935_length_983_cov_19.132353	430	510	0	80	80	1.0000000
NODE_6936_length_983_cov_16.875566	419	499	0	80	80	1.0000000
NODE_6936_length_983_cov_16.875566	472	552	0	80	80	1.0000000
NODE_6936_length_983_cov_16.875566	548	628	0	80	80	1.0000000
NODE_6936_length_983_cov_16.875566	601	681	0	80	80	1.0000000
NODE_6937_length_983_cov_7.240950	487	567	4	80	80	1.0000000
NODE_6937_length_983_cov_7.240950	540	620	0	30	80	0.3750000
NODE_6937_length_983_cov_7.240950	540	620	4	50	80	0.6250000
NODE_6949_length_982_cov_30.750849	357	437	0	20	80	0.2500000
NODE_6949_length_982_cov_30.750849	357	437	2	60	80	0.7500000
NODE_6949_length_982_cov_30.750849	410	490	0	52	80	0.6500000
NODE_6949_length_982_cov_30.750849	410	490	2	28	80	0.3500000
NODE_6950_length_982_cov_29.901472	516	596	0	80	80	1.0000000
NODE_6950_length_982_cov_29.901472	569	649	0	80	80	1.0000000
NODE_6951_length_982_cov_18.251416	356	436	0	11	80	0.1375000
NODE_6951_length_982_cov_18.251416	356	436	2	31	80	0.3875000
NODE_6951_length_982_cov_18.251416	356	436	4	38	80	0.4750000
NODE_6951_length_982_cov_18.251416	409	489	2	20	80	0.2500000
NODE_6951_length_982_cov_18.251416	409	489	4	45	80	0.5625000
NODE_6951_length_982_cov_18.251416	409	489	6	7	80	0.0875000
NODE_6951_length_982_cov_18.251416	409	489	8	7	80	0.0875000
NODE_6951_length_982_cov_18.251416	409	489	10	1	80	0.0125000
NODE_6951_length_982_cov_18.251416	485	565	6	10	80	0.1250000
NODE_6951_length_982_cov_18.251416	485	565	8	3	80	0.0375000
NODE_6951_length_982_cov_18.251416	485	565	10	67	80	0.8375000
NODE_6951_length_982_cov_18.251416	538	618	2	26	80	0.3250000
NODE_6951_length_982_cov_18.251416	538	618	6	37	80	0.4625000
NODE_6951_length_982_cov_18.251416	538	618	10	17	80	0.2125000
NODE_6952_length_982_cov_13.840317	608	688	4	5	80	0.0625000
NODE_6952_length_982_cov_13.840317	608	688	5	2	80	0.0250000
NODE_6952_length_982_cov_13.840317	608	688	6	12	80	0.1500000
NODE_6952_length_982_cov_13.840317	608	688	8	2	80	0.0250000
NODE_6952_length_982_cov_13.840317	608	688	10	59	80	0.7375000
NODE_6952_length_982_cov_13.840317	661	741	2	8	80	0.1000000
NODE_6952_length_982_cov_13.840317	661	741	3	9	80	0.1125000
NODE_6952_length_982_cov_13.840317	661	741	4	25	80	0.3125000
NODE_6952_length_982_cov_13.840317	661	741	8	13	80	0.1625000
NODE_6952_length_982_cov_13.840317	661	741	10	25	80	0.3125000
NODE_6953_length_982_cov_13.227633	317	397	0	45	80	0.5625000
NODE_6953_length_982_cov_13.227633	317	397	2	35	80	0.4375000
NODE_6953_length_982_cov_13.227633	370	450	2	80	80	1.0000000
NODE_6954_length_982_cov_10.918460	209	289	0	31	80	0.3875000
NODE_6954_length_982_cov_10.918460	209	289	2	49	80	0.6125000
NODE_6954_length_982_cov_10.918460	262	342	0	14	80	0.1750000
NODE_6954_length_982_cov_10.918460	262	342	2	66	80	0.8250000
NODE_6956_length_982_cov_7.210646	216	296	0	80	80	1.0000000
NODE_6956_length_982_cov_7.210646	269	349	0	80	80	1.0000000
NODE_6973_length_981_cov_55.260771	410	490	3	55	80	0.6875000
NODE_6973_length_981_cov_55.260771	410	490	4	25	80	0.3125000
NODE_6973_length_981_cov_55.260771	463	543	2	10	80	0.1250000
NODE_6973_length_981_cov_55.260771	463	543	3	2	80	0.0250000
NODE_6973_length_981_cov_55.260771	463	543	4	40	80	0.5000000
NODE_6973_length_981_cov_55.260771	463	543	6	28	80	0.3500000
NODE_6973_length_981_cov_55.260771	539	619	0	3	80	0.0375000
NODE_6973_length_981_cov_55.260771	539	619	2	7	80	0.0875000
NODE_6973_length_981_cov_55.260771	539	619	4	12	80	0.1500000
NODE_6973_length_981_cov_55.260771	539	619	6	58	80	0.7250000
NODE_6973_length_981_cov_55.260771	592	672	0	56	80	0.7000000
NODE_6973_length_981_cov_55.260771	592	672	2	7	80	0.0875000
NODE_6973_length_981_cov_55.260771	592	672	4	12	80	0.1500000
NODE_6973_length_981_cov_55.260771	592	672	6	5	80	0.0625000
NODE_6974_length_981_cov_33.287982	362	441	0	79	79	1.0000000
NODE_6974_length_981_cov_33.287982	414	495	0	81	81	1.0000000
NODE_6974_length_981_cov_33.287982	491	571	0	39	80	0.4875000
NODE_6974_length_981_cov_33.287982	491	571	2	41	80	0.5125000
NODE_6974_length_981_cov_33.287982	544	624	2	80	80	1.0000000
NODE_6975_length_981_cov_33.121315	269	349	0	20	80	0.2500000
NODE_6975_length_981_cov_33.121315	269	349	2	60	80	0.7500000
NODE_6975_length_981_cov_33.121315	322	402	0	40	80	0.5000000
NODE_6975_length_981_cov_33.121315	322	402	2	40	80	0.5000000
NODE_6975_length_981_cov_33.121315	398	478	0	47	80	0.5875000
NODE_6975_length_981_cov_33.121315	398	478	2	33	80	0.4125000
NODE_6975_length_981_cov_33.121315	451	531	0	80	80	1.0000000
NODE_6976_length_981_cov_26.732426	397	477	0	80	80	1.0000000
NODE_6976_length_981_cov_26.732426	450	530	0	80	80	1.0000000
NODE_6977_length_981_cov_24.304989	390	470	0	80	80	1.0000000
NODE_6977_length_981_cov_24.304989	443	523	0	80	80	1.0000000
NODE_6978_length_981_cov_10.485261	363	443	0	16	80	0.2000000
NODE_6978_length_981_cov_10.485261	363	443	2	64	80	0.8000000
NODE_6978_length_981_cov_10.485261	416	496	2	80	80	1.0000000
NODE_6980_length_981_cov_5.328798	821	885	2	64	64	1.0000000
NODE_6980_length_981_cov_5.328798	847	884	2	37	37	1.0000000
NODE_6998_length_980_cov_40.710556	329	409	2	80	80	1.0000000
NODE_6998_length_980_cov_40.710556	382	462	0	28	80	0.3500000
NODE_6998_length_980_cov_40.710556	382	462	2	52	80	0.6500000
NODE_6998_length_980_cov_40.710556	458	538	0	80	80	1.0000000
NODE_6998_length_980_cov_40.710556	511	591	0	80	80	1.0000000
NODE_6999_length_980_cov_37.634506	666	746	0	80	80	1.0000000
NODE_6999_length_980_cov_37.634506	719	799	0	80	80	1.0000000
NODE_7000_length_980_cov_36.261067	331	411	4	80	80	1.0000000
NODE_7000_length_980_cov_36.261067	384	453	0	17	69	0.2463768
NODE_7000_length_980_cov_36.261067	384	453	3	1	69	0.0144928
NODE_7000_length_980_cov_36.261067	384	453	4	51	69	0.7391304
NODE_7000_length_980_cov_36.261067	465	545	0	2	80	0.0250000
NODE_7000_length_980_cov_36.261067	465	545	2	53	80	0.6625000
NODE_7000_length_980_cov_36.261067	465	545	4	25	80	0.3125000
NODE_7000_length_980_cov_36.261067	518	598	2	2	80	0.0250000
NODE_7000_length_980_cov_36.261067	518	598	4	43	80	0.5375000
NODE_7000_length_980_cov_36.261067	518	598	6	35	80	0.4375000
NODE_7001_length_980_cov_28.514188	430	510	0	80	80	1.0000000
NODE_7001_length_980_cov_28.514188	483	563	0	80	80	1.0000000
NODE_7002_length_980_cov_25.205448	497	577	0	6	80	0.0750000
NODE_7002_length_980_cov_25.205448	497	577	2	74	80	0.9250000
NODE_7002_length_980_cov_25.205448	550	630	0	31	80	0.3875000
NODE_7002_length_980_cov_25.205448	550	630	2	49	80	0.6125000
NODE_7003_length_980_cov_24.321226	417	497	0	6	80	0.0750000
NODE_7003_length_980_cov_24.321226	417	497	2	74	80	0.9250000
NODE_7003_length_980_cov_24.321226	470	550	0	38	80	0.4750000
NODE_7003_length_980_cov_24.321226	470	550	2	42	80	0.5250000
NODE_7004_length_980_cov_20.460840	388	468	0	80	80	1.0000000
NODE_7004_length_980_cov_20.460840	441	521	0	66	80	0.8250000
NODE_7004_length_980_cov_20.460840	441	521	2	14	80	0.1750000
NODE_7005_length_980_cov_19.969353	486	566	0	21	80	0.2625000
NODE_7005_length_980_cov_19.969353	486	566	2	59	80	0.7375000
NODE_7005_length_980_cov_19.969353	539	619	0	58	80	0.7250000
NODE_7005_length_980_cov_19.969353	539	619	2	22	80	0.2750000
NODE_7006_length_980_cov_13.736663	350	430	0	31	80	0.3875000
NODE_7006_length_980_cov_13.736663	350	430	2	49	80	0.6125000
NODE_7006_length_980_cov_13.736663	403	483	0	24	80	0.3000000
NODE_7006_length_980_cov_13.736663	403	483	2	56	80	0.7000000
NODE_7006_length_980_cov_13.736663	479	559	0	80	80	1.0000000
NODE_7006_length_980_cov_13.736663	532	612	0	80	80	1.0000000
NODE_7008_length_980_cov_10.842225	517	597	0	80	80	1.0000000
NODE_7008_length_980_cov_10.842225	570	650	0	80	80	1.0000000
NODE_7009_length_980_cov_10.087401	341	424	1	4	83	0.0481928
NODE_7009_length_980_cov_10.087401	341	424	2	13	83	0.1566265
NODE_7009_length_980_cov_10.087401	341	424	3	66	83	0.7951807
NODE_7009_length_980_cov_10.087401	397	477	0	46	80	0.5750000
NODE_7009_length_980_cov_10.087401	397	477	2	20	80	0.2500000
NODE_7009_length_980_cov_10.087401	397	477	3	14	80	0.1750000
NODE_7010_length_980_cov_9.643587	267	347	0	80	80	1.0000000
NODE_7010_length_980_cov_9.643587	320	400	0	80	80	1.0000000
NODE_7010_length_980_cov_9.643587	396	476	0	18	80	0.2250000
NODE_7010_length_980_cov_9.643587	396	476	6	37	80	0.4625000
NODE_7010_length_980_cov_9.643587	396	476	8	25	80	0.3125000
NODE_7010_length_980_cov_9.643587	449	529	6	35	80	0.4375000
NODE_7010_length_980_cov_9.643587	449	529	8	45	80	0.5625000
NODE_7026_length_979_cov_22.576136	442	522	0	80	80	1.0000000
NODE_7026_length_979_cov_22.576136	495	575	0	80	80	1.0000000
NODE_7027_length_979_cov_19.739773	445	524	0	79	79	1.0000000
NODE_7027_length_979_cov_19.739773	497	577	0	80	80	1.0000000
NODE_7028_length_979_cov_19.480682	436	516	0	80	80	1.0000000
NODE_7028_length_979_cov_19.480682	489	569	0	66	80	0.8250000
NODE_7028_length_979_cov_19.480682	489	569	2	14	80	0.1750000
NODE_7028_length_979_cov_19.480682	565	645	2	60	80	0.7500000
NODE_7028_length_979_cov_19.480682	565	645	4	20	80	0.2500000
NODE_7028_length_979_cov_19.480682	618	698	2	44	80	0.5500000
NODE_7028_length_979_cov_19.480682	618	698	4	36	80	0.4500000
NODE_7029_length_979_cov_18.901136	470	550	0	80	80	1.0000000
NODE_7029_length_979_cov_18.901136	523	603	0	80	80	1.0000000
NODE_7031_length_979_cov_3.519318	101	168	0	6	67	0.0895522
NODE_7031_length_979_cov_3.519318	101	168	2	13	67	0.1940299
NODE_7031_length_979_cov_3.519318	101	168	4	48	67	0.7164179
NODE_7040_length_978_cov_23.195677	424	504	2	10	80	0.1250000
NODE_7040_length_978_cov_23.195677	424	504	4	19	80	0.2375000
NODE_7040_length_978_cov_23.195677	424	504	6	51	80	0.6375000
NODE_7040_length_978_cov_23.195677	477	557	0	18	80	0.2250000
NODE_7040_length_978_cov_23.195677	477	557	4	54	80	0.6750000
NODE_7040_length_978_cov_23.195677	477	557	6	8	80	0.1000000
NODE_7041_length_978_cov_18.866894	440	520	0	13	80	0.1625000
NODE_7041_length_978_cov_18.866894	440	520	2	30	80	0.3750000
NODE_7041_length_978_cov_18.866894	440	520	4	37	80	0.4625000
NODE_7041_length_978_cov_18.866894	493	573	0	15	80	0.1875000
NODE_7041_length_978_cov_18.866894	493	573	2	10	80	0.1250000
NODE_7041_length_978_cov_18.866894	493	573	4	55	80	0.6875000
NODE_7042_length_978_cov_15.614334	341	421	0	80	80	1.0000000
NODE_7042_length_978_cov_15.614334	394	474	0	80	80	1.0000000
NODE_7042_length_978_cov_15.614334	470	550	0	80	80	1.0000000
NODE_7042_length_978_cov_15.614334	523	603	0	80	80	1.0000000
NODE_7043_length_978_cov_15.253697	327	407	0	80	80	1.0000000
NODE_7043_length_978_cov_15.253697	380	460	0	72	80	0.9000000
NODE_7043_length_978_cov_15.253697	380	460	2	8	80	0.1000000
NODE_7043_length_978_cov_15.253697	456	536	2	80	80	1.0000000
NODE_7043_length_978_cov_15.253697	509	589	0	33	80	0.4125000
NODE_7043_length_978_cov_15.253697	509	589	2	47	80	0.5875000
NODE_7044_length_978_cov_14.730375	407	487	0	14	80	0.1750000
NODE_7044_length_978_cov_14.730375	407	487	2	66	80	0.8250000
NODE_7044_length_978_cov_14.730375	460	540	0	22	80	0.2750000
NODE_7044_length_978_cov_14.730375	460	540	2	58	80	0.7250000
NODE_7045_length_978_cov_7.257110	571	651	0	48	80	0.6000000
NODE_7045_length_978_cov_7.257110	571	651	2	32	80	0.4000000
NODE_7045_length_978_cov_7.257110	624	704	2	80	80	1.0000000
NODE_7062_length_977_cov_47.484055	427	507	0	80	80	1.0000000
NODE_7062_length_977_cov_47.484055	480	560	0	80	80	1.0000000
NODE_7063_length_977_cov_47.116173	428	508	0	80	80	1.0000000
NODE_7063_length_977_cov_47.116173	481	561	0	80	80	1.0000000
NODE_7063_length_977_cov_47.116173	557	637	0	80	80	1.0000000
NODE_7063_length_977_cov_47.116173	610	690	0	80	80	1.0000000
NODE_7064_length_977_cov_32.542141	486	566	0	80	80	1.0000000
NODE_7064_length_977_cov_32.542141	539	619	0	80	80	1.0000000
NODE_7065_length_977_cov_30.676538	361	441	0	13	80	0.1625000
NODE_7065_length_977_cov_30.676538	361	441	1	9	80	0.1125000
NODE_7065_length_977_cov_30.676538	361	441	3	30	80	0.3750000
NODE_7065_length_977_cov_30.676538	361	441	5	20	80	0.2500000
NODE_7065_length_977_cov_30.676538	361	441	6	8	80	0.1000000
NODE_7065_length_977_cov_30.676538	414	494	4	11	80	0.1375000
NODE_7065_length_977_cov_30.676538	414	494	5	19	80	0.2375000
NODE_7065_length_977_cov_30.676538	414	494	6	50	80	0.6250000
NODE_7066_length_977_cov_28.348519	455	535	0	80	80	1.0000000
NODE_7066_length_977_cov_28.348519	508	588	0	80	80	1.0000000
NODE_7067_length_977_cov_26.571754	343	423	6	34	80	0.4250000
NODE_7067_length_977_cov_26.571754	343	423	8	46	80	0.5750000
NODE_7067_length_977_cov_26.571754	396	476	0	3	80	0.0375000
NODE_7067_length_977_cov_26.571754	396	476	2	45	80	0.5625000
NODE_7067_length_977_cov_26.571754	396	476	8	32	80	0.4000000
NODE_7067_length_977_cov_26.571754	472	552	0	79	80	0.9875000
NODE_7067_length_977_cov_26.571754	472	552	2	1	80	0.0125000
NODE_7067_length_977_cov_26.571754	525	600	0	75	75	1.0000000
NODE_7068_length_977_cov_24.898633	470	550	0	61	80	0.7625000
NODE_7068_length_977_cov_24.898633	470	550	2	19	80	0.2375000
NODE_7068_length_977_cov_24.898633	523	603	0	15	80	0.1875000
NODE_7068_length_977_cov_24.898633	523	603	2	65	80	0.8125000
NODE_7069_length_977_cov_22.986333	313	393	0	56	80	0.7000000
NODE_7069_length_977_cov_22.986333	313	393	6	24	80	0.3000000
NODE_7069_length_977_cov_22.986333	366	446	0	5	80	0.0625000
NODE_7069_length_977_cov_22.986333	366	446	2	4	80	0.0500000
NODE_7069_length_977_cov_22.986333	366	446	4	2	80	0.0250000
NODE_7069_length_977_cov_22.986333	366	446	6	69	80	0.8625000
NODE_7069_length_977_cov_22.986333	442	522	0	31	80	0.3875000
NODE_7069_length_977_cov_22.986333	442	522	2	49	80	0.6125000
NODE_7069_length_977_cov_22.986333	495	575	0	13	80	0.1625000
NODE_7069_length_977_cov_22.986333	495	575	2	67	80	0.8375000
NODE_7070_length_977_cov_10.753986	290	370	0	10	80	0.1250000
NODE_7070_length_977_cov_10.753986	290	370	4	70	80	0.8750000
NODE_7070_length_977_cov_10.753986	343	423	0	46	80	0.5750000
NODE_7070_length_977_cov_10.753986	343	423	2	17	80	0.2125000
NODE_7070_length_977_cov_10.753986	343	423	4	17	80	0.2125000
NODE_7071_length_977_cov_9.924829	401	456	2	7	55	0.1272727
NODE_7071_length_977_cov_9.924829	401	456	4	48	55	0.8727273
NODE_7073_length_977_cov_6.391800	483	563	0	80	80	1.0000000
NODE_7073_length_977_cov_6.391800	536	616	0	80	80	1.0000000
NODE_7075_length_977_cov_2.907745	191	241	2	22	50	0.4400000
NODE_7075_length_977_cov_2.907745	191	241	4	25	50	0.5000000
NODE_7075_length_977_cov_2.907745	191	241	6	3	50	0.0600000
NODE_7085_length_976_cov_38.192702	326	406	0	80	80	1.0000000
NODE_7085_length_976_cov_38.192702	379	459	0	80	80	1.0000000
NODE_7085_length_976_cov_38.192702	455	535	0	72	80	0.9000000
NODE_7085_length_976_cov_38.192702	455	535	2	8	80	0.1000000
NODE_7085_length_976_cov_38.192702	455	536	0	72	81	0.8888889
NODE_7085_length_976_cov_38.192702	455	536	2	9	81	0.1111111
NODE_7085_length_976_cov_38.192702	455	519	0	64	64	1.0000000
NODE_7085_length_976_cov_38.192702	508	588	0	19	80	0.2375000
NODE_7085_length_976_cov_38.192702	508	588	2	61	80	0.7625000
NODE_7086_length_976_cov_26.275941	499	579	0	67	80	0.8375000
NODE_7086_length_976_cov_26.275941	499	579	2	13	80	0.1625000
NODE_7086_length_976_cov_26.275941	552	632	0	14	80	0.1750000
NODE_7086_length_976_cov_26.275941	552	632	2	21	80	0.2625000
NODE_7086_length_976_cov_26.275941	552	632	3	39	80	0.4875000
NODE_7086_length_976_cov_26.275941	552	632	4	6	80	0.0750000
NODE_7087_length_976_cov_25.559863	376	456	0	80	80	1.0000000
NODE_7087_length_976_cov_25.559863	429	509	0	31	80	0.3875000
NODE_7087_length_976_cov_25.559863	429	509	2	49	80	0.6125000
NODE_7088_length_976_cov_17.961231	572	652	0	46	80	0.5750000
NODE_7088_length_976_cov_17.961231	572	652	1	7	80	0.0875000
NODE_7088_length_976_cov_17.961231	572	652	2	2	80	0.0250000
NODE_7088_length_976_cov_17.961231	572	652	3	25	80	0.3125000
NODE_7088_length_976_cov_17.961231	625	705	2	2	80	0.0250000
NODE_7088_length_976_cov_17.961231	625	705	3	78	80	0.9750000
NODE_7089_length_976_cov_5.567845	789	851	0	8	62	0.1290323
NODE_7089_length_976_cov_5.567845	789	851	2	54	62	0.8709677
NODE_7089_length_976_cov_5.567845	842	904	0	2	62	0.0322581
NODE_7089_length_976_cov_5.567845	842	904	2	60	62	0.9677419
NODE_7101_length_975_cov_192.211187	722	802	42	2	80	0.0250000
NODE_7101_length_975_cov_192.211187	722	802	44	2	80	0.0250000
NODE_7101_length_975_cov_192.211187	722	802	46	11	80	0.1375000
NODE_7101_length_975_cov_192.211187	722	802	47	14	80	0.1750000
NODE_7101_length_975_cov_192.211187	722	802	48	6	80	0.0750000
NODE_7101_length_975_cov_192.211187	722	802	49	2	80	0.0250000
NODE_7101_length_975_cov_192.211187	722	802	51	2	80	0.0250000
NODE_7101_length_975_cov_192.211187	722	802	54	3	80	0.0375000
NODE_7101_length_975_cov_192.211187	722	802	55	4	80	0.0500000
NODE_7101_length_975_cov_192.211187	722	802	56	1	80	0.0125000
NODE_7101_length_975_cov_192.211187	722	802	57	9	80	0.1125000
NODE_7101_length_975_cov_192.211187	722	802	58	10	80	0.1250000
NODE_7101_length_975_cov_192.211187	722	802	59	1	80	0.0125000
NODE_7101_length_975_cov_192.211187	722	802	60	1	80	0.0125000
NODE_7101_length_975_cov_192.211187	722	802	62	1	80	0.0125000
NODE_7101_length_975_cov_192.211187	722	802	63	1	80	0.0125000
NODE_7101_length_975_cov_192.211187	722	802	65	1	80	0.0125000
NODE_7101_length_975_cov_192.211187	722	802	67	3	80	0.0375000
NODE_7101_length_975_cov_192.211187	722	802	69	1	80	0.0125000
NODE_7101_length_975_cov_192.211187	722	802	71	2	80	0.0250000
NODE_7101_length_975_cov_192.211187	722	802	73	3	80	0.0375000
NODE_7102_length_975_cov_41.446347	414	494	0	80	80	1.0000000
NODE_7102_length_975_cov_41.446347	467	547	0	80	80	1.0000000
NODE_7103_length_975_cov_37.618721	375	455	10	6	80	0.0750000
NODE_7103_length_975_cov_37.618721	375	455	12	23	80	0.2875000
NODE_7103_length_975_cov_37.618721	375	455	14	26	80	0.3250000
NODE_7103_length_975_cov_37.618721	375	455	16	25	80	0.3125000
NODE_7103_length_975_cov_37.618721	428	508	2	15	80	0.1875000
NODE_7103_length_975_cov_37.618721	428	508	8	18	80	0.2250000
NODE_7103_length_975_cov_37.618721	428	508	10	26	80	0.3250000
NODE_7103_length_975_cov_37.618721	428	508	12	3	80	0.0375000
NODE_7103_length_975_cov_37.618721	428	508	14	4	80	0.0500000
NODE_7103_length_975_cov_37.618721	428	508	16	14	80	0.1750000
NODE_7104_length_975_cov_34.265982	424	504	0	80	80	1.0000000
NODE_7104_length_975_cov_34.265982	477	557	0	80	80	1.0000000
NODE_7105_length_975_cov_31.888128	461	541	2	80	80	1.0000000
NODE_7105_length_975_cov_31.888128	514	594	0	21	80	0.2625000
NODE_7105_length_975_cov_31.888128	514	594	2	59	80	0.7375000
NODE_7106_length_975_cov_22.093607	392	472	0	80	80	1.0000000
NODE_7106_length_975_cov_22.093607	445	525	0	80	80	1.0000000
NODE_7107_length_975_cov_15.091324	403	483	1	40	80	0.5000000
NODE_7107_length_975_cov_15.091324	403	483	2	40	80	0.5000000
NODE_7107_length_975_cov_15.091324	456	536	0	9	80	0.1125000
NODE_7107_length_975_cov_15.091324	456	536	1	71	80	0.8875000
NODE_7108_length_975_cov_15.046804	63	143	4	30	80	0.3750000
NODE_7108_length_975_cov_15.046804	63	143	6	50	80	0.6250000
NODE_7108_length_975_cov_15.046804	116	196	0	44	80	0.5500000
NODE_7108_length_975_cov_15.046804	116	196	2	8	80	0.1000000
NODE_7108_length_975_cov_15.046804	116	196	4	21	80	0.2625000
NODE_7108_length_975_cov_15.046804	116	196	6	7	80	0.0875000
NODE_7109_length_975_cov_12.043379	535	615	6	80	80	1.0000000
NODE_7109_length_975_cov_12.043379	588	668	0	51	80	0.6375000
NODE_7109_length_975_cov_12.043379	588	668	6	29	80	0.3625000
NODE_7110_length_975_cov_11.772831	276	354	0	78	78	1.0000000
NODE_7110_length_975_cov_11.772831	327	407	0	80	80	1.0000000
NODE_7111_length_975_cov_10.599315	405	485	0	80	80	1.0000000
NODE_7111_length_975_cov_10.599315	458	538	0	80	80	1.0000000
NODE_7112_length_975_cov_8.089041	430	510	0	53	80	0.6625000
NODE_7112_length_975_cov_8.089041	430	510	2	27	80	0.3375000
NODE_7112_length_975_cov_8.089041	483	563	2	80	80	1.0000000
NODE_7114_length_975_cov_3.728311	254	334	0	5	80	0.0625000
NODE_7114_length_975_cov_3.728311	254	334	2	23	80	0.2875000
NODE_7114_length_975_cov_3.728311	254	334	4	52	80	0.6500000
NODE_7114_length_975_cov_3.728311	307	387	0	7	80	0.0875000
NODE_7114_length_975_cov_3.728311	307	387	2	16	80	0.2000000
NODE_7114_length_975_cov_3.728311	307	387	4	57	80	0.7125000
NODE_7125_length_974_cov_293.334857	564	642	109	3	78	0.0384615
NODE_7125_length_974_cov_293.334857	564	642	110	1	78	0.0128205
NODE_7125_length_974_cov_293.334857	564	642	112	2	78	0.0256410
NODE_7125_length_974_cov_293.334857	564	642	114	1	78	0.0128205
NODE_7125_length_974_cov_293.334857	564	642	115	3	78	0.0384615
NODE_7125_length_974_cov_293.334857	564	642	117	1	78	0.0128205
NODE_7125_length_974_cov_293.334857	564	642	118	3	78	0.0384615
NODE_7125_length_974_cov_293.334857	564	642	119	6	78	0.0769231
NODE_7125_length_974_cov_293.334857	564	642	120	1	78	0.0128205
NODE_7125_length_974_cov_293.334857	564	642	121	4	78	0.0512821
NODE_7125_length_974_cov_293.334857	564	642	122	5	78	0.0641026
NODE_7125_length_974_cov_293.334857	564	642	123	1	78	0.0128205
NODE_7125_length_974_cov_293.334857	564	642	124	3	78	0.0384615
NODE_7125_length_974_cov_293.334857	564	642	125	6	78	0.0769231
NODE_7125_length_974_cov_293.334857	564	642	126	4	78	0.0512821
NODE_7125_length_974_cov_293.334857	564	642	128	2	78	0.0256410
NODE_7125_length_974_cov_293.334857	564	642	129	1	78	0.0128205
NODE_7125_length_974_cov_293.334857	564	642	130	2	78	0.0256410
NODE_7125_length_974_cov_293.334857	564	642	131	2	78	0.0256410
NODE_7125_length_974_cov_293.334857	564	642	132	7	78	0.0897436
NODE_7125_length_974_cov_293.334857	564	642	134	1	78	0.0128205
NODE_7125_length_974_cov_293.334857	564	642	135	2	78	0.0256410
NODE_7125_length_974_cov_293.334857	564	642	136	4	78	0.0512821
NODE_7125_length_974_cov_293.334857	564	642	137	1	78	0.0128205
NODE_7125_length_974_cov_293.334857	564	642	138	1	78	0.0128205
NODE_7125_length_974_cov_293.334857	564	642	140	1	78	0.0128205
NODE_7125_length_974_cov_293.334857	564	642	145	1	78	0.0128205
NODE_7125_length_974_cov_293.334857	564	642	149	1	78	0.0128205
NODE_7125_length_974_cov_293.334857	564	642	151	1	78	0.0128205
NODE_7125_length_974_cov_293.334857	564	642	153	1	78	0.0128205
NODE_7125_length_974_cov_293.334857	564	642	155	1	78	0.0128205
NODE_7125_length_974_cov_293.334857	564	642	156	1	78	0.0128205
NODE_7125_length_974_cov_293.334857	564	642	158	1	78	0.0128205
NODE_7125_length_974_cov_293.334857	564	642	163	1	78	0.0128205
NODE_7125_length_974_cov_293.334857	564	642	168	1	78	0.0128205
NODE_7125_length_974_cov_293.334857	564	642	170	1	78	0.0128205
NODE_7125_length_974_cov_293.334857	564	642	109	3	78	0.0384615
NODE_7125_length_974_cov_293.334857	564	642	110	1	78	0.0128205
NODE_7125_length_974_cov_293.334857	564	642	112	2	78	0.0256410
NODE_7125_length_974_cov_293.334857	564	642	114	1	78	0.0128205
NODE_7125_length_974_cov_293.334857	564	642	115	3	78	0.0384615
NODE_7125_length_974_cov_293.334857	564	642	117	1	78	0.0128205
NODE_7125_length_974_cov_293.334857	564	642	118	3	78	0.0384615
NODE_7125_length_974_cov_293.334857	564	642	119	6	78	0.0769231
NODE_7125_length_974_cov_293.334857	564	642	120	1	78	0.0128205
NODE_7125_length_974_cov_293.334857	564	642	121	4	78	0.0512821
NODE_7125_length_974_cov_293.334857	564	642	122	5	78	0.0641026
NODE_7125_length_974_cov_293.334857	564	642	123	1	78	0.0128205
NODE_7125_length_974_cov_293.334857	564	642	124	3	78	0.0384615
NODE_7125_length_974_cov_293.334857	564	642	125	6	78	0.0769231
NODE_7125_length_974_cov_293.334857	564	642	126	4	78	0.0512821
NODE_7125_length_974_cov_293.334857	564	642	128	2	78	0.0256410
NODE_7125_length_974_cov_293.334857	564	642	129	1	78	0.0128205
NODE_7125_length_974_cov_293.334857	564	642	130	2	78	0.0256410
NODE_7125_length_974_cov_293.334857	564	642	131	2	78	0.0256410
NODE_7125_length_974_cov_293.334857	564	642	132	7	78	0.0897436
NODE_7125_length_974_cov_293.334857	564	642	134	1	78	0.0128205
NODE_7125_length_974_cov_293.334857	564	642	135	2	78	0.0256410
NODE_7125_length_974_cov_293.334857	564	642	136	4	78	0.0512821
NODE_7125_length_974_cov_293.334857	564	642	137	1	78	0.0128205
NODE_7125_length_974_cov_293.334857	564	642	138	1	78	0.0128205
NODE_7125_length_974_cov_293.334857	564	642	140	1	78	0.0128205
NODE_7125_length_974_cov_293.334857	564	642	145	1	78	0.0128205
NODE_7125_length_974_cov_293.334857	564	642	149	1	78	0.0128205
NODE_7125_length_974_cov_293.334857	564	642	151	1	78	0.0128205
NODE_7125_length_974_cov_293.334857	564	642	153	1	78	0.0128205
NODE_7125_length_974_cov_293.334857	564	642	155	1	78	0.0128205
NODE_7125_length_974_cov_293.334857	564	642	156	1	78	0.0128205
NODE_7125_length_974_cov_293.334857	564	642	158	1	78	0.0128205
NODE_7125_length_974_cov_293.334857	564	642	163	1	78	0.0128205
NODE_7125_length_974_cov_293.334857	564	642	168	1	78	0.0128205
NODE_7125_length_974_cov_293.334857	564	642	170	1	78	0.0128205
NODE_7125_length_974_cov_293.334857	564	633	109	3	69	0.0434783
NODE_7125_length_974_cov_293.334857	564	633	110	1	69	0.0144928
NODE_7125_length_974_cov_293.334857	564	633	112	2	69	0.0289855
NODE_7125_length_974_cov_293.334857	564	633	114	1	69	0.0144928
NODE_7125_length_974_cov_293.334857	564	633	115	3	69	0.0434783
NODE_7125_length_974_cov_293.334857	564	633	117	1	69	0.0144928
NODE_7125_length_974_cov_293.334857	564	633	118	2	69	0.0289855
NODE_7125_length_974_cov_293.334857	564	633	119	4	69	0.0579710
NODE_7125_length_974_cov_293.334857	564	633	120	1	69	0.0144928
NODE_7125_length_974_cov_293.334857	564	633	121	4	69	0.0579710
NODE_7125_length_974_cov_293.334857	564	633	122	4	69	0.0579710
NODE_7125_length_974_cov_293.334857	564	633	124	3	69	0.0434783
NODE_7125_length_974_cov_293.334857	564	633	125	6	69	0.0869565
NODE_7125_length_974_cov_293.334857	564	633	126	4	69	0.0579710
NODE_7125_length_974_cov_293.334857	564	633	128	2	69	0.0289855
NODE_7125_length_974_cov_293.334857	564	633	129	1	69	0.0144928
NODE_7125_length_974_cov_293.334857	564	633	130	1	69	0.0144928
NODE_7125_length_974_cov_293.334857	564	633	131	2	69	0.0289855
NODE_7125_length_974_cov_293.334857	564	633	132	4	69	0.0579710
NODE_7125_length_974_cov_293.334857	564	633	134	1	69	0.0144928
NODE_7125_length_974_cov_293.334857	564	633	135	2	69	0.0289855
NODE_7125_length_974_cov_293.334857	564	633	136	4	69	0.0579710
NODE_7125_length_974_cov_293.334857	564	633	137	1	69	0.0144928
NODE_7125_length_974_cov_293.334857	564	633	138	1	69	0.0144928
NODE_7125_length_974_cov_293.334857	564	633	140	1	69	0.0144928
NODE_7125_length_974_cov_293.334857	564	633	145	1	69	0.0144928
NODE_7125_length_974_cov_293.334857	564	633	149	1	69	0.0144928
NODE_7125_length_974_cov_293.334857	564	633	151	1	69	0.0144928
NODE_7125_length_974_cov_293.334857	564	633	153	1	69	0.0144928
NODE_7125_length_974_cov_293.334857	564	633	155	1	69	0.0144928
NODE_7125_length_974_cov_293.334857	564	633	156	1	69	0.0144928
NODE_7125_length_974_cov_293.334857	564	633	158	1	69	0.0144928
NODE_7125_length_974_cov_293.334857	564	633	163	1	69	0.0144928
NODE_7125_length_974_cov_293.334857	564	633	168	1	69	0.0144928
NODE_7125_length_974_cov_293.334857	564	633	170	1	69	0.0144928
NODE_7126_length_974_cov_49.884571	459	539	2	12	80	0.1500000
NODE_7126_length_974_cov_49.884571	459	539	4	2	80	0.0250000
NODE_7126_length_974_cov_49.884571	459	539	6	41	80	0.5125000
NODE_7126_length_974_cov_49.884571	459	539	7	2	80	0.0250000
NODE_7126_length_974_cov_49.884571	459	539	8	23	80	0.2875000
NODE_7126_length_974_cov_49.884571	512	592	2	65	80	0.8125000
NODE_7126_length_974_cov_49.884571	512	592	4	2	80	0.0250000
NODE_7126_length_974_cov_49.884571	512	592	6	13	80	0.1625000
NODE_7127_length_974_cov_38.384000	430	508	0	78	78	1.0000000
NODE_7127_length_974_cov_38.384000	483	561	0	78	78	1.0000000
NODE_7128_length_974_cov_26.008000	391	471	0	80	80	1.0000000
NODE_7128_length_974_cov_26.008000	444	524	0	30	80	0.3750000
NODE_7128_length_974_cov_26.008000	444	524	2	50	80	0.6250000
NODE_7128_length_974_cov_26.008000	520	600	2	63	80	0.7875000
NODE_7128_length_974_cov_26.008000	520	600	4	17	80	0.2125000
NODE_7128_length_974_cov_26.008000	573	653	2	69	80	0.8625000
NODE_7128_length_974_cov_26.008000	573	653	4	11	80	0.1375000
NODE_7129_length_974_cov_21.160000	460	540	1	1	80	0.0125000
NODE_7129_length_974_cov_21.160000	460	540	2	79	80	0.9875000
NODE_7129_length_974_cov_21.160000	513	593	2	36	80	0.4500000
NODE_7129_length_974_cov_21.160000	513	593	4	44	80	0.5500000
NODE_7131_length_974_cov_11.384000	290	370	0	80	80	1.0000000
NODE_7131_length_974_cov_11.384000	343	423	0	80	80	1.0000000
NODE_7132_length_974_cov_11.216000	543	623	0	80	80	1.0000000
NODE_7132_length_974_cov_11.216000	596	668	0	72	72	1.0000000
NODE_7133_length_974_cov_9.601143	436	516	0	75	80	0.9375000
NODE_7133_length_974_cov_9.601143	436	516	2	5	80	0.0625000
NODE_7133_length_974_cov_9.601143	489	569	0	80	80	1.0000000
NODE_7134_length_974_cov_7.436571	382	462	0	80	80	1.0000000
NODE_7134_length_974_cov_7.436571	436	515	0	79	79	1.0000000
NODE_7147_length_973_cov_46.012586	349	429	0	80	80	1.0000000
NODE_7147_length_973_cov_46.012586	402	482	0	80	80	1.0000000
NODE_7147_length_973_cov_46.012586	478	558	0	49	80	0.6125000
NODE_7147_length_973_cov_46.012586	478	558	4	31	80	0.3875000
NODE_7147_length_973_cov_46.012586	531	611	4	80	80	1.0000000
NODE_7148_length_973_cov_40.305492	364	444	0	6	80	0.0750000
NODE_7148_length_973_cov_40.305492	364	444	2	56	80	0.7000000
NODE_7148_length_973_cov_40.305492	364	444	4	18	80	0.2250000
NODE_7148_length_973_cov_40.305492	417	497	0	1	80	0.0125000
NODE_7148_length_973_cov_40.305492	417	497	2	29	80	0.3625000
NODE_7148_length_973_cov_40.305492	417	497	4	50	80	0.6250000
NODE_7149_length_973_cov_24.105263	460	540	0	80	80	1.0000000
NODE_7149_length_973_cov_24.105263	513	593	0	80	80	1.0000000
NODE_7150_length_973_cov_22.106407	342	422	0	80	80	1.0000000
NODE_7150_length_973_cov_22.106407	395	475	0	78	80	0.9750000
NODE_7150_length_973_cov_22.106407	395	475	2	2	80	0.0250000
NODE_7150_length_973_cov_22.106407	471	550	0	2	79	0.0253165
NODE_7150_length_973_cov_22.106407	471	550	2	23	79	0.2911392
NODE_7150_length_973_cov_22.106407	471	550	4	54	79	0.6835443
NODE_7150_length_973_cov_22.106407	526	604	0	22	78	0.2820513
NODE_7150_length_973_cov_22.106407	526	604	2	34	78	0.4358974
NODE_7150_length_973_cov_22.106407	526	604	4	22	78	0.2820513
NODE_7151_length_973_cov_10.994279	430	510	0	80	80	1.0000000
NODE_7151_length_973_cov_10.994279	483	563	0	80	80	1.0000000
NODE_7151_length_973_cov_10.994279	559	635	0	76	76	1.0000000
NODE_7151_length_973_cov_10.994279	608	688	0	80	80	1.0000000
NODE_7153_length_973_cov_2.973684	734	814	0	80	80	1.0000000
NODE_7153_length_973_cov_2.973684	820	890	0	18	70	0.2571429
NODE_7153_length_973_cov_2.973684	820	890	4	12	70	0.1714286
NODE_7153_length_973_cov_2.973684	820	890	6	40	70	0.5714286
NODE_7153_length_973_cov_2.973684	863	944	0	20	81	0.2469136
NODE_7153_length_973_cov_2.973684	863	944	4	18	81	0.2222222
NODE_7153_length_973_cov_2.973684	863	944	6	43	81	0.5308642
NODE_7166_length_972_cov_32.547537	299	379	4	17	80	0.2125000
NODE_7166_length_972_cov_32.547537	299	379	6	2	80	0.0250000
NODE_7166_length_972_cov_32.547537	299	379	8	57	80	0.7125000
NODE_7166_length_972_cov_32.547537	299	379	10	4	80	0.0500000
NODE_7166_length_972_cov_32.547537	352	432	0	42	80	0.5250000
NODE_7166_length_972_cov_32.547537	352	432	4	28	80	0.3500000
NODE_7166_length_972_cov_32.547537	352	432	8	10	80	0.1250000
NODE_7166_length_972_cov_32.547537	428	508	0	26	80	0.3250000
NODE_7166_length_972_cov_32.547537	428	508	2	54	80	0.6750000
NODE_7166_length_972_cov_32.547537	481	561	0	3	80	0.0375000
NODE_7166_length_972_cov_32.547537	481	561	2	77	80	0.9625000
NODE_7167_length_972_cov_31.010309	474	554	2	18	80	0.2250000
NODE_7167_length_972_cov_31.010309	474	554	4	11	80	0.1375000
NODE_7167_length_972_cov_31.010309	474	554	6	51	80	0.6375000
NODE_7167_length_972_cov_31.010309	527	607	0	8	80	0.1000000
NODE_7167_length_972_cov_31.010309	527	607	2	12	80	0.1500000
NODE_7167_length_972_cov_31.010309	527	607	4	33	80	0.4125000
NODE_7167_length_972_cov_31.010309	527	607	6	27	80	0.3375000
NODE_7168_length_972_cov_29.810997	481	561	0	38	80	0.4750000
NODE_7168_length_972_cov_29.810997	481	561	2	25	80	0.3125000
NODE_7168_length_972_cov_29.810997	481	561	4	17	80	0.2125000
NODE_7168_length_972_cov_29.810997	534	614	2	10	80	0.1250000
NODE_7168_length_972_cov_29.810997	534	614	4	62	80	0.7750000
NODE_7168_length_972_cov_29.810997	534	614	6	8	80	0.1000000
NODE_7169_length_972_cov_23.438717	442	522	0	26	80	0.3250000
NODE_7169_length_972_cov_23.438717	442	522	2	1	80	0.0125000
NODE_7169_length_972_cov_23.438717	442	522	4	4	80	0.0500000
NODE_7169_length_972_cov_23.438717	442	522	6	35	80	0.4375000
NODE_7169_length_972_cov_23.438717	442	522	8	14	80	0.1750000
NODE_7169_length_972_cov_23.438717	495	575	2	4	80	0.0500000
NODE_7169_length_972_cov_23.438717	495	575	4	20	80	0.2500000
NODE_7169_length_972_cov_23.438717	495	575	6	37	80	0.4625000
NODE_7169_length_972_cov_23.438717	495	575	8	19	80	0.2375000
NODE_7170_length_972_cov_18.886598	453	533	0	29	80	0.3625000
NODE_7170_length_972_cov_18.886598	453	533	2	38	80	0.4750000
NODE_7170_length_972_cov_18.886598	453	533	4	13	80	0.1625000
NODE_7170_length_972_cov_18.886598	506	585	2	14	79	0.1772152
NODE_7170_length_972_cov_18.886598	506	585	4	65	79	0.8227848
NODE_7171_length_972_cov_15.100802	329	409	0	80	80	1.0000000
NODE_7171_length_972_cov_15.100802	382	462	0	62	80	0.7750000
NODE_7171_length_972_cov_15.100802	382	462	2	18	80	0.2250000
NODE_7172_length_972_cov_12.674685	444	524	0	80	80	1.0000000
NODE_7172_length_972_cov_12.674685	497	577	0	80	80	1.0000000
NODE_7173_length_972_cov_11.235968	504	584	0	80	80	1.0000000
NODE_7173_length_972_cov_11.235968	557	637	0	33	80	0.4125000
NODE_7173_length_972_cov_11.235968	557	637	2	47	80	0.5875000
NODE_7174_length_972_cov_10.983963	402	482	0	80	80	1.0000000
NODE_7174_length_972_cov_10.983963	455	535	0	39	80	0.4875000
NODE_7174_length_972_cov_10.983963	455	535	2	29	80	0.3625000
NODE_7174_length_972_cov_10.983963	455	535	4	12	80	0.1500000
NODE_7175_length_972_cov_8.887743	302	382	0	80	80	1.0000000
NODE_7175_length_972_cov_8.887743	355	430	0	75	75	1.0000000
NODE_7176_length_972_cov_8.265750	488	568	0	80	80	1.0000000
NODE_7176_length_972_cov_8.265750	541	621	0	80	80	1.0000000
NODE_7182_length_972_cov_2.714777	165	241	6	48	76	0.6315789
NODE_7182_length_972_cov_2.714777	165	241	8	12	76	0.1578947
NODE_7182_length_972_cov_2.714777	165	241	10	16	76	0.2105263
NODE_7195_length_971_cov_52.575688	398	478	0	80	80	1.0000000
NODE_7195_length_971_cov_52.575688	451	531	0	80	80	1.0000000
NODE_7195_length_971_cov_52.575688	527	607	0	37	80	0.4625000
NODE_7195_length_971_cov_52.575688	527	607	2	43	80	0.5375000
NODE_7195_length_971_cov_52.575688	580	660	0	3	80	0.0375000
NODE_7195_length_971_cov_52.575688	580	660	2	77	80	0.9625000
NODE_7196_length_971_cov_44.464450	280	360	0	17	80	0.2125000
NODE_7196_length_971_cov_44.464450	280	360	1	63	80	0.7875000
NODE_7196_length_971_cov_44.464450	333	413	1	60	80	0.7500000
NODE_7196_length_971_cov_44.464450	333	413	2	20	80	0.2500000
NODE_7196_length_971_cov_44.464450	409	489	1	43	80	0.5375000
NODE_7196_length_971_cov_44.464450	409	489	2	37	80	0.4625000
NODE_7196_length_971_cov_44.464450	462	542	1	80	80	1.0000000
NODE_7197_length_971_cov_32.721330	509	589	0	80	80	1.0000000
NODE_7197_length_971_cov_32.721330	562	642	0	80	80	1.0000000
NODE_7198_length_971_cov_30.264908	474	554	1	1	80	0.0125000
NODE_7198_length_971_cov_30.264908	474	554	2	22	80	0.2750000
NODE_7198_length_971_cov_30.264908	474	554	3	57	80	0.7125000
NODE_7198_length_971_cov_30.264908	527	607	0	3	80	0.0375000
NODE_7198_length_971_cov_30.264908	527	607	1	6	80	0.0750000
NODE_7198_length_971_cov_30.264908	527	607	2	66	80	0.8250000
NODE_7198_length_971_cov_30.264908	527	607	3	5	80	0.0625000
NODE_7199_length_971_cov_26.631881	434	514	0	10	80	0.1250000
NODE_7199_length_971_cov_26.631881	434	514	2	70	80	0.8750000
NODE_7199_length_971_cov_26.631881	487	567	0	57	80	0.7125000
NODE_7199_length_971_cov_26.631881	487	567	2	23	80	0.2875000
NODE_7200_length_971_cov_25.635321	404	484	0	80	80	1.0000000
NODE_7200_length_971_cov_25.635321	457	537	0	80	80	1.0000000
NODE_7201_length_971_cov_23.334862	363	443	0	80	80	1.0000000
NODE_7201_length_971_cov_23.334862	416	497	0	81	81	1.0000000
NODE_7202_length_971_cov_18.254587	468	548	0	80	80	1.0000000
NODE_7202_length_971_cov_18.254587	521	601	0	80	80	1.0000000
NODE_7203_length_971_cov_18.229358	392	472	0	80	80	1.0000000
NODE_7203_length_971_cov_18.229358	445	525	0	46	80	0.5750000
NODE_7203_length_971_cov_18.229358	445	525	1	2	80	0.0250000
NODE_7203_length_971_cov_18.229358	445	525	2	2	80	0.0250000
NODE_7203_length_971_cov_18.229358	445	525	4	30	80	0.3750000
NODE_7204_length_971_cov_16.591743	481	561	0	80	80	1.0000000
NODE_7204_length_971_cov_16.591743	534	614	0	80	80	1.0000000
NODE_7205_length_971_cov_15.563073	463	543	0	80	80	1.0000000
NODE_7205_length_971_cov_15.563073	516	596	0	80	80	1.0000000
NODE_7206_length_971_cov_12.141055	415	495	0	80	80	1.0000000
NODE_7206_length_971_cov_12.141055	468	548	0	80	80	1.0000000
NODE_7222_length_970_cov_34.928817	438	518	0	80	80	1.0000000
NODE_7222_length_970_cov_34.928817	491	571	0	80	80	1.0000000
NODE_7223_length_970_cov_34.445465	540	620	12	19	80	0.2375000
NODE_7223_length_970_cov_34.445465	540	620	14	61	80	0.7625000
NODE_7223_length_970_cov_34.445465	593	673	0	47	80	0.5875000
NODE_7223_length_970_cov_34.445465	593	673	2	3	80	0.0375000
NODE_7223_length_970_cov_34.445465	593	673	5	1	80	0.0125000
NODE_7223_length_970_cov_34.445465	593	673	6	1	80	0.0125000
NODE_7223_length_970_cov_34.445465	593	673	14	28	80	0.3500000
NODE_7224_length_970_cov_34.257176	352	432	0	72	80	0.9000000
NODE_7224_length_970_cov_34.257176	352	432	2	8	80	0.1000000
NODE_7224_length_970_cov_34.257176	405	485	0	80	80	1.0000000
NODE_7225_length_970_cov_26.904707	297	372	16	5	75	0.0666667
NODE_7225_length_970_cov_26.904707	297	372	17	1	75	0.0133333
NODE_7225_length_970_cov_26.904707	297	372	18	3	75	0.0400000
NODE_7225_length_970_cov_26.904707	297	372	20	5	75	0.0666667
NODE_7225_length_970_cov_26.904707	297	372	22	52	75	0.6933333
NODE_7225_length_970_cov_26.904707	297	372	23	9	75	0.1200000
NODE_7225_length_970_cov_26.904707	303	376	16	9	73	0.1232877
NODE_7225_length_970_cov_26.904707	303	376	17	1	73	0.0136986
NODE_7225_length_970_cov_26.904707	303	376	18	3	73	0.0410959
NODE_7225_length_970_cov_26.904707	303	376	20	5	73	0.0684932
NODE_7225_length_970_cov_26.904707	303	376	22	52	73	0.7123288
NODE_7225_length_970_cov_26.904707	303	376	23	3	73	0.0410959
NODE_7225_length_970_cov_26.904707	311	377	16	10	66	0.1515152
NODE_7225_length_970_cov_26.904707	311	377	17	1	66	0.0151515
NODE_7225_length_970_cov_26.904707	311	377	18	3	66	0.0454545
NODE_7225_length_970_cov_26.904707	311	377	20	5	66	0.0757576
NODE_7225_length_970_cov_26.904707	311	377	22	47	66	0.7121212
NODE_7225_length_970_cov_26.904707	350	429	0	7	79	0.0886076
NODE_7225_length_970_cov_26.904707	350	429	12	42	79	0.5316456
NODE_7225_length_970_cov_26.904707	350	429	16	13	79	0.1645570
NODE_7225_length_970_cov_26.904707	350	429	17	1	79	0.0126582
NODE_7225_length_970_cov_26.904707	350	429	18	3	79	0.0379747
NODE_7225_length_970_cov_26.904707	350	429	20	5	79	0.0632911
NODE_7225_length_970_cov_26.904707	350	429	22	8	79	0.1012658
NODE_7225_length_970_cov_26.904707	350	429	0	7	79	0.0886076
NODE_7225_length_970_cov_26.904707	350	429	12	42	79	0.5316456
NODE_7225_length_970_cov_26.904707	350	429	16	13	79	0.1645570
NODE_7225_length_970_cov_26.904707	350	429	17	1	79	0.0126582
NODE_7225_length_970_cov_26.904707	350	429	18	3	79	0.0379747
NODE_7225_length_970_cov_26.904707	350	429	20	5	79	0.0632911
NODE_7225_length_970_cov_26.904707	350	429	22	8	79	0.1012658
NODE_7225_length_970_cov_26.904707	350	429	0	7	79	0.0886076
NODE_7225_length_970_cov_26.904707	350	429	12	42	79	0.5316456
NODE_7225_length_970_cov_26.904707	350	429	16	13	79	0.1645570
NODE_7225_length_970_cov_26.904707	350	429	17	1	79	0.0126582
NODE_7225_length_970_cov_26.904707	350	429	18	3	79	0.0379747
NODE_7225_length_970_cov_26.904707	350	429	20	5	79	0.0632911
NODE_7225_length_970_cov_26.904707	350	429	22	8	79	0.1012658
NODE_7226_length_970_cov_26.040184	266	346	0	80	80	1.0000000
NODE_7226_length_970_cov_26.040184	319	399	0	80	80	1.0000000
NODE_7226_length_970_cov_26.040184	395	475	0	80	80	1.0000000
NODE_7226_length_970_cov_26.040184	448	528	0	52	80	0.6500000
NODE_7226_length_970_cov_26.040184	448	528	2	28	80	0.3500000
NODE_7227_length_970_cov_19.291619	415	495	0	12	80	0.1500000
NODE_7227_length_970_cov_19.291619	415	495	2	13	80	0.1625000
NODE_7227_length_970_cov_19.291619	415	495	4	55	80	0.6875000
NODE_7227_length_970_cov_19.291619	468	548	0	29	80	0.3625000
NODE_7227_length_970_cov_19.291619	468	548	2	2	80	0.0250000
NODE_7227_length_970_cov_19.291619	468	548	4	49	80	0.6125000
NODE_7228_length_970_cov_17.731343	557	637	2	16	80	0.2000000
NODE_7228_length_970_cov_17.731343	557	637	4	4	80	0.0500000
NODE_7228_length_970_cov_17.731343	557	637	6	22	80	0.2750000
NODE_7228_length_970_cov_17.731343	557	637	8	38	80	0.4750000
NODE_7228_length_970_cov_17.731343	610	690	2	69	80	0.8625000
NODE_7228_length_970_cov_17.731343	610	690	4	4	80	0.0500000
NODE_7228_length_970_cov_17.731343	610	690	6	7	80	0.0875000
NODE_7229_length_970_cov_15.135476	407	487	0	24	80	0.3000000
NODE_7229_length_970_cov_15.135476	407	487	2	56	80	0.7000000
NODE_7229_length_970_cov_15.135476	460	540	0	6	80	0.0750000
NODE_7229_length_970_cov_15.135476	460	540	2	74	80	0.9250000
NODE_7230_length_970_cov_12.675086	534	614	0	20	80	0.2500000
NODE_7230_length_970_cov_12.675086	534	614	4	60	80	0.7500000
NODE_7230_length_970_cov_12.675086	587	667	0	33	80	0.4125000
NODE_7230_length_970_cov_12.675086	587	667	3	1	80	0.0125000
NODE_7230_length_970_cov_12.675086	587	667	4	46	80	0.5750000
NODE_7231_length_970_cov_8.095293	487	567	0	45	80	0.5625000
NODE_7231_length_970_cov_8.095293	487	567	2	35	80	0.4375000
NODE_7231_length_970_cov_8.095293	540	620	2	80	80	1.0000000
NODE_7233_length_970_cov_7.127440	336	416	0	80	80	1.0000000
NODE_7233_length_970_cov_7.127440	389	469	0	80	80	1.0000000
NODE_7234_length_970_cov_5.824340	0	56	0	56	56	1.0000000
NODE_7246_length_969_cov_47.172414	419	499	0	80	80	1.0000000
NODE_7246_length_969_cov_47.172414	472	552	0	80	80	1.0000000
NODE_7247_length_969_cov_28.234483	327	407	0	80	80	1.0000000
NODE_7247_length_969_cov_28.234483	380	460	0	80	80	1.0000000
NODE_7248_length_969_cov_27.131034	392	472	0	24	80	0.3000000
NODE_7248_length_969_cov_27.131034	392	472	2	56	80	0.7000000
NODE_7248_length_969_cov_27.131034	445	525	0	77	80	0.9625000
NODE_7248_length_969_cov_27.131034	445	525	2	3	80	0.0375000
NODE_7249_length_969_cov_26.345977	466	542	0	7	76	0.0921053
NODE_7249_length_969_cov_26.345977	466	542	2	45	76	0.5921053
NODE_7249_length_969_cov_26.345977	466	542	4	24	76	0.3157895
NODE_7249_length_969_cov_26.345977	515	595	2	12	80	0.1500000
NODE_7249_length_969_cov_26.345977	515	595	4	68	80	0.8500000
NODE_7250_length_969_cov_18.954023	274	354	0	80	80	1.0000000
NODE_7250_length_969_cov_18.954023	327	407	0	80	80	1.0000000
NODE_7251_length_969_cov_17.952874	410	490	0	80	80	1.0000000
NODE_7251_length_969_cov_17.952874	463	543	0	80	80	1.0000000
NODE_7251_length_969_cov_17.952874	693	773	0	80	80	1.0000000
NODE_7251_length_969_cov_17.952874	746	826	0	80	80	1.0000000
NODE_7252_length_969_cov_15.942529	446	526	2	80	80	1.0000000
NODE_7252_length_969_cov_15.942529	499	579	0	52	80	0.6500000
NODE_7252_length_969_cov_15.942529	499	579	2	28	80	0.3500000
NODE_7253_length_969_cov_9.926437	573	653	0	80	80	1.0000000
NODE_7253_length_969_cov_9.926437	626	706	0	80	80	1.0000000
NODE_7265_length_968_cov_59.162255	376	456	2	80	80	1.0000000
NODE_7265_length_968_cov_59.162255	429	509	0	34	80	0.4250000
NODE_7265_length_968_cov_59.162255	429	509	1	3	80	0.0375000
NODE_7265_length_968_cov_59.162255	429	509	2	43	80	0.5375000
NODE_7265_length_968_cov_59.162255	505	585	0	80	80	1.0000000
NODE_7265_length_968_cov_59.162255	558	638	0	31	80	0.3875000
NODE_7265_length_968_cov_59.162255	558	638	4	49	80	0.6125000
NODE_7266_length_968_cov_40.005754	514	594	0	16	80	0.2000000
NODE_7266_length_968_cov_40.005754	514	594	2	64	80	0.8000000
NODE_7266_length_968_cov_40.005754	567	647	0	31	80	0.3875000
NODE_7266_length_968_cov_40.005754	567	647	2	49	80	0.6125000
NODE_7267_length_968_cov_36.521289	450	530	4	80	80	1.0000000
NODE_7267_length_968_cov_36.521289	503	583	0	28	80	0.3500000
NODE_7267_length_968_cov_36.521289	503	583	4	52	80	0.6500000
NODE_7268_length_968_cov_34.799770	474	554	0	27	80	0.3375000
NODE_7268_length_968_cov_34.799770	474	554	2	53	80	0.6625000
NODE_7268_length_968_cov_34.799770	527	607	0	39	80	0.4875000
NODE_7268_length_968_cov_34.799770	527	607	2	41	80	0.5125000
NODE_7269_length_968_cov_26.929804	293	372	0	10	79	0.1265823
NODE_7269_length_968_cov_26.929804	293	372	2	23	79	0.2911392
NODE_7269_length_968_cov_26.929804	293	372	4	10	79	0.1265823
NODE_7269_length_968_cov_26.929804	293	372	6	36	79	0.4556962
NODE_7269_length_968_cov_26.929804	345	425	2	7	80	0.0875000
NODE_7269_length_968_cov_26.929804	345	425	4	4	80	0.0500000
NODE_7269_length_968_cov_26.929804	345	425	6	69	80	0.8625000
NODE_7269_length_968_cov_26.929804	421	501	2	42	80	0.5250000
NODE_7269_length_968_cov_26.929804	421	501	4	6	80	0.0750000
NODE_7269_length_968_cov_26.929804	421	501	8	31	80	0.3875000
NODE_7269_length_968_cov_26.929804	421	501	9	1	80	0.0125000
NODE_7269_length_968_cov_26.929804	474	554	6	19	80	0.2375000
NODE_7269_length_968_cov_26.929804	474	554	8	61	80	0.7625000
NODE_7270_length_968_cov_24.468354	434	514	0	26	80	0.3250000
NODE_7270_length_968_cov_24.468354	434	514	2	54	80	0.6750000
NODE_7270_length_968_cov_24.468354	487	567	0	28	80	0.3500000
NODE_7270_length_968_cov_24.468354	487	567	2	52	80	0.6500000
NODE_7271_length_968_cov_23.204833	344	424	0	80	80	1.0000000
NODE_7271_length_968_cov_23.204833	397	477	0	63	80	0.7875000
NODE_7271_length_968_cov_23.204833	397	477	2	17	80	0.2125000
NODE_7271_length_968_cov_23.204833	473	553	2	80	80	1.0000000
NODE_7271_length_968_cov_23.204833	526	606	0	38	80	0.4750000
NODE_7271_length_968_cov_23.204833	526	606	2	42	80	0.5250000
NODE_7272_length_968_cov_22.321059	417	497	6	4	80	0.0500000
NODE_7272_length_968_cov_22.321059	417	497	8	11	80	0.1375000
NODE_7272_length_968_cov_22.321059	417	497	10	37	80	0.4625000
NODE_7272_length_968_cov_22.321059	417	497	14	19	80	0.2375000
NODE_7272_length_968_cov_22.321059	417	497	15	2	80	0.0250000
NODE_7272_length_968_cov_22.321059	417	497	16	7	80	0.0875000
NODE_7272_length_968_cov_22.321059	470	550	2	2	80	0.0250000
NODE_7272_length_968_cov_22.321059	470	550	4	5	80	0.0625000
NODE_7272_length_968_cov_22.321059	470	550	8	27	80	0.3375000
NODE_7272_length_968_cov_22.321059	470	550	10	3	80	0.0375000
NODE_7272_length_968_cov_22.321059	470	550	12	4	80	0.0500000
NODE_7272_length_968_cov_22.321059	470	550	13	1	80	0.0125000
NODE_7272_length_968_cov_22.321059	470	550	14	29	80	0.3625000
NODE_7272_length_968_cov_22.321059	470	550	15	2	80	0.0250000
NODE_7272_length_968_cov_22.321059	470	550	16	7	80	0.0875000
NODE_7273_length_968_cov_20.897583	313	393	0	11	80	0.1375000
NODE_7273_length_968_cov_20.897583	313	393	4	4	80	0.0500000
NODE_7273_length_968_cov_20.897583	313	393	6	21	80	0.2625000
NODE_7273_length_968_cov_20.897583	313	393	8	5	80	0.0625000
NODE_7273_length_968_cov_20.897583	313	393	10	39	80	0.4875000
NODE_7273_length_968_cov_20.897583	366	446	0	7	80	0.0875000
NODE_7273_length_968_cov_20.897583	366	446	2	7	80	0.0875000
NODE_7273_length_968_cov_20.897583	366	446	4	28	80	0.3500000
NODE_7273_length_968_cov_20.897583	366	446	6	3	80	0.0375000
NODE_7273_length_968_cov_20.897583	366	446	10	35	80	0.4375000
NODE_7274_length_968_cov_19.296893	401	481	0	5	80	0.0625000
NODE_7274_length_968_cov_19.296893	401	481	4	75	80	0.9375000
NODE_7274_length_968_cov_19.296893	454	534	0	11	80	0.1375000
NODE_7274_length_968_cov_19.296893	454	534	4	69	80	0.8625000
NODE_7275_length_968_cov_18.100115	573	653	0	30	80	0.3750000
NODE_7275_length_968_cov_18.100115	573	653	2	50	80	0.6250000
NODE_7275_length_968_cov_18.100115	626	706	0	80	80	1.0000000
NODE_7276_length_968_cov_15.576525	472	552	0	73	80	0.9125000
NODE_7276_length_968_cov_15.576525	472	552	2	7	80	0.0875000
NODE_7276_length_968_cov_15.576525	525	605	0	20	80	0.2500000
NODE_7276_length_968_cov_15.576525	525	605	2	21	80	0.2625000
NODE_7276_length_968_cov_15.576525	525	605	4	39	80	0.4875000
NODE_7277_length_968_cov_15.024166	329	409	0	80	80	1.0000000
NODE_7277_length_968_cov_15.024166	382	462	0	80	80	1.0000000
NODE_7277_length_968_cov_15.024166	458	538	0	80	80	1.0000000
NODE_7277_length_968_cov_15.024166	511	591	0	80	80	1.0000000
NODE_7278_length_968_cov_13.911392	674	754	3	16	80	0.2000000
NODE_7278_length_968_cov_13.911392	674	754	5	48	80	0.6000000
NODE_7278_length_968_cov_13.911392	674	754	6	16	80	0.2000000
NODE_7278_length_968_cov_13.911392	727	807	0	32	80	0.4000000
NODE_7278_length_968_cov_13.911392	727	807	2	4	80	0.0500000
NODE_7278_length_968_cov_13.911392	727	807	3	33	80	0.4125000
NODE_7278_length_968_cov_13.911392	727	807	5	11	80	0.1375000
NODE_7279_length_968_cov_11.698504	598	678	0	62	80	0.7750000
NODE_7279_length_968_cov_11.698504	598	678	2	18	80	0.2250000
NODE_7279_length_968_cov_11.698504	651	731	0	9	80	0.1125000
NODE_7279_length_968_cov_11.698504	651	731	2	71	80	0.8875000
NODE_7280_length_968_cov_6.490219	538	618	0	80	80	1.0000000
NODE_7280_length_968_cov_6.490219	591	671	0	65	80	0.8125000
NODE_7280_length_968_cov_6.490219	591	671	2	15	80	0.1875000
NODE_7294_length_967_cov_25.572581	332	412	0	23	80	0.2875000
NODE_7294_length_967_cov_25.572581	332	412	2	9	80	0.1125000
NODE_7294_length_967_cov_25.572581	332	412	4	48	80	0.6000000
NODE_7294_length_967_cov_25.572581	385	465	2	39	80	0.4875000
NODE_7294_length_967_cov_25.572581	385	465	4	39	80	0.4875000
NODE_7294_length_967_cov_25.572581	385	465	6	2	80	0.0250000
NODE_7295_length_967_cov_24.919355	396	476	2	80	80	1.0000000
NODE_7295_length_967_cov_24.919355	449	529	0	30	80	0.3750000
NODE_7295_length_967_cov_24.919355	449	529	2	50	80	0.6250000
NODE_7296_length_967_cov_19.137097	374	454	0	80	80	1.0000000
NODE_7296_length_967_cov_19.137097	427	507	0	69	80	0.8625000
NODE_7296_length_967_cov_19.137097	427	507	2	11	80	0.1375000
NODE_7296_length_967_cov_19.137097	503	583	2	80	80	1.0000000
NODE_7296_length_967_cov_19.137097	556	636	0	51	80	0.6375000
NODE_7296_length_967_cov_19.137097	556	636	2	29	80	0.3625000
NODE_7297_length_967_cov_14.654378	453	533	2	17	80	0.2125000
NODE_7297_length_967_cov_14.654378	453	533	4	3	80	0.0375000
NODE_7297_length_967_cov_14.654378	453	533	6	60	80	0.7500000
NODE_7297_length_967_cov_14.654378	506	586	0	8	80	0.1000000
NODE_7297_length_967_cov_14.654378	506	586	2	26	80	0.3250000
NODE_7297_length_967_cov_14.654378	506	586	4	18	80	0.2250000
NODE_7297_length_967_cov_14.654378	506	586	6	28	80	0.3500000
NODE_7298_length_967_cov_8.027650	280	360	0	80	80	1.0000000
NODE_7298_length_967_cov_8.027650	333	413	0	80	80	1.0000000
NODE_7310_length_966_cov_43.154556	401	474	0	73	73	1.0000000
NODE_7310_length_966_cov_43.154556	447	527	0	80	80	1.0000000
NODE_7311_length_966_cov_42.877739	477	557	0	80	80	1.0000000
NODE_7311_length_966_cov_42.877739	530	610	0	80	80	1.0000000
NODE_7312_length_966_cov_39.956171	283	363	0	23	80	0.2875000
NODE_7312_length_966_cov_39.956171	283	363	4	32	80	0.4000000
NODE_7312_length_966_cov_39.956171	283	363	6	25	80	0.3125000
NODE_7312_length_966_cov_39.956171	336	416	4	4	80	0.0500000
NODE_7312_length_966_cov_39.956171	336	416	5	2	80	0.0250000
NODE_7312_length_966_cov_39.956171	336	416	6	36	80	0.4500000
NODE_7312_length_966_cov_39.956171	336	416	7	20	80	0.2500000
NODE_7312_length_966_cov_39.956171	336	416	8	18	80	0.2250000
NODE_7312_length_966_cov_39.956171	412	494	2	11	82	0.1341463
NODE_7312_length_966_cov_39.956171	412	494	6	51	82	0.6219512
NODE_7312_length_966_cov_39.956171	412	494	8	20	82	0.2439024
NODE_7312_length_966_cov_39.956171	467	547	0	14	80	0.1750000
NODE_7312_length_966_cov_39.956171	467	547	2	50	80	0.6250000
NODE_7312_length_966_cov_39.956171	467	547	6	16	80	0.2000000
NODE_7313_length_966_cov_36.160323	461	541	2	9	80	0.1125000
NODE_7313_length_966_cov_36.160323	461	541	6	4	80	0.0500000
NODE_7313_length_966_cov_36.160323	461	541	8	18	80	0.2250000
NODE_7313_length_966_cov_36.160323	461	541	9	19	80	0.2375000
NODE_7313_length_966_cov_36.160323	461	541	10	30	80	0.3750000
NODE_7313_length_966_cov_36.160323	461	541	2	9	80	0.1125000
NODE_7313_length_966_cov_36.160323	461	541	6	4	80	0.0500000
NODE_7313_length_966_cov_36.160323	461	541	8	18	80	0.2250000
NODE_7313_length_966_cov_36.160323	461	541	9	19	80	0.2375000
NODE_7313_length_966_cov_36.160323	461	541	10	30	80	0.3750000
NODE_7313_length_966_cov_36.160323	514	594	2	28	80	0.3500000
NODE_7313_length_966_cov_36.160323	514	594	6	15	80	0.1875000
NODE_7313_length_966_cov_36.160323	514	594	8	18	80	0.2250000
NODE_7313_length_966_cov_36.160323	514	594	10	19	80	0.2375000
NODE_7314_length_966_cov_18.658593	408	488	0	80	80	1.0000000
NODE_7314_length_966_cov_18.658593	461	541	0	80	80	1.0000000
NODE_7315_length_966_cov_17.606690	341	421	0	80	80	1.0000000
NODE_7315_length_966_cov_17.606690	394	474	0	80	80	1.0000000
NODE_7316_length_966_cov_16.064591	296	376	0	45	80	0.5625000
NODE_7316_length_966_cov_16.064591	296	376	2	4	80	0.0500000
NODE_7316_length_966_cov_16.064591	296	376	4	19	80	0.2375000
NODE_7316_length_966_cov_16.064591	296	376	10	12	80	0.1500000
NODE_7316_length_966_cov_16.064591	349	429	4	15	80	0.1875000
NODE_7316_length_966_cov_16.064591	349	429	8	1	80	0.0125000
NODE_7316_length_966_cov_16.064591	349	429	10	64	80	0.8000000
NODE_7317_length_966_cov_15.155709	562	642	0	80	80	1.0000000
NODE_7317_length_966_cov_15.155709	615	695	0	59	80	0.7375000
NODE_7317_length_966_cov_15.155709	615	695	2	21	80	0.2625000
NODE_7318_length_966_cov_7.726644	280	360	2	15	80	0.1875000
NODE_7318_length_966_cov_7.726644	280	360	4	61	80	0.7625000
NODE_7318_length_966_cov_7.726644	280	360	6	4	80	0.0500000
NODE_7318_length_966_cov_7.726644	334	414	2	20	80	0.2500000
NODE_7318_length_966_cov_7.726644	334	414	4	43	80	0.5375000
NODE_7318_length_966_cov_7.726644	334	414	6	17	80	0.2125000
NODE_7335_length_965_cov_51.524249	197	277	0	80	80	1.0000000
NODE_7335_length_965_cov_51.524249	250	327	0	77	77	1.0000000
NODE_7335_length_965_cov_51.524249	329	406	0	77	77	1.0000000
NODE_7335_length_965_cov_51.524249	379	459	0	32	80	0.4000000
NODE_7335_length_965_cov_51.524249	379	459	2	48	80	0.6000000
NODE_7336_length_965_cov_18.072748	515	595	0	4	80	0.0500000
NODE_7336_length_965_cov_18.072748	515	595	2	9	80	0.1125000
NODE_7336_length_965_cov_18.072748	515	595	4	67	80	0.8375000
NODE_7336_length_965_cov_18.072748	568	648	0	41	80	0.5125000
NODE_7336_length_965_cov_18.072748	568	648	2	6	80	0.0750000
NODE_7336_length_965_cov_18.072748	568	648	4	33	80	0.4125000
NODE_7337_length_965_cov_14.277136	342	422	0	58	80	0.7250000
NODE_7337_length_965_cov_14.277136	342	422	2	22	80	0.2750000
NODE_7337_length_965_cov_14.277136	395	470	0	5	75	0.0666667
NODE_7337_length_965_cov_14.277136	395	470	2	45	75	0.6000000
NODE_7337_length_965_cov_14.277136	395	470	6	25	75	0.3333333
NODE_7338_length_965_cov_7.808314	567	647	0	80	80	1.0000000
NODE_7338_length_965_cov_7.808314	620	700	0	80	80	1.0000000
NODE_7344_length_964_cov_60.153757	197	277	2	3	80	0.0375000
NODE_7344_length_964_cov_60.153757	197	277	4	68	80	0.8500000
NODE_7344_length_964_cov_60.153757	197	277	6	2	80	0.0250000
NODE_7344_length_964_cov_60.153757	197	277	8	4	80	0.0500000
NODE_7344_length_964_cov_60.153757	197	277	10	3	80	0.0375000
NODE_7344_length_964_cov_60.153757	250	314	0	19	64	0.2968750
NODE_7344_length_964_cov_60.153757	250	314	2	21	64	0.3281250
NODE_7344_length_964_cov_60.153757	250	314	4	24	64	0.3750000
NODE_7344_length_964_cov_60.153757	672	752	0	80	80	1.0000000
NODE_7344_length_964_cov_60.153757	725	805	0	80	80	1.0000000
NODE_7345_length_964_cov_45.564162	314	394	0	27	80	0.3375000
NODE_7345_length_964_cov_45.564162	314	394	2	53	80	0.6625000
NODE_7345_length_964_cov_45.564162	367	447	0	13	80	0.1625000
NODE_7345_length_964_cov_45.564162	367	447	2	67	80	0.8375000
NODE_7345_length_964_cov_45.564162	443	523	0	64	80	0.8000000
NODE_7345_length_964_cov_45.564162	443	523	2	16	80	0.2000000
NODE_7345_length_964_cov_45.564162	496	566	0	11	70	0.1571429
NODE_7345_length_964_cov_45.564162	496	566	2	59	70	0.8428571
NODE_7346_length_964_cov_33.487861	363	443	0	31	80	0.3875000
NODE_7346_length_964_cov_33.487861	363	443	2	49	80	0.6125000
NODE_7346_length_964_cov_33.487861	416	496	0	2	80	0.0250000
NODE_7346_length_964_cov_33.487861	416	496	2	78	80	0.9750000
NODE_7347_length_964_cov_33.077457	408	488	0	80	80	1.0000000
NODE_7347_length_964_cov_33.077457	461	541	0	80	80	1.0000000
NODE_7347_length_964_cov_33.077457	537	617	0	80	80	1.0000000
NODE_7347_length_964_cov_33.077457	590	670	0	80	80	1.0000000
NODE_7348_length_964_cov_29.250867	419	499	0	80	80	1.0000000
NODE_7348_length_964_cov_29.250867	472	552	0	80	80	1.0000000
NODE_7349_length_964_cov_20.191908	228	301	0	73	73	1.0000000
NODE_7349_length_964_cov_20.191908	349	429	0	46	80	0.5750000
NODE_7349_length_964_cov_20.191908	349	429	2	34	80	0.4250000
NODE_7349_length_964_cov_20.191908	402	482	2	80	80	1.0000000
NODE_7350_length_964_cov_18.510983	486	566	0	25	80	0.3125000
NODE_7350_length_964_cov_18.510983	486	566	1	2	80	0.0250000
NODE_7350_length_964_cov_18.510983	486	566	3	53	80	0.6625000
NODE_7350_length_964_cov_18.510983	539	619	1	4	80	0.0500000
NODE_7350_length_964_cov_18.510983	539	619	3	76	80	0.9500000
NODE_7351_length_964_cov_16.613873	464	544	0	80	80	1.0000000
NODE_7351_length_964_cov_16.613873	517	597	0	80	80	1.0000000
NODE_7352_length_964_cov_15.717919	411	491	0	80	80	1.0000000
NODE_7352_length_964_cov_15.717919	464	544	0	80	80	1.0000000
NODE_7352_length_964_cov_15.717919	540	620	0	80	80	1.0000000
NODE_7352_length_964_cov_15.717919	593	668	0	75	75	1.0000000
NODE_7353_length_964_cov_14.591908	521	601	0	1	80	0.0125000
NODE_7353_length_964_cov_14.591908	521	601	2	62	80	0.7750000
NODE_7353_length_964_cov_14.591908	521	601	6	17	80	0.2125000
NODE_7353_length_964_cov_14.591908	574	654	0	1	80	0.0125000
NODE_7353_length_964_cov_14.591908	574	654	2	9	80	0.1125000
NODE_7353_length_964_cov_14.591908	574	654	6	70	80	0.8750000
NODE_7354_length_964_cov_11.589595	475	555	0	29	80	0.3625000
NODE_7354_length_964_cov_11.589595	475	555	2	51	80	0.6375000
NODE_7354_length_964_cov_11.589595	528	608	2	32	80	0.4000000
NODE_7354_length_964_cov_11.589595	528	608	4	48	80	0.6000000
NODE_7355_length_964_cov_7.639306	420	500	0	10	80	0.1250000
NODE_7355_length_964_cov_7.639306	420	500	4	31	80	0.3875000
NODE_7355_length_964_cov_7.639306	420	500	6	39	80	0.4875000
NODE_7355_length_964_cov_7.639306	473	553	0	10	80	0.1250000
NODE_7355_length_964_cov_7.639306	473	553	4	10	80	0.1250000
NODE_7355_length_964_cov_7.639306	473	553	6	60	80	0.7500000
NODE_7356_length_964_cov_7.596532	534	614	1	3	80	0.0375000
NODE_7356_length_964_cov_7.596532	534	614	2	77	80	0.9625000
NODE_7356_length_964_cov_7.596532	587	667	1	56	80	0.7000000
NODE_7356_length_964_cov_7.596532	587	667	2	24	80	0.3000000
NODE_7357_length_964_cov_6.568786	368	448	2	35	80	0.4375000
NODE_7357_length_964_cov_6.568786	368	448	4	45	80	0.5625000
NODE_7357_length_964_cov_6.568786	421	501	0	40	80	0.5000000
NODE_7357_length_964_cov_6.568786	421	501	2	40	80	0.5000000
NODE_7359_length_964_cov_6.027746	890	940	0	8	50	0.1600000
NODE_7359_length_964_cov_6.027746	890	940	2	24	50	0.4800000
NODE_7359_length_964_cov_6.027746	890	940	4	10	50	0.2000000
NODE_7359_length_964_cov_6.027746	890	940	6	8	50	0.1600000
NODE_7361_length_964_cov_4.665896	706	772	0	20	66	0.3030303
NODE_7361_length_964_cov_4.665896	706	772	2	46	66	0.6969697
NODE_7376_length_963_cov_66.251157	456	536	0	1	80	0.0125000
NODE_7376_length_963_cov_66.251157	456	536	2	33	80	0.4125000
NODE_7376_length_963_cov_66.251157	456	536	4	46	80	0.5750000
NODE_7376_length_963_cov_66.251157	509	589	0	12	80	0.1500000
NODE_7376_length_963_cov_66.251157	509	589	2	46	80	0.5750000
NODE_7376_length_963_cov_66.251157	509	589	4	22	80	0.2750000
NODE_7376_length_963_cov_66.251157	585	665	0	80	80	1.0000000
NODE_7376_length_963_cov_66.251157	638	718	0	80	80	1.0000000
NODE_7377_length_963_cov_35.638889	381	461	0	80	80	1.0000000
NODE_7377_length_963_cov_35.638889	434	514	0	80	80	1.0000000
NODE_7377_length_963_cov_35.638889	510	590	0	80	80	1.0000000
NODE_7377_length_963_cov_35.638889	563	643	0	80	80	1.0000000
NODE_7378_length_963_cov_33.642361	347	427	0	80	80	1.0000000
NODE_7378_length_963_cov_33.642361	400	480	0	80	80	1.0000000
NODE_7379_length_963_cov_18.626157	392	472	2	80	80	1.0000000
NODE_7379_length_963_cov_18.626157	445	525	0	51	80	0.6375000
NODE_7379_length_963_cov_18.626157	445	525	2	29	80	0.3625000
NODE_7380_length_963_cov_17.750000	402	482	4	5	80	0.0625000
NODE_7380_length_963_cov_17.750000	402	482	6	16	80	0.2000000
NODE_7380_length_963_cov_17.750000	402	482	8	59	80	0.7375000
NODE_7380_length_963_cov_17.750000	455	535	2	36	80	0.4500000
NODE_7380_length_963_cov_17.750000	455	535	4	9	80	0.1125000
NODE_7380_length_963_cov_17.750000	455	535	6	23	80	0.2875000
NODE_7380_length_963_cov_17.750000	455	535	8	12	80	0.1500000
NODE_7381_length_963_cov_17.023148	542	622	0	80	80	1.0000000
NODE_7381_length_963_cov_17.023148	595	675	0	80	80	1.0000000
NODE_7382_length_963_cov_16.642361	481	561	0	80	80	1.0000000
NODE_7382_length_963_cov_16.642361	534	614	0	80	80	1.0000000
NODE_7382_length_963_cov_16.642361	572	629	0	57	57	1.0000000
NODE_7383_length_963_cov_14.961806	283	363	0	47	80	0.5875000
NODE_7383_length_963_cov_14.961806	283	363	2	33	80	0.4125000
NODE_7383_length_963_cov_14.961806	336	416	0	9	80	0.1125000
NODE_7383_length_963_cov_14.961806	336	416	2	71	80	0.8875000
NODE_7384_length_963_cov_13.341435	558	638	2	23	80	0.2875000
NODE_7384_length_963_cov_13.341435	558	638	4	21	80	0.2625000
NODE_7384_length_963_cov_13.341435	558	638	6	36	80	0.4500000
NODE_7384_length_963_cov_13.341435	611	691	0	11	80	0.1375000
NODE_7384_length_963_cov_13.341435	611	691	2	33	80	0.4125000
NODE_7384_length_963_cov_13.341435	611	691	4	25	80	0.3125000
NODE_7384_length_963_cov_13.341435	611	691	6	11	80	0.1375000
NODE_7386_length_963_cov_9.520833	459	539	0	51	80	0.6375000
NODE_7386_length_963_cov_9.520833	459	539	4	29	80	0.3625000
NODE_7386_length_963_cov_9.520833	512	592	4	80	80	1.0000000
NODE_7386_length_963_cov_9.520833	588	662	2	11	74	0.1486486
NODE_7386_length_963_cov_9.520833	588	662	4	4	74	0.0540541
NODE_7386_length_963_cov_9.520833	588	662	5	1	74	0.0135135
NODE_7386_length_963_cov_9.520833	588	662	6	58	74	0.7837838
NODE_7386_length_963_cov_9.520833	641	724	0	23	83	0.2771084
NODE_7386_length_963_cov_9.520833	641	724	2	50	83	0.6024097
NODE_7386_length_963_cov_9.520833	641	724	5	1	83	0.0120482
NODE_7386_length_963_cov_9.520833	641	724	6	9	83	0.1084337
NODE_7388_length_963_cov_7.510417	781	842	0	19	61	0.3114754
NODE_7388_length_963_cov_7.510417	781	842	6	5	61	0.0819672
NODE_7388_length_963_cov_7.510417	781	842	8	3	61	0.0491803
NODE_7388_length_963_cov_7.510417	781	842	10	2	61	0.0327869
NODE_7388_length_963_cov_7.510417	781	842	16	4	61	0.0655738
NODE_7388_length_963_cov_7.510417	781	842	18	2	61	0.0327869
NODE_7388_length_963_cov_7.510417	781	842	22	3	61	0.0491803
NODE_7388_length_963_cov_7.510417	781	842	26	10	61	0.1639344
NODE_7388_length_963_cov_7.510417	781	842	28	13	61	0.2131148
NODE_7388_length_963_cov_7.510417	815	894	18	1	79	0.0126582
NODE_7388_length_963_cov_7.510417	815	894	22	3	79	0.0379747
NODE_7388_length_963_cov_7.510417	815	894	26	10	79	0.1265823
NODE_7388_length_963_cov_7.510417	815	894	28	65	79	0.8227848
NODE_7392_length_963_cov_3.755787	378	458	0	63	80	0.7875000
NODE_7392_length_963_cov_3.755787	378	458	2	17	80	0.2125000
NODE_7392_length_963_cov_3.755787	431	511	0	10	80	0.1250000
NODE_7392_length_963_cov_3.755787	431	511	2	70	80	0.8750000
NODE_7397_length_963_cov_1.931713	426	485	0	59	59	1.0000000
NODE_7404_length_962_cov_37.169177	356	436	0	80	80	1.0000000
NODE_7404_length_962_cov_37.169177	409	489	0	80	80	1.0000000
NODE_7405_length_962_cov_28.852839	474	554	0	80	80	1.0000000
NODE_7405_length_962_cov_28.852839	527	607	0	80	80	1.0000000
NODE_7405_length_962_cov_28.852839	603	683	0	75	80	0.9375000
NODE_7405_length_962_cov_28.852839	603	683	4	5	80	0.0625000
NODE_7405_length_962_cov_28.852839	656	736	0	22	80	0.2750000
NODE_7405_length_962_cov_28.852839	656	736	4	13	80	0.1625000
NODE_7405_length_962_cov_28.852839	656	736	5	27	80	0.3375000
NODE_7405_length_962_cov_28.852839	656	736	9	16	80	0.2000000
NODE_7405_length_962_cov_28.852839	656	736	10	2	80	0.0250000
NODE_7406_length_962_cov_27.859791	441	521	0	80	80	1.0000000
NODE_7406_length_962_cov_27.859791	494	574	0	80	80	1.0000000
NODE_7407_length_962_cov_21.019699	318	398	0	21	80	0.2625000
NODE_7407_length_962_cov_21.019699	318	398	2	15	80	0.1875000
NODE_7407_length_962_cov_21.019699	318	398	4	37	80	0.4625000
NODE_7407_length_962_cov_21.019699	318	398	6	7	80	0.0875000
NODE_7407_length_962_cov_21.019699	371	451	4	20	80	0.2500000
NODE_7407_length_962_cov_21.019699	371	451	6	58	80	0.7250000
NODE_7407_length_962_cov_21.019699	371	451	8	2	80	0.0250000
NODE_7408_length_962_cov_16.792584	350	430	0	80	80	1.0000000
NODE_7408_length_962_cov_16.792584	403	483	0	38	80	0.4750000
NODE_7408_length_962_cov_16.792584	403	483	2	42	80	0.5250000
NODE_7409_length_962_cov_14.650058	477	557	0	26	80	0.3250000
NODE_7409_length_962_cov_14.650058	477	557	2	54	80	0.6750000
NODE_7409_length_962_cov_14.650058	530	610	0	17	80	0.2125000
NODE_7409_length_962_cov_14.650058	530	610	2	63	80	0.7875000
NODE_7410_length_962_cov_7.993048	308	345	2	37	37	1.0000000
NODE_7411_length_962_cov_7.835458	447	527	0	8	80	0.1000000
NODE_7411_length_962_cov_7.835458	447	527	5	1	80	0.0125000
NODE_7411_length_962_cov_7.835458	447	527	6	37	80	0.4625000
NODE_7411_length_962_cov_7.835458	447	527	8	34	80	0.4250000
NODE_7411_length_962_cov_7.835458	500	580	0	2	80	0.0250000
NODE_7411_length_962_cov_7.835458	500	580	2	3	80	0.0375000
NODE_7411_length_962_cov_7.835458	500	580	8	75	80	0.9375000
NODE_7412_length_962_cov_6.855156	490	570	0	80	80	1.0000000
NODE_7412_length_962_cov_6.855156	543	623	0	80	80	1.0000000
NODE_7417_length_962_cov_1.840093	88	151	4	1	63	0.0158730
NODE_7417_length_962_cov_1.840093	88	151	6	2	63	0.0317460
NODE_7417_length_962_cov_1.840093	88	151	10	3	63	0.0476190
NODE_7417_length_962_cov_1.840093	88	151	12	1	63	0.0158730
NODE_7417_length_962_cov_1.840093	88	151	17	1	63	0.0158730
NODE_7417_length_962_cov_1.840093	88	151	19	2	63	0.0317460
NODE_7417_length_962_cov_1.840093	88	151	21	1	63	0.0158730
NODE_7417_length_962_cov_1.840093	88	151	25	1	63	0.0158730
NODE_7417_length_962_cov_1.840093	88	151	29	2	63	0.0317460
NODE_7417_length_962_cov_1.840093	88	151	31	2	63	0.0317460
NODE_7417_length_962_cov_1.840093	88	151	43	1	63	0.0158730
NODE_7417_length_962_cov_1.840093	88	151	45	1	63	0.0158730
NODE_7417_length_962_cov_1.840093	88	151	47	4	63	0.0634921
NODE_7417_length_962_cov_1.840093	88	151	53	1	63	0.0158730
NODE_7417_length_962_cov_1.840093	88	151	55	1	63	0.0158730
NODE_7417_length_962_cov_1.840093	88	151	56	5	63	0.0793651
NODE_7417_length_962_cov_1.840093	88	151	58	2	63	0.0317460
NODE_7417_length_962_cov_1.840093	88	151	60	2	63	0.0317460
NODE_7417_length_962_cov_1.840093	88	151	62	1	63	0.0158730
NODE_7417_length_962_cov_1.840093	88	151	70	3	63	0.0476190
NODE_7417_length_962_cov_1.840093	88	151	72	1	63	0.0158730
NODE_7417_length_962_cov_1.840093	88	151	74	1	63	0.0158730
NODE_7417_length_962_cov_1.840093	88	151	76	1	63	0.0158730
NODE_7417_length_962_cov_1.840093	88	151	80	4	63	0.0634921
NODE_7417_length_962_cov_1.840093	88	151	82	2	63	0.0317460
NODE_7417_length_962_cov_1.840093	88	151	84	2	63	0.0317460
NODE_7417_length_962_cov_1.840093	88	151	86	2	63	0.0317460
NODE_7417_length_962_cov_1.840093	88	151	88	3	63	0.0476190
NODE_7417_length_962_cov_1.840093	88	151	92	2	63	0.0317460
NODE_7417_length_962_cov_1.840093	88	151	94	5	63	0.0793651
NODE_7417_length_962_cov_1.840093	88	151	96	3	63	0.0476190
NODE_7422_length_961_cov_61.019722	453	533	0	59	80	0.7375000
NODE_7422_length_961_cov_61.019722	453	533	2	14	80	0.1750000
NODE_7422_length_961_cov_61.019722	453	533	4	7	80	0.0875000
NODE_7422_length_961_cov_61.019722	506	586	0	6	80	0.0750000
NODE_7422_length_961_cov_61.019722	506	586	2	14	80	0.1750000
NODE_7422_length_961_cov_61.019722	506	586	4	60	80	0.7500000
NODE_7422_length_961_cov_61.019722	614	672	0	54	58	0.9310345
NODE_7422_length_961_cov_61.019722	614	672	2	4	58	0.0689655
NODE_7423_length_961_cov_51.005800	334	414	6	52	80	0.6500000
NODE_7423_length_961_cov_51.005800	334	414	8	28	80	0.3500000
NODE_7423_length_961_cov_51.005800	387	467	0	18	80	0.2250000
NODE_7423_length_961_cov_51.005800	387	467	2	17	80	0.2125000
NODE_7423_length_961_cov_51.005800	387	467	4	1	80	0.0125000
NODE_7423_length_961_cov_51.005800	387	467	6	24	80	0.3000000
NODE_7423_length_961_cov_51.005800	387	467	8	20	80	0.2500000
NODE_7424_length_961_cov_45.923434	391	471	0	28	80	0.3500000
NODE_7424_length_961_cov_45.923434	391	471	1	1	80	0.0125000
NODE_7424_length_961_cov_45.923434	391	471	2	1	80	0.0125000
NODE_7424_length_961_cov_45.923434	391	471	5	6	80	0.0750000
NODE_7424_length_961_cov_45.923434	391	471	7	23	80	0.2875000
NODE_7424_length_961_cov_45.923434	391	471	9	10	80	0.1250000
NODE_7424_length_961_cov_45.923434	391	471	10	6	80	0.0750000
NODE_7424_length_961_cov_45.923434	391	471	11	5	80	0.0625000
NODE_7424_length_961_cov_45.923434	444	524	7	6	80	0.0750000
NODE_7424_length_961_cov_45.923434	444	524	9	13	80	0.1625000
NODE_7424_length_961_cov_45.923434	444	524	10	22	80	0.2750000
NODE_7424_length_961_cov_45.923434	444	524	11	5	80	0.0625000
NODE_7424_length_961_cov_45.923434	444	524	12	34	80	0.4250000
NODE_7426_length_961_cov_21.410673	313	393	0	29	80	0.3625000
NODE_7426_length_961_cov_21.410673	313	393	2	40	80	0.5000000
NODE_7426_length_961_cov_21.410673	313	393	6	11	80	0.1375000
NODE_7426_length_961_cov_21.410673	366	446	2	16	80	0.2000000
NODE_7426_length_961_cov_21.410673	366	446	4	22	80	0.2750000
NODE_7426_length_961_cov_21.410673	366	446	6	42	80	0.5250000
NODE_7427_length_961_cov_18.592807	403	483	0	80	80	1.0000000
NODE_7427_length_961_cov_18.592807	456	536	0	80	80	1.0000000
NODE_7428_length_961_cov_17.701856	433	513	0	24	80	0.3000000
NODE_7428_length_961_cov_17.701856	433	513	2	1	80	0.0125000
NODE_7428_length_961_cov_17.701856	433	513	3	11	80	0.1375000
NODE_7428_length_961_cov_17.701856	433	513	6	7	80	0.0875000
NODE_7428_length_961_cov_17.701856	433	513	14	37	80	0.4625000
NODE_7428_length_961_cov_17.701856	486	566	14	80	80	1.0000000
NODE_7429_length_961_cov_17.020882	505	585	0	80	80	1.0000000
NODE_7429_length_961_cov_17.020882	558	638	0	80	80	1.0000000
NODE_7430_length_961_cov_16.235499	328	408	0	12	80	0.1500000
NODE_7430_length_961_cov_16.235499	328	408	2	68	80	0.8500000
NODE_7430_length_961_cov_16.235499	381	461	2	80	80	1.0000000
NODE_7432_length_961_cov_12.968677	347	427	0	61	80	0.7625000
NODE_7432_length_961_cov_12.968677	347	427	2	19	80	0.2375000
NODE_7432_length_961_cov_12.968677	400	480	0	80	80	1.0000000
NODE_7433_length_961_cov_9.875870	439	519	0	80	80	1.0000000
NODE_7433_length_961_cov_9.875870	492	572	0	80	80	1.0000000
NODE_7434_length_961_cov_6.172854	624	704	0	80	80	1.0000000
NODE_7434_length_961_cov_6.172854	677	757	0	80	80	1.0000000
NODE_7435_length_961_cov_4.553364	451	531	0	80	80	1.0000000
NODE_7435_length_961_cov_4.553364	504	584	0	44	80	0.5500000
NODE_7435_length_961_cov_4.553364	504	584	2	36	80	0.4500000
NODE_7440_length_960_cov_35.649245	65	145	0	80	80	1.0000000
NODE_7440_length_960_cov_35.649245	118	198	0	80	80	1.0000000
NODE_7440_length_960_cov_35.649245	446	526	0	12	80	0.1500000
NODE_7440_length_960_cov_35.649245	446	526	2	23	80	0.2875000
NODE_7440_length_960_cov_35.649245	446	526	4	45	80	0.5625000
NODE_7440_length_960_cov_35.649245	499	579	2	41	80	0.5125000
NODE_7440_length_960_cov_35.649245	499	579	4	39	80	0.4875000
NODE_7441_length_960_cov_34.886179	386	466	2	1	80	0.0125000
NODE_7441_length_960_cov_34.886179	386	466	4	20	80	0.2500000
NODE_7441_length_960_cov_34.886179	386	466	6	59	80	0.7375000
NODE_7441_length_960_cov_34.886179	439	519	0	44	80	0.5500000
NODE_7441_length_960_cov_34.886179	439	519	2	10	80	0.1250000
NODE_7441_length_960_cov_34.886179	439	519	4	3	80	0.0375000
NODE_7441_length_960_cov_34.886179	439	519	6	23	80	0.2875000
NODE_7443_length_960_cov_25.133566	413	493	0	80	80	1.0000000
NODE_7443_length_960_cov_25.133566	466	546	0	80	80	1.0000000
NODE_7444_length_960_cov_19.336818	385	465	0	24	80	0.3000000
NODE_7444_length_960_cov_19.336818	385	465	2	56	80	0.7000000
NODE_7444_length_960_cov_19.336818	438	518	0	24	80	0.3000000
NODE_7444_length_960_cov_19.336818	438	518	2	56	80	0.7000000
NODE_7445_length_960_cov_13.221835	460	539	0	41	79	0.5189874
NODE_7445_length_960_cov_13.221835	460	539	2	26	79	0.3291139
NODE_7445_length_960_cov_13.221835	460	539	4	12	79	0.1518987
NODE_7445_length_960_cov_13.221835	512	592	2	15	80	0.1875000
NODE_7445_length_960_cov_13.221835	512	592	4	65	80	0.8125000
NODE_7446_length_960_cov_12.804878	347	427	0	34	80	0.4250000
NODE_7446_length_960_cov_12.804878	347	427	2	46	80	0.5750000
NODE_7446_length_960_cov_12.804878	400	480	0	17	80	0.2125000
NODE_7446_length_960_cov_12.804878	400	480	2	63	80	0.7875000
NODE_7462_length_959_cov_39.394186	326	406	0	80	80	1.0000000
NODE_7462_length_959_cov_39.394186	379	459	0	80	80	1.0000000
NODE_7463_length_959_cov_28.895349	327	407	3	42	80	0.5250000
NODE_7463_length_959_cov_28.895349	327	407	5	33	80	0.4125000
NODE_7463_length_959_cov_28.895349	327	407	6	5	80	0.0625000
NODE_7463_length_959_cov_28.895349	380	460	1	1	80	0.0125000
NODE_7463_length_959_cov_28.895349	380	460	3	19	80	0.2375000
NODE_7463_length_959_cov_28.895349	380	460	4	31	80	0.3875000
NODE_7463_length_959_cov_28.895349	380	460	5	20	80	0.2500000
NODE_7463_length_959_cov_28.895349	380	460	6	9	80	0.1125000
NODE_7464_length_959_cov_26.634884	563	643	0	22	80	0.2750000
NODE_7464_length_959_cov_26.634884	563	643	1	14	80	0.1750000
NODE_7464_length_959_cov_26.634884	563	643	2	44	80	0.5500000
NODE_7464_length_959_cov_26.634884	616	696	0	75	80	0.9375000
NODE_7464_length_959_cov_26.634884	616	696	1	5	80	0.0625000
NODE_7464_length_959_cov_26.634884	692	772	0	80	80	1.0000000
NODE_7464_length_959_cov_26.634884	745	825	0	80	80	1.0000000
NODE_7465_length_959_cov_18.862791	320	400	0	8	80	0.1000000
NODE_7465_length_959_cov_18.862791	320	400	2	72	80	0.9000000
NODE_7465_length_959_cov_18.862791	373	453	2	32	80	0.4000000
NODE_7465_length_959_cov_18.862791	373	453	4	48	80	0.6000000
NODE_7466_length_959_cov_17.910465	358	438	2	50	80	0.6250000
NODE_7466_length_959_cov_17.910465	358	438	4	30	80	0.3750000
NODE_7466_length_959_cov_17.910465	411	491	0	12	80	0.1500000
NODE_7466_length_959_cov_17.910465	411	491	2	68	80	0.8500000
NODE_7467_length_959_cov_15.337209	267	347	0	22	80	0.2750000
NODE_7467_length_959_cov_15.337209	267	347	4	28	80	0.3500000
NODE_7467_length_959_cov_15.337209	267	347	6	30	80	0.3750000
NODE_7467_length_959_cov_15.337209	320	400	6	61	80	0.7625000
NODE_7467_length_959_cov_15.337209	320	400	8	19	80	0.2375000
NODE_7468_length_959_cov_9.005814	529	609	0	23	80	0.2875000
NODE_7468_length_959_cov_9.005814	529	609	2	57	80	0.7125000
NODE_7468_length_959_cov_9.005814	582	662	0	42	80	0.5250000
NODE_7468_length_959_cov_9.005814	582	662	2	38	80	0.4750000
NODE_7469_length_959_cov_8.163953	392	472	0	80	80	1.0000000
NODE_7469_length_959_cov_8.163953	445	525	0	54	80	0.6750000
NODE_7469_length_959_cov_8.163953	445	525	2	26	80	0.3250000
NODE_7470_length_959_cov_7.097674	401	481	0	80	80	1.0000000
NODE_7470_length_959_cov_7.097674	454	534	0	80	80	1.0000000
NODE_7472_length_959_cov_4.603488	596	676	0	80	80	1.0000000
NODE_7472_length_959_cov_4.603488	649	729	0	80	80	1.0000000
NODE_7486_length_958_cov_57.015134	328	408	0	32	80	0.4000000
NODE_7486_length_958_cov_57.015134	328	408	2	2	80	0.0250000
NODE_7486_length_958_cov_57.015134	328	408	6	46	80	0.5750000
NODE_7486_length_958_cov_57.015134	381	461	4	35	80	0.4375000
NODE_7486_length_958_cov_57.015134	381	461	6	45	80	0.5625000
NODE_7486_length_958_cov_57.015134	457	537	0	26	80	0.3250000
NODE_7486_length_958_cov_57.015134	457	537	2	34	80	0.4250000
NODE_7486_length_958_cov_57.015134	457	537	4	20	80	0.2500000
NODE_7486_length_958_cov_57.015134	510	590	0	4	80	0.0500000
NODE_7486_length_958_cov_57.015134	510	590	2	76	80	0.9500000
NODE_7487_length_958_cov_42.265425	418	498	0	80	80	1.0000000
NODE_7487_length_958_cov_42.265425	471	551	0	80	80	1.0000000
NODE_7488_length_958_cov_28.618161	336	416	6	1	80	0.0125000
NODE_7488_length_958_cov_28.618161	336	416	8	47	80	0.5875000
NODE_7488_length_958_cov_28.618161	336	416	10	32	80	0.4000000
NODE_7488_length_958_cov_28.618161	389	469	0	26	80	0.3250000
NODE_7488_length_958_cov_28.618161	389	469	4	15	80	0.1875000
NODE_7488_length_958_cov_28.618161	389	469	6	13	80	0.1625000
NODE_7488_length_958_cov_28.618161	389	469	8	26	80	0.3250000
NODE_7488_length_958_cov_28.618161	465	545	0	80	80	1.0000000
NODE_7488_length_958_cov_28.618161	518	598	0	80	80	1.0000000
NODE_7489_length_958_cov_16.452852	446	526	0	16	80	0.2000000
NODE_7489_length_958_cov_16.452852	446	526	2	2	80	0.0250000
NODE_7489_length_958_cov_16.452852	446	526	4	38	80	0.4750000
NODE_7489_length_958_cov_16.452852	446	526	6	24	80	0.3000000
NODE_7489_length_958_cov_16.452852	499	579	0	69	80	0.8625000
NODE_7489_length_958_cov_16.452852	499	579	2	2	80	0.0250000
NODE_7489_length_958_cov_16.452852	499	579	4	9	80	0.1125000
NODE_7490_length_958_cov_16.008149	446	526	0	80	80	1.0000000
NODE_7490_length_958_cov_16.008149	499	579	0	80	80	1.0000000
NODE_7491_length_958_cov_14.154831	516	596	0	80	80	1.0000000
NODE_7491_length_958_cov_14.154831	569	649	0	29	80	0.3625000
NODE_7491_length_958_cov_14.154831	569	649	2	51	80	0.6375000
NODE_7492_length_958_cov_12.381839	454	534	0	80	80	1.0000000
NODE_7492_length_958_cov_12.381839	507	587	0	80	80	1.0000000
NODE_7493_length_958_cov_11.782305	479	559	0	68	80	0.8500000
NODE_7493_length_958_cov_11.782305	479	559	2	12	80	0.1500000
NODE_7493_length_958_cov_11.782305	532	612	0	15	80	0.1875000
NODE_7493_length_958_cov_11.782305	532	612	2	65	80	0.8125000
NODE_7501_length_957_cov_40.837995	746	826	0	80	80	1.0000000
NODE_7501_length_957_cov_40.837995	799	879	0	80	80	1.0000000
NODE_7502_length_957_cov_25.976690	631	711	2	17	80	0.2125000
NODE_7502_length_957_cov_25.976690	631	711	4	12	80	0.1500000
NODE_7502_length_957_cov_25.976690	631	711	6	18	80	0.2250000
NODE_7502_length_957_cov_25.976690	631	711	8	33	80	0.4125000
NODE_7502_length_957_cov_25.976690	684	764	0	20	80	0.2500000
NODE_7502_length_957_cov_25.976690	684	764	2	2	80	0.0250000
NODE_7502_length_957_cov_25.976690	684	764	4	26	80	0.3250000
NODE_7502_length_957_cov_25.976690	684	764	6	17	80	0.2125000
NODE_7502_length_957_cov_25.976690	684	764	8	15	80	0.1875000
NODE_7503_length_957_cov_25.855478	57	131	0	6	74	0.0810811
NODE_7503_length_957_cov_25.855478	57	131	2	5	74	0.0675676
NODE_7503_length_957_cov_25.855478	57	131	4	4	74	0.0540541
NODE_7503_length_957_cov_25.855478	57	131	6	1	74	0.0135135
NODE_7503_length_957_cov_25.855478	57	131	8	4	74	0.0540541
NODE_7503_length_957_cov_25.855478	57	131	10	1	74	0.0135135
NODE_7503_length_957_cov_25.855478	57	131	12	3	74	0.0405405
NODE_7503_length_957_cov_25.855478	57	131	14	50	74	0.6756757
NODE_7503_length_957_cov_25.855478	414	494	0	45	80	0.5625000
NODE_7503_length_957_cov_25.855478	414	494	2	5	80	0.0625000
NODE_7503_length_957_cov_25.855478	414	494	4	30	80	0.3750000
NODE_7503_length_957_cov_25.855478	467	547	2	4	80	0.0500000
NODE_7503_length_957_cov_25.855478	467	547	3	1	80	0.0125000
NODE_7503_length_957_cov_25.855478	467	547	4	75	80	0.9375000
NODE_7504_length_957_cov_24.625874	445	525	0	2	80	0.0250000
NODE_7504_length_957_cov_24.625874	445	525	2	78	80	0.9750000
NODE_7504_length_957_cov_24.625874	498	578	0	55	80	0.6875000
NODE_7504_length_957_cov_24.625874	498	578	2	25	80	0.3125000
NODE_7505_length_957_cov_19.955711	286	366	0	80	80	1.0000000
NODE_7505_length_957_cov_19.955711	339	419	0	80	80	1.0000000
NODE_7506_length_957_cov_18.861305	414	494	2	59	80	0.7375000
NODE_7506_length_957_cov_18.861305	414	494	4	21	80	0.2625000
NODE_7506_length_957_cov_18.861305	467	547	0	17	80	0.2125000
NODE_7506_length_957_cov_18.861305	467	547	2	63	80	0.7875000
NODE_7507_length_957_cov_17.356643	361	441	0	80	80	1.0000000
NODE_7507_length_957_cov_17.356643	414	494	0	80	80	1.0000000
NODE_7508_length_957_cov_13.569930	162	242	0	80	80	1.0000000
NODE_7508_length_957_cov_13.569930	215	299	0	84	84	1.0000000
NODE_7509_length_957_cov_12.334499	314	394	0	80	80	1.0000000
NODE_7509_length_957_cov_12.334499	367	447	0	80	80	1.0000000
NODE_7510_length_957_cov_12.017483	173	253	0	80	80	1.0000000
NODE_7510_length_957_cov_12.017483	226	306	0	80	80	1.0000000
NODE_7511_length_957_cov_10.026807	446	526	0	80	80	1.0000000
NODE_7511_length_957_cov_10.026807	499	579	0	80	80	1.0000000
NODE_7529_length_956_cov_48.047841	479	559	2	24	80	0.3000000
NODE_7529_length_956_cov_48.047841	479	559	4	56	80	0.7000000
NODE_7529_length_956_cov_48.047841	532	612	0	12	80	0.1500000
NODE_7529_length_956_cov_48.047841	532	612	2	58	80	0.7250000
NODE_7529_length_956_cov_48.047841	532	612	4	10	80	0.1250000
NODE_7529_length_956_cov_48.047841	608	688	2	31	80	0.3875000
NODE_7529_length_956_cov_48.047841	608	688	4	49	80	0.6125000
NODE_7529_length_956_cov_48.047841	661	741	0	15	80	0.1875000
NODE_7529_length_956_cov_48.047841	661	741	2	18	80	0.2250000
NODE_7529_length_956_cov_48.047841	661	741	4	47	80	0.5875000
NODE_7530_length_956_cov_34.539090	298	378	4	41	80	0.5125000
NODE_7530_length_956_cov_34.539090	298	378	6	33	80	0.4125000
NODE_7530_length_956_cov_34.539090	298	378	8	6	80	0.0750000
NODE_7530_length_956_cov_34.539090	351	431	0	26	80	0.3250000
NODE_7530_length_956_cov_34.539090	351	431	2	3	80	0.0375000
NODE_7530_length_956_cov_34.539090	351	431	4	51	80	0.6375000
NODE_7530_length_956_cov_34.539090	427	507	0	80	80	1.0000000
NODE_7530_length_956_cov_34.539090	480	560	0	80	80	1.0000000
NODE_7531_length_956_cov_24.355893	398	478	0	71	80	0.8875000
NODE_7531_length_956_cov_24.355893	398	478	2	9	80	0.1125000
NODE_7531_length_956_cov_24.355893	451	531	0	18	80	0.2250000
NODE_7531_length_956_cov_24.355893	451	531	2	62	80	0.7750000
NODE_7532_length_956_cov_21.940490	373	453	0	80	80	1.0000000
NODE_7532_length_956_cov_21.940490	426	506	0	80	80	1.0000000
NODE_7532_length_956_cov_21.940490	502	582	0	80	80	1.0000000
NODE_7532_length_956_cov_21.940490	555	635	0	80	80	1.0000000
NODE_7533_length_956_cov_19.435239	274	354	0	80	80	1.0000000
NODE_7533_length_956_cov_19.435239	274	301	0	27	27	1.0000000
NODE_7534_length_956_cov_17.819137	378	458	0	80	80	1.0000000
NODE_7534_length_956_cov_17.819137	431	511	0	80	80	1.0000000
NODE_7535_length_956_cov_16.098016	551	631	0	25	80	0.3125000
NODE_7535_length_956_cov_16.098016	551	631	2	55	80	0.6875000
NODE_7535_length_956_cov_16.098016	604	684	0	48	80	0.6000000
NODE_7535_length_956_cov_16.098016	604	684	2	32	80	0.4000000
NODE_7536_length_956_cov_15.229872	490	570	0	80	80	1.0000000
NODE_7536_length_956_cov_15.229872	543	623	0	80	80	1.0000000
NODE_7537_length_956_cov_7.533256	439	519	0	80	80	1.0000000
NODE_7537_length_956_cov_7.533256	497	572	0	75	75	1.0000000
NODE_7545_length_955_cov_30.821262	438	518	0	6	80	0.0750000
NODE_7545_length_955_cov_30.821262	438	518	2	39	80	0.4875000
NODE_7545_length_955_cov_30.821262	438	518	6	10	80	0.1250000
NODE_7545_length_955_cov_30.821262	438	518	8	25	80	0.3125000
NODE_7545_length_955_cov_30.821262	491	571	6	38	80	0.4750000
NODE_7545_length_955_cov_30.821262	491	571	8	42	80	0.5250000
NODE_7546_length_955_cov_30.574766	380	460	4	59	80	0.7375000
NODE_7546_length_955_cov_30.574766	380	460	6	21	80	0.2625000
NODE_7546_length_955_cov_30.574766	433	513	2	29	80	0.3625000
NODE_7546_length_955_cov_30.574766	433	513	4	46	80	0.5750000
NODE_7546_length_955_cov_30.574766	433	513	6	5	80	0.0625000
NODE_7546_length_955_cov_30.574766	509	589	2	27	80	0.3375000
NODE_7546_length_955_cov_30.574766	509	589	6	4	80	0.0500000
NODE_7546_length_955_cov_30.574766	509	589	8	49	80	0.6125000
NODE_7546_length_955_cov_30.574766	562	642	6	57	80	0.7125000
NODE_7546_length_955_cov_30.574766	562	642	8	23	80	0.2875000
NODE_7547_length_955_cov_27.734813	373	453	0	80	80	1.0000000
NODE_7547_length_955_cov_27.734813	426	506	0	56	80	0.7000000
NODE_7547_length_955_cov_27.734813	426	506	2	24	80	0.3000000
NODE_7548_length_955_cov_24.475467	439	519	0	19	80	0.2375000
NODE_7548_length_955_cov_24.475467	439	519	2	61	80	0.7625000
NODE_7548_length_955_cov_24.475467	492	572	2	80	80	1.0000000
NODE_7549_length_955_cov_22.146028	351	431	0	80	80	1.0000000
NODE_7549_length_955_cov_22.146028	404	484	0	62	80	0.7750000
NODE_7549_length_955_cov_22.146028	404	484	2	13	80	0.1625000
NODE_7549_length_955_cov_22.146028	404	484	6	5	80	0.0625000
NODE_7550_length_955_cov_16.212617	441	521	0	80	80	1.0000000
NODE_7550_length_955_cov_16.212617	494	574	0	80	80	1.0000000
NODE_7551_length_955_cov_13.334112	269	349	0	80	80	1.0000000
NODE_7551_length_955_cov_13.334112	322	402	0	80	80	1.0000000
NODE_7552_length_955_cov_12.544393	363	443	2	80	80	1.0000000
NODE_7552_length_955_cov_12.544393	416	496	0	30	80	0.3750000
NODE_7552_length_955_cov_12.544393	416	496	2	50	80	0.6250000
NODE_7553_length_955_cov_8.204439	358	438	5	15	80	0.1875000
NODE_7553_length_955_cov_8.204439	358	438	7	65	80	0.8125000
NODE_7553_length_955_cov_8.204439	411	491	0	34	80	0.4250000
NODE_7553_length_955_cov_8.204439	411	491	2	9	80	0.1125000
NODE_7553_length_955_cov_8.204439	411	491	5	14	80	0.1750000
NODE_7553_length_955_cov_8.204439	411	491	7	23	80	0.2875000
NODE_7563_length_954_cov_35.691228	381	461	4	41	80	0.5125000
NODE_7563_length_954_cov_35.691228	381	461	6	34	80	0.4250000
NODE_7563_length_954_cov_35.691228	381	461	8	5	80	0.0625000
NODE_7563_length_954_cov_35.691228	434	514	4	4	80	0.0500000
NODE_7563_length_954_cov_35.691228	434	514	6	71	80	0.8875000
NODE_7563_length_954_cov_35.691228	434	514	8	5	80	0.0625000
NODE_7564_length_954_cov_30.769591	408	488	0	80	80	1.0000000
NODE_7564_length_954_cov_30.769591	461	541	0	80	80	1.0000000
NODE_7565_length_954_cov_27.247953	418	498	0	80	80	1.0000000
NODE_7565_length_954_cov_27.247953	471	551	0	80	80	1.0000000
NODE_7566_length_954_cov_22.796491	270	350	0	17	80	0.2125000
NODE_7566_length_954_cov_22.796491	270	350	2	63	80	0.7875000
NODE_7566_length_954_cov_22.796491	323	403	0	70	80	0.8750000
NODE_7566_length_954_cov_22.796491	323	403	2	10	80	0.1250000
NODE_7567_length_954_cov_15.645614	337	417	0	10	80	0.1250000
NODE_7567_length_954_cov_15.645614	337	417	2	70	80	0.8750000
NODE_7567_length_954_cov_15.645614	390	470	0	45	80	0.5625000
NODE_7567_length_954_cov_15.645614	390	470	2	35	80	0.4375000
NODE_7568_length_954_cov_13.538012	346	426	0	80	80	1.0000000
NODE_7568_length_954_cov_13.538012	399	479	0	80	80	1.0000000
NODE_7569_length_954_cov_12.162573	155	217	0	18	62	0.2903226
NODE_7569_length_954_cov_12.162573	155	217	2	24	62	0.3870968
NODE_7569_length_954_cov_12.162573	155	217	3	3	62	0.0483871
NODE_7569_length_954_cov_12.162573	155	217	4	17	62	0.2741936
NODE_7570_length_954_cov_10.714620	239	319	0	14	80	0.1750000
NODE_7570_length_954_cov_10.714620	239	319	2	22	80	0.2750000
NODE_7570_length_954_cov_10.714620	239	319	4	44	80	0.5500000
NODE_7570_length_954_cov_10.714620	292	372	2	61	80	0.7625000
NODE_7570_length_954_cov_10.714620	292	372	4	19	80	0.2375000
NODE_7571_length_954_cov_5.670175	431	511	3	16	80	0.2000000
NODE_7571_length_954_cov_5.670175	431	511	5	64	80	0.8000000
NODE_7571_length_954_cov_5.670175	484	564	2	6	80	0.0750000
NODE_7571_length_954_cov_5.670175	484	564	3	32	80	0.4000000
NODE_7571_length_954_cov_5.670175	484	564	4	27	80	0.3375000
NODE_7571_length_954_cov_5.670175	484	564	5	15	80	0.1875000
NODE_7582_length_953_cov_35.789227	425	505	2	46	80	0.5750000
NODE_7582_length_953_cov_35.789227	425	505	4	34	80	0.4250000
NODE_7582_length_953_cov_35.789227	478	558	0	8	80	0.1000000
NODE_7582_length_953_cov_35.789227	478	558	2	56	80	0.7000000
NODE_7582_length_953_cov_35.789227	478	558	4	16	80	0.2000000
NODE_7583_length_953_cov_33.940281	430	510	0	80	80	1.0000000
NODE_7583_length_953_cov_33.940281	483	563	0	80	80	1.0000000
NODE_7584_length_953_cov_26.844262	333	413	0	80	80	1.0000000
NODE_7584_length_953_cov_26.844262	386	466	0	80	80	1.0000000
NODE_7584_length_953_cov_26.844262	462	542	0	6	80	0.0750000
NODE_7584_length_953_cov_26.844262	462	542	2	36	80	0.4500000
NODE_7584_length_953_cov_26.844262	462	542	4	14	80	0.1750000
NODE_7584_length_953_cov_26.844262	462	542	6	24	80	0.3000000
NODE_7584_length_953_cov_26.844262	515	595	2	4	80	0.0500000
NODE_7584_length_953_cov_26.844262	515	595	4	40	80	0.5000000
NODE_7584_length_953_cov_26.844262	515	595	6	36	80	0.4500000
NODE_7585_length_953_cov_20.770492	301	381	0	45	80	0.5625000
NODE_7585_length_953_cov_20.770492	301	381	2	27	80	0.3375000
NODE_7585_length_953_cov_20.770492	301	381	4	8	80	0.1000000
NODE_7585_length_953_cov_20.770492	354	434	2	29	80	0.3625000
NODE_7585_length_953_cov_20.770492	354	434	4	51	80	0.6375000
NODE_7586_length_953_cov_17.514052	421	501	0	51	80	0.6375000
NODE_7586_length_953_cov_17.514052	421	501	2	29	80	0.3625000
NODE_7586_length_953_cov_17.514052	474	554	0	61	80	0.7625000
NODE_7586_length_953_cov_17.514052	474	554	2	19	80	0.2375000
NODE_7586_length_953_cov_17.514052	550	630	0	8	80	0.1000000
NODE_7586_length_953_cov_17.514052	550	630	2	71	80	0.8875000
NODE_7586_length_953_cov_17.514052	550	630	4	1	80	0.0125000
NODE_7586_length_953_cov_17.514052	603	683	0	8	80	0.1000000
NODE_7586_length_953_cov_17.514052	603	683	2	18	80	0.2250000
NODE_7586_length_953_cov_17.514052	603	683	4	54	80	0.6750000
NODE_7587_length_953_cov_11.579625	332	412	0	80	80	1.0000000
NODE_7587_length_953_cov_11.579625	385	465	0	80	80	1.0000000
NODE_7588_length_953_cov_7.281030	276	356	0	33	80	0.4125000
NODE_7588_length_953_cov_7.281030	276	356	2	47	80	0.5875000
NODE_7588_length_953_cov_7.281030	329	409	2	80	80	1.0000000
NODE_7599_length_952_cov_44.880422	447	527	0	80	80	1.0000000
NODE_7599_length_952_cov_44.880422	500	580	0	80	80	1.0000000
NODE_7599_length_952_cov_44.880422	871	951	0	80	80	1.0000000
NODE_7600_length_952_cov_42.485346	402	482	0	80	80	1.0000000
NODE_7600_length_952_cov_42.485346	455	535	0	28	80	0.3500000
NODE_7600_length_952_cov_42.485346	455	535	2	2	80	0.0250000
NODE_7600_length_952_cov_42.485346	455	535	4	50	80	0.6250000
NODE_7601_length_952_cov_40.065651	422	502	0	11	80	0.1375000
NODE_7601_length_952_cov_40.065651	422	502	2	69	80	0.8625000
NODE_7601_length_952_cov_40.065651	475	555	0	25	80	0.3125000
NODE_7601_length_952_cov_40.065651	475	555	2	55	80	0.6875000
NODE_7602_length_952_cov_34.813599	308	388	0	80	80	1.0000000
NODE_7602_length_952_cov_34.813599	361	441	0	80	80	1.0000000
NODE_7603_length_952_cov_28.055100	661	741	0	16	80	0.2000000
NODE_7603_length_952_cov_28.055100	661	741	4	2	80	0.0250000
NODE_7603_length_952_cov_28.055100	661	741	6	62	80	0.7750000
NODE_7603_length_952_cov_28.055100	714	794	0	69	80	0.8625000
NODE_7603_length_952_cov_28.055100	714	794	4	2	80	0.0250000
NODE_7603_length_952_cov_28.055100	714	794	6	9	80	0.1125000
NODE_7604_length_952_cov_23.739742	435	515	0	7	80	0.0875000
NODE_7604_length_952_cov_23.739742	435	515	2	73	80	0.9125000
NODE_7604_length_952_cov_23.739742	488	568	0	29	80	0.3625000
NODE_7604_length_952_cov_23.739742	488	568	2	51	80	0.6375000
NODE_7606_length_952_cov_11.478312	245	324	0	60	79	0.7594936
NODE_7606_length_952_cov_11.478312	245	324	2	19	79	0.2405063
NODE_7606_length_952_cov_11.478312	297	377	0	8	80	0.1000000
NODE_7606_length_952_cov_11.478312	297	377	2	72	80	0.9000000
NODE_7607_length_952_cov_11.284877	272	352	0	18	80	0.2250000
NODE_7607_length_952_cov_11.284877	272	352	6	62	80	0.7750000
NODE_7607_length_952_cov_11.284877	325	405	0	37	80	0.4625000
NODE_7607_length_952_cov_11.284877	325	405	6	43	80	0.5375000
NODE_7608_length_952_cov_10.807737	458	538	0	80	80	1.0000000
NODE_7608_length_952_cov_10.807737	511	591	0	80	80	1.0000000
NODE_7609_length_952_cov_8.770223	375	455	0	17	80	0.2125000
NODE_7609_length_952_cov_8.770223	375	455	2	63	80	0.7875000
NODE_7609_length_952_cov_8.770223	428	508	0	27	80	0.3375000
NODE_7609_length_952_cov_8.770223	428	508	2	53	80	0.6625000
NODE_7623_length_951_cov_54.397887	354	434	0	13	80	0.1625000
NODE_7623_length_951_cov_54.397887	354	434	2	67	80	0.8375000
NODE_7623_length_951_cov_54.397887	407	487	2	80	80	1.0000000
NODE_7623_length_951_cov_54.397887	483	563	0	3	80	0.0375000
NODE_7623_length_951_cov_54.397887	483	563	2	77	80	0.9625000
NODE_7623_length_951_cov_54.397887	544	616	2	72	72	1.0000000
NODE_7624_length_951_cov_47.881455	355	435	0	44	80	0.5500000
NODE_7624_length_951_cov_47.881455	355	435	2	36	80	0.4500000
NODE_7624_length_951_cov_47.881455	408	488	2	80	80	1.0000000
NODE_7624_length_951_cov_47.881455	484	564	2	4	80	0.0500000
NODE_7624_length_951_cov_47.881455	484	564	4	2	80	0.0250000
NODE_7624_length_951_cov_47.881455	484	564	6	46	80	0.5750000
NODE_7624_length_951_cov_47.881455	484	564	8	6	80	0.0750000
NODE_7624_length_951_cov_47.881455	484	564	10	22	80	0.2750000
NODE_7624_length_951_cov_47.881455	537	617	6	5	80	0.0625000
NODE_7624_length_951_cov_47.881455	537	617	8	9	80	0.1125000
NODE_7624_length_951_cov_47.881455	537	617	10	66	80	0.8250000
NODE_7625_length_951_cov_24.322770	479	559	0	29	80	0.3625000
NODE_7625_length_951_cov_24.322770	479	559	2	51	80	0.6375000
NODE_7625_length_951_cov_24.322770	532	612	0	80	80	1.0000000
NODE_7626_length_951_cov_23.001174	470	550	2	80	80	1.0000000
NODE_7626_length_951_cov_23.001174	523	603	0	37	80	0.4625000
NODE_7626_length_951_cov_23.001174	523	603	2	43	80	0.5375000
NODE_7627_length_951_cov_22.059859	562	642	0	47	80	0.5875000
NODE_7627_length_951_cov_22.059859	562	642	2	1	80	0.0125000
NODE_7627_length_951_cov_22.059859	562	642	4	32	80	0.4000000
NODE_7627_length_951_cov_22.059859	615	695	4	45	80	0.5625000
NODE_7627_length_951_cov_22.059859	615	695	8	12	80	0.1500000
NODE_7627_length_951_cov_22.059859	615	695	9	14	80	0.1750000
NODE_7627_length_951_cov_22.059859	615	695	10	9	80	0.1125000
NODE_7628_length_951_cov_19.413146	456	536	2	21	80	0.2625000
NODE_7628_length_951_cov_19.413146	456	536	6	4	80	0.0500000
NODE_7628_length_951_cov_19.413146	456	536	8	24	80	0.3000000
NODE_7628_length_951_cov_19.413146	456	536	10	31	80	0.3875000
NODE_7628_length_951_cov_19.413146	509	589	2	6	80	0.0750000
NODE_7628_length_951_cov_19.413146	509	589	6	25	80	0.3125000
NODE_7628_length_951_cov_19.413146	509	589	8	2	80	0.0250000
NODE_7628_length_951_cov_19.413146	509	589	10	47	80	0.5875000
NODE_7628_length_951_cov_19.413146	830	877	4	38	47	0.8085107
NODE_7628_length_951_cov_19.413146	830	877	6	9	47	0.1914894
NODE_7629_length_951_cov_18.970657	384	464	0	20	80	0.2500000
NODE_7629_length_951_cov_18.970657	384	464	2	60	80	0.7500000
NODE_7629_length_951_cov_18.970657	437	517	0	73	80	0.9125000
NODE_7629_length_951_cov_18.970657	437	517	2	7	80	0.0875000
NODE_7629_length_951_cov_18.970657	513	593	0	80	80	1.0000000
NODE_7629_length_951_cov_18.970657	566	646	0	80	80	1.0000000
NODE_7630_length_951_cov_17.164319	409	490	0	81	81	1.0000000
NODE_7630_length_951_cov_17.164319	463	543	0	80	80	1.0000000
NODE_7631_length_951_cov_17.009390	393	473	0	80	80	1.0000000
NODE_7631_length_951_cov_17.009390	446	526	0	80	80	1.0000000
NODE_7632_length_951_cov_15.551643	520	600	1	13	80	0.1625000
NODE_7632_length_951_cov_15.551643	520	600	3	5	80	0.0625000
NODE_7632_length_951_cov_15.551643	520	600	4	12	80	0.1500000
NODE_7632_length_951_cov_15.551643	520	600	5	21	80	0.2625000
NODE_7632_length_951_cov_15.551643	520	600	6	29	80	0.3625000
NODE_7632_length_951_cov_15.551643	573	653	1	66	80	0.8250000
NODE_7632_length_951_cov_15.551643	573	653	3	5	80	0.0625000
NODE_7632_length_951_cov_15.551643	573	653	4	9	80	0.1125000
NODE_7633_length_951_cov_13.562207	364	444	0	80	80	1.0000000
NODE_7633_length_951_cov_13.562207	417	497	0	80	80	1.0000000
NODE_7634_length_951_cov_13.086854	450	530	0	80	80	1.0000000
NODE_7634_length_951_cov_13.086854	503	583	0	32	80	0.4000000
NODE_7634_length_951_cov_13.086854	503	583	2	48	80	0.6000000
NODE_7635_length_951_cov_6.812207	350	430	2	80	80	1.0000000
NODE_7635_length_951_cov_6.812207	403	483	0	46	80	0.5750000
NODE_7635_length_951_cov_6.812207	403	483	2	34	80	0.4250000
NODE_7636_length_951_cov_5.076291	80	160	0	80	80	1.0000000
NODE_7636_length_951_cov_5.076291	133	213	0	80	80	1.0000000
NODE_7649_length_950_cov_62.151586	731	794	2	13	63	0.2063492
NODE_7649_length_950_cov_62.151586	731	794	4	8	63	0.1269841
NODE_7649_length_950_cov_62.151586	731	794	6	1	63	0.0158730
NODE_7649_length_950_cov_62.151586	731	794	10	4	63	0.0634921
NODE_7649_length_950_cov_62.151586	731	794	12	8	63	0.1269841
NODE_7649_length_950_cov_62.151586	731	794	14	6	63	0.0952381
NODE_7649_length_950_cov_62.151586	731	794	16	10	63	0.1587302
NODE_7649_length_950_cov_62.151586	731	794	20	4	63	0.0634921
NODE_7649_length_950_cov_62.151586	731	794	22	3	63	0.0476190
NODE_7649_length_950_cov_62.151586	731	794	24	6	63	0.0952381
NODE_7650_length_950_cov_56.088132	354	434	0	80	80	1.0000000
NODE_7650_length_950_cov_56.088132	407	487	0	80	80	1.0000000
NODE_7650_length_950_cov_56.088132	483	563	0	6	80	0.0750000
NODE_7650_length_950_cov_56.088132	483	563	2	17	80	0.2125000
NODE_7650_length_950_cov_56.088132	483	563	4	57	80	0.7125000
NODE_7650_length_950_cov_56.088132	536	616	0	27	80	0.3375000
NODE_7650_length_950_cov_56.088132	536	616	2	16	80	0.2000000
NODE_7650_length_950_cov_56.088132	536	616	4	37	80	0.4625000
NODE_7651_length_950_cov_29.780259	501	581	0	80	80	1.0000000
NODE_7651_length_950_cov_29.780259	554	634	0	80	80	1.0000000
NODE_7652_length_950_cov_27.278496	388	468	0	80	80	1.0000000
NODE_7652_length_950_cov_27.278496	441	519	0	78	78	1.0000000
NODE_7653_length_950_cov_26.766157	322	402	2	80	80	1.0000000
NODE_7653_length_950_cov_26.766157	375	455	0	22	80	0.2750000
NODE_7653_length_950_cov_26.766157	375	455	2	58	80	0.7250000
NODE_7653_length_950_cov_26.766157	451	531	0	76	80	0.9500000
NODE_7653_length_950_cov_26.766157	451	531	2	4	80	0.0500000
NODE_7653_length_950_cov_26.766157	504	584	0	23	80	0.2875000
NODE_7653_length_950_cov_26.766157	504	584	2	57	80	0.7125000
NODE_7654_length_950_cov_19.638073	421	501	0	67	80	0.8375000
NODE_7654_length_950_cov_19.638073	421	501	1	1	80	0.0125000
NODE_7654_length_950_cov_19.638073	421	501	2	12	80	0.1500000
NODE_7654_length_950_cov_19.638073	474	554	0	14	80	0.1750000
NODE_7654_length_950_cov_19.638073	474	554	1	1	80	0.0125000
NODE_7654_length_950_cov_19.638073	474	554	2	65	80	0.8125000
NODE_7654_length_950_cov_19.638073	550	630	0	53	80	0.6625000
NODE_7654_length_950_cov_19.638073	550	630	2	27	80	0.3375000
NODE_7654_length_950_cov_19.638073	603	683	0	80	80	1.0000000
NODE_7655_length_950_cov_14.686251	376	456	0	42	80	0.5250000
NODE_7655_length_950_cov_14.686251	376	456	4	28	80	0.3500000
NODE_7655_length_950_cov_14.686251	376	456	6	10	80	0.1250000
NODE_7655_length_950_cov_14.686251	429	509	2	3	80	0.0375000
NODE_7655_length_950_cov_14.686251	429	509	4	17	80	0.2125000
NODE_7655_length_950_cov_14.686251	429	509	6	60	80	0.7500000
NODE_7656_length_950_cov_14.215041	339	419	0	21	80	0.2625000
NODE_7656_length_950_cov_14.215041	339	419	2	59	80	0.7375000
NODE_7656_length_950_cov_14.215041	392	472	0	10	80	0.1250000
NODE_7656_length_950_cov_14.215041	392	472	2	70	80	0.8750000
NODE_7657_length_950_cov_6.397180	370	450	0	80	80	1.0000000
NODE_7657_length_950_cov_6.397180	423	504	0	81	81	1.0000000
NODE_7659_length_950_cov_4.430082	594	674	0	80	80	1.0000000
NODE_7659_length_950_cov_4.430082	647	727	0	80	80	1.0000000
NODE_7672_length_949_cov_25.550588	371	451	0	80	80	1.0000000
NODE_7672_length_949_cov_25.550588	500	580	0	68	80	0.8500000
NODE_7672_length_949_cov_25.550588	500	580	2	12	80	0.1500000
NODE_7672_length_949_cov_25.550588	553	633	0	19	80	0.2375000
NODE_7672_length_949_cov_25.550588	553	633	2	61	80	0.7625000
NODE_7673_length_949_cov_20.949412	252	332	0	80	80	1.0000000
NODE_7673_length_949_cov_20.949412	305	385	0	80	80	1.0000000
NODE_7674_length_949_cov_20.601176	364	444	0	80	80	1.0000000
NODE_7674_length_949_cov_20.601176	417	497	0	80	80	1.0000000
NODE_7674_length_949_cov_20.601176	493	573	0	80	80	1.0000000
NODE_7674_length_949_cov_20.601176	546	626	0	80	80	1.0000000
NODE_7675_length_949_cov_20.575294	481	561	2	12	80	0.1500000
NODE_7675_length_949_cov_20.575294	481	561	4	31	80	0.3875000
NODE_7675_length_949_cov_20.575294	481	561	6	37	80	0.4625000
NODE_7675_length_949_cov_20.575294	534	614	2	49	80	0.6125000
NODE_7675_length_949_cov_20.575294	534	614	4	21	80	0.2625000
NODE_7675_length_949_cov_20.575294	534	614	6	10	80	0.1250000
NODE_7676_length_949_cov_19.483529	340	420	0	80	80	1.0000000
NODE_7676_length_949_cov_19.483529	393	473	0	80	80	1.0000000
NODE_7676_length_949_cov_19.483529	469	549	0	80	80	1.0000000
NODE_7676_length_949_cov_19.483529	522	602	0	80	80	1.0000000
NODE_7677_length_949_cov_19.407059	433	513	2	80	80	1.0000000
NODE_7677_length_949_cov_19.407059	486	566	0	49	80	0.6125000
NODE_7677_length_949_cov_19.407059	486	566	2	31	80	0.3875000
NODE_7677_length_949_cov_19.407059	562	642	0	52	80	0.6500000
NODE_7677_length_949_cov_19.407059	562	642	2	28	80	0.3500000
NODE_7677_length_949_cov_19.407059	615	695	2	80	80	1.0000000
NODE_7678_length_949_cov_10.903529	561	641	0	80	80	1.0000000
NODE_7678_length_949_cov_10.903529	614	694	0	80	80	1.0000000
NODE_7679_length_949_cov_7.245882	0	71	2	12	71	0.1690141
NODE_7679_length_949_cov_7.245882	0	71	4	4	71	0.0563380
NODE_7679_length_949_cov_7.245882	0	71	6	3	71	0.0422535
NODE_7679_length_949_cov_7.245882	0	71	8	52	71	0.7323943
NODE_7679_length_949_cov_7.245882	0	71	2	12	71	0.1690141
NODE_7679_length_949_cov_7.245882	0	71	4	4	71	0.0563380
NODE_7679_length_949_cov_7.245882	0	71	6	3	71	0.0422535
NODE_7679_length_949_cov_7.245882	0	71	8	52	71	0.7323943
NODE_7679_length_949_cov_7.245882	44	124	6	5	80	0.0625000
NODE_7679_length_949_cov_7.245882	44	124	8	75	80	0.9375000
NODE_7680_length_949_cov_6.998824	494	574	0	80	80	1.0000000
NODE_7680_length_949_cov_6.998824	547	627	0	80	80	1.0000000
NODE_7702_length_948_cov_37.201413	510	590	2	73	80	0.9125000
NODE_7702_length_948_cov_37.201413	510	590	4	7	80	0.0875000
NODE_7702_length_948_cov_37.201413	563	643	0	24	80	0.3000000
NODE_7702_length_948_cov_37.201413	563	643	2	56	80	0.7000000
NODE_7703_length_948_cov_20.082450	58	99	0	41	41	1.0000000
NODE_7703_length_948_cov_20.082450	113	193	4	6	80	0.0750000
NODE_7703_length_948_cov_20.082450	113	193	6	2	80	0.0250000
NODE_7703_length_948_cov_20.082450	113	193	8	3	80	0.0375000
NODE_7703_length_948_cov_20.082450	113	193	10	11	80	0.1375000
NODE_7703_length_948_cov_20.082450	113	193	14	14	80	0.1750000
NODE_7703_length_948_cov_20.082450	113	193	16	21	80	0.2625000
NODE_7703_length_948_cov_20.082450	113	193	20	11	80	0.1375000
NODE_7703_length_948_cov_20.082450	113	193	22	12	80	0.1500000
NODE_7703_length_948_cov_20.082450	166	246	16	4	80	0.0500000
NODE_7703_length_948_cov_20.082450	166	246	20	11	80	0.1375000
NODE_7703_length_948_cov_20.082450	166	246	22	23	80	0.2875000
NODE_7703_length_948_cov_20.082450	166	246	24	19	80	0.2375000
NODE_7703_length_948_cov_20.082450	166	246	26	4	80	0.0500000
NODE_7703_length_948_cov_20.082450	166	246	28	4	80	0.0500000
NODE_7703_length_948_cov_20.082450	166	246	30	15	80	0.1875000
NODE_7704_length_948_cov_16.785630	308	388	1	80	80	1.0000000
NODE_7704_length_948_cov_16.785630	361	441	0	27	80	0.3375000
NODE_7704_length_948_cov_16.785630	361	441	1	53	80	0.6625000
NODE_7704_length_948_cov_16.785630	437	517	0	2	80	0.0250000
NODE_7704_length_948_cov_16.785630	437	517	1	78	80	0.9750000
NODE_7704_length_948_cov_16.785630	490	570	1	80	80	1.0000000
NODE_7705_length_948_cov_12.740872	400	480	0	33	80	0.4125000
NODE_7705_length_948_cov_12.740872	400	480	2	47	80	0.5875000
NODE_7705_length_948_cov_12.740872	453	533	0	80	80	1.0000000
NODE_7706_length_948_cov_10.220259	465	545	0	80	80	1.0000000
NODE_7706_length_948_cov_10.220259	518	598	0	80	80	1.0000000
NODE_7707_length_948_cov_8.504122	456	536	0	80	80	1.0000000
NODE_7707_length_948_cov_8.504122	509	589	0	80	80	1.0000000
NODE_7709_length_948_cov_5.425206	641	721	0	2	80	0.0250000
NODE_7709_length_948_cov_5.425206	641	721	2	23	80	0.2875000
NODE_7709_length_948_cov_5.425206	641	721	4	55	80	0.6875000
NODE_7709_length_948_cov_5.425206	694	774	0	32	80	0.4000000
NODE_7709_length_948_cov_5.425206	694	774	2	31	80	0.3875000
NODE_7709_length_948_cov_5.425206	694	774	4	17	80	0.2125000
NODE_7711_length_948_cov_3.586572	696	776	0	80	80	1.0000000
NODE_7715_length_948_cov_2.786808	259	324	0	11	65	0.1692308
NODE_7715_length_948_cov_2.786808	259	324	2	54	65	0.8307692
NODE_7715_length_948_cov_2.786808	297	377	0	18	80	0.2250000
NODE_7715_length_948_cov_2.786808	297	377	2	62	80	0.7750000
NODE_7721_length_947_cov_91.466981	393	473	2	80	80	1.0000000
NODE_7721_length_947_cov_91.466981	446	526	0	52	80	0.6500000
NODE_7721_length_947_cov_91.466981	446	526	2	28	80	0.3500000
NODE_7722_length_947_cov_61.139151	402	482	0	27	80	0.3375000
NODE_7722_length_947_cov_61.139151	402	482	2	53	80	0.6625000
NODE_7722_length_947_cov_61.139151	455	535	0	80	80	1.0000000
NODE_7723_length_947_cov_50.009434	488	568	0	80	80	1.0000000
NODE_7723_length_947_cov_50.009434	541	621	0	80	80	1.0000000
NODE_7724_length_947_cov_36.271226	511	591	6	53	80	0.6625000
NODE_7724_length_947_cov_36.271226	511	591	8	10	80	0.1250000
NODE_7724_length_947_cov_36.271226	511	591	10	17	80	0.2125000
NODE_7724_length_947_cov_36.271226	564	644	0	37	80	0.4625000
NODE_7724_length_947_cov_36.271226	564	644	4	16	80	0.2000000
NODE_7724_length_947_cov_36.271226	564	644	6	27	80	0.3375000
NODE_7725_length_947_cov_23.384434	425	505	0	54	80	0.6750000
NODE_7725_length_947_cov_23.384434	425	505	2	26	80	0.3250000
NODE_7725_length_947_cov_23.384434	478	558	0	1	80	0.0125000
NODE_7725_length_947_cov_23.384434	478	558	2	79	80	0.9875000
NODE_7726_length_947_cov_19.103774	316	396	0	80	80	1.0000000
NODE_7726_length_947_cov_19.103774	369	449	0	80	80	1.0000000
NODE_7727_length_947_cov_18.853774	516	596	2	32	80	0.4000000
NODE_7727_length_947_cov_18.853774	516	596	6	32	80	0.4000000
NODE_7727_length_947_cov_18.853774	516	596	8	16	80	0.2000000
NODE_7727_length_947_cov_18.853774	569	649	6	80	80	1.0000000
NODE_7728_length_947_cov_18.077830	315	395	0	80	80	1.0000000
NODE_7728_length_947_cov_18.077830	368	448	0	80	80	1.0000000
NODE_7729_length_947_cov_17.713443	403	483	0	80	80	1.0000000
NODE_7729_length_947_cov_17.713443	456	536	0	80	80	1.0000000
NODE_7730_length_947_cov_14.492925	358	438	0	80	80	1.0000000
NODE_7730_length_947_cov_14.492925	411	491	0	80	80	1.0000000
NODE_7730_length_947_cov_14.492925	487	567	0	80	80	1.0000000
NODE_7730_length_947_cov_14.492925	540	620	0	80	80	1.0000000
NODE_7731_length_947_cov_10.573113	550	630	0	45	80	0.5625000
NODE_7731_length_947_cov_10.573113	550	630	2	35	80	0.4375000
NODE_7731_length_947_cov_10.573113	603	683	0	22	80	0.2750000
NODE_7731_length_947_cov_10.573113	603	683	2	58	80	0.7250000
NODE_7732_length_947_cov_7.762972	550	630	4	80	80	1.0000000
NODE_7732_length_947_cov_7.762972	607	683	2	37	76	0.4868421
NODE_7732_length_947_cov_7.762972	607	683	4	37	76	0.4868421
NODE_7732_length_947_cov_7.762972	607	683	6	2	76	0.0263158
NODE_7747_length_946_cov_39.726092	378	458	2	80	80	1.0000000
NODE_7747_length_946_cov_39.726092	431	511	0	51	80	0.6375000
NODE_7747_length_946_cov_39.726092	431	511	2	29	80	0.3625000
NODE_7747_length_946_cov_39.726092	507	587	0	80	80	1.0000000
NODE_7747_length_946_cov_39.726092	560	640	0	80	80	1.0000000
NODE_7748_length_946_cov_32.728453	404	484	0	80	80	1.0000000
NODE_7748_length_946_cov_32.728453	457	537	0	80	80	1.0000000
NODE_7749_length_946_cov_27.548996	280	360	0	80	80	1.0000000
NODE_7749_length_946_cov_27.548996	333	413	0	80	80	1.0000000
NODE_7750_length_946_cov_24.622196	352	432	0	32	80	0.4000000
NODE_7750_length_946_cov_24.622196	352	432	2	14	80	0.1750000
NODE_7750_length_946_cov_24.622196	352	432	4	34	80	0.4250000
NODE_7750_length_946_cov_24.622196	405	486	0	18	81	0.2222222
NODE_7750_length_946_cov_24.622196	405	486	2	12	81	0.1481481
NODE_7750_length_946_cov_24.622196	405	486	4	51	81	0.6296296
NODE_7751_length_946_cov_18.082645	492	572	0	6	80	0.0750000
NODE_7751_length_946_cov_18.082645	492	572	2	53	80	0.6625000
NODE_7751_length_946_cov_18.082645	492	572	4	21	80	0.2625000
NODE_7751_length_946_cov_18.082645	545	625	2	50	80	0.6250000
NODE_7751_length_946_cov_18.082645	545	625	4	30	80	0.3750000
NODE_7752_length_946_cov_18.031877	433	513	2	80	80	1.0000000
NODE_7752_length_946_cov_18.031877	486	566	0	53	80	0.6625000
NODE_7752_length_946_cov_18.031877	486	566	2	27	80	0.3375000
NODE_7753_length_946_cov_15.188902	472	552	2	6	80	0.0750000
NODE_7753_length_946_cov_15.188902	472	552	4	23	80	0.2875000
NODE_7753_length_946_cov_15.188902	472	552	6	51	80	0.6375000
NODE_7753_length_946_cov_15.188902	525	605	0	12	80	0.1500000
NODE_7753_length_946_cov_15.188902	525	605	2	39	80	0.4875000
NODE_7753_length_946_cov_15.188902	525	605	4	13	80	0.1625000
NODE_7753_length_946_cov_15.188902	525	605	6	16	80	0.2000000
NODE_7754_length_946_cov_11.201889	408	488	0	80	80	1.0000000
NODE_7754_length_946_cov_11.201889	461	541	0	80	80	1.0000000
NODE_7768_length_945_cov_42.997636	361	441	0	4	80	0.0500000
NODE_7768_length_945_cov_42.997636	361	441	2	76	80	0.9500000
NODE_7768_length_945_cov_42.997636	414	494	0	57	80	0.7125000
NODE_7768_length_945_cov_42.997636	414	494	2	23	80	0.2875000
NODE_7769_length_945_cov_31.223404	357	437	2	5	80	0.0625000
NODE_7769_length_945_cov_31.223404	357	437	6	3	80	0.0375000
NODE_7769_length_945_cov_31.223404	357	437	8	72	80	0.9000000
NODE_7769_length_945_cov_31.223404	410	490	0	11	80	0.1375000
NODE_7769_length_945_cov_31.223404	410	490	4	28	80	0.3500000
NODE_7769_length_945_cov_31.223404	410	490	6	17	80	0.2125000
NODE_7769_length_945_cov_31.223404	410	490	8	24	80	0.3000000
NODE_7770_length_945_cov_26.348700	331	411	0	13	80	0.1625000
NODE_7770_length_945_cov_26.348700	331	411	2	67	80	0.8375000
NODE_7770_length_945_cov_26.348700	384	464	0	3	80	0.0375000
NODE_7770_length_945_cov_26.348700	384	464	2	77	80	0.9625000
NODE_7771_length_945_cov_20.349882	435	515	0	57	80	0.7125000
NODE_7771_length_945_cov_20.349882	435	515	2	23	80	0.2875000
NODE_7771_length_945_cov_20.349882	488	568	0	4	80	0.0500000
NODE_7771_length_945_cov_20.349882	488	568	2	76	80	0.9500000
NODE_7772_length_945_cov_14.771868	386	466	0	80	80	1.0000000
NODE_7772_length_945_cov_14.771868	439	519	0	80	80	1.0000000
NODE_7773_length_945_cov_10.158392	599	679	0	80	80	1.0000000
NODE_7773_length_945_cov_10.158392	652	732	0	80	80	1.0000000
NODE_7775_length_945_cov_5.403073	357	437	0	80	80	1.0000000
NODE_7775_length_945_cov_5.403073	410	490	0	51	80	0.6375000
NODE_7775_length_945_cov_5.403073	410	490	2	29	80	0.3625000
NODE_7785_length_944_cov_42.401183	358	438	0	61	80	0.7625000
NODE_7785_length_944_cov_42.401183	358	438	4	11	80	0.1375000
NODE_7785_length_944_cov_42.401183	358	438	6	8	80	0.1000000
NODE_7785_length_944_cov_42.401183	411	498	0	8	87	0.0919540
NODE_7785_length_944_cov_42.401183	411	498	4	11	87	0.1264368
NODE_7785_length_944_cov_42.401183	411	498	6	68	87	0.7816092
NODE_7786_length_944_cov_32.712426	377	457	0	80	80	1.0000000
NODE_7786_length_944_cov_32.712426	430	510	0	80	80	1.0000000
NODE_7787_length_944_cov_27.839053	417	497	0	25	80	0.3125000
NODE_7787_length_944_cov_27.839053	417	497	2	55	80	0.6875000
NODE_7787_length_944_cov_27.839053	470	550	0	25	80	0.3125000
NODE_7787_length_944_cov_27.839053	470	550	2	55	80	0.6875000
NODE_7788_length_944_cov_24.702959	413	493	0	12	80	0.1500000
NODE_7788_length_944_cov_24.702959	413	493	2	68	80	0.8500000
NODE_7788_length_944_cov_24.702959	466	546	1	9	80	0.1125000
NODE_7788_length_944_cov_24.702959	466	546	2	71	80	0.8875000
NODE_7789_length_944_cov_11.951479	347	427	0	17	80	0.2125000
NODE_7789_length_944_cov_11.951479	347	427	2	46	80	0.5750000
NODE_7789_length_944_cov_11.951479	347	427	4	17	80	0.2125000
NODE_7789_length_944_cov_11.951479	400	480	0	70	80	0.8750000
NODE_7789_length_944_cov_11.951479	400	480	2	10	80	0.1250000
NODE_7789_length_944_cov_11.951479	476	556	0	80	80	1.0000000
NODE_7789_length_944_cov_11.951479	529	609	0	80	80	1.0000000
NODE_7790_length_944_cov_6.745562	366	446	0	80	80	1.0000000
NODE_7790_length_944_cov_6.745562	419	499	0	80	80	1.0000000
NODE_7792_length_944_cov_4.420118	236	316	2	36	80	0.4500000
NODE_7792_length_944_cov_4.420118	236	316	4	44	80	0.5500000
NODE_7792_length_944_cov_4.420118	289	369	0	27	80	0.3375000
NODE_7792_length_944_cov_4.420118	289	369	2	30	80	0.3750000
NODE_7792_length_944_cov_4.420118	289	369	4	23	80	0.2875000
NODE_7800_length_943_cov_40.111374	536	614	0	78	78	1.0000000
NODE_7800_length_943_cov_40.111374	587	667	0	80	80	1.0000000
NODE_7801_length_943_cov_29.446682	338	418	2	30	80	0.3750000
NODE_7801_length_943_cov_29.446682	338	418	4	42	80	0.5250000
NODE_7801_length_943_cov_29.446682	338	418	6	8	80	0.1000000
NODE_7801_length_943_cov_29.446682	391	471	0	21	80	0.2625000
NODE_7801_length_943_cov_29.446682	391	471	2	4	80	0.0500000
NODE_7801_length_943_cov_29.446682	391	471	4	49	80	0.6125000
NODE_7801_length_943_cov_29.446682	391	471	6	6	80	0.0750000
NODE_7802_length_943_cov_28.289100	393	473	0	27	80	0.3375000
NODE_7802_length_943_cov_28.289100	393	473	2	12	80	0.1500000
NODE_7802_length_943_cov_28.289100	393	473	4	41	80	0.5125000
NODE_7802_length_943_cov_28.289100	446	526	4	80	80	1.0000000
NODE_7803_length_943_cov_27.225118	343	423	0	31	80	0.3875000
NODE_7803_length_943_cov_27.225118	343	423	2	29	80	0.3625000
NODE_7803_length_943_cov_27.225118	343	423	5	20	80	0.2500000
NODE_7803_length_943_cov_27.225118	396	476	2	7	80	0.0875000
NODE_7803_length_943_cov_27.225118	396	476	5	32	80	0.4000000
NODE_7803_length_943_cov_27.225118	396	476	6	41	80	0.5125000
NODE_7804_length_943_cov_26.536730	275	303	2	28	28	1.0000000
NODE_7804_length_943_cov_26.536730	299	379	0	7	80	0.0875000
NODE_7804_length_943_cov_26.536730	299	379	2	12	80	0.1500000
NODE_7804_length_943_cov_26.536730	299	379	4	21	80	0.2625000
NODE_7804_length_943_cov_26.536730	299	379	6	40	80	0.5000000
NODE_7804_length_943_cov_26.536730	352	432	0	13	80	0.1625000
NODE_7804_length_943_cov_26.536730	352	432	2	15	80	0.1875000
NODE_7804_length_943_cov_26.536730	352	432	4	1	80	0.0125000
NODE_7804_length_943_cov_26.536730	352	432	6	51	80	0.6375000
NODE_7805_length_943_cov_24.992891	374	454	0	18	80	0.2250000
NODE_7805_length_943_cov_24.992891	374	454	2	18	80	0.2250000
NODE_7805_length_943_cov_24.992891	374	454	6	23	80	0.2875000
NODE_7805_length_943_cov_24.992891	374	454	8	21	80	0.2625000
NODE_7805_length_943_cov_24.992891	427	507	6	6	80	0.0750000
NODE_7805_length_943_cov_24.992891	427	507	8	48	80	0.6000000
NODE_7805_length_943_cov_24.992891	427	507	10	26	80	0.3250000
NODE_7805_length_943_cov_24.992891	503	583	8	27	80	0.3375000
NODE_7805_length_943_cov_24.992891	503	583	10	41	80	0.5125000
NODE_7805_length_943_cov_24.992891	503	583	12	12	80	0.1500000
NODE_7805_length_943_cov_24.992891	556	636	8	15	80	0.1875000
NODE_7805_length_943_cov_24.992891	556	636	10	40	80	0.5000000
NODE_7805_length_943_cov_24.992891	556	636	12	25	80	0.3125000
NODE_7806_length_943_cov_24.758294	403	483	0	80	80	1.0000000
NODE_7806_length_943_cov_24.758294	456	536	0	80	80	1.0000000
NODE_7807_length_943_cov_22.316351	432	512	0	7	80	0.0875000
NODE_7807_length_943_cov_22.316351	432	512	2	28	80	0.3500000
NODE_7807_length_943_cov_22.316351	432	512	4	4	80	0.0500000
NODE_7807_length_943_cov_22.316351	432	512	6	41	80	0.5125000
NODE_7807_length_943_cov_22.316351	485	565	0	13	80	0.1625000
NODE_7807_length_943_cov_22.316351	485	565	2	20	80	0.2500000
NODE_7807_length_943_cov_22.316351	485	565	4	18	80	0.2250000
NODE_7807_length_943_cov_22.316351	485	565	6	29	80	0.3625000
NODE_7808_length_943_cov_22.149289	393	473	0	80	80	1.0000000
NODE_7808_length_943_cov_22.149289	446	526	0	80	80	1.0000000
NODE_7809_length_943_cov_20.055687	412	492	0	75	80	0.9375000
NODE_7809_length_943_cov_20.055687	412	492	2	5	80	0.0625000
NODE_7809_length_943_cov_20.055687	465	545	0	22	80	0.2750000
NODE_7809_length_943_cov_20.055687	465	545	2	58	80	0.7250000
NODE_7810_length_943_cov_16.022512	338	418	5	10	80	0.1250000
NODE_7810_length_943_cov_16.022512	338	418	6	70	80	0.8750000
NODE_7810_length_943_cov_16.022512	391	471	0	30	80	0.3750000
NODE_7810_length_943_cov_16.022512	391	471	5	33	80	0.4125000
NODE_7810_length_943_cov_16.022512	391	471	6	17	80	0.2125000
NODE_7811_length_943_cov_10.939573	474	554	0	9	80	0.1125000
NODE_7811_length_943_cov_10.939573	474	554	2	71	80	0.8875000
NODE_7811_length_943_cov_10.939573	527	607	0	27	80	0.3375000
NODE_7811_length_943_cov_10.939573	527	607	2	53	80	0.6625000
NODE_7812_length_943_cov_9.483412	422	502	0	80	80	1.0000000
NODE_7812_length_943_cov_9.483412	475	555	0	80	80	1.0000000
NODE_7830_length_942_cov_58.088968	384	464	2	29	80	0.3625000
NODE_7830_length_942_cov_58.088968	384	464	4	51	80	0.6375000
NODE_7830_length_942_cov_58.088968	437	517	0	32	80	0.4000000
NODE_7830_length_942_cov_58.088968	437	517	2	40	80	0.5000000
NODE_7830_length_942_cov_58.088968	437	517	4	8	80	0.1000000
NODE_7832_length_942_cov_27.466192	360	440	0	60	80	0.7500000
NODE_7832_length_942_cov_27.466192	360	440	2	3	80	0.0375000
NODE_7832_length_942_cov_27.466192	360	440	9	12	80	0.1500000
NODE_7832_length_942_cov_27.466192	360	440	12	5	80	0.0625000
NODE_7832_length_942_cov_27.466192	413	493	0	7	80	0.0875000
NODE_7832_length_942_cov_27.466192	413	493	2	3	80	0.0375000
NODE_7832_length_942_cov_27.466192	413	493	9	12	80	0.1500000
NODE_7832_length_942_cov_27.466192	413	493	12	13	80	0.1625000
NODE_7832_length_942_cov_27.466192	413	493	13	45	80	0.5625000
NODE_7833_length_942_cov_26.914591	346	426	0	55	80	0.6875000
NODE_7833_length_942_cov_26.914591	346	426	2	25	80	0.3125000
NODE_7833_length_942_cov_26.914591	399	479	0	9	80	0.1125000
NODE_7833_length_942_cov_26.914591	399	479	2	71	80	0.8875000
NODE_7834_length_942_cov_17.911032	390	470	0	14	80	0.1750000
NODE_7834_length_942_cov_17.911032	390	470	2	66	80	0.8250000
NODE_7834_length_942_cov_17.911032	443	523	0	28	80	0.3500000
NODE_7834_length_942_cov_17.911032	443	523	2	52	80	0.6500000
NODE_7835_length_942_cov_14.695136	442	522	0	80	80	1.0000000
NODE_7835_length_942_cov_14.695136	495	575	0	80	80	1.0000000
NODE_7836_length_942_cov_14.097272	547	627	0	25	80	0.3125000
NODE_7836_length_942_cov_14.097272	547	627	2	55	80	0.6875000
NODE_7836_length_942_cov_14.097272	600	680	0	31	80	0.3875000
NODE_7836_length_942_cov_14.097272	600	680	2	49	80	0.6125000
NODE_7837_length_942_cov_13.174377	322	402	0	65	80	0.8125000
NODE_7837_length_942_cov_13.174377	322	402	2	15	80	0.1875000
NODE_7837_length_942_cov_13.174377	375	455	0	12	80	0.1500000
NODE_7837_length_942_cov_13.174377	375	455	2	68	80	0.8500000
NODE_7858_length_941_cov_36.592637	259	339	0	38	80	0.4750000
NODE_7858_length_941_cov_36.592637	259	339	2	42	80	0.5250000
NODE_7858_length_941_cov_36.592637	312	392	0	80	80	1.0000000
NODE_7858_length_941_cov_36.592637	388	468	0	80	80	1.0000000
NODE_7858_length_941_cov_36.592637	441	521	0	80	80	1.0000000
NODE_7859_length_941_cov_35.375297	352	432	0	80	80	1.0000000
NODE_7859_length_941_cov_35.375297	405	485	0	57	80	0.7125000
NODE_7859_length_941_cov_35.375297	405	485	2	23	80	0.2875000
NODE_7859_length_941_cov_35.375297	481	561	2	80	80	1.0000000
NODE_7859_length_941_cov_35.375297	534	614	0	28	80	0.3500000
NODE_7859_length_941_cov_35.375297	534	614	2	52	80	0.6500000
NODE_7860_length_941_cov_32.222090	407	487	0	80	80	1.0000000
NODE_7860_length_941_cov_32.222090	460	540	0	80	80	1.0000000
NODE_7861_length_941_cov_28.442993	391	471	8	21	80	0.2625000
NODE_7861_length_941_cov_28.442993	391	471	10	11	80	0.1375000
NODE_7861_length_941_cov_28.442993	391	471	12	11	80	0.1375000
NODE_7861_length_941_cov_28.442993	391	471	14	33	80	0.4125000
NODE_7861_length_941_cov_28.442993	391	471	15	4	80	0.0500000
NODE_7861_length_941_cov_28.442993	444	524	7	25	80	0.3125000
NODE_7861_length_941_cov_28.442993	444	524	11	4	80	0.0500000
NODE_7861_length_941_cov_28.442993	444	524	12	15	80	0.1875000
NODE_7861_length_941_cov_28.442993	444	524	14	36	80	0.4500000
NODE_7862_length_941_cov_20.788599	341	421	0	80	80	1.0000000
NODE_7862_length_941_cov_20.788599	394	474	0	80	80	1.0000000
NODE_7863_length_941_cov_18.000000	364	444	0	14	80	0.1750000
NODE_7863_length_941_cov_18.000000	364	444	2	66	80	0.8250000
NODE_7863_length_941_cov_18.000000	417	497	0	41	80	0.5125000
NODE_7863_length_941_cov_18.000000	417	497	2	39	80	0.4875000
NODE_7864_length_941_cov_11.020190	325	405	0	41	80	0.5125000
NODE_7864_length_941_cov_11.020190	325	405	2	39	80	0.4875000
NODE_7864_length_941_cov_11.020190	378	458	0	80	80	1.0000000
NODE_7865_length_941_cov_6.020190	260	287	2	5	27	0.1851852
NODE_7865_length_941_cov_6.020190	260	287	6	22	27	0.8148148
NODE_7865_length_941_cov_6.020190	260	340	2	5	80	0.0625000
NODE_7865_length_941_cov_6.020190	260	340	6	72	80	0.9000000
NODE_7865_length_941_cov_6.020190	260	340	8	3	80	0.0375000
NODE_7867_length_941_cov_3.745843	867	941	0	11	74	0.1486486
NODE_7867_length_941_cov_3.745843	867	941	2	23	74	0.3108108
NODE_7867_length_941_cov_3.745843	867	941	4	40	74	0.5405405
NODE_7877_length_940_cov_43.954816	243	323	0	80	80	1.0000000
NODE_7877_length_940_cov_43.954816	296	376	0	80	80	1.0000000
NODE_7877_length_940_cov_43.954816	372	452	0	80	80	1.0000000
NODE_7877_length_940_cov_43.954816	425	505	0	80	80	1.0000000
NODE_7878_length_940_cov_27.763377	423	503	0	36	80	0.4500000
NODE_7878_length_940_cov_27.763377	423	503	2	44	80	0.5500000
NODE_7878_length_940_cov_27.763377	476	556	2	80	80	1.0000000
NODE_7897_length_939_cov_58.982143	363	443	4	36	80	0.4500000
NODE_7897_length_939_cov_58.982143	363	443	6	30	80	0.3750000
NODE_7897_length_939_cov_58.982143	363	443	8	14	80	0.1750000
NODE_7897_length_939_cov_58.982143	416	496	2	22	80	0.2750000
NODE_7897_length_939_cov_58.982143	416	496	4	16	80	0.2000000
NODE_7897_length_939_cov_58.982143	416	496	6	29	80	0.3625000
NODE_7897_length_939_cov_58.982143	416	496	8	13	80	0.1625000
NODE_7898_length_939_cov_32.469048	327	407	0	37	80	0.4625000
NODE_7898_length_939_cov_32.469048	327	407	2	32	80	0.4000000
NODE_7898_length_939_cov_32.469048	327	407	4	11	80	0.1375000
NODE_7898_length_939_cov_32.469048	380	460	2	37	80	0.4625000
NODE_7898_length_939_cov_32.469048	380	460	4	43	80	0.5375000
NODE_7899_length_939_cov_31.895238	265	345	0	80	80	1.0000000
NODE_7899_length_939_cov_31.895238	318	398	0	80	80	1.0000000
NODE_7900_length_939_cov_25.354762	439	519	0	11	80	0.1375000
NODE_7900_length_939_cov_25.354762	439	519	4	2	80	0.0250000
NODE_7900_length_939_cov_25.354762	439	519	6	31	80	0.3875000
NODE_7900_length_939_cov_25.354762	439	519	8	36	80	0.4500000
NODE_7900_length_939_cov_25.354762	492	572	4	11	80	0.1375000
NODE_7900_length_939_cov_25.354762	492	572	6	8	80	0.1000000
NODE_7900_length_939_cov_25.354762	492	572	8	61	80	0.7625000
NODE_7901_length_939_cov_24.892857	370	450	0	80	80	1.0000000
NODE_7901_length_939_cov_24.892857	423	503	0	80	80	1.0000000
NODE_7902_length_939_cov_24.246429	422	502	0	80	80	1.0000000
NODE_7902_length_939_cov_24.246429	475	555	0	80	80	1.0000000
NODE_7902_length_939_cov_24.246429	551	631	0	80	80	1.0000000
NODE_7902_length_939_cov_24.246429	604	684	0	80	80	1.0000000
NODE_7903_length_939_cov_21.141667	368	448	0	80	80	1.0000000
NODE_7903_length_939_cov_21.141667	421	501	0	59	80	0.7375000
NODE_7903_length_939_cov_21.141667	421	501	2	21	80	0.2625000
NODE_7904_length_939_cov_16.425000	327	407	2	30	80	0.3750000
NODE_7904_length_939_cov_16.425000	327	407	4	27	80	0.3375000
NODE_7904_length_939_cov_16.425000	327	407	8	23	80	0.2875000
NODE_7904_length_939_cov_16.425000	380	460	4	4	80	0.0500000
NODE_7904_length_939_cov_16.425000	380	460	5	7	80	0.0875000
NODE_7904_length_939_cov_16.425000	380	460	7	10	80	0.1250000
NODE_7904_length_939_cov_16.425000	380	460	8	59	80	0.7375000
NODE_7905_length_939_cov_13.828571	469	548	0	79	79	1.0000000
NODE_7905_length_939_cov_13.828571	522	603	0	81	81	1.0000000
NODE_7906_length_939_cov_13.521429	402	482	0	6	80	0.0750000
NODE_7906_length_939_cov_13.521429	402	482	2	74	80	0.9250000
NODE_7906_length_939_cov_13.521429	455	535	0	59	80	0.7375000
NODE_7906_length_939_cov_13.521429	455	535	2	21	80	0.2625000
NODE_7907_length_939_cov_12.955952	398	478	0	80	80	1.0000000
NODE_7907_length_939_cov_12.955952	451	531	0	80	80	1.0000000
NODE_7908_length_939_cov_6.564286	523	545	0	22	22	1.0000000
NODE_7922_length_938_cov_44.458880	362	442	0	73	80	0.9125000
NODE_7922_length_938_cov_44.458880	362	442	2	7	80	0.0875000
NODE_7922_length_938_cov_44.458880	415	495	0	20	80	0.2500000
NODE_7922_length_938_cov_44.458880	415	495	2	41	80	0.5125000
NODE_7922_length_938_cov_44.458880	415	495	4	19	80	0.2375000
NODE_7923_length_938_cov_44.435042	748	815	2	67	67	1.0000000
NODE_7924_length_938_cov_32.177592	466	546	3	4	80	0.0500000
NODE_7924_length_938_cov_32.177592	466	546	7	76	80	0.9500000
NODE_7924_length_938_cov_32.177592	519	599	2	22	80	0.2750000
NODE_7924_length_938_cov_32.177592	519	599	3	33	80	0.4125000
NODE_7924_length_938_cov_32.177592	519	599	7	25	80	0.3125000
NODE_7925_length_938_cov_21.139452	474	554	0	80	80	1.0000000
NODE_7925_length_938_cov_21.139452	527	607	0	80	80	1.0000000
NODE_7927_length_938_cov_8.791418	300	380	2	51	80	0.6375000
NODE_7927_length_938_cov_8.791418	300	380	4	29	80	0.3625000
NODE_7927_length_938_cov_8.791418	353	433	2	24	80	0.3000000
NODE_7927_length_938_cov_8.791418	353	433	4	56	80	0.7000000
NODE_7932_length_938_cov_2.693683	59	139	0	2	80	0.0250000
NODE_7932_length_938_cov_2.693683	59	139	4	6	80	0.0750000
NODE_7932_length_938_cov_2.693683	59	139	10	72	80	0.9000000
NODE_7932_length_938_cov_2.693683	112	192	0	55	80	0.6875000
NODE_7932_length_938_cov_2.693683	112	192	4	4	80	0.0500000
NODE_7932_length_938_cov_2.693683	112	192	10	21	80	0.2625000
NODE_7946_length_937_cov_31.890215	407	487	0	80	80	1.0000000
NODE_7946_length_937_cov_31.890215	460	536	0	76	76	1.0000000
NODE_7947_length_937_cov_31.198091	425	505	0	80	80	1.0000000
NODE_7947_length_937_cov_31.198091	478	558	0	80	80	1.0000000
NODE_7948_length_937_cov_29.742243	296	376	0	80	80	1.0000000
NODE_7948_length_937_cov_29.742243	349	429	0	80	80	1.0000000
NODE_7948_length_937_cov_29.742243	425	505	0	5	80	0.0625000
NODE_7948_length_937_cov_29.742243	425	505	2	39	80	0.4875000
NODE_7948_length_937_cov_29.742243	425	505	6	28	80	0.3500000
NODE_7948_length_937_cov_29.742243	425	505	8	8	80	0.1000000
NODE_7948_length_937_cov_29.742243	478	558	6	52	80	0.6500000
NODE_7948_length_937_cov_29.742243	478	558	8	28	80	0.3500000
NODE_7950_length_937_cov_26.153938	487	567	0	56	80	0.7000000
NODE_7950_length_937_cov_26.153938	487	567	2	24	80	0.3000000
NODE_7950_length_937_cov_26.153938	540	620	0	3	80	0.0375000
NODE_7950_length_937_cov_26.153938	540	620	2	77	80	0.9625000
NODE_7951_length_937_cov_20.898568	515	595	0	80	80	1.0000000
NODE_7951_length_937_cov_20.898568	568	648	0	80	80	1.0000000
NODE_7952_length_937_cov_20.502387	181	261	6	12	80	0.1500000
NODE_7952_length_937_cov_20.502387	181	261	8	12	80	0.1500000
NODE_7952_length_937_cov_20.502387	181	261	10	9	80	0.1125000
NODE_7952_length_937_cov_20.502387	181	261	12	47	80	0.5875000
NODE_7952_length_937_cov_20.502387	234	314	0	21	80	0.2625000
NODE_7952_length_937_cov_20.502387	234	314	2	4	80	0.0500000
NODE_7952_length_937_cov_20.502387	234	314	4	21	80	0.2625000
NODE_7952_length_937_cov_20.502387	234	314	6	19	80	0.2375000
NODE_7952_length_937_cov_20.502387	234	314	10	5	80	0.0625000
NODE_7952_length_937_cov_20.502387	234	314	12	10	80	0.1250000
NODE_7952_length_937_cov_20.502387	310	390	0	80	80	1.0000000
NODE_7952_length_937_cov_20.502387	363	443	0	80	80	1.0000000
NODE_7953_length_937_cov_15.219570	526	606	0	80	80	1.0000000
NODE_7953_length_937_cov_15.219570	579	659	0	80	80	1.0000000
NODE_7954_length_937_cov_9.633652	521	601	0	5	80	0.0625000
NODE_7954_length_937_cov_9.633652	521	601	2	26	80	0.3250000
NODE_7954_length_937_cov_9.633652	521	601	4	13	80	0.1625000
NODE_7954_length_937_cov_9.633652	521	601	6	36	80	0.4500000
NODE_7954_length_937_cov_9.633652	574	654	0	22	80	0.2750000
NODE_7954_length_937_cov_9.633652	574	654	4	44	80	0.5500000
NODE_7954_length_937_cov_9.633652	574	654	6	14	80	0.1750000
NODE_7956_length_937_cov_6.630072	305	385	0	80	80	1.0000000
NODE_7956_length_937_cov_6.630072	358	438	0	80	80	1.0000000
NODE_7957_length_937_cov_4.649165	470	550	0	62	80	0.7750000
NODE_7957_length_937_cov_4.649165	470	550	2	18	80	0.2250000
NODE_7957_length_937_cov_4.649165	523	603	0	80	80	1.0000000
NODE_7969_length_936_cov_57.105137	267	347	0	80	80	1.0000000
NODE_7969_length_936_cov_57.105137	320	400	0	64	80	0.8000000
NODE_7969_length_936_cov_57.105137	320	400	2	16	80	0.2000000
NODE_7969_length_936_cov_57.105137	396	476	0	20	80	0.2500000
NODE_7969_length_936_cov_57.105137	396	476	2	60	80	0.7500000
NODE_7969_length_936_cov_57.105137	449	529	0	39	80	0.4875000
NODE_7969_length_936_cov_57.105137	449	529	2	41	80	0.5125000
NODE_7970_length_936_cov_39.983274	433	513	0	1	80	0.0125000
NODE_7970_length_936_cov_39.983274	433	513	2	8	80	0.1000000
NODE_7970_length_936_cov_39.983274	433	513	4	71	80	0.8875000
NODE_7970_length_936_cov_39.983274	486	566	0	24	80	0.3000000
NODE_7970_length_936_cov_39.983274	486	566	2	38	80	0.4750000
NODE_7970_length_936_cov_39.983274	486	566	4	18	80	0.2250000
NODE_7971_length_936_cov_22.486260	534	614	0	16	80	0.2000000
NODE_7971_length_936_cov_22.486260	534	614	2	4	80	0.0500000
NODE_7971_length_936_cov_22.486260	534	614	3	8	80	0.1000000
NODE_7971_length_936_cov_22.486260	534	614	4	39	80	0.4875000
NODE_7971_length_936_cov_22.486260	534	614	6	13	80	0.1625000
NODE_7971_length_936_cov_22.486260	587	667	0	69	80	0.8625000
NODE_7971_length_936_cov_22.486260	587	667	2	4	80	0.0500000
NODE_7971_length_936_cov_22.486260	587	667	3	7	80	0.0875000
NODE_7972_length_936_cov_19.639188	409	489	0	80	80	1.0000000
NODE_7972_length_936_cov_19.639188	462	542	0	80	80	1.0000000
NODE_7973_length_936_cov_15.083632	322	402	0	6	80	0.0750000
NODE_7973_length_936_cov_15.083632	322	402	3	1	80	0.0125000
NODE_7973_length_936_cov_15.083632	322	402	4	58	80	0.7250000
NODE_7973_length_936_cov_15.083632	322	402	6	15	80	0.1875000
NODE_7973_length_936_cov_15.083632	375	455	4	12	80	0.1500000
NODE_7973_length_936_cov_15.083632	375	455	5	1	80	0.0125000
NODE_7973_length_936_cov_15.083632	375	455	6	67	80	0.8375000
NODE_7974_length_936_cov_13.962963	356	424	8	22	68	0.3235294
NODE_7974_length_936_cov_13.962963	356	424	10	46	68	0.6764706
NODE_7975_length_936_cov_12.502987	447	527	0	80	80	1.0000000
NODE_7975_length_936_cov_12.502987	500	580	0	80	80	1.0000000
NODE_7976_length_936_cov_12.279570	340	420	0	80	80	1.0000000
NODE_7976_length_936_cov_12.279570	393	473	0	80	80	1.0000000
NODE_7977_length_936_cov_7.906810	587	667	2	50	80	0.6250000
NODE_7977_length_936_cov_7.906810	587	667	4	30	80	0.3750000
NODE_7977_length_936_cov_7.906810	640	720	0	29	80	0.3625000
NODE_7977_length_936_cov_7.906810	640	720	2	49	80	0.6125000
NODE_7977_length_936_cov_7.906810	640	720	4	2	80	0.0250000
NODE_7978_length_936_cov_6.845878	322	402	0	80	80	1.0000000
NODE_7978_length_936_cov_6.845878	375	455	0	80	80	1.0000000
NODE_7979_length_936_cov_6.434886	556	635	0	79	79	1.0000000
NODE_7979_length_936_cov_6.434886	608	688	0	80	80	1.0000000
NODE_7993_length_935_cov_38.209330	57	137	63	2	80	0.0250000
NODE_7993_length_935_cov_38.209330	57	137	65	1	80	0.0125000
NODE_7993_length_935_cov_38.209330	57	137	67	3	80	0.0375000
NODE_7993_length_935_cov_38.209330	57	137	69	5	80	0.0625000
NODE_7993_length_935_cov_38.209330	57	137	74	3	80	0.0375000
NODE_7993_length_935_cov_38.209330	57	137	78	2	80	0.0250000
NODE_7993_length_935_cov_38.209330	57	137	80	2	80	0.0250000
NODE_7993_length_935_cov_38.209330	57	137	82	1	80	0.0125000
NODE_7993_length_935_cov_38.209330	57	137	84	1	80	0.0125000
NODE_7993_length_935_cov_38.209330	57	137	88	5	80	0.0625000
NODE_7993_length_935_cov_38.209330	57	137	92	1	80	0.0125000
NODE_7993_length_935_cov_38.209330	57	137	96	2	80	0.0250000
NODE_7993_length_935_cov_38.209330	57	137	98	3	80	0.0375000
NODE_7993_length_935_cov_38.209330	57	137	100	49	80	0.6125000
NODE_7994_length_935_cov_27.306220	439	519	6	42	80	0.5250000
NODE_7994_length_935_cov_27.306220	439	519	8	8	80	0.1000000
NODE_7994_length_935_cov_27.306220	439	519	9	21	80	0.2625000
NODE_7994_length_935_cov_27.306220	439	519	10	9	80	0.1125000
NODE_7994_length_935_cov_27.306220	492	572	4	36	80	0.4500000
NODE_7994_length_935_cov_27.306220	492	572	8	25	80	0.3125000
NODE_7994_length_935_cov_27.306220	492	572	9	19	80	0.2375000
NODE_7995_length_935_cov_26.562201	321	401	0	80	80	1.0000000
NODE_7995_length_935_cov_26.562201	374	454	0	80	80	1.0000000
NODE_7995_length_935_cov_26.562201	450	530	0	5	80	0.0625000
NODE_7995_length_935_cov_26.562201	450	530	2	35	80	0.4375000
NODE_7995_length_935_cov_26.562201	450	530	4	40	80	0.5000000
NODE_7995_length_935_cov_26.562201	503	583	2	7	80	0.0875000
NODE_7995_length_935_cov_26.562201	503	583	4	73	80	0.9125000
NODE_7996_length_935_cov_25.098086	356	436	0	80	80	1.0000000
NODE_7996_length_935_cov_25.098086	409	489	0	80	80	1.0000000
NODE_7997_length_935_cov_24.316986	467	547	0	5	80	0.0625000
NODE_7997_length_935_cov_24.316986	467	547	2	17	80	0.2125000
NODE_7997_length_935_cov_24.316986	467	547	5	2	80	0.0250000
NODE_7997_length_935_cov_24.316986	467	547	6	30	80	0.3750000
NODE_7997_length_935_cov_24.316986	467	547	8	26	80	0.3250000
NODE_7997_length_935_cov_24.316986	520	600	2	2	80	0.0250000
NODE_7997_length_935_cov_24.316986	520	600	4	21	80	0.2625000
NODE_7997_length_935_cov_24.316986	520	600	6	22	80	0.2750000
NODE_7997_length_935_cov_24.316986	520	600	8	35	80	0.4375000
NODE_7998_length_935_cov_19.221292	397	477	0	80	80	1.0000000
NODE_7998_length_935_cov_19.221292	450	530	0	80	80	1.0000000
NODE_7999_length_935_cov_15.016746	404	484	0	75	80	0.9375000
NODE_7999_length_935_cov_15.016746	404	484	2	5	80	0.0625000
NODE_7999_length_935_cov_15.016746	457	537	0	22	80	0.2750000
NODE_7999_length_935_cov_15.016746	457	537	2	58	80	0.7250000
NODE_8000_length_935_cov_13.138756	341	421	0	44	80	0.5500000
NODE_8000_length_935_cov_13.138756	341	421	2	36	80	0.4500000
NODE_8000_length_935_cov_13.138756	394	474	2	80	80	1.0000000
NODE_8002_length_935_cov_6.485646	512	592	0	28	80	0.3500000
NODE_8002_length_935_cov_6.485646	512	592	2	52	80	0.6500000
NODE_8002_length_935_cov_6.485646	565	645	0	80	80	1.0000000
NODE_8003_length_935_cov_6.467703	250	330	0	80	80	1.0000000
NODE_8003_length_935_cov_6.467703	303	383	0	80	80	1.0000000
NODE_8004_length_935_cov_6.144737	478	558	0	16	80	0.2000000
NODE_8004_length_935_cov_6.144737	478	558	1	25	80	0.3125000
NODE_8004_length_935_cov_6.144737	478	558	2	39	80	0.4875000
NODE_8004_length_935_cov_6.144737	531	611	2	80	80	1.0000000
NODE_8005_length_935_cov_3.905502	39	119	4	4	80	0.0500000
NODE_8005_length_935_cov_3.905502	39	119	6	3	80	0.0375000
NODE_8005_length_935_cov_3.905502	39	119	8	4	80	0.0500000
NODE_8005_length_935_cov_3.905502	39	119	10	3	80	0.0375000
NODE_8005_length_935_cov_3.905502	39	119	12	1	80	0.0125000
NODE_8005_length_935_cov_3.905502	39	119	14	8	80	0.1000000
NODE_8005_length_935_cov_3.905502	39	119	16	57	80	0.7125000
NODE_8005_length_935_cov_3.905502	92	166	0	31	74	0.4189189
NODE_8005_length_935_cov_3.905502	92	166	2	16	74	0.2162162
NODE_8005_length_935_cov_3.905502	92	166	4	4	74	0.0540541
NODE_8005_length_935_cov_3.905502	92	166	6	3	74	0.0405405
NODE_8005_length_935_cov_3.905502	92	166	8	4	74	0.0540541
NODE_8005_length_935_cov_3.905502	92	166	10	3	74	0.0405405
NODE_8005_length_935_cov_3.905502	92	166	12	1	74	0.0135135
NODE_8005_length_935_cov_3.905502	92	166	14	8	74	0.1081081
NODE_8005_length_935_cov_3.905502	92	166	16	4	74	0.0540541
NODE_8028_length_934_cov_22.898204	403	483	0	57	80	0.7125000
NODE_8028_length_934_cov_22.898204	403	483	2	23	80	0.2875000
NODE_8028_length_934_cov_22.898204	456	536	0	4	80	0.0500000
NODE_8028_length_934_cov_22.898204	456	536	2	76	80	0.9500000
NODE_8029_length_934_cov_17.746108	246	326	0	29	80	0.3625000
NODE_8029_length_934_cov_17.746108	246	326	2	51	80	0.6375000
NODE_8029_length_934_cov_17.746108	299	379	0	16	80	0.2000000
NODE_8029_length_934_cov_17.746108	299	379	2	64	80	0.8000000
NODE_8030_length_934_cov_16.049102	367	447	0	80	80	1.0000000
NODE_8030_length_934_cov_16.049102	420	500	0	80	80	1.0000000
NODE_8031_length_934_cov_13.738922	379	459	0	80	80	1.0000000
NODE_8031_length_934_cov_13.738922	432	459	0	27	27	1.0000000
NODE_8031_length_934_cov_13.738922	470	512	0	42	42	1.0000000
NODE_8032_length_934_cov_9.091018	407	487	0	80	80	1.0000000
NODE_8032_length_934_cov_9.091018	460	540	0	80	80	1.0000000
NODE_8034_length_934_cov_5.349701	583	663	0	80	80	1.0000000
NODE_8050_length_933_cov_36.557554	462	542	0	80	80	1.0000000
NODE_8050_length_933_cov_36.557554	515	595	0	69	80	0.8625000
NODE_8050_length_933_cov_36.557554	515	595	2	11	80	0.1375000
NODE_8051_length_933_cov_27.645084	476	556	0	80	80	1.0000000
NODE_8051_length_933_cov_27.645084	529	609	0	80	80	1.0000000
NODE_8052_length_933_cov_26.749400	611	691	0	80	80	1.0000000
NODE_8052_length_933_cov_26.749400	664	744	0	80	80	1.0000000
NODE_8053_length_933_cov_26.308153	430	510	0	80	80	1.0000000
NODE_8053_length_933_cov_26.308153	483	563	0	80	80	1.0000000
NODE_8054_length_933_cov_19.966427	444	530	2	86	86	1.0000000
NODE_8054_length_933_cov_19.966427	497	583	0	52	86	0.6046512
NODE_8054_length_933_cov_19.966427	497	583	2	34	86	0.3953488
NODE_8055_length_933_cov_16.870504	284	364	0	80	80	1.0000000
NODE_8055_length_933_cov_16.870504	337	415	0	78	78	1.0000000
NODE_8056_length_933_cov_16.699041	366	446	0	80	80	1.0000000
NODE_8056_length_933_cov_16.699041	419	499	0	80	80	1.0000000
NODE_8057_length_933_cov_11.171463	197	277	0	80	80	1.0000000
NODE_8057_length_933_cov_11.171463	250	330	0	80	80	1.0000000
NODE_8073_length_932_cov_26.656663	397	477	0	25	80	0.3125000
NODE_8073_length_932_cov_26.656663	397	477	2	55	80	0.6875000
NODE_8073_length_932_cov_26.656663	450	530	0	78	80	0.9750000
NODE_8073_length_932_cov_26.656663	450	530	2	2	80	0.0250000
NODE_8074_length_932_cov_16.581032	407	485	0	5	78	0.0641026
NODE_8074_length_932_cov_16.581032	407	485	2	31	78	0.3974359
NODE_8074_length_932_cov_16.581032	407	485	4	42	78	0.5384616
NODE_8074_length_932_cov_16.581032	460	538	2	54	78	0.6923077
NODE_8074_length_932_cov_16.581032	460	538	4	24	78	0.3076923
NODE_8075_length_932_cov_13.462185	413	493	2	74	80	0.9250000
NODE_8075_length_932_cov_13.462185	413	493	4	6	80	0.0750000
NODE_8075_length_932_cov_13.462185	466	546	2	34	80	0.4250000
NODE_8075_length_932_cov_13.462185	466	546	4	46	80	0.5750000
NODE_8076_length_932_cov_13.442977	386	466	2	2	80	0.0250000
NODE_8076_length_932_cov_13.442977	386	466	4	34	80	0.4250000
NODE_8076_length_932_cov_13.442977	386	466	5	1	80	0.0125000
NODE_8076_length_932_cov_13.442977	386	466	6	43	80	0.5375000
NODE_8076_length_932_cov_13.442977	439	519	0	11	80	0.1375000
NODE_8076_length_932_cov_13.442977	439	519	2	44	80	0.5500000
NODE_8076_length_932_cov_13.442977	439	519	5	1	80	0.0125000
NODE_8076_length_932_cov_13.442977	439	519	6	24	80	0.3000000
NODE_8077_length_932_cov_11.947179	344	424	0	80	80	1.0000000
NODE_8077_length_932_cov_11.947179	397	477	0	80	80	1.0000000
NODE_8079_length_932_cov_10.849940	409	489	0	37	80	0.4625000
NODE_8079_length_932_cov_10.849940	409	489	4	43	80	0.5375000
NODE_8079_length_932_cov_10.849940	462	542	4	80	80	1.0000000
NODE_8080_length_932_cov_10.174070	342	422	2	80	80	1.0000000
NODE_8080_length_932_cov_10.174070	395	475	0	13	80	0.1625000
NODE_8080_length_932_cov_10.174070	395	475	2	67	80	0.8375000
NODE_8082_length_932_cov_9.200480	184	264	0	80	80	1.0000000
NODE_8082_length_932_cov_9.200480	237	317	0	80	80	1.0000000
NODE_8090_length_932_cov_2.689076	598	676	0	78	78	1.0000000
NODE_8090_length_932_cov_2.689076	798	845	0	47	47	1.0000000
NODE_8103_length_931_cov_51.451923	320	400	0	80	80	1.0000000
NODE_8103_length_931_cov_51.451923	373	453	0	80	80	1.0000000
NODE_8104_length_931_cov_46.621394	527	607	6	2	80	0.0250000
NODE_8104_length_931_cov_46.621394	527	607	8	2	80	0.0250000
NODE_8104_length_931_cov_46.621394	527	607	10	12	80	0.1500000
NODE_8104_length_931_cov_46.621394	527	607	12	7	80	0.0875000
NODE_8104_length_931_cov_46.621394	527	607	14	14	80	0.1750000
NODE_8104_length_931_cov_46.621394	527	607	16	43	80	0.5375000
NODE_8104_length_931_cov_46.621394	580	660	0	2	80	0.0250000
NODE_8104_length_931_cov_46.621394	580	660	2	24	80	0.3000000
NODE_8104_length_931_cov_46.621394	580	660	4	3	80	0.0375000
NODE_8104_length_931_cov_46.621394	580	660	6	1	80	0.0125000
NODE_8104_length_931_cov_46.621394	580	660	8	12	80	0.1500000
NODE_8104_length_931_cov_46.621394	580	660	12	12	80	0.1500000
NODE_8104_length_931_cov_46.621394	580	660	16	26	80	0.3250000
NODE_8105_length_931_cov_36.334135	347	427	0	80	80	1.0000000
NODE_8105_length_931_cov_36.334135	400	480	0	80	80	1.0000000
NODE_8106_length_931_cov_32.495192	482	562	2	80	80	1.0000000
NODE_8106_length_931_cov_32.495192	535	617	0	38	82	0.4634146
NODE_8106_length_931_cov_32.495192	535	617	2	44	82	0.5365854
NODE_8107_length_931_cov_22.100962	375	455	3	9	80	0.1125000
NODE_8107_length_931_cov_22.100962	375	455	7	2	80	0.0250000
NODE_8107_length_931_cov_22.100962	375	455	10	17	80	0.2125000
NODE_8107_length_931_cov_22.100962	375	455	11	1	80	0.0125000
NODE_8107_length_931_cov_22.100962	375	455	12	2	80	0.0250000
NODE_8107_length_931_cov_22.100962	375	455	13	26	80	0.3250000
NODE_8107_length_931_cov_22.100962	375	455	14	23	80	0.2875000
NODE_8107_length_931_cov_22.100962	428	508	0	38	80	0.4750000
NODE_8107_length_931_cov_22.100962	428	508	3	24	80	0.3000000
NODE_8107_length_931_cov_22.100962	428	508	7	2	80	0.0250000
NODE_8107_length_931_cov_22.100962	428	508	11	1	80	0.0125000
NODE_8107_length_931_cov_22.100962	428	508	12	2	80	0.0250000
NODE_8107_length_931_cov_22.100962	428	508	13	13	80	0.1625000
NODE_8108_length_931_cov_21.781250	347	427	0	23	80	0.2875000
NODE_8108_length_931_cov_21.781250	347	427	2	36	80	0.4500000
NODE_8108_length_931_cov_21.781250	347	427	4	21	80	0.2625000
NODE_8108_length_931_cov_21.781250	400	480	2	6	80	0.0750000
NODE_8108_length_931_cov_21.781250	400	480	4	74	80	0.9250000
NODE_8109_length_931_cov_19.084135	411	491	0	80	80	1.0000000
NODE_8109_length_931_cov_19.084135	464	544	0	80	80	1.0000000
NODE_8110_length_931_cov_14.879808	444	524	1	5	80	0.0625000
NODE_8110_length_931_cov_14.879808	444	524	2	75	80	0.9375000
NODE_8110_length_931_cov_14.879808	497	577	0	41	80	0.5125000
NODE_8110_length_931_cov_14.879808	497	577	1	17	80	0.2125000
NODE_8110_length_931_cov_14.879808	497	577	2	22	80	0.2750000
NODE_8111_length_931_cov_13.087740	759	800	2	35	41	0.8536586
NODE_8111_length_931_cov_13.087740	759	800	4	5	41	0.1219512
NODE_8111_length_931_cov_13.087740	759	800	6	1	41	0.0243902
NODE_8112_length_931_cov_10.534856	399	479	0	26	80	0.3250000
NODE_8112_length_931_cov_10.534856	399	479	4	54	80	0.6750000
NODE_8112_length_931_cov_10.534856	452	532	4	80	80	1.0000000
NODE_8113_length_931_cov_9.865385	236	316	0	80	80	1.0000000
NODE_8113_length_931_cov_9.865385	289	369	0	80	80	1.0000000
NODE_8115_length_931_cov_6.201923	479	559	0	19	80	0.2375000
NODE_8115_length_931_cov_6.201923	479	559	1	61	80	0.7625000
NODE_8115_length_931_cov_6.201923	532	612	1	80	80	1.0000000
NODE_8124_length_931_cov_1.780048	832	902	0	66	70	0.9428571
NODE_8124_length_931_cov_1.780048	832	902	3	4	70	0.0571429
NODE_8126_length_931_cov_1.433894	220	284	8	16	64	0.2500000
NODE_8126_length_931_cov_1.433894	220	284	10	11	64	0.1718750
NODE_8126_length_931_cov_1.433894	220	284	12	12	64	0.1875000
NODE_8126_length_931_cov_1.433894	220	284	14	24	64	0.3750000
NODE_8126_length_931_cov_1.433894	220	284	16	1	64	0.0156250
NODE_8131_length_930_cov_49.052948	252	332	4	61	80	0.7625000
NODE_8131_length_930_cov_49.052948	252	332	6	14	80	0.1750000
NODE_8131_length_930_cov_49.052948	252	332	8	5	80	0.0625000
NODE_8131_length_930_cov_49.052948	305	385	2	2	80	0.0250000
NODE_8131_length_930_cov_49.052948	305	385	4	50	80	0.6250000
NODE_8131_length_930_cov_49.052948	305	385	6	23	80	0.2875000
NODE_8131_length_930_cov_49.052948	305	385	8	5	80	0.0625000
NODE_8131_length_930_cov_49.052948	381	462	0	42	81	0.5185185
NODE_8131_length_930_cov_49.052948	381	462	2	7	81	0.0864198
NODE_8131_length_930_cov_49.052948	381	462	4	3	81	0.0370370
NODE_8131_length_930_cov_49.052948	381	462	6	29	81	0.3580247
NODE_8131_length_930_cov_49.052948	435	515	6	33	80	0.4125000
NODE_8131_length_930_cov_49.052948	435	515	8	34	80	0.4250000
NODE_8131_length_930_cov_49.052948	435	515	10	13	80	0.1625000
NODE_8132_length_930_cov_31.510229	400	482	0	82	82	1.0000000
NODE_8132_length_930_cov_31.510229	453	535	0	82	82	1.0000000
NODE_8133_length_930_cov_29.139591	329	409	6	45	80	0.5625000
NODE_8133_length_930_cov_29.139591	329	409	8	11	80	0.1375000
NODE_8133_length_930_cov_29.139591	329	409	11	1	80	0.0125000
NODE_8133_length_930_cov_29.139591	329	409	12	23	80	0.2875000
NODE_8133_length_930_cov_29.139591	382	462	6	56	80	0.7000000
NODE_8133_length_930_cov_29.139591	382	462	8	11	80	0.1375000
NODE_8133_length_930_cov_29.139591	382	462	11	1	80	0.0125000
NODE_8133_length_930_cov_29.139591	382	462	12	12	80	0.1500000
NODE_8134_length_930_cov_24.787004	518	598	2	25	80	0.3125000
NODE_8134_length_930_cov_24.787004	518	598	4	55	80	0.6875000
NODE_8134_length_930_cov_24.787004	571	651	0	17	80	0.2125000
NODE_8134_length_930_cov_24.787004	571	651	2	8	80	0.1000000
NODE_8134_length_930_cov_24.787004	571	651	4	55	80	0.6875000
NODE_8135_length_930_cov_24.608905	300	380	0	6	80	0.0750000
NODE_8135_length_930_cov_24.608905	300	380	2	24	80	0.3000000
NODE_8135_length_930_cov_24.608905	300	380	4	50	80	0.6250000
NODE_8135_length_930_cov_24.608905	353	433	2	6	80	0.0750000
NODE_8135_length_930_cov_24.608905	353	433	4	74	80	0.9250000
NODE_8136_length_930_cov_16.494585	482	562	2	51	80	0.6375000
NODE_8136_length_930_cov_16.494585	482	562	4	29	80	0.3625000
NODE_8136_length_930_cov_16.494585	535	615	2	34	80	0.4250000
NODE_8136_length_930_cov_16.494585	535	615	4	46	80	0.5750000
NODE_8137_length_930_cov_13.296029	249	329	0	35	80	0.4375000
NODE_8137_length_930_cov_13.296029	249	329	2	45	80	0.5625000
NODE_8137_length_930_cov_13.296029	302	382	0	80	80	1.0000000
NODE_8137_length_930_cov_13.296029	378	458	0	80	80	1.0000000
NODE_8137_length_930_cov_13.296029	431	511	0	75	80	0.9375000
NODE_8137_length_930_cov_13.296029	431	511	1	5	80	0.0625000
NODE_8138_length_930_cov_11.758123	463	543	0	68	80	0.8500000
NODE_8138_length_930_cov_11.758123	463	543	2	12	80	0.1500000
NODE_8138_length_930_cov_11.758123	516	596	0	38	80	0.4750000
NODE_8138_length_930_cov_11.758123	516	596	2	42	80	0.5250000
NODE_8139_length_930_cov_7.576414	531	611	0	13	80	0.1625000
NODE_8139_length_930_cov_7.576414	531	611	2	67	80	0.8375000
NODE_8139_length_930_cov_7.576414	584	664	0	46	80	0.5750000
NODE_8139_length_930_cov_7.576414	584	664	2	34	80	0.4250000
NODE_8156_length_930_cov_0.821901	676	736	0	60	60	1.0000000
NODE_8157_length_929_cov_54.485542	313	393	0	60	80	0.7500000
NODE_8157_length_929_cov_54.485542	313	393	2	4	80	0.0500000
NODE_8157_length_929_cov_54.485542	313	393	4	16	80	0.2000000
NODE_8157_length_929_cov_54.485542	366	446	0	7	80	0.0875000
NODE_8157_length_929_cov_54.485542	366	446	2	14	80	0.1750000
NODE_8157_length_929_cov_54.485542	366	446	4	59	80	0.7375000
NODE_8157_length_929_cov_54.485542	442	522	0	13	80	0.1625000
NODE_8157_length_929_cov_54.485542	442	522	2	67	80	0.8375000
NODE_8157_length_929_cov_54.485542	495	575	0	34	80	0.4250000
NODE_8157_length_929_cov_54.485542	495	575	2	46	80	0.5750000
NODE_8158_length_929_cov_49.865060	429	509	0	67	80	0.8375000
NODE_8158_length_929_cov_49.865060	429	509	2	13	80	0.1625000
NODE_8158_length_929_cov_49.865060	482	562	0	14	80	0.1750000
NODE_8158_length_929_cov_49.865060	482	562	2	50	80	0.6250000
NODE_8158_length_929_cov_49.865060	482	562	4	16	80	0.2000000
NODE_8159_length_929_cov_34.634940	358	438	2	80	80	1.0000000
NODE_8159_length_929_cov_34.634940	411	491	0	24	80	0.3000000
NODE_8159_length_929_cov_34.634940	411	491	2	56	80	0.7000000
NODE_8161_length_929_cov_20.815663	365	445	4	6	80	0.0750000
NODE_8161_length_929_cov_20.815663	365	445	6	17	80	0.2125000
NODE_8161_length_929_cov_20.815663	365	445	8	17	80	0.2125000
NODE_8161_length_929_cov_20.815663	365	445	10	40	80	0.5000000
NODE_8161_length_929_cov_20.815663	418	498	2	4	80	0.0500000
NODE_8161_length_929_cov_20.815663	418	498	4	55	80	0.6875000
NODE_8161_length_929_cov_20.815663	418	498	6	4	80	0.0500000
NODE_8161_length_929_cov_20.815663	418	498	8	1	80	0.0125000
NODE_8161_length_929_cov_20.815663	418	498	10	16	80	0.2000000
NODE_8162_length_929_cov_17.798795	376	456	0	8	80	0.1000000
NODE_8162_length_929_cov_17.798795	376	456	1	3	80	0.0375000
NODE_8162_length_929_cov_17.798795	376	456	2	69	80	0.8625000
NODE_8162_length_929_cov_17.798795	429	509	2	80	80	1.0000000
NODE_8163_length_929_cov_16.622892	331	408	0	77	77	1.0000000
NODE_8163_length_929_cov_16.622892	381	461	0	27	80	0.3375000
NODE_8163_length_929_cov_16.622892	381	461	2	53	80	0.6625000
NODE_8163_length_929_cov_16.622892	457	537	2	34	80	0.4250000
NODE_8163_length_929_cov_16.622892	457	537	4	46	80	0.5750000
NODE_8163_length_929_cov_16.622892	510	590	0	24	80	0.3000000
NODE_8163_length_929_cov_16.622892	510	590	2	56	80	0.7000000
NODE_8164_length_929_cov_15.242169	302	382	0	80	80	1.0000000
NODE_8164_length_929_cov_15.242169	355	435	0	80	80	1.0000000
NODE_8164_length_929_cov_15.242169	431	511	0	16	80	0.2000000
NODE_8164_length_929_cov_15.242169	431	511	2	27	80	0.3375000
NODE_8164_length_929_cov_15.242169	431	511	4	37	80	0.4625000
NODE_8164_length_929_cov_15.242169	484	564	2	19	80	0.2375000
NODE_8164_length_929_cov_15.242169	484	564	4	61	80	0.7625000
NODE_8165_length_929_cov_13.197590	259	339	0	2	80	0.0250000
NODE_8165_length_929_cov_13.197590	259	339	2	41	80	0.5125000
NODE_8165_length_929_cov_13.197590	259	339	4	37	80	0.4625000
NODE_8165_length_929_cov_13.197590	312	392	0	55	80	0.6875000
NODE_8165_length_929_cov_13.197590	312	392	2	6	80	0.0750000
NODE_8165_length_929_cov_13.197590	312	392	4	19	80	0.2375000
NODE_8167_length_929_cov_7.766265	385	465	0	80	80	1.0000000
NODE_8167_length_929_cov_7.766265	438	518	0	80	80	1.0000000
NODE_8168_length_929_cov_5.750602	382	462	0	15	80	0.1875000
NODE_8168_length_929_cov_5.750602	382	462	1	63	80	0.7875000
NODE_8168_length_929_cov_5.750602	382	462	2	2	80	0.0250000
NODE_8168_length_929_cov_5.750602	435	515	0	4	80	0.0500000
NODE_8168_length_929_cov_5.750602	435	515	1	25	80	0.3125000
NODE_8168_length_929_cov_5.750602	435	515	2	51	80	0.6375000
NODE_8181_length_928_cov_35.226779	273	353	0	80	80	1.0000000
NODE_8181_length_928_cov_35.226779	326	406	0	80	80	1.0000000
NODE_8181_length_928_cov_35.226779	402	482	0	25	80	0.3125000
NODE_8181_length_928_cov_35.226779	402	482	2	54	80	0.6750000
NODE_8181_length_928_cov_35.226779	402	482	4	1	80	0.0125000
NODE_8181_length_928_cov_35.226779	455	535	2	52	80	0.6500000
NODE_8181_length_928_cov_35.226779	455	535	4	28	80	0.3500000
NODE_8182_length_928_cov_25.218335	299	379	2	35	80	0.4375000
NODE_8182_length_928_cov_25.218335	299	379	4	45	80	0.5625000
NODE_8182_length_928_cov_25.218335	352	432	0	16	80	0.2000000
NODE_8182_length_928_cov_25.218335	352	432	2	62	80	0.7750000
NODE_8182_length_928_cov_25.218335	352	432	4	2	80	0.0250000
NODE_8183_length_928_cov_22.815440	342	422	0	80	80	1.0000000
NODE_8183_length_928_cov_22.815440	395	475	0	80	80	1.0000000
NODE_8183_length_928_cov_22.815440	471	551	0	6	80	0.0750000
NODE_8183_length_928_cov_22.815440	471	551	2	21	80	0.2625000
NODE_8183_length_928_cov_22.815440	471	551	6	53	80	0.6625000
NODE_8183_length_928_cov_22.815440	524	604	4	30	80	0.3750000
NODE_8183_length_928_cov_22.815440	524	604	6	50	80	0.6250000
NODE_8184_length_928_cov_20.718938	365	445	0	20	80	0.2500000
NODE_8184_length_928_cov_20.718938	365	445	4	60	80	0.7500000
NODE_8184_length_928_cov_20.718938	418	498	4	80	80	1.0000000
NODE_8185_length_928_cov_19.418577	420	500	4	7	80	0.0875000
NODE_8185_length_928_cov_19.418577	420	500	6	67	80	0.8375000
NODE_8185_length_928_cov_19.418577	420	500	8	6	80	0.0750000
NODE_8185_length_928_cov_19.418577	473	553	0	39	80	0.4875000
NODE_8185_length_928_cov_19.418577	473	553	2	10	80	0.1250000
NODE_8185_length_928_cov_19.418577	473	553	4	11	80	0.1375000
NODE_8185_length_928_cov_19.418577	473	553	6	20	80	0.2500000
NODE_8185_length_928_cov_19.418577	549	591	0	42	42	1.0000000
NODE_8186_length_928_cov_13.354644	323	403	2	10	80	0.1250000
NODE_8186_length_928_cov_13.354644	323	403	4	9	80	0.1125000
NODE_8186_length_928_cov_13.354644	323	403	6	30	80	0.3750000
NODE_8186_length_928_cov_13.354644	323	403	8	31	80	0.3875000
NODE_8186_length_928_cov_13.354644	376	456	0	13	80	0.1625000
NODE_8186_length_928_cov_13.354644	376	456	2	19	80	0.2375000
NODE_8186_length_928_cov_13.354644	376	456	4	8	80	0.1000000
NODE_8186_length_928_cov_13.354644	376	456	6	22	80	0.2750000
NODE_8186_length_928_cov_13.354644	376	456	8	18	80	0.2250000
NODE_8187_length_928_cov_13.096502	361	441	0	55	80	0.6875000
NODE_8187_length_928_cov_13.096502	361	441	2	25	80	0.3125000
NODE_8187_length_928_cov_13.096502	414	494	0	80	80	1.0000000
NODE_8189_length_928_cov_10.399276	447	527	2	80	80	1.0000000
NODE_8189_length_928_cov_10.399276	500	580	0	30	80	0.3750000
NODE_8189_length_928_cov_10.399276	500	580	2	50	80	0.6250000
NODE_8207_length_927_cov_19.516908	398	478	0	80	80	1.0000000
NODE_8207_length_927_cov_19.516908	451	531	0	29	80	0.3625000
NODE_8207_length_927_cov_19.516908	451	531	1	51	80	0.6375000
NODE_8208_length_927_cov_11.190821	358	438	0	7	80	0.0875000
NODE_8208_length_927_cov_11.190821	358	438	2	73	80	0.9125000
NODE_8208_length_927_cov_11.190821	411	491	0	60	80	0.7500000
NODE_8208_length_927_cov_11.190821	411	491	2	20	80	0.2500000
NODE_8209_length_927_cov_8.123188	239	319	0	80	80	1.0000000
NODE_8209_length_927_cov_8.123188	292	372	0	80	80	1.0000000
NODE_8210_length_927_cov_4.585749	515	595	0	49	80	0.6125000
NODE_8210_length_927_cov_4.585749	515	595	2	31	80	0.3875000
NODE_8210_length_927_cov_4.585749	568	648	0	80	80	1.0000000
NODE_8222_length_927_cov_1.250000	626	706	0	80	80	1.0000000
NODE_8222_length_927_cov_1.250000	679	759	0	80	80	1.0000000
NODE_8227_length_926_cov_78.382104	433	513	6	33	80	0.4125000
NODE_8227_length_926_cov_78.382104	433	513	8	16	80	0.2000000
NODE_8227_length_926_cov_78.382104	433	513	10	5	80	0.0625000
NODE_8227_length_926_cov_78.382104	433	513	12	18	80	0.2250000
NODE_8227_length_926_cov_78.382104	433	513	14	3	80	0.0375000
NODE_8227_length_926_cov_78.382104	433	513	16	5	80	0.0625000
NODE_8227_length_926_cov_78.382104	486	566	8	3	80	0.0375000
NODE_8227_length_926_cov_78.382104	486	566	10	15	80	0.1875000
NODE_8227_length_926_cov_78.382104	486	566	12	24	80	0.3000000
NODE_8227_length_926_cov_78.382104	486	566	14	33	80	0.4125000
NODE_8227_length_926_cov_78.382104	486	566	16	5	80	0.0625000
NODE_8228_length_926_cov_44.385732	383	463	0	80	80	1.0000000
NODE_8228_length_926_cov_44.385732	436	516	0	80	80	1.0000000
NODE_8229_length_926_cov_43.446191	362	442	0	80	80	1.0000000
NODE_8229_length_926_cov_43.446191	415	495	0	80	80	1.0000000
NODE_8229_length_926_cov_43.446191	491	571	0	80	80	1.0000000
NODE_8229_length_926_cov_43.446191	544	624	0	80	80	1.0000000
NODE_8230_length_926_cov_40.163241	42	61	0	19	19	1.0000000
NODE_8230_length_926_cov_40.163241	279	359	2	80	80	1.0000000
NODE_8230_length_926_cov_40.163241	332	412	0	5	80	0.0625000
NODE_8230_length_926_cov_40.163241	332	412	2	75	80	0.9375000
NODE_8230_length_926_cov_40.163241	408	488	0	9	80	0.1125000
NODE_8230_length_926_cov_40.163241	408	488	1	2	80	0.0250000
NODE_8230_length_926_cov_40.163241	408	488	2	69	80	0.8625000
NODE_8230_length_926_cov_40.163241	461	541	2	80	80	1.0000000
NODE_8231_length_926_cov_29.923821	372	452	5	12	80	0.1500000
NODE_8231_length_926_cov_29.923821	372	452	6	25	80	0.3125000
NODE_8231_length_926_cov_29.923821	372	452	8	35	80	0.4375000
NODE_8231_length_926_cov_29.923821	372	452	10	8	80	0.1000000
NODE_8231_length_926_cov_29.923821	425	505	2	1	80	0.0125000
NODE_8231_length_926_cov_29.923821	425	505	4	44	80	0.5500000
NODE_8231_length_926_cov_29.923821	425	505	8	19	80	0.2375000
NODE_8231_length_926_cov_29.923821	425	505	9	1	80	0.0125000
NODE_8231_length_926_cov_29.923821	425	505	10	15	80	0.1875000
NODE_8232_length_926_cov_24.657799	350	430	0	4	80	0.0500000
NODE_8232_length_926_cov_24.657799	350	430	2	76	80	0.9500000
NODE_8232_length_926_cov_24.657799	403	483	0	4	80	0.0500000
NODE_8232_length_926_cov_24.657799	403	483	2	76	80	0.9500000
NODE_8233_length_926_cov_17.438936	360	440	0	35	80	0.4375000
NODE_8233_length_926_cov_17.438936	360	440	2	8	80	0.1000000
NODE_8233_length_926_cov_17.438936	360	440	4	6	80	0.0750000
NODE_8233_length_926_cov_17.438936	360	440	6	31	80	0.3875000
NODE_8233_length_926_cov_17.438936	413	493	0	8	80	0.1000000
NODE_8233_length_926_cov_17.438936	413	493	4	2	80	0.0250000
NODE_8233_length_926_cov_17.438936	413	493	6	70	80	0.8750000
NODE_8234_length_926_cov_12.413543	418	491	1	24	73	0.3287671
NODE_8234_length_926_cov_12.413543	418	491	2	5	73	0.0684932
NODE_8234_length_926_cov_12.413543	418	491	3	44	73	0.6027398
NODE_8234_length_926_cov_12.413543	464	544	0	1	80	0.0125000
NODE_8234_length_926_cov_12.413543	464	544	1	1	80	0.0125000
NODE_8234_length_926_cov_12.413543	464	544	2	56	80	0.7000000
NODE_8234_length_926_cov_12.413543	464	544	3	22	80	0.2750000
NODE_8235_length_926_cov_5.771463	453	533	0	27	80	0.3375000
NODE_8235_length_926_cov_5.771463	453	533	4	53	80	0.6625000
NODE_8235_length_926_cov_5.771463	505	586	4	81	81	1.0000000
NODE_8236_length_926_cov_5.209190	435	515	0	80	80	1.0000000
NODE_8236_length_926_cov_5.209190	488	568	0	80	80	1.0000000
NODE_8247_length_925_cov_40.767554	514	594	1	5	80	0.0625000
NODE_8247_length_925_cov_40.767554	514	594	2	34	80	0.4250000
NODE_8247_length_925_cov_40.767554	514	594	4	41	80	0.5125000
NODE_8247_length_925_cov_40.767554	567	647	0	8	80	0.1000000
NODE_8247_length_925_cov_40.767554	567	647	2	29	80	0.3625000
NODE_8247_length_925_cov_40.767554	567	647	4	43	80	0.5375000
NODE_8248_length_925_cov_30.226392	262	342	0	50	80	0.6250000
NODE_8248_length_925_cov_30.226392	262	342	2	30	80	0.3750000
NODE_8248_length_925_cov_30.226392	315	395	0	13	80	0.1625000
NODE_8248_length_925_cov_30.226392	315	395	2	67	80	0.8375000
NODE_8248_length_925_cov_30.226392	391	471	0	80	80	1.0000000
NODE_8248_length_925_cov_30.226392	444	524	0	80	80	1.0000000
NODE_8249_length_925_cov_22.075061	334	414	0	3	80	0.0375000
NODE_8249_length_925_cov_22.075061	334	414	2	55	80	0.6875000
NODE_8249_length_925_cov_22.075061	334	414	4	22	80	0.2750000
NODE_8249_length_925_cov_22.075061	387	467	0	8	80	0.1000000
NODE_8249_length_925_cov_22.075061	387	467	2	50	80	0.6250000
NODE_8249_length_925_cov_22.075061	387	467	4	22	80	0.2750000
NODE_8250_length_925_cov_18.164649	410	490	0	80	80	1.0000000
NODE_8250_length_925_cov_18.164649	464	543	0	79	79	1.0000000
NODE_8251_length_925_cov_14.067797	472	548	0	76	76	1.0000000
NODE_8251_length_925_cov_14.067797	525	601	0	68	76	0.8947368
NODE_8251_length_925_cov_14.067797	525	601	2	8	76	0.1052632
NODE_8252_length_925_cov_7.098063	418	498	0	80	80	1.0000000
NODE_8252_length_925_cov_7.098063	471	551	0	80	80	1.0000000
NODE_8266_length_924_cov_61.292121	397	477	0	26	80	0.3250000
NODE_8266_length_924_cov_61.292121	397	477	2	54	80	0.6750000
NODE_8266_length_924_cov_61.292121	450	530	0	12	80	0.1500000
NODE_8266_length_924_cov_61.292121	450	530	2	68	80	0.8500000
NODE_8267_length_924_cov_31.522424	375	455	0	80	80	1.0000000
NODE_8267_length_924_cov_31.522424	428	508	0	80	80	1.0000000
NODE_8268_length_924_cov_30.446061	299	379	0	80	80	1.0000000
NODE_8268_length_924_cov_30.446061	352	432	0	80	80	1.0000000
NODE_8268_length_924_cov_30.446061	428	508	0	80	80	1.0000000
NODE_8268_length_924_cov_30.446061	481	561	0	80	80	1.0000000
NODE_8269_length_924_cov_28.877576	542	622	1	48	80	0.6000000
NODE_8269_length_924_cov_28.877576	542	622	2	3	80	0.0375000
NODE_8269_length_924_cov_28.877576	542	622	3	29	80	0.3625000
NODE_8269_length_924_cov_28.877576	595	675	2	24	80	0.3000000
NODE_8269_length_924_cov_28.877576	595	675	3	56	80	0.7000000
NODE_8270_length_924_cov_27.261818	506	586	0	5	80	0.0625000
NODE_8270_length_924_cov_27.261818	506	586	4	65	80	0.8125000
NODE_8270_length_924_cov_27.261818	506	586	6	10	80	0.1250000
NODE_8270_length_924_cov_27.261818	559	639	2	28	80	0.3500000
NODE_8270_length_924_cov_27.261818	559	639	4	17	80	0.2125000
NODE_8270_length_924_cov_27.261818	559	639	6	35	80	0.4375000
NODE_8271_length_924_cov_25.946667	371	451	0	43	80	0.5375000
NODE_8271_length_924_cov_25.946667	371	451	2	37	80	0.4625000
NODE_8271_length_924_cov_25.946667	424	504	0	80	80	1.0000000
NODE_8271_length_924_cov_25.946667	500	580	0	53	80	0.6625000
NODE_8271_length_924_cov_25.946667	500	580	2	27	80	0.3375000
NODE_8271_length_924_cov_25.946667	553	633	2	27	80	0.3375000
NODE_8271_length_924_cov_25.946667	553	633	4	53	80	0.6625000
NODE_8272_length_924_cov_25.113939	305	385	0	80	80	1.0000000
NODE_8272_length_924_cov_25.113939	358	438	0	80	80	1.0000000
NODE_8272_length_924_cov_25.113939	434	514	0	80	80	1.0000000
NODE_8272_length_924_cov_25.113939	487	567	0	80	80	1.0000000
NODE_8273_length_924_cov_16.343030	481	561	0	16	80	0.2000000
NODE_8273_length_924_cov_16.343030	481	561	2	64	80	0.8000000
NODE_8273_length_924_cov_16.343030	534	614	2	51	80	0.6375000
NODE_8273_length_924_cov_16.343030	534	614	4	29	80	0.3625000
NODE_8274_length_924_cov_14.793939	299	379	0	80	80	1.0000000
NODE_8274_length_924_cov_14.793939	352	432	0	80	80	1.0000000
NODE_8275_length_924_cov_14.209697	485	562	0	13	77	0.1688312
NODE_8275_length_924_cov_14.209697	485	562	2	64	77	0.8311688
NODE_8275_length_924_cov_14.209697	535	615	0	38	80	0.4750000
NODE_8275_length_924_cov_14.209697	535	615	2	42	80	0.5250000
NODE_8276_length_924_cov_13.423030	287	367	0	80	80	1.0000000
NODE_8276_length_924_cov_13.423030	340	420	0	80	80	1.0000000
NODE_8277_length_924_cov_12.008485	237	307	2	70	70	1.0000000
NODE_8279_length_924_cov_8.619394	560	640	1	5	80	0.0625000
NODE_8279_length_924_cov_8.619394	560	640	2	27	80	0.3375000
NODE_8279_length_924_cov_8.619394	560	640	3	48	80	0.6000000
NODE_8279_length_924_cov_8.619394	613	693	1	30	80	0.3750000
NODE_8279_length_924_cov_8.619394	613	693	3	50	80	0.6250000
NODE_8280_length_924_cov_4.640000	426	506	0	80	80	1.0000000
NODE_8280_length_924_cov_4.640000	479	559	0	80	80	1.0000000
NODE_8290_length_924_cov_1.467879	352	381	0	29	29	1.0000000
NODE_8296_length_924_cov_0.648485	830	890	0	10	60	0.1666667
NODE_8296_length_924_cov_0.648485	830	890	4	50	60	0.8333333
NODE_8296_length_924_cov_0.648485	863	924	0	3	61	0.0491803
NODE_8296_length_924_cov_0.648485	863	924	4	58	61	0.9508197
NODE_8297_length_923_cov_43.213592	371	451	0	80	80	1.0000000
NODE_8297_length_923_cov_43.213592	424	504	0	80	80	1.0000000
NODE_8297_length_923_cov_43.213592	500	580	0	30	80	0.3750000
NODE_8297_length_923_cov_43.213592	500	580	2	50	80	0.6250000
NODE_8297_length_923_cov_43.213592	553	633	0	6	80	0.0750000
NODE_8297_length_923_cov_43.213592	553	633	2	74	80	0.9250000
NODE_8298_length_923_cov_34.108010	370	450	0	64	80	0.8000000
NODE_8298_length_923_cov_34.108010	370	450	2	16	80	0.2000000
NODE_8298_length_923_cov_34.108010	423	503	0	11	80	0.1375000
NODE_8298_length_923_cov_34.108010	423	503	2	69	80	0.8625000
NODE_8299_length_923_cov_29.163835	392	472	0	27	80	0.3375000
NODE_8299_length_923_cov_29.163835	392	472	2	7	80	0.0875000
NODE_8299_length_923_cov_29.163835	392	472	4	18	80	0.2250000
NODE_8299_length_923_cov_29.163835	392	472	6	28	80	0.3500000
NODE_8299_length_923_cov_29.163835	445	525	0	1	80	0.0125000
NODE_8299_length_923_cov_29.163835	445	525	1	7	80	0.0875000
NODE_8299_length_923_cov_29.163835	445	525	2	9	80	0.1125000
NODE_8299_length_923_cov_29.163835	445	525	4	33	80	0.4125000
NODE_8299_length_923_cov_29.163835	445	525	6	30	80	0.3750000
NODE_8300_length_923_cov_19.139563	375	455	0	63	80	0.7875000
NODE_8300_length_923_cov_19.139563	375	455	2	17	80	0.2125000
NODE_8300_length_923_cov_19.139563	428	508	0	80	80	1.0000000
NODE_8301_length_923_cov_17.433252	512	592	0	80	80	1.0000000
NODE_8301_length_923_cov_17.433252	565	645	0	80	80	1.0000000
NODE_8302_length_923_cov_16.597087	279	359	0	80	80	1.0000000
NODE_8302_length_923_cov_16.597087	332	412	0	80	80	1.0000000
NODE_8303_length_923_cov_15.229369	446	526	0	80	80	1.0000000
NODE_8303_length_923_cov_15.229369	499	579	0	80	80	1.0000000
NODE_8304_length_923_cov_14.007282	304	349	0	45	45	1.0000000
NODE_8304_length_923_cov_14.007282	345	427	0	82	82	1.0000000
NODE_8304_length_923_cov_14.007282	397	480	0	83	83	1.0000000
NODE_8305_length_923_cov_6.500000	308	388	0	80	80	1.0000000
NODE_8305_length_923_cov_6.500000	361	441	0	80	80	1.0000000
NODE_8307_length_923_cov_6.115291	447	527	0	80	80	1.0000000
NODE_8307_length_923_cov_6.115291	500	580	0	80	80	1.0000000
NODE_8308_length_923_cov_5.351942	363	445	0	22	82	0.2682927
NODE_8308_length_923_cov_5.351942	363	445	2	60	82	0.7317073
NODE_8308_length_923_cov_5.351942	365	445	0	22	80	0.2750000
NODE_8308_length_923_cov_5.351942	365	445	2	58	80	0.7250000
NODE_8317_length_923_cov_1.059466	63	143	0	6	80	0.0750000
NODE_8317_length_923_cov_1.059466	63	143	2	74	80	0.9250000
NODE_8320_length_922_cov_40.331713	243	289	18	3	46	0.0652174
NODE_8320_length_922_cov_40.331713	243	289	19	2	46	0.0434783
NODE_8320_length_922_cov_40.331713	243	289	20	10	46	0.2173913
NODE_8320_length_922_cov_40.331713	243	289	21	1	46	0.0217391
NODE_8320_length_922_cov_40.331713	243	289	22	1	46	0.0217391
NODE_8320_length_922_cov_40.331713	243	289	23	1	46	0.0217391
NODE_8320_length_922_cov_40.331713	243	289	26	1	46	0.0217391
NODE_8320_length_922_cov_40.331713	243	289	29	1	46	0.0217391
NODE_8320_length_922_cov_40.331713	243	289	33	1	46	0.0217391
NODE_8320_length_922_cov_40.331713	243	289	35	2	46	0.0434783
NODE_8320_length_922_cov_40.331713	243	289	37	2	46	0.0434783
NODE_8320_length_922_cov_40.331713	243	289	41	1	46	0.0217391
NODE_8320_length_922_cov_40.331713	243	289	45	2	46	0.0434783
NODE_8320_length_922_cov_40.331713	243	289	49	2	46	0.0434783
NODE_8320_length_922_cov_40.331713	243	289	51	4	46	0.0869565
NODE_8320_length_922_cov_40.331713	243	289	53	1	46	0.0217391
NODE_8320_length_922_cov_40.331713	243	289	55	2	46	0.0434783
NODE_8320_length_922_cov_40.331713	243	289	57	1	46	0.0217391
NODE_8320_length_922_cov_40.331713	243	289	58	3	46	0.0652174
NODE_8320_length_922_cov_40.331713	243	289	60	5	46	0.1086956
NODE_8320_length_922_cov_40.331713	262	342	15	6	80	0.0750000
NODE_8320_length_922_cov_40.331713	262	342	17	2	80	0.0250000
NODE_8320_length_922_cov_40.331713	262	342	18	3	80	0.0375000
NODE_8320_length_922_cov_40.331713	262	342	19	2	80	0.0250000
NODE_8320_length_922_cov_40.331713	262	342	20	10	80	0.1250000
NODE_8320_length_922_cov_40.331713	262	342	21	2	80	0.0250000
NODE_8320_length_922_cov_40.331713	262	342	22	5	80	0.0625000
NODE_8320_length_922_cov_40.331713	262	342	23	1	80	0.0125000
NODE_8320_length_922_cov_40.331713	262	342	24	4	80	0.0500000
NODE_8320_length_922_cov_40.331713	262	342	25	1	80	0.0125000
NODE_8320_length_922_cov_40.331713	262	342	26	1	80	0.0125000
NODE_8320_length_922_cov_40.331713	262	342	28	3	80	0.0375000
NODE_8320_length_922_cov_40.331713	262	342	29	1	80	0.0125000
NODE_8320_length_922_cov_40.331713	262	342	30	1	80	0.0125000
NODE_8320_length_922_cov_40.331713	262	342	33	1	80	0.0125000
NODE_8320_length_922_cov_40.331713	262	342	34	4	80	0.0500000
NODE_8320_length_922_cov_40.331713	262	342	35	2	80	0.0250000
NODE_8320_length_922_cov_40.331713	262	342	37	5	80	0.0625000
NODE_8320_length_922_cov_40.331713	262	342	40	2	80	0.0250000
NODE_8320_length_922_cov_40.331713	262	342	41	1	80	0.0125000
NODE_8320_length_922_cov_40.331713	262	342	45	2	80	0.0250000
NODE_8320_length_922_cov_40.331713	262	342	52	1	80	0.0125000
NODE_8320_length_922_cov_40.331713	262	342	62	1	80	0.0125000
NODE_8320_length_922_cov_40.331713	262	342	63	1	80	0.0125000
NODE_8320_length_922_cov_40.331713	262	342	68	1	80	0.0125000
NODE_8320_length_922_cov_40.331713	262	342	70	1	80	0.0125000
NODE_8320_length_922_cov_40.331713	262	342	72	1	80	0.0125000
NODE_8320_length_922_cov_40.331713	262	342	74	1	80	0.0125000
NODE_8320_length_922_cov_40.331713	262	342	75	2	80	0.0250000
NODE_8320_length_922_cov_40.331713	262	342	77	2	80	0.0250000
NODE_8320_length_922_cov_40.331713	262	342	79	1	80	0.0125000
NODE_8320_length_922_cov_40.331713	262	342	81	1	80	0.0125000
NODE_8320_length_922_cov_40.331713	262	342	85	2	80	0.0250000
NODE_8320_length_922_cov_40.331713	262	342	95	1	80	0.0125000
NODE_8320_length_922_cov_40.331713	262	342	97	1	80	0.0125000
NODE_8320_length_922_cov_40.331713	262	342	99	1	80	0.0125000
NODE_8320_length_922_cov_40.331713	262	342	103	1	80	0.0125000
NODE_8320_length_922_cov_40.331713	262	342	123	1	80	0.0125000
NODE_8320_length_922_cov_40.331713	262	342	129	1	80	0.0125000
NODE_8320_length_922_cov_40.331713	780	860	0	7	80	0.0875000
NODE_8320_length_922_cov_40.331713	780	860	2	15	80	0.1875000
NODE_8320_length_922_cov_40.331713	780	860	4	58	80	0.7250000
NODE_8320_length_922_cov_40.331713	833	913	0	60	80	0.7500000
NODE_8320_length_922_cov_40.331713	833	913	2	5	80	0.0625000
NODE_8320_length_922_cov_40.331713	833	913	4	15	80	0.1875000
NODE_8321_length_922_cov_38.549210	126	177	48	2	51	0.0392157
NODE_8321_length_922_cov_38.549210	126	177	51	1	51	0.0196078
NODE_8321_length_922_cov_38.549210	126	177	52	1	51	0.0196078
NODE_8321_length_922_cov_38.549210	126	177	60	4	51	0.0784314
NODE_8321_length_922_cov_38.549210	126	177	61	2	51	0.0392157
NODE_8321_length_922_cov_38.549210	126	177	63	2	51	0.0392157
NODE_8321_length_922_cov_38.549210	126	177	67	1	51	0.0196078
NODE_8321_length_922_cov_38.549210	126	177	69	1	51	0.0196078
NODE_8321_length_922_cov_38.549210	126	177	77	2	51	0.0392157
NODE_8321_length_922_cov_38.549210	126	177	79	1	51	0.0196078
NODE_8321_length_922_cov_38.549210	126	177	81	1	51	0.0196078
NODE_8321_length_922_cov_38.549210	126	177	83	1	51	0.0196078
NODE_8321_length_922_cov_38.549210	126	177	85	1	51	0.0196078
NODE_8321_length_922_cov_38.549210	126	177	87	2	51	0.0392157
NODE_8321_length_922_cov_38.549210	126	177	89	3	51	0.0588235
NODE_8321_length_922_cov_38.549210	126	177	93	5	51	0.0980392
NODE_8321_length_922_cov_38.549210	126	177	99	2	51	0.0392157
NODE_8321_length_922_cov_38.549210	126	177	101	1	51	0.0196078
NODE_8321_length_922_cov_38.549210	126	177	103	1	51	0.0196078
NODE_8321_length_922_cov_38.549210	126	177	105	2	51	0.0392157
NODE_8321_length_922_cov_38.549210	126	177	107	1	51	0.0196078
NODE_8321_length_922_cov_38.549210	126	177	111	3	51	0.0588235
NODE_8321_length_922_cov_38.549210	126	177	115	2	51	0.0392157
NODE_8321_length_922_cov_38.549210	126	177	117	7	51	0.1372549
NODE_8321_length_922_cov_38.549210	126	177	119	1	51	0.0196078
NODE_8321_length_922_cov_38.549210	126	177	121	1	51	0.0196078
NODE_8321_length_922_cov_38.549210	308	383	0	75	75	1.0000000
NODE_8321_length_922_cov_38.549210	356	393	0	37	37	1.0000000
NODE_8321_length_922_cov_38.549210	818	898	0	80	80	1.0000000
NODE_8321_length_922_cov_38.549210	871	908	0	37	37	1.0000000
NODE_8322_length_922_cov_35.041312	385	465	0	80	80	1.0000000
NODE_8322_length_922_cov_35.041312	438	518	0	55	80	0.6875000
NODE_8322_length_922_cov_35.041312	438	518	2	25	80	0.3125000
NODE_8323_length_922_cov_30.749696	426	506	4	2	80	0.0250000
NODE_8323_length_922_cov_30.749696	426	506	6	47	80	0.5875000
NODE_8323_length_922_cov_30.749696	426	506	8	31	80	0.3875000
NODE_8323_length_922_cov_30.749696	479	559	4	16	80	0.2000000
NODE_8323_length_922_cov_30.749696	479	559	6	19	80	0.2375000
NODE_8323_length_922_cov_30.749696	479	559	8	45	80	0.5625000
NODE_8324_length_922_cov_25.558931	291	370	0	79	79	1.0000000
NODE_8324_length_922_cov_25.558931	344	423	0	79	79	1.0000000
NODE_8325_length_922_cov_25.527339	391	471	0	44	80	0.5500000
NODE_8325_length_922_cov_25.527339	391	471	2	25	80	0.3125000
NODE_8325_length_922_cov_25.527339	391	471	3	11	80	0.1375000
NODE_8325_length_922_cov_25.527339	444	524	2	16	80	0.2000000
NODE_8325_length_922_cov_25.527339	444	524	3	64	80	0.8000000
NODE_8326_length_922_cov_23.630620	224	304	0	80	80	1.0000000
NODE_8326_length_922_cov_23.630620	277	357	0	80	80	1.0000000
NODE_8326_length_922_cov_23.630620	353	433	0	32	80	0.4000000
NODE_8326_length_922_cov_23.630620	353	433	2	48	80	0.6000000
NODE_8326_length_922_cov_23.630620	406	486	0	13	80	0.1625000
NODE_8326_length_922_cov_23.630620	406	486	2	67	80	0.8375000
NODE_8327_length_922_cov_22.388821	465	545	0	80	80	1.0000000
NODE_8327_length_922_cov_22.388821	518	598	0	80	80	1.0000000
NODE_8328_length_922_cov_20.320778	421	501	0	36	80	0.4500000
NODE_8328_length_922_cov_20.320778	421	501	2	27	80	0.3375000
NODE_8328_length_922_cov_20.320778	421	501	4	17	80	0.2125000
NODE_8328_length_922_cov_20.320778	474	554	2	20	80	0.2500000
NODE_8328_length_922_cov_20.320778	474	554	4	52	80	0.6500000
NODE_8328_length_922_cov_20.320778	474	554	6	8	80	0.1000000
NODE_8329_length_922_cov_17.645200	413	479	0	18	66	0.2727273
NODE_8329_length_922_cov_17.645200	413	479	2	48	66	0.7272727
NODE_8330_length_922_cov_12.574727	454	534	0	80	80	1.0000000
NODE_8330_length_922_cov_12.574727	507	587	0	80	80	1.0000000
NODE_8331_length_922_cov_11.934386	255	335	0	80	80	1.0000000
NODE_8331_length_922_cov_11.934386	308	388	0	80	80	1.0000000
NODE_8332_length_922_cov_11.068044	423	503	0	80	80	1.0000000
NODE_8332_length_922_cov_11.068044	476	557	0	81	81	1.0000000
NODE_8333_length_922_cov_7.907655	441	521	0	80	80	1.0000000
NODE_8333_length_922_cov_7.907655	494	574	0	80	80	1.0000000
NODE_8334_length_922_cov_7.737546	463	543	0	16	80	0.2000000
NODE_8334_length_922_cov_7.737546	463	543	2	1	80	0.0125000
NODE_8334_length_922_cov_7.737546	463	543	4	63	80	0.7875000
NODE_8334_length_922_cov_7.737546	516	596	0	23	80	0.2875000
NODE_8334_length_922_cov_7.737546	516	596	2	19	80	0.2375000
NODE_8334_length_922_cov_7.737546	516	596	4	38	80	0.4750000
NODE_8335_length_922_cov_7.241798	298	378	0	80	80	1.0000000
NODE_8335_length_922_cov_7.241798	351	431	0	80	80	1.0000000
NODE_8347_length_921_cov_21.317518	457	537	0	80	80	1.0000000
NODE_8347_length_921_cov_21.317518	510	590	0	80	80	1.0000000
NODE_8348_length_921_cov_18.462287	519	599	0	62	80	0.7750000
NODE_8348_length_921_cov_18.462287	519	599	2	6	80	0.0750000
NODE_8348_length_921_cov_18.462287	519	599	4	12	80	0.1500000
NODE_8348_length_921_cov_18.462287	572	652	0	9	80	0.1125000
NODE_8348_length_921_cov_18.462287	572	652	2	6	80	0.0750000
NODE_8348_length_921_cov_18.462287	572	652	4	65	80	0.8125000
NODE_8349_length_921_cov_15.440389	373	453	0	24	80	0.3000000
NODE_8349_length_921_cov_15.440389	373	453	2	56	80	0.7000000
NODE_8349_length_921_cov_15.440389	426	506	0	11	80	0.1375000
NODE_8349_length_921_cov_15.440389	426	506	2	69	80	0.8625000
NODE_8350_length_921_cov_13.216545	465	545	0	80	80	1.0000000
NODE_8350_length_921_cov_13.216545	518	598	0	80	80	1.0000000
NODE_8351_length_921_cov_9.283455	399	439	0	40	40	1.0000000
NODE_8351_length_921_cov_9.283455	532	612	0	63	80	0.7875000
NODE_8351_length_921_cov_9.283455	532	612	2	17	80	0.2125000
NODE_8351_length_921_cov_9.283455	585	665	0	10	80	0.1250000
NODE_8351_length_921_cov_9.283455	585	665	2	70	80	0.8750000
NODE_8352_length_921_cov_8.253041	289	369	0	80	80	1.0000000
NODE_8352_length_921_cov_8.253041	342	422	0	80	80	1.0000000
NODE_8364_length_920_cov_47.493301	543	623	4	22	80	0.2750000
NODE_8364_length_920_cov_47.493301	543	623	6	58	80	0.7250000
NODE_8364_length_920_cov_47.493301	596	676	0	28	80	0.3500000
NODE_8364_length_920_cov_47.493301	596	676	2	8	80	0.1000000
NODE_8364_length_920_cov_47.493301	596	676	4	2	80	0.0250000
NODE_8364_length_920_cov_47.493301	596	676	6	42	80	0.5250000
NODE_8365_length_920_cov_30.404385	543	623	0	19	80	0.2375000
NODE_8365_length_920_cov_30.404385	543	623	2	61	80	0.7625000
NODE_8365_length_920_cov_30.404385	596	676	0	6	80	0.0750000
NODE_8365_length_920_cov_30.404385	596	676	2	74	80	0.9250000
NODE_8366_length_920_cov_25.360536	413	493	0	9	80	0.1125000
NODE_8366_length_920_cov_25.360536	413	493	2	71	80	0.8875000
NODE_8366_length_920_cov_25.360536	466	546	0	62	80	0.7750000
NODE_8366_length_920_cov_25.360536	466	546	2	18	80	0.2250000
NODE_8366_length_920_cov_25.360536	542	615	0	32	73	0.4383562
NODE_8366_length_920_cov_25.360536	542	615	2	41	73	0.5616438
NODE_8366_length_920_cov_25.360536	588	668	0	24	80	0.3000000
NODE_8366_length_920_cov_25.360536	588	668	2	56	80	0.7000000
NODE_8367_length_920_cov_24.918392	403	483	0	31	80	0.3875000
NODE_8367_length_920_cov_24.918392	403	483	2	49	80	0.6125000
NODE_8367_length_920_cov_24.918392	456	536	0	31	80	0.3875000
NODE_8367_length_920_cov_24.918392	456	536	2	49	80	0.6125000
NODE_8368_length_920_cov_18.517661	353	433	0	80	80	1.0000000
NODE_8368_length_920_cov_18.517661	406	486	0	80	80	1.0000000
NODE_8369_length_920_cov_17.710110	310	390	4	8	80	0.1000000
NODE_8369_length_920_cov_17.710110	310	390	6	72	80	0.9000000
NODE_8369_length_920_cov_17.710110	363	443	0	50	80	0.6250000
NODE_8369_length_920_cov_17.710110	363	443	2	1	80	0.0125000
NODE_8369_length_920_cov_17.710110	363	443	4	5	80	0.0625000
NODE_8369_length_920_cov_17.710110	363	443	6	24	80	0.3000000
NODE_8370_length_920_cov_15.650426	403	458	0	55	55	1.0000000
NODE_8371_length_920_cov_12.588307	454	534	0	9	80	0.1125000
NODE_8371_length_920_cov_12.588307	454	534	2	71	80	0.8875000
NODE_8371_length_920_cov_12.588307	507	586	0	61	79	0.7721519
NODE_8371_length_920_cov_12.588307	507	586	2	18	79	0.2278481
NODE_8372_length_920_cov_10.822168	354	434	1	80	80	1.0000000
NODE_8372_length_920_cov_10.822168	407	487	0	36	80	0.4500000
NODE_8372_length_920_cov_10.822168	407	487	1	44	80	0.5500000
NODE_8374_length_920_cov_8.297199	453	533	0	36	80	0.4500000
NODE_8374_length_920_cov_8.297199	453	533	2	44	80	0.5500000
NODE_8374_length_920_cov_8.297199	506	583	0	23	77	0.2987013
NODE_8374_length_920_cov_8.297199	506	583	2	54	77	0.7012987
NODE_8378_length_920_cov_2.992692	501	581	0	80	80	1.0000000
NODE_8378_length_920_cov_2.992692	554	634	0	80	80	1.0000000
NODE_8389_length_919_cov_44.813415	338	418	0	9	80	0.1125000
NODE_8389_length_919_cov_44.813415	338	418	2	4	80	0.0500000
NODE_8389_length_919_cov_44.813415	338	418	4	19	80	0.2375000
NODE_8389_length_919_cov_44.813415	338	418	6	48	80	0.6000000
NODE_8389_length_919_cov_44.813415	391	471	0	24	80	0.3000000
NODE_8389_length_919_cov_44.813415	391	471	2	22	80	0.2750000
NODE_8389_length_919_cov_44.813415	391	471	4	8	80	0.1000000
NODE_8389_length_919_cov_44.813415	391	471	6	26	80	0.3250000
NODE_8389_length_919_cov_44.813415	467	547	0	80	80	1.0000000
NODE_8389_length_919_cov_44.813415	520	600	0	80	80	1.0000000
NODE_8390_length_919_cov_37.459756	389	469	0	7	80	0.0875000
NODE_8390_length_919_cov_37.459756	389	469	2	73	80	0.9125000
NODE_8390_length_919_cov_37.459756	442	522	0	7	80	0.0875000
NODE_8390_length_919_cov_37.459756	442	522	2	73	80	0.9125000
NODE_8390_length_919_cov_37.459756	518	598	0	58	80	0.7250000
NODE_8390_length_919_cov_37.459756	518	598	2	22	80	0.2750000
NODE_8390_length_919_cov_37.459756	571	651	0	41	80	0.5125000
NODE_8390_length_919_cov_37.459756	571	651	4	39	80	0.4875000
NODE_8391_length_919_cov_35.002439	474	554	0	80	80	1.0000000
NODE_8391_length_919_cov_35.002439	527	607	0	80	80	1.0000000
NODE_8392_length_919_cov_29.935366	246	326	0	80	80	1.0000000
NODE_8392_length_919_cov_29.935366	299	379	0	80	80	1.0000000
NODE_8393_length_919_cov_28.190244	470	550	0	13	80	0.1625000
NODE_8393_length_919_cov_28.190244	470	550	2	67	80	0.8375000
NODE_8393_length_919_cov_28.190244	523	603	0	45	80	0.5625000
NODE_8393_length_919_cov_28.190244	523	603	2	35	80	0.4375000
NODE_8394_length_919_cov_27.119512	454	534	0	12	80	0.1500000
NODE_8394_length_919_cov_27.119512	454	534	2	68	80	0.8500000
NODE_8394_length_919_cov_27.119512	507	587	0	11	80	0.1375000
NODE_8394_length_919_cov_27.119512	507	587	2	69	80	0.8625000
NODE_8395_length_919_cov_21.836585	545	625	0	80	80	1.0000000
NODE_8395_length_919_cov_21.836585	598	677	0	79	79	1.0000000
NODE_8396_length_919_cov_17.442683	385	465	0	80	80	1.0000000
NODE_8396_length_919_cov_17.442683	438	518	0	80	80	1.0000000
NODE_8397_length_919_cov_16.685366	309	389	0	80	80	1.0000000
NODE_8397_length_919_cov_16.685366	362	442	0	80	80	1.0000000
NODE_8398_length_919_cov_14.013415	435	515	0	80	80	1.0000000
NODE_8398_length_919_cov_14.013415	488	568	0	80	80	1.0000000
NODE_8399_length_919_cov_12.013415	340	420	0	49	80	0.6125000
NODE_8399_length_919_cov_12.013415	340	420	2	30	80	0.3750000
NODE_8399_length_919_cov_12.013415	340	420	4	1	80	0.0125000
NODE_8399_length_919_cov_12.013415	393	473	0	80	80	1.0000000
NODE_8403_length_919_cov_3.529268	424	504	0	80	80	1.0000000
NODE_8403_length_919_cov_3.529268	477	557	0	57	80	0.7125000
NODE_8403_length_919_cov_3.529268	477	557	2	23	80	0.2875000
NODE_8404_length_919_cov_3.200000	444	524	0	66	80	0.8250000
NODE_8404_length_919_cov_3.200000	444	524	2	14	80	0.1750000
NODE_8404_length_919_cov_3.200000	497	577	0	13	80	0.1625000
NODE_8404_length_919_cov_3.200000	497	577	2	67	80	0.8375000
NODE_8415_length_918_cov_41.115995	387	467	4	7	80	0.0875000
NODE_8415_length_918_cov_41.115995	387	467	6	18	80	0.2250000
NODE_8415_length_918_cov_41.115995	387	467	8	5	80	0.0625000
NODE_8415_length_918_cov_41.115995	387	467	10	21	80	0.2625000
NODE_8415_length_918_cov_41.115995	387	467	12	29	80	0.3625000
NODE_8415_length_918_cov_41.115995	440	520	0	7	80	0.0875000
NODE_8415_length_918_cov_41.115995	440	520	5	1	80	0.0125000
NODE_8415_length_918_cov_41.115995	440	520	6	52	80	0.6500000
NODE_8415_length_918_cov_41.115995	440	520	8	5	80	0.0625000
NODE_8415_length_918_cov_41.115995	440	520	10	15	80	0.1875000
NODE_8416_length_918_cov_37.405372	427	507	2	80	80	1.0000000
NODE_8416_length_918_cov_37.405372	480	560	0	50	80	0.6250000
NODE_8416_length_918_cov_37.405372	480	560	2	30	80	0.3750000
NODE_8417_length_918_cov_31.559219	289	369	0	35	80	0.4375000
NODE_8417_length_918_cov_31.559219	289	369	2	6	80	0.0750000
NODE_8417_length_918_cov_31.559219	289	369	4	39	80	0.4875000
NODE_8417_length_918_cov_31.559219	342	422	2	20	80	0.2500000
NODE_8417_length_918_cov_31.559219	342	422	4	60	80	0.7500000
NODE_8417_length_918_cov_31.559219	418	498	2	58	80	0.7250000
NODE_8417_length_918_cov_31.559219	418	498	4	22	80	0.2750000
NODE_8417_length_918_cov_31.559219	471	551	2	80	80	1.0000000
NODE_8418_length_918_cov_25.195360	429	509	4	33	80	0.4125000
NODE_8418_length_918_cov_25.195360	429	509	6	14	80	0.1750000
NODE_8418_length_918_cov_25.195360	429	509	8	10	80	0.1250000
NODE_8418_length_918_cov_25.195360	429	509	10	3	80	0.0375000
NODE_8418_length_918_cov_25.195360	429	509	14	1	80	0.0125000
NODE_8418_length_918_cov_25.195360	429	509	16	19	80	0.2375000
NODE_8418_length_918_cov_25.195360	482	562	6	2	80	0.0250000
NODE_8418_length_918_cov_25.195360	482	562	8	17	80	0.2125000
NODE_8418_length_918_cov_25.195360	482	562	10	5	80	0.0625000
NODE_8418_length_918_cov_25.195360	482	562	12	7	80	0.0875000
NODE_8418_length_918_cov_25.195360	482	562	14	1	80	0.0125000
NODE_8418_length_918_cov_25.195360	482	562	16	48	80	0.6000000
NODE_8420_length_918_cov_10.537241	361	441	0	80	80	1.0000000
NODE_8420_length_918_cov_10.537241	414	492	0	78	78	1.0000000
NODE_8421_length_918_cov_9.821734	283	363	0	80	80	1.0000000
NODE_8421_length_918_cov_9.821734	336	416	0	80	80	1.0000000
NODE_8422_length_918_cov_9.714286	365	445	0	24	80	0.3000000
NODE_8422_length_918_cov_9.714286	365	445	2	56	80	0.7000000
NODE_8422_length_918_cov_9.714286	418	498	0	18	80	0.2250000
NODE_8422_length_918_cov_9.714286	418	498	2	62	80	0.7750000
NODE_8441_length_917_cov_38.845966	405	476	0	62	71	0.8732395
NODE_8441_length_917_cov_38.845966	405	476	4	9	71	0.1267606
NODE_8441_length_917_cov_38.845966	458	538	0	9	80	0.1125000
NODE_8441_length_917_cov_38.845966	458	538	4	71	80	0.8875000
NODE_8442_length_917_cov_37.775061	505	585	0	76	80	0.9500000
NODE_8442_length_917_cov_37.775061	505	585	2	4	80	0.0500000
NODE_8442_length_917_cov_37.775061	558	638	0	80	80	1.0000000
NODE_8443_length_917_cov_33.195599	335	415	0	80	80	1.0000000
NODE_8443_length_917_cov_33.195599	388	468	0	80	80	1.0000000
NODE_8443_length_917_cov_33.195599	464	544	0	80	80	1.0000000
NODE_8443_length_917_cov_33.195599	517	597	0	80	80	1.0000000
NODE_8444_length_917_cov_22.871638	463	543	2	26	80	0.3250000
NODE_8444_length_917_cov_22.871638	463	543	5	1	80	0.0125000
NODE_8444_length_917_cov_22.871638	463	543	6	13	80	0.1625000
NODE_8444_length_917_cov_22.871638	463	543	8	24	80	0.3000000
NODE_8444_length_917_cov_22.871638	463	543	10	16	80	0.2000000
NODE_8444_length_917_cov_22.871638	516	593	8	32	77	0.4155844
NODE_8444_length_917_cov_22.871638	516	593	10	45	77	0.5844156
NODE_8445_length_917_cov_16.899756	321	401	0	25	80	0.3125000
NODE_8445_length_917_cov_16.899756	321	401	2	55	80	0.6875000
NODE_8445_length_917_cov_16.899756	374	454	0	55	80	0.6875000
NODE_8445_length_917_cov_16.899756	374	454	2	25	80	0.3125000
NODE_8446_length_917_cov_12.283619	397	477	0	80	80	1.0000000
NODE_8446_length_917_cov_12.283619	450	530	0	67	80	0.8375000
NODE_8446_length_917_cov_12.283619	450	530	2	13	80	0.1625000
NODE_8447_length_917_cov_12.172372	380	460	0	22	80	0.2750000
NODE_8447_length_917_cov_12.172372	380	460	2	23	80	0.2875000
NODE_8447_length_917_cov_12.172372	380	460	4	35	80	0.4375000
NODE_8447_length_917_cov_12.172372	433	513	4	28	80	0.3500000
NODE_8447_length_917_cov_12.172372	433	513	6	3	80	0.0375000
NODE_8447_length_917_cov_12.172372	433	513	8	17	80	0.2125000
NODE_8447_length_917_cov_12.172372	433	513	10	32	80	0.4000000
NODE_8447_length_917_cov_12.172372	545	597	4	13	52	0.2500000
NODE_8447_length_917_cov_12.172372	545	597	6	31	52	0.5961539
NODE_8447_length_917_cov_12.172372	545	597	8	8	52	0.1538462
NODE_8448_length_917_cov_8.277506	564	644	0	13	80	0.1625000
NODE_8448_length_917_cov_8.277506	564	644	2	21	80	0.2625000
NODE_8448_length_917_cov_8.277506	564	644	6	46	80	0.5750000
NODE_8448_length_917_cov_8.277506	617	697	0	66	80	0.8250000
NODE_8448_length_917_cov_8.277506	617	697	2	14	80	0.1750000
NODE_8449_length_917_cov_8.145477	155	235	0	80	80	1.0000000
NODE_8449_length_917_cov_8.145477	208	288	0	80	80	1.0000000
NODE_8451_length_917_cov_6.073350	366	446	0	80	80	1.0000000
NODE_8451_length_917_cov_6.073350	419	499	0	80	80	1.0000000
NODE_8463_length_916_cov_32.867809	347	427	0	6	80	0.0750000
NODE_8463_length_916_cov_32.867809	347	427	2	74	80	0.9250000
NODE_8463_length_916_cov_32.867809	400	480	0	36	80	0.4500000
NODE_8463_length_916_cov_32.867809	400	480	2	44	80	0.5500000
NODE_8464_length_916_cov_27.673195	450	530	0	30	80	0.3750000
NODE_8464_length_916_cov_27.673195	450	530	2	50	80	0.6250000
NODE_8464_length_916_cov_27.673195	503	583	0	28	80	0.3500000
NODE_8464_length_916_cov_27.673195	503	583	2	52	80	0.6500000
NODE_8465_length_916_cov_27.146879	223	303	6	80	80	1.0000000
NODE_8465_length_916_cov_27.146879	276	356	0	7	80	0.0875000
NODE_8465_length_916_cov_27.146879	276	356	2	30	80	0.3750000
NODE_8465_length_916_cov_27.146879	276	356	4	4	80	0.0500000
NODE_8465_length_916_cov_27.146879	276	356	6	39	80	0.4875000
NODE_8466_length_916_cov_25.604651	398	478	0	80	80	1.0000000
NODE_8466_length_916_cov_25.604651	451	531	0	80	80	1.0000000
NODE_8467_length_916_cov_18.035496	456	536	0	22	80	0.2750000
NODE_8467_length_916_cov_18.035496	456	536	1	1	80	0.0125000
NODE_8467_length_916_cov_18.035496	456	536	2	24	80	0.3000000
NODE_8467_length_916_cov_18.035496	456	536	4	33	80	0.4125000
NODE_8467_length_916_cov_18.035496	509	589	4	80	80	1.0000000
NODE_8468_length_916_cov_12.651163	500	580	0	80	80	1.0000000
NODE_8468_length_916_cov_12.651163	553	633	0	80	80	1.0000000
NODE_8469_length_916_cov_11.337821	530	610	0	80	80	1.0000000
NODE_8469_length_916_cov_11.337821	583	663	0	80	80	1.0000000
NODE_8470_length_916_cov_9.640147	293	373	0	80	80	1.0000000
NODE_8470_length_916_cov_9.640147	346	426	0	80	80	1.0000000
NODE_8472_length_916_cov_8.042840	426	506	0	9	80	0.1125000
NODE_8472_length_916_cov_8.042840	426	506	2	71	80	0.8875000
NODE_8472_length_916_cov_8.042840	479	559	0	62	80	0.7750000
NODE_8472_length_916_cov_8.042840	479	559	2	18	80	0.2250000
NODE_8473_length_916_cov_7.123623	785	847	6	1	62	0.0161290
NODE_8473_length_916_cov_7.123623	785	847	8	4	62	0.0645161
NODE_8473_length_916_cov_7.123623	785	847	10	11	62	0.1774193
NODE_8473_length_916_cov_7.123623	785	847	12	2	62	0.0322581
NODE_8473_length_916_cov_7.123623	785	847	14	1	62	0.0161290
NODE_8473_length_916_cov_7.123623	785	847	16	1	62	0.0161290
NODE_8473_length_916_cov_7.123623	785	847	18	2	62	0.0322581
NODE_8473_length_916_cov_7.123623	785	847	20	40	62	0.6451613
NODE_8473_length_916_cov_7.123623	820	900	12	3	80	0.0375000
NODE_8473_length_916_cov_7.123623	820	900	14	1	80	0.0125000
NODE_8473_length_916_cov_7.123623	820	900	18	1	80	0.0125000
NODE_8473_length_916_cov_7.123623	820	900	20	75	80	0.9375000
NODE_8481_length_915_cov_59.289216	398	478	8	80	80	1.0000000
NODE_8481_length_915_cov_59.289216	451	531	0	10	80	0.1250000
NODE_8481_length_915_cov_59.289216	451	531	2	29	80	0.3625000
NODE_8481_length_915_cov_59.289216	451	531	7	1	80	0.0125000
NODE_8481_length_915_cov_59.289216	451	531	8	40	80	0.5000000
NODE_8481_length_915_cov_59.289216	527	607	0	29	80	0.3625000
NODE_8481_length_915_cov_59.289216	527	607	3	2	80	0.0250000
NODE_8481_length_915_cov_59.289216	527	607	4	34	80	0.4250000
NODE_8481_length_915_cov_59.289216	527	607	5	15	80	0.1875000
NODE_8481_length_915_cov_59.289216	580	660	2	18	80	0.2250000
NODE_8481_length_915_cov_59.289216	580	660	3	2	80	0.0250000
NODE_8481_length_915_cov_59.289216	580	660	4	10	80	0.1250000
NODE_8481_length_915_cov_59.289216	580	660	5	50	80	0.6250000
NODE_8482_length_915_cov_45.104167	153	228	0	75	75	1.0000000
NODE_8482_length_915_cov_45.104167	206	286	0	75	80	0.9375000
NODE_8482_length_915_cov_45.104167	206	286	2	5	80	0.0625000
NODE_8482_length_915_cov_45.104167	282	362	0	1	80	0.0125000
NODE_8482_length_915_cov_45.104167	282	362	2	79	80	0.9875000
NODE_8482_length_915_cov_45.104167	335	415	0	12	80	0.1500000
NODE_8482_length_915_cov_45.104167	335	415	2	68	80	0.8500000
NODE_8483_length_915_cov_37.599265	397	477	0	80	80	1.0000000
NODE_8483_length_915_cov_37.599265	450	530	0	80	80	1.0000000
NODE_8485_length_915_cov_20.458333	297	377	1	25	80	0.3125000
NODE_8485_length_915_cov_20.458333	297	377	2	55	80	0.6875000
NODE_8485_length_915_cov_20.458333	350	430	2	37	80	0.4625000
NODE_8485_length_915_cov_20.458333	350	430	4	43	80	0.5375000
NODE_8485_length_915_cov_20.458333	426	506	0	34	80	0.4250000
NODE_8485_length_915_cov_20.458333	426	506	1	18	80	0.2250000
NODE_8485_length_915_cov_20.458333	426	506	3	9	80	0.1125000
NODE_8485_length_915_cov_20.458333	426	506	4	19	80	0.2375000
NODE_8485_length_915_cov_20.458333	479	559	0	80	80	1.0000000
NODE_8486_length_915_cov_14.397059	175	255	0	80	80	1.0000000
NODE_8486_length_915_cov_14.397059	228	308	0	80	80	1.0000000
NODE_8487_length_915_cov_8.741422	295	375	0	38	80	0.4750000
NODE_8487_length_915_cov_8.741422	295	375	4	42	80	0.5250000
NODE_8487_length_915_cov_8.741422	348	428	0	15	80	0.1875000
NODE_8487_length_915_cov_8.741422	348	428	4	65	80	0.8125000
NODE_8488_length_915_cov_7.719363	823	894	2	71	71	1.0000000
NODE_8488_length_915_cov_7.719363	828	894	2	66	66	1.0000000
NODE_8488_length_915_cov_7.719363	867	915	0	7	48	0.1458333
NODE_8488_length_915_cov_7.719363	867	915	2	41	48	0.8541667
NODE_8488_length_915_cov_7.719363	867	915	0	7	48	0.1458333
NODE_8488_length_915_cov_7.719363	867	915	2	41	48	0.8541667
NODE_8488_length_915_cov_7.719363	867	915	0	7	48	0.1458333
NODE_8488_length_915_cov_7.719363	867	915	2	41	48	0.8541667
NODE_8489_length_915_cov_7.648284	370	450	0	80	80	1.0000000
NODE_8489_length_915_cov_7.648284	423	503	0	80	80	1.0000000
NODE_8490_length_915_cov_6.848039	434	514	2	32	80	0.4000000
NODE_8490_length_915_cov_6.848039	434	514	4	31	80	0.3875000
NODE_8490_length_915_cov_6.848039	434	514	6	17	80	0.2125000
NODE_8490_length_915_cov_6.848039	487	567	2	23	80	0.2875000
NODE_8490_length_915_cov_6.848039	487	567	4	43	80	0.5375000
NODE_8490_length_915_cov_6.848039	487	567	6	14	80	0.1750000
NODE_8497_length_915_cov_2.011029	24	99	2	34	75	0.4533333
NODE_8497_length_915_cov_2.011029	24	99	6	41	75	0.5466667
NODE_8505_length_914_cov_89.814724	0	41	2	4	41	0.0975610
NODE_8505_length_914_cov_89.814724	0	41	6	1	41	0.0243902
NODE_8505_length_914_cov_89.814724	0	41	10	3	41	0.0731707
NODE_8505_length_914_cov_89.814724	0	41	12	2	41	0.0487805
NODE_8505_length_914_cov_89.814724	0	41	22	3	41	0.0731707
NODE_8505_length_914_cov_89.814724	0	41	28	1	41	0.0243902
NODE_8505_length_914_cov_89.814724	0	41	30	1	41	0.0243902
NODE_8505_length_914_cov_89.814724	0	41	33	2	41	0.0487805
NODE_8505_length_914_cov_89.814724	0	41	34	1	41	0.0243902
NODE_8505_length_914_cov_89.814724	0	41	35	2	41	0.0487805
NODE_8505_length_914_cov_89.814724	0	41	41	3	41	0.0731707
NODE_8505_length_914_cov_89.814724	0	41	47	2	41	0.0487805
NODE_8505_length_914_cov_89.814724	0	41	53	3	41	0.0731707
NODE_8505_length_914_cov_89.814724	0	41	55	4	41	0.0975610
NODE_8505_length_914_cov_89.814724	0	41	58	2	41	0.0487805
NODE_8505_length_914_cov_89.814724	0	41	64	1	41	0.0243902
NODE_8505_length_914_cov_89.814724	0	41	67	4	41	0.0975610
NODE_8505_length_914_cov_89.814724	0	41	69	2	41	0.0487805
NODE_8505_length_914_cov_89.814724	19	94	35	1	75	0.0133333
NODE_8505_length_914_cov_89.814724	19	94	41	3	75	0.0400000
NODE_8505_length_914_cov_89.814724	19	94	47	2	75	0.0266667
NODE_8505_length_914_cov_89.814724	19	94	53	3	75	0.0400000
NODE_8505_length_914_cov_89.814724	19	94	55	4	75	0.0533333
NODE_8505_length_914_cov_89.814724	19	94	58	2	75	0.0266667
NODE_8505_length_914_cov_89.814724	19	94	64	1	75	0.0133333
NODE_8505_length_914_cov_89.814724	19	94	67	4	75	0.0533333
NODE_8505_length_914_cov_89.814724	19	94	69	2	75	0.0266667
NODE_8505_length_914_cov_89.814724	19	94	71	1	75	0.0133333
NODE_8505_length_914_cov_89.814724	19	94	75	1	75	0.0133333
NODE_8505_length_914_cov_89.814724	19	94	91	4	75	0.0533333
NODE_8505_length_914_cov_89.814724	19	94	98	2	75	0.0266667
NODE_8505_length_914_cov_89.814724	19	94	102	2	75	0.0266667
NODE_8505_length_914_cov_89.814724	19	94	104	2	75	0.0266667
NODE_8505_length_914_cov_89.814724	19	94	109	1	75	0.0133333
NODE_8505_length_914_cov_89.814724	19	94	110	2	75	0.0266667
NODE_8505_length_914_cov_89.814724	19	94	112	1	75	0.0133333
NODE_8505_length_914_cov_89.814724	19	94	118	1	75	0.0133333
NODE_8505_length_914_cov_89.814724	19	94	120	2	75	0.0266667
NODE_8505_length_914_cov_89.814724	19	94	122	8	75	0.1066667
NODE_8505_length_914_cov_89.814724	19	94	124	2	75	0.0266667
NODE_8505_length_914_cov_89.814724	19	94	128	4	75	0.0533333
NODE_8505_length_914_cov_89.814724	19	94	132	5	75	0.0666667
NODE_8505_length_914_cov_89.814724	19	94	134	1	75	0.0133333
NODE_8505_length_914_cov_89.814724	19	94	135	2	75	0.0266667
NODE_8505_length_914_cov_89.814724	19	94	136	5	75	0.0666667
NODE_8505_length_914_cov_89.814724	19	94	137	4	75	0.0533333
NODE_8505_length_914_cov_89.814724	19	94	139	2	75	0.0266667
NODE_8505_length_914_cov_89.814724	19	94	141	1	75	0.0133333
NODE_8506_length_914_cov_33.755828	400	480	0	80	80	1.0000000
NODE_8506_length_914_cov_33.755828	453	533	0	80	80	1.0000000
NODE_8507_length_914_cov_31.557055	368	448	0	80	80	1.0000000
NODE_8507_length_914_cov_31.557055	421	501	0	80	80	1.0000000
NODE_8508_length_914_cov_29.087117	331	411	10	4	80	0.0500000
NODE_8508_length_914_cov_29.087117	331	411	12	76	80	0.9500000
NODE_8508_length_914_cov_29.087117	384	464	0	6	80	0.0750000
NODE_8508_length_914_cov_29.087117	384	464	2	26	80	0.3250000
NODE_8508_length_914_cov_29.087117	384	464	4	1	80	0.0125000
NODE_8508_length_914_cov_29.087117	384	464	10	21	80	0.2625000
NODE_8508_length_914_cov_29.087117	384	464	12	26	80	0.3250000
NODE_8509_length_914_cov_28.490798	273	353	0	80	80	1.0000000
NODE_8509_length_914_cov_28.490798	326	406	0	80	80	1.0000000
NODE_8509_length_914_cov_28.490798	402	482	0	80	80	1.0000000
NODE_8509_length_914_cov_28.490798	455	535	0	80	80	1.0000000
NODE_8510_length_914_cov_25.429448	393	473	2	6	80	0.0750000
NODE_8510_length_914_cov_25.429448	393	473	4	17	80	0.2125000
NODE_8510_length_914_cov_25.429448	393	473	6	6	80	0.0750000
NODE_8510_length_914_cov_25.429448	393	473	8	51	80	0.6375000
NODE_8510_length_914_cov_25.429448	446	526	2	2	80	0.0250000
NODE_8510_length_914_cov_25.429448	446	526	4	12	80	0.1500000
NODE_8510_length_914_cov_25.429448	446	526	5	1	80	0.0125000
NODE_8510_length_914_cov_25.429448	446	526	6	41	80	0.5125000
NODE_8510_length_914_cov_25.429448	446	526	8	24	80	0.3000000
NODE_8510_length_914_cov_25.429448	522	602	0	76	80	0.9500000
NODE_8510_length_914_cov_25.429448	522	602	2	2	80	0.0250000
NODE_8510_length_914_cov_25.429448	522	602	4	2	80	0.0250000
NODE_8510_length_914_cov_25.429448	575	655	0	80	80	1.0000000
NODE_8511_length_914_cov_19.111656	354	434	0	80	80	1.0000000
NODE_8511_length_914_cov_19.111656	407	487	0	80	80	1.0000000
NODE_8512_length_914_cov_13.423313	603	683	0	43	80	0.5375000
NODE_8512_length_914_cov_13.423313	603	683	2	37	80	0.4625000
NODE_8512_length_914_cov_13.423313	656	736	2	80	80	1.0000000
NODE_8513_length_914_cov_10.947239	341	411	0	70	70	1.0000000
NODE_8513_length_914_cov_10.947239	384	464	0	80	80	1.0000000
NODE_8518_length_914_cov_1.931288	833	873	0	40	40	1.0000000
NODE_8526_length_913_cov_49.665848	31	111	31	1	80	0.0125000
NODE_8526_length_913_cov_49.665848	31	111	35	2	80	0.0250000
NODE_8526_length_913_cov_49.665848	31	111	37	1	80	0.0125000
NODE_8526_length_913_cov_49.665848	31	111	39	1	80	0.0125000
NODE_8526_length_913_cov_49.665848	31	111	41	1	80	0.0125000
NODE_8526_length_913_cov_49.665848	31	111	47	1	80	0.0125000
NODE_8526_length_913_cov_49.665848	31	111	49	2	80	0.0250000
NODE_8526_length_913_cov_49.665848	31	111	51	9	80	0.1125000
NODE_8526_length_913_cov_49.665848	31	111	53	2	80	0.0250000
NODE_8526_length_913_cov_49.665848	31	111	54	2	80	0.0250000
NODE_8526_length_913_cov_49.665848	31	111	56	2	80	0.0250000
NODE_8526_length_913_cov_49.665848	31	111	58	2	80	0.0250000
NODE_8526_length_913_cov_49.665848	31	111	59	5	80	0.0625000
NODE_8526_length_913_cov_49.665848	31	111	61	3	80	0.0375000
NODE_8526_length_913_cov_49.665848	31	111	67	1	80	0.0125000
NODE_8526_length_913_cov_49.665848	31	111	73	1	80	0.0125000
NODE_8526_length_913_cov_49.665848	31	111	79	1	80	0.0125000
NODE_8526_length_913_cov_49.665848	31	111	81	8	80	0.1000000
NODE_8526_length_913_cov_49.665848	31	111	85	1	80	0.0125000
NODE_8526_length_913_cov_49.665848	31	111	87	5	80	0.0625000
NODE_8526_length_913_cov_49.665848	31	111	89	2	80	0.0250000
NODE_8526_length_913_cov_49.665848	31	111	91	1	80	0.0125000
NODE_8526_length_913_cov_49.665848	31	111	93	3	80	0.0375000
NODE_8526_length_913_cov_49.665848	31	111	95	1	80	0.0125000
NODE_8526_length_913_cov_49.665848	31	111	99	4	80	0.0500000
NODE_8526_length_913_cov_49.665848	31	111	102	1	80	0.0125000
NODE_8526_length_913_cov_49.665848	31	111	104	4	80	0.0500000
NODE_8526_length_913_cov_49.665848	31	111	106	6	80	0.0750000
NODE_8526_length_913_cov_49.665848	31	111	108	6	80	0.0750000
NODE_8526_length_913_cov_49.665848	31	111	110	1	80	0.0125000
NODE_8526_length_913_cov_49.665848	136	155	68	2	19	0.1052632
NODE_8526_length_913_cov_49.665848	136	155	70	1	19	0.0526316
NODE_8526_length_913_cov_49.665848	136	155	72	3	19	0.1578947
NODE_8526_length_913_cov_49.665848	136	155	76	4	19	0.2105263
NODE_8526_length_913_cov_49.665848	136	155	82	1	19	0.0526316
NODE_8526_length_913_cov_49.665848	136	155	85	1	19	0.0526316
NODE_8526_length_913_cov_49.665848	136	155	86	6	19	0.3157895
NODE_8526_length_913_cov_49.665848	136	155	88	1	19	0.0526316
NODE_8527_length_913_cov_47.115479	367	447	0	40	80	0.5000000
NODE_8527_length_913_cov_47.115479	367	447	2	20	80	0.2500000
NODE_8527_length_913_cov_47.115479	367	447	6	15	80	0.1875000
NODE_8527_length_913_cov_47.115479	367	447	10	5	80	0.0625000
NODE_8527_length_913_cov_47.115479	420	500	2	7	80	0.0875000
NODE_8527_length_913_cov_47.115479	420	500	6	15	80	0.1875000
NODE_8527_length_913_cov_47.115479	420	500	8	37	80	0.4625000
NODE_8527_length_913_cov_47.115479	420	500	10	21	80	0.2625000
NODE_8528_length_913_cov_36.541769	502	582	0	27	80	0.3375000
NODE_8528_length_913_cov_36.541769	502	582	6	53	80	0.6625000
NODE_8528_length_913_cov_36.541769	555	635	0	6	80	0.0750000
NODE_8528_length_913_cov_36.541769	555	635	6	74	80	0.9250000
NODE_8529_length_913_cov_33.679361	433	513	0	18	80	0.2250000
NODE_8529_length_913_cov_33.679361	433	513	2	40	80	0.5000000
NODE_8529_length_913_cov_33.679361	433	513	4	2	80	0.0250000
NODE_8529_length_913_cov_33.679361	433	513	6	20	80	0.2500000
NODE_8529_length_913_cov_33.679361	486	566	2	5	80	0.0625000
NODE_8529_length_913_cov_33.679361	486	566	4	13	80	0.1625000
NODE_8529_length_913_cov_33.679361	486	566	6	62	80	0.7750000
NODE_8530_length_913_cov_29.675676	408	488	0	68	80	0.8500000
NODE_8530_length_913_cov_29.675676	408	488	2	12	80	0.1500000
NODE_8530_length_913_cov_29.675676	461	541	0	15	80	0.1875000
NODE_8530_length_913_cov_29.675676	461	541	2	65	80	0.8125000
NODE_8531_length_913_cov_24.901720	342	422	0	17	80	0.2125000
NODE_8531_length_913_cov_24.901720	342	422	2	63	80	0.7875000
NODE_8531_length_913_cov_24.901720	395	475	0	30	80	0.3750000
NODE_8531_length_913_cov_24.901720	395	475	2	50	80	0.6250000
NODE_8532_length_913_cov_24.625307	396	476	0	80	80	1.0000000
NODE_8532_length_913_cov_24.625307	449	529	0	80	80	1.0000000
NODE_8533_length_913_cov_15.094595	525	589	0	11	64	0.1718750
NODE_8533_length_913_cov_15.094595	525	589	2	53	64	0.8281250
NODE_8533_length_913_cov_15.094595	562	642	0	35	80	0.4375000
NODE_8533_length_913_cov_15.094595	562	642	2	45	80	0.5625000
NODE_8534_length_913_cov_8.633907	305	385	0	31	80	0.3875000
NODE_8534_length_913_cov_8.633907	305	385	2	9	80	0.1125000
NODE_8534_length_913_cov_8.633907	305	385	4	40	80	0.5000000
NODE_8534_length_913_cov_8.633907	358	429	4	71	71	1.0000000
NODE_8546_length_912_cov_25.110701	419	499	0	45	80	0.5625000
NODE_8546_length_912_cov_25.110701	419	499	2	35	80	0.4375000
NODE_8546_length_912_cov_25.110701	472	552	2	31	80	0.3875000
NODE_8546_length_912_cov_25.110701	472	552	4	49	80	0.6125000
NODE_8547_length_912_cov_20.045510	306	386	0	12	80	0.1500000
NODE_8547_length_912_cov_20.045510	306	386	2	68	80	0.8500000
NODE_8547_length_912_cov_20.045510	359	439	0	63	80	0.7875000
NODE_8547_length_912_cov_20.045510	359	439	2	17	80	0.2125000
NODE_8548_length_912_cov_19.635916	326	406	0	80	80	1.0000000
NODE_8548_length_912_cov_19.635916	379	459	0	80	80	1.0000000
NODE_8549_length_912_cov_17.714637	395	475	0	80	80	1.0000000
NODE_8549_length_912_cov_17.714637	448	528	0	80	80	1.0000000
NODE_8550_length_912_cov_15.546125	355	435	0	4	80	0.0500000
NODE_8550_length_912_cov_15.546125	355	435	2	13	80	0.1625000
NODE_8550_length_912_cov_15.546125	355	435	4	18	80	0.2250000
NODE_8550_length_912_cov_15.546125	355	435	6	9	80	0.1125000
NODE_8550_length_912_cov_15.546125	355	435	8	36	80	0.4500000
NODE_8550_length_912_cov_15.546125	408	488	2	11	80	0.1375000
NODE_8550_length_912_cov_15.546125	408	488	4	4	80	0.0500000
NODE_8550_length_912_cov_15.546125	408	488	6	34	80	0.4250000
NODE_8550_length_912_cov_15.546125	408	488	8	31	80	0.3875000
NODE_8551_length_912_cov_15.077491	255	291	2	29	36	0.8055556
NODE_8551_length_912_cov_15.077491	255	291	4	7	36	0.1944444
NODE_8551_length_912_cov_15.077491	264	328	2	44	64	0.6875000
NODE_8551_length_912_cov_15.077491	264	328	4	20	64	0.3125000
NODE_8551_length_912_cov_15.077491	415	495	0	52	80	0.6500000
NODE_8551_length_912_cov_15.077491	415	495	2	28	80	0.3500000
NODE_8551_length_912_cov_15.077491	468	548	0	80	80	1.0000000
NODE_8552_length_912_cov_15.023370	361	441	0	64	80	0.8000000
NODE_8552_length_912_cov_15.023370	361	441	6	16	80	0.2000000
NODE_8552_length_912_cov_15.023370	414	494	0	11	80	0.1375000
NODE_8552_length_912_cov_15.023370	414	494	6	69	80	0.8625000
NODE_8553_length_912_cov_13.600246	61	141	2	80	80	1.0000000
NODE_8553_length_912_cov_13.600246	460	540	0	77	80	0.9625000
NODE_8553_length_912_cov_13.600246	460	540	2	3	80	0.0375000
NODE_8553_length_912_cov_13.600246	513	593	0	24	80	0.3000000
NODE_8553_length_912_cov_13.600246	513	593	2	56	80	0.7000000
NODE_8554_length_912_cov_13.113161	385	465	2	80	80	1.0000000
NODE_8554_length_912_cov_13.113161	438	518	0	31	80	0.3875000
NODE_8554_length_912_cov_13.113161	438	518	2	49	80	0.6125000
NODE_8555_length_912_cov_11.110701	353	433	0	80	80	1.0000000
NODE_8555_length_912_cov_11.110701	406	486	0	80	80	1.0000000
NODE_8555_length_912_cov_11.110701	827	907	4	80	80	1.0000000
NODE_8555_length_912_cov_11.110701	831	854	4	23	23	1.0000000
NODE_8584_length_911_cov_173.171182	580	660	169	1	80	0.0125000
NODE_8584_length_911_cov_173.171182	580	660	171	1	80	0.0125000
NODE_8584_length_911_cov_173.171182	580	660	173	1	80	0.0125000
NODE_8584_length_911_cov_173.171182	580	660	174	1	80	0.0125000
NODE_8584_length_911_cov_173.171182	580	660	176	2	80	0.0250000
NODE_8584_length_911_cov_173.171182	580	660	181	1	80	0.0125000
NODE_8584_length_911_cov_173.171182	580	660	182	1	80	0.0125000
NODE_8584_length_911_cov_173.171182	580	660	185	1	80	0.0125000
NODE_8584_length_911_cov_173.171182	580	660	192	1	80	0.0125000
NODE_8584_length_911_cov_173.171182	580	660	195	1	80	0.0125000
NODE_8584_length_911_cov_173.171182	580	660	201	1	80	0.0125000
NODE_8584_length_911_cov_173.171182	580	660	206	1	80	0.0125000
NODE_8584_length_911_cov_173.171182	580	660	208	1	80	0.0125000
NODE_8584_length_911_cov_173.171182	580	660	210	2	80	0.0250000
NODE_8584_length_911_cov_173.171182	580	660	211	6	80	0.0750000
NODE_8584_length_911_cov_173.171182	580	660	212	1	80	0.0125000
NODE_8584_length_911_cov_173.171182	580	660	213	1	80	0.0125000
NODE_8584_length_911_cov_173.171182	580	660	214	4	80	0.0500000
NODE_8584_length_911_cov_173.171182	580	660	219	2	80	0.0250000
NODE_8584_length_911_cov_173.171182	580	660	221	1	80	0.0125000
NODE_8584_length_911_cov_173.171182	580	660	223	1	80	0.0125000
NODE_8584_length_911_cov_173.171182	580	660	224	1	80	0.0125000
NODE_8584_length_911_cov_173.171182	580	660	225	2	80	0.0250000
NODE_8584_length_911_cov_173.171182	580	660	226	4	80	0.0500000
NODE_8584_length_911_cov_173.171182	580	660	228	1	80	0.0125000
NODE_8584_length_911_cov_173.171182	580	660	229	2	80	0.0250000
NODE_8584_length_911_cov_173.171182	580	660	230	1	80	0.0125000
NODE_8584_length_911_cov_173.171182	580	660	231	7	80	0.0875000
NODE_8584_length_911_cov_173.171182	580	660	232	1	80	0.0125000
NODE_8584_length_911_cov_173.171182	580	660	234	1	80	0.0125000
NODE_8584_length_911_cov_173.171182	580	660	235	1	80	0.0125000
NODE_8584_length_911_cov_173.171182	580	660	236	2	80	0.0250000
NODE_8584_length_911_cov_173.171182	580	660	238	1	80	0.0125000
NODE_8584_length_911_cov_173.171182	580	660	248	1	80	0.0125000
NODE_8584_length_911_cov_173.171182	580	660	249	2	80	0.0250000
NODE_8584_length_911_cov_173.171182	580	660	255	2	80	0.0250000
NODE_8584_length_911_cov_173.171182	580	660	256	1	80	0.0125000
NODE_8584_length_911_cov_173.171182	580	660	258	1	80	0.0125000
NODE_8584_length_911_cov_173.171182	580	660	260	1	80	0.0125000
NODE_8584_length_911_cov_173.171182	580	660	277	1	80	0.0125000
NODE_8584_length_911_cov_173.171182	580	660	278	2	80	0.0250000
NODE_8584_length_911_cov_173.171182	580	660	280	4	80	0.0500000
NODE_8584_length_911_cov_173.171182	580	660	282	3	80	0.0375000
NODE_8584_length_911_cov_173.171182	580	660	286	1	80	0.0125000
NODE_8584_length_911_cov_173.171182	580	660	292	1	80	0.0125000
NODE_8584_length_911_cov_173.171182	580	660	293	1	80	0.0125000
NODE_8584_length_911_cov_173.171182	580	660	294	1	80	0.0125000
NODE_8584_length_911_cov_173.171182	580	660	300	1	80	0.0125000
NODE_8584_length_911_cov_173.171182	580	660	304	1	80	0.0125000
NODE_8584_length_911_cov_173.171182	633	713	236	2	80	0.0250000
NODE_8584_length_911_cov_173.171182	633	713	238	1	80	0.0125000
NODE_8584_length_911_cov_173.171182	633	713	248	1	80	0.0125000
NODE_8584_length_911_cov_173.171182	633	713	249	2	80	0.0250000
NODE_8584_length_911_cov_173.171182	633	713	255	2	80	0.0250000
NODE_8584_length_911_cov_173.171182	633	713	256	1	80	0.0125000
NODE_8584_length_911_cov_173.171182	633	713	258	1	80	0.0125000
NODE_8584_length_911_cov_173.171182	633	713	260	1	80	0.0125000
NODE_8584_length_911_cov_173.171182	633	713	277	1	80	0.0125000
NODE_8584_length_911_cov_173.171182	633	713	278	2	80	0.0250000
NODE_8584_length_911_cov_173.171182	633	713	280	4	80	0.0500000
NODE_8584_length_911_cov_173.171182	633	713	282	3	80	0.0375000
NODE_8584_length_911_cov_173.171182	633	713	286	1	80	0.0125000
NODE_8584_length_911_cov_173.171182	633	713	292	1	80	0.0125000
NODE_8584_length_911_cov_173.171182	633	713	293	1	80	0.0125000
NODE_8584_length_911_cov_173.171182	633	713	294	1	80	0.0125000
NODE_8584_length_911_cov_173.171182	633	713	300	1	80	0.0125000
NODE_8584_length_911_cov_173.171182	633	713	301	1	80	0.0125000
NODE_8584_length_911_cov_173.171182	633	713	304	1	80	0.0125000
NODE_8584_length_911_cov_173.171182	633	713	305	1	80	0.0125000
NODE_8584_length_911_cov_173.171182	633	713	307	1	80	0.0125000
NODE_8584_length_911_cov_173.171182	633	713	309	2	80	0.0250000
NODE_8584_length_911_cov_173.171182	633	713	311	1	80	0.0125000
NODE_8584_length_911_cov_173.171182	633	713	312	1	80	0.0125000
NODE_8584_length_911_cov_173.171182	633	713	313	2	80	0.0250000
NODE_8584_length_911_cov_173.171182	633	713	314	2	80	0.0250000
NODE_8584_length_911_cov_173.171182	633	713	316	2	80	0.0250000
NODE_8584_length_911_cov_173.171182	633	713	317	1	80	0.0125000
NODE_8584_length_911_cov_173.171182	633	713	318	1	80	0.0125000
NODE_8584_length_911_cov_173.171182	633	713	319	2	80	0.0250000
NODE_8584_length_911_cov_173.171182	633	713	320	2	80	0.0250000
NODE_8584_length_911_cov_173.171182	633	713	321	2	80	0.0250000
NODE_8584_length_911_cov_173.171182	633	713	323	1	80	0.0125000
NODE_8584_length_911_cov_173.171182	633	713	325	2	80	0.0250000
NODE_8584_length_911_cov_173.171182	633	713	326	3	80	0.0375000
NODE_8584_length_911_cov_173.171182	633	713	327	1	80	0.0125000
NODE_8584_length_911_cov_173.171182	633	713	328	1	80	0.0125000
NODE_8584_length_911_cov_173.171182	633	713	329	1	80	0.0125000
NODE_8584_length_911_cov_173.171182	633	713	330	1	80	0.0125000
NODE_8584_length_911_cov_173.171182	633	713	335	2	80	0.0250000
NODE_8584_length_911_cov_173.171182	633	713	336	1	80	0.0125000
NODE_8584_length_911_cov_173.171182	633	713	338	2	80	0.0250000
NODE_8584_length_911_cov_173.171182	633	713	339	1	80	0.0125000
NODE_8584_length_911_cov_173.171182	633	713	340	7	80	0.0875000
NODE_8584_length_911_cov_173.171182	633	713	341	1	80	0.0125000
NODE_8584_length_911_cov_173.171182	633	713	342	2	80	0.0250000
NODE_8584_length_911_cov_173.171182	633	713	349	1	80	0.0125000
NODE_8584_length_911_cov_173.171182	633	713	361	2	80	0.0250000
NODE_8584_length_911_cov_173.171182	633	713	363	2	80	0.0250000
NODE_8584_length_911_cov_173.171182	633	713	369	1	80	0.0125000
NODE_8585_length_911_cov_88.250000	525	605	0	16	80	0.2000000
NODE_8585_length_911_cov_88.250000	525	605	2	64	80	0.8000000
NODE_8585_length_911_cov_88.250000	578	658	0	32	80	0.4000000
NODE_8585_length_911_cov_88.250000	578	658	2	48	80	0.6000000
NODE_8586_length_911_cov_46.854680	255	335	4	25	80	0.3125000
NODE_8586_length_911_cov_46.854680	255	335	6	8	80	0.1000000
NODE_8586_length_911_cov_46.854680	255	335	8	47	80	0.5875000
NODE_8586_length_911_cov_46.854680	308	388	2	38	80	0.4750000
NODE_8586_length_911_cov_46.854680	308	388	4	2	80	0.0250000
NODE_8586_length_911_cov_46.854680	308	388	6	12	80	0.1500000
NODE_8586_length_911_cov_46.854680	308	388	8	28	80	0.3500000
NODE_8586_length_911_cov_46.854680	384	464	0	70	80	0.8750000
NODE_8586_length_911_cov_46.854680	384	464	2	10	80	0.1250000
NODE_8586_length_911_cov_46.854680	437	517	0	80	80	1.0000000
NODE_8587_length_911_cov_31.362069	301	381	0	31	80	0.3875000
NODE_8587_length_911_cov_31.362069	301	381	2	31	80	0.3875000
NODE_8587_length_911_cov_31.362069	301	381	6	7	80	0.0875000
NODE_8587_length_911_cov_31.362069	301	381	8	8	80	0.1000000
NODE_8587_length_911_cov_31.362069	301	381	10	3	80	0.0375000
NODE_8587_length_911_cov_31.362069	354	434	2	9	80	0.1125000
NODE_8587_length_911_cov_31.362069	354	434	6	7	80	0.0875000
NODE_8587_length_911_cov_31.362069	354	434	8	8	80	0.1000000
NODE_8587_length_911_cov_31.362069	354	434	10	22	80	0.2750000
NODE_8587_length_911_cov_31.362069	354	434	12	34	80	0.4250000
NODE_8588_length_911_cov_19.235222	445	525	0	80	80	1.0000000
NODE_8588_length_911_cov_19.235222	498	578	0	80	80	1.0000000
NODE_8589_length_911_cov_16.230296	233	313	2	80	80	1.0000000
NODE_8589_length_911_cov_16.230296	286	366	0	29	80	0.3625000
NODE_8589_length_911_cov_16.230296	286	366	2	51	80	0.6375000
NODE_8590_length_911_cov_14.979064	472	552	0	80	80	1.0000000
NODE_8590_length_911_cov_14.979064	525	605	0	80	80	1.0000000
NODE_8591_length_911_cov_12.089901	357	409	12	16	52	0.3076923
NODE_8591_length_911_cov_12.089901	357	409	14	36	52	0.6923077
NODE_8591_length_911_cov_12.089901	401	462	2	2	61	0.0327869
NODE_8591_length_911_cov_12.089901	401	462	4	9	61	0.1475410
NODE_8591_length_911_cov_12.089901	401	462	12	12	61	0.1967213
NODE_8591_length_911_cov_12.089901	401	462	14	37	61	0.6065574
NODE_8591_length_911_cov_12.089901	401	462	16	1	61	0.0163934
NODE_8606_length_910_cov_27.838471	347	427	0	35	80	0.4375000
NODE_8606_length_910_cov_27.838471	347	427	2	45	80	0.5625000
NODE_8606_length_910_cov_27.838471	400	480	0	27	80	0.3375000
NODE_8606_length_910_cov_27.838471	400	480	2	53	80	0.6625000
NODE_8607_length_910_cov_25.895191	361	441	0	14	80	0.1750000
NODE_8607_length_910_cov_25.895191	361	441	2	66	80	0.8250000
NODE_8607_length_910_cov_25.895191	414	494	0	67	80	0.8375000
NODE_8607_length_910_cov_25.895191	414	494	2	13	80	0.1625000
NODE_8608_length_910_cov_25.604192	294	374	4	80	80	1.0000000
NODE_8608_length_910_cov_25.604192	347	427	0	27	80	0.3375000
NODE_8608_length_910_cov_25.604192	347	427	2	13	80	0.1625000
NODE_8608_length_910_cov_25.604192	347	427	4	40	80	0.5000000
NODE_8608_length_910_cov_25.604192	423	503	2	62	80	0.7750000
NODE_8608_length_910_cov_25.604192	423	503	4	18	80	0.2250000
NODE_8608_length_910_cov_25.604192	476	556	2	62	80	0.7750000
NODE_8608_length_910_cov_25.604192	476	556	4	18	80	0.2250000
NODE_8609_length_910_cov_16.066584	656	736	0	10	80	0.1250000
NODE_8609_length_910_cov_16.066584	656	736	4	70	80	0.8750000
NODE_8609_length_910_cov_16.066584	709	789	0	36	80	0.4500000
NODE_8609_length_910_cov_16.066584	709	789	4	44	80	0.5500000
NODE_8610_length_910_cov_14.696671	417	497	16	16	80	0.2000000
NODE_8610_length_910_cov_14.696671	417	497	27	13	80	0.1625000
NODE_8610_length_910_cov_14.696671	417	497	28	5	80	0.0625000
NODE_8610_length_910_cov_14.696671	417	497	29	1	80	0.0125000
NODE_8610_length_910_cov_14.696671	417	497	30	2	80	0.0250000
NODE_8610_length_910_cov_14.696671	417	497	31	2	80	0.0250000
NODE_8610_length_910_cov_14.696671	417	497	35	2	80	0.0250000
NODE_8610_length_910_cov_14.696671	417	497	36	33	80	0.4125000
NODE_8610_length_910_cov_14.696671	417	497	38	6	80	0.0750000
NODE_8610_length_910_cov_14.696671	470	550	0	15	80	0.1875000
NODE_8610_length_910_cov_14.696671	470	550	13	10	80	0.1250000
NODE_8610_length_910_cov_14.696671	470	550	18	4	80	0.0500000
NODE_8610_length_910_cov_14.696671	470	550	24	12	80	0.1500000
NODE_8610_length_910_cov_14.696671	470	550	26	10	80	0.1250000
NODE_8610_length_910_cov_14.696671	470	550	27	15	80	0.1875000
NODE_8610_length_910_cov_14.696671	470	550	28	5	80	0.0625000
NODE_8610_length_910_cov_14.696671	470	550	29	1	80	0.0125000
NODE_8610_length_910_cov_14.696671	470	550	30	2	80	0.0250000
NODE_8610_length_910_cov_14.696671	470	550	31	2	80	0.0250000
NODE_8610_length_910_cov_14.696671	470	550	35	2	80	0.0250000
NODE_8610_length_910_cov_14.696671	470	550	36	1	80	0.0125000
NODE_8610_length_910_cov_14.696671	470	550	38	1	80	0.0125000
NODE_8612_length_910_cov_7.114673	442	522	0	17	80	0.2125000
NODE_8612_length_910_cov_7.114673	442	522	4	63	80	0.7875000
NODE_8612_length_910_cov_7.114673	495	575	0	41	80	0.5125000
NODE_8612_length_910_cov_7.114673	495	575	2	9	80	0.1125000
NODE_8612_length_910_cov_7.114673	495	575	4	30	80	0.3750000
NODE_8614_length_910_cov_2.992602	196	269	8	10	73	0.1369863
NODE_8614_length_910_cov_2.992602	196	269	10	15	73	0.2054795
NODE_8614_length_910_cov_2.992602	196	269	12	27	73	0.3698630
NODE_8614_length_910_cov_2.992602	196	269	14	2	73	0.0273973
NODE_8614_length_910_cov_2.992602	196	269	16	1	73	0.0136986
NODE_8614_length_910_cov_2.992602	196	269	18	18	73	0.2465753
NODE_8614_length_910_cov_2.992602	249	329	6	2	80	0.0250000
NODE_8614_length_910_cov_2.992602	249	329	10	11	80	0.1375000
NODE_8614_length_910_cov_2.992602	249	329	12	61	80	0.7625000
NODE_8614_length_910_cov_2.992602	249	329	13	2	80	0.0250000
NODE_8614_length_910_cov_2.992602	249	329	14	4	80	0.0500000
NODE_8614_length_910_cov_2.992602	386	439	2	2	53	0.0377358
NODE_8614_length_910_cov_2.992602	386	439	6	10	53	0.1886792
NODE_8614_length_910_cov_2.992602	386	439	8	21	53	0.3962264
NODE_8614_length_910_cov_2.992602	386	439	10	20	53	0.3773585
NODE_8623_length_909_cov_35.291358	426	506	4	21	80	0.2625000
NODE_8623_length_909_cov_35.291358	426	506	14	18	80	0.2250000
NODE_8623_length_909_cov_35.291358	426	506	16	23	80	0.2875000
NODE_8623_length_909_cov_35.291358	426	506	18	18	80	0.2250000
NODE_8623_length_909_cov_35.291358	479	559	2	6	80	0.0750000
NODE_8623_length_909_cov_35.291358	479	559	14	65	80	0.8125000
NODE_8623_length_909_cov_35.291358	479	559	16	9	80	0.1125000
NODE_8624_length_909_cov_27.449383	311	391	2	80	80	1.0000000
NODE_8624_length_909_cov_27.449383	364	444	0	8	80	0.1000000
NODE_8624_length_909_cov_27.449383	364	444	2	72	80	0.9000000
NODE_8625_length_909_cov_25.212346	295	375	0	80	80	1.0000000
NODE_8625_length_909_cov_25.212346	348	428	0	80	80	1.0000000
NODE_8626_length_909_cov_23.604938	403	483	0	80	80	1.0000000
NODE_8626_length_909_cov_23.604938	456	536	0	80	80	1.0000000
NODE_8627_length_909_cov_19.070370	441	521	0	23	80	0.2875000
NODE_8627_length_909_cov_19.070370	441	521	2	57	80	0.7125000
NODE_8627_length_909_cov_19.070370	494	574	0	27	80	0.3375000
NODE_8627_length_909_cov_19.070370	494	574	2	53	80	0.6625000
NODE_8628_length_909_cov_11.533333	332	412	2	25	80	0.3125000
NODE_8628_length_909_cov_11.533333	332	412	4	55	80	0.6875000
NODE_8628_length_909_cov_11.533333	385	465	0	27	80	0.3375000
NODE_8628_length_909_cov_11.533333	385	465	2	25	80	0.3125000
NODE_8628_length_909_cov_11.533333	385	465	4	28	80	0.3500000
NODE_8629_length_909_cov_10.229630	497	577	0	80	80	1.0000000
NODE_8629_length_909_cov_10.229630	550	622	0	72	72	1.0000000
NODE_8631_length_909_cov_7.122222	328	408	0	42	80	0.5250000
NODE_8631_length_909_cov_7.122222	328	408	2	18	80	0.2250000
NODE_8631_length_909_cov_7.122222	328	408	3	20	80	0.2500000
NODE_8631_length_909_cov_7.122222	381	461	1	27	80	0.3375000
NODE_8631_length_909_cov_7.122222	381	461	2	7	80	0.0875000
NODE_8631_length_909_cov_7.122222	381	461	3	46	80	0.5750000
NODE_8632_length_909_cov_4.664198	775	855	2	26	80	0.3250000
NODE_8632_length_909_cov_4.664198	775	855	4	26	80	0.3250000
NODE_8632_length_909_cov_4.664198	775	855	6	28	80	0.3500000
NODE_8632_length_909_cov_4.664198	828	885	2	42	57	0.7368421
NODE_8632_length_909_cov_4.664198	828	885	4	15	57	0.2631579
NODE_8644_length_908_cov_55.546354	409	489	0	19	80	0.2375000
NODE_8644_length_908_cov_55.546354	409	489	4	61	80	0.7625000
NODE_8644_length_908_cov_55.546354	462	542	0	36	80	0.4500000
NODE_8644_length_908_cov_55.546354	462	542	4	44	80	0.5500000
NODE_8645_length_908_cov_18.720643	329	409	0	29	80	0.3625000
NODE_8645_length_908_cov_18.720643	329	409	4	7	80	0.0875000
NODE_8645_length_908_cov_18.720643	329	409	7	3	80	0.0375000
NODE_8645_length_908_cov_18.720643	329	409	9	26	80	0.3250000
NODE_8645_length_908_cov_18.720643	329	409	13	15	80	0.1875000
NODE_8645_length_908_cov_18.720643	382	462	5	6	80	0.0750000
NODE_8645_length_908_cov_18.720643	382	462	7	21	80	0.2625000
NODE_8645_length_908_cov_18.720643	382	462	9	12	80	0.1500000
NODE_8645_length_908_cov_18.720643	382	462	11	3	80	0.0375000
NODE_8645_length_908_cov_18.720643	382	462	13	38	80	0.4750000
NODE_8646_length_908_cov_14.640297	430	510	0	12	80	0.1500000
NODE_8646_length_908_cov_14.640297	430	510	2	56	80	0.7000000
NODE_8646_length_908_cov_14.640297	430	510	4	12	80	0.1500000
NODE_8646_length_908_cov_14.640297	483	562	2	32	79	0.4050633
NODE_8646_length_908_cov_14.640297	483	562	4	47	79	0.5949367
NODE_8648_length_908_cov_10.789864	370	450	4	9	80	0.1125000
NODE_8648_length_908_cov_10.789864	370	450	6	17	80	0.2125000
NODE_8648_length_908_cov_10.789864	370	450	10	3	80	0.0375000
NODE_8648_length_908_cov_10.789864	370	450	12	33	80	0.4125000
NODE_8648_length_908_cov_10.789864	370	450	14	18	80	0.2250000
NODE_8648_length_908_cov_10.789864	423	503	2	11	80	0.1375000
NODE_8648_length_908_cov_10.789864	423	503	6	6	80	0.0750000
NODE_8648_length_908_cov_10.789864	423	503	8	2	80	0.0250000
NODE_8648_length_908_cov_10.789864	423	503	10	9	80	0.1125000
NODE_8648_length_908_cov_10.789864	423	503	12	49	80	0.6125000
NODE_8648_length_908_cov_10.789864	423	503	14	3	80	0.0375000
NODE_8651_length_908_cov_3.737948	251	331	0	73	80	0.9125000
NODE_8651_length_908_cov_3.737948	251	331	2	7	80	0.0875000
NODE_8651_length_908_cov_3.737948	304	384	0	23	80	0.2875000
NODE_8651_length_908_cov_3.737948	304	384	2	57	80	0.7125000
NODE_8664_length_907_cov_22.110149	459	539	0	80	80	1.0000000
NODE_8664_length_907_cov_22.110149	512	592	0	80	80	1.0000000
NODE_8665_length_907_cov_20.943069	410	490	0	24	80	0.3000000
NODE_8665_length_907_cov_20.943069	410	490	2	56	80	0.7000000
NODE_8665_length_907_cov_20.943069	463	543	0	41	80	0.5125000
NODE_8665_length_907_cov_20.943069	463	543	2	39	80	0.4875000
NODE_8666_length_907_cov_19.519802	411	488	0	34	77	0.4415585
NODE_8666_length_907_cov_19.519802	411	488	2	38	77	0.4935065
NODE_8666_length_907_cov_19.519802	411	488	4	5	77	0.0649351
NODE_8666_length_907_cov_19.519802	461	541	0	80	80	1.0000000
NODE_8667_length_907_cov_17.928218	329	405	0	31	76	0.4078947
NODE_8667_length_907_cov_17.928218	329	405	2	45	76	0.5921053
NODE_8667_length_907_cov_17.928218	382	462	0	80	80	1.0000000
NODE_8668_length_907_cov_13.060644	293	373	0	80	80	1.0000000
NODE_8668_length_907_cov_13.060644	346	426	0	80	80	1.0000000
NODE_8669_length_907_cov_11.155941	401	462	0	61	61	1.0000000
NODE_8669_length_907_cov_11.155941	607	687	0	80	80	1.0000000
NODE_8670_length_907_cov_9.237624	247	327	0	80	80	1.0000000
NODE_8670_length_907_cov_9.237624	300	380	0	80	80	1.0000000
NODE_8671_length_907_cov_8.686881	275	365	0	8	90	0.0888889
NODE_8671_length_907_cov_8.686881	275	365	2	57	90	0.6333333
NODE_8671_length_907_cov_8.686881	275	365	8	25	90	0.2777778
NODE_8671_length_907_cov_8.686881	338	418	2	2	80	0.0250000
NODE_8671_length_907_cov_8.686881	338	418	6	32	80	0.4000000
NODE_8671_length_907_cov_8.686881	338	418	8	46	80	0.5750000
NODE_8680_length_907_cov_2.949257	503	526	0	23	23	1.0000000
NODE_8686_length_906_cov_32.369269	447	527	2	50	80	0.6250000
NODE_8686_length_906_cov_32.369269	447	527	3	30	80	0.3750000
NODE_8686_length_906_cov_32.369269	500	580	1	39	80	0.4875000
NODE_8686_length_906_cov_32.369269	500	580	2	8	80	0.1000000
NODE_8686_length_906_cov_32.369269	500	580	3	33	80	0.4125000
NODE_8687_length_906_cov_23.594796	196	276	0	14	80	0.1750000
NODE_8687_length_906_cov_23.594796	196	276	2	61	80	0.7625000
NODE_8687_length_906_cov_23.594796	196	276	4	5	80	0.0625000
NODE_8687_length_906_cov_23.594796	249	329	2	75	80	0.9375000
NODE_8687_length_906_cov_23.594796	249	329	4	5	80	0.0625000
NODE_8688_length_906_cov_21.443618	404	484	0	80	80	1.0000000
NODE_8688_length_906_cov_21.443618	457	537	0	80	80	1.0000000
NODE_8689_length_906_cov_20.596035	593	634	4	21	41	0.5121951
NODE_8689_length_906_cov_20.596035	593	634	6	4	41	0.0975610
NODE_8689_length_906_cov_20.596035	593	634	8	16	41	0.3902439
NODE_8690_length_906_cov_20.429988	410	490	0	80	80	1.0000000
NODE_8690_length_906_cov_20.429988	463	543	0	80	80	1.0000000
NODE_8691_length_906_cov_20.395291	523	603	0	80	80	1.0000000
NODE_8691_length_906_cov_20.395291	576	656	0	80	80	1.0000000
NODE_8692_length_906_cov_19.297398	255	335	0	80	80	1.0000000
NODE_8692_length_906_cov_19.297398	308	388	0	80	80	1.0000000
NODE_8693_length_906_cov_18.505576	357	437	0	80	80	1.0000000
NODE_8693_length_906_cov_18.505576	410	490	0	80	80	1.0000000
NODE_8694_length_906_cov_10.068154	191	271	0	68	80	0.8500000
NODE_8694_length_906_cov_10.068154	191	271	2	12	80	0.1500000
NODE_8694_length_906_cov_10.068154	244	324	0	15	80	0.1875000
NODE_8694_length_906_cov_10.068154	244	324	2	27	80	0.3375000
NODE_8694_length_906_cov_10.068154	244	324	4	38	80	0.4750000
NODE_8695_length_906_cov_10.006196	304	384	0	26	80	0.3250000
NODE_8695_length_906_cov_10.006196	304	384	2	54	80	0.6750000
NODE_8695_length_906_cov_10.006196	357	437	0	79	80	0.9875000
NODE_8695_length_906_cov_10.006196	357	437	2	1	80	0.0125000
NODE_8696_length_906_cov_8.562577	370	454	0	30	84	0.3571429
NODE_8696_length_906_cov_8.562577	370	454	2	13	84	0.1547619
NODE_8696_length_906_cov_8.562577	370	454	4	41	84	0.4880952
NODE_8696_length_906_cov_8.562577	423	507	2	1	84	0.0119048
NODE_8696_length_906_cov_8.562577	423	507	4	54	84	0.6428571
NODE_8696_length_906_cov_8.562577	423	507	6	29	84	0.3452381
NODE_8716_length_905_cov_39.203474	406	486	0	36	80	0.4500000
NODE_8716_length_905_cov_39.203474	406	486	2	5	80	0.0625000
NODE_8716_length_905_cov_39.203474	406	486	6	1	80	0.0125000
NODE_8716_length_905_cov_39.203474	406	486	9	1	80	0.0125000
NODE_8716_length_905_cov_39.203474	406	486	12	37	80	0.4625000
NODE_8716_length_905_cov_39.203474	459	539	2	4	80	0.0500000
NODE_8716_length_905_cov_39.203474	459	539	5	1	80	0.0125000
NODE_8716_length_905_cov_39.203474	459	539	6	2	80	0.0250000
NODE_8716_length_905_cov_39.203474	459	539	10	13	80	0.1625000
NODE_8716_length_905_cov_39.203474	459	539	12	60	80	0.7500000
NODE_8717_length_905_cov_37.053350	411	491	0	80	80	1.0000000
NODE_8717_length_905_cov_37.053350	464	544	0	80	80	1.0000000
NODE_8718_length_905_cov_27.426799	288	368	2	47	80	0.5875000
NODE_8718_length_905_cov_27.426799	288	368	4	2	80	0.0250000
NODE_8718_length_905_cov_27.426799	288	368	6	31	80	0.3875000
NODE_8718_length_905_cov_27.426799	341	421	4	24	80	0.3000000
NODE_8718_length_905_cov_27.426799	341	421	5	10	80	0.1250000
NODE_8718_length_905_cov_27.426799	341	421	6	46	80	0.5750000
NODE_8719_length_905_cov_26.332506	375	455	0	80	80	1.0000000
NODE_8719_length_905_cov_26.332506	428	508	0	80	80	1.0000000
NODE_8720_length_905_cov_20.651365	377	457	0	80	80	1.0000000
NODE_8720_length_905_cov_20.651365	430	510	0	80	80	1.0000000
NODE_8721_length_905_cov_19.718362	365	445	0	49	80	0.6125000
NODE_8721_length_905_cov_19.718362	365	445	2	31	80	0.3875000
NODE_8721_length_905_cov_19.718362	418	498	0	7	80	0.0875000
NODE_8721_length_905_cov_19.718362	418	498	2	73	80	0.9125000
NODE_8722_length_905_cov_13.696030	366	420	5	1	54	0.0185185
NODE_8722_length_905_cov_13.696030	366	420	6	53	54	0.9814815
NODE_8723_length_905_cov_9.978908	222	302	2	80	80	1.0000000
NODE_8723_length_905_cov_9.978908	275	355	0	53	80	0.6625000
NODE_8723_length_905_cov_9.978908	275	355	2	27	80	0.3375000
NODE_8725_length_905_cov_7.980149	321	401	0	21	80	0.2625000
NODE_8725_length_905_cov_7.980149	321	401	2	59	80	0.7375000
NODE_8725_length_905_cov_7.980149	374	454	2	68	80	0.8500000
NODE_8725_length_905_cov_7.980149	374	454	4	12	80	0.1500000
NODE_8727_length_905_cov_6.064516	459	539	0	80	80	1.0000000
NODE_8727_length_905_cov_6.064516	512	592	0	80	80	1.0000000
NODE_8742_length_905_cov_1.040943	73	119	3	2	46	0.0434783
NODE_8742_length_905_cov_1.040943	73	119	4	7	46	0.1521739
NODE_8742_length_905_cov_1.040943	73	119	6	37	46	0.8043478
NODE_8742_length_905_cov_1.040943	126	172	2	16	46	0.3478261
NODE_8742_length_905_cov_1.040943	126	172	4	6	46	0.1304348
NODE_8742_length_905_cov_1.040943	126	172	6	24	46	0.5217391
NODE_8743_length_904_cov_29.532919	338	418	0	60	80	0.7500000
NODE_8743_length_904_cov_29.532919	338	418	6	20	80	0.2500000
NODE_8743_length_904_cov_29.532919	391	471	0	7	80	0.0875000
NODE_8743_length_904_cov_29.532919	391	471	6	73	80	0.9125000
NODE_8743_length_904_cov_29.532919	467	547	0	57	80	0.7125000
NODE_8743_length_904_cov_29.532919	467	547	5	1	80	0.0125000
NODE_8743_length_904_cov_29.532919	467	547	6	22	80	0.2750000
NODE_8743_length_904_cov_29.532919	520	600	0	80	80	1.0000000
NODE_8744_length_904_cov_28.844720	371	451	2	10	80	0.1250000
NODE_8744_length_904_cov_28.844720	371	451	4	39	80	0.4875000
NODE_8744_length_904_cov_28.844720	371	451	5	21	80	0.2625000
NODE_8744_length_904_cov_28.844720	371	451	7	10	80	0.1250000
NODE_8744_length_904_cov_28.844720	424	504	5	27	80	0.3375000
NODE_8744_length_904_cov_28.844720	424	504	6	4	80	0.0500000
NODE_8744_length_904_cov_28.844720	424	504	7	25	80	0.3125000
NODE_8744_length_904_cov_28.844720	424	504	8	23	80	0.2875000
NODE_8744_length_904_cov_28.844720	424	504	9	1	80	0.0125000
NODE_8745_length_904_cov_26.977640	488	568	0	24	80	0.3000000
NODE_8745_length_904_cov_26.977640	488	568	2	7	80	0.0875000
NODE_8745_length_904_cov_26.977640	488	568	4	49	80	0.6125000
NODE_8745_length_904_cov_26.977640	541	621	0	77	80	0.9625000
NODE_8745_length_904_cov_26.977640	541	621	2	3	80	0.0375000
NODE_8746_length_904_cov_24.529193	464	544	0	1	80	0.0125000
NODE_8746_length_904_cov_24.529193	464	544	2	79	80	0.9875000
NODE_8746_length_904_cov_24.529193	517	597	0	38	80	0.4750000
NODE_8746_length_904_cov_24.529193	517	597	2	42	80	0.5250000
NODE_8747_length_904_cov_24.452174	507	587	0	80	80	1.0000000
NODE_8747_length_904_cov_24.452174	560	640	0	80	80	1.0000000
NODE_8748_length_904_cov_19.649689	307	387	0	42	80	0.5250000
NODE_8748_length_904_cov_19.649689	307	387	2	38	80	0.4750000
NODE_8748_length_904_cov_19.649689	360	440	0	80	80	1.0000000
NODE_8748_length_904_cov_19.649689	595	675	0	80	80	1.0000000
NODE_8748_length_904_cov_19.649689	648	728	0	80	80	1.0000000
NODE_8750_length_904_cov_16.608696	252	332	0	59	80	0.7375000
NODE_8750_length_904_cov_16.608696	252	332	6	21	80	0.2625000
NODE_8750_length_904_cov_16.608696	305	385	0	6	80	0.0750000
NODE_8750_length_904_cov_16.608696	305	385	6	47	80	0.5875000
NODE_8750_length_904_cov_16.608696	305	385	8	27	80	0.3375000
NODE_8750_length_904_cov_16.608696	381	461	6	18	80	0.2250000
NODE_8750_length_904_cov_16.608696	381	461	8	29	80	0.3625000
NODE_8750_length_904_cov_16.608696	381	461	10	15	80	0.1875000
NODE_8750_length_904_cov_16.608696	381	461	12	18	80	0.2250000
NODE_8750_length_904_cov_16.608696	434	514	2	8	80	0.1000000
NODE_8750_length_904_cov_16.608696	434	514	4	13	80	0.1625000
NODE_8750_length_904_cov_16.608696	434	514	6	50	80	0.6250000
NODE_8750_length_904_cov_16.608696	434	514	12	9	80	0.1125000
NODE_8751_length_904_cov_15.811180	431	511	0	51	80	0.6375000
NODE_8751_length_904_cov_15.811180	431	511	6	7	80	0.0875000
NODE_8751_length_904_cov_15.811180	431	511	8	18	80	0.2250000
NODE_8751_length_904_cov_15.811180	431	511	10	4	80	0.0500000
NODE_8751_length_904_cov_15.811180	484	564	4	4	80	0.0500000
NODE_8751_length_904_cov_15.811180	484	564	6	5	80	0.0625000
NODE_8751_length_904_cov_15.811180	484	564	8	32	80	0.4000000
NODE_8751_length_904_cov_15.811180	484	564	10	39	80	0.4875000
NODE_8752_length_904_cov_9.249689	581	661	0	80	80	1.0000000
NODE_8752_length_904_cov_9.249689	634	714	0	80	80	1.0000000
NODE_8756_length_904_cov_4.772671	318	398	0	80	80	1.0000000
NODE_8756_length_904_cov_4.772671	371	451	0	80	80	1.0000000
NODE_8773_length_903_cov_58.723881	386	466	0	1	80	0.0125000
NODE_8773_length_903_cov_58.723881	386	466	2	7	80	0.0875000
NODE_8773_length_903_cov_58.723881	386	466	6	9	80	0.1125000
NODE_8773_length_903_cov_58.723881	386	466	7	7	80	0.0875000
NODE_8773_length_903_cov_58.723881	386	466	11	4	80	0.0500000
NODE_8773_length_903_cov_58.723881	386	466	15	2	80	0.0250000
NODE_8773_length_903_cov_58.723881	386	466	16	1	80	0.0125000
NODE_8773_length_903_cov_58.723881	386	466	18	15	80	0.1875000
NODE_8773_length_903_cov_58.723881	386	466	20	34	80	0.4250000
NODE_8773_length_903_cov_58.723881	439	519	8	1	80	0.0125000
NODE_8773_length_903_cov_58.723881	439	519	10	5	80	0.0625000
NODE_8773_length_903_cov_58.723881	439	519	14	21	80	0.2625000
NODE_8773_length_903_cov_58.723881	439	519	16	8	80	0.1000000
NODE_8773_length_903_cov_58.723881	439	519	18	2	80	0.0250000
NODE_8773_length_903_cov_58.723881	439	519	20	43	80	0.5375000
NODE_8773_length_903_cov_58.723881	515	595	1	5	80	0.0625000
NODE_8773_length_903_cov_58.723881	515	595	2	59	80	0.7375000
NODE_8773_length_903_cov_58.723881	515	595	3	8	80	0.1000000
NODE_8773_length_903_cov_58.723881	515	595	4	3	80	0.0375000
NODE_8773_length_903_cov_58.723881	515	595	8	2	80	0.0250000
NODE_8773_length_903_cov_58.723881	515	595	10	3	80	0.0375000
NODE_8773_length_903_cov_58.723881	568	648	0	15	80	0.1875000
NODE_8773_length_903_cov_58.723881	568	648	2	65	80	0.8125000
NODE_8774_length_903_cov_41.298507	397	477	0	80	80	1.0000000
NODE_8774_length_903_cov_41.298507	450	530	0	80	80	1.0000000
NODE_8775_length_903_cov_28.691542	394	474	0	80	80	1.0000000
NODE_8775_length_903_cov_28.691542	447	527	0	80	80	1.0000000
NODE_8776_length_903_cov_26.276119	441	521	0	39	80	0.4875000
NODE_8776_length_903_cov_26.276119	441	521	2	2	80	0.0250000
NODE_8776_length_903_cov_26.276119	441	521	4	39	80	0.4875000
NODE_8776_length_903_cov_26.276119	494	574	0	80	80	1.0000000
NODE_8778_length_903_cov_18.166667	351	431	0	80	80	1.0000000
NODE_8778_length_903_cov_18.166667	404	484	0	46	80	0.5750000
NODE_8778_length_903_cov_18.166667	404	484	2	34	80	0.4250000
NODE_8779_length_903_cov_15.460199	440	520	0	80	80	1.0000000
NODE_8779_length_903_cov_15.460199	493	573	0	80	80	1.0000000
NODE_8780_length_903_cov_15.084577	352	432	0	80	80	1.0000000
NODE_8780_length_903_cov_15.084577	405	485	0	80	80	1.0000000
NODE_8781_length_903_cov_15.070896	367	447	6	57	80	0.7125000
NODE_8781_length_903_cov_15.070896	367	447	8	23	80	0.2875000
NODE_8781_length_903_cov_15.070896	420	500	0	12	80	0.1500000
NODE_8781_length_903_cov_15.070896	420	500	2	25	80	0.3125000
NODE_8781_length_903_cov_15.070896	420	500	6	43	80	0.5375000
NODE_8782_length_903_cov_14.004975	318	399	0	81	81	1.0000000
NODE_8782_length_903_cov_14.004975	372	452	0	80	80	1.0000000
NODE_8783_length_903_cov_10.546020	150	230	0	66	80	0.8250000
NODE_8783_length_903_cov_10.546020	150	230	2	14	80	0.1750000
NODE_8783_length_903_cov_10.546020	203	283	0	41	80	0.5125000
NODE_8783_length_903_cov_10.546020	203	283	2	33	80	0.4125000
NODE_8783_length_903_cov_10.546020	203	283	4	6	80	0.0750000
NODE_8784_length_903_cov_9.288557	373	453	0	80	80	1.0000000
NODE_8784_length_903_cov_9.288557	426	506	0	75	80	0.9375000
NODE_8784_length_903_cov_9.288557	426	506	2	5	80	0.0625000
NODE_8785_length_903_cov_8.052239	439	519	0	80	80	1.0000000
NODE_8785_length_903_cov_8.052239	492	572	0	80	80	1.0000000
NODE_8798_length_902_cov_64.459527	355	435	0	80	80	1.0000000
NODE_8798_length_902_cov_64.459527	408	488	0	80	80	1.0000000
NODE_8798_length_902_cov_64.459527	484	564	0	54	80	0.6750000
NODE_8798_length_902_cov_64.459527	484	564	2	26	80	0.3250000
NODE_8798_length_902_cov_64.459527	537	617	0	1	80	0.0125000
NODE_8798_length_902_cov_64.459527	537	617	2	79	80	0.9875000
NODE_8799_length_902_cov_60.823163	395	475	0	31	80	0.3875000
NODE_8799_length_902_cov_60.823163	395	475	2	49	80	0.6125000
NODE_8799_length_902_cov_60.823163	448	528	0	27	80	0.3375000
NODE_8799_length_902_cov_60.823163	448	528	2	53	80	0.6625000
NODE_8800_length_902_cov_44.002491	383	463	0	80	80	1.0000000
NODE_8800_length_902_cov_44.002491	436	516	0	80	80	1.0000000
NODE_8801_length_902_cov_41.059776	378	458	10	4	80	0.0500000
NODE_8801_length_902_cov_41.059776	378	458	14	3	80	0.0375000
NODE_8801_length_902_cov_41.059776	378	458	15	73	80	0.9125000
NODE_8801_length_902_cov_41.059776	431	511	0	42	80	0.5250000
NODE_8801_length_902_cov_41.059776	431	511	6	3	80	0.0375000
NODE_8801_length_902_cov_41.059776	431	511	10	1	80	0.0125000
NODE_8801_length_902_cov_41.059776	431	511	14	10	80	0.1250000
NODE_8801_length_902_cov_41.059776	431	511	15	24	80	0.3000000
NODE_8802_length_902_cov_38.952677	372	452	0	80	80	1.0000000
NODE_8802_length_902_cov_38.952677	425	505	0	80	80	1.0000000
NODE_8803_length_902_cov_34.156912	373	453	0	80	80	1.0000000
NODE_8803_length_902_cov_34.156912	426	506	0	80	80	1.0000000
NODE_8804_length_902_cov_23.007472	295	375	0	80	80	1.0000000
NODE_8804_length_902_cov_23.007472	348	428	0	80	80	1.0000000
NODE_8805_length_902_cov_19.491905	238	291	2	15	53	0.2830189
NODE_8805_length_902_cov_19.491905	238	291	4	25	53	0.4716981
NODE_8805_length_902_cov_19.491905	238	291	8	9	53	0.1698113
NODE_8805_length_902_cov_19.491905	238	291	10	4	53	0.0754717
NODE_8805_length_902_cov_19.491905	264	344	4	14	80	0.1750000
NODE_8805_length_902_cov_19.491905	264	344	6	13	80	0.1625000
NODE_8805_length_902_cov_19.491905	264	344	8	49	80	0.6125000
NODE_8805_length_902_cov_19.491905	264	344	10	4	80	0.0500000
NODE_8806_length_902_cov_10.794521	214	294	0	80	80	1.0000000
NODE_8806_length_902_cov_10.794521	267	347	0	78	80	0.9750000
NODE_8806_length_902_cov_10.794521	267	347	2	2	80	0.0250000
NODE_8807_length_902_cov_9.520548	518	598	0	80	80	1.0000000
NODE_8807_length_902_cov_9.520548	571	651	0	80	80	1.0000000
NODE_8808_length_902_cov_8.323786	337	417	0	68	80	0.8500000
NODE_8808_length_902_cov_8.323786	337	417	2	12	80	0.1500000
NODE_8808_length_902_cov_8.323786	390	470	0	18	80	0.2250000
NODE_8808_length_902_cov_8.323786	390	470	2	62	80	0.7750000
NODE_8811_length_902_cov_7.300125	434	514	0	80	80	1.0000000
NODE_8811_length_902_cov_7.300125	487	567	0	80	80	1.0000000
NODE_8812_length_902_cov_4.185554	505	585	0	41	80	0.5125000
NODE_8812_length_902_cov_4.185554	505	585	2	39	80	0.4875000
NODE_8812_length_902_cov_4.185554	558	588	0	1	30	0.0333333
NODE_8812_length_902_cov_4.185554	558	588	2	29	30	0.9666666
NODE_8812_length_902_cov_4.185554	610	662	0	5	52	0.0961538
NODE_8812_length_902_cov_4.185554	610	662	2	47	52	0.9038461
NODE_8830_length_902_cov_0.963885	82	106	0	24	24	1.0000000
NODE_8832_length_901_cov_36.066085	412	490	2	78	78	1.0000000
NODE_8832_length_901_cov_36.066085	463	543	0	52	80	0.6500000
NODE_8832_length_901_cov_36.066085	463	543	2	28	80	0.3500000
NODE_8833_length_901_cov_28.129676	377	457	0	14	80	0.1750000
NODE_8833_length_901_cov_28.129676	377	457	2	66	80	0.8250000
NODE_8833_length_901_cov_28.129676	430	510	0	67	80	0.8375000
NODE_8833_length_901_cov_28.129676	430	510	2	13	80	0.1625000
NODE_8834_length_901_cov_26.763092	272	352	0	68	80	0.8500000
NODE_8834_length_901_cov_26.763092	272	352	2	12	80	0.1500000
NODE_8834_length_901_cov_26.763092	325	405	0	15	80	0.1875000
NODE_8834_length_901_cov_26.763092	325	405	2	65	80	0.8125000
NODE_8834_length_901_cov_26.763092	401	481	0	40	80	0.5000000
NODE_8834_length_901_cov_26.763092	401	481	2	40	80	0.5000000
NODE_8834_length_901_cov_26.763092	454	534	0	80	80	1.0000000
NODE_8835_length_901_cov_25.628429	369	449	4	18	80	0.2250000
NODE_8835_length_901_cov_25.628429	369	449	6	47	80	0.5875000
NODE_8835_length_901_cov_25.628429	369	449	8	15	80	0.1875000
NODE_8835_length_901_cov_25.628429	422	502	0	18	80	0.2250000
NODE_8835_length_901_cov_25.628429	422	502	2	15	80	0.1875000
NODE_8835_length_901_cov_25.628429	422	502	4	26	80	0.3250000
NODE_8835_length_901_cov_25.628429	422	502	6	21	80	0.2625000
NODE_8836_length_901_cov_17.857855	408	488	0	80	80	1.0000000
NODE_8836_length_901_cov_17.857855	461	541	0	80	80	1.0000000
NODE_8837_length_901_cov_16.254364	362	442	2	80	80	1.0000000
NODE_8837_length_901_cov_16.254364	415	495	0	49	80	0.6125000
NODE_8837_length_901_cov_16.254364	415	495	2	31	80	0.3875000
NODE_8838_length_901_cov_8.346633	321	401	0	29	80	0.3625000
NODE_8838_length_901_cov_8.346633	321	401	2	51	80	0.6375000
NODE_8838_length_901_cov_8.346633	374	454	0	11	80	0.1375000
NODE_8838_length_901_cov_8.346633	374	454	2	69	80	0.8625000
NODE_8840_length_901_cov_6.044888	363	443	0	21	80	0.2625000
NODE_8840_length_901_cov_6.044888	363	443	2	59	80	0.7375000
NODE_8840_length_901_cov_6.044888	416	496	0	11	80	0.1375000
NODE_8840_length_901_cov_6.044888	416	496	2	69	80	0.8625000
NODE_8845_length_901_cov_3.814214	194	274	0	80	80	1.0000000
NODE_8845_length_901_cov_3.814214	247	326	0	79	79	1.0000000
NODE_8857_length_900_cov_30.284644	407	487	2	31	80	0.3875000
NODE_8857_length_900_cov_30.284644	407	487	4	49	80	0.6125000
NODE_8857_length_900_cov_30.284644	460	540	2	38	80	0.4750000
NODE_8857_length_900_cov_30.284644	460	540	4	42	80	0.5250000
NODE_8858_length_900_cov_29.679151	425	505	4	15	80	0.1875000
NODE_8858_length_900_cov_29.679151	425	505	8	65	80	0.8125000
NODE_8858_length_900_cov_29.679151	478	558	4	51	80	0.6375000
NODE_8858_length_900_cov_29.679151	478	558	8	29	80	0.3625000
NODE_8859_length_900_cov_25.963795	321	401	0	80	80	1.0000000
NODE_8859_length_900_cov_25.963795	374	454	0	80	80	1.0000000
NODE_8860_length_900_cov_17.681648	530	606	0	40	76	0.5263158
NODE_8860_length_900_cov_17.681648	530	606	2	36	76	0.4736842
NODE_8860_length_900_cov_17.681648	583	659	0	12	76	0.1578947
NODE_8860_length_900_cov_17.681648	583	659	2	59	76	0.7763158
NODE_8860_length_900_cov_17.681648	583	659	4	5	76	0.0657895
NODE_8861_length_900_cov_16.294632	316	396	0	80	80	1.0000000
NODE_8861_length_900_cov_16.294632	369	449	0	80	80	1.0000000
NODE_8863_length_900_cov_5.962547	0	70	2	4	70	0.0571429
NODE_8863_length_900_cov_5.962547	0	70	4	1	70	0.0142857
NODE_8863_length_900_cov_5.962547	0	70	8	6	70	0.0857143
NODE_8863_length_900_cov_5.962547	0	70	10	3	70	0.0428571
NODE_8863_length_900_cov_5.962547	0	70	12	29	70	0.4142857
NODE_8863_length_900_cov_5.962547	0	70	14	27	70	0.3857143
NODE_8863_length_900_cov_5.962547	43	108	6	3	65	0.0461538
NODE_8863_length_900_cov_5.962547	43	108	14	62	65	0.9538462
NODE_8870_length_900_cov_2.521848	85	165	0	80	80	1.0000000
NODE_8870_length_900_cov_2.521848	138	218	0	80	80	1.0000000
NODE_8879_length_899_cov_45.853750	380	460	0	18	80	0.2250000
NODE_8879_length_899_cov_45.853750	380	460	2	45	80	0.5625000
NODE_8879_length_899_cov_45.853750	380	460	3	3	80	0.0375000
NODE_8879_length_899_cov_45.853750	380	460	4	14	80	0.1750000
NODE_8879_length_899_cov_45.853750	433	516	2	41	83	0.4939759
NODE_8879_length_899_cov_45.853750	433	516	3	3	83	0.0361446
NODE_8879_length_899_cov_45.853750	433	516	4	39	83	0.4698795
NODE_8880_length_899_cov_37.758750	381	461	0	12	80	0.1500000
NODE_8880_length_899_cov_37.758750	381	461	2	68	80	0.8500000
NODE_8880_length_899_cov_37.758750	434	514	0	63	80	0.7875000
NODE_8880_length_899_cov_37.758750	434	514	2	17	80	0.2125000
NODE_8881_length_899_cov_27.362500	413	493	4	25	80	0.3125000
NODE_8881_length_899_cov_27.362500	413	493	6	55	80	0.6875000
NODE_8881_length_899_cov_27.362500	466	546	0	42	80	0.5250000
NODE_8881_length_899_cov_27.362500	466	546	4	36	80	0.4500000
NODE_8881_length_899_cov_27.362500	466	546	6	2	80	0.0250000
NODE_8882_length_899_cov_20.563750	379	459	0	80	80	1.0000000
NODE_8882_length_899_cov_20.563750	432	507	0	75	75	1.0000000
NODE_8884_length_899_cov_17.130000	319	399	0	8	80	0.1000000
NODE_8884_length_899_cov_17.130000	319	399	2	72	80	0.9000000
NODE_8884_length_899_cov_17.130000	372	452	0	61	80	0.7625000
NODE_8884_length_899_cov_17.130000	372	452	2	19	80	0.2375000
NODE_8885_length_899_cov_16.317500	270	350	0	9	80	0.1125000
NODE_8885_length_899_cov_16.317500	270	350	2	46	80	0.5750000
NODE_8885_length_899_cov_16.317500	270	350	4	25	80	0.3125000
NODE_8885_length_899_cov_16.317500	323	403	0	12	80	0.1500000
NODE_8885_length_899_cov_16.317500	323	403	2	6	80	0.0750000
NODE_8885_length_899_cov_16.317500	323	403	4	62	80	0.7750000
NODE_8886_length_899_cov_16.190000	284	364	2	22	80	0.2750000
NODE_8886_length_899_cov_16.190000	284	364	4	22	80	0.2750000
NODE_8886_length_899_cov_16.190000	284	364	6	36	80	0.4500000
NODE_8886_length_899_cov_16.190000	337	417	0	4	80	0.0500000
NODE_8886_length_899_cov_16.190000	337	417	2	14	80	0.1750000
NODE_8886_length_899_cov_16.190000	337	417	4	11	80	0.1375000
NODE_8886_length_899_cov_16.190000	337	417	6	51	80	0.6375000
NODE_8887_length_899_cov_13.873750	317	397	0	80	80	1.0000000
NODE_8887_length_899_cov_13.873750	370	450	0	80	80	1.0000000
NODE_8888_length_899_cov_12.957500	240	320	0	80	80	1.0000000
NODE_8888_length_899_cov_12.957500	293	373	0	80	80	1.0000000
NODE_8889_length_899_cov_12.516250	387	467	4	80	80	1.0000000
NODE_8889_length_899_cov_12.516250	440	520	0	47	80	0.5875000
NODE_8889_length_899_cov_12.516250	440	520	4	33	80	0.4125000
NODE_8890_length_899_cov_10.846250	348	428	0	80	80	1.0000000
NODE_8890_length_899_cov_10.846250	401	485	0	78	84	0.9285714
NODE_8890_length_899_cov_10.846250	401	485	2	6	84	0.0714286
NODE_8891_length_899_cov_9.185000	347	427	0	80	80	1.0000000
NODE_8891_length_899_cov_9.185000	400	480	0	80	80	1.0000000
NODE_8892_length_899_cov_8.655000	498	578	0	80	80	1.0000000
NODE_8892_length_899_cov_8.655000	551	631	0	80	80	1.0000000
NODE_8893_length_899_cov_3.551250	0	54	0	19	54	0.3518519
NODE_8893_length_899_cov_3.551250	0	54	2	35	54	0.6481481
NODE_8893_length_899_cov_3.551250	27	107	2	29	80	0.3625000
NODE_8893_length_899_cov_3.551250	27	107	6	8	80	0.1000000
NODE_8893_length_899_cov_3.551250	27	107	8	4	80	0.0500000
NODE_8893_length_899_cov_3.551250	27	107	10	14	80	0.1750000
NODE_8893_length_899_cov_3.551250	27	107	12	15	80	0.1875000
NODE_8893_length_899_cov_3.551250	27	107	14	10	80	0.1250000
NODE_8893_length_899_cov_3.551250	103	183	6	3	80	0.0375000
NODE_8893_length_899_cov_3.551250	103	183	8	1	80	0.0125000
NODE_8893_length_899_cov_3.551250	103	183	10	38	80	0.4750000
NODE_8893_length_899_cov_3.551250	103	183	12	5	80	0.0625000
NODE_8893_length_899_cov_3.551250	103	183	14	33	80	0.4125000
NODE_8893_length_899_cov_3.551250	156	179	10	23	23	1.0000000
NODE_8914_length_898_cov_52.405507	299	379	0	53	80	0.6625000
NODE_8914_length_898_cov_52.405507	299	379	2	27	80	0.3375000
NODE_8914_length_898_cov_52.405507	352	432	2	60	80	0.7500000
NODE_8914_length_898_cov_52.405507	352	432	4	20	80	0.2500000
NODE_8914_length_898_cov_52.405507	428	508	0	9	80	0.1125000
NODE_8914_length_898_cov_52.405507	428	508	2	71	80	0.8875000
NODE_8914_length_898_cov_52.405507	481	561	0	62	80	0.7750000
NODE_8914_length_898_cov_52.405507	481	561	2	18	80	0.2250000
NODE_8915_length_898_cov_44.973717	363	443	0	46	80	0.5750000
NODE_8915_length_898_cov_44.973717	363	443	6	4	80	0.0500000
NODE_8915_length_898_cov_44.973717	363	443	8	30	80	0.3750000
NODE_8915_length_898_cov_44.973717	416	496	0	4	80	0.0500000
NODE_8915_length_898_cov_44.973717	416	496	6	10	80	0.1250000
NODE_8915_length_898_cov_44.973717	416	496	8	66	80	0.8250000
NODE_8916_length_898_cov_38.269086	425	505	0	14	80	0.1750000
NODE_8916_length_898_cov_38.269086	425	505	1	4	80	0.0500000
NODE_8916_length_898_cov_38.269086	425	505	2	62	80	0.7750000
NODE_8916_length_898_cov_38.269086	478	558	2	80	80	1.0000000
NODE_8917_length_898_cov_27.006258	465	545	0	26	80	0.3250000
NODE_8917_length_898_cov_27.006258	465	545	4	25	80	0.3125000
NODE_8917_length_898_cov_27.006258	465	545	8	29	80	0.3625000
NODE_8917_length_898_cov_27.006258	518	598	4	11	80	0.1375000
NODE_8917_length_898_cov_27.006258	518	598	8	69	80	0.8625000
NODE_8918_length_898_cov_25.902378	185	265	0	22	80	0.2750000
NODE_8918_length_898_cov_25.902378	185	265	2	58	80	0.7250000
NODE_8918_length_898_cov_25.902378	238	318	0	75	80	0.9375000
NODE_8918_length_898_cov_25.902378	238	318	2	5	80	0.0625000
NODE_8918_length_898_cov_25.902378	314	394	0	80	80	1.0000000
NODE_8918_length_898_cov_25.902378	367	447	0	80	80	1.0000000
NODE_8919_length_898_cov_25.209011	368	448	0	80	80	1.0000000
NODE_8919_length_898_cov_25.209011	421	501	0	80	80	1.0000000
NODE_8920_length_898_cov_21.923655	325	405	0	80	80	1.0000000
NODE_8920_length_898_cov_21.923655	378	458	0	80	80	1.0000000
NODE_8921_length_898_cov_21.065081	306	386	0	80	80	1.0000000
NODE_8921_length_898_cov_21.065081	359	439	0	63	80	0.7875000
NODE_8921_length_898_cov_21.065081	359	439	2	17	80	0.2125000
NODE_8922_length_898_cov_20.954944	374	454	0	31	80	0.3875000
NODE_8922_length_898_cov_20.954944	374	454	2	49	80	0.6125000
NODE_8922_length_898_cov_20.954944	427	507	0	14	80	0.1750000
NODE_8922_length_898_cov_20.954944	427	507	2	66	80	0.8250000
NODE_8923_length_898_cov_17.387985	398	478	0	80	80	1.0000000
NODE_8923_length_898_cov_17.387985	451	531	0	80	80	1.0000000
NODE_8924_length_898_cov_17.252816	265	345	0	80	80	1.0000000
NODE_8924_length_898_cov_17.252816	318	398	0	80	80	1.0000000
NODE_8926_length_898_cov_13.152691	455	535	0	80	80	1.0000000
NODE_8926_length_898_cov_13.152691	508	588	0	80	80	1.0000000
NODE_8927_length_898_cov_12.612015	375	455	2	23	80	0.2875000
NODE_8927_length_898_cov_12.612015	375	455	4	57	80	0.7125000
NODE_8927_length_898_cov_12.612015	428	508	0	3	80	0.0375000
NODE_8927_length_898_cov_12.612015	428	508	2	17	80	0.2125000
NODE_8927_length_898_cov_12.612015	428	508	4	60	80	0.7500000
NODE_8928_length_898_cov_12.498123	428	508	0	5	80	0.0625000
NODE_8928_length_898_cov_12.498123	428	508	4	16	80	0.2000000
NODE_8928_length_898_cov_12.498123	428	508	6	59	80	0.7375000
NODE_8928_length_898_cov_12.498123	481	561	0	58	80	0.7250000
NODE_8928_length_898_cov_12.498123	481	561	6	22	80	0.2750000
NODE_8932_length_898_cov_1.790989	0	56	0	24	56	0.4285714
NODE_8932_length_898_cov_1.790989	0	56	2	32	56	0.5714286
NODE_8932_length_898_cov_1.790989	29	93	2	62	64	0.9687500
NODE_8932_length_898_cov_1.790989	29	93	6	2	64	0.0312500
NODE_8944_length_897_cov_63.921053	350	430	0	44	80	0.5500000
NODE_8944_length_897_cov_63.921053	350	430	2	36	80	0.4500000
NODE_8944_length_897_cov_63.921053	403	483	0	31	80	0.3875000
NODE_8944_length_897_cov_63.921053	403	483	2	49	80	0.6125000
NODE_8945_length_897_cov_58.921053	316	396	0	8	80	0.1000000
NODE_8945_length_897_cov_58.921053	316	396	2	62	80	0.7750000
NODE_8945_length_897_cov_58.921053	316	396	3	1	80	0.0125000
NODE_8945_length_897_cov_58.921053	316	396	5	9	80	0.1125000
NODE_8945_length_897_cov_58.921053	369	449	0	4	80	0.0500000
NODE_8945_length_897_cov_58.921053	369	449	2	13	80	0.1625000
NODE_8945_length_897_cov_58.921053	369	449	3	1	80	0.0125000
NODE_8945_length_897_cov_58.921053	369	449	4	6	80	0.0750000
NODE_8945_length_897_cov_58.921053	369	449	5	56	80	0.7000000
NODE_8946_length_897_cov_35.946115	324	404	0	80	80	1.0000000
NODE_8946_length_897_cov_35.946115	377	457	0	80	80	1.0000000
NODE_8947_length_897_cov_25.548872	238	318	0	1	80	0.0125000
NODE_8947_length_897_cov_25.548872	238	318	2	79	80	0.9875000
NODE_8947_length_897_cov_25.548872	291	371	0	54	80	0.6750000
NODE_8947_length_897_cov_25.548872	291	371	2	26	80	0.3250000
NODE_8948_length_897_cov_24.913534	399	479	4	80	80	1.0000000
NODE_8948_length_897_cov_24.913534	452	532	0	14	80	0.1750000
NODE_8948_length_897_cov_24.913534	452	532	4	66	80	0.8250000
NODE_8949_length_897_cov_21.839599	308	388	0	80	80	1.0000000
NODE_8949_length_897_cov_21.839599	361	441	0	80	80	1.0000000
NODE_8950_length_897_cov_19.355890	489	569	0	42	80	0.5250000
NODE_8950_length_897_cov_19.355890	489	569	2	38	80	0.4750000
NODE_8950_length_897_cov_19.355890	542	622	0	72	80	0.9000000
NODE_8950_length_897_cov_19.355890	542	622	2	8	80	0.1000000
NODE_8951_length_897_cov_16.295739	209	289	8	50	80	0.6250000
NODE_8951_length_897_cov_16.295739	209	289	10	30	80	0.3750000
NODE_8951_length_897_cov_16.295739	262	342	2	34	80	0.4250000
NODE_8951_length_897_cov_16.295739	262	342	4	5	80	0.0625000
NODE_8951_length_897_cov_16.295739	262	342	6	5	80	0.0625000
NODE_8951_length_897_cov_16.295739	262	342	8	36	80	0.4500000
NODE_8952_length_897_cov_14.766917	395	475	0	36	80	0.4500000
NODE_8952_length_897_cov_14.766917	395	475	2	44	80	0.5500000
NODE_8952_length_897_cov_14.766917	448	528	2	80	80	1.0000000
NODE_8953_length_897_cov_14.219298	253	333	0	80	80	1.0000000
NODE_8953_length_897_cov_14.219298	306	386	0	80	80	1.0000000
NODE_8954_length_897_cov_11.116541	182	262	0	44	80	0.5500000
NODE_8954_length_897_cov_11.116541	182	262	2	36	80	0.4500000
NODE_8954_length_897_cov_11.116541	235	315	0	8	80	0.1000000
NODE_8954_length_897_cov_11.116541	235	315	2	72	80	0.9000000
NODE_8955_length_897_cov_8.211779	303	383	0	80	80	1.0000000
NODE_8955_length_897_cov_8.211779	356	436	0	80	80	1.0000000
NODE_8973_length_896_cov_48.249686	397	477	0	62	80	0.7750000
NODE_8973_length_896_cov_48.249686	397	477	4	18	80	0.2250000
NODE_8973_length_896_cov_48.249686	450	530	0	9	80	0.1125000
NODE_8973_length_896_cov_48.249686	450	530	4	71	80	0.8875000
NODE_8974_length_896_cov_24.824341	213	293	0	80	80	1.0000000
NODE_8974_length_896_cov_24.824341	266	346	0	58	80	0.7250000
NODE_8974_length_896_cov_24.824341	266	346	2	22	80	0.2750000
NODE_8975_length_896_cov_23.130489	333	413	0	34	80	0.4250000
NODE_8975_length_896_cov_23.130489	333	413	2	46	80	0.5750000
NODE_8975_length_896_cov_23.130489	386	466	0	24	80	0.3000000
NODE_8975_length_896_cov_23.130489	386	466	2	56	80	0.7000000
NODE_8975_length_896_cov_23.130489	462	542	0	80	80	1.0000000
NODE_8975_length_896_cov_23.130489	515	595	0	80	80	1.0000000
NODE_8976_length_896_cov_20.673777	361	441	0	21	80	0.2625000
NODE_8976_length_896_cov_20.673777	361	441	2	4	80	0.0500000
NODE_8976_length_896_cov_20.673777	361	441	4	55	80	0.6875000
NODE_8976_length_896_cov_20.673777	414	497	0	30	83	0.3614458
NODE_8976_length_896_cov_20.673777	414	497	2	13	83	0.1566265
NODE_8976_length_896_cov_20.673777	414	497	4	40	83	0.4819277
NODE_8977_length_896_cov_18.979925	418	498	0	5	80	0.0625000
NODE_8977_length_896_cov_18.979925	418	498	2	75	80	0.9375000
NODE_8977_length_896_cov_18.979925	471	551	0	58	80	0.7250000
NODE_8977_length_896_cov_18.979925	471	551	2	22	80	0.2750000
NODE_8978_length_896_cov_15.875784	340	420	0	46	80	0.5750000
NODE_8978_length_896_cov_15.875784	340	420	2	34	80	0.4250000
NODE_8978_length_896_cov_15.875784	393	473	0	21	80	0.2625000
NODE_8978_length_896_cov_15.875784	393	473	2	59	80	0.7375000
NODE_8980_length_896_cov_10.646173	337	417	0	16	80	0.2000000
NODE_8980_length_896_cov_10.646173	337	417	4	64	80	0.8000000
NODE_8980_length_896_cov_10.646173	390	470	0	2	80	0.0250000
NODE_8980_length_896_cov_10.646173	390	470	4	78	80	0.9750000
NODE_8981_length_896_cov_10.351317	327	407	0	80	80	1.0000000
NODE_8981_length_896_cov_10.351317	380	460	0	38	80	0.4750000
NODE_8981_length_896_cov_10.351317	380	460	2	42	80	0.5250000
NODE_8982_length_896_cov_9.754078	411	491	0	80	80	1.0000000
NODE_8982_length_896_cov_9.754078	464	544	0	80	80	1.0000000
NODE_8983_length_896_cov_8.069009	340	422	0	14	82	0.1707317
NODE_8983_length_896_cov_8.069009	340	422	2	20	82	0.2439024
NODE_8983_length_896_cov_8.069009	340	422	4	48	82	0.5853658
NODE_8983_length_896_cov_8.069009	395	475	0	32	80	0.4000000
NODE_8983_length_896_cov_8.069009	395	475	2	16	80	0.2000000
NODE_8983_length_896_cov_8.069009	395	475	4	32	80	0.4000000
NODE_8986_length_896_cov_4.939774	384	464	0	80	80	1.0000000
NODE_8986_length_896_cov_4.939774	437	517	0	80	80	1.0000000
NODE_9005_length_895_cov_54.949749	378	458	0	37	80	0.4625000
NODE_9005_length_895_cov_54.949749	378	458	2	43	80	0.5375000
NODE_9005_length_895_cov_54.949749	431	511	0	31	80	0.3875000
NODE_9005_length_895_cov_54.949749	431	511	2	49	80	0.6125000
NODE_9006_length_895_cov_53.945980	306	386	0	58	80	0.7250000
NODE_9006_length_895_cov_53.945980	306	386	2	13	80	0.1625000
NODE_9006_length_895_cov_53.945980	306	386	10	9	80	0.1125000
NODE_9006_length_895_cov_53.945980	359	439	0	5	80	0.0625000
NODE_9006_length_895_cov_53.945980	359	439	2	13	80	0.1625000
NODE_9006_length_895_cov_53.945980	359	439	10	62	80	0.7750000
NODE_9007_length_895_cov_48.915829	369	449	0	53	80	0.6625000
NODE_9007_length_895_cov_48.915829	369	449	2	27	80	0.3375000
NODE_9007_length_895_cov_48.915829	422	502	2	80	80	1.0000000
NODE_9007_length_895_cov_48.915829	498	578	0	53	80	0.6625000
NODE_9007_length_895_cov_48.915829	498	578	2	26	80	0.3250000
NODE_9007_length_895_cov_48.915829	498	578	4	1	80	0.0125000
NODE_9007_length_895_cov_48.915829	551	631	0	18	80	0.2250000
NODE_9007_length_895_cov_48.915829	551	631	2	8	80	0.1000000
NODE_9007_length_895_cov_48.915829	551	631	4	40	80	0.5000000
NODE_9007_length_895_cov_48.915829	551	631	6	14	80	0.1750000
NODE_9008_length_895_cov_38.347990	452	532	0	53	80	0.6625000
NODE_9008_length_895_cov_38.347990	452	532	2	9	80	0.1125000
NODE_9008_length_895_cov_38.347990	452	532	6	18	80	0.2250000
NODE_9008_length_895_cov_38.347990	505	585	2	9	80	0.1125000
NODE_9008_length_895_cov_38.347990	505	585	4	5	80	0.0625000
NODE_9008_length_895_cov_38.347990	505	585	6	66	80	0.8250000
NODE_9009_length_895_cov_33.716080	418	499	0	3	81	0.0370370
NODE_9009_length_895_cov_33.716080	418	499	2	18	81	0.2222222
NODE_9009_length_895_cov_33.716080	418	499	3	8	81	0.0987654
NODE_9009_length_895_cov_33.716080	418	499	4	20	81	0.2469136
NODE_9009_length_895_cov_33.716080	418	499	5	32	81	0.3950617
NODE_9009_length_895_cov_33.716080	472	552	0	39	80	0.4875000
NODE_9009_length_895_cov_33.716080	472	552	5	41	80	0.5125000
NODE_9010_length_895_cov_21.630653	392	468	0	76	76	1.0000000
NODE_9010_length_895_cov_21.630653	441	521	0	80	80	1.0000000
NODE_9011_length_895_cov_19.932161	331	411	2	51	80	0.6375000
NODE_9011_length_895_cov_19.932161	331	411	4	8	80	0.1000000
NODE_9011_length_895_cov_19.932161	331	411	5	21	80	0.2625000
NODE_9011_length_895_cov_19.932161	384	464	0	22	80	0.2750000
NODE_9011_length_895_cov_19.932161	384	464	2	58	80	0.7250000
NODE_9011_length_895_cov_19.932161	460	540	0	19	80	0.2375000
NODE_9011_length_895_cov_19.932161	460	540	2	31	80	0.3875000
NODE_9011_length_895_cov_19.932161	460	540	4	24	80	0.3000000
NODE_9011_length_895_cov_19.932161	460	540	6	6	80	0.0750000
NODE_9011_length_895_cov_19.932161	513	593	4	27	80	0.3375000
NODE_9011_length_895_cov_19.932161	513	593	6	53	80	0.6625000
NODE_9012_length_895_cov_16.037688	403	479	0	16	76	0.2105263
NODE_9012_length_895_cov_16.037688	403	479	2	25	76	0.3289474
NODE_9012_length_895_cov_16.037688	403	479	4	35	76	0.4605263
NODE_9012_length_895_cov_16.037688	452	532	2	16	80	0.2000000
NODE_9012_length_895_cov_16.037688	452	532	4	64	80	0.8000000
NODE_9013_length_895_cov_13.003769	372	452	0	3	80	0.0375000
NODE_9013_length_895_cov_13.003769	372	452	2	77	80	0.9625000
NODE_9013_length_895_cov_13.003769	425	491	0	10	66	0.1515152
NODE_9013_length_895_cov_13.003769	425	491	2	56	66	0.8484849
NODE_9014_length_895_cov_12.736181	280	360	0	10	80	0.1250000
NODE_9014_length_895_cov_12.736181	280	360	2	70	80	0.8750000
NODE_9014_length_895_cov_12.736181	333	413	0	26	80	0.3250000
NODE_9014_length_895_cov_12.736181	333	413	2	54	80	0.6750000
NODE_9015_length_895_cov_11.090452	505	585	0	80	80	1.0000000
NODE_9015_length_895_cov_11.090452	558	638	0	80	80	1.0000000
NODE_9016_length_895_cov_9.266332	468	548	0	80	80	1.0000000
NODE_9016_length_895_cov_9.266332	521	601	0	80	80	1.0000000
NODE_9018_length_895_cov_5.659548	472	552	0	80	80	1.0000000
NODE_9018_length_895_cov_5.659548	525	605	0	80	80	1.0000000
NODE_9019_length_895_cov_5.383166	42	123	0	4	81	0.0493827
NODE_9019_length_895_cov_5.383166	42	123	2	77	81	0.9506173
NODE_9030_length_894_cov_60.153459	446	526	0	80	80	1.0000000
NODE_9030_length_894_cov_60.153459	499	579	0	80	80	1.0000000
NODE_9031_length_894_cov_49.618868	373	453	2	64	80	0.8000000
NODE_9031_length_894_cov_49.618868	373	453	4	16	80	0.2000000
NODE_9031_length_894_cov_49.618868	426	506	0	13	80	0.1625000
NODE_9031_length_894_cov_49.618868	426	506	2	67	80	0.8375000
NODE_9032_length_894_cov_33.228931	459	539	0	80	80	1.0000000
NODE_9032_length_894_cov_33.228931	512	592	0	80	80	1.0000000
NODE_9033_length_894_cov_31.933333	411	491	0	70	80	0.8750000
NODE_9033_length_894_cov_31.933333	411	491	4	10	80	0.1250000
NODE_9033_length_894_cov_31.933333	464	544	0	17	80	0.2125000
NODE_9033_length_894_cov_31.933333	464	544	4	62	80	0.7750000
NODE_9033_length_894_cov_31.933333	464	544	8	1	80	0.0125000
NODE_9034_length_894_cov_30.499371	270	350	0	70	80	0.8750000
NODE_9034_length_894_cov_30.499371	270	350	2	10	80	0.1250000
NODE_9034_length_894_cov_30.499371	323	403	0	17	80	0.2125000
NODE_9034_length_894_cov_30.499371	323	403	2	63	80	0.7875000
NODE_9034_length_894_cov_30.499371	399	479	2	41	80	0.5125000
NODE_9034_length_894_cov_30.499371	399	479	4	38	80	0.4750000
NODE_9034_length_894_cov_30.499371	399	479	6	1	80	0.0125000
NODE_9034_length_894_cov_30.499371	452	532	2	3	80	0.0375000
NODE_9034_length_894_cov_30.499371	452	532	4	46	80	0.5750000
NODE_9034_length_894_cov_30.499371	452	532	6	31	80	0.3875000
NODE_9035_length_894_cov_23.046541	79	159	0	80	80	1.0000000
NODE_9035_length_894_cov_23.046541	132	212	0	80	80	1.0000000
NODE_9036_length_894_cov_22.266667	381	461	0	80	80	1.0000000
NODE_9036_length_894_cov_22.266667	434	514	0	57	80	0.7125000
NODE_9036_length_894_cov_22.266667	434	514	2	23	80	0.2875000
NODE_9037_length_894_cov_21.997484	332	412	0	13	80	0.1625000
NODE_9037_length_894_cov_21.997484	332	412	2	67	80	0.8375000
NODE_9037_length_894_cov_21.997484	385	465	2	80	80	1.0000000
NODE_9038_length_894_cov_21.205031	319	399	2	50	80	0.6250000
NODE_9038_length_894_cov_21.205031	319	399	3	9	80	0.1125000
NODE_9038_length_894_cov_21.205031	319	399	4	21	80	0.2625000
NODE_9038_length_894_cov_21.205031	372	452	2	29	80	0.3625000
NODE_9038_length_894_cov_21.205031	372	452	3	33	80	0.4125000
NODE_9038_length_894_cov_21.205031	372	452	4	18	80	0.2250000
NODE_9038_length_894_cov_21.205031	448	528	0	56	80	0.7000000
NODE_9038_length_894_cov_21.205031	448	528	2	24	80	0.3000000
NODE_9038_length_894_cov_21.205031	501	581	0	80	80	1.0000000
NODE_9039_length_894_cov_21.132075	422	502	0	80	80	1.0000000
NODE_9039_length_894_cov_21.132075	475	555	0	80	80	1.0000000
NODE_9040_length_894_cov_15.598742	338	418	0	80	80	1.0000000
NODE_9040_length_894_cov_15.598742	391	471	0	80	80	1.0000000
NODE_9041_length_894_cov_14.079245	344	424	0	37	80	0.4625000
NODE_9041_length_894_cov_14.079245	344	424	2	43	80	0.5375000
NODE_9041_length_894_cov_14.079245	397	477	2	80	80	1.0000000
NODE_9042_length_894_cov_13.031447	336	416	0	80	80	1.0000000
NODE_9042_length_894_cov_13.031447	389	469	0	80	80	1.0000000
NODE_9043_length_894_cov_13.031447	353	433	0	26	80	0.3250000
NODE_9043_length_894_cov_13.031447	353	433	2	54	80	0.6750000
NODE_9043_length_894_cov_13.031447	406	486	0	17	80	0.2125000
NODE_9043_length_894_cov_13.031447	406	486	2	63	80	0.7875000
NODE_9044_length_894_cov_9.706918	330	410	0	80	80	1.0000000
NODE_9045_length_894_cov_6.963522	378	458	0	53	80	0.6625000
NODE_9045_length_894_cov_6.963522	378	458	2	27	80	0.3375000
NODE_9045_length_894_cov_6.963522	431	511	2	37	80	0.4625000
NODE_9045_length_894_cov_6.963522	431	511	4	43	80	0.5375000
NODE_9046_length_894_cov_4.993711	365	445	0	80	80	1.0000000
NODE_9046_length_894_cov_4.993711	418	498	0	80	80	1.0000000
NODE_9066_length_893_cov_59.134761	261	341	12	7	80	0.0875000
NODE_9066_length_893_cov_59.134761	261	341	14	4	80	0.0500000
NODE_9066_length_893_cov_59.134761	261	341	20	8	80	0.1000000
NODE_9066_length_893_cov_59.134761	261	341	24	5	80	0.0625000
NODE_9066_length_893_cov_59.134761	261	341	28	1	80	0.0125000
NODE_9066_length_893_cov_59.134761	261	341	30	4	80	0.0500000
NODE_9066_length_893_cov_59.134761	261	341	31	43	80	0.5375000
NODE_9066_length_893_cov_59.134761	261	341	32	8	80	0.1000000
NODE_9066_length_893_cov_59.134761	314	394	8	4	80	0.0500000
NODE_9066_length_893_cov_59.134761	314	394	12	28	80	0.3500000
NODE_9066_length_893_cov_59.134761	314	394	18	5	80	0.0625000
NODE_9066_length_893_cov_59.134761	314	394	20	5	80	0.0625000
NODE_9066_length_893_cov_59.134761	314	394	28	4	80	0.0500000
NODE_9066_length_893_cov_59.134761	314	394	31	34	80	0.4250000
NODE_9067_length_893_cov_58.991184	388	468	0	27	80	0.3375000
NODE_9067_length_893_cov_58.991184	388	468	2	53	80	0.6625000
NODE_9067_length_893_cov_58.991184	441	521	0	23	80	0.2875000
NODE_9067_length_893_cov_58.991184	441	521	2	57	80	0.7125000
NODE_9067_length_893_cov_58.991184	517	597	2	10	80	0.1250000
NODE_9067_length_893_cov_58.991184	517	597	4	3	80	0.0375000
NODE_9067_length_893_cov_58.991184	517	597	6	21	80	0.2625000
NODE_9067_length_893_cov_58.991184	517	597	8	46	80	0.5750000
NODE_9067_length_893_cov_58.991184	570	650	0	31	80	0.3875000
NODE_9067_length_893_cov_58.991184	570	650	8	49	80	0.6125000
NODE_9068_length_893_cov_55.644836	434	514	0	80	80	1.0000000
NODE_9068_length_893_cov_55.644836	487	567	0	55	80	0.6875000
NODE_9068_length_893_cov_55.644836	487	567	2	25	80	0.3125000
NODE_9068_length_893_cov_55.644836	563	643	2	12	80	0.1500000
NODE_9068_length_893_cov_55.644836	563	643	3	5	80	0.0625000
NODE_9068_length_893_cov_55.644836	563	643	5	21	80	0.2625000
NODE_9068_length_893_cov_55.644836	563	643	7	19	80	0.2375000
NODE_9068_length_893_cov_55.644836	563	643	8	23	80	0.2875000
NODE_9068_length_893_cov_55.644836	616	696	2	13	80	0.1625000
NODE_9068_length_893_cov_55.644836	616	696	4	15	80	0.1875000
NODE_9068_length_893_cov_55.644836	616	696	6	6	80	0.0750000
NODE_9068_length_893_cov_55.644836	616	696	7	4	80	0.0500000
NODE_9068_length_893_cov_55.644836	616	696	8	37	80	0.4625000
NODE_9068_length_893_cov_55.644836	616	696	10	5	80	0.0625000
NODE_9069_length_893_cov_54.803526	479	559	2	9	80	0.1125000
NODE_9069_length_893_cov_54.803526	479	559	6	71	80	0.8875000
NODE_9069_length_893_cov_54.803526	532	612	0	38	80	0.4750000
NODE_9069_length_893_cov_54.803526	532	612	2	14	80	0.1750000
NODE_9069_length_893_cov_54.803526	532	612	6	28	80	0.3500000
NODE_9070_length_893_cov_38.147355	391	471	0	80	80	1.0000000
NODE_9070_length_893_cov_38.147355	444	524	0	80	80	1.0000000
NODE_9071_length_893_cov_33.690176	387	467	0	80	80	1.0000000
NODE_9071_length_893_cov_33.690176	440	520	0	71	80	0.8875000
NODE_9071_length_893_cov_33.690176	440	520	2	9	80	0.1125000
NODE_9072_length_893_cov_32.162469	524	604	0	37	80	0.4625000
NODE_9072_length_893_cov_32.162469	524	604	2	43	80	0.5375000
NODE_9072_length_893_cov_32.162469	577	657	2	80	80	1.0000000
NODE_9073_length_893_cov_31.916877	344	424	0	80	80	1.0000000
NODE_9073_length_893_cov_31.916877	397	477	0	80	80	1.0000000
NODE_9074_length_893_cov_28.693955	437	517	0	74	80	0.9250000
NODE_9074_length_893_cov_28.693955	437	517	2	6	80	0.0750000
NODE_9074_length_893_cov_28.693955	490	570	0	21	80	0.2625000
NODE_9074_length_893_cov_28.693955	490	570	2	59	80	0.7375000
NODE_9075_length_893_cov_23.564232	363	443	2	11	80	0.1375000
NODE_9075_length_893_cov_23.564232	363	443	4	69	80	0.8625000
NODE_9075_length_893_cov_23.564232	416	496	0	27	80	0.3375000
NODE_9075_length_893_cov_23.564232	416	496	2	35	80	0.4375000
NODE_9075_length_893_cov_23.564232	416	496	4	18	80	0.2250000
NODE_9076_length_893_cov_22.633501	272	352	0	47	80	0.5875000
NODE_9076_length_893_cov_22.633501	272	352	2	20	80	0.2500000
NODE_9076_length_893_cov_22.633501	272	352	6	13	80	0.1625000
NODE_9076_length_893_cov_22.633501	272	352	0	47	80	0.5875000
NODE_9076_length_893_cov_22.633501	272	352	2	20	80	0.2500000
NODE_9076_length_893_cov_22.633501	272	352	6	13	80	0.1625000
NODE_9076_length_893_cov_22.633501	272	352	0	47	80	0.5875000
NODE_9076_length_893_cov_22.633501	272	352	2	20	80	0.2500000
NODE_9076_length_893_cov_22.633501	272	352	6	13	80	0.1625000
NODE_9076_length_893_cov_22.633501	325	405	0	3	80	0.0375000
NODE_9076_length_893_cov_22.633501	325	405	2	11	80	0.1375000
NODE_9076_length_893_cov_22.633501	325	405	4	21	80	0.2625000
NODE_9076_length_893_cov_22.633501	325	405	6	45	80	0.5625000
NODE_9076_length_893_cov_22.633501	325	405	0	3	80	0.0375000
NODE_9076_length_893_cov_22.633501	325	405	2	11	80	0.1375000
NODE_9076_length_893_cov_22.633501	325	405	4	21	80	0.2625000
NODE_9076_length_893_cov_22.633501	325	405	6	45	80	0.5625000
NODE_9076_length_893_cov_22.633501	325	405	0	3	80	0.0375000
NODE_9076_length_893_cov_22.633501	325	405	2	11	80	0.1375000
NODE_9076_length_893_cov_22.633501	325	405	4	21	80	0.2625000
NODE_9076_length_893_cov_22.633501	325	405	6	45	80	0.5625000
NODE_9076_length_893_cov_22.633501	401	481	0	28	80	0.3500000
NODE_9076_length_893_cov_22.633501	401	481	2	36	80	0.4500000
NODE_9076_length_893_cov_22.633501	401	481	4	16	80	0.2000000
NODE_9076_length_893_cov_22.633501	454	534	2	80	80	1.0000000
NODE_9077_length_893_cov_22.403023	453	533	4	11	80	0.1375000
NODE_9077_length_893_cov_22.403023	453	533	8	10	80	0.1250000
NODE_9077_length_893_cov_22.403023	453	533	10	7	80	0.0875000
NODE_9077_length_893_cov_22.403023	453	533	12	52	80	0.6500000
NODE_9077_length_893_cov_22.403023	506	586	4	2	80	0.0250000
NODE_9077_length_893_cov_22.403023	506	586	6	26	80	0.3250000
NODE_9077_length_893_cov_22.403023	506	586	8	10	80	0.1250000
NODE_9077_length_893_cov_22.403023	506	586	12	42	80	0.5250000
NODE_9078_length_893_cov_19.423174	298	378	0	80	80	1.0000000
NODE_9078_length_893_cov_19.423174	351	431	0	80	80	1.0000000
NODE_9078_length_893_cov_19.423174	427	507	0	80	80	1.0000000
NODE_9078_length_893_cov_19.423174	480	560	0	80	80	1.0000000
NODE_9079_length_893_cov_19.389169	360	440	0	80	80	1.0000000
NODE_9079_length_893_cov_19.389169	413	493	0	80	80	1.0000000
NODE_9079_length_893_cov_19.389169	489	569	0	40	80	0.5000000
NODE_9079_length_893_cov_19.389169	489	569	2	40	80	0.5000000
NODE_9079_length_893_cov_19.389169	542	622	2	80	80	1.0000000
NODE_9080_length_893_cov_18.152393	394	474	0	80	80	1.0000000
NODE_9080_length_893_cov_18.152393	447	527	0	80	80	1.0000000
NODE_9081_length_893_cov_15.960957	442	522	0	80	80	1.0000000
NODE_9081_length_893_cov_15.960957	495	575	0	80	80	1.0000000
NODE_9082_length_893_cov_13.119647	473	553	0	80	80	1.0000000
NODE_9082_length_893_cov_13.119647	526	606	0	80	80	1.0000000
NODE_9084_length_893_cov_5.549118	353	415	0	48	62	0.7741935
NODE_9084_length_893_cov_5.549118	353	415	2	14	62	0.2258064
NODE_9100_length_893_cov_1.141058	28	108	2	9	80	0.1125000
NODE_9100_length_893_cov_1.141058	28	108	4	8	80	0.1000000
NODE_9100_length_893_cov_1.141058	28	108	6	63	80	0.7875000
NODE_9104_length_892_cov_74.968474	333	413	2	29	80	0.3625000
NODE_9104_length_892_cov_74.968474	333	413	4	24	80	0.3000000
NODE_9104_length_892_cov_74.968474	333	413	6	27	80	0.3375000
NODE_9104_length_892_cov_74.968474	386	466	0	38	80	0.4750000
NODE_9104_length_892_cov_74.968474	386	466	2	42	80	0.5250000
NODE_9104_length_892_cov_74.968474	462	542	0	80	80	1.0000000
NODE_9104_length_892_cov_74.968474	515	595	0	80	80	1.0000000
NODE_9105_length_892_cov_54.549811	463	550	0	87	87	1.0000000
NODE_9105_length_892_cov_54.549811	523	603	0	80	80	1.0000000
NODE_9105_length_892_cov_54.549811	599	679	0	80	80	1.0000000
NODE_9106_length_892_cov_37.887768	373	453	0	26	80	0.3250000
NODE_9106_length_892_cov_37.887768	373	453	2	54	80	0.6750000
NODE_9106_length_892_cov_37.887768	426	506	0	24	80	0.3000000
NODE_9106_length_892_cov_37.887768	426	506	2	56	80	0.7000000
NODE_9107_length_892_cov_19.732661	361	441	2	30	80	0.3750000
NODE_9107_length_892_cov_19.732661	361	441	4	50	80	0.6250000
NODE_9107_length_892_cov_19.732661	414	494	0	53	80	0.6625000
NODE_9107_length_892_cov_19.732661	414	494	2	27	80	0.3375000
NODE_9108_length_892_cov_19.052963	290	370	0	80	80	1.0000000
NODE_9108_length_892_cov_19.052963	343	423	0	80	80	1.0000000
NODE_9108_length_892_cov_19.052963	419	499	0	47	80	0.5875000
NODE_9108_length_892_cov_19.052963	419	499	2	33	80	0.4125000
NODE_9108_length_892_cov_19.052963	472	552	2	31	80	0.3875000
NODE_9108_length_892_cov_19.052963	472	552	6	49	80	0.6125000
NODE_9109_length_892_cov_17.276166	341	421	0	61	80	0.7625000
NODE_9109_length_892_cov_17.276166	341	421	1	19	80	0.2375000
NODE_9109_length_892_cov_17.276166	394	474	0	8	80	0.1000000
NODE_9109_length_892_cov_17.276166	394	474	1	72	80	0.9000000
NODE_9110_length_892_cov_16.312736	411	491	0	61	80	0.7625000
NODE_9110_length_892_cov_16.312736	411	491	2	19	80	0.2375000
NODE_9110_length_892_cov_16.312736	464	544	0	80	80	1.0000000
NODE_9111_length_892_cov_15.808323	395	475	0	19	80	0.2375000
NODE_9111_length_892_cov_15.808323	395	475	2	61	80	0.7625000
NODE_9111_length_892_cov_15.808323	448	528	0	17	80	0.2125000
NODE_9111_length_892_cov_15.808323	448	528	2	63	80	0.7875000
NODE_9112_length_892_cov_14.020177	522	602	0	80	80	1.0000000
NODE_9112_length_892_cov_14.020177	575	655	0	80	80	1.0000000
NODE_9114_length_892_cov_8.798235	400	480	1	55	80	0.6875000
NODE_9114_length_892_cov_8.798235	400	480	2	25	80	0.3125000
NODE_9114_length_892_cov_8.798235	453	533	1	80	80	1.0000000
NODE_9115_length_892_cov_8.413619	428	508	3	4	80	0.0500000
NODE_9115_length_892_cov_8.413619	428	508	4	5	80	0.0625000
NODE_9115_length_892_cov_8.413619	428	508	5	23	80	0.2875000
NODE_9115_length_892_cov_8.413619	428	508	6	48	80	0.6000000
NODE_9115_length_892_cov_8.413619	481	561	4	37	80	0.4625000
NODE_9115_length_892_cov_8.413619	481	561	5	13	80	0.1625000
NODE_9115_length_892_cov_8.413619	481	561	6	30	80	0.3750000
NODE_9116_length_892_cov_6.694830	374	454	0	80	80	1.0000000
NODE_9116_length_892_cov_6.694830	427	507	0	47	80	0.5875000
NODE_9116_length_892_cov_6.694830	427	507	2	33	80	0.4125000
NODE_9134_length_891_cov_30.166667	295	375	0	21	80	0.2625000
NODE_9134_length_891_cov_30.166667	295	375	2	57	80	0.7125000
NODE_9134_length_891_cov_30.166667	295	375	4	2	80	0.0250000
NODE_9134_length_891_cov_30.166667	348	428	2	25	80	0.3125000
NODE_9134_length_891_cov_30.166667	348	428	4	40	80	0.5000000
NODE_9134_length_891_cov_30.166667	348	428	6	15	80	0.1875000
NODE_9135_length_891_cov_26.333333	319	399	0	80	80	1.0000000
NODE_9135_length_891_cov_26.333333	372	452	0	80	80	1.0000000
NODE_9136_length_891_cov_22.228535	336	416	0	80	80	1.0000000
NODE_9136_length_891_cov_22.228535	389	469	0	80	80	1.0000000
NODE_9137_length_891_cov_20.446970	377	457	0	56	80	0.7000000
NODE_9137_length_891_cov_20.446970	377	457	3	1	80	0.0125000
NODE_9137_length_891_cov_20.446970	377	457	4	23	80	0.2875000
NODE_9137_length_891_cov_20.446970	430	510	0	3	80	0.0375000
NODE_9137_length_891_cov_20.446970	430	510	3	1	80	0.0125000
NODE_9137_length_891_cov_20.446970	430	510	4	76	80	0.9500000
NODE_9138_length_891_cov_20.226010	310	390	0	80	80	1.0000000
NODE_9138_length_891_cov_20.226010	363	443	0	80	80	1.0000000
NODE_9140_length_891_cov_13.207071	392	472	2	3	80	0.0375000
NODE_9140_length_891_cov_13.207071	392	472	4	19	80	0.2375000
NODE_9140_length_891_cov_13.207071	392	472	6	58	80	0.7250000
NODE_9140_length_891_cov_13.207071	445	525	0	36	80	0.4500000
NODE_9140_length_891_cov_13.207071	445	525	2	8	80	0.1000000
NODE_9140_length_891_cov_13.207071	445	525	4	7	80	0.0875000
NODE_9140_length_891_cov_13.207071	445	525	6	29	80	0.3625000
NODE_9141_length_891_cov_11.579545	379	459	0	3	80	0.0375000
NODE_9141_length_891_cov_11.579545	379	459	2	77	80	0.9625000
NODE_9141_length_891_cov_11.579545	432	512	0	30	80	0.3750000
NODE_9141_length_891_cov_11.579545	432	512	2	50	80	0.6250000
NODE_9142_length_891_cov_11.117424	499	579	0	80	80	1.0000000
NODE_9142_length_891_cov_11.117424	552	632	0	80	80	1.0000000
NODE_9153_length_890_cov_29.070796	284	364	0	80	80	1.0000000
NODE_9153_length_890_cov_29.070796	337	417	0	80	80	1.0000000
NODE_9153_length_890_cov_29.070796	413	497	0	84	84	1.0000000
NODE_9153_length_890_cov_29.070796	470	550	0	80	80	1.0000000
NODE_9154_length_890_cov_27.295828	550	630	0	38	80	0.4750000
NODE_9154_length_890_cov_27.295828	550	630	2	42	80	0.5250000
NODE_9154_length_890_cov_27.295828	603	683	0	80	80	1.0000000
NODE_9155_length_890_cov_18.088496	80	135	0	55	55	1.0000000
NODE_9155_length_890_cov_18.088496	276	356	0	4	80	0.0500000
NODE_9155_length_890_cov_18.088496	276	356	2	53	80	0.6625000
NODE_9155_length_890_cov_18.088496	276	356	4	23	80	0.2875000
NODE_9155_length_890_cov_18.088496	329	406	2	53	77	0.6883117
NODE_9155_length_890_cov_18.088496	329	406	4	24	77	0.3116883
NODE_9156_length_890_cov_16.831858	402	482	0	80	80	1.0000000
NODE_9156_length_890_cov_16.831858	455	535	0	80	80	1.0000000
NODE_9157_length_890_cov_11.881163	222	302	0	38	80	0.4750000
NODE_9157_length_890_cov_11.881163	222	302	4	38	80	0.4750000
NODE_9157_length_890_cov_11.881163	222	302	6	4	80	0.0500000
NODE_9157_length_890_cov_11.881163	275	355	4	29	80	0.3625000
NODE_9157_length_890_cov_11.881163	275	355	6	51	80	0.6375000
NODE_9158_length_890_cov_8.676359	335	415	2	11	80	0.1375000
NODE_9158_length_890_cov_8.676359	335	415	4	41	80	0.5125000
NODE_9158_length_890_cov_8.676359	335	415	6	28	80	0.3500000
NODE_9158_length_890_cov_8.676359	388	468	2	17	80	0.2125000
NODE_9158_length_890_cov_8.676359	388	468	4	63	80	0.7875000
NODE_9183_length_889_cov_61.520253	334	414	0	12	80	0.1500000
NODE_9183_length_889_cov_61.520253	334	414	2	12	80	0.1500000
NODE_9183_length_889_cov_61.520253	334	414	6	56	80	0.7000000
NODE_9183_length_889_cov_61.520253	387	467	6	73	80	0.9125000
NODE_9183_length_889_cov_61.520253	387	467	8	7	80	0.0875000
NODE_9183_length_889_cov_61.520253	463	543	2	39	80	0.4875000
NODE_9183_length_889_cov_61.520253	463	543	4	27	80	0.3375000
NODE_9183_length_889_cov_61.520253	463	543	6	14	80	0.1750000
NODE_9183_length_889_cov_61.520253	516	596	0	4	80	0.0500000
NODE_9183_length_889_cov_61.520253	516	596	2	60	80	0.7500000
NODE_9183_length_889_cov_61.520253	516	596	4	16	80	0.2000000
NODE_9184_length_889_cov_30.012658	311	391	0	51	80	0.6375000
NODE_9184_length_889_cov_30.012658	311	391	4	4	80	0.0500000
NODE_9184_length_889_cov_30.012658	311	391	6	25	80	0.3125000
NODE_9184_length_889_cov_30.012658	364	444	4	2	80	0.0250000
NODE_9184_length_889_cov_30.012658	364	444	6	78	80	0.9750000
NODE_9185_length_889_cov_28.217722	413	483	0	70	70	1.0000000
NODE_9185_length_889_cov_28.217722	466	542	0	76	76	1.0000000
NODE_9186_length_889_cov_27.924051	379	449	2	65	70	0.9285714
NODE_9186_length_889_cov_27.924051	379	449	4	5	70	0.0714286
NODE_9186_length_889_cov_27.924051	432	512	0	23	80	0.2875000
NODE_9186_length_889_cov_27.924051	432	512	2	38	80	0.4750000
NODE_9186_length_889_cov_27.924051	432	512	4	19	80	0.2375000
NODE_9187_length_889_cov_25.887342	227	285	0	26	58	0.4482759
NODE_9187_length_889_cov_25.887342	227	285	2	32	58	0.5517241
NODE_9187_length_889_cov_25.887342	258	337	2	77	79	0.9746835
NODE_9187_length_889_cov_25.887342	258	337	4	2	79	0.0253165
NODE_9188_length_889_cov_22.992405	451	531	0	10	80	0.1250000
NODE_9188_length_889_cov_22.992405	451	531	2	70	80	0.8750000
NODE_9188_length_889_cov_22.992405	504	584	0	63	80	0.7875000
NODE_9188_length_889_cov_22.992405	504	584	2	17	80	0.2125000
NODE_9189_length_889_cov_20.703797	331	411	0	80	80	1.0000000
NODE_9189_length_889_cov_20.703797	384	464	0	80	80	1.0000000
NODE_9190_length_889_cov_20.226582	234	314	0	79	80	0.9875000
NODE_9190_length_889_cov_20.226582	234	314	2	1	80	0.0125000
NODE_9190_length_889_cov_20.226582	287	367	0	26	80	0.3250000
NODE_9190_length_889_cov_20.226582	287	367	2	54	80	0.6750000
NODE_9191_length_889_cov_15.587342	407	487	0	80	80	1.0000000
NODE_9191_length_889_cov_15.587342	460	540	0	80	80	1.0000000
NODE_9192_length_889_cov_12.669620	313	393	0	80	80	1.0000000
NODE_9192_length_889_cov_12.669620	366	446	0	42	80	0.5250000
NODE_9192_length_889_cov_12.669620	366	446	2	38	80	0.4750000
NODE_9193_length_889_cov_12.198734	399	479	4	11	80	0.1375000
NODE_9193_length_889_cov_12.198734	399	479	6	5	80	0.0625000
NODE_9193_length_889_cov_12.198734	399	479	8	7	80	0.0875000
NODE_9193_length_889_cov_12.198734	399	479	10	21	80	0.2625000
NODE_9193_length_889_cov_12.198734	399	479	12	36	80	0.4500000
NODE_9193_length_889_cov_12.198734	452	532	2	10	80	0.1250000
NODE_9193_length_889_cov_12.198734	452	532	4	9	80	0.1125000
NODE_9193_length_889_cov_12.198734	452	532	6	28	80	0.3500000
NODE_9193_length_889_cov_12.198734	452	532	8	7	80	0.0875000
NODE_9193_length_889_cov_12.198734	452	532	10	1	80	0.0125000
NODE_9193_length_889_cov_12.198734	452	532	12	25	80	0.3125000
NODE_9197_length_889_cov_3.841772	187	267	0	80	80	1.0000000
NODE_9197_length_889_cov_3.841772	240	320	0	80	80	1.0000000
NODE_9213_length_888_cov_37.102662	490	570	0	80	80	1.0000000
NODE_9213_length_888_cov_37.102662	543	623	0	80	80	1.0000000
NODE_9214_length_888_cov_28.230672	366	446	1	34	80	0.4250000
NODE_9214_length_888_cov_28.230672	366	446	2	46	80	0.5750000
NODE_9214_length_888_cov_28.230672	419	499	1	65	80	0.8125000
NODE_9214_length_888_cov_28.230672	419	499	2	15	80	0.1875000
NODE_9215_length_888_cov_25.243346	391	471	0	7	80	0.0875000
NODE_9215_length_888_cov_25.243346	391	471	2	6	80	0.0750000
NODE_9215_length_888_cov_25.243346	391	471	4	5	80	0.0625000
NODE_9215_length_888_cov_25.243346	391	471	6	2	80	0.0250000
NODE_9215_length_888_cov_25.243346	391	471	10	5	80	0.0625000
NODE_9215_length_888_cov_25.243346	391	471	12	55	80	0.6875000
NODE_9215_length_888_cov_25.243346	444	524	2	13	80	0.1625000
NODE_9215_length_888_cov_25.243346	444	524	6	1	80	0.0125000
NODE_9215_length_888_cov_25.243346	444	524	8	21	80	0.2625000
NODE_9215_length_888_cov_25.243346	444	524	10	3	80	0.0375000
NODE_9215_length_888_cov_25.243346	444	524	12	42	80	0.5250000
NODE_9216_length_888_cov_21.045627	236	316	0	80	80	1.0000000
NODE_9216_length_888_cov_21.045627	289	367	0	78	78	1.0000000
NODE_9218_length_888_cov_13.447402	515	595	0	80	80	1.0000000
NODE_9218_length_888_cov_13.447402	568	648	0	80	80	1.0000000
NODE_9219_length_888_cov_12.806084	179	259	0	80	80	1.0000000
NODE_9219_length_888_cov_12.806084	232	312	0	80	80	1.0000000
NODE_9219_length_888_cov_12.806084	308	388	0	43	80	0.5375000
NODE_9219_length_888_cov_12.806084	308	388	2	37	80	0.4625000
NODE_9219_length_888_cov_12.806084	361	441	0	10	80	0.1250000
NODE_9219_length_888_cov_12.806084	361	441	2	70	80	0.8750000
NODE_9220_length_888_cov_12.551331	365	445	0	10	80	0.1250000
NODE_9220_length_888_cov_12.551331	365	445	2	70	80	0.8750000
NODE_9220_length_888_cov_12.551331	418	498	0	5	80	0.0625000
NODE_9220_length_888_cov_12.551331	418	498	2	75	80	0.9375000
NODE_9228_length_888_cov_2.041825	42	102	2	8	60	0.1333333
NODE_9228_length_888_cov_2.041825	42	102	4	52	60	0.8666667
NODE_9237_length_887_cov_32.927665	514	594	2	69	80	0.8625000
NODE_9237_length_887_cov_32.927665	514	594	4	11	80	0.1375000
NODE_9237_length_887_cov_32.927665	567	647	1	47	80	0.5875000
NODE_9237_length_887_cov_32.927665	567	647	2	33	80	0.4125000
NODE_9238_length_887_cov_26.920051	358	438	0	16	80	0.2000000
NODE_9238_length_887_cov_26.920051	358	438	2	1	80	0.0125000
NODE_9238_length_887_cov_26.920051	358	438	4	63	80	0.7875000
NODE_9238_length_887_cov_26.920051	411	491	0	24	80	0.3000000
NODE_9238_length_887_cov_26.920051	411	491	2	15	80	0.1875000
NODE_9238_length_887_cov_26.920051	411	491	4	41	80	0.5125000
NODE_9239_length_887_cov_20.714467	304	384	0	80	80	1.0000000
NODE_9239_length_887_cov_20.714467	357	433	0	76	76	1.0000000
NODE_9240_length_887_cov_19.771574	407	487	2	56	80	0.7000000
NODE_9240_length_887_cov_19.771574	407	487	4	23	80	0.2875000
NODE_9240_length_887_cov_19.771574	407	487	6	1	80	0.0125000
NODE_9240_length_887_cov_19.771574	460	540	0	34	80	0.4250000
NODE_9240_length_887_cov_19.771574	460	540	2	46	80	0.5750000
NODE_9241_length_887_cov_14.535533	333	413	2	80	80	1.0000000
NODE_9241_length_887_cov_14.535533	386	466	1	21	80	0.2625000
NODE_9241_length_887_cov_14.535533	386	466	2	59	80	0.7375000
NODE_9242_length_887_cov_14.114213	345	425	0	80	80	1.0000000
NODE_9242_length_887_cov_14.114213	398	478	0	80	80	1.0000000
NODE_9243_length_887_cov_9.451777	406	486	2	31	80	0.3875000
NODE_9243_length_887_cov_9.451777	406	486	4	2	80	0.0250000
NODE_9243_length_887_cov_9.451777	406	486	6	47	80	0.5875000
NODE_9243_length_887_cov_9.451777	459	539	0	14	80	0.1750000
NODE_9243_length_887_cov_9.451777	459	539	2	14	80	0.1750000
NODE_9243_length_887_cov_9.451777	459	539	4	10	80	0.1250000
NODE_9243_length_887_cov_9.451777	459	539	6	42	80	0.5250000
NODE_9245_length_887_cov_6.656091	473	553	0	17	80	0.2125000
NODE_9245_length_887_cov_6.656091	473	553	2	63	80	0.7875000
NODE_9245_length_887_cov_6.656091	526	606	0	16	80	0.2000000
NODE_9245_length_887_cov_6.656091	526	606	2	64	80	0.8000000
NODE_9246_length_887_cov_4.719543	420	500	0	11	80	0.1375000
NODE_9246_length_887_cov_4.719543	420	500	2	69	80	0.8625000
NODE_9246_length_887_cov_4.719543	473	553	0	64	80	0.8000000
NODE_9246_length_887_cov_4.719543	473	553	2	16	80	0.2000000
NODE_9250_length_887_cov_2.583756	385	429	0	44	44	1.0000000
NODE_9250_length_887_cov_2.583756	393	428	0	35	35	1.0000000
NODE_9261_length_887_cov_1.087563	754	829	2	9	75	0.1200000
NODE_9261_length_887_cov_1.087563	754	829	4	66	75	0.8800000
NODE_9264_length_886_cov_35.482846	365	445	4	5	80	0.0625000
NODE_9264_length_886_cov_35.482846	365	445	5	7	80	0.0875000
NODE_9264_length_886_cov_35.482846	365	445	6	53	80	0.6625000
NODE_9264_length_886_cov_35.482846	365	445	8	15	80	0.1875000
NODE_9264_length_886_cov_35.482846	418	498	0	31	80	0.3875000
NODE_9264_length_886_cov_35.482846	418	498	2	6	80	0.0750000
NODE_9264_length_886_cov_35.482846	418	498	4	21	80	0.2625000
NODE_9264_length_886_cov_35.482846	418	498	5	7	80	0.0875000
NODE_9264_length_886_cov_35.482846	418	498	6	15	80	0.1875000
NODE_9265_length_886_cov_31.939009	438	518	0	23	80	0.2875000
NODE_9265_length_886_cov_31.939009	438	518	2	23	80	0.2875000
NODE_9265_length_886_cov_31.939009	438	518	4	34	80	0.4250000
NODE_9265_length_886_cov_31.939009	491	571	4	70	80	0.8750000
NODE_9265_length_886_cov_31.939009	491	571	6	10	80	0.1250000
NODE_9266_length_886_cov_25.301144	326	406	2	47	80	0.5875000
NODE_9266_length_886_cov_25.301144	326	406	4	12	80	0.1500000
NODE_9266_length_886_cov_25.301144	326	406	6	21	80	0.2625000
NODE_9266_length_886_cov_25.301144	326	406	2	47	80	0.5875000
NODE_9266_length_886_cov_25.301144	326	406	4	12	80	0.1500000
NODE_9266_length_886_cov_25.301144	326	406	6	21	80	0.2625000
NODE_9266_length_886_cov_25.301144	379	459	4	25	80	0.3125000
NODE_9266_length_886_cov_25.301144	379	459	6	55	80	0.6875000
NODE_9266_length_886_cov_25.301144	379	459	4	25	80	0.3125000
NODE_9266_length_886_cov_25.301144	379	459	6	55	80	0.6875000
NODE_9267_length_886_cov_14.463787	327	407	0	80	80	1.0000000
NODE_9267_length_886_cov_14.463787	380	460	0	80	80	1.0000000
NODE_9286_length_885_cov_35.510178	373	453	0	80	80	1.0000000
NODE_9286_length_885_cov_35.510178	426	506	0	80	80	1.0000000
NODE_9287_length_885_cov_31.857506	368	448	0	28	80	0.3500000
NODE_9287_length_885_cov_31.857506	368	448	2	52	80	0.6500000
NODE_9287_length_885_cov_31.857506	421	501	0	28	80	0.3500000
NODE_9287_length_885_cov_31.857506	421	501	2	52	80	0.6500000
NODE_9288_length_885_cov_31.195929	395	475	4	20	80	0.2500000
NODE_9288_length_885_cov_31.195929	395	475	6	60	80	0.7500000
NODE_9288_length_885_cov_31.195929	448	528	0	19	80	0.2375000
NODE_9288_length_885_cov_31.195929	448	528	2	34	80	0.4250000
NODE_9288_length_885_cov_31.195929	448	528	6	27	80	0.3375000
NODE_9289_length_885_cov_23.735369	356	436	0	80	80	1.0000000
NODE_9289_length_885_cov_23.735369	409	489	0	80	80	1.0000000
NODE_9289_length_885_cov_23.735369	485	565	0	80	80	1.0000000
NODE_9289_length_885_cov_23.735369	538	618	0	80	80	1.0000000
NODE_9290_length_885_cov_22.174300	340	420	0	80	80	1.0000000
NODE_9290_length_885_cov_22.174300	393	473	0	50	80	0.6250000
NODE_9290_length_885_cov_22.174300	393	473	2	30	80	0.3750000
NODE_9290_length_885_cov_22.174300	469	549	2	80	80	1.0000000
NODE_9290_length_885_cov_22.174300	522	602	0	6	80	0.0750000
NODE_9290_length_885_cov_22.174300	522	602	2	74	80	0.9250000
NODE_9291_length_885_cov_17.852417	413	493	2	80	80	1.0000000
NODE_9291_length_885_cov_17.852417	466	546	0	9	80	0.1125000
NODE_9291_length_885_cov_17.852417	466	546	1	18	80	0.2250000
NODE_9291_length_885_cov_17.852417	466	546	2	53	80	0.6625000
NODE_9292_length_885_cov_15.652672	346	426	0	80	80	1.0000000
NODE_9292_length_885_cov_15.652672	399	479	0	80	80	1.0000000
NODE_9292_length_885_cov_15.652672	475	555	0	80	80	1.0000000
NODE_9292_length_885_cov_15.652672	528	608	0	80	80	1.0000000
NODE_9293_length_885_cov_11.648855	530	610	0	5	80	0.0625000
NODE_9293_length_885_cov_11.648855	530	610	2	75	80	0.9375000
NODE_9293_length_885_cov_11.648855	583	663	0	58	80	0.7250000
NODE_9293_length_885_cov_11.648855	583	663	2	22	80	0.2750000
NODE_9294_length_885_cov_9.707379	611	691	2	80	80	1.0000000
NODE_9294_length_885_cov_9.707379	664	744	0	12	80	0.1500000
NODE_9294_length_885_cov_9.707379	664	744	1	21	80	0.2625000
NODE_9294_length_885_cov_9.707379	664	744	2	47	80	0.5875000
NODE_9311_length_884_cov_73.050955	536	616	2	10	80	0.1250000
NODE_9311_length_884_cov_73.050955	536	616	4	48	80	0.6000000
NODE_9311_length_884_cov_73.050955	536	616	6	22	80	0.2750000
NODE_9311_length_884_cov_73.050955	589	669	2	63	80	0.7875000
NODE_9311_length_884_cov_73.050955	589	669	4	1	80	0.0125000
NODE_9311_length_884_cov_73.050955	589	669	6	16	80	0.2000000
NODE_9312_length_884_cov_28.373248	381	461	0	80	80	1.0000000
NODE_9312_length_884_cov_28.373248	434	514	0	80	80	1.0000000
NODE_9313_length_884_cov_20.649682	463	543	0	2	80	0.0250000
NODE_9313_length_884_cov_20.649682	463	543	2	78	80	0.9750000
NODE_9313_length_884_cov_20.649682	516	596	0	12	80	0.1500000
NODE_9313_length_884_cov_20.649682	516	596	2	68	80	0.8500000
NODE_9314_length_884_cov_13.391083	225	305	0	2	80	0.0250000
NODE_9314_length_884_cov_13.391083	225	305	2	78	80	0.9750000
NODE_9314_length_884_cov_13.391083	278	358	0	55	80	0.6875000
NODE_9314_length_884_cov_13.391083	278	358	2	25	80	0.3125000
NODE_9315_length_884_cov_9.192357	278	358	0	9	80	0.1125000
NODE_9315_length_884_cov_9.192357	278	358	2	13	80	0.1625000
NODE_9315_length_884_cov_9.192357	278	358	4	16	80	0.2000000
NODE_9315_length_884_cov_9.192357	278	358	6	42	80	0.5250000
NODE_9315_length_884_cov_9.192357	331	411	0	10	80	0.1250000
NODE_9315_length_884_cov_9.192357	331	411	2	18	80	0.2250000
NODE_9315_length_884_cov_9.192357	331	411	4	13	80	0.1625000
NODE_9315_length_884_cov_9.192357	331	411	6	39	80	0.4875000
NODE_9315_length_884_cov_9.192357	407	487	0	80	80	1.0000000
NODE_9315_length_884_cov_9.192357	460	540	0	68	80	0.8500000
NODE_9315_length_884_cov_9.192357	460	540	2	12	80	0.1500000
NODE_9335_length_883_cov_46.780612	344	424	0	10	80	0.1250000
NODE_9335_length_883_cov_46.780612	344	424	2	70	80	0.8750000
NODE_9335_length_883_cov_46.780612	397	477	0	43	80	0.5375000
NODE_9335_length_883_cov_46.780612	397	477	2	37	80	0.4625000
NODE_9336_length_883_cov_46.304847	387	467	0	36	80	0.4500000
NODE_9336_length_883_cov_46.304847	387	467	2	12	80	0.1500000
NODE_9336_length_883_cov_46.304847	387	467	4	32	80	0.4000000
NODE_9336_length_883_cov_46.304847	440	520	0	4	80	0.0500000
NODE_9336_length_883_cov_46.304847	440	520	2	8	80	0.1000000
NODE_9336_length_883_cov_46.304847	440	520	4	68	80	0.8500000
NODE_9337_length_883_cov_39.579082	410	490	2	80	80	1.0000000
NODE_9337_length_883_cov_39.579082	463	543	0	52	80	0.6500000
NODE_9337_length_883_cov_39.579082	463	543	2	28	80	0.3500000
NODE_9338_length_883_cov_28.307398	379	459	13	22	80	0.2750000
NODE_9338_length_883_cov_28.307398	379	459	19	4	80	0.0500000
NODE_9338_length_883_cov_28.307398	379	459	20	4	80	0.0500000
NODE_9338_length_883_cov_28.307398	379	459	21	13	80	0.1625000
NODE_9338_length_883_cov_28.307398	379	459	22	23	80	0.2875000
NODE_9338_length_883_cov_28.307398	379	459	23	14	80	0.1750000
NODE_9338_length_883_cov_28.307398	432	512	0	11	80	0.1375000
NODE_9338_length_883_cov_28.307398	432	512	5	3	80	0.0375000
NODE_9338_length_883_cov_28.307398	432	512	14	1	80	0.0125000
NODE_9338_length_883_cov_28.307398	432	512	15	14	80	0.1750000
NODE_9338_length_883_cov_28.307398	432	512	17	5	80	0.0625000
NODE_9338_length_883_cov_28.307398	432	512	19	2	80	0.0250000
NODE_9338_length_883_cov_28.307398	432	512	21	22	80	0.2750000
NODE_9338_length_883_cov_28.307398	432	512	22	18	80	0.2250000
NODE_9338_length_883_cov_28.307398	432	512	23	4	80	0.0500000
NODE_9339_length_883_cov_24.927296	429	509	6	7	80	0.0875000
NODE_9339_length_883_cov_24.927296	429	509	7	11	80	0.1375000
NODE_9339_length_883_cov_24.927296	429	509	8	31	80	0.3875000
NODE_9339_length_883_cov_24.927296	429	509	9	11	80	0.1375000
NODE_9339_length_883_cov_24.927296	429	509	10	15	80	0.1875000
NODE_9339_length_883_cov_24.927296	429	509	11	5	80	0.0625000
NODE_9339_length_883_cov_24.927296	482	562	0	4	80	0.0500000
NODE_9339_length_883_cov_24.927296	482	562	3	25	80	0.3125000
NODE_9339_length_883_cov_24.927296	482	562	5	2	80	0.0250000
NODE_9339_length_883_cov_24.927296	482	562	7	12	80	0.1500000
NODE_9339_length_883_cov_24.927296	482	562	8	22	80	0.2750000
NODE_9339_length_883_cov_24.927296	482	562	9	11	80	0.1375000
NODE_9339_length_883_cov_24.927296	482	562	11	4	80	0.0500000
NODE_9341_length_883_cov_17.445153	326	406	10	5	80	0.0625000
NODE_9341_length_883_cov_17.445153	326	406	12	39	80	0.4875000
NODE_9341_length_883_cov_17.445153	326	406	14	32	80	0.4000000
NODE_9341_length_883_cov_17.445153	326	406	15	4	80	0.0500000
NODE_9341_length_883_cov_17.445153	379	459	7	9	80	0.1125000
NODE_9341_length_883_cov_17.445153	379	459	12	14	80	0.1750000
NODE_9341_length_883_cov_17.445153	379	459	14	46	80	0.5750000
NODE_9341_length_883_cov_17.445153	379	459	15	9	80	0.1125000
NODE_9341_length_883_cov_17.445153	379	459	16	2	80	0.0250000
NODE_9342_length_883_cov_14.660714	319	395	0	34	76	0.4473684
NODE_9342_length_883_cov_14.660714	319	395	4	5	76	0.0657895
NODE_9342_length_883_cov_14.660714	319	395	6	37	76	0.4868421
NODE_9342_length_883_cov_14.660714	740	816	0	76	76	1.0000000
NODE_9343_length_883_cov_11.052296	223	303	0	80	80	1.0000000
NODE_9343_length_883_cov_11.052296	276	356	0	80	80	1.0000000
NODE_9344_length_883_cov_6.873724	0	66	0	14	66	0.2121212
NODE_9344_length_883_cov_6.873724	0	66	1	1	66	0.0151515
NODE_9344_length_883_cov_6.873724	0	66	2	1	66	0.0151515
NODE_9344_length_883_cov_6.873724	0	66	3	8	66	0.1212121
NODE_9344_length_883_cov_6.873724	0	66	5	10	66	0.1515152
NODE_9344_length_883_cov_6.873724	0	66	7	14	66	0.2121212
NODE_9344_length_883_cov_6.873724	0	66	9	18	66	0.2727273
NODE_9345_length_883_cov_3.873724	471	551	0	80	80	1.0000000
NODE_9345_length_883_cov_3.873724	524	604	0	63	80	0.7875000
NODE_9345_length_883_cov_3.873724	524	604	2	17	80	0.2125000
NODE_9346_length_883_cov_3.247449	294	374	0	80	80	1.0000000
NODE_9346_length_883_cov_3.247449	347	427	0	80	80	1.0000000
NODE_9370_length_882_cov_24.241379	438	518	2	67	80	0.8375000
NODE_9370_length_882_cov_24.241379	438	518	4	13	80	0.1625000
NODE_9370_length_882_cov_24.241379	491	571	0	51	80	0.6375000
NODE_9370_length_882_cov_24.241379	491	571	2	29	80	0.3625000
NODE_9371_length_882_cov_23.145594	355	435	0	41	80	0.5125000
NODE_9371_length_882_cov_23.145594	355	435	2	26	80	0.3250000
NODE_9371_length_882_cov_23.145594	355	435	4	13	80	0.1625000
NODE_9371_length_882_cov_23.145594	408	488	2	14	80	0.1750000
NODE_9371_length_882_cov_23.145594	408	488	4	66	80	0.8250000
NODE_9372_length_882_cov_21.401022	335	415	0	27	80	0.3375000
NODE_9372_length_882_cov_21.401022	335	415	2	53	80	0.6625000
NODE_9372_length_882_cov_21.401022	388	468	0	23	80	0.2875000
NODE_9372_length_882_cov_21.401022	388	468	2	57	80	0.7125000
NODE_9373_length_882_cov_19.579821	456	511	0	55	55	1.0000000
NODE_9373_length_882_cov_19.579821	506	586	0	19	80	0.2375000
NODE_9373_length_882_cov_19.579821	506	586	2	1	80	0.0125000
NODE_9373_length_882_cov_19.579821	506	586	4	60	80	0.7500000
NODE_9373_length_882_cov_19.579821	559	639	0	19	80	0.2375000
NODE_9373_length_882_cov_19.579821	559	639	2	3	80	0.0375000
NODE_9373_length_882_cov_19.579821	559	639	4	58	80	0.7250000
NODE_9374_length_882_cov_19.342273	298	378	0	80	80	1.0000000
NODE_9374_length_882_cov_19.342273	351	431	0	80	80	1.0000000
NODE_9374_length_882_cov_19.342273	427	508	0	81	81	1.0000000
NODE_9374_length_882_cov_19.342273	481	561	0	80	80	1.0000000
NODE_9375_length_882_cov_11.873563	267	347	2	38	80	0.4750000
NODE_9375_length_882_cov_11.873563	267	347	4	42	80	0.5250000
NODE_9375_length_882_cov_11.873563	320	400	2	27	80	0.3375000
NODE_9375_length_882_cov_11.873563	320	400	4	53	80	0.6625000
NODE_9376_length_882_cov_8.794381	430	510	0	80	80	1.0000000
NODE_9376_length_882_cov_8.794381	483	563	0	80	80	1.0000000
NODE_9377_length_882_cov_7.537676	527	608	0	81	81	1.0000000
NODE_9379_length_882_cov_6.696041	355	435	0	80	80	1.0000000
NODE_9379_length_882_cov_6.696041	408	488	0	80	80	1.0000000
NODE_9380_length_882_cov_4.734355	585	665	2	80	80	1.0000000
NODE_9380_length_882_cov_4.734355	638	718	0	51	80	0.6375000
NODE_9380_length_882_cov_4.734355	638	718	2	29	80	0.3625000
NODE_9398_length_881_cov_32.875959	444	524	0	32	80	0.4000000
NODE_9398_length_881_cov_32.875959	444	524	2	48	80	0.6000000
NODE_9398_length_881_cov_32.875959	497	577	0	14	80	0.1750000
NODE_9398_length_881_cov_32.875959	497	577	2	66	80	0.8250000
NODE_9399_length_881_cov_25.750639	43	117	0	57	74	0.7702703
NODE_9399_length_881_cov_25.750639	43	117	2	17	74	0.2297297
NODE_9399_length_881_cov_25.750639	116	193	2	32	77	0.4155844
NODE_9399_length_881_cov_25.750639	116	193	4	28	77	0.3636364
NODE_9399_length_881_cov_25.750639	116	193	6	17	77	0.2207792
NODE_9400_length_881_cov_23.897698	286	365	0	68	79	0.8607595
NODE_9400_length_881_cov_23.897698	286	365	4	3	79	0.0379747
NODE_9400_length_881_cov_23.897698	286	365	6	8	79	0.1012658
NODE_9400_length_881_cov_23.897698	338	418	0	16	80	0.2000000
NODE_9400_length_881_cov_23.897698	338	418	4	3	80	0.0375000
NODE_9400_length_881_cov_23.897698	338	418	6	17	80	0.2125000
NODE_9400_length_881_cov_23.897698	338	418	8	27	80	0.3375000
NODE_9400_length_881_cov_23.897698	338	418	9	9	80	0.1125000
NODE_9400_length_881_cov_23.897698	338	418	10	8	80	0.1000000
NODE_9401_length_881_cov_20.656010	359	439	0	80	80	1.0000000
NODE_9401_length_881_cov_20.656010	412	492	0	80	80	1.0000000
NODE_9402_length_881_cov_20.340153	242	322	2	80	80	1.0000000
NODE_9402_length_881_cov_20.340153	295	375	0	38	80	0.4750000
NODE_9402_length_881_cov_20.340153	295	375	2	42	80	0.5250000
NODE_9403_length_881_cov_18.234015	420	500	0	80	80	1.0000000
NODE_9403_length_881_cov_18.234015	473	553	0	80	80	1.0000000
NODE_9404_length_881_cov_17.748082	291	371	0	80	80	1.0000000
NODE_9404_length_881_cov_17.748082	344	424	0	80	80	1.0000000
NODE_9405_length_881_cov_12.884910	332	412	0	80	80	1.0000000
NODE_9405_length_881_cov_12.884910	385	465	0	80	80	1.0000000
NODE_9406_length_881_cov_6.473146	474	553	0	79	79	1.0000000
NODE_9406_length_881_cov_6.473146	514	594	0	80	80	1.0000000
NODE_9406_length_881_cov_6.473146	526	565	0	39	39	1.0000000
NODE_9406_length_881_cov_6.473146	555	606	0	51	51	1.0000000
NODE_9406_length_881_cov_6.473146	567	647	0	80	80	1.0000000
NODE_9407_length_881_cov_5.615090	547	627	0	80	80	1.0000000
NODE_9407_length_881_cov_5.615090	600	680	0	80	80	1.0000000
NODE_9424_length_880_cov_26.663252	320	400	1	19	80	0.2375000
NODE_9424_length_880_cov_26.663252	320	400	2	61	80	0.7625000
NODE_9424_length_880_cov_26.663252	373	453	0	16	80	0.2000000
NODE_9424_length_880_cov_26.663252	373	453	1	56	80	0.7000000
NODE_9424_length_880_cov_26.663252	373	453	2	8	80	0.1000000
NODE_9425_length_880_cov_21.828425	328	408	0	16	80	0.2000000
NODE_9425_length_880_cov_21.828425	328	408	2	30	80	0.3750000
NODE_9425_length_880_cov_21.828425	328	408	4	34	80	0.4250000
NODE_9425_length_880_cov_21.828425	381	461	0	4	80	0.0500000
NODE_9425_length_880_cov_21.828425	381	461	2	33	80	0.4125000
NODE_9425_length_880_cov_21.828425	381	461	4	43	80	0.5375000
NODE_9426_length_880_cov_20.245839	427	507	0	80	80	1.0000000
NODE_9426_length_880_cov_20.245839	480	560	0	80	80	1.0000000
NODE_9427_length_880_cov_19.434059	0	69	0	69	69	1.0000000
NODE_9428_length_880_cov_11.843790	363	430	0	25	67	0.3731343
NODE_9428_length_880_cov_11.843790	363	430	2	42	67	0.6268657
NODE_9429_length_880_cov_11.544174	185	265	0	59	80	0.7375000
NODE_9429_length_880_cov_11.544174	185	265	2	21	80	0.2625000
NODE_9429_length_880_cov_11.544174	238	318	0	14	80	0.1750000
NODE_9429_length_880_cov_11.544174	238	318	2	66	80	0.8250000
NODE_9430_length_880_cov_10.956466	354	434	0	80	80	1.0000000
NODE_9430_length_880_cov_10.956466	407	487	0	80	80	1.0000000
NODE_9431_length_880_cov_10.008963	395	474	0	79	79	1.0000000
NODE_9431_length_880_cov_10.008963	448	527	0	79	79	1.0000000
NODE_9453_length_879_cov_23.565385	326	406	0	80	80	1.0000000
NODE_9453_length_879_cov_23.565385	379	459	0	80	80	1.0000000
NODE_9453_length_879_cov_23.565385	455	535	0	19	80	0.2375000
NODE_9453_length_879_cov_23.565385	455	535	2	61	80	0.7625000
NODE_9453_length_879_cov_23.565385	508	586	0	22	78	0.2820513
NODE_9453_length_879_cov_23.565385	508	586	2	56	78	0.7179487
NODE_9454_length_879_cov_20.758974	355	439	0	84	84	1.0000000
NODE_9454_length_879_cov_20.758974	412	492	0	80	80	1.0000000
NODE_9455_length_879_cov_19.685897	295	375	0	40	80	0.5000000
NODE_9455_length_879_cov_19.685897	295	375	2	40	80	0.5000000
NODE_9455_length_879_cov_19.685897	348	428	0	3	80	0.0375000
NODE_9455_length_879_cov_19.685897	348	428	2	77	80	0.9625000
NODE_9456_length_879_cov_17.738462	413	488	0	27	75	0.3600000
NODE_9456_length_879_cov_17.738462	413	488	2	48	75	0.6400000
NODE_9456_length_879_cov_17.738462	569	649	0	80	80	1.0000000
NODE_9456_length_879_cov_17.738462	569	649	0	80	80	1.0000000
NODE_9456_length_879_cov_17.738462	569	649	0	80	80	1.0000000
NODE_9456_length_879_cov_17.738462	622	676	0	54	54	1.0000000
NODE_9458_length_879_cov_10.756410	335	415	0	20	80	0.2500000
NODE_9458_length_879_cov_10.756410	335	415	2	60	80	0.7500000
NODE_9458_length_879_cov_10.756410	388	468	0	23	80	0.2875000
NODE_9458_length_879_cov_10.756410	388	468	2	57	80	0.7125000
NODE_9459_length_879_cov_7.432051	234	314	0	14	80	0.1750000
NODE_9459_length_879_cov_7.432051	234	314	2	36	80	0.4500000
NODE_9459_length_879_cov_7.432051	234	314	4	13	80	0.1625000
NODE_9459_length_879_cov_7.432051	234	314	6	17	80	0.2125000
NODE_9459_length_879_cov_7.432051	288	367	0	57	79	0.7215190
NODE_9459_length_879_cov_7.432051	288	367	2	22	79	0.2784810
NODE_9473_length_878_cov_230.436457	415	495	0	24	80	0.3000000
NODE_9473_length_878_cov_230.436457	415	495	2	56	80	0.7000000
NODE_9473_length_878_cov_230.436457	468	548	0	35	80	0.4375000
NODE_9473_length_878_cov_230.436457	468	548	2	45	80	0.5625000
NODE_9474_length_878_cov_49.514763	410	490	6	80	80	1.0000000
NODE_9474_length_878_cov_49.514763	463	543	0	30	80	0.3750000
NODE_9474_length_878_cov_49.514763	463	543	5	1	80	0.0125000
NODE_9474_length_878_cov_49.514763	463	543	6	49	80	0.6125000
NODE_9475_length_878_cov_38.862644	365	445	0	5	80	0.0625000
NODE_9475_length_878_cov_38.862644	365	445	2	30	80	0.3750000
NODE_9475_length_878_cov_38.862644	365	445	4	45	80	0.5625000
NODE_9475_length_878_cov_38.862644	418	498	0	11	80	0.1375000
NODE_9475_length_878_cov_38.862644	418	498	2	2	80	0.0250000
NODE_9475_length_878_cov_38.862644	418	498	4	67	80	0.8375000
NODE_9476_length_878_cov_36.517330	346	426	0	80	80	1.0000000
NODE_9476_length_878_cov_36.517330	399	479	0	80	80	1.0000000
NODE_9476_length_878_cov_36.517330	475	555	0	80	80	1.0000000
NODE_9476_length_878_cov_36.517330	528	608	0	80	80	1.0000000
NODE_9477_length_878_cov_34.404365	627	707	0	21	80	0.2625000
NODE_9477_length_878_cov_34.404365	627	707	2	19	80	0.2375000
NODE_9477_length_878_cov_34.404365	627	707	4	14	80	0.1750000
NODE_9477_length_878_cov_34.404365	627	707	6	26	80	0.3250000
NODE_9477_length_878_cov_34.404365	627	695	0	21	68	0.3088235
NODE_9477_length_878_cov_34.404365	627	695	2	19	68	0.2794118
NODE_9477_length_878_cov_34.404365	627	695	4	14	68	0.2058824
NODE_9477_length_878_cov_34.404365	627	695	6	14	68	0.2058824
NODE_9477_length_878_cov_34.404365	680	760	4	1	80	0.0125000
NODE_9477_length_878_cov_34.404365	680	760	6	26	80	0.3250000
NODE_9477_length_878_cov_34.404365	680	760	8	3	80	0.0375000
NODE_9477_length_878_cov_34.404365	680	760	10	1	80	0.0125000
NODE_9477_length_878_cov_34.404365	680	760	12	6	80	0.0750000
NODE_9477_length_878_cov_34.404365	680	760	14	29	80	0.3625000
NODE_9477_length_878_cov_34.404365	680	760	16	13	80	0.1625000
NODE_9477_length_878_cov_34.404365	680	760	18	1	80	0.0125000
NODE_9478_length_878_cov_28.761232	467	547	0	80	80	1.0000000
NODE_9478_length_878_cov_28.761232	520	600	0	80	80	1.0000000
NODE_9479_length_878_cov_24.899872	316	396	2	80	80	1.0000000
NODE_9479_length_878_cov_24.899872	369	449	0	46	80	0.5750000
NODE_9479_length_878_cov_24.899872	369	449	2	34	80	0.4250000
NODE_9479_length_878_cov_24.899872	445	525	0	80	80	1.0000000
NODE_9479_length_878_cov_24.899872	498	578	0	80	80	1.0000000
NODE_9480_length_878_cov_21.446727	377	457	0	80	80	1.0000000
NODE_9480_length_878_cov_21.446727	430	510	0	80	80	1.0000000
NODE_9481_length_878_cov_20.553273	424	504	0	54	80	0.6750000
NODE_9481_length_878_cov_20.553273	424	504	2	26	80	0.3250000
NODE_9481_length_878_cov_20.553273	477	557	0	1	80	0.0125000
NODE_9481_length_878_cov_20.553273	477	557	2	79	80	0.9875000
NODE_9482_length_878_cov_14.016688	214	294	0	80	80	1.0000000
NODE_9482_length_878_cov_14.016688	267	347	0	80	80	1.0000000
NODE_9483_length_878_cov_9.252888	423	503	0	14	80	0.1750000
NODE_9483_length_878_cov_9.252888	423	503	1	66	80	0.8250000
NODE_9483_length_878_cov_9.252888	476	556	0	55	80	0.6875000
NODE_9483_length_878_cov_9.252888	476	556	1	21	80	0.2625000
NODE_9483_length_878_cov_9.252888	476	556	2	4	80	0.0500000
NODE_9484_length_878_cov_8.695764	333	413	0	71	80	0.8875000
NODE_9484_length_878_cov_8.695764	333	413	2	9	80	0.1125000
NODE_9484_length_878_cov_8.695764	386	466	0	18	80	0.2250000
NODE_9484_length_878_cov_8.695764	386	466	2	62	80	0.7750000
NODE_9485_length_878_cov_6.686778	65	145	0	36	80	0.4500000
NODE_9485_length_878_cov_6.686778	65	145	2	44	80	0.5500000
NODE_9485_length_878_cov_6.686778	118	198	2	80	80	1.0000000
NODE_9487_length_878_cov_6.328626	426	506	0	80	80	1.0000000
NODE_9487_length_878_cov_6.328626	479	559	0	80	80	1.0000000
NODE_9488_length_878_cov_5.771502	470	513	0	43	43	1.0000000
NODE_9490_length_878_cov_2.672657	499	579	0	20	80	0.2500000
NODE_9490_length_878_cov_2.672657	499	579	2	60	80	0.7500000
NODE_9490_length_878_cov_2.672657	552	631	0	3	79	0.0379747
NODE_9490_length_878_cov_2.672657	552	631	2	76	79	0.9620253
NODE_9507_length_877_cov_59.021851	324	404	0	80	80	1.0000000
NODE_9507_length_877_cov_59.021851	377	457	0	80	80	1.0000000
NODE_9508_length_877_cov_54.422879	418	498	2	9	80	0.1125000
NODE_9508_length_877_cov_54.422879	418	498	4	71	80	0.8875000
NODE_9508_length_877_cov_54.422879	471	551	0	33	80	0.4125000
NODE_9508_length_877_cov_54.422879	471	551	2	25	80	0.3125000
NODE_9508_length_877_cov_54.422879	471	551	4	22	80	0.2750000
NODE_9509_length_877_cov_47.672237	451	527	0	76	76	1.0000000
NODE_9509_length_877_cov_47.672237	500	580	0	80	80	1.0000000
NODE_9510_length_877_cov_29.884319	349	429	6	15	80	0.1875000
NODE_9510_length_877_cov_29.884319	349	429	7	37	80	0.4625000
NODE_9510_length_877_cov_29.884319	349	429	8	14	80	0.1750000
NODE_9510_length_877_cov_29.884319	349	429	9	14	80	0.1750000
NODE_9510_length_877_cov_29.884319	402	482	1	33	80	0.4125000
NODE_9510_length_877_cov_29.884319	402	482	2	6	80	0.0750000
NODE_9510_length_877_cov_29.884319	402	482	4	12	80	0.1500000
NODE_9510_length_877_cov_29.884319	402	482	6	17	80	0.2125000
NODE_9510_length_877_cov_29.884319	402	482	8	12	80	0.1500000
NODE_9511_length_877_cov_17.681234	423	503	0	80	80	1.0000000
NODE_9511_length_877_cov_17.681234	476	556	0	80	80	1.0000000
NODE_9512_length_877_cov_17.520566	228	308	0	54	80	0.6750000
NODE_9512_length_877_cov_17.520566	228	308	2	26	80	0.3250000
NODE_9512_length_877_cov_17.520566	281	361	0	3	80	0.0375000
NODE_9512_length_877_cov_17.520566	281	361	2	77	80	0.9625000
NODE_9513_length_877_cov_17.374036	362	442	2	74	80	0.9250000
NODE_9513_length_877_cov_17.374036	362	442	4	6	80	0.0750000
NODE_9513_length_877_cov_17.374036	415	495	2	74	80	0.9250000
NODE_9513_length_877_cov_17.374036	415	495	4	6	80	0.0750000
NODE_9515_length_877_cov_9.320051	395	475	0	80	80	1.0000000
NODE_9515_length_877_cov_9.320051	448	528	0	80	80	1.0000000
NODE_9517_length_877_cov_6.755784	222	302	0	12	80	0.1500000
NODE_9517_length_877_cov_6.755784	222	302	2	68	80	0.8500000
NODE_9517_length_877_cov_6.755784	275	354	0	64	79	0.8101266
NODE_9517_length_877_cov_6.755784	275	354	2	15	79	0.1898734
NODE_9537_length_876_cov_46.021879	389	469	2	5	80	0.0625000
NODE_9537_length_876_cov_46.021879	389	469	4	8	80	0.1000000
NODE_9537_length_876_cov_46.021879	389	469	6	3	80	0.0375000
NODE_9537_length_876_cov_46.021879	389	469	8	22	80	0.2750000
NODE_9537_length_876_cov_46.021879	389	469	10	19	80	0.2375000
NODE_9537_length_876_cov_46.021879	389	469	12	23	80	0.2875000
NODE_9537_length_876_cov_46.021879	442	522	0	13	80	0.1625000
NODE_9537_length_876_cov_46.021879	442	522	4	16	80	0.2000000
NODE_9537_length_876_cov_46.021879	442	522	6	5	80	0.0625000
NODE_9537_length_876_cov_46.021879	442	522	8	13	80	0.1625000
NODE_9537_length_876_cov_46.021879	442	522	10	25	80	0.3125000
NODE_9537_length_876_cov_46.021879	442	522	12	8	80	0.1000000
NODE_9538_length_876_cov_34.441441	379	459	0	5	80	0.0625000
NODE_9538_length_876_cov_34.441441	379	459	4	75	80	0.9375000
NODE_9538_length_876_cov_34.441441	432	512	0	37	80	0.4625000
NODE_9538_length_876_cov_34.441441	432	512	4	43	80	0.5375000
NODE_9539_length_876_cov_30.742600	344	424	0	80	80	1.0000000
NODE_9539_length_876_cov_30.742600	397	477	0	77	80	0.9625000
NODE_9539_length_876_cov_30.742600	397	477	2	3	80	0.0375000
NODE_9540_length_876_cov_28.476190	345	425	0	11	80	0.1375000
NODE_9540_length_876_cov_28.476190	345	425	6	34	80	0.4250000
NODE_9540_length_876_cov_28.476190	345	425	8	4	80	0.0500000
NODE_9540_length_876_cov_28.476190	345	425	10	31	80	0.3875000
NODE_9540_length_876_cov_28.476190	398	478	8	14	80	0.1750000
NODE_9540_length_876_cov_28.476190	398	478	10	66	80	0.8250000
NODE_9541_length_876_cov_22.722008	324	404	0	65	80	0.8125000
NODE_9541_length_876_cov_22.722008	324	404	2	15	80	0.1875000
NODE_9541_length_876_cov_22.722008	377	457	0	44	80	0.5500000
NODE_9541_length_876_cov_22.722008	377	457	2	36	80	0.4500000
NODE_9542_length_876_cov_17.458172	367	447	0	80	80	1.0000000
NODE_9542_length_876_cov_17.458172	420	500	0	80	80	1.0000000
NODE_9561_length_875_cov_52.965206	190	270	2	50	80	0.6250000
NODE_9561_length_875_cov_52.965206	190	270	4	30	80	0.3750000
NODE_9561_length_875_cov_52.965206	243	323	0	37	80	0.4625000
NODE_9561_length_875_cov_52.965206	243	323	2	31	80	0.3875000
NODE_9561_length_875_cov_52.965206	243	323	4	12	80	0.1500000
NODE_9561_length_875_cov_52.965206	319	399	0	80	80	1.0000000
NODE_9561_length_875_cov_52.965206	372	447	0	75	75	1.0000000
NODE_9562_length_875_cov_35.634021	260	340	0	80	80	1.0000000
NODE_9562_length_875_cov_35.634021	313	393	0	80	80	1.0000000
NODE_9562_length_875_cov_35.634021	389	469	0	13	80	0.1625000
NODE_9562_length_875_cov_35.634021	389	469	1	1	80	0.0125000
NODE_9562_length_875_cov_35.634021	389	469	2	43	80	0.5375000
NODE_9562_length_875_cov_35.634021	389	469	4	19	80	0.2375000
NODE_9562_length_875_cov_35.634021	389	469	8	4	80	0.0500000
NODE_9562_length_875_cov_35.634021	442	522	2	4	80	0.0500000
NODE_9562_length_875_cov_35.634021	442	522	4	19	80	0.2375000
NODE_9562_length_875_cov_35.634021	442	522	8	57	80	0.7125000
NODE_9563_length_875_cov_33.771907	363	441	0	78	78	1.0000000
NODE_9563_length_875_cov_33.771907	414	494	0	80	80	1.0000000
NODE_9564_length_875_cov_29.698454	322	402	0	80	80	1.0000000
NODE_9564_length_875_cov_29.698454	375	455	0	80	80	1.0000000
NODE_9565_length_875_cov_23.041237	364	444	0	80	80	1.0000000
NODE_9565_length_875_cov_23.041237	417	497	0	80	80	1.0000000
NODE_9565_length_875_cov_23.041237	493	573	0	80	80	1.0000000
NODE_9565_length_875_cov_23.041237	546	626	0	80	80	1.0000000
NODE_9566_length_875_cov_9.800258	242	322	0	36	80	0.4500000
NODE_9566_length_875_cov_9.800258	242	322	2	6	80	0.0750000
NODE_9566_length_875_cov_9.800258	242	322	4	38	80	0.4750000
NODE_9566_length_875_cov_9.800258	295	376	4	81	81	1.0000000
NODE_9567_length_875_cov_8.195876	407	487	0	80	80	1.0000000
NODE_9567_length_875_cov_8.195876	460	540	0	80	80	1.0000000
NODE_9585_length_874_cov_48.925161	185	265	0	27	80	0.3375000
NODE_9585_length_874_cov_48.925161	185	265	2	53	80	0.6625000
NODE_9585_length_874_cov_48.925161	238	318	2	49	80	0.6125000
NODE_9585_length_874_cov_48.925161	238	318	4	23	80	0.2875000
NODE_9585_length_874_cov_48.925161	238	318	6	8	80	0.1000000
NODE_9587_length_874_cov_37.354839	199	279	0	16	80	0.2000000
NODE_9587_length_874_cov_37.354839	199	279	2	13	80	0.1625000
NODE_9587_length_874_cov_37.354839	199	279	4	51	80	0.6375000
NODE_9587_length_874_cov_37.354839	252	332	0	15	80	0.1875000
NODE_9587_length_874_cov_37.354839	252	332	2	65	80	0.8125000
NODE_9588_length_874_cov_35.040000	231	311	0	80	80	1.0000000
NODE_9588_length_874_cov_35.040000	284	364	0	80	80	1.0000000
NODE_9589_length_874_cov_23.415484	327	407	0	80	80	1.0000000
NODE_9589_length_874_cov_23.415484	380	460	0	80	80	1.0000000
NODE_9589_length_874_cov_23.415484	456	536	0	80	80	1.0000000
NODE_9589_length_874_cov_23.415484	509	589	0	80	80	1.0000000
NODE_9590_length_874_cov_21.885161	279	359	6	79	80	0.9875000
NODE_9590_length_874_cov_21.885161	279	359	8	1	80	0.0125000
NODE_9590_length_874_cov_21.885161	332	412	0	7	80	0.0875000
NODE_9590_length_874_cov_21.885161	332	412	2	23	80	0.2875000
NODE_9590_length_874_cov_21.885161	332	412	6	50	80	0.6250000
NODE_9591_length_874_cov_11.172903	67	147	0	80	80	1.0000000
NODE_9591_length_874_cov_11.172903	120	200	0	80	80	1.0000000
NODE_9592_length_874_cov_9.645161	424	504	0	80	80	1.0000000
NODE_9592_length_874_cov_9.645161	477	557	0	31	80	0.3875000
NODE_9592_length_874_cov_9.645161	477	557	2	49	80	0.6125000
NODE_9593_length_874_cov_8.637419	359	439	0	5	80	0.0625000
NODE_9593_length_874_cov_8.637419	359	439	2	75	80	0.9375000
NODE_9593_length_874_cov_8.637419	412	499	0	65	87	0.7471265
NODE_9593_length_874_cov_8.637419	412	499	2	22	87	0.2528736
NODE_9596_length_874_cov_4.785806	829	874	0	38	45	0.8444445
NODE_9596_length_874_cov_4.785806	829	874	2	7	45	0.1555556
NODE_9618_length_873_cov_100.625323	50	130	18	5	80	0.0625000
NODE_9618_length_873_cov_100.625323	50	130	20	75	80	0.9375000
NODE_9619_length_873_cov_45.633075	226	306	2	34	80	0.4250000
NODE_9619_length_873_cov_45.633075	226	306	4	46	80	0.5750000
NODE_9619_length_873_cov_45.633075	279	359	0	4	80	0.0500000
NODE_9619_length_873_cov_45.633075	279	359	2	53	80	0.6625000
NODE_9619_length_873_cov_45.633075	279	359	4	23	80	0.2875000
NODE_9619_length_873_cov_45.633075	693	773	2	17	80	0.2125000
NODE_9619_length_873_cov_45.633075	693	773	4	29	80	0.3625000
NODE_9619_length_873_cov_45.633075	693	773	5	1	80	0.0125000
NODE_9619_length_873_cov_45.633075	693	773	6	33	80	0.4125000
NODE_9619_length_873_cov_45.633075	746	826	4	29	80	0.3625000
NODE_9619_length_873_cov_45.633075	746	826	6	48	80	0.6000000
NODE_9619_length_873_cov_45.633075	746	826	8	3	80	0.0375000
NODE_9620_length_873_cov_39.224806	190	270	0	68	80	0.8500000
NODE_9620_length_873_cov_39.224806	190	270	2	12	80	0.1500000
NODE_9620_length_873_cov_39.224806	243	307	0	64	64	1.0000000
NODE_9620_length_873_cov_39.224806	390	470	0	80	80	1.0000000
NODE_9620_length_873_cov_39.224806	443	523	0	80	80	1.0000000
NODE_9620_length_873_cov_39.224806	504	523	0	19	19	1.0000000
NODE_9620_length_873_cov_39.224806	519	599	0	80	80	1.0000000
NODE_9620_length_873_cov_39.224806	572	652	0	80	80	1.0000000
NODE_9621_length_873_cov_27.992248	372	452	0	11	80	0.1375000
NODE_9621_length_873_cov_27.992248	372	452	2	69	80	0.8625000
NODE_9621_length_873_cov_27.992248	425	505	0	64	80	0.8000000
NODE_9621_length_873_cov_27.992248	425	505	2	16	80	0.2000000
NODE_9622_length_873_cov_23.270026	390	470	0	80	80	1.0000000
NODE_9622_length_873_cov_23.270026	443	528	0	85	85	1.0000000
NODE_9623_length_873_cov_23.197674	293	373	2	80	80	1.0000000
NODE_9623_length_873_cov_23.197674	346	426	0	24	80	0.3000000
NODE_9623_length_873_cov_23.197674	346	426	2	56	80	0.7000000
NODE_9624_length_873_cov_20.432817	347	427	0	80	80	1.0000000
NODE_9624_length_873_cov_20.432817	400	480	0	80	80	1.0000000
NODE_9624_length_873_cov_20.432817	476	556	0	80	80	1.0000000
NODE_9624_length_873_cov_20.432817	529	609	0	80	80	1.0000000
NODE_9625_length_873_cov_19.913437	445	525	0	80	80	1.0000000
NODE_9625_length_873_cov_19.913437	498	578	0	80	80	1.0000000
NODE_9626_length_873_cov_16.718346	276	356	0	18	80	0.2250000
NODE_9626_length_873_cov_16.718346	276	356	4	62	80	0.7750000
NODE_9626_length_873_cov_16.718346	329	409	0	31	80	0.3875000
NODE_9626_length_873_cov_16.718346	329	409	4	49	80	0.6125000
NODE_9627_length_873_cov_16.422481	423	503	2	70	80	0.8750000
NODE_9627_length_873_cov_16.422481	423	503	4	10	80	0.1250000
NODE_9627_length_873_cov_16.422481	476	556	2	70	80	0.8750000
NODE_9627_length_873_cov_16.422481	476	556	4	10	80	0.1250000
NODE_9628_length_873_cov_11.198966	410	490	0	9	80	0.1125000
NODE_9628_length_873_cov_11.198966	410	490	4	71	80	0.8875000
NODE_9628_length_873_cov_11.198966	463	543	0	62	80	0.7750000
NODE_9628_length_873_cov_11.198966	463	543	4	18	80	0.2250000
NODE_9629_length_873_cov_9.799742	334	414	0	80	80	1.0000000
NODE_9629_length_873_cov_9.799742	387	467	0	80	80	1.0000000
NODE_9632_length_873_cov_3.828165	490	570	0	62	80	0.7750000
NODE_9632_length_873_cov_3.828165	490	570	2	18	80	0.2250000
NODE_9632_length_873_cov_3.828165	543	583	0	9	40	0.2250000
NODE_9632_length_873_cov_3.828165	543	583	2	31	40	0.7750000
NODE_9632_length_873_cov_3.828165	690	735	0	44	45	0.9777778
NODE_9632_length_873_cov_3.828165	690	735	2	1	45	0.0222222
NODE_9633_length_873_cov_3.443152	716	746	0	12	30	0.4000000
NODE_9633_length_873_cov_3.443152	716	746	2	5	30	0.1666667
NODE_9633_length_873_cov_3.443152	716	746	4	13	30	0.4333333
NODE_9647_length_873_cov_1.239018	593	658	0	12	65	0.1846154
NODE_9647_length_873_cov_1.239018	593	658	2	5	65	0.0769231
NODE_9647_length_873_cov_1.239018	593	658	4	11	65	0.1692308
NODE_9647_length_873_cov_1.239018	593	658	6	11	65	0.1692308
NODE_9647_length_873_cov_1.239018	593	658	8	1	65	0.0153846
NODE_9647_length_873_cov_1.239018	593	658	10	25	65	0.3846154
NODE_9651_length_872_cov_47.732212	432	512	0	80	80	1.0000000
NODE_9651_length_872_cov_47.732212	484	564	0	80	80	1.0000000
NODE_9651_length_872_cov_47.732212	560	640	0	69	80	0.8625000
NODE_9651_length_872_cov_47.732212	560	640	2	11	80	0.1375000
NODE_9651_length_872_cov_47.732212	613	693	0	16	80	0.2000000
NODE_9651_length_872_cov_47.732212	613	693	2	64	80	0.8000000
NODE_9652_length_872_cov_16.204398	349	429	0	80	80	1.0000000
NODE_9652_length_872_cov_16.204398	402	482	0	78	80	0.9750000
NODE_9652_length_872_cov_16.204398	402	482	2	2	80	0.0250000
NODE_9652_length_872_cov_16.204398	478	558	0	2	80	0.0250000
NODE_9652_length_872_cov_16.204398	478	558	2	21	80	0.2625000
NODE_9652_length_872_cov_16.204398	478	558	4	57	80	0.7125000
NODE_9652_length_872_cov_16.204398	531	611	4	32	80	0.4000000
NODE_9652_length_872_cov_16.204398	531	611	6	48	80	0.6000000
NODE_9653_length_872_cov_12.835705	376	456	0	80	80	1.0000000
NODE_9653_length_872_cov_12.835705	429	509	0	80	80	1.0000000
NODE_9654_length_872_cov_9.657180	356	431	0	4	75	0.0533333
NODE_9654_length_872_cov_9.657180	356	431	2	18	75	0.2400000
NODE_9654_length_872_cov_9.657180	356	431	4	2	75	0.0266667
NODE_9654_length_872_cov_9.657180	356	431	6	51	75	0.6800000
NODE_9660_length_872_cov_3.531695	425	505	0	40	80	0.5000000
NODE_9660_length_872_cov_3.531695	425	505	2	40	80	0.5000000
NODE_9660_length_872_cov_3.531695	478	559	0	81	81	1.0000000
NODE_9673_length_871_cov_56.841969	265	345	0	80	80	1.0000000
NODE_9673_length_871_cov_56.841969	318	398	0	54	80	0.6750000
NODE_9673_length_871_cov_56.841969	318	398	2	5	80	0.0625000
NODE_9673_length_871_cov_56.841969	318	398	4	10	80	0.1250000
NODE_9673_length_871_cov_56.841969	318	398	6	11	80	0.1375000
NODE_9673_length_871_cov_56.841969	394	474	0	1	80	0.0125000
NODE_9673_length_871_cov_56.841969	394	474	2	20	80	0.2500000
NODE_9673_length_871_cov_56.841969	394	474	4	1	80	0.0125000
NODE_9673_length_871_cov_56.841969	394	474	6	58	80	0.7250000
NODE_9673_length_871_cov_56.841969	447	527	0	54	80	0.6750000
NODE_9673_length_871_cov_56.841969	447	527	2	20	80	0.2500000
NODE_9673_length_871_cov_56.841969	447	527	4	1	80	0.0125000
NODE_9673_length_871_cov_56.841969	447	527	6	5	80	0.0625000
NODE_9674_length_871_cov_47.528497	461	541	0	80	80	1.0000000
NODE_9674_length_871_cov_47.528497	514	594	0	80	80	1.0000000
NODE_9675_length_871_cov_31.145078	326	406	0	75	80	0.9375000
NODE_9675_length_871_cov_31.145078	326	406	2	5	80	0.0625000
NODE_9675_length_871_cov_31.145078	379	459	0	22	80	0.2750000
NODE_9675_length_871_cov_31.145078	379	459	2	58	80	0.7250000
NODE_9676_length_871_cov_27.993523	379	459	0	16	80	0.2000000
NODE_9676_length_871_cov_27.993523	379	459	4	64	80	0.8000000
NODE_9676_length_871_cov_27.993523	432	512	0	25	80	0.3125000
NODE_9676_length_871_cov_27.993523	432	512	3	2	80	0.0250000
NODE_9676_length_871_cov_27.993523	432	512	4	53	80	0.6625000
NODE_9677_length_871_cov_25.954663	463	543	0	80	80	1.0000000
NODE_9677_length_871_cov_25.954663	516	596	0	31	80	0.3875000
NODE_9677_length_871_cov_25.954663	516	596	2	49	80	0.6125000
NODE_9678_length_871_cov_24.069948	492	558	0	66	66	1.0000000
NODE_9678_length_871_cov_24.069948	558	634	0	76	76	1.0000000
NODE_9679_length_871_cov_23.953368	445	522	6	23	77	0.2987013
NODE_9679_length_871_cov_23.953368	445	522	8	7	77	0.0909091
NODE_9679_length_871_cov_23.953368	445	522	10	5	77	0.0649351
NODE_9679_length_871_cov_23.953368	445	522	11	4	77	0.0519481
NODE_9679_length_871_cov_23.953368	445	522	12	1	77	0.0129870
NODE_9679_length_871_cov_23.953368	445	522	13	17	77	0.2207792
NODE_9679_length_871_cov_23.953368	445	522	21	11	77	0.1428571
NODE_9679_length_871_cov_23.953368	445	522	22	2	77	0.0259740
NODE_9679_length_871_cov_23.953368	445	522	23	2	77	0.0259740
NODE_9679_length_871_cov_23.953368	445	522	24	5	77	0.0649351
NODE_9680_length_871_cov_19.304404	335	415	0	80	80	1.0000000
NODE_9680_length_871_cov_19.304404	388	468	0	80	80	1.0000000
NODE_9682_length_871_cov_18.108808	370	450	0	80	80	1.0000000
NODE_9682_length_871_cov_18.108808	423	503	0	80	80	1.0000000
NODE_9683_length_871_cov_17.034974	362	442	2	80	80	1.0000000
NODE_9683_length_871_cov_17.034974	415	495	0	47	80	0.5875000
NODE_9683_length_871_cov_17.034974	415	495	2	33	80	0.4125000
NODE_9684_length_871_cov_16.768135	374	454	2	29	80	0.3625000
NODE_9684_length_871_cov_16.768135	374	454	4	51	80	0.6375000
NODE_9685_length_871_cov_14.196891	267	347	0	33	80	0.4125000
NODE_9685_length_871_cov_14.196891	267	347	2	10	80	0.1250000
NODE_9685_length_871_cov_14.196891	267	347	4	37	80	0.4625000
NODE_9685_length_871_cov_14.196891	320	400	0	3	80	0.0375000
NODE_9685_length_871_cov_14.196891	320	400	2	26	80	0.3250000
NODE_9685_length_871_cov_14.196891	320	400	4	51	80	0.6375000
NODE_9686_length_871_cov_13.443005	246	326	0	15	80	0.1875000
NODE_9686_length_871_cov_13.443005	246	326	4	65	80	0.8125000
NODE_9686_length_871_cov_13.443005	299	322	0	11	23	0.4782609
NODE_9686_length_871_cov_13.443005	299	322	4	12	23	0.5217391
NODE_9687_length_871_cov_11.839378	29	109	0	80	80	1.0000000
NODE_9687_length_871_cov_11.839378	82	149	0	67	67	1.0000000
NODE_9687_length_871_cov_11.839378	331	411	0	80	80	1.0000000
NODE_9687_length_871_cov_11.839378	384	464	0	80	80	1.0000000
NODE_9689_length_871_cov_5.730570	316	373	4	30	57	0.5263158
NODE_9689_length_871_cov_5.730570	316	373	6	27	57	0.4736842
NODE_9694_length_871_cov_3.544041	428	508	0	80	80	1.0000000
NODE_9694_length_871_cov_3.544041	481	561	0	68	80	0.8500000
NODE_9694_length_871_cov_3.544041	481	561	2	12	80	0.1500000
NODE_9716_length_870_cov_43.400778	542	622	0	80	80	1.0000000
NODE_9716_length_870_cov_43.400778	595	675	0	80	80	1.0000000
NODE_9719_length_870_cov_28.249027	442	524	0	60	82	0.7317073
NODE_9719_length_870_cov_28.249027	442	524	2	22	82	0.2682927
NODE_9719_length_870_cov_28.249027	497	577	0	30	80	0.3750000
NODE_9719_length_870_cov_28.249027	497	577	2	50	80	0.6250000
NODE_9720_length_870_cov_26.992218	240	320	0	80	80	1.0000000
NODE_9720_length_870_cov_26.992218	293	373	0	80	80	1.0000000
NODE_9720_length_870_cov_26.992218	369	449	0	80	80	1.0000000
NODE_9720_length_870_cov_26.992218	422	502	0	80	80	1.0000000
NODE_9721_length_870_cov_25.806744	186	237	4	17	51	0.3333333
NODE_9721_length_870_cov_25.806744	186	237	6	34	51	0.6666667
NODE_9721_length_870_cov_25.806744	391	471	0	24	80	0.3000000
NODE_9721_length_870_cov_25.806744	391	471	2	56	80	0.7000000
NODE_9721_length_870_cov_25.806744	444	524	2	58	80	0.7250000
NODE_9721_length_870_cov_25.806744	444	524	3	22	80	0.2750000
NODE_9722_length_870_cov_18.862516	345	425	0	22	80	0.2750000
NODE_9722_length_870_cov_18.862516	345	425	2	20	80	0.2500000
NODE_9722_length_870_cov_18.862516	345	425	4	7	80	0.0875000
NODE_9722_length_870_cov_18.862516	345	425	6	31	80	0.3875000
NODE_9722_length_870_cov_18.862516	398	478	0	11	80	0.1375000
NODE_9722_length_870_cov_18.862516	398	478	2	28	80	0.3500000
NODE_9722_length_870_cov_18.862516	398	478	6	41	80	0.5125000
NODE_9723_length_870_cov_15.686122	330	410	0	11	80	0.1375000
NODE_9723_length_870_cov_15.686122	330	410	2	69	80	0.8625000
NODE_9723_length_870_cov_15.686122	383	463	2	39	80	0.4875000
NODE_9723_length_870_cov_15.686122	383	463	4	41	80	0.5125000
NODE_9725_length_870_cov_13.334630	479	559	0	13	80	0.1625000
NODE_9725_length_870_cov_13.334630	479	559	2	67	80	0.8375000
NODE_9725_length_870_cov_13.334630	532	612	0	66	80	0.8250000
NODE_9725_length_870_cov_13.334630	532	612	2	14	80	0.1750000
NODE_9726_length_870_cov_9.712062	410	490	0	80	80	1.0000000
NODE_9726_length_870_cov_9.712062	463	542	0	79	79	1.0000000
NODE_9728_length_870_cov_7.556420	448	528	0	80	80	1.0000000
NODE_9728_length_870_cov_7.556420	501	581	0	80	80	1.0000000
NODE_9746_length_869_cov_42.784416	395	475	0	10	80	0.1250000
NODE_9746_length_869_cov_42.784416	395	475	2	5	80	0.0625000
NODE_9746_length_869_cov_42.784416	395	475	4	38	80	0.4750000
NODE_9746_length_869_cov_42.784416	395	475	6	27	80	0.3375000
NODE_9746_length_869_cov_42.784416	448	528	0	25	80	0.3125000
NODE_9746_length_869_cov_42.784416	448	528	4	16	80	0.2000000
NODE_9746_length_869_cov_42.784416	448	528	6	39	80	0.4875000
NODE_9747_length_869_cov_29.525974	211	291	0	80	80	1.0000000
NODE_9747_length_869_cov_29.525974	264	344	0	80	80	1.0000000
NODE_9748_length_869_cov_16.258442	389	469	0	80	80	1.0000000
NODE_9748_length_869_cov_16.258442	442	522	0	80	80	1.0000000
NODE_9749_length_869_cov_15.940260	321	401	0	80	80	1.0000000
NODE_9749_length_869_cov_15.940260	374	454	0	80	80	1.0000000
NODE_9750_length_869_cov_9.619481	402	442	81	1	40	0.0250000
NODE_9750_length_869_cov_9.619481	402	442	83	1	40	0.0250000
NODE_9750_length_869_cov_9.619481	402	442	86	1	40	0.0250000
NODE_9750_length_869_cov_9.619481	402	442	88	6	40	0.1500000
NODE_9750_length_869_cov_9.619481	402	442	90	1	40	0.0250000
NODE_9750_length_869_cov_9.619481	402	442	92	2	40	0.0500000
NODE_9750_length_869_cov_9.619481	402	442	94	1	40	0.0250000
NODE_9750_length_869_cov_9.619481	402	442	96	1	40	0.0250000
NODE_9750_length_869_cov_9.619481	402	442	97	1	40	0.0250000
NODE_9750_length_869_cov_9.619481	402	442	98	1	40	0.0250000
NODE_9750_length_869_cov_9.619481	402	442	100	2	40	0.0500000
NODE_9750_length_869_cov_9.619481	402	442	101	3	40	0.0750000
NODE_9750_length_869_cov_9.619481	402	442	106	3	40	0.0750000
NODE_9750_length_869_cov_9.619481	402	442	107	1	40	0.0250000
NODE_9750_length_869_cov_9.619481	402	442	108	4	40	0.1000000
NODE_9750_length_869_cov_9.619481	402	442	109	1	40	0.0250000
NODE_9750_length_869_cov_9.619481	402	442	110	2	40	0.0500000
NODE_9750_length_869_cov_9.619481	402	442	111	1	40	0.0250000
NODE_9750_length_869_cov_9.619481	402	442	112	1	40	0.0250000
NODE_9750_length_869_cov_9.619481	402	442	115	1	40	0.0250000
NODE_9750_length_869_cov_9.619481	402	442	118	1	40	0.0250000
NODE_9750_length_869_cov_9.619481	402	442	130	1	40	0.0250000
NODE_9750_length_869_cov_9.619481	402	442	134	1	40	0.0250000
NODE_9750_length_869_cov_9.619481	402	442	135	2	40	0.0500000
NODE_9751_length_869_cov_7.123377	392	472	0	80	80	1.0000000
NODE_9751_length_869_cov_7.123377	445	525	0	80	80	1.0000000
NODE_9753_length_869_cov_3.658442	310	378	0	68	68	1.0000000
NODE_9777_length_868_cov_57.465540	355	435	0	17	80	0.2125000
NODE_9777_length_868_cov_57.465540	355	435	2	63	80	0.7875000
NODE_9778_length_868_cov_46.509753	0	65	0	1	65	0.0153846
NODE_9778_length_868_cov_46.509753	0	65	2	10	65	0.1538462
NODE_9778_length_868_cov_46.509753	0	65	4	2	65	0.0307692
NODE_9778_length_868_cov_46.509753	0	65	6	52	65	0.8000000
NODE_9778_length_868_cov_46.509753	0	65	0	1	65	0.0153846
NODE_9778_length_868_cov_46.509753	0	65	2	10	65	0.1538462
NODE_9778_length_868_cov_46.509753	0	65	4	2	65	0.0307692
NODE_9778_length_868_cov_46.509753	0	65	6	52	65	0.8000000
NODE_9778_length_868_cov_46.509753	0	65	0	1	65	0.0153846
NODE_9778_length_868_cov_46.509753	0	65	2	10	65	0.1538462
NODE_9778_length_868_cov_46.509753	0	65	4	2	65	0.0307692
NODE_9778_length_868_cov_46.509753	0	65	6	52	65	0.8000000
NODE_9778_length_868_cov_46.509753	0	65	0	1	65	0.0153846
NODE_9778_length_868_cov_46.509753	0	65	2	10	65	0.1538462
NODE_9778_length_868_cov_46.509753	0	65	4	2	65	0.0307692
NODE_9778_length_868_cov_46.509753	0	65	6	52	65	0.8000000
NODE_9778_length_868_cov_46.509753	61	141	2	3	80	0.0375000
NODE_9778_length_868_cov_46.509753	61	141	4	23	80	0.2875000
NODE_9778_length_868_cov_46.509753	61	141	6	54	80	0.6750000
NODE_9778_length_868_cov_46.509753	61	141	2	3	80	0.0375000
NODE_9778_length_868_cov_46.509753	61	141	4	23	80	0.2875000
NODE_9778_length_868_cov_46.509753	61	141	6	54	80	0.6750000
NODE_9778_length_868_cov_46.509753	114	194	0	52	80	0.6500000
NODE_9778_length_868_cov_46.509753	114	194	2	4	80	0.0500000
NODE_9778_length_868_cov_46.509753	114	194	4	23	80	0.2875000
NODE_9778_length_868_cov_46.509753	114	194	6	1	80	0.0125000
NODE_9778_length_868_cov_46.509753	114	194	0	52	80	0.6500000
NODE_9778_length_868_cov_46.509753	114	194	2	4	80	0.0500000
NODE_9778_length_868_cov_46.509753	114	194	4	23	80	0.2875000
NODE_9778_length_868_cov_46.509753	114	194	6	1	80	0.0125000
NODE_9779_length_868_cov_26.092328	318	398	0	27	80	0.3375000
NODE_9779_length_868_cov_26.092328	318	398	2	53	80	0.6625000
NODE_9779_length_868_cov_26.092328	371	451	0	53	80	0.6625000
NODE_9779_length_868_cov_26.092328	371	451	2	27	80	0.3375000
NODE_9781_length_868_cov_22.555267	377	457	0	5	80	0.0625000
NODE_9781_length_868_cov_22.555267	377	457	2	8	80	0.1000000
NODE_9781_length_868_cov_22.555267	377	457	4	15	80	0.1875000
NODE_9781_length_868_cov_22.555267	377	457	5	21	80	0.2625000
NODE_9781_length_868_cov_22.555267	377	457	6	31	80	0.3875000
NODE_9781_length_868_cov_22.555267	430	510	4	30	80	0.3750000
NODE_9781_length_868_cov_22.555267	430	510	6	50	80	0.6250000
NODE_9782_length_868_cov_20.466840	259	339	0	80	80	1.0000000
NODE_9782_length_868_cov_20.466840	312	392	0	80	80	1.0000000
NODE_9782_length_868_cov_20.466840	388	468	0	80	80	1.0000000
NODE_9782_length_868_cov_20.466840	441	521	0	80	80	1.0000000
NODE_9783_length_868_cov_20.414824	311	391	0	80	80	1.0000000
NODE_9783_length_868_cov_20.414824	364	444	0	53	80	0.6625000
NODE_9783_length_868_cov_20.414824	364	444	2	27	80	0.3375000
NODE_9784_length_868_cov_17.613784	340	420	0	25	80	0.3125000
NODE_9784_length_868_cov_17.613784	340	420	2	55	80	0.6875000
NODE_9784_length_868_cov_17.613784	393	473	0	35	80	0.4375000
NODE_9784_length_868_cov_17.613784	393	473	2	45	80	0.5625000
NODE_9785_length_868_cov_15.768531	353	433	0	80	80	1.0000000
NODE_9785_length_868_cov_15.768531	406	486	0	80	80	1.0000000
NODE_9786_length_868_cov_13.997399	611	691	6	80	80	1.0000000
NODE_9786_length_868_cov_13.997399	664	744	0	8	80	0.1000000
NODE_9786_length_868_cov_13.997399	664	744	6	72	80	0.9000000
NODE_9787_length_868_cov_13.224967	451	531	0	24	80	0.3000000
NODE_9787_length_868_cov_13.224967	451	531	2	56	80	0.7000000
NODE_9787_length_868_cov_13.224967	504	583	0	42	79	0.5316456
NODE_9787_length_868_cov_13.224967	504	583	2	37	79	0.4683544
NODE_9788_length_868_cov_11.851756	363	422	0	12	59	0.2033898
NODE_9788_length_868_cov_11.851756	363	422	2	47	59	0.7966102
NODE_9788_length_868_cov_11.851756	395	475	0	36	80	0.4500000
NODE_9788_length_868_cov_11.851756	395	475	2	44	80	0.5500000
NODE_9789_length_868_cov_11.352406	361	441	0	32	80	0.4000000
NODE_9789_length_868_cov_11.352406	361	441	2	48	80	0.6000000
NODE_9789_length_868_cov_11.352406	414	494	0	13	80	0.1625000
NODE_9789_length_868_cov_11.352406	414	494	2	67	80	0.8375000
NODE_9790_length_868_cov_11.335501	289	369	0	6	80	0.0750000
NODE_9790_length_868_cov_11.335501	289	369	2	74	80	0.9250000
NODE_9790_length_868_cov_11.335501	342	422	0	22	80	0.2750000
NODE_9790_length_868_cov_11.335501	342	422	2	58	80	0.7250000
NODE_9791_length_868_cov_8.455137	401	481	2	80	80	1.0000000
NODE_9791_length_868_cov_8.455137	454	534	0	18	80	0.2250000
NODE_9791_length_868_cov_8.455137	454	534	2	62	80	0.7750000
NODE_9816_length_867_cov_27.756510	333	376	0	43	43	1.0000000
NODE_9816_length_867_cov_27.756510	349	429	0	80	80	1.0000000
NODE_9816_length_867_cov_27.756510	425	505	0	80	80	1.0000000
NODE_9816_length_867_cov_27.756510	478	542	0	64	64	1.0000000
NODE_9817_length_867_cov_25.354167	280	345	2	65	65	1.0000000
NODE_9817_length_867_cov_25.354167	325	397	0	51	72	0.7083333
NODE_9817_length_867_cov_25.354167	325	397	2	21	72	0.2916667
NODE_9818_length_867_cov_23.968750	369	449	0	80	80	1.0000000
NODE_9818_length_867_cov_23.968750	422	502	0	80	80	1.0000000
NODE_9819_length_867_cov_21.220052	524	604	0	44	80	0.5500000
NODE_9819_length_867_cov_21.220052	524	604	2	3	80	0.0375000
NODE_9819_length_867_cov_21.220052	524	604	4	33	80	0.4125000
NODE_9819_length_867_cov_21.220052	577	657	4	80	80	1.0000000
NODE_9820_length_867_cov_15.042969	287	364	2	10	77	0.1298701
NODE_9820_length_867_cov_15.042969	287	364	6	25	77	0.3246753
NODE_9820_length_867_cov_15.042969	287	364	8	36	77	0.4675325
NODE_9820_length_867_cov_15.042969	287	364	10	6	77	0.0779221
NODE_9821_length_867_cov_11.057292	305	373	0	68	68	1.0000000
NODE_9821_length_867_cov_11.057292	346	426	0	80	80	1.0000000
NODE_9821_length_867_cov_11.057292	475	555	2	80	80	1.0000000
NODE_9822_length_867_cov_8.127604	347	427	0	80	80	1.0000000
NODE_9822_length_867_cov_8.127604	400	480	0	80	80	1.0000000
NODE_9823_length_867_cov_7.621094	292	372	0	32	80	0.4000000
NODE_9823_length_867_cov_7.621094	292	372	2	48	80	0.6000000
NODE_9823_length_867_cov_7.621094	345	425	0	80	80	1.0000000
NODE_9826_length_867_cov_5.494792	445	525	0	59	80	0.7375000
NODE_9826_length_867_cov_5.494792	445	525	2	21	80	0.2625000
NODE_9826_length_867_cov_5.494792	498	578	0	80	80	1.0000000
NODE_9857_length_866_cov_49.224250	269	349	0	49	80	0.6125000
NODE_9857_length_866_cov_49.224250	269	349	4	31	80	0.3875000
NODE_9857_length_866_cov_49.224250	322	402	4	57	80	0.7125000
NODE_9857_length_866_cov_49.224250	322	402	6	13	80	0.1625000
NODE_9857_length_866_cov_49.224250	322	402	8	10	80	0.1250000
NODE_9858_length_866_cov_47.160365	428	508	0	28	80	0.3500000
NODE_9858_length_866_cov_47.160365	428	508	1	52	80	0.6500000
NODE_9858_length_866_cov_47.160365	481	561	1	37	80	0.4625000
NODE_9858_length_866_cov_47.160365	481	561	2	43	80	0.5375000
NODE_9858_length_866_cov_47.160365	557	637	1	31	80	0.3875000
NODE_9858_length_866_cov_47.160365	557	637	2	49	80	0.6125000
NODE_9858_length_866_cov_47.160365	610	690	0	22	80	0.2750000
NODE_9858_length_866_cov_47.160365	610	690	1	58	80	0.7250000
NODE_9859_length_866_cov_23.398957	281	361	0	71	80	0.8875000
NODE_9859_length_866_cov_23.398957	281	361	2	9	80	0.1125000
NODE_9859_length_866_cov_23.398957	334	414	0	18	80	0.2250000
NODE_9859_length_866_cov_23.398957	334	414	2	62	80	0.7750000
NODE_9860_length_866_cov_22.186441	455	535	0	80	80	1.0000000
NODE_9860_length_866_cov_22.186441	508	588	0	80	80	1.0000000
NODE_9861_length_866_cov_18.362451	451	531	0	80	80	1.0000000
NODE_9861_length_866_cov_18.362451	504	584	0	80	80	1.0000000
NODE_9862_length_866_cov_16.830508	372	452	0	80	80	1.0000000
NODE_9862_length_866_cov_16.830508	425	505	0	80	80	1.0000000
NODE_9882_length_865_cov_63.137076	288	368	2	80	80	1.0000000
NODE_9882_length_865_cov_63.137076	341	421	0	40	80	0.5000000
NODE_9882_length_865_cov_63.137076	341	421	2	40	80	0.5000000
NODE_9883_length_865_cov_19.882507	335	415	0	27	80	0.3375000
NODE_9883_length_865_cov_19.882507	335	415	4	11	80	0.1375000
NODE_9883_length_865_cov_19.882507	335	415	6	22	80	0.2750000
NODE_9883_length_865_cov_19.882507	335	415	8	20	80	0.2500000
NODE_9883_length_865_cov_19.882507	388	468	6	19	80	0.2375000
NODE_9883_length_865_cov_19.882507	388	468	8	61	80	0.7625000
NODE_9884_length_865_cov_17.784595	306	386	0	10	80	0.1250000
NODE_9884_length_865_cov_17.784595	306	386	2	51	80	0.6375000
NODE_9884_length_865_cov_17.784595	306	386	4	19	80	0.2375000
NODE_9884_length_865_cov_17.784595	359	439	2	53	80	0.6625000
NODE_9884_length_865_cov_17.784595	359	439	4	27	80	0.3375000
NODE_9885_length_865_cov_16.150131	451	531	2	12	80	0.1500000
NODE_9885_length_865_cov_16.150131	451	531	4	13	80	0.1625000
NODE_9885_length_865_cov_16.150131	451	531	6	55	80	0.6875000
NODE_9885_length_865_cov_16.150131	504	584	0	8	80	0.1000000
NODE_9885_length_865_cov_16.150131	504	584	2	32	80	0.4000000
NODE_9885_length_865_cov_16.150131	504	584	4	3	80	0.0375000
NODE_9885_length_865_cov_16.150131	504	584	6	37	80	0.4625000
NODE_9886_length_865_cov_14.751958	473	553	0	55	80	0.6875000
NODE_9886_length_865_cov_14.751958	473	553	2	25	80	0.3125000
NODE_9886_length_865_cov_14.751958	473	553	0	55	80	0.6875000
NODE_9886_length_865_cov_14.751958	473	553	2	25	80	0.3125000
NODE_9886_length_865_cov_14.751958	526	589	0	2	63	0.0317460
NODE_9886_length_865_cov_14.751958	526	589	2	61	63	0.9682540
NODE_9886_length_865_cov_14.751958	526	606	0	2	80	0.0250000
NODE_9886_length_865_cov_14.751958	526	606	2	78	80	0.9750000
NODE_9887_length_865_cov_10.937337	422	502	0	80	80	1.0000000
NODE_9887_length_865_cov_10.937337	475	555	0	50	80	0.6250000
NODE_9887_length_865_cov_10.937337	475	555	2	30	80	0.3750000
NODE_9889_length_865_cov_9.167102	389	469	0	43	80	0.5375000
NODE_9889_length_865_cov_9.167102	389	469	2	37	80	0.4625000
NODE_9889_length_865_cov_9.167102	442	522	0	57	80	0.7125000
NODE_9889_length_865_cov_9.167102	442	522	2	11	80	0.1375000
NODE_9889_length_865_cov_9.167102	442	522	4	12	80	0.1500000
NODE_9912_length_864_cov_13.398693	491	571	0	80	80	1.0000000
NODE_9912_length_864_cov_13.398693	544	624	0	80	80	1.0000000
NODE_9913_length_864_cov_8.466667	308	388	0	80	80	1.0000000
NODE_9913_length_864_cov_8.466667	361	441	0	80	80	1.0000000
NODE_9917_length_864_cov_3.947712	651	676	0	25	25	1.0000000
NODE_9917_length_864_cov_3.947712	725	805	3	2	80	0.0250000
NODE_9917_length_864_cov_3.947712	725	805	5	6	80	0.0750000
NODE_9917_length_864_cov_3.947712	725	805	7	2	80	0.0250000
NODE_9917_length_864_cov_3.947712	725	805	8	10	80	0.1250000
NODE_9917_length_864_cov_3.947712	725	805	10	26	80	0.3250000
NODE_9917_length_864_cov_3.947712	725	805	12	34	80	0.4250000
NODE_9917_length_864_cov_3.947712	778	844	0	2	66	0.0303030
NODE_9917_length_864_cov_3.947712	778	844	2	1	66	0.0151515
NODE_9917_length_864_cov_3.947712	778	844	4	4	66	0.0606061
NODE_9917_length_864_cov_3.947712	778	844	6	10	66	0.1515152
NODE_9917_length_864_cov_3.947712	778	844	8	1	66	0.0151515
NODE_9917_length_864_cov_3.947712	778	844	10	39	66	0.5909091
NODE_9917_length_864_cov_3.947712	778	844	12	9	66	0.1363636
NODE_9931_length_863_cov_72.856021	241	321	0	80	80	1.0000000
NODE_9931_length_863_cov_72.856021	294	374	0	78	80	0.9750000
NODE_9931_length_863_cov_72.856021	294	374	2	2	80	0.0250000
NODE_9931_length_863_cov_72.856021	370	450	0	2	80	0.0250000
NODE_9931_length_863_cov_72.856021	370	450	2	55	80	0.6875000
NODE_9931_length_863_cov_72.856021	370	450	8	23	80	0.2875000
NODE_9931_length_863_cov_72.856021	423	503	2	4	80	0.0500000
NODE_9931_length_863_cov_72.856021	423	503	6	37	80	0.4625000
NODE_9931_length_863_cov_72.856021	423	503	8	39	80	0.4875000
NODE_9932_length_863_cov_37.130890	363	443	0	80	80	1.0000000
NODE_9932_length_863_cov_37.130890	416	496	0	80	80	1.0000000
NODE_9932_length_863_cov_37.130890	492	572	0	80	80	1.0000000
NODE_9932_length_863_cov_37.130890	545	617	0	66	72	0.9166667
NODE_9932_length_863_cov_37.130890	545	617	2	2	72	0.0277778
NODE_9932_length_863_cov_37.130890	545	617	4	2	72	0.0277778
NODE_9932_length_863_cov_37.130890	545	617	8	1	72	0.0138889
NODE_9932_length_863_cov_37.130890	545	617	27	1	72	0.0138889
NODE_9933_length_863_cov_33.159686	287	367	0	20	80	0.2500000
NODE_9933_length_863_cov_33.159686	287	367	2	1	80	0.0125000
NODE_9933_length_863_cov_33.159686	287	367	7	38	80	0.4750000
NODE_9933_length_863_cov_33.159686	287	367	9	8	80	0.1000000
NODE_9933_length_863_cov_33.159686	287	367	11	2	80	0.0250000
NODE_9933_length_863_cov_33.159686	287	367	12	11	80	0.1375000
NODE_9933_length_863_cov_33.159686	340	420	7	6	80	0.0750000
NODE_9933_length_863_cov_33.159686	340	420	9	8	80	0.1000000
NODE_9933_length_863_cov_33.159686	340	420	10	10	80	0.1250000
NODE_9933_length_863_cov_33.159686	340	420	11	2	80	0.0250000
NODE_9933_length_863_cov_33.159686	340	420	12	38	80	0.4750000
NODE_9933_length_863_cov_33.159686	340	420	14	16	80	0.2000000
NODE_9934_length_863_cov_24.714660	370	450	0	80	80	1.0000000
NODE_9934_length_863_cov_24.714660	423	503	0	80	80	1.0000000
NODE_9935_length_863_cov_21.945026	341	421	0	80	80	1.0000000
NODE_9935_length_863_cov_21.945026	394	474	0	80	80	1.0000000
NODE_9936_length_863_cov_19.794503	393	473	0	80	80	1.0000000
NODE_9936_length_863_cov_19.794503	446	526	0	43	80	0.5375000
NODE_9936_length_863_cov_19.794503	446	526	2	37	80	0.4625000
NODE_9937_length_863_cov_11.778796	303	383	0	5	80	0.0625000
NODE_9937_length_863_cov_11.778796	303	383	2	75	80	0.9375000
NODE_9937_length_863_cov_11.778796	356	436	0	44	80	0.5500000
NODE_9937_length_863_cov_11.778796	356	436	2	36	80	0.4500000
NODE_9938_length_863_cov_10.026178	283	363	0	46	80	0.5750000
NODE_9938_length_863_cov_10.026178	283	363	2	2	80	0.0250000
NODE_9938_length_863_cov_10.026178	283	363	4	32	80	0.4000000
NODE_9938_length_863_cov_10.026178	336	416	2	27	80	0.3375000
NODE_9938_length_863_cov_10.026178	336	416	4	53	80	0.6625000
NODE_9957_length_862_cov_46.811271	272	352	0	80	80	1.0000000
NODE_9957_length_862_cov_46.811271	325	405	0	80	80	1.0000000
NODE_9957_length_862_cov_46.811271	401	481	0	80	80	1.0000000
NODE_9957_length_862_cov_46.811271	454	534	0	80	80	1.0000000
NODE_9958_length_862_cov_34.638270	259	339	0	15	80	0.1875000
NODE_9958_length_862_cov_34.638270	259	339	2	65	80	0.8125000
NODE_9958_length_862_cov_34.638270	312	392	0	68	80	0.8500000
NODE_9958_length_862_cov_34.638270	312	392	2	12	80	0.1500000
NODE_9958_length_862_cov_34.638270	388	468	0	80	80	1.0000000
NODE_9958_length_862_cov_34.638270	441	521	0	80	80	1.0000000
NODE_9959_length_862_cov_32.068152	468	548	0	4	80	0.0500000
NODE_9959_length_862_cov_32.068152	468	548	2	76	80	0.9500000
NODE_9959_length_862_cov_32.068152	521	601	0	44	80	0.5500000
NODE_9959_length_862_cov_32.068152	521	601	2	36	80	0.4500000
NODE_9960_length_862_cov_23.584535	526	606	0	26	80	0.3250000
NODE_9960_length_862_cov_23.584535	526	606	2	54	80	0.6750000
NODE_9960_length_862_cov_23.584535	579	659	0	11	80	0.1375000
NODE_9960_length_862_cov_23.584535	579	659	2	69	80	0.8625000
NODE_9961_length_862_cov_19.980341	347	427	0	2	80	0.0250000
NODE_9961_length_862_cov_19.980341	347	427	2	78	80	0.9750000
NODE_9961_length_862_cov_19.980341	400	480	0	22	80	0.2750000
NODE_9961_length_862_cov_19.980341	400	480	2	58	80	0.7250000
NODE_9962_length_862_cov_19.079948	379	459	0	80	80	1.0000000
NODE_9962_length_862_cov_19.079948	432	512	0	80	80	1.0000000
NODE_9963_length_862_cov_18.425950	94	174	0	80	80	1.0000000
NODE_9963_length_862_cov_18.425950	147	201	0	54	54	1.0000000
NODE_9963_length_862_cov_18.425950	392	472	2	48	80	0.6000000
NODE_9963_length_862_cov_18.425950	392	472	4	32	80	0.4000000
NODE_9963_length_862_cov_18.425950	445	525	2	46	80	0.5750000
NODE_9963_length_862_cov_18.425950	445	525	4	34	80	0.4250000
NODE_9964_length_862_cov_11.740498	348	428	0	80	80	1.0000000
NODE_9964_length_862_cov_11.740498	401	481	0	80	80	1.0000000
NODE_9965_length_862_cov_11.685452	292	372	0	34	80	0.4250000
NODE_9965_length_862_cov_11.685452	292	372	2	46	80	0.5750000
NODE_9965_length_862_cov_11.685452	345	425	2	80	80	1.0000000
NODE_9966_length_862_cov_8.259502	385	465	0	80	80	1.0000000
NODE_9966_length_862_cov_8.259502	438	518	0	80	80	1.0000000
NODE_9970_length_862_cov_2.895151	388	468	0	80	80	1.0000000
NODE_9970_length_862_cov_2.895151	441	521	0	80	80	1.0000000
NODE_9984_length_861_cov_52.679790	450	530	0	80	80	1.0000000
NODE_9984_length_861_cov_52.679790	503	583	0	80	80	1.0000000
NODE_9985_length_861_cov_34.868766	470	550	2	13	80	0.1625000
NODE_9985_length_861_cov_34.868766	470	550	4	10	80	0.1250000
NODE_9985_length_861_cov_34.868766	470	550	6	57	80	0.7125000
NODE_9985_length_861_cov_34.868766	523	603	0	38	80	0.4750000
NODE_9985_length_861_cov_34.868766	523	603	2	28	80	0.3500000
NODE_9985_length_861_cov_34.868766	523	603	4	4	80	0.0500000
NODE_9985_length_861_cov_34.868766	523	603	6	10	80	0.1250000
NODE_9986_length_861_cov_25.622047	145	225	0	80	80	1.0000000
NODE_9986_length_861_cov_25.622047	198	278	0	80	80	1.0000000
NODE_9987_length_861_cov_22.052493	401	481	0	30	80	0.3750000
NODE_9987_length_861_cov_22.052493	401	481	2	50	80	0.6250000
NODE_9987_length_861_cov_22.052493	454	534	0	80	80	1.0000000
NODE_9988_length_861_cov_19.913386	400	480	0	80	80	1.0000000
NODE_9988_length_861_cov_19.913386	453	533	0	80	80	1.0000000
NODE_9989_length_861_cov_15.237533	492	572	0	70	80	0.8750000
NODE_9989_length_861_cov_15.237533	492	572	2	10	80	0.1250000
NODE_9989_length_861_cov_15.237533	545	625	0	80	80	1.0000000
NODE_9990_length_861_cov_12.460630	451	531	0	16	80	0.2000000
NODE_9990_length_861_cov_12.460630	451	531	2	64	80	0.8000000
NODE_9990_length_861_cov_12.460630	504	584	0	4	80	0.0500000
NODE_9990_length_861_cov_12.460630	504	584	2	76	80	0.9500000
NODE_9991_length_861_cov_9.463255	446	526	0	80	80	1.0000000
NODE_9991_length_861_cov_9.463255	499	579	0	80	80	1.0000000
NODE_9992_length_861_cov_9.435696	348	423	0	2	75	0.0266667
NODE_9992_length_861_cov_9.435696	348	423	2	73	75	0.9733334
NODE_9993_length_861_cov_7.009186	51	91	0	40	40	1.0000000
NODE_9993_length_861_cov_7.009186	185	265	0	80	80	1.0000000
NODE_9993_length_861_cov_7.009186	238	318	0	80	80	1.0000000
NODE_10019_length_860_cov_54.315375	245	325	0	80	80	1.0000000
NODE_10019_length_860_cov_54.315375	298	378	0	80	80	1.0000000
NODE_10019_length_860_cov_54.315375	374	454	0	12	80	0.1500000
NODE_10019_length_860_cov_54.315375	374	454	2	68	80	0.8500000
NODE_10019_length_860_cov_54.315375	427	507	0	24	80	0.3000000
NODE_10019_length_860_cov_54.315375	427	507	2	56	80	0.7000000
NODE_10020_length_860_cov_29.618922	356	436	0	80	80	1.0000000
NODE_10020_length_860_cov_29.618922	409	489	0	80	80	1.0000000
NODE_10021_length_860_cov_15.152431	393	473	0	46	80	0.5750000
NODE_10021_length_860_cov_15.152431	393	473	2	34	80	0.4250000
NODE_10021_length_860_cov_15.152431	446	526	0	72	80	0.9000000
NODE_10021_length_860_cov_15.152431	446	526	2	8	80	0.1000000
NODE_10022_length_860_cov_11.320631	343	423	0	80	80	1.0000000
NODE_10022_length_860_cov_11.320631	396	476	0	80	80	1.0000000
NODE_10049_length_859_cov_48.173684	432	512	4	33	80	0.4125000
NODE_10049_length_859_cov_48.173684	432	512	6	47	80	0.5875000
NODE_10049_length_859_cov_48.173684	485	565	0	26	80	0.3250000
NODE_10049_length_859_cov_48.173684	485	565	2	12	80	0.1500000
NODE_10049_length_859_cov_48.173684	485	565	4	28	80	0.3500000
NODE_10049_length_859_cov_48.173684	485	565	6	14	80	0.1750000
NODE_10050_length_859_cov_24.957895	402	482	0	11	80	0.1375000
NODE_10050_length_859_cov_24.957895	402	482	2	69	80	0.8625000
NODE_10050_length_859_cov_24.957895	455	535	0	56	80	0.7000000
NODE_10050_length_859_cov_24.957895	455	535	2	24	80	0.3000000
NODE_10051_length_859_cov_23.431579	251	331	0	24	80	0.3000000
NODE_10051_length_859_cov_23.431579	251	331	2	56	80	0.7000000
NODE_10051_length_859_cov_23.431579	304	384	2	60	80	0.7500000
NODE_10051_length_859_cov_23.431579	304	384	4	20	80	0.2500000
NODE_10052_length_859_cov_20.523684	341	421	2	41	80	0.5125000
NODE_10052_length_859_cov_20.523684	341	421	4	39	80	0.4875000
NODE_10052_length_859_cov_20.523684	394	474	0	40	80	0.5000000
NODE_10052_length_859_cov_20.523684	394	474	2	40	80	0.5000000
NODE_10053_length_859_cov_17.996053	316	396	0	35	80	0.4375000
NODE_10053_length_859_cov_17.996053	316	396	2	45	80	0.5625000
NODE_10053_length_859_cov_17.996053	369	449	0	33	80	0.4125000
NODE_10053_length_859_cov_17.996053	369	449	2	47	80	0.5875000
NODE_10054_length_859_cov_16.757895	404	484	0	80	80	1.0000000
NODE_10054_length_859_cov_16.757895	457	537	0	80	80	1.0000000
NODE_10055_length_859_cov_15.852632	346	426	0	51	80	0.6375000
NODE_10055_length_859_cov_15.852632	346	426	2	29	80	0.3625000
NODE_10055_length_859_cov_15.852632	399	479	0	42	80	0.5250000
NODE_10055_length_859_cov_15.852632	399	479	2	38	80	0.4750000
NODE_10056_length_859_cov_11.584211	407	487	0	10	80	0.1250000
NODE_10056_length_859_cov_11.584211	407	487	2	70	80	0.8750000
NODE_10056_length_859_cov_11.584211	460	540	0	41	80	0.5125000
NODE_10056_length_859_cov_11.584211	460	540	2	39	80	0.4875000
NODE_10057_length_859_cov_10.296053	368	448	0	68	80	0.8500000
NODE_10057_length_859_cov_10.296053	368	448	2	12	80	0.1500000
NODE_10057_length_859_cov_10.296053	421	501	0	15	80	0.1875000
NODE_10057_length_859_cov_10.296053	421	501	2	65	80	0.8125000
NODE_10066_length_859_cov_2.359211	498	578	0	80	80	1.0000000
NODE_10066_length_859_cov_2.359211	551	631	0	80	80	1.0000000
NODE_10079_length_858_cov_54.677207	277	357	0	80	80	1.0000000
NODE_10079_length_858_cov_54.677207	330	410	0	80	80	1.0000000
NODE_10080_length_858_cov_40.584980	500	580	4	20	80	0.2500000
NODE_10080_length_858_cov_40.584980	500	580	6	29	80	0.3625000
NODE_10080_length_858_cov_40.584980	500	580	8	31	80	0.3875000
NODE_10080_length_858_cov_40.584980	553	633	2	52	80	0.6500000
NODE_10080_length_858_cov_40.584980	553	633	4	11	80	0.1375000
NODE_10080_length_858_cov_40.584980	553	633	6	15	80	0.1875000
NODE_10080_length_858_cov_40.584980	553	633	8	2	80	0.0250000
NODE_10081_length_858_cov_30.177866	363	443	2	80	80	1.0000000
NODE_10081_length_858_cov_30.177866	416	496	0	48	80	0.6000000
NODE_10081_length_858_cov_30.177866	416	496	2	32	80	0.4000000
NODE_10081_length_858_cov_30.177866	492	572	0	67	80	0.8375000
NODE_10081_length_858_cov_30.177866	492	572	2	13	80	0.1625000
NODE_10081_length_858_cov_30.177866	545	625	0	14	80	0.1750000
NODE_10081_length_858_cov_30.177866	545	625	2	66	80	0.8250000
NODE_10082_length_858_cov_18.534914	371	451	0	80	80	1.0000000
NODE_10082_length_858_cov_18.534914	424	504	0	56	80	0.7000000
NODE_10082_length_858_cov_18.534914	424	504	2	24	80	0.3000000
NODE_10083_length_858_cov_15.378129	232	312	0	46	80	0.5750000
NODE_10083_length_858_cov_15.378129	232	312	2	32	80	0.4000000
NODE_10083_length_858_cov_15.378129	232	312	4	2	80	0.0250000
NODE_10083_length_858_cov_15.378129	285	365	2	25	80	0.3125000
NODE_10083_length_858_cov_15.378129	285	365	4	28	80	0.3500000
NODE_10083_length_858_cov_15.378129	285	365	6	27	80	0.3375000
NODE_10084_length_858_cov_12.310935	335	415	4	12	80	0.1500000
NODE_10084_length_858_cov_12.310935	335	415	6	50	80	0.6250000
NODE_10084_length_858_cov_12.310935	335	415	8	18	80	0.2250000
NODE_10084_length_858_cov_12.310935	388	468	0	47	80	0.5875000
NODE_10084_length_858_cov_12.310935	388	468	4	18	80	0.2250000
NODE_10084_length_858_cov_12.310935	388	468	6	15	80	0.1875000
NODE_10085_length_858_cov_7.835310	396	479	0	83	83	1.0000000
NODE_10085_length_858_cov_7.835310	452	532	0	80	80	1.0000000
NODE_10088_length_858_cov_4.953887	474	554	0	80	80	1.0000000
NODE_10088_length_858_cov_4.953887	527	607	0	80	80	1.0000000
NODE_10091_length_858_cov_3.475626	428	502	0	6	74	0.0810811
NODE_10091_length_858_cov_3.475626	428	502	2	68	74	0.9189189
NODE_10091_length_858_cov_3.475626	498	578	0	8	80	0.1000000
NODE_10091_length_858_cov_3.475626	498	578	2	72	80	0.9000000
NODE_10091_length_858_cov_3.475626	551	631	0	7	80	0.0875000
NODE_10091_length_858_cov_3.475626	551	631	2	73	80	0.9125000
NODE_10108_length_857_cov_33.449868	384	455	2	5	71	0.0704225
NODE_10108_length_857_cov_33.449868	384	455	4	1	71	0.0140845
NODE_10108_length_857_cov_33.449868	384	455	8	5	71	0.0704225
NODE_10108_length_857_cov_33.449868	384	455	10	60	71	0.8450704
NODE_10108_length_857_cov_33.449868	437	518	2	40	81	0.4938272
NODE_10108_length_857_cov_33.449868	437	518	4	24	81	0.2962963
NODE_10108_length_857_cov_33.449868	437	518	8	5	81	0.0617284
NODE_10108_length_857_cov_33.449868	437	518	10	12	81	0.1481481
NODE_10109_length_857_cov_32.527704	391	471	0	5	80	0.0625000
NODE_10109_length_857_cov_32.527704	391	471	2	41	80	0.5125000
NODE_10109_length_857_cov_32.527704	391	471	4	34	80	0.4250000
NODE_10109_length_857_cov_32.527704	444	524	2	36	80	0.4500000
NODE_10109_length_857_cov_32.527704	444	524	4	44	80	0.5500000
NODE_10110_length_857_cov_27.853562	310	390	0	76	80	0.9500000
NODE_10110_length_857_cov_27.853562	310	390	2	4	80	0.0500000
NODE_10110_length_857_cov_27.853562	363	443	0	23	80	0.2875000
NODE_10110_length_857_cov_27.853562	363	443	2	57	80	0.7125000
NODE_10111_length_857_cov_24.654354	282	362	0	58	80	0.7250000
NODE_10111_length_857_cov_24.654354	282	362	2	22	80	0.2750000
NODE_10111_length_857_cov_24.654354	335	415	0	5	80	0.0625000
NODE_10111_length_857_cov_24.654354	335	415	2	75	80	0.9375000
NODE_10112_length_857_cov_22.604222	374	456	0	82	82	1.0000000
NODE_10112_length_857_cov_22.604222	427	509	0	82	82	1.0000000
NODE_10113_length_857_cov_17.399736	320	400	0	80	80	1.0000000
NODE_10113_length_857_cov_17.399736	373	453	0	80	80	1.0000000
NODE_10114_length_857_cov_17.069921	388	468	6	30	80	0.3750000
NODE_10114_length_857_cov_17.069921	388	468	10	4	80	0.0500000
NODE_10114_length_857_cov_17.069921	388	468	12	7	80	0.0875000
NODE_10114_length_857_cov_17.069921	388	468	14	39	80	0.4875000
NODE_10114_length_857_cov_17.069921	441	521	0	21	80	0.2625000
NODE_10114_length_857_cov_17.069921	441	521	4	16	80	0.2000000
NODE_10114_length_857_cov_17.069921	441	521	6	43	80	0.5375000
NODE_10115_length_857_cov_11.816623	433	513	2	50	80	0.6250000
NODE_10115_length_857_cov_11.816623	433	513	4	30	80	0.3750000
NODE_10115_length_857_cov_11.816623	486	566	0	26	80	0.3250000
NODE_10115_length_857_cov_11.816623	486	566	2	54	80	0.6750000
NODE_10116_length_857_cov_6.733509	513	593	0	80	80	1.0000000
NODE_10117_length_857_cov_6.251979	298	378	0	80	80	1.0000000
NODE_10117_length_857_cov_6.251979	351	431	0	80	80	1.0000000
NODE_10118_length_857_cov_5.827177	323	403	0	80	80	1.0000000
NODE_10118_length_857_cov_5.827177	376	456	0	80	80	1.0000000
NODE_10120_length_857_cov_4.530343	362	442	0	80	80	1.0000000
NODE_10120_length_857_cov_4.530343	415	495	0	80	80	1.0000000
NODE_10128_length_857_cov_1.464380	179	249	12	3	70	0.0428571
NODE_10128_length_857_cov_1.464380	179	249	14	1	70	0.0142857
NODE_10128_length_857_cov_1.464380	179	249	16	2	70	0.0285714
NODE_10128_length_857_cov_1.464380	179	249	18	4	70	0.0571429
NODE_10128_length_857_cov_1.464380	179	249	20	10	70	0.1428571
NODE_10128_length_857_cov_1.464380	179	249	22	44	70	0.6285715
NODE_10128_length_857_cov_1.464380	179	249	24	6	70	0.0857143
NODE_10128_length_857_cov_1.464380	222	288	10	1	66	0.0151515
NODE_10128_length_857_cov_1.464380	222	288	12	1	66	0.0151515
NODE_10128_length_857_cov_1.464380	222	288	14	6	66	0.0909091
NODE_10128_length_857_cov_1.464380	222	288	16	3	66	0.0454545
NODE_10128_length_857_cov_1.464380	222	288	18	12	66	0.1818182
NODE_10128_length_857_cov_1.464380	222	288	20	22	66	0.3333333
NODE_10128_length_857_cov_1.464380	222	288	22	18	66	0.2727273
NODE_10128_length_857_cov_1.464380	222	288	24	3	66	0.0454545
NODE_10138_length_856_cov_39.147952	157	237	0	13	80	0.1625000
NODE_10138_length_856_cov_39.147952	157	237	2	59	80	0.7375000
NODE_10138_length_856_cov_39.147952	157	237	4	8	80	0.1000000
NODE_10138_length_856_cov_39.147952	210	290	2	63	80	0.7875000
NODE_10138_length_856_cov_39.147952	210	290	4	17	80	0.2125000
NODE_10138_length_856_cov_39.147952	286	366	0	31	80	0.3875000
NODE_10138_length_856_cov_39.147952	286	366	1	1	80	0.0125000
NODE_10138_length_856_cov_39.147952	286	366	2	48	80	0.6000000
NODE_10138_length_856_cov_39.147952	339	419	0	80	80	1.0000000
NODE_10139_length_856_cov_21.937913	353	433	2	14	80	0.1750000
NODE_10139_length_856_cov_21.937913	353	433	4	66	80	0.8250000
NODE_10139_length_856_cov_21.937913	406	486	0	22	80	0.2750000
NODE_10139_length_856_cov_21.937913	406	486	2	45	80	0.5625000
NODE_10139_length_856_cov_21.937913	406	486	4	13	80	0.1625000
NODE_10140_length_856_cov_20.227213	375	459	0	43	84	0.5119048
NODE_10140_length_856_cov_20.227213	375	459	2	41	84	0.4880952
NODE_10140_length_856_cov_20.227213	432	512	2	80	80	1.0000000
NODE_10141_length_856_cov_18.445178	340	420	0	14	80	0.1750000
NODE_10141_length_856_cov_18.445178	340	420	1	12	80	0.1500000
NODE_10141_length_856_cov_18.445178	340	420	2	54	80	0.6750000
NODE_10141_length_856_cov_18.445178	393	473	0	67	80	0.8375000
NODE_10141_length_856_cov_18.445178	393	473	1	12	80	0.1500000
NODE_10141_length_856_cov_18.445178	393	473	2	1	80	0.0125000
NODE_10142_length_856_cov_16.564069	462	543	0	81	81	1.0000000
NODE_10142_length_856_cov_16.564069	516	596	0	80	80	1.0000000
NODE_10142_length_856_cov_16.564069	516	593	0	77	77	1.0000000
NODE_10143_length_856_cov_15.803170	403	483	0	2	80	0.0250000
NODE_10143_length_856_cov_15.803170	403	483	6	78	80	0.9750000
NODE_10143_length_856_cov_15.803170	456	536	0	25	80	0.3125000
NODE_10143_length_856_cov_15.803170	456	536	2	12	80	0.1500000
NODE_10143_length_856_cov_15.803170	456	536	6	43	80	0.5375000
NODE_10144_length_856_cov_12.904888	345	425	2	80	80	1.0000000
NODE_10144_length_856_cov_12.904888	398	478	0	34	80	0.4250000
NODE_10144_length_856_cov_12.904888	398	478	2	46	80	0.5750000
NODE_10145_length_856_cov_9.881110	338	418	0	80	80	1.0000000
NODE_10145_length_856_cov_9.881110	391	471	0	80	80	1.0000000
NODE_10146_length_856_cov_5.875826	405	485	0	14	80	0.1750000
NODE_10146_length_856_cov_5.875826	405	485	2	66	80	0.8250000
NODE_10146_length_856_cov_5.875826	458	538	0	67	80	0.8375000
NODE_10146_length_856_cov_5.875826	458	538	2	13	80	0.1625000
NODE_10149_length_856_cov_4.821664	466	546	0	80	80	1.0000000
NODE_10149_length_856_cov_4.821664	519	599	0	80	80	1.0000000
NODE_10151_length_856_cov_4.195509	248	328	0	80	80	1.0000000
NODE_10151_length_856_cov_4.195509	301	381	0	80	80	1.0000000
NODE_10152_length_856_cov_3.899604	262	339	0	77	77	1.0000000
NODE_10152_length_856_cov_3.899604	312	392	0	44	80	0.5500000
NODE_10152_length_856_cov_3.899604	312	392	2	36	80	0.4500000
NODE_10176_length_855_cov_28.312169	541	621	0	12	80	0.1500000
NODE_10176_length_855_cov_28.312169	541	621	2	68	80	0.8500000
NODE_10176_length_855_cov_28.312169	594	674	0	13	80	0.1625000
NODE_10176_length_855_cov_28.312169	594	674	2	67	80	0.8375000
NODE_10177_length_855_cov_19.392857	692	772	0	15	80	0.1875000
NODE_10177_length_855_cov_19.392857	692	772	1	1	80	0.0125000
NODE_10177_length_855_cov_19.392857	692	772	2	64	80	0.8000000
NODE_10177_length_855_cov_19.392857	745	825	2	80	80	1.0000000
NODE_10178_length_855_cov_13.402116	343	423	0	23	80	0.2875000
NODE_10178_length_855_cov_13.402116	343	423	4	57	80	0.7125000
NODE_10178_length_855_cov_13.402116	396	476	0	38	80	0.4750000
NODE_10178_length_855_cov_13.402116	396	476	4	42	80	0.5250000
NODE_10179_length_855_cov_13.116402	295	375	0	22	80	0.2750000
NODE_10179_length_855_cov_13.116402	295	375	2	58	80	0.7250000
NODE_10179_length_855_cov_13.116402	348	428	0	35	80	0.4375000
NODE_10179_length_855_cov_13.116402	348	428	2	45	80	0.5625000
NODE_10180_length_855_cov_11.179894	360	436	0	76	76	1.0000000
NODE_10180_length_855_cov_11.179894	409	489	0	80	80	1.0000000
NODE_10183_length_855_cov_8.593915	339	419	0	80	80	1.0000000
NODE_10183_length_855_cov_8.593915	392	472	0	80	80	1.0000000
NODE_10206_length_854_cov_64.200000	586	666	6	69	80	0.8625000
NODE_10206_length_854_cov_64.200000	586	666	8	11	80	0.1375000
NODE_10206_length_854_cov_64.200000	639	719	0	12	80	0.1500000
NODE_10206_length_854_cov_64.200000	639	719	2	24	80	0.3000000
NODE_10206_length_854_cov_64.200000	639	719	6	33	80	0.4125000
NODE_10206_length_854_cov_64.200000	639	719	8	11	80	0.1375000
NODE_10207_length_854_cov_46.037086	348	428	0	10	80	0.1250000
NODE_10207_length_854_cov_46.037086	348	428	1	1	80	0.0125000
NODE_10207_length_854_cov_46.037086	348	428	2	11	80	0.1375000
NODE_10207_length_854_cov_46.037086	348	428	4	30	80	0.3750000
NODE_10207_length_854_cov_46.037086	348	428	6	23	80	0.2875000
NODE_10207_length_854_cov_46.037086	348	428	8	5	80	0.0625000
NODE_10207_length_854_cov_46.037086	401	481	6	38	80	0.4750000
NODE_10207_length_854_cov_46.037086	401	481	8	42	80	0.5250000
NODE_10207_length_854_cov_46.037086	458	481	6	15	23	0.6521739
NODE_10207_length_854_cov_46.037086	458	481	8	8	23	0.3478261
NODE_10208_length_854_cov_45.633113	393	473	0	43	80	0.5375000
NODE_10208_length_854_cov_45.633113	393	473	2	30	80	0.3750000
NODE_10208_length_854_cov_45.633113	393	473	4	7	80	0.0875000
NODE_10208_length_854_cov_45.633113	446	526	2	20	80	0.2500000
NODE_10208_length_854_cov_45.633113	446	526	4	60	80	0.7500000
NODE_10209_length_854_cov_40.407947	489	569	0	80	80	1.0000000
NODE_10209_length_854_cov_40.407947	542	622	0	80	80	1.0000000
NODE_10210_length_854_cov_29.773510	450	530	0	80	80	1.0000000
NODE_10210_length_854_cov_29.773510	503	583	0	80	80	1.0000000
NODE_10211_length_854_cov_22.968212	318	398	0	80	80	1.0000000
NODE_10211_length_854_cov_22.968212	371	451	0	80	80	1.0000000
NODE_10212_length_854_cov_18.038411	387	467	2	37	80	0.4625000
NODE_10212_length_854_cov_18.038411	387	467	4	43	80	0.5375000
NODE_10212_length_854_cov_18.038411	440	520	0	18	80	0.2250000
NODE_10212_length_854_cov_18.038411	440	520	2	44	80	0.5500000
NODE_10212_length_854_cov_18.038411	440	520	4	18	80	0.2250000
NODE_10213_length_854_cov_13.774834	330	410	2	80	80	1.0000000
NODE_10213_length_854_cov_13.774834	383	463	0	31	80	0.3875000
NODE_10213_length_854_cov_13.774834	383	463	2	27	80	0.3375000
NODE_10213_length_854_cov_13.774834	383	463	4	22	80	0.2750000
NODE_10214_length_854_cov_11.998675	366	446	2	80	80	1.0000000
NODE_10214_length_854_cov_11.998675	419	499	0	35	80	0.4375000
NODE_10214_length_854_cov_11.998675	419	499	2	45	80	0.5625000
NODE_10215_length_854_cov_7.600000	298	378	0	80	80	1.0000000
NODE_10215_length_854_cov_7.600000	351	431	0	80	80	1.0000000
NODE_10218_length_854_cov_4.939073	603	633	0	30	30	1.0000000
NODE_10226_length_854_cov_2.354967	613	633	0	6	20	0.3000000
NODE_10226_length_854_cov_2.354967	613	633	2	14	20	0.7000000
NODE_10239_length_853_cov_61.988064	380	460	0	20	80	0.2500000
NODE_10239_length_853_cov_61.988064	380	460	2	1	80	0.0125000
NODE_10239_length_853_cov_61.988064	380	460	3	59	80	0.7375000
NODE_10239_length_853_cov_61.988064	433	513	0	73	80	0.9125000
NODE_10239_length_853_cov_61.988064	433	513	2	1	80	0.0125000
NODE_10239_length_853_cov_61.988064	433	513	3	6	80	0.0750000
NODE_10240_length_853_cov_33.683024	384	464	0	6	80	0.0750000
NODE_10240_length_853_cov_33.683024	384	464	2	31	80	0.3875000
NODE_10240_length_853_cov_33.683024	384	464	4	43	80	0.5375000
NODE_10240_length_853_cov_33.683024	437	517	0	4	80	0.0500000
NODE_10240_length_853_cov_33.683024	437	517	2	42	80	0.5250000
NODE_10240_length_853_cov_33.683024	437	517	4	34	80	0.4250000
NODE_10241_length_853_cov_31.965517	224	305	0	43	81	0.5308642
NODE_10241_length_853_cov_31.965517	224	305	2	3	81	0.0370370
NODE_10241_length_853_cov_31.965517	224	305	4	6	81	0.0740741
NODE_10241_length_853_cov_31.965517	224	305	6	26	81	0.3209876
NODE_10241_length_853_cov_31.965517	224	305	8	3	81	0.0370370
NODE_10241_length_853_cov_31.965517	278	358	6	39	80	0.4875000
NODE_10241_length_853_cov_31.965517	278	358	8	41	80	0.5125000
NODE_10241_length_853_cov_31.965517	354	434	0	26	80	0.3250000
NODE_10241_length_853_cov_31.965517	354	434	2	22	80	0.2750000
NODE_10241_length_853_cov_31.965517	354	434	4	26	80	0.3250000
NODE_10241_length_853_cov_31.965517	354	434	6	6	80	0.0750000
NODE_10241_length_853_cov_31.965517	407	466	0	58	59	0.9830508
NODE_10241_length_853_cov_31.965517	407	466	2	1	59	0.0169492
NODE_10242_length_853_cov_16.551724	247	327	0	47	80	0.5875000
NODE_10242_length_853_cov_16.551724	247	327	2	2	80	0.0250000
NODE_10242_length_853_cov_16.551724	247	327	4	1	80	0.0125000
NODE_10242_length_853_cov_16.551724	247	327	6	30	80	0.3750000
NODE_10242_length_853_cov_16.551724	300	380	0	80	80	1.0000000
NODE_10242_length_853_cov_16.551724	376	456	0	80	80	1.0000000
NODE_10242_length_853_cov_16.551724	429	509	0	47	80	0.5875000
NODE_10242_length_853_cov_16.551724	429	509	2	33	80	0.4125000
NODE_10243_length_853_cov_15.395225	395	475	0	80	80	1.0000000
NODE_10243_length_853_cov_15.395225	448	528	0	80	80	1.0000000
NODE_10244_length_853_cov_15.086207	355	434	0	52	79	0.6582279
NODE_10244_length_853_cov_15.086207	355	434	2	27	79	0.3417721
NODE_10244_length_853_cov_15.086207	408	488	0	3	80	0.0375000
NODE_10244_length_853_cov_15.086207	408	488	2	77	80	0.9625000
NODE_10245_length_853_cov_14.929708	160	240	0	21	80	0.2625000
NODE_10245_length_853_cov_14.929708	160	240	2	6	80	0.0750000
NODE_10245_length_853_cov_14.929708	160	240	4	53	80	0.6625000
NODE_10245_length_853_cov_14.929708	213	293	0	17	80	0.2125000
NODE_10245_length_853_cov_14.929708	213	293	2	21	80	0.2625000
NODE_10245_length_853_cov_14.929708	213	293	4	42	80	0.5250000
NODE_10246_length_853_cov_11.299735	395	475	0	80	80	1.0000000
NODE_10246_length_853_cov_11.299735	448	528	0	80	80	1.0000000
NODE_10247_length_853_cov_9.571618	479	559	0	80	80	1.0000000
NODE_10247_length_853_cov_9.571618	532	612	0	80	80	1.0000000
NODE_10248_length_853_cov_7.828912	265	345	0	33	80	0.4125000
NODE_10248_length_853_cov_7.828912	265	345	2	47	80	0.5875000
NODE_10248_length_853_cov_7.828912	318	398	2	80	80	1.0000000
NODE_10249_length_853_cov_7.623342	255	335	0	39	80	0.4875000
NODE_10249_length_853_cov_7.623342	255	335	2	41	80	0.5125000
NODE_10249_length_853_cov_7.623342	308	388	2	51	80	0.6375000
NODE_10249_length_853_cov_7.623342	308	388	4	29	80	0.3625000
NODE_10253_length_853_cov_3.173740	212	292	0	80	80	1.0000000
NODE_10253_length_853_cov_3.173740	265	343	0	78	78	1.0000000
NODE_10258_length_853_cov_1.823607	710	773	0	63	63	1.0000000
NODE_10258_length_853_cov_1.823607	711	773	0	62	62	1.0000000
NODE_10258_length_853_cov_1.823607	711	773	0	62	62	1.0000000
NODE_10258_length_853_cov_1.823607	746	826	0	80	80	1.0000000
NODE_10267_length_852_cov_30.022576	279	359	0	80	80	1.0000000
NODE_10267_length_852_cov_30.022576	332	412	0	80	80	1.0000000
NODE_10268_length_852_cov_19.373174	353	433	2	80	80	1.0000000
NODE_10268_length_852_cov_19.373174	406	486	0	1	80	0.0125000
NODE_10268_length_852_cov_19.373174	406	486	2	79	80	0.9875000
NODE_10269_length_852_cov_18.853918	297	377	0	80	80	1.0000000
NODE_10269_length_852_cov_18.853918	350	430	0	80	80	1.0000000
NODE_10269_length_852_cov_18.853918	426	506	0	80	80	1.0000000
NODE_10269_length_852_cov_18.853918	489	559	0	70	70	1.0000000
NODE_10270_length_852_cov_17.391766	472	552	0	80	80	1.0000000
NODE_10270_length_852_cov_17.391766	525	605	0	80	80	1.0000000
NODE_10271_length_852_cov_8.818061	513	593	0	5	80	0.0625000
NODE_10271_length_852_cov_8.818061	513	593	4	75	80	0.9375000
NODE_10271_length_852_cov_8.818061	566	646	0	41	80	0.5125000
NODE_10271_length_852_cov_8.818061	566	646	4	39	80	0.4875000
NODE_10274_length_852_cov_4.403718	493	573	0	80	80	1.0000000
NODE_10274_length_852_cov_4.403718	546	626	0	80	80	1.0000000
NODE_10285_length_851_cov_33.953457	329	409	0	19	80	0.2375000
NODE_10285_length_851_cov_33.953457	329	409	2	61	80	0.7625000
NODE_10285_length_851_cov_33.953457	382	462	0	44	80	0.5500000
NODE_10285_length_851_cov_33.953457	382	462	2	36	80	0.4500000
NODE_10286_length_851_cov_30.488032	395	475	0	18	80	0.2250000
NODE_10286_length_851_cov_30.488032	395	475	2	35	80	0.4375000
NODE_10286_length_851_cov_30.488032	395	475	4	27	80	0.3375000
NODE_10286_length_851_cov_30.488032	448	528	0	8	80	0.1000000
NODE_10286_length_851_cov_30.488032	448	528	2	20	80	0.2500000
NODE_10286_length_851_cov_30.488032	448	528	4	52	80	0.6500000
NODE_10287_length_851_cov_27.481383	353	433	0	20	80	0.2500000
NODE_10287_length_851_cov_27.481383	353	433	1	1	80	0.0125000
NODE_10287_length_851_cov_27.481383	353	433	2	59	80	0.7375000
NODE_10287_length_851_cov_27.481383	406	486	2	80	80	1.0000000
NODE_10288_length_851_cov_23.656915	345	425	2	22	80	0.2750000
NODE_10288_length_851_cov_23.656915	345	425	4	58	80	0.7250000
NODE_10288_length_851_cov_23.656915	398	478	0	53	80	0.6625000
NODE_10288_length_851_cov_23.656915	398	478	2	22	80	0.2750000
NODE_10288_length_851_cov_23.656915	398	478	4	5	80	0.0625000
NODE_10289_length_851_cov_19.769947	298	378	0	64	80	0.8000000
NODE_10289_length_851_cov_19.769947	298	378	2	16	80	0.2000000
NODE_10289_length_851_cov_19.769947	351	431	0	11	80	0.1375000
NODE_10289_length_851_cov_19.769947	351	431	2	69	80	0.8625000
NODE_10290_length_851_cov_17.386968	459	539	0	80	80	1.0000000
NODE_10290_length_851_cov_17.386968	512	592	0	80	80	1.0000000
NODE_10291_length_851_cov_13.519947	323	403	0	80	80	1.0000000
NODE_10291_length_851_cov_13.519947	376	456	0	80	80	1.0000000
NODE_10292_length_851_cov_11.771277	403	483	0	12	80	0.1500000
NODE_10292_length_851_cov_11.771277	403	483	2	68	80	0.8500000
NODE_10292_length_851_cov_11.771277	456	536	0	40	80	0.5000000
NODE_10292_length_851_cov_11.771277	456	536	2	40	80	0.5000000
NODE_10293_length_851_cov_11.698138	227	307	2	41	80	0.5125000
NODE_10293_length_851_cov_11.698138	227	307	4	39	80	0.4875000
NODE_10293_length_851_cov_11.698138	280	360	0	17	80	0.2125000
NODE_10293_length_851_cov_11.698138	280	360	2	63	80	0.7875000
NODE_10293_length_851_cov_11.698138	356	436	2	17	80	0.2125000
NODE_10293_length_851_cov_11.698138	356	436	4	41	80	0.5125000
NODE_10293_length_851_cov_11.698138	356	436	6	22	80	0.2750000
NODE_10293_length_851_cov_11.698138	409	489	2	3	80	0.0375000
NODE_10293_length_851_cov_11.698138	409	489	4	36	80	0.4500000
NODE_10293_length_851_cov_11.698138	409	489	6	41	80	0.5125000
NODE_10294_length_851_cov_11.672872	372	452	0	47	80	0.5875000
NODE_10294_length_851_cov_11.672872	372	452	2	33	80	0.4125000
NODE_10294_length_851_cov_11.672872	425	505	2	80	80	1.0000000
NODE_10295_length_851_cov_10.938830	418	499	0	81	81	1.0000000
NODE_10296_length_851_cov_10.074468	454	534	1	80	80	1.0000000
NODE_10296_length_851_cov_10.074468	507	587	1	62	80	0.7750000
NODE_10296_length_851_cov_10.074468	507	587	2	18	80	0.2250000
NODE_10297_length_851_cov_7.599734	330	410	0	14	80	0.1750000
NODE_10297_length_851_cov_7.599734	330	410	2	66	80	0.8250000
NODE_10297_length_851_cov_7.599734	383	463	0	63	80	0.7875000
NODE_10297_length_851_cov_7.599734	383	463	2	17	80	0.2125000
NODE_10298_length_851_cov_5.639628	379	459	0	80	80	1.0000000
NODE_10298_length_851_cov_5.639628	432	512	0	80	80	1.0000000
NODE_10300_length_851_cov_3.880319	729	765	0	12	36	0.3333333
NODE_10300_length_851_cov_3.880319	729	765	2	8	36	0.2222222
NODE_10300_length_851_cov_3.880319	729	765	4	16	36	0.4444444
NODE_10300_length_851_cov_3.880319	743	824	0	8	81	0.0987654
NODE_10300_length_851_cov_3.880319	743	824	2	34	81	0.4197531
NODE_10300_length_851_cov_3.880319	743	824	4	39	81	0.4814815
NODE_10301_length_851_cov_3.823138	380	460	0	80	80	1.0000000
NODE_10301_length_851_cov_3.823138	433	513	0	80	80	1.0000000
NODE_10318_length_851_cov_1.130319	33	103	0	70	70	1.0000000
NODE_10326_length_850_cov_36.527297	360	440	0	28	80	0.3500000
NODE_10326_length_850_cov_36.527297	360	440	2	52	80	0.6500000
NODE_10326_length_850_cov_36.527297	413	493	0	27	80	0.3375000
NODE_10326_length_850_cov_36.527297	413	493	2	53	80	0.6625000
NODE_10327_length_850_cov_31.006658	330	410	2	22	80	0.2750000
NODE_10327_length_850_cov_31.006658	330	410	3	42	80	0.5250000
NODE_10327_length_850_cov_31.006658	330	410	5	7	80	0.0875000
NODE_10327_length_850_cov_31.006658	330	410	6	9	80	0.1125000
NODE_10327_length_850_cov_31.006658	383	463	3	11	80	0.1375000
NODE_10327_length_850_cov_31.006658	383	463	4	47	80	0.5875000
NODE_10327_length_850_cov_31.006658	383	463	5	7	80	0.0875000
NODE_10327_length_850_cov_31.006658	383	463	6	15	80	0.1875000
NODE_10328_length_850_cov_30.460719	251	331	0	2	80	0.0250000
NODE_10328_length_850_cov_30.460719	251	331	3	39	80	0.4875000
NODE_10328_length_850_cov_30.460719	251	331	6	32	80	0.4000000
NODE_10328_length_850_cov_30.460719	251	331	9	7	80	0.0875000
NODE_10328_length_850_cov_30.460719	304	384	6	20	80	0.2500000
NODE_10328_length_850_cov_30.460719	304	384	9	60	80	0.7500000
NODE_10329_length_850_cov_25.263648	355	435	4	10	80	0.1250000
NODE_10329_length_850_cov_25.263648	355	435	6	61	80	0.7625000
NODE_10329_length_850_cov_25.263648	355	435	7	1	80	0.0125000
NODE_10329_length_850_cov_25.263648	355	435	8	8	80	0.1000000
NODE_10329_length_850_cov_25.263648	408	488	2	39	80	0.4875000
NODE_10329_length_850_cov_25.263648	408	488	4	20	80	0.2500000
NODE_10329_length_850_cov_25.263648	408	488	6	12	80	0.1500000
NODE_10329_length_850_cov_25.263648	408	488	7	1	80	0.0125000
NODE_10329_length_850_cov_25.263648	408	488	8	8	80	0.1000000
NODE_10330_length_850_cov_21.368842	290	370	0	30	80	0.3750000
NODE_10330_length_850_cov_21.368842	290	370	2	50	80	0.6250000
NODE_10330_length_850_cov_21.368842	343	423	1	1	80	0.0125000
NODE_10330_length_850_cov_21.368842	343	423	2	79	80	0.9875000
NODE_10331_length_850_cov_20.500666	318	398	2	19	80	0.2375000
NODE_10331_length_850_cov_20.500666	318	398	3	9	80	0.1125000
NODE_10331_length_850_cov_20.500666	318	398	4	52	80	0.6500000
NODE_10331_length_850_cov_20.500666	371	451	2	17	80	0.2125000
NODE_10331_length_850_cov_20.500666	371	451	4	63	80	0.7875000
NODE_10332_length_850_cov_17.268975	398	478	4	80	80	1.0000000
NODE_10332_length_850_cov_17.268975	451	531	0	29	80	0.3625000
NODE_10332_length_850_cov_17.268975	451	531	4	51	80	0.6375000
NODE_10333_length_850_cov_14.728362	379	459	0	80	80	1.0000000
NODE_10333_length_850_cov_14.728362	432	512	0	80	80	1.0000000
NODE_10334_length_850_cov_14.230360	313	393	0	74	80	0.9250000
NODE_10334_length_850_cov_14.230360	313	393	2	6	80	0.0750000
NODE_10334_length_850_cov_14.230360	366	446	0	21	80	0.2625000
NODE_10334_length_850_cov_14.230360	366	446	2	59	80	0.7375000
NODE_10335_length_850_cov_12.387483	337	417	0	12	80	0.1500000
NODE_10335_length_850_cov_12.387483	337	417	2	10	80	0.1250000
NODE_10335_length_850_cov_12.387483	337	417	4	58	80	0.7250000
NODE_10335_length_850_cov_12.387483	390	470	0	43	80	0.5375000
NODE_10335_length_850_cov_12.387483	390	470	4	37	80	0.4625000
NODE_10335_length_850_cov_12.387483	466	545	0	30	79	0.3797468
NODE_10335_length_850_cov_12.387483	466	545	2	49	79	0.6202531
NODE_10335_length_850_cov_12.387483	518	598	0	18	80	0.2250000
NODE_10335_length_850_cov_12.387483	518	598	2	62	80	0.7750000
NODE_10336_length_850_cov_11.402130	329	409	0	80	80	1.0000000
NODE_10336_length_850_cov_11.402130	382	462	0	80	80	1.0000000
NODE_10337_length_850_cov_10.326232	330	410	0	80	80	1.0000000
NODE_10337_length_850_cov_10.326232	383	463	0	80	80	1.0000000
NODE_10338_length_850_cov_9.675100	464	544	0	80	80	1.0000000
NODE_10338_length_850_cov_9.675100	517	597	0	80	80	1.0000000
NODE_10367_length_849_cov_43.137333	336	416	0	80	80	1.0000000
NODE_10367_length_849_cov_43.137333	389	469	0	80	80	1.0000000
NODE_10368_length_849_cov_36.562667	326	406	0	80	80	1.0000000
NODE_10368_length_849_cov_36.562667	379	459	0	80	80	1.0000000
NODE_10369_length_849_cov_35.449333	408	488	0	51	80	0.6375000
NODE_10369_length_849_cov_35.449333	408	488	2	14	80	0.1750000
NODE_10369_length_849_cov_35.449333	408	488	6	15	80	0.1875000
NODE_10369_length_849_cov_35.449333	461	541	2	12	80	0.1500000
NODE_10369_length_849_cov_35.449333	461	541	6	68	80	0.8500000
NODE_10370_length_849_cov_29.989333	332	412	0	38	80	0.4750000
NODE_10370_length_849_cov_29.989333	332	412	2	42	80	0.5250000
NODE_10370_length_849_cov_29.989333	385	465	0	5	80	0.0625000
NODE_10370_length_849_cov_29.989333	385	465	2	41	80	0.5125000
NODE_10370_length_849_cov_29.989333	385	465	4	34	80	0.4250000
NODE_10371_length_849_cov_17.974667	343	423	0	14	80	0.1750000
NODE_10371_length_849_cov_17.974667	343	423	1	10	80	0.1250000
NODE_10371_length_849_cov_17.974667	343	423	2	56	80	0.7000000
NODE_10371_length_849_cov_17.974667	396	476	2	80	80	1.0000000
NODE_10372_length_849_cov_17.018667	360	440	2	80	80	1.0000000
NODE_10372_length_849_cov_17.018667	416	493	0	15	77	0.1948052
NODE_10372_length_849_cov_17.018667	416	493	2	62	77	0.8051948
NODE_10373_length_849_cov_15.581333	287	367	0	80	80	1.0000000
NODE_10373_length_849_cov_15.581333	340	420	0	80	80	1.0000000
NODE_10373_length_849_cov_15.581333	416	496	0	80	80	1.0000000
NODE_10373_length_849_cov_15.581333	469	549	0	80	80	1.0000000
NODE_10374_length_849_cov_9.460000	370	450	0	80	80	1.0000000
NODE_10374_length_849_cov_9.460000	423	503	0	80	80	1.0000000
NODE_10375_length_849_cov_4.893333	427	507	0	9	80	0.1125000
NODE_10375_length_849_cov_4.893333	427	507	2	71	80	0.8875000
NODE_10375_length_849_cov_4.893333	480	560	0	62	80	0.7750000
NODE_10375_length_849_cov_4.893333	480	560	2	18	80	0.2250000
NODE_10376_length_849_cov_4.860000	380	460	0	80	80	1.0000000
NODE_10376_length_849_cov_4.860000	433	513	0	38	80	0.4750000
NODE_10376_length_849_cov_4.860000	433	513	2	24	80	0.3000000
NODE_10376_length_849_cov_4.860000	433	513	4	18	80	0.2250000
NODE_10379_length_849_cov_2.761333	254	334	0	80	80	1.0000000
NODE_10396_length_848_cov_27.287049	253	333	0	3	80	0.0375000
NODE_10396_length_848_cov_27.287049	253	333	2	77	80	0.9625000
NODE_10396_length_848_cov_27.287049	306	386	0	56	80	0.7000000
NODE_10396_length_848_cov_27.287049	306	386	2	24	80	0.3000000
NODE_10396_length_848_cov_27.287049	382	458	0	24	76	0.3157895
NODE_10396_length_848_cov_27.287049	382	458	2	52	76	0.6842105
NODE_10396_length_848_cov_27.287049	435	513	0	20	78	0.2564103
NODE_10396_length_848_cov_27.287049	435	513	2	58	78	0.7435898
NODE_10397_length_848_cov_23.511348	248	328	0	80	80	1.0000000
NODE_10397_length_848_cov_23.511348	301	381	0	80	80	1.0000000
NODE_10397_length_848_cov_23.511348	377	457	0	80	80	1.0000000
NODE_10397_length_848_cov_23.511348	430	508	0	78	78	1.0000000
NODE_10398_length_848_cov_21.939920	295	375	0	5	80	0.0625000
NODE_10398_length_848_cov_21.939920	295	375	4	75	80	0.9375000
NODE_10398_length_848_cov_21.939920	348	428	0	23	80	0.2875000
NODE_10398_length_848_cov_21.939920	348	428	3	1	80	0.0125000
NODE_10398_length_848_cov_21.939920	348	428	4	56	80	0.7000000
NODE_10399_length_848_cov_21.937250	434	514	0	80	80	1.0000000
NODE_10399_length_848_cov_21.937250	487	567	0	41	80	0.5125000
NODE_10399_length_848_cov_21.937250	487	567	2	7	80	0.0875000
NODE_10399_length_848_cov_21.937250	487	567	6	32	80	0.4000000
NODE_10400_length_848_cov_19.500668	367	392	0	25	25	1.0000000
NODE_10400_length_848_cov_19.500668	388	468	0	32	80	0.4000000
NODE_10400_length_848_cov_19.500668	388	468	2	14	80	0.1750000
NODE_10400_length_848_cov_19.500668	388	468	4	34	80	0.4250000
NODE_10400_length_848_cov_19.500668	441	521	0	21	80	0.2625000
NODE_10400_length_848_cov_19.500668	441	521	2	14	80	0.1750000
NODE_10400_length_848_cov_19.500668	441	521	4	45	80	0.5625000
NODE_10400_length_848_cov_19.500668	443	512	0	12	69	0.1739130
NODE_10400_length_848_cov_19.500668	443	512	2	14	69	0.2028985
NODE_10400_length_848_cov_19.500668	443	512	4	43	69	0.6231884
NODE_10400_length_848_cov_19.500668	443	472	4	29	29	1.0000000
NODE_10401_length_848_cov_16.566088	323	403	0	14	80	0.1750000
NODE_10401_length_848_cov_16.566088	323	403	2	66	80	0.8250000
NODE_10401_length_848_cov_16.566088	376	456	0	66	80	0.8250000
NODE_10401_length_848_cov_16.566088	376	456	2	14	80	0.1750000
NODE_10402_length_848_cov_16.109479	256	336	2	80	80	1.0000000
NODE_10402_length_848_cov_16.109479	309	389	0	14	80	0.1750000
NODE_10402_length_848_cov_16.109479	309	389	2	66	80	0.8250000
NODE_10402_length_848_cov_16.109479	385	465	2	26	80	0.3250000
NODE_10402_length_848_cov_16.109479	385	465	4	54	80	0.6750000
NODE_10402_length_848_cov_16.109479	438	518	0	25	80	0.3125000
NODE_10402_length_848_cov_16.109479	438	518	2	47	80	0.5875000
NODE_10402_length_848_cov_16.109479	438	518	4	8	80	0.1000000
NODE_10403_length_848_cov_15.919893	492	568	2	76	76	1.0000000
NODE_10403_length_848_cov_15.919893	541	621	0	49	80	0.6125000
NODE_10403_length_848_cov_15.919893	541	621	2	31	80	0.3875000
NODE_10404_length_848_cov_13.979973	269	349	0	80	80	1.0000000
NODE_10404_length_848_cov_13.979973	322	402	0	80	80	1.0000000
NODE_10405_length_848_cov_13.073431	343	423	0	80	80	1.0000000
NODE_10405_length_848_cov_13.073431	396	476	0	80	80	1.0000000
NODE_10406_length_848_cov_8.523364	232	312	2	39	80	0.4875000
NODE_10406_length_848_cov_8.523364	232	312	3	19	80	0.2375000
NODE_10406_length_848_cov_8.523364	232	312	4	22	80	0.2750000
NODE_10406_length_848_cov_8.523364	285	365	2	80	80	1.0000000
NODE_10406_length_848_cov_8.523364	361	441	0	40	80	0.5000000
NODE_10406_length_848_cov_8.523364	361	441	1	22	80	0.2750000
NODE_10406_length_848_cov_8.523364	361	441	2	18	80	0.2250000
NODE_10406_length_848_cov_8.523364	414	494	0	80	80	1.0000000
NODE_10408_length_848_cov_5.903872	251	331	0	25	80	0.3125000
NODE_10408_length_848_cov_5.903872	251	331	2	53	80	0.6625000
NODE_10408_length_848_cov_5.903872	251	331	4	2	80	0.0250000
NODE_10408_length_848_cov_5.903872	304	383	2	25	79	0.3164557
NODE_10408_length_848_cov_5.903872	304	383	4	54	79	0.6835443
NODE_10409_length_848_cov_5.236315	378	458	0	51	80	0.6375000
NODE_10409_length_848_cov_5.236315	378	458	2	29	80	0.3625000
NODE_10409_length_848_cov_5.236315	431	507	2	76	76	1.0000000
NODE_10424_length_847_cov_56.417112	576	656	6	16	80	0.2000000
NODE_10424_length_847_cov_56.417112	576	656	8	4	80	0.0500000
NODE_10424_length_847_cov_56.417112	576	656	10	7	80	0.0875000
NODE_10424_length_847_cov_56.417112	576	656	12	6	80	0.0750000
NODE_10424_length_847_cov_56.417112	576	656	14	47	80	0.5875000
NODE_10424_length_847_cov_56.417112	629	709	0	42	80	0.5250000
NODE_10424_length_847_cov_56.417112	629	709	5	1	80	0.0125000
NODE_10424_length_847_cov_56.417112	629	709	6	26	80	0.3250000
NODE_10424_length_847_cov_56.417112	629	709	8	4	80	0.0500000
NODE_10424_length_847_cov_56.417112	629	709	10	7	80	0.0875000
NODE_10425_length_847_cov_27.292781	390	470	2	1	80	0.0125000
NODE_10425_length_847_cov_27.292781	390	470	4	37	80	0.4625000
NODE_10425_length_847_cov_27.292781	390	470	6	42	80	0.5250000
NODE_10425_length_847_cov_27.292781	443	523	0	7	80	0.0875000
NODE_10425_length_847_cov_27.292781	443	523	2	37	80	0.4625000
NODE_10425_length_847_cov_27.292781	443	523	4	30	80	0.3750000
NODE_10425_length_847_cov_27.292781	443	523	6	6	80	0.0750000
NODE_10426_length_847_cov_24.954545	342	422	0	40	80	0.5000000
NODE_10426_length_847_cov_24.954545	342	422	2	40	80	0.5000000
NODE_10426_length_847_cov_24.954545	395	475	2	59	80	0.7375000
NODE_10426_length_847_cov_24.954545	395	475	4	21	80	0.2625000
NODE_10427_length_847_cov_20.310160	341	421	0	80	80	1.0000000
NODE_10427_length_847_cov_20.310160	394	474	0	80	80	1.0000000
NODE_10428_length_847_cov_19.002674	368	448	0	54	80	0.6750000
NODE_10428_length_847_cov_19.002674	368	448	2	26	80	0.3250000
NODE_10428_length_847_cov_19.002674	421	501	0	1	80	0.0125000
NODE_10428_length_847_cov_19.002674	421	501	2	79	80	0.9875000
NODE_10429_length_847_cov_16.879679	218	298	0	32	80	0.4000000
NODE_10429_length_847_cov_16.879679	218	298	2	48	80	0.6000000
NODE_10429_length_847_cov_16.879679	271	351	2	49	80	0.6125000
NODE_10429_length_847_cov_16.879679	271	351	4	31	80	0.3875000
NODE_10431_length_847_cov_11.784759	298	378	0	63	80	0.7875000
NODE_10431_length_847_cov_11.784759	298	378	2	17	80	0.2125000
NODE_10431_length_847_cov_11.784759	351	431	0	10	80	0.1250000
NODE_10431_length_847_cov_11.784759	351	431	2	70	80	0.8750000
NODE_10431_length_847_cov_11.784759	427	507	0	74	80	0.9250000
NODE_10431_length_847_cov_11.784759	427	507	2	6	80	0.0750000
NODE_10431_length_847_cov_11.784759	480	560	0	80	80	1.0000000
NODE_10432_length_847_cov_11.604278	407	487	0	80	80	1.0000000
NODE_10432_length_847_cov_11.604278	460	540	0	80	80	1.0000000
NODE_10433_length_847_cov_10.221925	395	475	0	51	80	0.6375000
NODE_10433_length_847_cov_10.221925	395	475	2	29	80	0.3625000
NODE_10433_length_847_cov_10.221925	448	528	0	80	80	1.0000000
NODE_10434_length_847_cov_4.602941	97	154	8	6	57	0.1052632
NODE_10434_length_847_cov_4.602941	97	154	10	42	57	0.7368421
NODE_10434_length_847_cov_4.602941	97	154	12	9	57	0.1578947
NODE_10434_length_847_cov_4.602941	127	207	2	49	80	0.6125000
NODE_10434_length_847_cov_4.602941	127	207	4	3	80	0.0375000
NODE_10434_length_847_cov_4.602941	127	207	8	7	80	0.0875000
NODE_10434_length_847_cov_4.602941	127	207	10	21	80	0.2625000
NODE_10456_length_846_cov_39.476573	336	416	0	12	80	0.1500000
NODE_10456_length_846_cov_39.476573	336	416	2	50	80	0.6250000
NODE_10456_length_846_cov_39.476573	336	416	4	18	80	0.2250000
NODE_10456_length_846_cov_39.476573	389	469	0	36	80	0.4500000
NODE_10456_length_846_cov_39.476573	389	469	2	30	80	0.3750000
NODE_10456_length_846_cov_39.476573	389	469	4	14	80	0.1750000
NODE_10456_length_846_cov_39.476573	465	545	0	80	80	1.0000000
NODE_10456_length_846_cov_39.476573	518	598	0	80	80	1.0000000
NODE_10457_length_846_cov_37.297189	312	392	0	80	80	1.0000000
NODE_10457_length_846_cov_37.297189	365	445	0	80	80	1.0000000
NODE_10458_length_846_cov_32.852744	279	359	0	29	80	0.3625000
NODE_10458_length_846_cov_32.852744	279	359	2	51	80	0.6375000
NODE_10458_length_846_cov_32.852744	332	412	0	80	80	1.0000000
NODE_10459_length_846_cov_31.717537	290	370	0	80	80	1.0000000
NODE_10459_length_846_cov_31.717537	343	423	0	80	80	1.0000000
NODE_10460_length_846_cov_24.380187	350	430	0	80	80	1.0000000
NODE_10460_length_846_cov_24.380187	403	483	0	80	80	1.0000000
NODE_10461_length_846_cov_16.155288	364	444	0	3	80	0.0375000
NODE_10461_length_846_cov_16.155288	364	444	2	77	80	0.9625000
NODE_10461_length_846_cov_16.155288	417	497	0	36	80	0.4500000
NODE_10461_length_846_cov_16.155288	417	497	2	44	80	0.5500000
NODE_10462_length_846_cov_15.917001	398	478	2	80	80	1.0000000
NODE_10462_length_846_cov_15.917001	451	531	0	11	80	0.1375000
NODE_10462_length_846_cov_15.917001	451	531	2	69	80	0.8625000
NODE_10463_length_846_cov_15.275770	355	435	0	47	80	0.5875000
NODE_10463_length_846_cov_15.275770	355	435	2	33	80	0.4125000
NODE_10463_length_846_cov_15.275770	408	488	0	1	80	0.0125000
NODE_10463_length_846_cov_15.275770	408	488	2	79	80	0.9875000
NODE_10464_length_846_cov_13.618474	216	296	0	46	80	0.5750000
NODE_10464_length_846_cov_13.618474	216	296	2	20	80	0.2500000
NODE_10464_length_846_cov_13.618474	216	296	4	14	80	0.1750000
NODE_10464_length_846_cov_13.618474	269	349	2	15	80	0.1875000
NODE_10464_length_846_cov_13.618474	269	349	4	65	80	0.8125000
NODE_10464_length_846_cov_13.618474	345	425	2	6	80	0.0750000
NODE_10464_length_846_cov_13.618474	345	425	4	27	80	0.3375000
NODE_10464_length_846_cov_13.618474	345	425	6	11	80	0.1375000
NODE_10464_length_846_cov_13.618474	345	425	8	36	80	0.4500000
NODE_10464_length_846_cov_13.618474	398	478	4	15	80	0.1875000
NODE_10464_length_846_cov_13.618474	398	478	6	30	80	0.3750000
NODE_10464_length_846_cov_13.618474	398	478	8	35	80	0.4375000
NODE_10465_length_846_cov_12.878179	425	505	0	80	80	1.0000000
NODE_10465_length_846_cov_12.878179	478	558	0	80	80	1.0000000
NODE_10467_length_846_cov_7.232932	407	487	0	80	80	1.0000000
NODE_10467_length_846_cov_7.232932	460	540	0	80	80	1.0000000
NODE_10468_length_846_cov_6.776439	320	400	0	80	80	1.0000000
NODE_10468_length_846_cov_6.776439	373	453	0	80	80	1.0000000
NODE_10472_length_846_cov_3.025435	190	270	0	80	80	1.0000000
NODE_10472_length_846_cov_3.025435	243	323	0	80	80	1.0000000
NODE_10488_length_845_cov_34.458445	213	293	0	43	80	0.5375000
NODE_10488_length_845_cov_34.458445	213	293	1	2	80	0.0250000
NODE_10488_length_845_cov_34.458445	213	293	2	12	80	0.1500000
NODE_10488_length_845_cov_34.458445	213	293	4	2	80	0.0250000
NODE_10488_length_845_cov_34.458445	213	293	6	12	80	0.1500000
NODE_10488_length_845_cov_34.458445	213	293	8	9	80	0.1125000
NODE_10488_length_845_cov_34.458445	266	346	2	4	80	0.0500000
NODE_10488_length_845_cov_34.458445	266	346	4	2	80	0.0250000
NODE_10488_length_845_cov_34.458445	266	346	6	12	80	0.1500000
NODE_10488_length_845_cov_34.458445	266	346	8	22	80	0.2750000
NODE_10488_length_845_cov_34.458445	266	346	10	40	80	0.5000000
NODE_10489_length_845_cov_33.025469	309	389	0	80	80	1.0000000
NODE_10489_length_845_cov_33.025469	362	442	0	80	80	1.0000000
NODE_10490_length_845_cov_30.331099	288	368	4	6	80	0.0750000
NODE_10490_length_845_cov_30.331099	288	368	8	8	80	0.1000000
NODE_10490_length_845_cov_30.331099	288	368	10	66	80	0.8250000
NODE_10490_length_845_cov_30.331099	341	421	0	31	80	0.3875000
NODE_10490_length_845_cov_30.331099	341	421	2	2	80	0.0250000
NODE_10490_length_845_cov_30.331099	341	421	4	26	80	0.3250000
NODE_10490_length_845_cov_30.331099	341	421	10	21	80	0.2625000
NODE_10491_length_845_cov_22.042895	455	535	2	4	80	0.0500000
NODE_10491_length_845_cov_22.042895	455	535	4	76	80	0.9500000
NODE_10491_length_845_cov_22.042895	508	588	0	25	80	0.3125000
NODE_10491_length_845_cov_22.042895	508	588	2	7	80	0.0875000
NODE_10491_length_845_cov_22.042895	508	588	4	48	80	0.6000000
NODE_10492_length_845_cov_20.662198	325	406	0	37	81	0.4567901
NODE_10492_length_845_cov_20.662198	325	406	2	44	81	0.5432099
NODE_10492_length_845_cov_20.662198	379	459	0	1	80	0.0125000
NODE_10492_length_845_cov_20.662198	379	459	2	79	80	0.9875000
NODE_10493_length_845_cov_17.214477	352	432	0	2	80	0.0250000
NODE_10493_length_845_cov_17.214477	352	432	2	78	80	0.9750000
NODE_10493_length_845_cov_17.214477	405	485	0	6	80	0.0750000
NODE_10493_length_845_cov_17.214477	405	485	2	74	80	0.9250000
NODE_10494_length_845_cov_15.805630	409	489	0	14	80	0.1750000
NODE_10494_length_845_cov_15.805630	409	489	2	66	80	0.8250000
NODE_10494_length_845_cov_15.805630	462	542	0	67	80	0.8375000
NODE_10494_length_845_cov_15.805630	462	542	2	13	80	0.1625000
NODE_10495_length_845_cov_13.443700	329	409	0	28	80	0.3500000
NODE_10495_length_845_cov_13.443700	329	409	2	52	80	0.6500000
NODE_10495_length_845_cov_13.443700	382	462	0	37	80	0.4625000
NODE_10495_length_845_cov_13.443700	382	462	2	43	80	0.5375000
NODE_10496_length_845_cov_12.301609	334	414	0	80	80	1.0000000
NODE_10496_length_845_cov_12.301609	387	467	0	80	80	1.0000000
NODE_10497_length_845_cov_11.836461	389	469	0	25	80	0.3125000
NODE_10497_length_845_cov_11.836461	389	469	2	55	80	0.6875000
NODE_10497_length_845_cov_11.836461	442	522	0	35	80	0.4375000
NODE_10497_length_845_cov_11.836461	442	522	2	45	80	0.5625000
NODE_10499_length_845_cov_8.140751	439	519	0	80	80	1.0000000
NODE_10499_length_845_cov_8.140751	492	572	0	80	80	1.0000000
NODE_10516_length_845_cov_1.680965	447	491	2	44	44	1.0000000
NODE_10528_length_844_cov_43.778523	313	393	2	80	80	1.0000000
NODE_10528_length_844_cov_43.778523	366	446	0	3	80	0.0375000
NODE_10528_length_844_cov_43.778523	366	446	2	77	80	0.9625000
NODE_10528_length_844_cov_43.778523	442	522	0	21	80	0.2625000
NODE_10528_length_844_cov_43.778523	442	522	2	59	80	0.7375000
NODE_10528_length_844_cov_43.778523	495	575	0	2	80	0.0250000
NODE_10528_length_844_cov_43.778523	495	575	2	78	80	0.9750000
NODE_10529_length_844_cov_36.762416	381	461	0	80	80	1.0000000
NODE_10529_length_844_cov_36.762416	434	514	0	80	80	1.0000000
NODE_10529_length_844_cov_36.762416	510	590	0	80	80	1.0000000
NODE_10529_length_844_cov_36.762416	563	644	0	81	81	1.0000000
NODE_10530_length_844_cov_35.765101	424	504	0	80	80	1.0000000
NODE_10530_length_844_cov_35.765101	477	557	0	80	80	1.0000000
NODE_10531_length_844_cov_18.445638	353	420	0	16	67	0.2388060
NODE_10531_length_844_cov_18.445638	353	420	2	51	67	0.7611941
NODE_10531_length_844_cov_18.445638	393	473	0	31	80	0.3875000
NODE_10531_length_844_cov_18.445638	393	473	2	49	80	0.6125000
NODE_10532_length_844_cov_12.616107	363	443	0	80	80	1.0000000
NODE_10532_length_844_cov_12.616107	416	496	0	80	80	1.0000000
NODE_10533_length_844_cov_12.092617	171	251	0	80	80	1.0000000
NODE_10533_length_844_cov_12.092617	224	304	0	80	80	1.0000000
NODE_10534_length_844_cov_11.883221	341	421	0	80	80	1.0000000
NODE_10534_length_844_cov_11.883221	394	474	0	55	80	0.6875000
NODE_10534_length_844_cov_11.883221	394	474	2	25	80	0.3125000
NODE_10535_length_844_cov_10.571812	390	448	2	58	58	1.0000000
NODE_10537_length_844_cov_9.357047	370	450	0	80	80	1.0000000
NODE_10537_length_844_cov_9.357047	423	503	0	80	80	1.0000000
NODE_10538_length_844_cov_8.975839	355	435	0	80	80	1.0000000
NODE_10538_length_844_cov_8.975839	408	488	0	80	80	1.0000000
NODE_10539_length_844_cov_7.347651	357	438	0	81	81	1.0000000
NODE_10539_length_844_cov_7.347651	410	491	0	81	81	1.0000000
NODE_10540_length_844_cov_6.975839	444	524	0	80	80	1.0000000
NODE_10540_length_844_cov_6.975839	497	577	0	80	80	1.0000000
NODE_10567_length_843_cov_48.258065	203	262	93	8	59	0.1355932
NODE_10567_length_843_cov_48.258065	203	262	95	8	59	0.1355932
NODE_10567_length_843_cov_48.258065	203	262	96	6	59	0.1016949
NODE_10567_length_843_cov_48.258065	203	262	97	8	59	0.1355932
NODE_10567_length_843_cov_48.258065	203	262	98	12	59	0.2033898
NODE_10567_length_843_cov_48.258065	203	262	99	4	59	0.0677966
NODE_10567_length_843_cov_48.258065	203	262	100	7	59	0.1186441
NODE_10567_length_843_cov_48.258065	203	262	101	3	59	0.0508475
NODE_10567_length_843_cov_48.258065	203	262	103	3	59	0.0508475
NODE_10568_length_843_cov_31.279570	351	431	2	80	80	1.0000000
NODE_10568_length_843_cov_31.279570	404	484	0	42	80	0.5250000
NODE_10568_length_843_cov_31.279570	404	484	2	38	80	0.4750000
NODE_10569_length_843_cov_27.060484	423	503	0	80	80	1.0000000
NODE_10569_length_843_cov_27.060484	476	556	0	39	80	0.4875000
NODE_10569_length_843_cov_27.060484	476	556	2	41	80	0.5125000
NODE_10570_length_843_cov_22.725806	334	414	0	80	80	1.0000000
NODE_10570_length_843_cov_22.725806	339	396	0	57	57	1.0000000
NODE_10570_length_843_cov_22.725806	356	427	0	71	71	1.0000000
NODE_10570_length_843_cov_22.725806	387	455	0	68	68	1.0000000
NODE_10570_length_843_cov_22.725806	401	476	0	75	75	1.0000000
NODE_10570_length_843_cov_22.725806	418	486	0	68	68	1.0000000
NODE_10570_length_843_cov_22.725806	449	529	0	80	80	1.0000000
NODE_10571_length_843_cov_22.387097	412	492	0	80	80	1.0000000
NODE_10571_length_843_cov_22.387097	465	545	0	31	80	0.3875000
NODE_10571_length_843_cov_22.387097	465	545	2	49	80	0.6125000
NODE_10572_length_843_cov_16.326613	551	631	2	2	80	0.0250000
NODE_10572_length_843_cov_16.326613	551	631	4	78	80	0.9750000
NODE_10572_length_843_cov_16.326613	604	684	0	16	80	0.2000000
NODE_10572_length_843_cov_16.326613	604	684	2	11	80	0.1375000
NODE_10572_length_843_cov_16.326613	604	684	4	53	80	0.6625000
NODE_10573_length_843_cov_13.478495	381	461	0	66	80	0.8250000
NODE_10573_length_843_cov_13.478495	381	461	2	14	80	0.1750000
NODE_10573_length_843_cov_13.478495	434	514	0	13	80	0.1625000
NODE_10573_length_843_cov_13.478495	434	514	2	16	80	0.2000000
NODE_10573_length_843_cov_13.478495	434	514	4	51	80	0.6375000
NODE_10574_length_843_cov_13.150538	448	528	0	3	80	0.0375000
NODE_10574_length_843_cov_13.150538	448	528	4	77	80	0.9625000
NODE_10574_length_843_cov_13.150538	501	581	0	56	80	0.7000000
NODE_10574_length_843_cov_13.150538	501	581	4	24	80	0.3000000
NODE_10575_length_843_cov_12.510753	360	440	0	80	80	1.0000000
NODE_10575_length_843_cov_12.510753	413	493	0	80	80	1.0000000
NODE_10576_length_843_cov_11.090054	457	537	0	80	80	1.0000000
NODE_10576_length_843_cov_11.090054	510	590	0	80	80	1.0000000
NODE_10577_length_843_cov_7.672043	472	552	0	46	80	0.5750000
NODE_10577_length_843_cov_7.672043	472	552	3	1	80	0.0125000
NODE_10577_length_843_cov_7.672043	472	552	4	33	80	0.4125000
NODE_10577_length_843_cov_7.672043	525	605	4	80	80	1.0000000
NODE_10601_length_842_cov_39.518170	390	470	0	77	80	0.9625000
NODE_10601_length_842_cov_39.518170	390	470	6	3	80	0.0375000
NODE_10601_length_842_cov_39.518170	443	523	0	80	80	1.0000000
NODE_10602_length_842_cov_21.567968	331	411	0	80	80	1.0000000
NODE_10602_length_842_cov_21.567968	384	464	0	80	80	1.0000000
NODE_10603_length_842_cov_19.761777	228	308	0	47	80	0.5875000
NODE_10603_length_842_cov_19.761777	228	308	2	33	80	0.4125000
NODE_10603_length_842_cov_19.761777	281	361	2	80	80	1.0000000
NODE_10605_length_842_cov_8.703903	641	722	0	81	81	1.0000000
NODE_10608_length_842_cov_5.305518	287	367	0	80	80	1.0000000
NODE_10608_length_842_cov_5.305518	340	420	0	80	80	1.0000000
NODE_10617_length_842_cov_1.751009	35	66	0	31	31	1.0000000
NODE_10622_length_841_cov_23.815364	292	372	0	80	80	1.0000000
NODE_10622_length_841_cov_23.815364	345	425	0	80	80	1.0000000
NODE_10623_length_841_cov_18.871968	338	418	0	80	80	1.0000000
NODE_10623_length_841_cov_18.871968	391	471	0	80	80	1.0000000
NODE_10624_length_841_cov_14.663073	345	425	0	80	80	1.0000000
NODE_10624_length_841_cov_14.663073	398	478	0	80	80	1.0000000
NODE_10625_length_841_cov_14.149596	341	421	0	80	80	1.0000000
NODE_10625_length_841_cov_14.149596	394	474	0	80	80	1.0000000
NODE_10626_length_841_cov_12.452830	240	320	2	80	80	1.0000000
NODE_10626_length_841_cov_12.452830	293	373	0	37	80	0.4625000
NODE_10626_length_841_cov_12.452830	293	373	2	43	80	0.5375000
NODE_10628_length_841_cov_9.925876	394	474	0	80	80	1.0000000
NODE_10628_length_841_cov_9.925876	447	527	0	80	80	1.0000000
NODE_10629_length_841_cov_7.407008	317	397	0	80	80	1.0000000
NODE_10629_length_841_cov_7.407008	370	450	0	80	80	1.0000000
NODE_10632_length_841_cov_3.865229	305	356	0	51	51	1.0000000
NODE_10651_length_840_cov_63.726046	461	541	8	8	80	0.1000000
NODE_10651_length_840_cov_63.726046	461	541	9	1	80	0.0125000
NODE_10651_length_840_cov_63.726046	461	541	10	21	80	0.2625000
NODE_10651_length_840_cov_63.726046	461	541	12	36	80	0.4500000
NODE_10651_length_840_cov_63.726046	461	541	14	14	80	0.1750000
NODE_10651_length_840_cov_63.726046	514	594	2	20	80	0.2500000
NODE_10651_length_840_cov_63.726046	514	594	4	5	80	0.0625000
NODE_10651_length_840_cov_63.726046	514	594	6	3	80	0.0375000
NODE_10651_length_840_cov_63.726046	514	594	7	1	80	0.0125000
NODE_10651_length_840_cov_63.726046	514	594	9	2	80	0.0250000
NODE_10651_length_840_cov_63.726046	514	594	10	8	80	0.1000000
NODE_10651_length_840_cov_63.726046	514	594	12	27	80	0.3375000
NODE_10651_length_840_cov_63.726046	514	594	14	14	80	0.1750000
NODE_10652_length_840_cov_35.874494	486	566	0	6	80	0.0750000
NODE_10652_length_840_cov_35.874494	486	566	2	21	80	0.2625000
NODE_10652_length_840_cov_35.874494	486	566	6	53	80	0.6625000
NODE_10652_length_840_cov_35.874494	539	619	0	33	80	0.4125000
NODE_10652_length_840_cov_35.874494	539	619	4	16	80	0.2000000
NODE_10652_length_840_cov_35.874494	539	619	6	31	80	0.3875000
NODE_10653_length_840_cov_24.499325	224	304	0	9	80	0.1125000
NODE_10653_length_840_cov_24.499325	224	304	2	71	80	0.8875000
NODE_10653_length_840_cov_24.499325	277	357	0	62	80	0.7750000
NODE_10653_length_840_cov_24.499325	277	357	2	18	80	0.2250000
NODE_10653_length_840_cov_24.499325	353	433	0	80	80	1.0000000
NODE_10653_length_840_cov_24.499325	406	486	0	80	80	1.0000000
NODE_10654_length_840_cov_23.272605	309	389	0	15	80	0.1875000
NODE_10654_length_840_cov_23.272605	309	389	2	10	80	0.1250000
NODE_10654_length_840_cov_23.272605	309	389	4	55	80	0.6875000
NODE_10654_length_840_cov_23.272605	362	442	2	9	80	0.1125000
NODE_10654_length_840_cov_23.272605	362	442	4	71	80	0.8875000
NODE_10655_length_840_cov_22.221323	293	373	0	80	80	1.0000000
NODE_10655_length_840_cov_22.221323	346	426	0	80	80	1.0000000
NODE_10656_length_840_cov_17.026991	348	432	0	84	84	1.0000000
NODE_10656_length_840_cov_17.026991	405	485	0	80	80	1.0000000
NODE_10657_length_840_cov_16.635628	347	427	0	80	80	1.0000000
NODE_10657_length_840_cov_16.635628	400	480	0	80	80	1.0000000
NODE_10658_length_840_cov_12.133603	336	416	0	80	80	1.0000000
NODE_10658_length_840_cov_12.133603	389	469	0	80	80	1.0000000
NODE_10659_length_840_cov_12.041835	332	412	0	9	80	0.1125000
NODE_10659_length_840_cov_12.041835	332	412	2	71	80	0.8875000
NODE_10659_length_840_cov_12.041835	385	465	0	16	80	0.2000000
NODE_10659_length_840_cov_12.041835	385	465	2	64	80	0.8000000
NODE_10660_length_840_cov_10.719298	275	354	0	29	79	0.3670886
NODE_10660_length_840_cov_10.719298	275	354	2	50	79	0.6329114
NODE_10660_length_840_cov_10.719298	327	407	0	35	80	0.4375000
NODE_10660_length_840_cov_10.719298	327	407	2	45	80	0.5625000
NODE_10663_length_840_cov_5.207827	427	507	0	80	80	1.0000000
NODE_10663_length_840_cov_5.207827	480	560	0	80	80	1.0000000
NODE_10683_length_839_cov_274.987838	450	530	29	2	80	0.0250000
NODE_10683_length_839_cov_274.987838	450	530	30	4	80	0.0500000
NODE_10683_length_839_cov_274.987838	450	530	31	1	80	0.0125000
NODE_10683_length_839_cov_274.987838	450	530	32	2	80	0.0250000
NODE_10683_length_839_cov_274.987838	450	530	34	1	80	0.0125000
NODE_10683_length_839_cov_274.987838	450	530	35	1	80	0.0125000
NODE_10683_length_839_cov_274.987838	450	530	36	2	80	0.0250000
NODE_10683_length_839_cov_274.987838	450	530	39	1	80	0.0125000
NODE_10683_length_839_cov_274.987838	450	530	41	2	80	0.0250000
NODE_10683_length_839_cov_274.987838	450	530	44	2	80	0.0250000
NODE_10683_length_839_cov_274.987838	450	530	45	3	80	0.0375000
NODE_10683_length_839_cov_274.987838	450	530	47	1	80	0.0125000
NODE_10683_length_839_cov_274.987838	450	530	48	2	80	0.0250000
NODE_10683_length_839_cov_274.987838	450	530	52	1	80	0.0125000
NODE_10683_length_839_cov_274.987838	450	530	58	2	80	0.0250000
NODE_10683_length_839_cov_274.987838	450	530	62	3	80	0.0375000
NODE_10683_length_839_cov_274.987838	450	530	66	2	80	0.0250000
NODE_10683_length_839_cov_274.987838	450	530	68	1	80	0.0125000
NODE_10683_length_839_cov_274.987838	450	530	74	1	80	0.0125000
NODE_10683_length_839_cov_274.987838	450	530	78	1	80	0.0125000
NODE_10683_length_839_cov_274.987838	450	530	82	1	80	0.0125000
NODE_10683_length_839_cov_274.987838	450	530	84	7	80	0.0875000
NODE_10683_length_839_cov_274.987838	450	530	88	3	80	0.0375000
NODE_10683_length_839_cov_274.987838	450	530	90	6	80	0.0750000
NODE_10683_length_839_cov_274.987838	450	530	92	7	80	0.0875000
NODE_10683_length_839_cov_274.987838	450	530	93	2	80	0.0250000
NODE_10683_length_839_cov_274.987838	450	530	94	5	80	0.0625000
NODE_10683_length_839_cov_274.987838	450	530	95	1	80	0.0125000
NODE_10683_length_839_cov_274.987838	450	530	97	4	80	0.0500000
NODE_10683_length_839_cov_274.987838	450	530	98	2	80	0.0250000
NODE_10683_length_839_cov_274.987838	450	530	100	1	80	0.0125000
NODE_10683_length_839_cov_274.987838	450	530	101	1	80	0.0125000
NODE_10683_length_839_cov_274.987838	450	530	102	5	80	0.0625000
NODE_10683_length_839_cov_274.987838	503	583	78	2	80	0.0250000
NODE_10683_length_839_cov_274.987838	503	583	81	4	80	0.0500000
NODE_10683_length_839_cov_274.987838	503	583	82	2	80	0.0250000
NODE_10683_length_839_cov_274.987838	503	583	85	1	80	0.0125000
NODE_10683_length_839_cov_274.987838	503	583	88	1	80	0.0125000
NODE_10683_length_839_cov_274.987838	503	583	90	1	80	0.0125000
NODE_10683_length_839_cov_274.987838	503	583	92	6	80	0.0750000
NODE_10683_length_839_cov_274.987838	503	583	93	2	80	0.0250000
NODE_10683_length_839_cov_274.987838	503	583	94	5	80	0.0625000
NODE_10683_length_839_cov_274.987838	503	583	95	1	80	0.0125000
NODE_10683_length_839_cov_274.987838	503	583	96	4	80	0.0500000
NODE_10683_length_839_cov_274.987838	503	583	97	4	80	0.0500000
NODE_10683_length_839_cov_274.987838	503	583	98	2	80	0.0250000
NODE_10683_length_839_cov_274.987838	503	583	100	1	80	0.0125000
NODE_10683_length_839_cov_274.987838	503	583	101	1	80	0.0125000
NODE_10683_length_839_cov_274.987838	503	583	102	8	80	0.1000000
NODE_10683_length_839_cov_274.987838	503	583	104	1	80	0.0125000
NODE_10683_length_839_cov_274.987838	503	583	106	2	80	0.0250000
NODE_10683_length_839_cov_274.987838	503	583	108	1	80	0.0125000
NODE_10683_length_839_cov_274.987838	503	583	110	2	80	0.0250000
NODE_10683_length_839_cov_274.987838	503	583	112	5	80	0.0625000
NODE_10683_length_839_cov_274.987838	503	583	114	4	80	0.0500000
NODE_10683_length_839_cov_274.987838	503	583	116	5	80	0.0625000
NODE_10683_length_839_cov_274.987838	503	583	118	2	80	0.0250000
NODE_10683_length_839_cov_274.987838	503	583	120	1	80	0.0125000
NODE_10683_length_839_cov_274.987838	503	583	122	2	80	0.0250000
NODE_10683_length_839_cov_274.987838	503	583	124	7	80	0.0875000
NODE_10683_length_839_cov_274.987838	503	583	126	3	80	0.0375000
NODE_10684_length_839_cov_24.500000	303	383	2	18	80	0.2250000
NODE_10684_length_839_cov_24.500000	303	383	4	62	80	0.7750000
NODE_10684_length_839_cov_24.500000	356	436	0	48	80	0.6000000
NODE_10684_length_839_cov_24.500000	356	436	4	32	80	0.4000000
NODE_10685_length_839_cov_16.390541	477	557	0	80	80	1.0000000
NODE_10685_length_839_cov_16.390541	530	610	0	60	80	0.7500000
NODE_10685_length_839_cov_16.390541	530	610	2	20	80	0.2500000
NODE_10686_length_839_cov_10.006757	383	463	0	80	80	1.0000000
NODE_10686_length_839_cov_10.006757	436	516	0	80	80	1.0000000
NODE_10688_length_839_cov_7.612162	308	388	0	80	80	1.0000000
NODE_10688_length_839_cov_7.612162	361	441	0	80	80	1.0000000
NODE_10689_length_839_cov_6.693243	343	423	2	80	80	1.0000000
NODE_10706_length_838_cov_39.263870	383	463	2	48	80	0.6000000
NODE_10706_length_838_cov_39.263870	383	463	4	8	80	0.1000000
NODE_10706_length_838_cov_39.263870	383	463	6	24	80	0.3000000
NODE_10706_length_838_cov_39.263870	436	516	4	56	80	0.7000000
NODE_10706_length_838_cov_39.263870	436	516	6	24	80	0.3000000
NODE_10707_length_838_cov_27.843031	473	553	0	80	80	1.0000000
NODE_10707_length_838_cov_27.843031	526	606	0	80	80	1.0000000
NODE_10708_length_838_cov_27.238160	432	512	2	41	80	0.5125000
NODE_10708_length_838_cov_27.238160	432	512	4	39	80	0.4875000
NODE_10708_length_838_cov_27.238160	485	565	0	19	80	0.2375000
NODE_10708_length_838_cov_27.238160	485	565	2	42	80	0.5250000
NODE_10708_length_838_cov_27.238160	485	565	4	19	80	0.2375000
NODE_10709_length_838_cov_22.691475	380	460	0	74	80	0.9250000
NODE_10709_length_838_cov_22.691475	380	460	2	6	80	0.0750000
NODE_10709_length_838_cov_22.691475	433	513	0	80	80	1.0000000
NODE_10710_length_838_cov_16.169147	312	392	0	80	80	1.0000000
NODE_10710_length_838_cov_16.169147	365	445	0	80	80	1.0000000
NODE_10711_length_838_cov_15.753721	328	408	0	12	80	0.1500000
NODE_10711_length_838_cov_15.753721	328	408	2	68	80	0.8500000
NODE_10711_length_838_cov_15.753721	381	461	0	65	80	0.8125000
NODE_10711_length_838_cov_15.753721	381	461	2	15	80	0.1875000
NODE_10712_length_838_cov_15.514208	294	374	0	80	80	1.0000000
NODE_10712_length_838_cov_15.514208	347	427	0	80	80	1.0000000
NODE_10713_length_838_cov_7.733424	350	430	2	80	80	1.0000000
NODE_10713_length_838_cov_7.733424	403	483	0	50	80	0.6250000
NODE_10713_length_838_cov_7.733424	403	483	2	30	80	0.3750000
NODE_10716_length_838_cov_4.511502	131	213	0	61	82	0.7439024
NODE_10716_length_838_cov_4.511502	131	213	2	21	82	0.2560976
NODE_10716_length_838_cov_4.511502	184	252	0	68	68	1.0000000
NODE_10722_length_838_cov_2.247632	359	405	0	46	46	1.0000000
NODE_10727_length_838_cov_1.843031	732	752	0	20	20	1.0000000
NODE_10740_length_837_cov_32.691057	401	481	2	80	80	1.0000000
NODE_10740_length_837_cov_32.691057	454	534	0	44	80	0.5500000
NODE_10740_length_837_cov_32.691057	454	534	2	36	80	0.4500000
NODE_10741_length_837_cov_30.995935	399	479	0	18	80	0.2250000
NODE_10741_length_837_cov_30.995935	399	479	1	3	80	0.0375000
NODE_10741_length_837_cov_30.995935	399	479	2	59	80	0.7375000
NODE_10741_length_837_cov_30.995935	452	532	0	71	80	0.8875000
NODE_10741_length_837_cov_30.995935	452	532	1	3	80	0.0375000
NODE_10741_length_837_cov_30.995935	452	532	2	6	80	0.0750000
NODE_10742_length_837_cov_30.883469	278	358	0	80	80	1.0000000
NODE_10742_length_837_cov_30.883469	331	411	0	80	80	1.0000000
NODE_10742_length_837_cov_30.883469	407	487	0	27	80	0.3375000
NODE_10742_length_837_cov_30.883469	407	487	2	53	80	0.6625000
NODE_10742_length_837_cov_30.883469	460	540	2	80	80	1.0000000
NODE_10743_length_837_cov_14.573171	205	280	0	75	75	1.0000000
NODE_10743_length_837_cov_14.573171	258	337	0	79	79	1.0000000
NODE_10743_length_837_cov_14.573171	333	413	0	80	80	1.0000000
NODE_10743_length_837_cov_14.573171	386	466	0	80	80	1.0000000
NODE_10744_length_837_cov_12.582656	226	306	0	76	80	0.9500000
NODE_10744_length_837_cov_12.582656	226	306	4	4	80	0.0500000
NODE_10744_length_837_cov_12.582656	279	359	0	23	80	0.2875000
NODE_10744_length_837_cov_12.582656	279	359	4	57	80	0.7125000
NODE_10745_length_837_cov_6.998645	389	474	0	85	85	1.0000000
NODE_10745_length_837_cov_6.998645	447	527	0	80	80	1.0000000
NODE_10750_length_837_cov_3.119241	373	453	0	80	80	1.0000000
NODE_10750_length_837_cov_3.119241	426	506	0	80	80	1.0000000
NODE_10769_length_836_cov_40.141113	224	304	0	45	80	0.5625000
NODE_10769_length_836_cov_40.141113	224	304	4	35	80	0.4375000
NODE_10769_length_836_cov_40.141113	277	357	4	80	80	1.0000000
NODE_10769_length_836_cov_40.141113	353	433	0	21	80	0.2625000
NODE_10769_length_836_cov_40.141113	353	433	2	30	80	0.3750000
NODE_10769_length_836_cov_40.141113	353	433	4	29	80	0.3625000
NODE_10769_length_836_cov_40.141113	406	486	2	80	80	1.0000000
NODE_10770_length_836_cov_27.610583	344	424	0	30	80	0.3750000
NODE_10770_length_836_cov_27.610583	344	424	2	50	80	0.6250000
NODE_10770_length_836_cov_27.610583	397	477	0	80	80	1.0000000
NODE_10771_length_836_cov_15.719132	295	375	0	80	80	1.0000000
NODE_10771_length_836_cov_15.719132	348	428	0	80	80	1.0000000
NODE_10772_length_836_cov_9.309362	295	375	0	80	80	1.0000000
NODE_10772_length_836_cov_9.309362	348	428	0	80	80	1.0000000
NODE_10773_length_836_cov_6.283582	336	416	0	80	80	1.0000000
NODE_10773_length_836_cov_6.283582	389	469	0	80	80	1.0000000
NODE_10774_length_836_cov_4.979647	371	451	0	15	80	0.1875000
NODE_10774_length_836_cov_4.979647	371	451	4	65	80	0.8125000
NODE_10774_length_836_cov_4.979647	424	504	0	37	80	0.4625000
NODE_10774_length_836_cov_4.979647	424	504	4	43	80	0.5375000
NODE_10787_length_835_cov_61.033967	253	333	2	2	80	0.0250000
NODE_10787_length_835_cov_61.033967	253	333	4	20	80	0.2500000
NODE_10787_length_835_cov_61.033967	253	333	6	41	80	0.5125000
NODE_10787_length_835_cov_61.033967	253	333	8	17	80	0.2125000
NODE_10787_length_835_cov_61.033967	306	386	4	31	80	0.3875000
NODE_10787_length_835_cov_61.033967	306	386	6	10	80	0.1250000
NODE_10787_length_835_cov_61.033967	306	386	8	39	80	0.4875000
NODE_10788_length_835_cov_32.380435	390	470	0	80	80	1.0000000
NODE_10788_length_835_cov_32.380435	443	523	0	80	80	1.0000000
NODE_10789_length_835_cov_20.779891	415	495	0	15	80	0.1875000
NODE_10789_length_835_cov_20.779891	415	495	1	6	80	0.0750000
NODE_10789_length_835_cov_20.779891	415	495	2	59	80	0.7375000
NODE_10789_length_835_cov_20.779891	468	548	0	23	80	0.2875000
NODE_10789_length_835_cov_20.779891	468	548	2	57	80	0.7125000
NODE_10808_length_835_cov_1.694293	18	80	0	8	62	0.1290323
NODE_10808_length_835_cov_1.694293	18	80	2	54	62	0.8709677
NODE_10820_length_834_cov_13.689796	213	293	3	41	80	0.5125000
NODE_10820_length_834_cov_13.689796	213	293	5	39	80	0.4875000
NODE_10820_length_834_cov_13.689796	266	346	2	20	80	0.2500000
NODE_10820_length_834_cov_13.689796	266	346	5	60	80	0.7500000
NODE_10822_length_834_cov_12.609524	406	486	0	57	80	0.7125000
NODE_10822_length_834_cov_12.609524	406	486	2	23	80	0.2875000
NODE_10822_length_834_cov_12.609524	459	539	0	59	80	0.7375000
NODE_10822_length_834_cov_12.609524	459	539	2	21	80	0.2625000
NODE_10823_length_834_cov_11.492517	248	328	2	38	80	0.4750000
NODE_10823_length_834_cov_11.492517	248	328	4	42	80	0.5250000
NODE_10823_length_834_cov_11.492517	301	381	2	47	80	0.5875000
NODE_10823_length_834_cov_11.492517	301	381	4	33	80	0.4125000
NODE_10824_length_834_cov_9.957823	212	292	0	80	80	1.0000000
NODE_10824_length_834_cov_9.957823	265	345	0	80	80	1.0000000
NODE_10825_length_834_cov_6.448980	482	546	0	3	64	0.0468750
NODE_10825_length_834_cov_6.448980	482	546	4	61	64	0.9531250
NODE_10833_length_834_cov_2.658503	589	641	0	52	52	1.0000000
NODE_10846_length_833_cov_57.702997	338	418	0	35	80	0.4375000
NODE_10846_length_833_cov_57.702997	338	418	4	45	80	0.5625000
NODE_10846_length_833_cov_57.702997	391	471	4	80	80	1.0000000
NODE_10847_length_833_cov_38.153951	364	444	2	33	80	0.4125000
NODE_10847_length_833_cov_38.153951	364	444	4	47	80	0.5875000
NODE_10847_length_833_cov_38.153951	417	497	0	46	80	0.5750000
NODE_10847_length_833_cov_38.153951	417	497	2	30	80	0.3750000
NODE_10847_length_833_cov_38.153951	417	497	4	4	80	0.0500000
NODE_10848_length_833_cov_34.302452	368	448	0	42	80	0.5250000
NODE_10848_length_833_cov_34.302452	368	448	2	36	80	0.4500000
NODE_10848_length_833_cov_34.302452	368	448	4	2	80	0.0250000
NODE_10848_length_833_cov_34.302452	421	501	2	25	80	0.3125000
NODE_10848_length_833_cov_34.302452	421	501	4	21	80	0.2625000
NODE_10848_length_833_cov_34.302452	421	501	6	34	80	0.4250000
NODE_10849_length_833_cov_20.452316	311	392	0	81	81	1.0000000
NODE_10849_length_833_cov_20.452316	365	445	0	80	80	1.0000000
NODE_10850_length_833_cov_16.643052	238	318	0	80	80	1.0000000
NODE_10851_length_833_cov_16.536785	84	164	0	5	80	0.0625000
NODE_10851_length_833_cov_16.536785	84	164	4	3	80	0.0375000
NODE_10851_length_833_cov_16.536785	84	164	6	41	80	0.5125000
NODE_10851_length_833_cov_16.536785	84	164	8	31	80	0.3875000
NODE_10851_length_833_cov_16.536785	137	217	0	15	80	0.1875000
NODE_10851_length_833_cov_16.536785	137	217	2	12	80	0.1500000
NODE_10851_length_833_cov_16.536785	137	217	6	25	80	0.3125000
NODE_10851_length_833_cov_16.536785	137	217	8	28	80	0.3500000
NODE_10865_length_833_cov_3.089918	467	547	0	80	80	1.0000000
NODE_10865_length_833_cov_3.089918	520	600	0	80	80	1.0000000
NODE_10891_length_832_cov_35.728513	460	540	0	80	80	1.0000000
NODE_10891_length_832_cov_35.728513	513	593	0	80	80	1.0000000
NODE_10892_length_832_cov_25.450205	292	372	0	80	80	1.0000000
NODE_10892_length_832_cov_25.450205	345	425	0	80	80	1.0000000
NODE_10893_length_832_cov_18.858117	428	508	4	2	80	0.0250000
NODE_10893_length_832_cov_18.858117	428	508	6	6	80	0.0750000
NODE_10893_length_832_cov_18.858117	428	508	8	32	80	0.4000000
NODE_10893_length_832_cov_18.858117	428	508	10	19	80	0.2375000
NODE_10893_length_832_cov_18.858117	428	508	12	21	80	0.2625000
NODE_10893_length_832_cov_18.858117	481	561	4	44	80	0.5500000
NODE_10893_length_832_cov_18.858117	481	561	6	14	80	0.1750000
NODE_10893_length_832_cov_18.858117	481	561	10	19	80	0.2375000
NODE_10893_length_832_cov_18.858117	481	561	12	3	80	0.0375000
NODE_10894_length_832_cov_17.799454	314	394	0	80	80	1.0000000
NODE_10894_length_832_cov_17.799454	367	447	0	80	80	1.0000000
NODE_10895_length_832_cov_14.811733	353	433	0	55	80	0.6875000
NODE_10895_length_832_cov_14.811733	353	433	2	13	80	0.1625000
NODE_10895_length_832_cov_14.811733	353	433	4	12	80	0.1500000
NODE_10896_length_832_cov_14.770805	259	339	0	80	80	1.0000000
NODE_10896_length_832_cov_14.770805	312	392	0	80	80	1.0000000
NODE_10897_length_832_cov_8.305593	266	346	0	69	80	0.8625000
NODE_10897_length_832_cov_8.305593	266	346	2	11	80	0.1375000
NODE_10897_length_832_cov_8.305593	319	399	0	16	80	0.2000000
NODE_10897_length_832_cov_8.305593	319	399	2	35	80	0.4375000
NODE_10897_length_832_cov_8.305593	319	399	4	29	80	0.3625000
NODE_10918_length_831_cov_18.403005	371	451	0	44	80	0.5500000
NODE_10918_length_831_cov_18.403005	371	451	2	12	80	0.1500000
NODE_10918_length_831_cov_18.403005	371	451	4	24	80	0.3000000
NODE_10918_length_831_cov_18.403005	424	504	2	3	80	0.0375000
NODE_10918_length_831_cov_18.403005	424	504	4	77	80	0.9625000
NODE_10919_length_831_cov_16.017760	357	437	0	66	80	0.8250000
NODE_10919_length_831_cov_16.017760	357	437	2	14	80	0.1750000
NODE_10919_length_831_cov_16.017760	410	490	0	13	80	0.1625000
NODE_10919_length_831_cov_16.017760	410	490	2	67	80	0.8375000
NODE_10920_length_831_cov_13.740437	405	485	0	61	80	0.7625000
NODE_10920_length_831_cov_13.740437	405	485	2	19	80	0.2375000
NODE_10920_length_831_cov_13.740437	458	538	0	8	80	0.1000000
NODE_10920_length_831_cov_13.740437	458	538	2	48	80	0.6000000
NODE_10920_length_831_cov_13.740437	458	538	4	24	80	0.3000000
NODE_10921_length_831_cov_9.595628	281	361	0	80	80	1.0000000
NODE_10921_length_831_cov_9.595628	334	414	0	80	80	1.0000000
NODE_10922_length_831_cov_8.199454	433	482	2	49	49	1.0000000
NODE_10923_length_831_cov_7.607923	216	296	0	32	80	0.4000000
NODE_10923_length_831_cov_7.607923	216	296	2	48	80	0.6000000
NODE_10923_length_831_cov_7.607923	269	349	0	9	80	0.1125000
NODE_10923_length_831_cov_7.607923	269	349	2	71	80	0.8875000
NODE_10924_length_831_cov_6.454918	334	409	0	35	75	0.4666667
NODE_10924_length_831_cov_6.454918	334	409	2	40	75	0.5333334
NODE_10924_length_831_cov_6.454918	382	462	2	80	80	1.0000000
NODE_10960_length_830_cov_40.856361	238	318	0	14	80	0.1750000
NODE_10960_length_830_cov_40.856361	238	318	5	1	80	0.0125000
NODE_10960_length_830_cov_40.856361	238	318	6	54	80	0.6750000
NODE_10960_length_830_cov_40.856361	238	318	10	11	80	0.1375000
NODE_10960_length_830_cov_40.856361	291	371	6	16	80	0.2000000
NODE_10960_length_830_cov_40.856361	291	371	10	64	80	0.8000000
NODE_10961_length_830_cov_32.170999	302	378	0	64	76	0.8421053
NODE_10961_length_830_cov_32.170999	302	378	2	12	76	0.1578947
NODE_10961_length_830_cov_32.170999	303	383	0	63	80	0.7875000
NODE_10961_length_830_cov_32.170999	303	383	2	17	80	0.2125000
NODE_10961_length_830_cov_32.170999	356	436	0	10	80	0.1250000
NODE_10961_length_830_cov_32.170999	356	436	2	53	80	0.6625000
NODE_10961_length_830_cov_32.170999	356	436	6	17	80	0.2125000
NODE_10962_length_830_cov_28.041040	393	473	0	25	80	0.3125000
NODE_10962_length_830_cov_28.041040	393	473	2	55	80	0.6875000
NODE_10962_length_830_cov_28.041040	446	526	0	37	80	0.4625000
NODE_10962_length_830_cov_28.041040	446	526	2	43	80	0.5375000
NODE_10963_length_830_cov_20.280438	360	440	0	34	80	0.4250000
NODE_10963_length_830_cov_20.280438	360	440	2	46	80	0.5750000
NODE_10963_length_830_cov_20.280438	413	492	0	25	79	0.3164557
NODE_10963_length_830_cov_20.280438	413	492	2	54	79	0.6835443
NODE_10964_length_830_cov_19.495212	274	354	0	35	80	0.4375000
NODE_10964_length_830_cov_19.495212	274	354	2	18	80	0.2250000
NODE_10964_length_830_cov_19.495212	274	354	4	27	80	0.3375000
NODE_10964_length_830_cov_19.495212	327	407	4	80	80	1.0000000
NODE_10965_length_830_cov_18.522572	368	448	0	36	80	0.4500000
NODE_10965_length_830_cov_18.522572	368	448	4	44	80	0.5500000
NODE_10965_length_830_cov_18.522572	421	501	4	37	80	0.4625000
NODE_10965_length_830_cov_18.522572	421	501	6	43	80	0.5375000
NODE_10966_length_830_cov_13.830369	278	358	0	20	80	0.2500000
NODE_10966_length_830_cov_13.830369	278	358	2	6	80	0.0750000
NODE_10966_length_830_cov_13.830369	278	358	4	54	80	0.6750000
NODE_10966_length_830_cov_13.830369	331	411	0	11	80	0.1375000
NODE_10966_length_830_cov_13.830369	331	411	2	16	80	0.2000000
NODE_10966_length_830_cov_13.830369	331	411	4	53	80	0.6625000
NODE_10967_length_830_cov_12.459644	201	281	0	80	80	1.0000000
NODE_10967_length_830_cov_12.459644	254	334	0	80	80	1.0000000
NODE_10968_length_830_cov_8.344733	450	530	0	80	80	1.0000000
NODE_10968_length_830_cov_8.344733	503	583	0	80	80	1.0000000
NODE_10969_length_830_cov_8.227086	634	714	0	6	80	0.0750000
NODE_10969_length_830_cov_8.227086	634	714	2	74	80	0.9250000
NODE_10969_length_830_cov_8.227086	687	767	0	51	80	0.6375000
NODE_10969_length_830_cov_8.227086	687	767	2	29	80	0.3625000
NODE_10995_length_829_cov_74.910959	271	351	0	2	80	0.0250000
NODE_10995_length_829_cov_74.910959	271	351	2	78	80	0.9750000
NODE_10995_length_829_cov_74.910959	324	404	0	53	80	0.6625000
NODE_10995_length_829_cov_74.910959	324	404	2	27	80	0.3375000
NODE_10996_length_829_cov_34.068493	302	382	4	80	80	1.0000000
NODE_10996_length_829_cov_34.068493	355	435	0	51	80	0.6375000
NODE_10996_length_829_cov_34.068493	355	435	4	29	80	0.3625000
NODE_10997_length_829_cov_24.027397	441	521	0	80	80	1.0000000
NODE_10997_length_829_cov_24.027397	494	574	0	80	80	1.0000000
NODE_10998_length_829_cov_21.735616	420	500	2	17	80	0.2125000
NODE_10998_length_829_cov_21.735616	420	500	6	2	80	0.0250000
NODE_10998_length_829_cov_21.735616	420	500	8	61	80	0.7625000
NODE_10998_length_829_cov_21.735616	473	553	0	7	80	0.0875000
NODE_10998_length_829_cov_21.735616	473	553	1	5	80	0.0625000
NODE_10998_length_829_cov_21.735616	473	553	2	2	80	0.0250000
NODE_10998_length_829_cov_21.735616	473	553	4	13	80	0.1625000
NODE_10998_length_829_cov_21.735616	473	553	8	53	80	0.6625000
NODE_10999_length_829_cov_18.446575	407	487	0	80	80	1.0000000
NODE_10999_length_829_cov_18.446575	460	540	0	80	80	1.0000000
NODE_11000_length_829_cov_10.971233	368	448	0	35	80	0.4375000
NODE_11000_length_829_cov_10.971233	368	448	2	9	80	0.1125000
NODE_11000_length_829_cov_10.971233	368	448	4	12	80	0.1500000
NODE_11000_length_829_cov_10.971233	368	448	6	12	80	0.1500000
NODE_11000_length_829_cov_10.971233	368	448	8	12	80	0.1500000
NODE_11000_length_829_cov_10.971233	421	501	0	53	80	0.6625000
NODE_11000_length_829_cov_10.971233	421	501	2	27	80	0.3375000
NODE_11001_length_829_cov_10.035616	387	467	0	80	80	1.0000000
NODE_11001_length_829_cov_10.035616	440	520	0	80	80	1.0000000
NODE_11002_length_829_cov_9.906849	326	406	1	80	80	1.0000000
NODE_11002_length_829_cov_9.906849	379	459	0	12	80	0.1500000
NODE_11002_length_829_cov_9.906849	379	459	1	68	80	0.8500000
NODE_11003_length_829_cov_8.809589	450	530	0	80	80	1.0000000
NODE_11003_length_829_cov_8.809589	503	583	0	80	80	1.0000000
NODE_11006_length_829_cov_4.310959	473	553	0	80	80	1.0000000
NODE_11006_length_829_cov_4.310959	526	606	0	80	80	1.0000000
NODE_11008_length_829_cov_3.079452	507	587	0	31	80	0.3875000
NODE_11008_length_829_cov_3.079452	507	587	2	4	80	0.0500000
NODE_11008_length_829_cov_3.079452	507	587	4	9	80	0.1125000
NODE_11008_length_829_cov_3.079452	507	587	6	36	80	0.4500000
NODE_11008_length_829_cov_3.079452	507	587	0	31	80	0.3875000
NODE_11008_length_829_cov_3.079452	507	587	2	4	80	0.0500000
NODE_11008_length_829_cov_3.079452	507	587	4	9	80	0.1125000
NODE_11008_length_829_cov_3.079452	507	587	6	36	80	0.4500000
NODE_11008_length_829_cov_3.079452	560	640	0	21	80	0.2625000
NODE_11008_length_829_cov_3.079452	560	640	2	17	80	0.2125000
NODE_11008_length_829_cov_3.079452	560	640	4	23	80	0.2875000
NODE_11008_length_829_cov_3.079452	560	640	6	19	80	0.2375000
NODE_11025_length_828_cov_41.116598	436	516	0	5	80	0.0625000
NODE_11025_length_828_cov_41.116598	436	516	2	8	80	0.1000000
NODE_11025_length_828_cov_41.116598	436	516	6	50	80	0.6250000
NODE_11025_length_828_cov_41.116598	436	516	10	17	80	0.2125000
NODE_11025_length_828_cov_41.116598	489	569	6	10	80	0.1250000
NODE_11025_length_828_cov_41.116598	489	569	10	18	80	0.2250000
NODE_11025_length_828_cov_41.116598	489	569	12	18	80	0.2250000
NODE_11025_length_828_cov_41.116598	489	569	14	34	80	0.4250000
NODE_11026_length_828_cov_36.459534	372	452	0	27	80	0.3375000
NODE_11026_length_828_cov_36.459534	372	452	2	53	80	0.6625000
NODE_11026_length_828_cov_36.459534	425	505	0	80	80	1.0000000
NODE_11027_length_828_cov_33.515775	443	523	0	39	80	0.4875000
NODE_11027_length_828_cov_33.515775	443	523	2	41	80	0.5125000
NODE_11027_length_828_cov_33.515775	496	576	0	4	80	0.0500000
NODE_11027_length_828_cov_33.515775	496	576	2	76	80	0.9500000
NODE_11028_length_828_cov_21.123457	380	460	2	80	80	1.0000000
NODE_11028_length_828_cov_21.123457	433	513	0	50	80	0.6250000
NODE_11028_length_828_cov_21.123457	433	513	2	30	80	0.3750000
NODE_11029_length_828_cov_17.406036	304	392	0	88	88	1.0000000
NODE_11029_length_828_cov_17.406036	369	445	0	76	76	1.0000000
NODE_11030_length_828_cov_14.606310	287	367	1	51	80	0.6375000
NODE_11030_length_828_cov_14.606310	287	367	2	29	80	0.3625000
NODE_11030_length_828_cov_14.606310	340	420	0	34	80	0.4250000
NODE_11030_length_828_cov_14.606310	340	420	1	46	80	0.5750000
NODE_11031_length_828_cov_14.493827	326	406	0	10	80	0.1250000
NODE_11031_length_828_cov_14.493827	326	406	4	70	80	0.8750000
NODE_11031_length_828_cov_14.493827	379	459	0	14	80	0.1750000
NODE_11031_length_828_cov_14.493827	379	459	4	66	80	0.8250000
NODE_11031_length_828_cov_14.493827	455	535	0	80	80	1.0000000
NODE_11031_length_828_cov_14.493827	508	588	0	80	80	1.0000000
NODE_11032_length_828_cov_10.550069	280	360	0	11	80	0.1375000
NODE_11032_length_828_cov_10.550069	280	360	2	69	80	0.8625000
NODE_11032_length_828_cov_10.550069	333	413	0	64	80	0.8000000
NODE_11032_length_828_cov_10.550069	333	413	2	16	80	0.2000000
NODE_11033_length_828_cov_9.292181	594	674	0	80	80	1.0000000
NODE_11033_length_828_cov_9.292181	647	727	0	80	80	1.0000000
NODE_11034_length_828_cov_8.747599	298	378	0	5	80	0.0625000
NODE_11034_length_828_cov_8.747599	298	378	4	23	80	0.2875000
NODE_11034_length_828_cov_8.747599	298	378	8	52	80	0.6500000
NODE_11034_length_828_cov_8.747599	351	431	0	36	80	0.4500000
NODE_11034_length_828_cov_8.747599	351	431	4	6	80	0.0750000
NODE_11034_length_828_cov_8.747599	351	431	8	38	80	0.4750000
NODE_11035_length_828_cov_8.098765	199	279	0	80	80	1.0000000
NODE_11035_length_828_cov_8.098765	252	332	0	49	80	0.6125000
NODE_11035_length_828_cov_8.098765	252	332	1	15	80	0.1875000
NODE_11035_length_828_cov_8.098765	252	332	2	16	80	0.2000000
NODE_11037_length_828_cov_7.473251	300	380	2	80	80	1.0000000
NODE_11037_length_828_cov_7.473251	353	433	0	43	80	0.5375000
NODE_11037_length_828_cov_7.473251	353	433	2	37	80	0.4625000
NODE_11039_length_828_cov_5.481481	543	623	0	57	80	0.7125000
NODE_11039_length_828_cov_5.481481	543	623	2	23	80	0.2875000
NODE_11039_length_828_cov_5.481481	596	676	0	4	80	0.0500000
NODE_11039_length_828_cov_5.481481	596	676	2	76	80	0.9500000
NODE_11041_length_828_cov_5.069959	259	339	0	80	80	1.0000000
NODE_11066_length_827_cov_34.567308	269	349	0	80	80	1.0000000
NODE_11066_length_827_cov_34.567308	322	402	0	80	80	1.0000000
NODE_11066_length_827_cov_34.567308	398	478	0	80	80	1.0000000
NODE_11066_length_827_cov_34.567308	451	531	0	80	80	1.0000000
NODE_11067_length_827_cov_31.538462	320	400	0	6	80	0.0750000
NODE_11067_length_827_cov_31.538462	320	400	2	12	80	0.1500000
NODE_11067_length_827_cov_31.538462	320	400	4	48	80	0.6000000
NODE_11067_length_827_cov_31.538462	320	400	6	14	80	0.1750000
NODE_11067_length_827_cov_31.538462	373	453	2	5	80	0.0625000
NODE_11067_length_827_cov_31.538462	373	453	4	46	80	0.5750000
NODE_11067_length_827_cov_31.538462	373	453	6	29	80	0.3625000
NODE_11068_length_827_cov_19.548077	464	544	0	80	80	1.0000000
NODE_11068_length_827_cov_19.548077	517	597	0	80	80	1.0000000
NODE_11069_length_827_cov_17.490385	320	400	0	71	80	0.8875000
NODE_11069_length_827_cov_17.490385	320	400	2	9	80	0.1125000
NODE_11069_length_827_cov_17.490385	373	453	0	18	80	0.2250000
NODE_11069_length_827_cov_17.490385	373	453	2	62	80	0.7750000
NODE_11070_length_827_cov_15.247253	205	285	0	33	80	0.4125000
NODE_11070_length_827_cov_15.247253	205	285	5	1	80	0.0125000
NODE_11070_length_827_cov_15.247253	205	285	6	2	80	0.0250000
NODE_11070_length_827_cov_15.247253	205	285	8	15	80	0.1875000
NODE_11070_length_827_cov_15.247253	205	285	10	23	80	0.2875000
NODE_11070_length_827_cov_15.247253	205	285	12	6	80	0.0750000
NODE_11070_length_827_cov_15.247253	258	338	10	30	80	0.3750000
NODE_11070_length_827_cov_15.247253	258	338	12	50	80	0.6250000
NODE_11071_length_827_cov_14.151099	372	452	2	21	80	0.2625000
NODE_11071_length_827_cov_14.151099	372	452	4	59	80	0.7375000
NODE_11071_length_827_cov_14.151099	425	505	0	31	80	0.3875000
NODE_11071_length_827_cov_14.151099	425	505	2	17	80	0.2125000
NODE_11071_length_827_cov_14.151099	425	505	4	32	80	0.4000000
NODE_11072_length_827_cov_12.157967	262	342	0	39	80	0.4875000
NODE_11072_length_827_cov_12.157967	262	342	4	41	80	0.5125000
NODE_11072_length_827_cov_12.157967	315	395	4	28	80	0.3500000
NODE_11072_length_827_cov_12.157967	315	395	6	52	80	0.6500000
NODE_11073_length_827_cov_11.777473	316	396	0	80	80	1.0000000
NODE_11073_length_827_cov_11.777473	369	449	0	80	80	1.0000000
NODE_11074_length_827_cov_11.651099	393	473	0	75	80	0.9375000
NODE_11074_length_827_cov_11.651099	393	473	2	5	80	0.0625000
NODE_11074_length_827_cov_11.651099	446	526	0	22	80	0.2750000
NODE_11074_length_827_cov_11.651099	446	526	2	58	80	0.7250000
NODE_11075_length_827_cov_10.711538	286	366	0	59	80	0.7375000
NODE_11075_length_827_cov_10.711538	286	366	2	15	80	0.1875000
NODE_11075_length_827_cov_10.711538	286	366	4	6	80	0.0750000
NODE_11075_length_827_cov_10.711538	339	419	0	6	80	0.0750000
NODE_11075_length_827_cov_10.711538	339	419	2	15	80	0.1875000
NODE_11075_length_827_cov_10.711538	339	419	4	59	80	0.7375000
NODE_11076_length_827_cov_10.262363	273	353	0	40	80	0.5000000
NODE_11076_length_827_cov_10.262363	273	353	2	40	80	0.5000000
NODE_11076_length_827_cov_10.262363	326	406	0	7	80	0.0875000
NODE_11076_length_827_cov_10.262363	326	406	2	73	80	0.9125000
NODE_11077_length_827_cov_10.221154	256	336	0	6	80	0.0750000
NODE_11077_length_827_cov_10.221154	256	336	2	48	80	0.6000000
NODE_11077_length_827_cov_10.221154	256	336	4	26	80	0.3250000
NODE_11078_length_827_cov_9.576923	359	439	0	80	80	1.0000000
NODE_11078_length_827_cov_9.576923	412	492	0	80	80	1.0000000
NODE_11079_length_827_cov_8.780220	361	441	0	15	80	0.1875000
NODE_11079_length_827_cov_8.780220	361	441	2	65	80	0.8125000
NODE_11079_length_827_cov_8.780220	414	494	0	38	80	0.4750000
NODE_11079_length_827_cov_8.780220	414	494	2	42	80	0.5250000
NODE_11093_length_827_cov_1.412088	736	784	0	48	48	1.0000000
NODE_11106_length_826_cov_34.026135	211	291	0	80	80	1.0000000
NODE_11106_length_826_cov_34.026135	264	344	0	80	80	1.0000000
NODE_11107_length_826_cov_24.093535	282	362	0	69	80	0.8625000
NODE_11107_length_826_cov_24.093535	282	362	2	11	80	0.1375000
NODE_11107_length_826_cov_24.093535	335	415	0	80	80	1.0000000
NODE_11108_length_826_cov_20.943604	207	287	0	80	80	1.0000000
NODE_11108_length_826_cov_20.943604	260	340	0	80	80	1.0000000
NODE_11109_length_826_cov_20.437414	413	493	0	80	80	1.0000000
NODE_11109_length_826_cov_20.437414	466	546	0	80	80	1.0000000
NODE_11110_length_826_cov_20.200825	432	512	0	64	80	0.8000000
NODE_11110_length_826_cov_20.200825	432	512	2	16	80	0.2000000
NODE_11110_length_826_cov_20.200825	485	565	0	80	80	1.0000000
NODE_11111_length_826_cov_18.489684	345	425	0	80	80	1.0000000
NODE_11111_length_826_cov_18.489684	398	478	0	60	80	0.7500000
NODE_11111_length_826_cov_18.489684	398	478	2	2	80	0.0250000
NODE_11111_length_826_cov_18.489684	398	478	4	18	80	0.2250000
NODE_11112_length_826_cov_17.998624	336	416	0	50	80	0.6250000
NODE_11112_length_826_cov_17.998624	336	416	2	30	80	0.3750000
NODE_11112_length_826_cov_17.998624	389	469	0	80	80	1.0000000
NODE_11113_length_826_cov_17.038514	358	438	0	80	80	1.0000000
NODE_11113_length_826_cov_17.038514	411	491	0	80	80	1.0000000
NODE_11114_length_826_cov_16.777166	514	603	0	89	89	1.0000000
NODE_11115_length_826_cov_16.177442	361	441	0	80	80	1.0000000
NODE_11115_length_826_cov_16.177442	414	494	0	80	80	1.0000000
NODE_11116_length_826_cov_15.134801	346	426	0	80	80	1.0000000
NODE_11116_length_826_cov_15.134801	399	479	0	80	80	1.0000000
NODE_11117_length_826_cov_9.943604	320	400	0	80	80	1.0000000
NODE_11117_length_826_cov_9.943604	373	453	0	80	80	1.0000000
NODE_11120_length_826_cov_4.852820	501	579	2	17	78	0.2179487
NODE_11120_length_826_cov_4.852820	501	579	4	61	78	0.7820513
NODE_11120_length_826_cov_4.852820	552	632	0	17	80	0.2125000
NODE_11120_length_826_cov_4.852820	552	632	2	53	80	0.6625000
NODE_11120_length_826_cov_4.852820	552	632	4	10	80	0.1250000
NODE_11161_length_825_cov_61.804408	382	462	0	80	80	1.0000000
NODE_11161_length_825_cov_61.804408	435	514	0	79	79	1.0000000
NODE_11162_length_825_cov_43.825069	488	568	4	20	80	0.2500000
NODE_11162_length_825_cov_43.825069	488	568	8	18	80	0.2250000
NODE_11162_length_825_cov_43.825069	488	568	10	22	80	0.2750000
NODE_11162_length_825_cov_43.825069	488	568	12	20	80	0.2500000
NODE_11162_length_825_cov_43.825069	541	621	2	48	80	0.6000000
NODE_11162_length_825_cov_43.825069	541	621	4	25	80	0.3125000
NODE_11162_length_825_cov_43.825069	541	621	8	7	80	0.0875000
NODE_11162_length_825_cov_43.825069	617	697	0	28	80	0.3500000
NODE_11162_length_825_cov_43.825069	617	697	2	52	80	0.6500000
NODE_11162_length_825_cov_43.825069	670	750	0	4	80	0.0500000
NODE_11162_length_825_cov_43.825069	670	750	2	29	80	0.3625000
NODE_11162_length_825_cov_43.825069	670	750	10	47	80	0.5875000
NODE_11163_length_825_cov_43.389807	496	576	0	40	80	0.5000000
NODE_11163_length_825_cov_43.389807	496	576	2	40	80	0.5000000
NODE_11163_length_825_cov_43.389807	549	629	0	21	80	0.2625000
NODE_11163_length_825_cov_43.389807	549	629	2	59	80	0.7375000
NODE_11164_length_825_cov_39.603306	386	466	0	23	80	0.2875000
NODE_11164_length_825_cov_39.603306	386	466	4	57	80	0.7125000
NODE_11164_length_825_cov_39.603306	439	519	0	32	80	0.4000000
NODE_11164_length_825_cov_39.603306	439	519	4	48	80	0.6000000
NODE_11165_length_825_cov_32.205234	354	434	0	56	80	0.7000000
NODE_11165_length_825_cov_32.205234	354	434	2	19	80	0.2375000
NODE_11165_length_825_cov_32.205234	354	434	4	5	80	0.0625000
NODE_11165_length_825_cov_32.205234	407	487	0	80	80	1.0000000
NODE_11166_length_825_cov_29.411846	503	583	6	20	80	0.2500000
NODE_11166_length_825_cov_29.411846	503	583	7	33	80	0.4125000
NODE_11166_length_825_cov_29.411846	503	583	8	27	80	0.3375000
NODE_11166_length_825_cov_29.411846	556	636	0	42	80	0.5250000
NODE_11166_length_825_cov_29.411846	556	636	4	4	80	0.0500000
NODE_11166_length_825_cov_29.411846	556	636	6	22	80	0.2750000
NODE_11166_length_825_cov_29.411846	556	636	7	12	80	0.1500000
NODE_11167_length_825_cov_22.428375	312	392	2	4	80	0.0500000
NODE_11167_length_825_cov_22.428375	312	392	4	28	80	0.3500000
NODE_11167_length_825_cov_22.428375	312	392	6	11	80	0.1375000
NODE_11167_length_825_cov_22.428375	312	392	10	11	80	0.1375000
NODE_11167_length_825_cov_22.428375	312	392	12	22	80	0.2750000
NODE_11167_length_825_cov_22.428375	312	392	14	4	80	0.0500000
NODE_11167_length_825_cov_22.428375	365	445	6	4	80	0.0500000
NODE_11167_length_825_cov_22.428375	365	445	8	11	80	0.1375000
NODE_11167_length_825_cov_22.428375	365	445	10	48	80	0.6000000
NODE_11167_length_825_cov_22.428375	365	445	12	13	80	0.1625000
NODE_11167_length_825_cov_22.428375	365	445	14	4	80	0.0500000
NODE_11167_length_825_cov_22.428375	441	521	6	8	80	0.1000000
NODE_11167_length_825_cov_22.428375	441	521	8	65	80	0.8125000
NODE_11167_length_825_cov_22.428375	441	521	10	7	80	0.0875000
NODE_11167_length_825_cov_22.428375	494	574	0	10	80	0.1250000
NODE_11167_length_825_cov_22.428375	494	574	4	20	80	0.2500000
NODE_11167_length_825_cov_22.428375	494	574	8	50	80	0.6250000
NODE_11168_length_825_cov_19.964187	249	329	0	47	80	0.5875000
NODE_11168_length_825_cov_19.964187	249	329	2	33	80	0.4125000
NODE_11168_length_825_cov_19.964187	302	382	0	24	80	0.3000000
NODE_11168_length_825_cov_19.964187	302	382	2	56	80	0.7000000
NODE_11169_length_825_cov_13.790634	273	353	0	80	80	1.0000000
NODE_11169_length_825_cov_13.790634	326	406	0	80	80	1.0000000
NODE_11170_length_825_cov_11.834711	331	411	0	57	80	0.7125000
NODE_11170_length_825_cov_11.834711	331	411	2	23	80	0.2875000
NODE_11170_length_825_cov_11.834711	384	464	0	6	80	0.0750000
NODE_11170_length_825_cov_11.834711	384	464	2	74	80	0.9250000
NODE_11171_length_825_cov_11.477961	392	472	0	14	80	0.1750000
NODE_11171_length_825_cov_11.477961	392	472	2	41	80	0.5125000
NODE_11171_length_825_cov_11.477961	392	472	4	25	80	0.3125000
NODE_11172_length_825_cov_8.947658	259	339	0	80	80	1.0000000
NODE_11172_length_825_cov_8.947658	312	392	0	80	80	1.0000000
NODE_11173_length_825_cov_7.811295	379	459	0	80	80	1.0000000
NODE_11173_length_825_cov_7.811295	432	512	0	80	80	1.0000000
NODE_11174_length_825_cov_7.104683	464	544	0	80	80	1.0000000
NODE_11174_length_825_cov_7.104683	517	597	0	80	80	1.0000000
NODE_11176_length_825_cov_6.252066	542	622	0	15	80	0.1875000
NODE_11176_length_825_cov_6.252066	542	622	2	65	80	0.8125000
NODE_11176_length_825_cov_6.252066	595	675	0	24	80	0.3000000
NODE_11176_length_825_cov_6.252066	595	675	2	56	80	0.7000000
NODE_11178_length_825_cov_5.230028	264	344	0	80	80	1.0000000
NODE_11178_length_825_cov_5.230028	317	372	0	55	55	1.0000000
NODE_11178_length_825_cov_5.230028	383	463	0	50	80	0.6250000
NODE_11178_length_825_cov_5.230028	383	463	2	30	80	0.3750000
NODE_11178_length_825_cov_5.230028	436	516	2	80	80	1.0000000
NODE_11205_length_825_cov_0.765840	0	50	0	50	50	1.0000000
NODE_11207_length_824_cov_27.074483	337	412	0	28	75	0.3733333
NODE_11207_length_824_cov_27.074483	337	412	2	4	75	0.0533333
NODE_11207_length_824_cov_27.074483	337	412	4	43	75	0.5733333
NODE_11207_length_824_cov_27.074483	390	470	0	15	80	0.1875000
NODE_11207_length_824_cov_27.074483	390	470	2	4	80	0.0500000
NODE_11207_length_824_cov_27.074483	390	470	4	61	80	0.7625000
NODE_11208_length_824_cov_23.936552	365	445	0	70	80	0.8750000
NODE_11208_length_824_cov_23.936552	365	445	2	10	80	0.1250000
NODE_11208_length_824_cov_23.936552	418	493	0	17	75	0.2266667
NODE_11208_length_824_cov_23.936552	418	493	2	58	75	0.7733333
NODE_11209_length_824_cov_22.129655	377	457	0	27	80	0.3375000
NODE_11209_length_824_cov_22.129655	377	457	4	19	80	0.2375000
NODE_11209_length_824_cov_22.129655	377	457	6	34	80	0.4250000
NODE_11209_length_824_cov_22.129655	430	510	0	80	80	1.0000000
NODE_11210_length_824_cov_17.914483	387	467	2	33	80	0.4125000
NODE_11210_length_824_cov_17.914483	387	467	4	47	80	0.5875000
NODE_11210_length_824_cov_17.914483	440	520	0	17	80	0.2125000
NODE_11210_length_824_cov_17.914483	440	520	2	30	80	0.3750000
NODE_11210_length_824_cov_17.914483	440	520	4	33	80	0.4125000
NODE_11211_length_824_cov_16.662069	362	442	0	8	80	0.1000000
NODE_11211_length_824_cov_16.662069	362	442	2	72	80	0.9000000
NODE_11211_length_824_cov_16.662069	415	495	0	61	80	0.7625000
NODE_11211_length_824_cov_16.662069	415	495	2	19	80	0.2375000
NODE_11212_length_824_cov_16.306207	352	432	0	18	80	0.2250000
NODE_11212_length_824_cov_16.306207	352	432	2	62	80	0.7750000
NODE_11212_length_824_cov_16.306207	405	485	0	16	80	0.2000000
NODE_11212_length_824_cov_16.306207	405	485	2	64	80	0.8000000
NODE_11213_length_824_cov_15.891034	342	422	2	53	80	0.6625000
NODE_11213_length_824_cov_15.891034	342	422	4	7	80	0.0875000
NODE_11213_length_824_cov_15.891034	342	422	6	20	80	0.2500000
NODE_11213_length_824_cov_15.891034	395	475	2	11	80	0.1375000
NODE_11213_length_824_cov_15.891034	395	475	4	20	80	0.2500000
NODE_11213_length_824_cov_15.891034	395	475	6	49	80	0.6125000
NODE_11214_length_824_cov_12.485517	280	360	0	39	80	0.4875000
NODE_11214_length_824_cov_12.485517	280	360	2	18	80	0.2250000
NODE_11214_length_824_cov_12.485517	280	360	6	3	80	0.0375000
NODE_11214_length_824_cov_12.485517	280	360	8	20	80	0.2500000
NODE_11214_length_824_cov_12.485517	333	413	2	4	80	0.0500000
NODE_11214_length_824_cov_12.485517	333	413	6	7	80	0.0875000
NODE_11214_length_824_cov_12.485517	333	413	8	69	80	0.8625000
NODE_11216_length_824_cov_5.924138	269	349	0	80	80	1.0000000
NODE_11216_length_824_cov_5.924138	322	402	0	80	80	1.0000000
NODE_11222_length_824_cov_3.849655	191	271	0	52	80	0.6500000
NODE_11222_length_824_cov_3.849655	191	271	2	28	80	0.3500000
NODE_11251_length_823_cov_75.169890	207	287	2	8	80	0.1000000
NODE_11251_length_823_cov_75.169890	207	287	4	28	80	0.3500000
NODE_11251_length_823_cov_75.169890	207	287	6	42	80	0.5250000
NODE_11251_length_823_cov_75.169890	207	287	8	2	80	0.0250000
NODE_11251_length_823_cov_75.169890	260	340	2	11	80	0.1375000
NODE_11251_length_823_cov_75.169890	260	340	4	46	80	0.5750000
NODE_11251_length_823_cov_75.169890	260	340	6	21	80	0.2625000
NODE_11251_length_823_cov_75.169890	260	340	8	2	80	0.0250000
NODE_11251_length_823_cov_75.169890	336	416	2	73	80	0.9125000
NODE_11251_length_823_cov_75.169890	336	416	4	7	80	0.0875000
NODE_11251_length_823_cov_75.169890	389	469	0	9	80	0.1125000
NODE_11251_length_823_cov_75.169890	389	469	2	71	80	0.8875000
NODE_11253_length_823_cov_37.738950	332	412	4	36	80	0.4500000
NODE_11253_length_823_cov_37.738950	332	412	6	26	80	0.3250000
NODE_11253_length_823_cov_37.738950	332	412	8	18	80	0.2250000
NODE_11253_length_823_cov_37.738950	385	466	0	13	81	0.1604938
NODE_11253_length_823_cov_37.738950	385	466	2	29	81	0.3580247
NODE_11253_length_823_cov_37.738950	385	466	4	19	81	0.2345679
NODE_11253_length_823_cov_37.738950	385	466	6	20	81	0.2469136
NODE_11254_length_823_cov_29.349448	400	480	2	8	80	0.1000000
NODE_11254_length_823_cov_29.349448	400	480	6	42	80	0.5250000
NODE_11254_length_823_cov_29.349448	400	480	8	30	80	0.3750000
NODE_11254_length_823_cov_29.349448	453	533	0	32	80	0.4000000
NODE_11254_length_823_cov_29.349448	453	533	2	16	80	0.2000000
NODE_11254_length_823_cov_29.349448	453	533	6	32	80	0.4000000
NODE_11255_length_823_cov_25.730663	338	418	0	80	80	1.0000000
NODE_11255_length_823_cov_25.730663	391	471	0	80	80	1.0000000
NODE_11256_length_823_cov_24.599448	349	429	0	21	80	0.2625000
NODE_11256_length_823_cov_24.599448	349	429	2	59	80	0.7375000
NODE_11256_length_823_cov_24.599448	402	482	0	74	80	0.9250000
NODE_11256_length_823_cov_24.599448	402	482	2	6	80	0.0750000
NODE_11257_length_823_cov_22.149171	356	436	0	28	80	0.3500000
NODE_11257_length_823_cov_22.149171	356	436	2	46	80	0.5750000
NODE_11257_length_823_cov_22.149171	356	436	6	6	80	0.0750000
NODE_11257_length_823_cov_22.149171	409	489	0	80	80	1.0000000
NODE_11257_length_823_cov_22.149171	485	565	0	80	80	1.0000000
NODE_11257_length_823_cov_22.149171	538	618	0	80	80	1.0000000
NODE_11258_length_823_cov_20.892265	329	409	0	22	80	0.2750000
NODE_11258_length_823_cov_20.892265	329	409	4	58	80	0.7250000
NODE_11258_length_823_cov_20.892265	382	462	0	28	80	0.3500000
NODE_11258_length_823_cov_20.892265	382	462	4	52	80	0.6500000
NODE_11259_length_823_cov_19.281768	305	385	4	14	80	0.1750000
NODE_11259_length_823_cov_19.281768	305	385	6	14	80	0.1750000
NODE_11259_length_823_cov_19.281768	305	385	8	52	80	0.6500000
NODE_11259_length_823_cov_19.281768	358	438	0	49	80	0.6125000
NODE_11259_length_823_cov_19.281768	358	438	1	1	80	0.0125000
NODE_11259_length_823_cov_19.281768	358	438	2	2	80	0.0250000
NODE_11259_length_823_cov_19.281768	358	438	4	15	80	0.1875000
NODE_11259_length_823_cov_19.281768	358	438	6	13	80	0.1625000
NODE_11260_length_823_cov_15.738950	409	489	0	25	80	0.3125000
NODE_11260_length_823_cov_15.738950	409	489	2	55	80	0.6875000
NODE_11260_length_823_cov_15.738950	462	542	0	2	80	0.0250000
NODE_11260_length_823_cov_15.738950	462	542	2	78	80	0.9750000
NODE_11261_length_823_cov_10.729282	362	437	0	75	75	1.0000000
NODE_11261_length_823_cov_10.729282	410	484	0	74	74	1.0000000
NODE_11262_length_823_cov_9.110497	394	474	0	80	80	1.0000000
NODE_11262_length_823_cov_9.110497	447	527	0	80	80	1.0000000
NODE_11265_length_823_cov_5.511050	168	248	2	2	80	0.0250000
NODE_11265_length_823_cov_5.511050	168	248	4	22	80	0.2750000
NODE_11265_length_823_cov_5.511050	168	248	6	54	80	0.6750000
NODE_11265_length_823_cov_5.511050	168	248	8	2	80	0.0250000
NODE_11265_length_823_cov_5.511050	434	485	0	51	51	1.0000000
NODE_11292_length_823_cov_0.968232	86	154	0	68	68	1.0000000
NODE_11298_length_822_cov_25.423237	377	459	0	79	82	0.9634146
NODE_11298_length_822_cov_25.423237	377	459	4	3	82	0.0365854
NODE_11298_length_822_cov_25.423237	432	512	0	24	80	0.3000000
NODE_11298_length_822_cov_25.423237	432	512	4	56	80	0.7000000
NODE_11299_length_822_cov_16.381743	394	474	2	57	80	0.7125000
NODE_11299_length_822_cov_16.381743	394	474	4	23	80	0.2875000
NODE_11299_length_822_cov_16.381743	447	527	0	16	80	0.2000000
NODE_11299_length_822_cov_16.381743	447	527	1	4	80	0.0500000
NODE_11299_length_822_cov_16.381743	447	527	2	60	80	0.7500000
NODE_11300_length_822_cov_12.426003	223	296	0	53	73	0.7260274
NODE_11300_length_822_cov_12.426003	223	296	2	20	73	0.2739726
NODE_11300_length_822_cov_12.426003	278	349	2	37	71	0.5211267
NODE_11300_length_822_cov_12.426003	278	349	4	34	71	0.4788733
NODE_11301_length_822_cov_10.608575	464	544	0	80	80	1.0000000
NODE_11301_length_822_cov_10.608575	517	597	0	74	80	0.9250000
NODE_11301_length_822_cov_10.608575	517	597	2	6	80	0.0750000
NODE_11302_length_822_cov_9.496542	363	443	0	80	80	1.0000000
NODE_11302_length_822_cov_9.496542	416	496	0	80	80	1.0000000
NODE_11333_length_821_cov_39.818560	341	420	0	66	79	0.8354430
NODE_11333_length_821_cov_39.818560	341	420	2	13	79	0.1645570
NODE_11333_length_821_cov_39.818560	393	473	0	21	80	0.2625000
NODE_11333_length_821_cov_39.818560	393	473	2	38	80	0.4750000
NODE_11333_length_821_cov_39.818560	393	473	4	21	80	0.2625000
NODE_11334_length_821_cov_27.721607	299	379	0	32	80	0.4000000
NODE_11334_length_821_cov_27.721607	299	379	2	48	80	0.6000000
NODE_11334_length_821_cov_27.721607	352	432	0	80	80	1.0000000
NODE_11335_length_821_cov_26.252078	386	466	0	80	80	1.0000000
NODE_11335_length_821_cov_26.252078	439	519	0	80	80	1.0000000
NODE_11336_length_821_cov_19.603878	353	433	0	6	80	0.0750000
NODE_11336_length_821_cov_19.603878	353	433	2	74	80	0.9250000
NODE_11336_length_821_cov_19.603878	406	486	0	37	80	0.4625000
NODE_11336_length_821_cov_19.603878	406	486	2	43	80	0.5375000
NODE_11337_length_821_cov_15.945983	310	390	0	80	80	1.0000000
NODE_11337_length_821_cov_15.945983	363	443	0	80	80	1.0000000
NODE_11339_length_821_cov_8.711911	288	368	0	80	80	1.0000000
NODE_11339_length_821_cov_8.711911	341	421	0	80	80	1.0000000
NODE_11349_length_821_cov_3.026316	310	390	0	34	80	0.4250000
NODE_11349_length_821_cov_3.026316	310	390	2	46	80	0.5750000
NODE_11349_length_821_cov_3.026316	363	443	0	80	80	1.0000000
NODE_11361_length_820_cov_67.292649	328	408	2	80	80	1.0000000
NODE_11361_length_820_cov_67.292649	381	461	0	22	80	0.2750000
NODE_11361_length_820_cov_67.292649	381	461	2	58	80	0.7250000
NODE_11362_length_820_cov_26.915395	308	388	4	4	80	0.0500000
NODE_11362_length_820_cov_26.915395	308	388	6	25	80	0.3125000
NODE_11362_length_820_cov_26.915395	308	388	8	11	80	0.1375000
NODE_11362_length_820_cov_26.915395	308	388	10	26	80	0.3250000
NODE_11362_length_820_cov_26.915395	308	388	12	14	80	0.1750000
NODE_11363_length_820_cov_25.253814	301	381	0	80	80	1.0000000
NODE_11363_length_820_cov_25.253814	354	434	0	80	80	1.0000000
NODE_11363_length_820_cov_25.253814	430	510	0	80	80	1.0000000
NODE_11363_length_820_cov_25.253814	483	563	0	80	80	1.0000000
NODE_11364_length_820_cov_16.015257	325	405	0	28	80	0.3500000
NODE_11364_length_820_cov_16.015257	325	405	2	52	80	0.6500000
NODE_11364_length_820_cov_16.015257	378	458	0	10	80	0.1250000
NODE_11364_length_820_cov_16.015257	378	458	2	70	80	0.8750000
NODE_11365_length_820_cov_14.703190	371	451	2	39	80	0.4875000
NODE_11365_length_820_cov_14.703190	371	451	4	41	80	0.5125000
NODE_11365_length_820_cov_14.703190	424	504	0	24	80	0.3000000
NODE_11365_length_820_cov_14.703190	424	504	2	42	80	0.5250000
NODE_11365_length_820_cov_14.703190	424	504	4	14	80	0.1750000
NODE_11366_length_820_cov_14.527046	249	329	0	80	80	1.0000000
NODE_11366_length_820_cov_14.527046	302	382	0	80	80	1.0000000
NODE_11367_length_820_cov_14.284327	286	366	0	80	80	1.0000000
NODE_11367_length_820_cov_14.284327	339	419	0	48	80	0.6000000
NODE_11367_length_820_cov_14.284327	339	419	2	32	80	0.4000000
NODE_11367_length_820_cov_14.284327	619	699	0	13	80	0.1625000
NODE_11367_length_820_cov_14.284327	619	699	1	18	80	0.2250000
NODE_11367_length_820_cov_14.284327	619	699	2	49	80	0.6125000
NODE_11368_length_820_cov_13.036061	364	444	0	76	80	0.9500000
NODE_11368_length_820_cov_13.036061	364	444	2	4	80	0.0500000
NODE_11368_length_820_cov_13.036061	417	497	0	23	80	0.2875000
NODE_11368_length_820_cov_13.036061	417	497	2	57	80	0.7125000
NODE_11369_length_820_cov_12.830791	313	393	0	19	80	0.2375000
NODE_11369_length_820_cov_12.830791	313	393	2	9	80	0.1125000
NODE_11369_length_820_cov_12.830791	313	393	4	52	80	0.6500000
NODE_11369_length_820_cov_12.830791	366	446	0	14	80	0.1750000
NODE_11369_length_820_cov_12.830791	366	446	2	7	80	0.0875000
NODE_11369_length_820_cov_12.830791	366	446	4	59	80	0.7375000
NODE_11370_length_820_cov_12.768377	366	443	0	77	77	1.0000000
NODE_11370_length_820_cov_12.768377	496	525	0	29	29	1.0000000
NODE_11371_length_820_cov_12.223301	452	519	0	67	67	1.0000000
NODE_11371_length_820_cov_12.223301	492	572	0	80	80	1.0000000
NODE_11396_length_819_cov_43.027778	403	483	0	80	80	1.0000000
NODE_11396_length_819_cov_43.027778	456	536	0	80	80	1.0000000
NODE_11396_length_819_cov_43.027778	532	612	0	80	80	1.0000000
NODE_11396_length_819_cov_43.027778	585	665	0	80	80	1.0000000
NODE_11397_length_819_cov_42.758333	391	471	2	19	80	0.2375000
NODE_11397_length_819_cov_42.758333	391	471	4	35	80	0.4375000
NODE_11397_length_819_cov_42.758333	391	471	6	26	80	0.3250000
NODE_11397_length_819_cov_42.758333	444	524	0	28	80	0.3500000
NODE_11397_length_819_cov_42.758333	444	524	2	15	80	0.1875000
NODE_11397_length_819_cov_42.758333	444	524	4	17	80	0.2125000
NODE_11397_length_819_cov_42.758333	444	524	6	20	80	0.2500000
NODE_11398_length_819_cov_41.341667	86	166	0	80	80	1.0000000
NODE_11398_length_819_cov_41.341667	139	219	0	80	80	1.0000000
NODE_11398_length_819_cov_41.341667	215	295	0	42	80	0.5250000
NODE_11398_length_819_cov_41.341667	215	295	2	38	80	0.4750000
NODE_11398_length_819_cov_41.341667	268	348	0	15	80	0.1875000
NODE_11398_length_819_cov_41.341667	268	348	2	65	80	0.8125000
NODE_11399_length_819_cov_23.656944	335	415	0	6	80	0.0750000
NODE_11399_length_819_cov_23.656944	335	415	2	65	80	0.8125000
NODE_11399_length_819_cov_23.656944	335	415	4	9	80	0.1125000
NODE_11399_length_819_cov_23.656944	388	468	0	6	80	0.0750000
NODE_11399_length_819_cov_23.656944	388	468	2	12	80	0.1500000
NODE_11399_length_819_cov_23.656944	388	468	4	62	80	0.7750000
NODE_11400_length_819_cov_20.633333	475	555	0	80	80	1.0000000
NODE_11400_length_819_cov_20.633333	528	608	0	80	80	1.0000000
NODE_11401_length_819_cov_18.941667	307	387	0	40	80	0.5000000
NODE_11401_length_819_cov_18.941667	307	387	2	40	80	0.5000000
NODE_11401_length_819_cov_18.941667	360	440	2	80	80	1.0000000
NODE_11401_length_819_cov_18.941667	436	516	0	66	80	0.8250000
NODE_11401_length_819_cov_18.941667	436	516	2	14	80	0.1750000
NODE_11401_length_819_cov_18.941667	489	569	0	80	80	1.0000000
NODE_11402_length_819_cov_12.225000	431	511	0	80	80	1.0000000
NODE_11402_length_819_cov_12.225000	484	564	0	80	80	1.0000000
NODE_11403_length_819_cov_11.562500	273	353	0	80	80	1.0000000
NODE_11403_length_819_cov_11.562500	326	406	0	80	80	1.0000000
NODE_11404_length_819_cov_8.905556	477	557	0	80	80	1.0000000
NODE_11404_length_819_cov_8.905556	530	610	0	80	80	1.0000000
NODE_11405_length_819_cov_5.675000	232	312	0	80	80	1.0000000
NODE_11405_length_819_cov_5.675000	285	365	0	80	80	1.0000000
NODE_11431_length_818_cov_21.979138	342	422	0	80	80	1.0000000
NODE_11431_length_818_cov_21.979138	395	475	0	80	80	1.0000000
NODE_11432_length_818_cov_15.326843	334	414	0	80	80	1.0000000
NODE_11432_length_818_cov_15.326843	387	467	0	80	80	1.0000000
NODE_11433_length_818_cov_14.880389	392	472	0	80	80	1.0000000
NODE_11433_length_818_cov_14.880389	445	525	0	80	80	1.0000000
NODE_11434_length_818_cov_12.369958	390	470	0	32	80	0.4000000
NODE_11434_length_818_cov_12.369958	390	470	2	48	80	0.6000000
NODE_11434_length_818_cov_12.369958	443	523	0	80	80	1.0000000
NODE_11436_length_818_cov_8.421419	370	450	0	21	80	0.2625000
NODE_11436_length_818_cov_8.421419	370	450	2	19	80	0.2375000
NODE_11436_length_818_cov_8.421419	370	450	4	40	80	0.5000000
NODE_11436_length_818_cov_8.421419	423	503	2	41	80	0.5125000
NODE_11436_length_818_cov_8.421419	423	503	4	39	80	0.4875000
NODE_11437_length_818_cov_6.439499	706	741	2	33	35	0.9428571
NODE_11437_length_818_cov_6.439499	706	741	4	2	35	0.0571429
NODE_11439_length_818_cov_4.098748	320	390	0	70	70	1.0000000
NODE_11439_length_818_cov_4.098748	416	472	0	56	56	1.0000000
NODE_11457_length_817_cov_7.238162	494	574	0	80	80	1.0000000
NODE_11457_length_817_cov_7.238162	547	627	0	80	80	1.0000000
NODE_11458_length_817_cov_5.789694	400	480	0	80	80	1.0000000
NODE_11458_length_817_cov_5.789694	476	555	0	79	79	1.0000000
NODE_11458_length_817_cov_5.789694	528	608	0	80	80	1.0000000
NODE_11462_length_817_cov_4.357939	433	513	0	80	80	1.0000000
NODE_11462_length_817_cov_4.357939	486	566	0	80	80	1.0000000
NODE_11486_length_817_cov_0.692201	626	696	0	6	70	0.0857143
NODE_11486_length_817_cov_0.692201	626	696	2	17	70	0.2428571
NODE_11486_length_817_cov_0.692201	626	696	5	2	70	0.0285714
NODE_11486_length_817_cov_0.692201	626	696	6	16	70	0.2285714
NODE_11486_length_817_cov_0.692201	626	696	8	6	70	0.0857143
NODE_11486_length_817_cov_0.692201	626	696	9	1	70	0.0142857
NODE_11486_length_817_cov_0.692201	626	696	11	8	70	0.1142857
NODE_11486_length_817_cov_0.692201	626	696	13	4	70	0.0571429
NODE_11486_length_817_cov_0.692201	626	696	14	10	70	0.1428571
NODE_11488_length_816_cov_69.800558	395	475	2	10	80	0.1250000
NODE_11488_length_816_cov_69.800558	395	475	4	1	80	0.0125000
NODE_11488_length_816_cov_69.800558	395	475	6	51	80	0.6375000
NODE_11488_length_816_cov_69.800558	395	475	8	18	80	0.2250000
NODE_11488_length_816_cov_69.800558	448	520	0	11	72	0.1527778
NODE_11488_length_816_cov_69.800558	448	520	2	44	72	0.6111111
NODE_11488_length_816_cov_69.800558	448	520	4	1	72	0.0138889
NODE_11488_length_816_cov_69.800558	448	520	6	13	72	0.1805556
NODE_11488_length_816_cov_69.800558	448	520	8	3	72	0.0416667
NODE_11489_length_816_cov_19.044630	77	154	0	77	77	1.0000000
NODE_11489_length_816_cov_19.044630	130	212	0	82	82	1.0000000
NODE_11490_length_816_cov_16.418410	381	461	0	60	80	0.7500000
NODE_11490_length_816_cov_16.418410	381	461	2	20	80	0.2500000
NODE_11490_length_816_cov_16.418410	434	514	0	80	80	1.0000000
NODE_11491_length_816_cov_15.945607	319	399	0	15	80	0.1875000
NODE_11491_length_816_cov_15.945607	319	399	4	1	80	0.0125000
NODE_11491_length_816_cov_15.945607	319	399	6	64	80	0.8000000
NODE_11491_length_816_cov_15.945607	372	452	2	42	80	0.5250000
NODE_11491_length_816_cov_15.945607	372	452	6	38	80	0.4750000
NODE_11492_length_816_cov_12.797768	358	438	0	80	80	1.0000000
NODE_11492_length_816_cov_12.797768	411	491	0	80	80	1.0000000
NODE_11493_length_816_cov_12.086471	242	322	0	22	80	0.2750000
NODE_11493_length_816_cov_12.086471	242	322	4	48	80	0.6000000
NODE_11493_length_816_cov_12.086471	242	322	6	10	80	0.1250000
NODE_11493_length_816_cov_12.086471	295	375	4	17	80	0.2125000
NODE_11493_length_816_cov_12.086471	295	375	6	63	80	0.7875000
NODE_11495_length_816_cov_3.873082	412	492	0	80	80	1.0000000
NODE_11495_length_816_cov_3.873082	465	545	0	80	80	1.0000000
NODE_11516_length_815_cov_48.090782	334	414	0	18	80	0.2250000
NODE_11516_length_815_cov_48.090782	334	414	2	62	80	0.7750000
NODE_11516_length_815_cov_48.090782	387	467	0	32	80	0.4000000
NODE_11516_length_815_cov_48.090782	387	467	2	48	80	0.6000000
NODE_11517_length_815_cov_27.748603	290	370	0	80	80	1.0000000
NODE_11517_length_815_cov_27.748603	343	423	0	80	80	1.0000000
NODE_11518_length_815_cov_23.748603	429	509	2	80	80	1.0000000
NODE_11518_length_815_cov_23.748603	482	562	0	6	80	0.0750000
NODE_11518_length_815_cov_23.748603	482	562	2	74	80	0.9250000
NODE_11519_length_815_cov_14.870112	318	398	0	74	80	0.9250000
NODE_11519_length_815_cov_14.870112	318	398	2	6	80	0.0750000
NODE_11519_length_815_cov_14.870112	371	451	0	21	80	0.2625000
NODE_11519_length_815_cov_14.870112	371	451	2	59	80	0.7375000
NODE_11520_length_815_cov_13.317039	338	418	0	20	80	0.2500000
NODE_11520_length_815_cov_13.317039	338	418	6	60	80	0.7500000
NODE_11520_length_815_cov_13.317039	391	471	0	52	80	0.6500000
NODE_11520_length_815_cov_13.317039	391	471	5	1	80	0.0125000
NODE_11520_length_815_cov_13.317039	391	471	6	27	80	0.3375000
NODE_11521_length_815_cov_12.270950	315	395	0	80	80	1.0000000
NODE_11521_length_815_cov_12.270950	368	448	0	80	80	1.0000000
NODE_11522_length_815_cov_9.304469	150	230	0	15	80	0.1875000
NODE_11522_length_815_cov_9.304469	150	230	2	65	80	0.8125000
NODE_11522_length_815_cov_9.304469	203	283	0	63	80	0.7875000
NODE_11522_length_815_cov_9.304469	203	283	2	17	80	0.2125000
NODE_11524_length_815_cov_8.117318	437	517	0	41	80	0.5125000
NODE_11524_length_815_cov_8.117318	437	517	1	39	80	0.4875000
NODE_11524_length_815_cov_8.117318	490	570	1	43	80	0.5375000
NODE_11524_length_815_cov_8.117318	490	570	2	37	80	0.4625000
NODE_11530_length_815_cov_3.963687	275	355	0	65	80	0.8125000
NODE_11530_length_815_cov_3.963687	275	355	2	15	80	0.1875000
NODE_11530_length_815_cov_3.963687	328	408	0	80	80	1.0000000
NODE_11532_length_815_cov_2.976257	441	508	0	67	67	1.0000000
NODE_11554_length_814_cov_55.545455	304	384	0	80	80	1.0000000
NODE_11554_length_814_cov_55.545455	357	437	0	80	80	1.0000000
NODE_11554_length_814_cov_55.545455	517	559	0	42	42	1.0000000
NODE_11554_length_814_cov_55.545455	724	804	2	6	80	0.0750000
NODE_11554_length_814_cov_55.545455	724	804	4	6	80	0.0750000
NODE_11554_length_814_cov_55.545455	724	804	6	4	80	0.0500000
NODE_11554_length_814_cov_55.545455	724	804	8	5	80	0.0625000
NODE_11554_length_814_cov_55.545455	724	804	10	5	80	0.0625000
NODE_11554_length_814_cov_55.545455	724	804	12	1	80	0.0125000
NODE_11554_length_814_cov_55.545455	724	804	14	11	80	0.1375000
NODE_11554_length_814_cov_55.545455	724	804	16	3	80	0.0375000
NODE_11554_length_814_cov_55.545455	724	804	18	28	80	0.3500000
NODE_11554_length_814_cov_55.545455	724	804	20	10	80	0.1250000
NODE_11554_length_814_cov_55.545455	724	804	22	1	80	0.0125000
NODE_11555_length_814_cov_32.216783	317	397	0	80	80	1.0000000
NODE_11555_length_814_cov_32.216783	370	450	0	75	80	0.9375000
NODE_11555_length_814_cov_32.216783	370	450	2	5	80	0.0625000
NODE_11556_length_814_cov_19.507692	174	254	0	7	80	0.0875000
NODE_11556_length_814_cov_19.507692	174	254	2	6	80	0.0750000
NODE_11556_length_814_cov_19.507692	174	254	4	67	80	0.8375000
NODE_11556_length_814_cov_19.507692	227	307	0	60	80	0.7500000
NODE_11556_length_814_cov_19.507692	227	307	2	6	80	0.0750000
NODE_11556_length_814_cov_19.507692	227	307	4	14	80	0.1750000
NODE_11556_length_814_cov_19.507692	303	383	0	80	80	1.0000000
NODE_11556_length_814_cov_19.507692	356	436	0	80	80	1.0000000
NODE_11557_length_814_cov_18.579021	433	513	0	18	80	0.2250000
NODE_11557_length_814_cov_18.579021	433	513	2	62	80	0.7750000
NODE_11557_length_814_cov_18.579021	486	566	2	80	80	1.0000000
NODE_11558_length_814_cov_17.183217	339	419	2	80	80	1.0000000
NODE_11558_length_814_cov_17.183217	392	472	0	42	80	0.5250000
NODE_11558_length_814_cov_17.183217	392	472	2	38	80	0.4750000
NODE_11559_length_814_cov_15.306294	238	318	0	80	80	1.0000000
NODE_11559_length_814_cov_15.306294	291	371	0	34	80	0.4250000
NODE_11559_length_814_cov_15.306294	291	371	4	46	80	0.5750000
NODE_11560_length_814_cov_11.511888	397	477	0	80	80	1.0000000
NODE_11560_length_814_cov_11.511888	459	530	0	71	71	1.0000000
NODE_11561_length_814_cov_10.395804	305	385	0	35	80	0.4375000
NODE_11561_length_814_cov_10.395804	305	385	2	45	80	0.5625000
NODE_11561_length_814_cov_10.395804	358	438	0	43	80	0.5375000
NODE_11561_length_814_cov_10.395804	358	438	2	37	80	0.4625000
NODE_11562_length_814_cov_9.692308	347	427	2	19	80	0.2375000
NODE_11562_length_814_cov_9.692308	347	427	4	4	80	0.0500000
NODE_11562_length_814_cov_9.692308	347	427	6	57	80	0.7125000
NODE_11562_length_814_cov_9.692308	400	480	0	18	80	0.2250000
NODE_11562_length_814_cov_9.692308	400	480	2	2	80	0.0250000
NODE_11562_length_814_cov_9.692308	400	480	4	13	80	0.1625000
NODE_11562_length_814_cov_9.692308	400	480	6	47	80	0.5875000
NODE_11564_length_814_cov_9.274126	245	325	0	80	80	1.0000000
NODE_11564_length_814_cov_9.274126	298	378	0	80	80	1.0000000
NODE_11565_length_814_cov_8.973427	271	351	0	80	80	1.0000000
NODE_11565_length_814_cov_8.973427	324	404	0	51	80	0.6375000
NODE_11565_length_814_cov_8.973427	324	404	2	29	80	0.3625000
NODE_11573_length_814_cov_2.145455	273	327	2	44	54	0.8148148
NODE_11573_length_814_cov_2.145455	273	327	4	10	54	0.1851852
NODE_11573_length_814_cov_2.145455	307	371	2	53	64	0.8281250
NODE_11573_length_814_cov_2.145455	307	371	4	11	64	0.1718750
NODE_11587_length_813_cov_39.228291	225	305	0	61	80	0.7625000
NODE_11587_length_813_cov_39.228291	225	305	2	19	80	0.2375000
NODE_11587_length_813_cov_39.228291	278	358	0	8	80	0.1000000
NODE_11587_length_813_cov_39.228291	278	358	2	29	80	0.3625000
NODE_11587_length_813_cov_39.228291	278	358	4	43	80	0.5375000
NODE_11588_length_813_cov_36.570028	406	486	3	5	80	0.0625000
NODE_11588_length_813_cov_36.570028	406	486	7	30	80	0.3750000
NODE_11588_length_813_cov_36.570028	406	486	11	45	80	0.5625000
NODE_11588_length_813_cov_36.570028	459	539	2	17	80	0.2125000
NODE_11588_length_813_cov_36.570028	459	539	6	19	80	0.2375000
NODE_11588_length_813_cov_36.570028	459	539	9	4	80	0.0500000
NODE_11588_length_813_cov_36.570028	459	539	11	40	80	0.5000000
NODE_11589_length_813_cov_26.718487	209	289	1	27	80	0.3375000
NODE_11589_length_813_cov_26.718487	209	289	2	29	80	0.3625000
NODE_11589_length_813_cov_26.718487	209	289	4	1	80	0.0125000
NODE_11589_length_813_cov_26.718487	209	289	6	23	80	0.2875000
NODE_11589_length_813_cov_26.718487	262	342	2	3	80	0.0375000
NODE_11589_length_813_cov_26.718487	262	342	4	1	80	0.0125000
NODE_11589_length_813_cov_26.718487	262	342	5	36	80	0.4500000
NODE_11589_length_813_cov_26.718487	262	342	6	40	80	0.5000000
NODE_11590_length_813_cov_17.537815	335	415	2	6	80	0.0750000
NODE_11590_length_813_cov_17.537815	335	415	4	74	80	0.9250000
NODE_11590_length_813_cov_17.537815	388	468	2	29	80	0.3625000
NODE_11590_length_813_cov_17.537815	388	468	4	51	80	0.6375000
NODE_11591_length_813_cov_14.243697	279	359	0	80	80	1.0000000
NODE_11591_length_813_cov_14.243697	332	412	0	80	80	1.0000000
NODE_11592_length_813_cov_13.984594	307	387	0	47	80	0.5875000
NODE_11592_length_813_cov_13.984594	307	387	2	33	80	0.4125000
NODE_11592_length_813_cov_13.984594	360	440	0	80	80	1.0000000
NODE_11593_length_813_cov_13.242297	336	416	0	25	80	0.3125000
NODE_11593_length_813_cov_13.242297	336	416	2	27	80	0.3375000
NODE_11593_length_813_cov_13.242297	336	416	4	28	80	0.3500000
NODE_11593_length_813_cov_13.242297	389	469	2	4	80	0.0500000
NODE_11593_length_813_cov_13.242297	389	469	4	76	80	0.9500000
NODE_11594_length_813_cov_11.985994	374	454	2	80	80	1.0000000
NODE_11594_length_813_cov_11.985994	427	507	0	5	80	0.0625000
NODE_11594_length_813_cov_11.985994	427	507	1	12	80	0.1500000
NODE_11594_length_813_cov_11.985994	427	507	2	63	80	0.7875000
NODE_11595_length_813_cov_11.668067	279	359	0	80	80	1.0000000
NODE_11595_length_813_cov_11.668067	332	412	0	80	80	1.0000000
NODE_11596_length_813_cov_8.149860	538	618	0	17	80	0.2125000
NODE_11596_length_813_cov_8.149860	538	618	2	63	80	0.7875000
NODE_11596_length_813_cov_8.149860	591	671	0	50	80	0.6250000
NODE_11596_length_813_cov_8.149860	591	671	2	30	80	0.3750000
NODE_11597_length_813_cov_7.098039	234	314	0	35	80	0.4375000
NODE_11597_length_813_cov_7.098039	234	314	2	45	80	0.5625000
NODE_11597_length_813_cov_7.098039	287	367	0	19	80	0.2375000
NODE_11597_length_813_cov_7.098039	287	367	2	61	80	0.7625000
NODE_11613_length_812_cov_45.183731	435	515	0	32	80	0.4000000
NODE_11613_length_812_cov_45.183731	435	515	2	48	80	0.6000000
NODE_11613_length_812_cov_45.183731	488	568	0	80	80	1.0000000
NODE_11614_length_812_cov_23.862553	386	466	0	32	80	0.4000000
NODE_11614_length_812_cov_23.862553	386	466	2	2	80	0.0250000
NODE_11614_length_812_cov_23.862553	386	466	4	6	80	0.0750000
NODE_11614_length_812_cov_23.862553	386	466	5	1	80	0.0125000
NODE_11614_length_812_cov_23.862553	386	466	6	39	80	0.4875000
NODE_11614_length_812_cov_23.862553	439	519	0	4	80	0.0500000
NODE_11614_length_812_cov_23.862553	439	519	2	19	80	0.2375000
NODE_11614_length_812_cov_23.862553	439	519	4	3	80	0.0375000
NODE_11614_length_812_cov_23.862553	439	519	6	54	80	0.6750000
NODE_11615_length_812_cov_23.516129	295	375	0	11	80	0.1375000
NODE_11615_length_812_cov_23.516129	295	375	1	69	80	0.8625000
NODE_11615_length_812_cov_23.516129	348	428	0	61	80	0.7625000
NODE_11615_length_812_cov_23.516129	348	428	1	16	80	0.2000000
NODE_11615_length_812_cov_23.516129	348	428	2	3	80	0.0375000
NODE_11616_length_812_cov_15.577840	509	589	0	80	80	1.0000000
NODE_11616_length_812_cov_15.577840	562	644	0	82	82	1.0000000
NODE_11617_length_812_cov_13.277700	257	331	0	71	74	0.9594595
NODE_11617_length_812_cov_13.277700	257	331	2	1	74	0.0135135
NODE_11617_length_812_cov_13.277700	257	331	3	2	74	0.0270270
NODE_11617_length_812_cov_13.277700	304	384	0	80	80	1.0000000
NODE_11619_length_812_cov_6.697055	309	389	0	80	80	1.0000000
NODE_11619_length_812_cov_6.697055	362	442	0	80	80	1.0000000
NODE_11642_length_811_cov_65.762640	418	492	5	10	74	0.1351351
NODE_11642_length_811_cov_65.762640	418	492	6	1	74	0.0135135
NODE_11642_length_811_cov_65.762640	418	492	7	31	74	0.4189189
NODE_11642_length_811_cov_65.762640	418	492	8	2	74	0.0270270
NODE_11642_length_811_cov_65.762640	418	492	9	30	74	0.4054054
NODE_11642_length_811_cov_65.762640	471	545	2	9	74	0.1216216
NODE_11642_length_811_cov_65.762640	471	545	4	15	74	0.2027027
NODE_11642_length_811_cov_65.762640	471	545	5	1	74	0.0135135
NODE_11642_length_811_cov_65.762640	471	545	7	35	74	0.4729730
NODE_11642_length_811_cov_65.762640	471	545	9	14	74	0.1891892
NODE_11643_length_811_cov_62.933989	457	537	0	8	80	0.1000000
NODE_11643_length_811_cov_62.933989	457	537	4	35	80	0.4375000
NODE_11643_length_811_cov_62.933989	457	537	6	8	80	0.1000000
NODE_11643_length_811_cov_62.933989	457	537	9	23	80	0.2875000
NODE_11643_length_811_cov_62.933989	457	537	10	6	80	0.0750000
NODE_11643_length_811_cov_62.933989	510	590	8	24	80	0.3000000
NODE_11643_length_811_cov_62.933989	510	590	9	21	80	0.2625000
NODE_11643_length_811_cov_62.933989	510	590	10	12	80	0.1500000
NODE_11643_length_811_cov_62.933989	510	590	12	23	80	0.2875000
NODE_11644_length_811_cov_26.401685	397	477	0	80	80	1.0000000
NODE_11644_length_811_cov_26.401685	450	530	0	80	80	1.0000000
NODE_11645_length_811_cov_23.009831	189	269	0	80	80	1.0000000
NODE_11645_length_811_cov_23.009831	242	322	0	29	80	0.3625000
NODE_11645_length_811_cov_23.009831	242	322	2	51	80	0.6375000
NODE_11646_length_811_cov_20.523876	375	455	0	15	80	0.1875000
NODE_11646_length_811_cov_20.523876	375	455	1	1	80	0.0125000
NODE_11646_length_811_cov_20.523876	375	455	2	52	80	0.6500000
NODE_11646_length_811_cov_20.523876	375	455	4	12	80	0.1500000
NODE_11646_length_811_cov_20.523876	428	508	0	7	80	0.0875000
NODE_11646_length_811_cov_20.523876	428	508	2	73	80	0.9125000
NODE_11647_length_811_cov_17.386236	421	501	0	19	80	0.2375000
NODE_11647_length_811_cov_17.386236	421	501	2	46	80	0.5750000
NODE_11647_length_811_cov_17.386236	421	501	4	15	80	0.1875000
NODE_11647_length_811_cov_17.386236	474	554	2	39	80	0.4875000
NODE_11647_length_811_cov_17.386236	474	554	4	41	80	0.5125000
NODE_11648_length_811_cov_15.279494	368	448	0	80	80	1.0000000
NODE_11648_length_811_cov_15.279494	421	502	0	81	81	1.0000000
NODE_11649_length_811_cov_14.543539	222	302	0	34	80	0.4250000
NODE_11649_length_811_cov_14.543539	222	302	4	46	80	0.5750000
NODE_11649_length_811_cov_14.543539	275	355	4	32	80	0.4000000
NODE_11649_length_811_cov_14.543539	275	355	6	48	80	0.6000000
NODE_11650_length_811_cov_12.196629	402	482	0	80	80	1.0000000
NODE_11650_length_811_cov_12.196629	455	535	0	80	80	1.0000000
NODE_11651_length_811_cov_12.117978	289	369	0	80	80	1.0000000
NODE_11651_length_811_cov_12.117978	342	422	0	80	80	1.0000000
NODE_11652_length_811_cov_11.886236	330	410	2	59	80	0.7375000
NODE_11652_length_811_cov_11.886236	330	410	4	21	80	0.2625000
NODE_11652_length_811_cov_11.886236	383	463	2	42	80	0.5250000
NODE_11652_length_811_cov_11.886236	383	463	4	38	80	0.4750000
NODE_11653_length_811_cov_10.602528	342	422	2	31	80	0.3875000
NODE_11653_length_811_cov_10.602528	342	422	4	5	80	0.0625000
NODE_11653_length_811_cov_10.602528	342	422	6	44	80	0.5500000
NODE_11653_length_811_cov_10.602528	395	461	2	4	66	0.0606061
NODE_11653_length_811_cov_10.602528	395	461	4	12	66	0.1818182
NODE_11653_length_811_cov_10.602528	395	461	6	50	66	0.7575758
NODE_11653_length_811_cov_10.602528	452	519	0	58	67	0.8656716
NODE_11653_length_811_cov_10.602528	452	519	2	4	67	0.0597015
NODE_11653_length_811_cov_10.602528	452	519	4	5	67	0.0746269
NODE_11653_length_811_cov_10.602528	492	572	0	80	80	1.0000000
NODE_11654_length_811_cov_7.539326	324	404	0	12	80	0.1500000
NODE_11654_length_811_cov_7.539326	324	404	2	68	80	0.8500000
NODE_11654_length_811_cov_7.539326	377	457	0	65	80	0.8125000
NODE_11654_length_811_cov_7.539326	377	457	2	15	80	0.1875000
NODE_11655_length_811_cov_6.398876	419	499	0	80	80	1.0000000
NODE_11655_length_811_cov_6.398876	472	552	0	80	80	1.0000000
NODE_11657_length_811_cov_5.939607	496	527	0	31	31	1.0000000
NODE_11657_length_811_cov_5.939607	528	603	0	51	75	0.6800000
NODE_11657_length_811_cov_5.939607	528	603	2	24	75	0.3200000
NODE_11669_length_811_cov_1.501404	645	676	2	31	31	1.0000000
NODE_11684_length_810_cov_42.358650	484	564	0	12	80	0.1500000
NODE_11684_length_810_cov_42.358650	484	564	2	68	80	0.8500000
NODE_11684_length_810_cov_42.358650	537	617	0	65	80	0.8125000
NODE_11684_length_810_cov_42.358650	537	617	2	15	80	0.1875000
NODE_11685_length_810_cov_38.604782	370	450	0	80	80	1.0000000
NODE_11685_length_810_cov_38.604782	423	499	0	76	76	1.0000000
NODE_11686_length_810_cov_20.354430	338	418	0	26	80	0.3250000
NODE_11686_length_810_cov_20.354430	338	418	2	54	80	0.6750000
NODE_11686_length_810_cov_20.354430	391	471	2	80	80	1.0000000
NODE_11688_length_810_cov_12.367089	144	224	0	29	80	0.3625000
NODE_11688_length_810_cov_12.367089	144	224	2	24	80	0.3000000
NODE_11688_length_810_cov_12.367089	144	224	4	27	80	0.3375000
NODE_11688_length_810_cov_12.367089	197	277	2	8	80	0.1000000
NODE_11688_length_810_cov_12.367089	197	277	4	72	80	0.9000000
NODE_11689_length_810_cov_8.886076	333	399	0	8	66	0.1212121
NODE_11689_length_810_cov_8.886076	333	399	2	58	66	0.8787879
NODE_11690_length_810_cov_8.291139	446	526	0	74	80	0.9250000
NODE_11690_length_810_cov_8.291139	446	526	2	6	80	0.0750000
NODE_11690_length_810_cov_8.291139	499	579	0	21	80	0.2625000
NODE_11690_length_810_cov_8.291139	499	579	2	59	80	0.7375000
NODE_11692_length_810_cov_7.213783	335	406	0	40	71	0.5633803
NODE_11692_length_810_cov_7.213783	335	406	1	15	71	0.2112676
NODE_11692_length_810_cov_7.213783	335	406	3	16	71	0.2253521
NODE_11692_length_810_cov_7.213783	335	416	0	40	81	0.4938272
NODE_11692_length_810_cov_7.213783	335	416	1	15	81	0.1851852
NODE_11692_length_810_cov_7.213783	335	416	3	26	81	0.3209876
NODE_11692_length_810_cov_7.213783	379	459	0	2	80	0.0250000
NODE_11692_length_810_cov_7.213783	379	459	1	13	80	0.1625000
NODE_11692_length_810_cov_7.213783	379	459	3	65	80	0.8125000
NODE_11714_length_809_cov_40.536620	428	500	0	72	72	1.0000000
NODE_11714_length_809_cov_40.536620	473	553	0	80	80	1.0000000
NODE_11715_length_809_cov_15.871831	385	465	0	80	80	1.0000000
NODE_11715_length_809_cov_15.871831	402	465	0	63	63	1.0000000
NODE_11715_length_809_cov_15.871831	438	518	0	80	80	1.0000000
NODE_11715_length_809_cov_15.871831	438	518	0	80	80	1.0000000
NODE_11716_length_809_cov_15.019718	286	366	0	31	80	0.3875000
NODE_11716_length_809_cov_15.019718	286	366	1	1	80	0.0125000
NODE_11716_length_809_cov_15.019718	286	366	2	17	80	0.2125000
NODE_11716_length_809_cov_15.019718	286	366	4	31	80	0.3875000
NODE_11716_length_809_cov_15.019718	339	419	4	80	80	1.0000000
NODE_11718_length_809_cov_4.483099	244	324	2	80	80	1.0000000
NODE_11718_length_809_cov_4.483099	278	324	2	46	46	1.0000000
NODE_11718_length_809_cov_4.483099	298	377	0	46	79	0.5822785
NODE_11718_length_809_cov_4.483099	298	377	2	33	79	0.4177215
NODE_11718_length_809_cov_4.483099	308	377	0	46	69	0.6666667
NODE_11718_length_809_cov_4.483099	308	377	2	23	69	0.3333333
NODE_11738_length_808_cov_45.023977	325	405	2	80	80	1.0000000
NODE_11738_length_808_cov_45.023977	378	458	2	36	80	0.4500000
NODE_11738_length_808_cov_45.023977	378	458	4	44	80	0.5500000
NODE_11739_length_808_cov_24.087447	287	367	0	80	80	1.0000000
NODE_11739_length_808_cov_24.087447	340	420	0	80	80	1.0000000
NODE_11740_length_808_cov_21.867419	324	404	0	80	80	1.0000000
NODE_11740_length_808_cov_21.867419	377	457	0	80	80	1.0000000
NODE_11741_length_808_cov_16.289140	333	413	2	80	80	1.0000000
NODE_11741_length_808_cov_16.289140	386	466	2	74	80	0.9250000
NODE_11741_length_808_cov_16.289140	386	466	4	6	80	0.0750000
NODE_11742_length_808_cov_14.489422	307	387	0	80	80	1.0000000
NODE_11742_length_808_cov_14.489422	360	440	0	80	80	1.0000000
NODE_11744_length_808_cov_10.507757	317	397	0	80	80	1.0000000
NODE_11744_length_808_cov_10.507757	370	450	0	80	80	1.0000000
NODE_11745_length_808_cov_10.066291	483	563	0	80	80	1.0000000
NODE_11745_length_808_cov_10.066291	536	616	0	80	80	1.0000000
NODE_11746_length_808_cov_7.581100	358	438	3	80	80	1.0000000
NODE_11746_length_808_cov_7.581100	411	491	0	2	80	0.0250000
NODE_11746_length_808_cov_7.581100	411	491	2	10	80	0.1250000
NODE_11746_length_808_cov_7.581100	411	491	3	65	80	0.8125000
NODE_11746_length_808_cov_7.581100	411	491	4	3	80	0.0375000
NODE_11756_length_808_cov_3.283498	471	551	2	61	80	0.7625000
NODE_11756_length_808_cov_3.283498	471	551	4	19	80	0.2375000
NODE_11756_length_808_cov_3.283498	524	604	0	50	80	0.6250000
NODE_11756_length_808_cov_3.283498	524	604	2	30	80	0.3750000
NODE_11783_length_807_cov_67.341808	2	25	16	1	23	0.0434783
NODE_11783_length_807_cov_67.341808	2	25	18	2	23	0.0869565
NODE_11783_length_807_cov_67.341808	2	25	20	2	23	0.0869565
NODE_11783_length_807_cov_67.341808	2	25	26	1	23	0.0434783
NODE_11783_length_807_cov_67.341808	2	25	32	1	23	0.0434783
NODE_11783_length_807_cov_67.341808	2	25	34	1	23	0.0434783
NODE_11783_length_807_cov_67.341808	2	25	42	1	23	0.0434783
NODE_11783_length_807_cov_67.341808	2	25	51	1	23	0.0434783
NODE_11783_length_807_cov_67.341808	2	25	53	2	23	0.0869565
NODE_11783_length_807_cov_67.341808	2	25	55	1	23	0.0434783
NODE_11783_length_807_cov_67.341808	2	25	59	2	23	0.0869565
NODE_11783_length_807_cov_67.341808	2	25	60	2	23	0.0869565
NODE_11783_length_807_cov_67.341808	2	25	64	1	23	0.0434783
NODE_11783_length_807_cov_67.341808	2	25	68	1	23	0.0434783
NODE_11783_length_807_cov_67.341808	2	25	70	1	23	0.0434783
NODE_11783_length_807_cov_67.341808	2	25	71	1	23	0.0434783
NODE_11783_length_807_cov_67.341808	2	25	90	2	23	0.0869565
NODE_11783_length_807_cov_67.341808	339	370	96	1	31	0.0322581
NODE_11783_length_807_cov_67.341808	339	370	98	1	31	0.0322581
NODE_11783_length_807_cov_67.341808	339	370	102	1	31	0.0322581
NODE_11783_length_807_cov_67.341808	339	370	114	4	31	0.1290323
NODE_11783_length_807_cov_67.341808	339	370	118	1	31	0.0322581
NODE_11783_length_807_cov_67.341808	339	370	122	1	31	0.0322581
NODE_11783_length_807_cov_67.341808	339	370	132	1	31	0.0322581
NODE_11783_length_807_cov_67.341808	339	370	134	1	31	0.0322581
NODE_11783_length_807_cov_67.341808	339	370	138	1	31	0.0322581
NODE_11783_length_807_cov_67.341808	339	370	142	1	31	0.0322581
NODE_11783_length_807_cov_67.341808	339	370	144	1	31	0.0322581
NODE_11783_length_807_cov_67.341808	339	370	148	1	31	0.0322581
NODE_11783_length_807_cov_67.341808	339	370	154	2	31	0.0645161
NODE_11783_length_807_cov_67.341808	339	370	168	1	31	0.0322581
NODE_11783_length_807_cov_67.341808	339	370	173	2	31	0.0645161
NODE_11783_length_807_cov_67.341808	339	370	175	2	31	0.0645161
NODE_11783_length_807_cov_67.341808	339	370	179	1	31	0.0322581
NODE_11783_length_807_cov_67.341808	339	370	181	1	31	0.0322581
NODE_11783_length_807_cov_67.341808	339	370	182	2	31	0.0645161
NODE_11783_length_807_cov_67.341808	339	370	184	1	31	0.0322581
NODE_11783_length_807_cov_67.341808	339	370	186	4	31	0.1290323
NODE_11783_length_807_cov_67.341808	343	423	114	3	80	0.0375000
NODE_11783_length_807_cov_67.341808	343	423	118	1	80	0.0125000
NODE_11783_length_807_cov_67.341808	343	423	122	1	80	0.0125000
NODE_11783_length_807_cov_67.341808	343	423	132	1	80	0.0125000
NODE_11783_length_807_cov_67.341808	343	423	134	1	80	0.0125000
NODE_11783_length_807_cov_67.341808	343	423	138	1	80	0.0125000
NODE_11783_length_807_cov_67.341808	343	423	142	1	80	0.0125000
NODE_11783_length_807_cov_67.341808	343	423	144	1	80	0.0125000
NODE_11783_length_807_cov_67.341808	343	423	148	1	80	0.0125000
NODE_11783_length_807_cov_67.341808	343	423	154	2	80	0.0250000
NODE_11783_length_807_cov_67.341808	343	423	168	1	80	0.0125000
NODE_11783_length_807_cov_67.341808	343	423	173	2	80	0.0250000
NODE_11783_length_807_cov_67.341808	343	423	175	2	80	0.0250000
NODE_11783_length_807_cov_67.341808	343	423	179	1	80	0.0125000
NODE_11783_length_807_cov_67.341808	343	423	181	1	80	0.0125000
NODE_11783_length_807_cov_67.341808	343	423	182	2	80	0.0250000
NODE_11783_length_807_cov_67.341808	343	423	184	3	80	0.0375000
NODE_11783_length_807_cov_67.341808	343	423	186	14	80	0.1750000
NODE_11783_length_807_cov_67.341808	343	423	187	1	80	0.0125000
NODE_11783_length_807_cov_67.341808	343	423	188	6	80	0.0750000
NODE_11783_length_807_cov_67.341808	343	423	189	1	80	0.0125000
NODE_11783_length_807_cov_67.341808	343	423	190	6	80	0.0750000
NODE_11783_length_807_cov_67.341808	343	423	192	3	80	0.0375000
NODE_11783_length_807_cov_67.341808	343	423	194	1	80	0.0125000
NODE_11783_length_807_cov_67.341808	343	423	198	2	80	0.0250000
NODE_11783_length_807_cov_67.341808	343	423	202	2	80	0.0250000
NODE_11783_length_807_cov_67.341808	343	423	204	3	80	0.0375000
NODE_11783_length_807_cov_67.341808	343	423	206	3	80	0.0375000
NODE_11783_length_807_cov_67.341808	343	423	208	4	80	0.0500000
NODE_11783_length_807_cov_67.341808	343	423	209	1	80	0.0125000
NODE_11783_length_807_cov_67.341808	343	423	210	6	80	0.0750000
NODE_11783_length_807_cov_67.341808	343	423	212	1	80	0.0125000
NODE_11783_length_807_cov_67.341808	343	423	222	1	80	0.0125000
NODE_11784_length_807_cov_54.980226	683	749	66	2	66	0.0303030
NODE_11784_length_807_cov_54.980226	683	749	68	2	66	0.0303030
NODE_11784_length_807_cov_54.980226	683	749	70	1	66	0.0151515
NODE_11784_length_807_cov_54.980226	683	749	71	4	66	0.0606061
NODE_11784_length_807_cov_54.980226	683	749	74	1	66	0.0151515
NODE_11784_length_807_cov_54.980226	683	749	75	3	66	0.0454545
NODE_11784_length_807_cov_54.980226	683	749	77	1	66	0.0151515
NODE_11784_length_807_cov_54.980226	683	749	79	1	66	0.0151515
NODE_11784_length_807_cov_54.980226	683	749	81	5	66	0.0757576
NODE_11784_length_807_cov_54.980226	683	749	83	2	66	0.0303030
NODE_11784_length_807_cov_54.980226	683	749	85	1	66	0.0151515
NODE_11784_length_807_cov_54.980226	683	749	87	3	66	0.0454545
NODE_11784_length_807_cov_54.980226	683	749	89	1	66	0.0151515
NODE_11784_length_807_cov_54.980226	683	749	91	1	66	0.0151515
NODE_11784_length_807_cov_54.980226	683	749	93	2	66	0.0303030
NODE_11784_length_807_cov_54.980226	683	749	95	1	66	0.0151515
NODE_11784_length_807_cov_54.980226	683	749	98	1	66	0.0151515
NODE_11784_length_807_cov_54.980226	683	749	104	1	66	0.0151515
NODE_11784_length_807_cov_54.980226	683	749	112	1	66	0.0151515
NODE_11784_length_807_cov_54.980226	683	749	114	1	66	0.0151515
NODE_11784_length_807_cov_54.980226	683	749	115	1	66	0.0151515
NODE_11784_length_807_cov_54.980226	683	749	118	5	66	0.0757576
NODE_11784_length_807_cov_54.980226	683	749	120	2	66	0.0303030
NODE_11784_length_807_cov_54.980226	683	749	126	2	66	0.0303030
NODE_11784_length_807_cov_54.980226	683	749	127	1	66	0.0151515
NODE_11784_length_807_cov_54.980226	683	749	128	1	66	0.0151515
NODE_11784_length_807_cov_54.980226	683	749	130	1	66	0.0151515
NODE_11784_length_807_cov_54.980226	683	749	131	3	66	0.0454545
NODE_11784_length_807_cov_54.980226	683	749	132	4	66	0.0606061
NODE_11784_length_807_cov_54.980226	683	749	134	1	66	0.0151515
NODE_11784_length_807_cov_54.980226	683	749	137	2	66	0.0303030
NODE_11784_length_807_cov_54.980226	683	749	139	1	66	0.0151515
NODE_11784_length_807_cov_54.980226	683	749	141	1	66	0.0151515
NODE_11784_length_807_cov_54.980226	683	749	143	1	66	0.0151515
NODE_11784_length_807_cov_54.980226	683	749	147	1	66	0.0151515
NODE_11784_length_807_cov_54.980226	683	749	149	3	66	0.0454545
NODE_11784_length_807_cov_54.980226	683	749	151	1	66	0.0151515
NODE_11784_length_807_cov_54.980226	727	802	7	1	75	0.0133333
NODE_11784_length_807_cov_54.980226	727	802	9	2	75	0.0266667
NODE_11784_length_807_cov_54.980226	727	802	13	4	75	0.0533333
NODE_11784_length_807_cov_54.980226	727	802	17	5	75	0.0666667
NODE_11784_length_807_cov_54.980226	727	802	19	6	75	0.0800000
NODE_11784_length_807_cov_54.980226	727	802	25	1	75	0.0133333
NODE_11784_length_807_cov_54.980226	727	802	29	1	75	0.0133333
NODE_11784_length_807_cov_54.980226	727	802	31	1	75	0.0133333
NODE_11784_length_807_cov_54.980226	727	802	33	2	75	0.0266667
NODE_11784_length_807_cov_54.980226	727	802	37	4	75	0.0533333
NODE_11784_length_807_cov_54.980226	727	802	39	4	75	0.0533333
NODE_11784_length_807_cov_54.980226	727	802	41	2	75	0.0266667
NODE_11784_length_807_cov_54.980226	727	802	43	7	75	0.0933333
NODE_11784_length_807_cov_54.980226	727	802	47	1	75	0.0133333
NODE_11784_length_807_cov_54.980226	727	802	49	2	75	0.0266667
NODE_11784_length_807_cov_54.980226	727	802	53	3	75	0.0400000
NODE_11784_length_807_cov_54.980226	727	802	55	3	75	0.0400000
NODE_11784_length_807_cov_54.980226	727	802	59	1	75	0.0133333
NODE_11784_length_807_cov_54.980226	727	802	61	1	75	0.0133333
NODE_11784_length_807_cov_54.980226	727	802	62	1	75	0.0133333
NODE_11784_length_807_cov_54.980226	727	802	64	1	75	0.0133333
NODE_11784_length_807_cov_54.980226	727	802	66	2	75	0.0266667
NODE_11784_length_807_cov_54.980226	727	802	68	2	75	0.0266667
NODE_11784_length_807_cov_54.980226	727	802	70	1	75	0.0133333
NODE_11784_length_807_cov_54.980226	727	802	71	4	75	0.0533333
NODE_11784_length_807_cov_54.980226	727	802	74	1	75	0.0133333
NODE_11784_length_807_cov_54.980226	727	802	75	3	75	0.0400000
NODE_11784_length_807_cov_54.980226	727	802	77	1	75	0.0133333
NODE_11784_length_807_cov_54.980226	727	802	79	1	75	0.0133333
NODE_11784_length_807_cov_54.980226	727	802	81	5	75	0.0666667
NODE_11784_length_807_cov_54.980226	727	802	83	2	75	0.0266667
NODE_11785_length_807_cov_37.306497	435	515	0	80	80	1.0000000
NODE_11785_length_807_cov_37.306497	488	568	0	80	80	1.0000000
NODE_11786_length_807_cov_31.177966	287	367	0	80	80	1.0000000
NODE_11786_length_807_cov_31.177966	340	420	0	80	80	1.0000000
NODE_11787_length_807_cov_30.638418	250	329	0	79	79	1.0000000
NODE_11787_length_807_cov_30.638418	302	382	0	80	80	1.0000000
NODE_11787_length_807_cov_30.638418	378	458	0	80	80	1.0000000
NODE_11787_length_807_cov_30.638418	431	511	0	80	80	1.0000000
NODE_11788_length_807_cov_29.725989	362	442	0	80	80	1.0000000
NODE_11788_length_807_cov_29.725989	415	495	0	48	80	0.6000000
NODE_11788_length_807_cov_29.725989	415	495	2	32	80	0.4000000
NODE_11789_length_807_cov_23.200565	441	521	0	80	80	1.0000000
NODE_11789_length_807_cov_23.200565	494	574	0	80	80	1.0000000
NODE_11790_length_807_cov_21.888418	319	386	0	5	67	0.0746269
NODE_11790_length_807_cov_21.888418	319	386	2	62	67	0.9253731
NODE_11790_length_807_cov_21.888418	390	440	0	50	50	1.0000000
NODE_11791_length_807_cov_17.480226	339	419	0	71	80	0.8875000
NODE_11791_length_807_cov_17.480226	339	419	2	9	80	0.1125000
NODE_11791_length_807_cov_17.480226	392	472	0	80	80	1.0000000
NODE_11792_length_807_cov_14.895480	350	430	0	80	80	1.0000000
NODE_11792_length_807_cov_14.895480	403	483	0	80	80	1.0000000
NODE_11794_length_807_cov_12.255650	440	520	0	80	80	1.0000000
NODE_11794_length_807_cov_12.255650	493	573	0	80	80	1.0000000
NODE_11795_length_807_cov_11.129944	359	439	2	39	80	0.4875000
NODE_11795_length_807_cov_11.129944	359	439	4	41	80	0.5125000
NODE_11795_length_807_cov_11.129944	412	492	0	2	80	0.0250000
NODE_11795_length_807_cov_11.129944	412	492	2	18	80	0.2250000
NODE_11795_length_807_cov_11.129944	412	492	4	60	80	0.7500000
NODE_11801_length_807_cov_3.847458	322	385	0	63	63	1.0000000
NODE_11822_length_806_cov_35.650636	397	477	0	57	80	0.7125000
NODE_11822_length_806_cov_35.650636	397	477	2	23	80	0.2875000
NODE_11822_length_806_cov_35.650636	450	530	0	80	80	1.0000000
NODE_11822_length_806_cov_35.650636	526	606	0	9	80	0.1125000
NODE_11822_length_806_cov_35.650636	526	606	2	23	80	0.2875000
NODE_11822_length_806_cov_35.650636	526	606	4	20	80	0.2500000
NODE_11822_length_806_cov_35.650636	526	606	6	28	80	0.3500000
NODE_11822_length_806_cov_35.650636	579	667	0	3	88	0.0340909
NODE_11822_length_806_cov_35.650636	579	667	2	16	88	0.1818182
NODE_11822_length_806_cov_35.650636	579	667	4	5	88	0.0568182
NODE_11822_length_806_cov_35.650636	579	667	6	64	88	0.7272727
NODE_11823_length_806_cov_29.615276	377	457	0	1	80	0.0125000
NODE_11823_length_806_cov_29.615276	377	457	2	1	80	0.0125000
NODE_11823_length_806_cov_29.615276	377	457	4	7	80	0.0875000
NODE_11823_length_806_cov_29.615276	377	457	6	22	80	0.2750000
NODE_11823_length_806_cov_29.615276	377	457	8	14	80	0.1750000
NODE_11823_length_806_cov_29.615276	377	457	10	35	80	0.4375000
NODE_11823_length_806_cov_29.615276	430	510	0	31	80	0.3875000
NODE_11823_length_806_cov_29.615276	430	510	2	2	80	0.0250000
NODE_11823_length_806_cov_29.615276	430	510	4	3	80	0.0375000
NODE_11823_length_806_cov_29.615276	430	510	6	6	80	0.0750000
NODE_11823_length_806_cov_29.615276	430	510	8	20	80	0.2500000
NODE_11823_length_806_cov_29.615276	430	510	10	18	80	0.2250000
NODE_11824_length_806_cov_23.680339	394	474	0	58	80	0.7250000
NODE_11824_length_806_cov_23.680339	394	474	2	22	80	0.2750000
NODE_11824_length_806_cov_23.680339	447	527	0	5	80	0.0625000
NODE_11824_length_806_cov_23.680339	447	527	2	75	80	0.9375000
NODE_11825_length_806_cov_19.107496	239	293	0	54	54	1.0000000
NODE_11825_length_806_cov_19.107496	248	293	0	45	45	1.0000000
NODE_11825_length_806_cov_19.107496	266	345	0	79	79	1.0000000
NODE_11825_length_806_cov_19.107496	266	345	0	79	79	1.0000000
NODE_11825_length_806_cov_19.107496	421	501	2	3	80	0.0375000
NODE_11825_length_806_cov_19.107496	421	501	4	77	80	0.9625000
NODE_11826_length_806_cov_17.551627	308	388	0	80	80	1.0000000
NODE_11826_length_806_cov_17.551627	361	441	0	80	80	1.0000000
NODE_11827_length_806_cov_15.608204	408	488	0	80	80	1.0000000
NODE_11827_length_806_cov_15.608204	461	543	0	82	82	1.0000000
NODE_11864_length_805_cov_94.121813	398	478	0	33	80	0.4125000
NODE_11864_length_805_cov_94.121813	398	478	2	47	80	0.5875000
NODE_11864_length_805_cov_94.121813	451	531	2	80	80	1.0000000
NODE_11865_length_805_cov_54.001416	284	364	0	7	80	0.0875000
NODE_11865_length_805_cov_54.001416	284	364	2	73	80	0.9125000
NODE_11865_length_805_cov_54.001416	337	417	0	56	80	0.7000000
NODE_11865_length_805_cov_54.001416	337	417	2	24	80	0.3000000
NODE_11865_length_805_cov_54.001416	413	493	0	7	80	0.0875000
NODE_11865_length_805_cov_54.001416	413	493	2	34	80	0.4250000
NODE_11865_length_805_cov_54.001416	413	493	4	39	80	0.4875000
NODE_11865_length_805_cov_54.001416	466	546	0	9	80	0.1125000
NODE_11865_length_805_cov_54.001416	466	546	2	11	80	0.1375000
NODE_11865_length_805_cov_54.001416	466	546	4	60	80	0.7500000
NODE_11866_length_805_cov_42.325779	377	457	0	80	80	1.0000000
NODE_11866_length_805_cov_42.325779	430	510	0	80	80	1.0000000
NODE_11867_length_805_cov_36.742210	345	425	0	80	80	1.0000000
NODE_11867_length_805_cov_36.742210	398	478	0	80	80	1.0000000
NODE_11868_length_805_cov_25.879603	361	441	4	80	80	1.0000000
NODE_11868_length_805_cov_25.879603	414	494	0	51	80	0.6375000
NODE_11868_length_805_cov_25.879603	414	494	4	29	80	0.3625000
NODE_11869_length_805_cov_25.048159	306	386	0	80	80	1.0000000
NODE_11869_length_805_cov_25.048159	359	439	0	80	80	1.0000000
NODE_11870_length_805_cov_15.453258	311	391	0	7	80	0.0875000
NODE_11870_length_805_cov_15.453258	311	391	2	73	80	0.9125000
NODE_11870_length_805_cov_15.453258	364	444	2	80	80	1.0000000
NODE_11871_length_805_cov_14.930595	264	344	0	51	80	0.6375000
NODE_11871_length_805_cov_14.930595	264	344	2	23	80	0.2875000
NODE_11871_length_805_cov_14.930595	264	344	4	6	80	0.0750000
NODE_11871_length_805_cov_14.930595	317	397	0	80	80	1.0000000
NODE_11872_length_805_cov_10.888102	259	339	0	45	80	0.5625000
NODE_11872_length_805_cov_10.888102	259	339	2	35	80	0.4375000
NODE_11872_length_805_cov_10.888102	312	392	0	80	80	1.0000000
NODE_11873_length_805_cov_10.716714	348	428	0	80	80	1.0000000
NODE_11873_length_805_cov_10.716714	401	481	0	80	80	1.0000000
NODE_11876_length_805_cov_7.212465	374	454	0	26	80	0.3250000
NODE_11876_length_805_cov_7.212465	374	454	2	18	80	0.2250000
NODE_11876_length_805_cov_7.212465	374	454	4	36	80	0.4500000
NODE_11876_length_805_cov_7.212465	427	507	0	21	80	0.2625000
NODE_11876_length_805_cov_7.212465	427	507	2	6	80	0.0750000
NODE_11876_length_805_cov_7.212465	427	507	4	53	80	0.6625000
NODE_11877_length_805_cov_5.637394	323	403	0	80	80	1.0000000
NODE_11877_length_805_cov_5.637394	376	456	0	80	80	1.0000000
NODE_11878_length_805_cov_4.001416	304	384	0	80	80	1.0000000
NODE_11878_length_805_cov_4.001416	357	437	0	61	80	0.7625000
NODE_11878_length_805_cov_4.001416	357	437	2	19	80	0.2375000
NODE_11903_length_804_cov_26.204255	319	399	6	13	80	0.1625000
NODE_11903_length_804_cov_26.204255	319	399	8	67	80	0.8375000
NODE_11903_length_804_cov_26.204255	372	452	0	33	80	0.4125000
NODE_11903_length_804_cov_26.204255	372	452	6	9	80	0.1125000
NODE_11903_length_804_cov_26.204255	372	452	8	38	80	0.4750000
NODE_11904_length_804_cov_25.978723	242	322	0	72	80	0.9000000
NODE_11904_length_804_cov_25.978723	242	322	2	8	80	0.1000000
NODE_11904_length_804_cov_25.978723	295	375	0	80	80	1.0000000
NODE_11904_length_804_cov_25.978723	371	451	0	80	80	1.0000000
NODE_11904_length_804_cov_25.978723	424	504	0	80	80	1.0000000
NODE_11905_length_804_cov_25.628369	444	524	0	17	80	0.2125000
NODE_11905_length_804_cov_25.628369	444	524	2	2	80	0.0250000
NODE_11905_length_804_cov_25.628369	444	524	4	46	80	0.5750000
NODE_11905_length_804_cov_25.628369	444	524	6	15	80	0.1875000
NODE_11905_length_804_cov_25.628369	497	577	4	54	80	0.6750000
NODE_11905_length_804_cov_25.628369	497	577	6	26	80	0.3250000
NODE_11906_length_804_cov_22.438298	269	349	0	80	80	1.0000000
NODE_11906_length_804_cov_22.438298	322	402	0	80	80	1.0000000
NODE_11907_length_804_cov_17.425532	273	353	0	80	80	1.0000000
NODE_11907_length_804_cov_17.425532	326	406	0	80	80	1.0000000
NODE_11908_length_804_cov_16.849645	229	309	0	80	80	1.0000000
NODE_11908_length_804_cov_16.849645	282	362	0	80	80	1.0000000
NODE_11909_length_804_cov_16.024113	499	579	0	13	80	0.1625000
NODE_11909_length_804_cov_16.024113	499	579	2	67	80	0.8375000
NODE_11909_length_804_cov_16.024113	552	632	0	66	80	0.8250000
NODE_11909_length_804_cov_16.024113	552	632	2	14	80	0.1750000
NODE_11910_length_804_cov_14.567376	375	455	4	65	80	0.8125000
NODE_11910_length_804_cov_14.567376	375	455	6	15	80	0.1875000
NODE_11910_length_804_cov_14.567376	428	508	0	6	80	0.0750000
NODE_11910_length_804_cov_14.567376	428	508	2	37	80	0.4625000
NODE_11910_length_804_cov_14.567376	428	508	4	22	80	0.2750000
NODE_11910_length_804_cov_14.567376	428	508	6	15	80	0.1875000
NODE_11911_length_804_cov_14.011348	262	342	2	44	80	0.5500000
NODE_11911_length_804_cov_14.011348	262	342	4	36	80	0.4500000
NODE_11911_length_804_cov_14.011348	315	395	0	18	80	0.2250000
NODE_11911_length_804_cov_14.011348	315	395	2	2	80	0.0250000
NODE_11911_length_804_cov_14.011348	315	395	4	60	80	0.7500000
NODE_11912_length_804_cov_13.800000	289	318	0	29	29	1.0000000
NODE_11913_length_804_cov_12.585816	396	476	0	80	80	1.0000000
NODE_11913_length_804_cov_12.585816	449	529	0	80	80	1.0000000
NODE_11914_length_804_cov_12.375887	190	270	2	37	80	0.4625000
NODE_11914_length_804_cov_12.375887	190	270	4	43	80	0.5375000
NODE_11914_length_804_cov_12.375887	243	323	0	33	80	0.4125000
NODE_11914_length_804_cov_12.375887	243	323	2	37	80	0.4625000
NODE_11914_length_804_cov_12.375887	243	323	4	10	80	0.1250000
NODE_11915_length_804_cov_10.947518	363	443	0	19	80	0.2375000
NODE_11915_length_804_cov_10.947518	363	443	2	61	80	0.7625000
NODE_11915_length_804_cov_10.947518	416	496	2	57	80	0.7125000
NODE_11915_length_804_cov_10.947518	416	496	4	23	80	0.2875000
NODE_11916_length_804_cov_8.164539	427	507	0	80	80	1.0000000
NODE_11916_length_804_cov_8.164539	480	560	0	80	80	1.0000000
NODE_11917_length_804_cov_7.462411	345	425	0	42	80	0.5250000
NODE_11917_length_804_cov_7.462411	345	425	2	38	80	0.4750000
NODE_11917_length_804_cov_7.462411	398	478	0	17	80	0.2125000
NODE_11917_length_804_cov_7.462411	398	478	2	63	80	0.7875000
NODE_11919_length_804_cov_3.663830	736	799	0	63	63	1.0000000
NODE_11933_length_804_cov_1.303546	480	560	0	80	80	1.0000000
NODE_11933_length_804_cov_1.303546	533	613	0	80	80	1.0000000
NODE_11942_length_803_cov_40.930398	374	454	0	35	80	0.4375000
NODE_11942_length_803_cov_40.930398	374	454	2	45	80	0.5625000
NODE_11942_length_803_cov_40.930398	427	507	0	25	80	0.3125000
NODE_11942_length_803_cov_40.930398	427	507	2	55	80	0.6875000
NODE_11944_length_803_cov_28.346591	242	322	0	35	80	0.4375000
NODE_11944_length_803_cov_28.346591	242	322	2	24	80	0.3000000
NODE_11944_length_803_cov_28.346591	242	322	4	21	80	0.2625000
NODE_11944_length_803_cov_28.346591	295	375	2	41	80	0.5125000
NODE_11944_length_803_cov_28.346591	295	375	4	39	80	0.4875000
NODE_11945_length_803_cov_23.420455	288	368	0	80	80	1.0000000
NODE_11945_length_803_cov_23.420455	341	421	0	80	80	1.0000000
NODE_11946_length_803_cov_20.977273	316	396	0	61	80	0.7625000
NODE_11946_length_803_cov_20.977273	316	396	2	19	80	0.2375000
NODE_11946_length_803_cov_20.977273	369	449	0	8	80	0.1000000
NODE_11946_length_803_cov_20.977273	369	449	2	72	80	0.9000000
NODE_11947_length_803_cov_18.458807	307	387	1	21	80	0.2625000
NODE_11947_length_803_cov_18.458807	307	387	3	59	80	0.7375000
NODE_11947_length_803_cov_18.458807	360	440	1	74	80	0.9250000
NODE_11947_length_803_cov_18.458807	360	440	3	6	80	0.0750000
NODE_11948_length_803_cov_14.411932	386	466	0	80	80	1.0000000
NODE_11948_length_803_cov_14.411932	439	519	0	80	80	1.0000000
NODE_11949_length_803_cov_10.157670	319	399	2	80	80	1.0000000
NODE_11949_length_803_cov_10.157670	372	452	0	52	80	0.6500000
NODE_11949_length_803_cov_10.157670	372	452	2	28	80	0.3500000
NODE_11950_length_803_cov_8.977273	362	442	0	80	80	1.0000000
NODE_11950_length_803_cov_8.977273	415	485	0	70	70	1.0000000
NODE_11951_length_803_cov_7.735795	195	275	2	80	80	1.0000000
NODE_11951_length_803_cov_7.735795	248	328	0	42	80	0.5250000
NODE_11951_length_803_cov_7.735795	248	328	2	38	80	0.4750000
NODE_11955_length_803_cov_4.613636	266	346	0	14	80	0.1750000
NODE_11955_length_803_cov_4.613636	266	346	2	40	80	0.5000000
NODE_11955_length_803_cov_4.613636	266	346	4	26	80	0.3250000
NODE_11955_length_803_cov_4.613636	319	399	2	32	80	0.4000000
NODE_11955_length_803_cov_4.613636	319	399	4	48	80	0.6000000
NODE_11957_length_803_cov_4.220170	72	152	0	80	80	1.0000000
NODE_11957_length_803_cov_4.220170	130	207	0	77	77	1.0000000
NODE_11985_length_802_cov_42.294452	289	369	2	62	80	0.7750000
NODE_11985_length_802_cov_42.294452	289	369	4	18	80	0.2250000
NODE_11985_length_802_cov_42.294452	342	422	2	22	80	0.2750000
NODE_11985_length_802_cov_42.294452	342	422	3	26	80	0.3250000
NODE_11985_length_802_cov_42.294452	342	422	4	32	80	0.4000000
NODE_11986_length_802_cov_31.896159	246	326	0	80	80	1.0000000
NODE_11986_length_802_cov_31.896159	299	379	0	80	80	1.0000000
NODE_11987_length_802_cov_30.786629	419	499	0	80	80	1.0000000
NODE_11987_length_802_cov_30.786629	472	552	0	76	80	0.9500000
NODE_11987_length_802_cov_30.786629	472	552	2	4	80	0.0500000
NODE_11988_length_802_cov_19.540541	368	448	2	7	80	0.0875000
NODE_11988_length_802_cov_19.540541	368	448	4	4	80	0.0500000
NODE_11988_length_802_cov_19.540541	368	448	6	69	80	0.8625000
NODE_11988_length_802_cov_19.540541	421	501	0	9	80	0.1125000
NODE_11988_length_802_cov_19.540541	421	501	2	34	80	0.4250000
NODE_11988_length_802_cov_19.540541	421	501	4	4	80	0.0500000
NODE_11988_length_802_cov_19.540541	421	501	6	33	80	0.4125000
NODE_11989_length_802_cov_17.689900	268	348	0	80	80	1.0000000
NODE_11989_length_802_cov_17.689900	321	401	0	80	80	1.0000000
NODE_11990_length_802_cov_16.432432	364	444	0	80	80	1.0000000
NODE_11990_length_802_cov_16.432432	417	497	0	80	80	1.0000000
NODE_11991_length_802_cov_15.409673	317	397	0	54	80	0.6750000
NODE_11991_length_802_cov_15.409673	317	397	4	7	80	0.0875000
NODE_11991_length_802_cov_15.409673	317	397	10	19	80	0.2375000
NODE_11991_length_802_cov_15.409673	370	450	0	1	80	0.0125000
NODE_11991_length_802_cov_15.409673	370	450	4	7	80	0.0875000
NODE_11991_length_802_cov_15.409673	370	450	10	72	80	0.9000000
NODE_11992_length_802_cov_12.507824	340	420	0	80	80	1.0000000
NODE_11992_length_802_cov_12.507824	393	473	0	80	80	1.0000000
NODE_11993_length_802_cov_9.310100	374	454	0	22	80	0.2750000
NODE_11993_length_802_cov_9.310100	374	454	1	29	80	0.3625000
NODE_11993_length_802_cov_9.310100	374	454	2	29	80	0.3625000
NODE_11993_length_802_cov_9.310100	427	507	0	72	80	0.9000000
NODE_11993_length_802_cov_9.310100	427	507	1	5	80	0.0625000
NODE_11993_length_802_cov_9.310100	427	507	2	3	80	0.0375000
NODE_11994_length_802_cov_8.421053	272	351	0	19	79	0.2405063
NODE_11994_length_802_cov_8.421053	272	351	1	8	79	0.1012658
NODE_11994_length_802_cov_8.421053	272	351	2	1	79	0.0126582
NODE_11994_length_802_cov_8.421053	272	351	4	51	79	0.6455696
NODE_11994_length_802_cov_8.421053	324	404	2	44	80	0.5500000
NODE_11994_length_802_cov_8.421053	324	404	4	36	80	0.4500000
NODE_11997_length_802_cov_5.576102	294	374	0	80	80	1.0000000
NODE_11997_length_802_cov_5.576102	347	427	0	80	80	1.0000000
NODE_12025_length_801_cov_35.199430	334	414	2	80	80	1.0000000
NODE_12025_length_801_cov_35.199430	387	467	0	52	80	0.6500000
NODE_12025_length_801_cov_35.199430	387	467	2	28	80	0.3500000
NODE_12026_length_801_cov_20.096866	347	427	0	10	80	0.1250000
NODE_12026_length_801_cov_20.096866	347	427	2	21	80	0.2625000
NODE_12026_length_801_cov_20.096866	347	427	4	49	80	0.6125000
NODE_12026_length_801_cov_20.096866	400	480	0	6	80	0.0750000
NODE_12026_length_801_cov_20.096866	400	480	2	6	80	0.0750000
NODE_12026_length_801_cov_20.096866	400	480	4	68	80	0.8500000
NODE_12027_length_801_cov_18.643875	355	435	0	49	80	0.6125000
NODE_12027_length_801_cov_18.643875	355	435	2	16	80	0.2000000
NODE_12027_length_801_cov_18.643875	355	435	4	15	80	0.1875000
NODE_12027_length_801_cov_18.643875	408	488	2	12	80	0.1500000
NODE_12027_length_801_cov_18.643875	408	488	4	68	80	0.8500000
NODE_12028_length_801_cov_16.099715	427	507	0	80	80	1.0000000
NODE_12028_length_801_cov_16.099715	480	560	0	80	80	1.0000000
NODE_12029_length_801_cov_12.307692	332	412	0	80	80	1.0000000
NODE_12029_length_801_cov_12.307692	385	465	0	80	80	1.0000000
NODE_12030_length_801_cov_11.464387	293	373	0	12	80	0.1500000
NODE_12030_length_801_cov_11.464387	293	373	2	68	80	0.8500000
NODE_12030_length_801_cov_11.464387	346	426	0	65	80	0.8125000
NODE_12030_length_801_cov_11.464387	346	426	2	15	80	0.1875000
NODE_12031_length_801_cov_8.562678	309	389	0	80	80	1.0000000
NODE_12031_length_801_cov_8.562678	362	442	0	40	80	0.5000000
NODE_12031_length_801_cov_8.562678	362	442	2	40	80	0.5000000
NODE_12032_length_801_cov_3.927350	339	419	0	80	80	1.0000000
NODE_12032_length_801_cov_3.927350	392	472	0	80	80	1.0000000
NODE_12053_length_800_cov_72.029957	245	325	2	6	80	0.0750000
NODE_12053_length_800_cov_72.029957	245	325	6	23	80	0.2875000
NODE_12053_length_800_cov_72.029957	245	325	7	1	80	0.0125000
NODE_12053_length_800_cov_72.029957	245	325	8	50	80	0.6250000
NODE_12053_length_800_cov_72.029957	298	378	0	4	80	0.0500000
NODE_12053_length_800_cov_72.029957	298	378	2	55	80	0.6875000
NODE_12053_length_800_cov_72.029957	298	378	7	1	80	0.0125000
NODE_12053_length_800_cov_72.029957	298	378	8	20	80	0.2500000
NODE_12054_length_800_cov_22.631954	297	377	0	42	80	0.5250000
NODE_12054_length_800_cov_22.631954	297	377	2	30	80	0.3750000
NODE_12054_length_800_cov_22.631954	297	377	4	8	80	0.1000000
NODE_12054_length_800_cov_22.631954	350	430	2	46	80	0.5750000
NODE_12054_length_800_cov_22.631954	350	430	4	34	80	0.4250000
NODE_12055_length_800_cov_9.457917	409	489	2	34	80	0.4250000
NODE_12055_length_800_cov_9.457917	409	489	4	6	80	0.0750000
NODE_12055_length_800_cov_9.457917	409	489	6	11	80	0.1375000
NODE_12055_length_800_cov_9.457917	409	489	8	29	80	0.3625000
NODE_12055_length_800_cov_9.457917	462	542	0	16	80	0.2000000
NODE_12055_length_800_cov_9.457917	462	542	2	2	80	0.0250000
NODE_12055_length_800_cov_9.457917	462	542	4	15	80	0.1875000
NODE_12055_length_800_cov_9.457917	462	542	6	13	80	0.1625000
NODE_12055_length_800_cov_9.457917	462	542	8	34	80	0.4250000
NODE_12084_length_799_cov_101.640000	101	132	23	2	31	0.0645161
NODE_12084_length_799_cov_101.640000	101	132	24	1	31	0.0322581
NODE_12084_length_799_cov_101.640000	101	132	32	9	31	0.2903226
NODE_12084_length_799_cov_101.640000	101	132	36	1	31	0.0322581
NODE_12084_length_799_cov_101.640000	101	132	38	1	31	0.0322581
NODE_12084_length_799_cov_101.640000	101	132	40	4	31	0.1290323
NODE_12084_length_799_cov_101.640000	101	132	42	1	31	0.0322581
NODE_12084_length_799_cov_101.640000	101	132	44	1	31	0.0322581
NODE_12084_length_799_cov_101.640000	101	132	46	1	31	0.0322581
NODE_12084_length_799_cov_101.640000	101	132	47	1	31	0.0322581
NODE_12084_length_799_cov_101.640000	101	132	49	1	31	0.0322581
NODE_12084_length_799_cov_101.640000	101	132	57	1	31	0.0322581
NODE_12084_length_799_cov_101.640000	101	132	59	2	31	0.0645161
NODE_12084_length_799_cov_101.640000	101	132	62	2	31	0.0645161
NODE_12084_length_799_cov_101.640000	101	132	65	1	31	0.0322581
NODE_12084_length_799_cov_101.640000	101	132	67	1	31	0.0322581
NODE_12084_length_799_cov_101.640000	101	132	69	1	31	0.0322581
NODE_12085_length_799_cov_33.630000	367	447	2	1	80	0.0125000
NODE_12085_length_799_cov_33.630000	367	447	4	64	80	0.8000000
NODE_12085_length_799_cov_33.630000	367	447	6	15	80	0.1875000
NODE_12085_length_799_cov_33.630000	420	500	0	28	80	0.3500000
NODE_12085_length_799_cov_33.630000	420	500	2	16	80	0.2000000
NODE_12085_length_799_cov_33.630000	420	500	4	36	80	0.4500000
NODE_12086_length_799_cov_15.717143	408	488	2	16	80	0.2000000
NODE_12086_length_799_cov_15.717143	408	488	4	64	80	0.8000000
NODE_12086_length_799_cov_15.717143	461	541	0	24	80	0.3000000
NODE_12086_length_799_cov_15.717143	461	541	2	7	80	0.0875000
NODE_12086_length_799_cov_15.717143	461	541	4	49	80	0.6125000
NODE_12087_length_799_cov_15.175714	293	373	0	33	80	0.4125000
NODE_12087_length_799_cov_15.175714	293	373	2	16	80	0.2000000
NODE_12087_length_799_cov_15.175714	293	373	4	31	80	0.3875000
NODE_12087_length_799_cov_15.175714	346	426	0	24	80	0.3000000
NODE_12087_length_799_cov_15.175714	346	426	2	5	80	0.0625000
NODE_12087_length_799_cov_15.175714	346	426	4	51	80	0.6375000
NODE_12088_length_799_cov_8.444286	408	488	0	15	80	0.1875000
NODE_12088_length_799_cov_8.444286	408	488	2	22	80	0.2750000
NODE_12088_length_799_cov_8.444286	408	488	4	43	80	0.5375000
NODE_12088_length_799_cov_8.444286	461	541	0	68	80	0.8500000
NODE_12088_length_799_cov_8.444286	461	541	2	12	80	0.1500000
NODE_12120_length_798_cov_42.629471	148	228	0	80	80	1.0000000
NODE_12120_length_798_cov_42.629471	201	281	0	80	80	1.0000000
NODE_12121_length_798_cov_23.658083	368	448	0	80	80	1.0000000
NODE_12121_length_798_cov_23.658083	421	501	0	80	80	1.0000000
NODE_12122_length_798_cov_15.037196	341	421	0	22	80	0.2750000
NODE_12122_length_798_cov_15.037196	341	421	2	58	80	0.7250000
NODE_12122_length_798_cov_15.037196	394	474	0	31	80	0.3875000
NODE_12122_length_798_cov_15.037196	394	474	2	49	80	0.6125000
NODE_12123_length_798_cov_6.816881	404	483	0	79	79	1.0000000
NODE_12123_length_798_cov_6.816881	457	536	0	79	79	1.0000000
NODE_12129_length_798_cov_2.796853	246	326	0	80	80	1.0000000
NODE_12129_length_798_cov_2.796853	299	379	0	80	80	1.0000000
NODE_12151_length_797_cov_24.340974	207	287	8	26	80	0.3250000
NODE_12151_length_797_cov_24.340974	207	287	10	54	80	0.6750000
NODE_12151_length_797_cov_24.340974	260	340	0	33	80	0.4125000
NODE_12151_length_797_cov_24.340974	260	340	2	11	80	0.1375000
NODE_12151_length_797_cov_24.340974	260	340	10	36	80	0.4500000
NODE_12152_length_797_cov_21.071633	372	452	0	30	80	0.3750000
NODE_12152_length_797_cov_21.071633	372	452	2	29	80	0.3625000
NODE_12152_length_797_cov_21.071633	372	452	4	1	80	0.0125000
NODE_12152_length_797_cov_21.071633	372	452	6	19	80	0.2375000
NODE_12152_length_797_cov_21.071633	372	452	8	1	80	0.0125000
NODE_12152_length_797_cov_21.071633	425	505	2	6	80	0.0750000
NODE_12152_length_797_cov_21.071633	425	505	4	1	80	0.0125000
NODE_12152_length_797_cov_21.071633	425	505	6	19	80	0.2375000
NODE_12152_length_797_cov_21.071633	425	505	8	54	80	0.6750000
NODE_12153_length_797_cov_18.286533	346	426	0	25	80	0.3125000
NODE_12153_length_797_cov_18.286533	346	426	2	15	80	0.1875000
NODE_12153_length_797_cov_18.286533	346	426	4	2	80	0.0250000
NODE_12153_length_797_cov_18.286533	346	426	6	38	80	0.4750000
NODE_12153_length_797_cov_18.286533	399	479	0	78	80	0.9750000
NODE_12153_length_797_cov_18.286533	399	479	2	2	80	0.0250000
NODE_12154_length_797_cov_16.628940	322	402	0	80	80	1.0000000
NODE_12154_length_797_cov_16.628940	375	455	0	80	80	1.0000000
NODE_12155_length_797_cov_15.266476	299	379	0	80	80	1.0000000
NODE_12155_length_797_cov_15.266476	352	432	0	80	80	1.0000000
NODE_12156_length_797_cov_15.035817	263	343	0	80	80	1.0000000
NODE_12156_length_797_cov_15.035817	316	396	0	47	80	0.5875000
NODE_12156_length_797_cov_15.035817	316	396	1	6	80	0.0750000
NODE_12156_length_797_cov_15.035817	316	396	2	27	80	0.3375000
NODE_12157_length_797_cov_12.934097	403	484	0	81	81	1.0000000
NODE_12157_length_797_cov_12.934097	457	537	0	80	80	1.0000000
NODE_12158_length_797_cov_11.140401	201	281	0	80	80	1.0000000
NODE_12158_length_797_cov_11.140401	254	334	0	80	80	1.0000000
NODE_12159_length_797_cov_8.681948	284	364	0	80	80	1.0000000
NODE_12159_length_797_cov_8.681948	337	417	0	80	80	1.0000000
NODE_12160_length_797_cov_7.616046	314	397	0	28	83	0.3373494
NODE_12160_length_797_cov_7.616046	314	397	2	55	83	0.6626506
NODE_12160_length_797_cov_7.616046	370	450	0	80	80	1.0000000
NODE_12161_length_797_cov_7.487106	275	347	0	72	72	1.0000000
NODE_12161_length_797_cov_7.487106	320	400	0	35	80	0.4375000
NODE_12161_length_797_cov_7.487106	320	400	2	45	80	0.5625000
NODE_12163_length_797_cov_6.068768	357	437	0	66	80	0.8250000
NODE_12163_length_797_cov_6.068768	357	437	2	14	80	0.1750000
NODE_12163_length_797_cov_6.068768	410	490	0	13	80	0.1625000
NODE_12163_length_797_cov_6.068768	410	490	2	24	80	0.3000000
NODE_12163_length_797_cov_6.068768	410	490	6	43	80	0.5375000
NODE_12186_length_796_cov_20.862267	262	342	0	80	80	1.0000000
NODE_12186_length_796_cov_20.862267	315	395	0	80	80	1.0000000
NODE_12187_length_796_cov_18.291248	283	363	0	32	80	0.4000000
NODE_12187_length_796_cov_18.291248	283	363	12	18	80	0.2250000
NODE_12187_length_796_cov_18.291248	283	363	14	18	80	0.2250000
NODE_12187_length_796_cov_18.291248	283	363	20	12	80	0.1500000
NODE_12187_length_796_cov_18.291248	336	416	8	10	80	0.1250000
NODE_12187_length_796_cov_18.291248	336	416	9	15	80	0.1875000
NODE_12187_length_796_cov_18.291248	336	416	14	15	80	0.1875000
NODE_12187_length_796_cov_18.291248	336	416	17	2	80	0.0250000
NODE_12187_length_796_cov_18.291248	336	416	18	11	80	0.1375000
NODE_12187_length_796_cov_18.291248	336	416	19	14	80	0.1750000
NODE_12187_length_796_cov_18.291248	336	416	20	13	80	0.1625000
NODE_12189_length_796_cov_7.880918	388	460	0	72	72	1.0000000
NODE_12189_length_796_cov_7.880918	442	513	0	71	71	1.0000000
NODE_12216_length_795_cov_31.729885	298	378	0	80	80	1.0000000
NODE_12216_length_795_cov_31.729885	351	431	0	80	80	1.0000000
NODE_12217_length_795_cov_26.760057	367	447	0	10	80	0.1250000
NODE_12217_length_795_cov_26.760057	367	447	1	1	80	0.0125000
NODE_12217_length_795_cov_26.760057	367	447	2	69	80	0.8625000
NODE_12217_length_795_cov_26.760057	420	500	0	9	80	0.1125000
NODE_12217_length_795_cov_26.760057	420	500	2	71	80	0.8875000
NODE_12218_length_795_cov_24.522989	352	432	0	80	80	1.0000000
NODE_12218_length_795_cov_24.522989	405	485	0	80	80	1.0000000
NODE_12219_length_795_cov_22.747126	363	443	0	80	80	1.0000000
NODE_12219_length_795_cov_22.747126	416	496	0	80	80	1.0000000
NODE_12220_length_795_cov_9.439655	425	505	0	4	80	0.0500000
NODE_12220_length_795_cov_9.439655	425	505	2	17	80	0.2125000
NODE_12220_length_795_cov_9.439655	425	505	4	59	80	0.7375000
NODE_12220_length_795_cov_9.439655	478	558	2	20	80	0.2500000
NODE_12220_length_795_cov_9.439655	478	558	4	60	80	0.7500000
NODE_12232_length_795_cov_3.359195	349	429	0	80	80	1.0000000
NODE_12232_length_795_cov_3.359195	402	482	0	80	80	1.0000000
NODE_12256_length_794_cov_24.680576	326	406	2	49	80	0.6125000
NODE_12256_length_794_cov_24.680576	326	406	4	31	80	0.3875000
NODE_12256_length_794_cov_24.680576	379	459	0	5	80	0.0625000
NODE_12256_length_794_cov_24.680576	379	459	2	69	80	0.8625000
NODE_12256_length_794_cov_24.680576	379	459	4	6	80	0.0750000
NODE_12257_length_794_cov_20.057554	153	233	0	54	80	0.6750000
NODE_12257_length_794_cov_20.057554	153	233	2	26	80	0.3250000
NODE_12257_length_794_cov_20.057554	206	286	0	1	80	0.0125000
NODE_12257_length_794_cov_20.057554	206	286	2	79	80	0.9875000
NODE_12257_length_794_cov_20.057554	282	362	0	36	80	0.4500000
NODE_12257_length_794_cov_20.057554	282	362	2	44	80	0.5500000
NODE_12257_length_794_cov_20.057554	335	415	0	80	80	1.0000000
NODE_12258_length_794_cov_16.602878	361	441	0	41	80	0.5125000
NODE_12258_length_794_cov_16.602878	361	441	2	39	80	0.4875000
NODE_12258_length_794_cov_16.602878	414	494	2	80	80	1.0000000
NODE_12259_length_794_cov_16.362590	337	417	0	80	80	1.0000000
NODE_12259_length_794_cov_16.362590	390	470	0	80	80	1.0000000
NODE_12260_length_794_cov_14.444604	101	160	0	59	59	1.0000000
NODE_12260_length_794_cov_14.444604	409	489	0	80	80	1.0000000
NODE_12260_length_794_cov_14.444604	462	542	0	80	80	1.0000000
NODE_12261_length_794_cov_12.866187	442	522	2	17	80	0.2125000
NODE_12261_length_794_cov_12.866187	442	522	4	63	80	0.7875000
NODE_12261_length_794_cov_12.866187	495	575	0	19	80	0.2375000
NODE_12261_length_794_cov_12.866187	495	575	2	12	80	0.1500000
NODE_12261_length_794_cov_12.866187	495	575	4	49	80	0.6125000
NODE_12262_length_794_cov_12.287770	235	315	0	80	80	1.0000000
NODE_12262_length_794_cov_12.287770	288	368	0	80	80	1.0000000
NODE_12263_length_794_cov_11.210072	315	395	0	53	80	0.6625000
NODE_12263_length_794_cov_11.210072	315	395	2	27	80	0.3375000
NODE_12263_length_794_cov_11.210072	368	448	0	9	80	0.1125000
NODE_12263_length_794_cov_11.210072	368	448	2	71	80	0.8875000
NODE_12264_length_794_cov_10.638849	325	406	0	81	81	1.0000000
NODE_12264_length_794_cov_10.638849	379	459	0	80	80	1.0000000
NODE_12266_length_794_cov_6.274820	412	492	0	80	80	1.0000000
NODE_12266_length_794_cov_6.274820	465	545	0	80	80	1.0000000
NODE_12271_length_794_cov_3.197122	273	338	0	65	65	1.0000000
NODE_12282_length_794_cov_1.848921	246	326	0	80	80	1.0000000
NODE_12282_length_794_cov_1.848921	299	379	0	44	80	0.5500000
NODE_12282_length_794_cov_1.848921	299	379	2	36	80	0.4500000
NODE_12295_length_793_cov_29.878963	326	406	0	14	80	0.1750000
NODE_12295_length_793_cov_29.878963	326	406	2	8	80	0.1000000
NODE_12295_length_793_cov_29.878963	326	406	4	58	80	0.7250000
NODE_12295_length_793_cov_29.878963	379	459	0	9	80	0.1125000
NODE_12295_length_793_cov_29.878963	379	459	2	13	80	0.1625000
NODE_12295_length_793_cov_29.878963	379	459	4	58	80	0.7250000
NODE_12296_length_793_cov_25.981268	310	390	0	80	80	1.0000000
NODE_12296_length_793_cov_25.981268	363	445	0	82	82	1.0000000
NODE_12297_length_793_cov_24.840058	331	411	0	80	80	1.0000000
NODE_12297_length_793_cov_24.840058	384	464	0	80	80	1.0000000
NODE_12298_length_793_cov_21.707493	398	478	0	34	80	0.4250000
NODE_12298_length_793_cov_21.707493	398	478	2	46	80	0.5750000
NODE_12298_length_793_cov_21.707493	451	531	0	73	80	0.9125000
NODE_12298_length_793_cov_21.707493	451	531	2	7	80	0.0875000
NODE_12299_length_793_cov_8.358790	257	337	2	2	80	0.0250000
NODE_12299_length_793_cov_8.358790	257	337	6	78	80	0.9750000
NODE_12299_length_793_cov_8.358790	310	390	0	52	80	0.6500000
NODE_12299_length_793_cov_8.358790	310	390	2	3	80	0.0375000
NODE_12299_length_793_cov_8.358790	310	390	6	25	80	0.3125000
NODE_12300_length_793_cov_8.236311	477	557	0	80	80	1.0000000
NODE_12300_length_793_cov_8.236311	530	610	0	80	80	1.0000000
NODE_12302_length_793_cov_6.763689	461	541	0	80	80	1.0000000
NODE_12302_length_793_cov_6.763689	514	594	0	80	80	1.0000000
NODE_12307_length_793_cov_4.465418	501	549	4	48	48	1.0000000
NODE_12311_length_793_cov_4.138329	174	254	0	80	80	1.0000000
NODE_12311_length_793_cov_4.138329	227	307	0	80	80	1.0000000
NODE_12338_length_792_cov_40.025974	198	278	0	80	80	1.0000000
NODE_12338_length_792_cov_40.025974	251	331	0	80	80	1.0000000
NODE_12338_length_792_cov_40.025974	327	408	0	81	81	1.0000000
NODE_12338_length_792_cov_40.025974	381	461	0	80	80	1.0000000
NODE_12339_length_792_cov_31.176046	331	411	0	80	80	1.0000000
NODE_12339_length_792_cov_31.176046	384	463	0	56	79	0.7088608
NODE_12339_length_792_cov_31.176046	384	463	2	23	79	0.2911392
NODE_12339_length_792_cov_31.176046	459	539	2	80	80	1.0000000
NODE_12339_length_792_cov_31.176046	512	546	2	34	34	1.0000000
NODE_12340_length_792_cov_21.347763	303	383	0	16	80	0.2000000
NODE_12340_length_792_cov_21.347763	303	383	4	64	80	0.8000000
NODE_12340_length_792_cov_21.347763	356	436	0	16	80	0.2000000
NODE_12340_length_792_cov_21.347763	356	436	4	64	80	0.8000000
NODE_12341_length_792_cov_20.142857	361	441	0	80	80	1.0000000
NODE_12341_length_792_cov_20.142857	414	494	0	80	80	1.0000000
NODE_12342_length_792_cov_18.733045	320	400	0	15	80	0.1875000
NODE_12342_length_792_cov_18.733045	320	400	2	65	80	0.8125000
NODE_12342_length_792_cov_18.733045	373	453	0	38	80	0.4750000
NODE_12342_length_792_cov_18.733045	373	453	2	42	80	0.5250000
NODE_12343_length_792_cov_12.024531	369	449	0	80	80	1.0000000
NODE_12343_length_792_cov_12.024531	422	502	0	80	80	1.0000000
NODE_12372_length_791_cov_53.573699	287	359	0	32	72	0.4444444
NODE_12372_length_791_cov_53.573699	287	359	4	40	72	0.5555556
NODE_12372_length_791_cov_53.573699	332	412	2	28	80	0.3500000
NODE_12372_length_791_cov_53.573699	332	412	4	52	80	0.6500000
NODE_12373_length_791_cov_40.416185	238	318	2	47	80	0.5875000
NODE_12373_length_791_cov_40.416185	238	318	4	33	80	0.4125000
NODE_12373_length_791_cov_40.416185	291	371	2	46	80	0.5750000
NODE_12373_length_791_cov_40.416185	291	371	4	34	80	0.4250000
NODE_12374_length_791_cov_38.791908	309	389	0	50	80	0.6250000
NODE_12374_length_791_cov_38.791908	309	389	1	1	80	0.0125000
NODE_12374_length_791_cov_38.791908	309	389	2	29	80	0.3625000
NODE_12374_length_791_cov_38.791908	362	442	0	80	80	1.0000000
NODE_12375_length_791_cov_23.468208	328	408	0	15	80	0.1875000
NODE_12375_length_791_cov_23.468208	328	408	2	17	80	0.2125000
NODE_12375_length_791_cov_23.468208	328	408	4	48	80	0.6000000
NODE_12375_length_791_cov_23.468208	381	461	0	20	80	0.2500000
NODE_12375_length_791_cov_23.468208	381	461	2	4	80	0.0500000
NODE_12375_length_791_cov_23.468208	381	461	4	56	80	0.7000000
NODE_12376_length_791_cov_20.897399	299	379	0	80	80	1.0000000
NODE_12376_length_791_cov_20.897399	352	432	0	80	80	1.0000000
NODE_12377_length_791_cov_13.504335	339	419	2	13	80	0.1625000
NODE_12377_length_791_cov_13.504335	339	419	4	7	80	0.0875000
NODE_12377_length_791_cov_13.504335	339	419	6	60	80	0.7500000
NODE_12377_length_791_cov_13.504335	392	472	0	10	80	0.1250000
NODE_12377_length_791_cov_13.504335	392	472	2	38	80	0.4750000
NODE_12377_length_791_cov_13.504335	392	472	4	7	80	0.0875000
NODE_12377_length_791_cov_13.504335	392	472	6	25	80	0.3125000
NODE_12379_length_791_cov_12.547688	338	418	0	80	80	1.0000000
NODE_12379_length_791_cov_12.547688	391	471	0	80	80	1.0000000
NODE_12380_length_791_cov_11.791908	440	520	0	46	80	0.5750000
NODE_12380_length_791_cov_11.791908	440	520	2	34	80	0.4250000
NODE_12380_length_791_cov_11.791908	493	573	2	80	80	1.0000000
NODE_12381_length_791_cov_11.011561	337	417	0	21	80	0.2625000
NODE_12381_length_791_cov_11.011561	337	417	2	59	80	0.7375000
NODE_12381_length_791_cov_11.011561	390	470	0	74	80	0.9250000
NODE_12381_length_791_cov_11.011561	390	470	2	6	80	0.0750000
NODE_12382_length_791_cov_8.757225	325	405	0	46	80	0.5750000
NODE_12382_length_791_cov_8.757225	325	405	2	34	80	0.4250000
NODE_12382_length_791_cov_8.757225	378	458	0	80	80	1.0000000
NODE_12384_length_791_cov_8.125723	416	496	0	80	80	1.0000000
NODE_12384_length_791_cov_8.125723	469	549	0	80	80	1.0000000
NODE_12409_length_790_cov_48.021708	526	606	0	11	80	0.1375000
NODE_12409_length_790_cov_48.021708	526	606	2	69	80	0.8625000
NODE_12409_length_790_cov_48.021708	579	659	0	50	80	0.6250000
NODE_12409_length_790_cov_48.021708	579	659	2	30	80	0.3750000
NODE_12410_length_790_cov_44.151954	343	423	0	5	80	0.0625000
NODE_12410_length_790_cov_44.151954	343	423	2	75	80	0.9375000
NODE_12410_length_790_cov_44.151954	396	438	0	18	42	0.4285714
NODE_12410_length_790_cov_44.151954	396	438	2	24	42	0.5714286
NODE_12410_length_790_cov_44.151954	696	776	0	21	80	0.2625000
NODE_12410_length_790_cov_44.151954	696	776	2	2	80	0.0250000
NODE_12410_length_790_cov_44.151954	696	776	5	30	80	0.3750000
NODE_12410_length_790_cov_44.151954	696	776	7	11	80	0.1375000
NODE_12410_length_790_cov_44.151954	696	776	9	16	80	0.2000000
NODE_12411_length_790_cov_27.144718	291	371	0	80	80	1.0000000
NODE_12411_length_790_cov_27.144718	344	424	0	80	80	1.0000000
NODE_12412_length_790_cov_16.973951	232	312	2	15	80	0.1875000
NODE_12412_length_790_cov_16.973951	232	312	6	44	80	0.5500000
NODE_12412_length_790_cov_16.973951	232	312	8	21	80	0.2625000
NODE_12412_length_790_cov_16.973951	285	365	0	21	80	0.2625000
NODE_12412_length_790_cov_16.973951	285	365	6	59	80	0.7375000
NODE_12413_length_790_cov_13.374819	204	284	0	80	80	1.0000000
NODE_12413_length_790_cov_13.374819	257	337	0	80	80	1.0000000
NODE_12415_length_790_cov_10.613603	302	382	0	53	80	0.6625000
NODE_12415_length_790_cov_10.613603	302	382	2	27	80	0.3375000
NODE_12415_length_790_cov_10.613603	355	435	2	80	80	1.0000000
NODE_12418_length_790_cov_5.493488	271	351	0	80	80	1.0000000
NODE_12418_length_790_cov_5.493488	324	404	0	80	80	1.0000000
NODE_12434_length_790_cov_1.463097	313	376	0	63	63	1.0000000
NODE_12452_length_789_cov_39.123188	226	306	0	80	80	1.0000000
NODE_12452_length_789_cov_39.123188	279	359	0	80	80	1.0000000
NODE_12453_length_789_cov_37.205797	423	503	0	80	80	1.0000000
NODE_12453_length_789_cov_37.205797	476	556	0	80	80	1.0000000
NODE_12454_length_789_cov_31.311594	223	303	0	15	80	0.1875000
NODE_12454_length_789_cov_31.311594	223	303	2	65	80	0.8125000
NODE_12454_length_789_cov_31.311594	276	356	0	46	80	0.5750000
NODE_12454_length_789_cov_31.311594	276	356	2	34	80	0.4250000
NODE_12455_length_789_cov_30.536232	306	386	4	22	80	0.2750000
NODE_12455_length_789_cov_30.536232	306	386	6	58	80	0.7250000
NODE_12455_length_789_cov_30.536232	359	439	0	38	80	0.4750000
NODE_12455_length_789_cov_30.536232	359	439	4	37	80	0.4625000
NODE_12455_length_789_cov_30.536232	359	439	6	5	80	0.0625000
NODE_12456_length_789_cov_24.886957	343	423	0	18	80	0.2250000
NODE_12456_length_789_cov_24.886957	343	423	2	11	80	0.1375000
NODE_12456_length_789_cov_24.886957	343	423	4	51	80	0.6375000
NODE_12456_length_789_cov_24.886957	396	476	0	40	80	0.5000000
NODE_12456_length_789_cov_24.886957	396	476	2	4	80	0.0500000
NODE_12456_length_789_cov_24.886957	396	476	4	36	80	0.4500000
NODE_12457_length_789_cov_23.539130	357	437	0	45	80	0.5625000
NODE_12457_length_789_cov_23.539130	357	437	2	7	80	0.0875000
NODE_12457_length_789_cov_23.539130	357	437	4	28	80	0.3500000
NODE_12457_length_789_cov_23.539130	410	490	4	80	80	1.0000000
NODE_12458_length_789_cov_16.169565	392	472	0	80	80	1.0000000
NODE_12458_length_789_cov_16.169565	445	525	0	80	80	1.0000000
NODE_12459_length_789_cov_15.175362	242	322	0	80	80	1.0000000
NODE_12459_length_789_cov_15.175362	295	375	0	80	80	1.0000000
NODE_12459_length_789_cov_15.175362	371	451	0	34	80	0.4250000
NODE_12459_length_789_cov_15.175362	371	451	2	39	80	0.4875000
NODE_12459_length_789_cov_15.175362	371	451	4	7	80	0.0875000
NODE_12459_length_789_cov_15.175362	424	504	2	20	80	0.2500000
NODE_12459_length_789_cov_15.175362	424	504	4	60	80	0.7500000
NODE_12460_length_789_cov_7.276812	306	386	0	80	80	1.0000000
NODE_12460_length_789_cov_7.276812	359	439	0	80	80	1.0000000
NODE_12482_length_788_cov_43.091437	335	415	4	54	80	0.6750000
NODE_12482_length_788_cov_43.091437	335	415	6	26	80	0.3250000
NODE_12482_length_788_cov_43.091437	388	460	2	20	72	0.2777778
NODE_12482_length_788_cov_43.091437	388	460	4	5	72	0.0694444
NODE_12482_length_788_cov_43.091437	388	460	6	47	72	0.6527778
NODE_12483_length_788_cov_38.914369	345	425	0	67	80	0.8375000
NODE_12483_length_788_cov_38.914369	345	425	4	13	80	0.1625000
NODE_12483_length_788_cov_38.914369	398	478	0	14	80	0.1750000
NODE_12483_length_788_cov_38.914369	398	478	4	19	80	0.2375000
NODE_12483_length_788_cov_38.914369	398	478	6	4	80	0.0500000
NODE_12483_length_788_cov_38.914369	398	478	8	43	80	0.5375000
NODE_12484_length_788_cov_36.148041	320	400	0	5	80	0.0625000
NODE_12484_length_788_cov_36.148041	320	400	1	2	80	0.0250000
NODE_12484_length_788_cov_36.148041	320	400	2	1	80	0.0125000
NODE_12484_length_788_cov_36.148041	320	400	3	5	80	0.0625000
NODE_12484_length_788_cov_36.148041	320	400	4	18	80	0.2250000
NODE_12484_length_788_cov_36.148041	320	400	6	49	80	0.6125000
NODE_12484_length_788_cov_36.148041	373	453	4	17	80	0.2125000
NODE_12484_length_788_cov_36.148041	373	453	6	63	80	0.7875000
NODE_12485_length_788_cov_35.460087	346	426	0	13	80	0.1625000
NODE_12485_length_788_cov_35.460087	346	426	2	24	80	0.3000000
NODE_12485_length_788_cov_35.460087	346	426	4	43	80	0.5375000
NODE_12485_length_788_cov_35.460087	399	479	2	30	80	0.3750000
NODE_12485_length_788_cov_35.460087	399	479	4	50	80	0.6250000
NODE_12486_length_788_cov_30.785196	278	358	2	21	80	0.2625000
NODE_12486_length_788_cov_30.785196	278	358	6	9	80	0.1125000
NODE_12486_length_788_cov_30.785196	278	358	8	10	80	0.1250000
NODE_12486_length_788_cov_30.785196	278	358	10	40	80	0.5000000
NODE_12486_length_788_cov_30.785196	331	411	4	11	80	0.1375000
NODE_12486_length_788_cov_30.785196	331	411	6	23	80	0.2875000
NODE_12486_length_788_cov_30.785196	331	411	8	16	80	0.2000000
NODE_12486_length_788_cov_30.785196	331	411	10	30	80	0.3750000
NODE_12488_length_788_cov_20.867925	300	380	0	17	80	0.2125000
NODE_12488_length_788_cov_20.867925	300	380	4	63	80	0.7875000
NODE_12488_length_788_cov_20.867925	353	430	4	77	77	1.0000000
NODE_12489_length_788_cov_20.821480	322	402	0	80	80	1.0000000
NODE_12489_length_788_cov_20.821480	375	455	0	80	80	1.0000000
NODE_12490_length_788_cov_15.570392	342	422	0	80	80	1.0000000
NODE_12490_length_788_cov_15.570392	395	475	0	80	80	1.0000000
NODE_12491_length_788_cov_12.235123	241	321	0	80	80	1.0000000
NODE_12491_length_788_cov_12.235123	294	374	0	80	80	1.0000000
NODE_12492_length_788_cov_10.509434	405	480	0	75	75	1.0000000
NODE_12493_length_788_cov_9.737300	310	390	0	21	80	0.2625000
NODE_12493_length_788_cov_9.737300	310	390	2	37	80	0.4625000
NODE_12493_length_788_cov_9.737300	310	390	4	22	80	0.2750000
NODE_12493_length_788_cov_9.737300	363	443	2	5	80	0.0625000
NODE_12493_length_788_cov_9.737300	363	443	4	75	80	0.9375000
NODE_12494_length_788_cov_8.872279	280	360	0	23	80	0.2875000
NODE_12494_length_788_cov_8.872279	280	360	2	21	80	0.2625000
NODE_12494_length_788_cov_8.872279	280	360	4	36	80	0.4500000
NODE_12494_length_788_cov_8.872279	333	413	4	80	80	1.0000000
NODE_12516_length_787_cov_34.683140	274	335	0	61	61	1.0000000
NODE_12516_length_787_cov_34.683140	319	380	0	61	61	1.0000000
NODE_12517_length_787_cov_28.039244	252	329	0	77	77	1.0000000
NODE_12517_length_787_cov_28.039244	302	370	0	68	68	1.0000000
NODE_12518_length_787_cov_25.422965	351	431	0	80	80	1.0000000
NODE_12518_length_787_cov_25.422965	404	484	0	80	80	1.0000000
NODE_12519_length_787_cov_24.857558	319	399	1	23	80	0.2875000
NODE_12519_length_787_cov_24.857558	319	399	3	10	80	0.1250000
NODE_12519_length_787_cov_24.857558	319	399	5	21	80	0.2625000
NODE_12519_length_787_cov_24.857558	319	399	6	26	80	0.3250000
NODE_12519_length_787_cov_24.857558	372	452	4	22	80	0.2750000
NODE_12519_length_787_cov_24.857558	372	452	5	1	80	0.0125000
NODE_12519_length_787_cov_24.857558	372	452	6	57	80	0.7125000
NODE_12520_length_787_cov_21.357558	291	371	0	32	80	0.4000000
NODE_12520_length_787_cov_21.357558	291	371	2	13	80	0.1625000
NODE_12520_length_787_cov_21.357558	291	371	4	6	80	0.0750000
NODE_12520_length_787_cov_21.357558	291	371	6	29	80	0.3625000
NODE_12520_length_787_cov_21.357558	344	424	2	8	80	0.1000000
NODE_12520_length_787_cov_21.357558	344	424	4	23	80	0.2875000
NODE_12520_length_787_cov_21.357558	344	424	6	49	80	0.6125000
NODE_12521_length_787_cov_17.360465	396	476	0	31	80	0.3875000
NODE_12521_length_787_cov_17.360465	396	476	2	49	80	0.6125000
NODE_12521_length_787_cov_17.360465	449	529	0	33	80	0.4125000
NODE_12521_length_787_cov_17.360465	449	529	2	47	80	0.5875000
NODE_12522_length_787_cov_14.677326	178	258	0	37	80	0.4625000
NODE_12522_length_787_cov_14.677326	178	258	2	43	80	0.5375000
NODE_12522_length_787_cov_14.677326	231	311	2	31	80	0.3875000
NODE_12522_length_787_cov_14.677326	231	311	4	22	80	0.2750000
NODE_12522_length_787_cov_14.677326	231	311	6	5	80	0.0625000
NODE_12522_length_787_cov_14.677326	231	311	8	22	80	0.2750000
NODE_12523_length_787_cov_12.959302	331	411	0	35	80	0.4375000
NODE_12523_length_787_cov_12.959302	331	411	2	45	80	0.5625000
NODE_12523_length_787_cov_12.959302	384	464	0	19	80	0.2375000
NODE_12523_length_787_cov_12.959302	384	464	2	61	80	0.7625000
NODE_12524_length_787_cov_12.748547	426	506	0	80	80	1.0000000
NODE_12524_length_787_cov_12.748547	479	559	0	80	80	1.0000000
NODE_12525_length_787_cov_12.369186	338	418	0	80	80	1.0000000
NODE_12525_length_787_cov_12.369186	391	471	0	80	80	1.0000000
NODE_12526_length_787_cov_9.213663	376	456	0	80	80	1.0000000
NODE_12527_length_787_cov_8.857558	344	424	0	29	80	0.3625000
NODE_12527_length_787_cov_8.857558	344	424	2	51	80	0.6375000
NODE_12527_length_787_cov_8.857558	397	477	0	27	80	0.3375000
NODE_12527_length_787_cov_8.857558	397	477	2	53	80	0.6625000
NODE_12529_length_787_cov_8.186047	508	552	0	44	44	1.0000000
NODE_12541_length_787_cov_2.188953	505	552	0	47	47	1.0000000
NODE_12562_length_786_cov_36.441048	431	511	0	80	80	1.0000000
NODE_12562_length_786_cov_36.441048	484	564	0	80	80	1.0000000
NODE_12563_length_786_cov_23.771470	235	315	0	80	80	1.0000000
NODE_12563_length_786_cov_23.771470	288	368	0	80	80	1.0000000
NODE_12564_length_786_cov_23.333333	361	436	0	42	75	0.5600000
NODE_12564_length_786_cov_23.333333	361	436	2	7	75	0.0933333
NODE_12564_length_786_cov_23.333333	361	436	8	18	75	0.2400000
NODE_12564_length_786_cov_23.333333	361	436	10	8	75	0.1066667
NODE_12564_length_786_cov_23.333333	362	436	0	41	74	0.5540541
NODE_12564_length_786_cov_23.333333	362	436	2	7	74	0.0945946
NODE_12564_length_786_cov_23.333333	362	436	8	18	74	0.2432432
NODE_12564_length_786_cov_23.333333	362	436	10	8	74	0.1081081
NODE_12564_length_786_cov_23.333333	375	436	0	28	61	0.4590164
NODE_12564_length_786_cov_23.333333	375	436	2	7	61	0.1147541
NODE_12564_length_786_cov_23.333333	375	436	8	18	61	0.2950820
NODE_12564_length_786_cov_23.333333	375	436	10	8	61	0.1311475
NODE_12564_length_786_cov_23.333333	414	489	8	14	75	0.1866667
NODE_12564_length_786_cov_23.333333	414	489	10	61	75	0.8133333
NODE_12564_length_786_cov_23.333333	414	489	8	14	75	0.1866667
NODE_12564_length_786_cov_23.333333	414	489	10	61	75	0.8133333
NODE_12564_length_786_cov_23.333333	414	489	8	14	75	0.1866667
NODE_12564_length_786_cov_23.333333	414	489	10	61	75	0.8133333
NODE_12564_length_786_cov_23.333333	490	564	0	18	74	0.2432432
NODE_12564_length_786_cov_23.333333	490	564	2	2	74	0.0270270
NODE_12564_length_786_cov_23.333333	490	564	8	40	74	0.5405405
NODE_12564_length_786_cov_23.333333	490	564	10	14	74	0.1891892
NODE_12565_length_786_cov_19.279476	310	375	0	65	65	1.0000000
NODE_12565_length_786_cov_19.279476	371	441	0	70	70	1.0000000
NODE_12565_length_786_cov_19.279476	371	451	0	80	80	1.0000000
NODE_12565_length_786_cov_19.279476	424	491	0	67	67	1.0000000
NODE_12566_length_786_cov_18.652111	251	331	0	80	80	1.0000000
NODE_12566_length_786_cov_18.652111	304	384	0	80	80	1.0000000
NODE_12567_length_786_cov_16.704512	319	399	0	16	80	0.2000000
NODE_12567_length_786_cov_16.704512	319	399	2	64	80	0.8000000
NODE_12567_length_786_cov_16.704512	372	452	0	7	80	0.0875000
NODE_12567_length_786_cov_16.704512	372	452	2	73	80	0.9125000
NODE_12568_length_786_cov_16.254731	378	458	0	80	80	1.0000000
NODE_12568_length_786_cov_16.254731	431	511	0	80	80	1.0000000
NODE_12571_length_786_cov_10.053857	381	461	0	45	80	0.5625000
NODE_12571_length_786_cov_10.053857	381	461	2	35	80	0.4375000
NODE_12571_length_786_cov_10.053857	434	514	2	80	80	1.0000000
NODE_12572_length_786_cov_7.455604	400	473	0	73	73	1.0000000
NODE_12572_length_786_cov_7.455604	453	533	0	80	80	1.0000000
NODE_12573_length_786_cov_7.119360	276	356	0	80	80	1.0000000
NODE_12573_length_786_cov_7.119360	329	409	0	80	80	1.0000000
NODE_12575_length_786_cov_6.771470	382	462	0	80	80	1.0000000
NODE_12575_length_786_cov_6.771470	435	515	0	68	80	0.8500000
NODE_12575_length_786_cov_6.771470	435	515	4	12	80	0.1500000
NODE_12603_length_785_cov_83.972303	315	395	0	36	80	0.4500000
NODE_12603_length_785_cov_83.972303	315	395	2	44	80	0.5500000
NODE_12603_length_785_cov_83.972303	368	448	0	13	80	0.1625000
NODE_12603_length_785_cov_83.972303	368	448	2	67	80	0.8375000
NODE_12604_length_785_cov_33.911079	477	557	0	80	80	1.0000000
NODE_12604_length_785_cov_33.911079	530	610	0	80	80	1.0000000
NODE_12605_length_785_cov_21.174927	265	299	2	34	34	1.0000000
NODE_12605_length_785_cov_21.174927	295	375	2	20	80	0.2500000
NODE_12605_length_785_cov_21.174927	295	375	4	12	80	0.1500000
NODE_12605_length_785_cov_21.174927	295	375	6	48	80	0.6000000
NODE_12605_length_785_cov_21.174927	348	428	4	22	80	0.2750000
NODE_12605_length_785_cov_21.174927	348	428	6	58	80	0.7250000
NODE_12606_length_785_cov_18.612245	291	371	0	24	80	0.3000000
NODE_12606_length_785_cov_18.612245	291	371	2	56	80	0.7000000
NODE_12606_length_785_cov_18.612245	344	424	0	77	80	0.9625000
NODE_12606_length_785_cov_18.612245	344	424	2	3	80	0.0375000
NODE_12606_length_785_cov_18.612245	684	705	0	21	21	1.0000000
NODE_12607_length_785_cov_9.893586	153	233	0	80	80	1.0000000
NODE_12607_length_785_cov_9.893586	206	286	0	80	80	1.0000000
NODE_12645_length_784_cov_203.604380	5	85	2	3	80	0.0375000
NODE_12645_length_784_cov_203.604380	5	85	4	7	80	0.0875000
NODE_12645_length_784_cov_203.604380	5	85	8	4	80	0.0500000
NODE_12645_length_784_cov_203.604380	5	85	12	2	80	0.0250000
NODE_12645_length_784_cov_203.604380	5	85	14	4	80	0.0500000
NODE_12645_length_784_cov_203.604380	5	85	16	1	80	0.0125000
NODE_12645_length_784_cov_203.604380	5	85	24	3	80	0.0375000
NODE_12645_length_784_cov_203.604380	5	85	28	1	80	0.0125000
NODE_12645_length_784_cov_203.604380	5	85	34	2	80	0.0250000
NODE_12645_length_784_cov_203.604380	5	85	38	3	80	0.0375000
NODE_12645_length_784_cov_203.604380	5	85	40	2	80	0.0250000
NODE_12645_length_784_cov_203.604380	5	85	48	1	80	0.0125000
NODE_12645_length_784_cov_203.604380	5	85	52	2	80	0.0250000
NODE_12645_length_784_cov_203.604380	5	85	56	1	80	0.0125000
NODE_12645_length_784_cov_203.604380	5	85	58	4	80	0.0500000
NODE_12645_length_784_cov_203.604380	5	85	60	11	80	0.1375000
NODE_12645_length_784_cov_203.604380	5	85	64	15	80	0.1875000
NODE_12645_length_784_cov_203.604380	5	85	66	5	80	0.0625000
NODE_12645_length_784_cov_203.604380	5	85	70	9	80	0.1125000
NODE_12645_length_784_cov_203.604380	58	138	55	2	80	0.0250000
NODE_12645_length_784_cov_203.604380	58	138	59	3	80	0.0375000
NODE_12645_length_784_cov_203.604380	58	138	61	1	80	0.0125000
NODE_12645_length_784_cov_203.604380	58	138	63	8	80	0.1000000
NODE_12645_length_784_cov_203.604380	58	138	64	13	80	0.1625000
NODE_12645_length_784_cov_203.604380	58	138	65	6	80	0.0750000
NODE_12645_length_784_cov_203.604380	58	138	66	5	80	0.0625000
NODE_12645_length_784_cov_203.604380	58	138	67	1	80	0.0125000
NODE_12645_length_784_cov_203.604380	58	138	68	1	80	0.0125000
NODE_12645_length_784_cov_203.604380	58	138	69	4	80	0.0500000
NODE_12645_length_784_cov_203.604380	58	138	70	21	80	0.2625000
NODE_12645_length_784_cov_203.604380	58	138	71	11	80	0.1375000
NODE_12645_length_784_cov_203.604380	58	138	73	4	80	0.0500000
NODE_12646_length_784_cov_45.210219	49	129	0	80	80	1.0000000
NODE_12646_length_784_cov_45.210219	102	182	0	65	80	0.8125000
NODE_12646_length_784_cov_45.210219	102	182	1	15	80	0.1875000
NODE_12646_length_784_cov_45.210219	218	298	1	80	80	1.0000000
NODE_12646_length_784_cov_45.210219	271	351	0	34	80	0.4250000
NODE_12646_length_784_cov_45.210219	271	351	1	46	80	0.5750000
NODE_12646_length_784_cov_45.210219	347	427	0	80	80	1.0000000
NODE_12646_length_784_cov_45.210219	347	427	0	80	80	1.0000000
NODE_12646_length_784_cov_45.210219	347	427	0	80	80	1.0000000
NODE_12646_length_784_cov_45.210219	400	447	0	47	47	1.0000000
NODE_12646_length_784_cov_45.210219	400	480	0	80	80	1.0000000
NODE_12646_length_784_cov_45.210219	400	455	0	55	55	1.0000000
NODE_12647_length_784_cov_33.543066	405	485	0	80	80	1.0000000
NODE_12647_length_784_cov_33.543066	458	538	0	80	80	1.0000000
NODE_12648_length_784_cov_21.762044	318	398	0	80	80	1.0000000
NODE_12648_length_784_cov_21.762044	371	451	0	33	80	0.4125000
NODE_12648_length_784_cov_21.762044	371	451	2	15	80	0.1875000
NODE_12648_length_784_cov_21.762044	371	451	4	32	80	0.4000000
NODE_12649_length_784_cov_20.583942	286	366	2	11	80	0.1375000
NODE_12649_length_784_cov_20.583942	286	366	4	66	80	0.8250000
NODE_12649_length_784_cov_20.583942	286	366	6	3	80	0.0375000
NODE_12649_length_784_cov_20.583942	339	419	0	2	80	0.0250000
NODE_12649_length_784_cov_20.583942	339	419	2	62	80	0.7750000
NODE_12649_length_784_cov_20.583942	339	419	4	16	80	0.2000000
NODE_12649_length_784_cov_20.583942	415	495	0	78	80	0.9750000
NODE_12649_length_784_cov_20.583942	415	495	2	2	80	0.0250000
NODE_12649_length_784_cov_20.583942	468	548	0	45	80	0.5625000
NODE_12649_length_784_cov_20.583942	468	548	2	35	80	0.4375000
NODE_12650_length_784_cov_19.448175	217	297	0	80	80	1.0000000
NODE_12650_length_784_cov_19.448175	270	350	0	80	80	1.0000000
NODE_12652_length_784_cov_12.480292	297	377	0	80	80	1.0000000
NODE_12652_length_784_cov_12.480292	350	430	0	80	80	1.0000000
NODE_12653_length_784_cov_9.296350	250	330	0	80	80	1.0000000
NODE_12653_length_784_cov_9.296350	303	383	0	80	80	1.0000000
NODE_12653_length_784_cov_9.296350	379	459	0	53	80	0.6625000
NODE_12653_length_784_cov_9.296350	379	459	2	27	80	0.3375000
NODE_12653_length_784_cov_9.296350	432	512	2	80	80	1.0000000
NODE_12654_length_784_cov_6.316788	274	354	0	80	80	1.0000000
NODE_12654_length_784_cov_6.316788	327	407	0	80	80	1.0000000
NODE_12688_length_783_cov_41.849415	459	539	4	31	80	0.3875000
NODE_12688_length_783_cov_41.849415	459	539	6	41	80	0.5125000
NODE_12688_length_783_cov_41.849415	459	539	8	8	80	0.1000000
NODE_12688_length_783_cov_41.849415	512	592	0	9	80	0.1125000
NODE_12688_length_783_cov_41.849415	512	592	2	2	80	0.0250000
NODE_12688_length_783_cov_41.849415	512	592	4	69	80	0.8625000
NODE_12689_length_783_cov_39.881579	230	310	0	80	80	1.0000000
NODE_12689_length_783_cov_39.881579	283	363	0	80	80	1.0000000
NODE_12689_length_783_cov_39.881579	359	439	0	55	80	0.6875000
NODE_12689_length_783_cov_39.881579	359	439	2	25	80	0.3125000
NODE_12689_length_783_cov_39.881579	412	492	0	2	80	0.0250000
NODE_12689_length_783_cov_39.881579	412	492	2	78	80	0.9750000
NODE_12690_length_783_cov_35.967836	229	309	0	80	80	1.0000000
NODE_12690_length_783_cov_35.967836	282	362	0	80	80	1.0000000
NODE_12691_length_783_cov_28.203216	292	372	0	80	80	1.0000000
NODE_12691_length_783_cov_28.203216	345	425	0	80	80	1.0000000
NODE_12692_length_783_cov_16.695906	393	473	0	80	80	1.0000000
NODE_12692_length_783_cov_16.695906	446	526	0	80	80	1.0000000
NODE_12693_length_783_cov_15.656433	418	498	0	38	80	0.4750000
NODE_12693_length_783_cov_15.656433	418	498	2	42	80	0.5250000
NODE_12693_length_783_cov_15.656433	471	551	0	26	80	0.3250000
NODE_12693_length_783_cov_15.656433	471	551	2	54	80	0.6750000
NODE_12694_length_783_cov_14.904971	321	401	0	40	80	0.5000000
NODE_12694_length_783_cov_14.904971	321	401	2	40	80	0.5000000
NODE_12694_length_783_cov_14.904971	374	454	2	80	80	1.0000000
NODE_12728_length_782_cov_22.461201	347	427	0	12	80	0.1500000
NODE_12728_length_782_cov_22.461201	347	427	2	68	80	0.8500000
NODE_12728_length_782_cov_22.461201	400	480	0	65	80	0.8125000
NODE_12728_length_782_cov_22.461201	400	480	2	15	80	0.1875000
NODE_12729_length_782_cov_19.163982	306	386	0	80	80	1.0000000
NODE_12729_length_782_cov_19.163982	382	462	0	10	80	0.1250000
NODE_12729_length_782_cov_19.163982	382	462	2	70	80	0.8750000
NODE_12729_length_782_cov_19.163982	435	515	2	71	80	0.8875000
NODE_12729_length_782_cov_19.163982	435	515	4	9	80	0.1125000
NODE_12730_length_782_cov_19.090776	295	375	0	80	80	1.0000000
NODE_12730_length_782_cov_19.090776	348	428	0	80	80	1.0000000
NODE_12731_length_782_cov_13.509517	323	403	0	80	80	1.0000000
NODE_12731_length_782_cov_13.509517	376	456	0	80	80	1.0000000
NODE_12732_length_782_cov_11.364568	367	447	0	80	80	1.0000000
NODE_12732_length_782_cov_11.364568	420	500	0	63	80	0.7875000
NODE_12732_length_782_cov_11.364568	420	500	2	17	80	0.2125000
NODE_12735_length_782_cov_7.976574	245	325	0	80	80	1.0000000
NODE_12735_length_782_cov_7.976574	298	378	0	80	80	1.0000000
NODE_12737_length_782_cov_5.500732	384	464	0	80	80	1.0000000
NODE_12737_length_782_cov_5.500732	437	517	0	80	80	1.0000000
NODE_12739_length_782_cov_4.434846	309	389	0	55	80	0.6875000
NODE_12739_length_782_cov_4.434846	309	389	2	25	80	0.3125000
NODE_12739_length_782_cov_4.434846	362	442	0	2	80	0.0250000
NODE_12739_length_782_cov_4.434846	362	442	2	78	80	0.9750000
NODE_12740_length_782_cov_3.352855	177	196	0	19	19	1.0000000
NODE_12741_length_782_cov_3.231332	160	240	0	80	80	1.0000000
NODE_12741_length_782_cov_3.231332	213	298	0	85	85	1.0000000
NODE_12765_length_781_cov_34.247801	174	254	0	6	80	0.0750000
NODE_12765_length_781_cov_34.247801	174	254	4	74	80	0.9250000
NODE_12765_length_781_cov_34.247801	227	307	0	21	80	0.2625000
NODE_12765_length_781_cov_34.247801	227	307	4	59	80	0.7375000
NODE_12766_length_781_cov_27.530792	490	570	6	8	80	0.1000000
NODE_12766_length_781_cov_27.530792	490	570	9	24	80	0.3000000
NODE_12766_length_781_cov_27.530792	490	570	11	48	80	0.6000000
NODE_12766_length_781_cov_27.530792	543	623	0	43	80	0.5375000
NODE_12766_length_781_cov_27.530792	543	623	2	3	80	0.0375000
NODE_12766_length_781_cov_27.530792	543	623	6	15	80	0.1875000
NODE_12766_length_781_cov_27.530792	543	623	9	10	80	0.1250000
NODE_12766_length_781_cov_27.530792	543	623	11	9	80	0.1125000
NODE_12766_length_781_cov_27.530792	619	699	0	80	80	1.0000000
NODE_12766_length_781_cov_27.530792	672	752	0	80	80	1.0000000
NODE_12767_length_781_cov_22.768328	427	507	0	80	80	1.0000000
NODE_12767_length_781_cov_22.768328	480	560	0	80	80	1.0000000
NODE_12768_length_781_cov_17.894428	411	491	0	23	80	0.2875000
NODE_12768_length_781_cov_17.894428	411	491	3	2	80	0.0250000
NODE_12768_length_781_cov_17.894428	411	491	4	55	80	0.6875000
NODE_12768_length_781_cov_17.894428	464	544	0	76	80	0.9500000
NODE_12768_length_781_cov_17.894428	464	544	3	2	80	0.0250000
NODE_12768_length_781_cov_17.894428	464	544	4	2	80	0.0250000
NODE_12769_length_781_cov_14.922287	486	565	0	2	79	0.0253165
NODE_12769_length_781_cov_14.922287	486	565	2	77	79	0.9746835
NODE_12769_length_781_cov_14.922287	538	618	0	23	80	0.2875000
NODE_12769_length_781_cov_14.922287	538	618	2	57	80	0.7125000
NODE_12770_length_781_cov_12.529326	318	398	0	80	80	1.0000000
NODE_12770_length_781_cov_12.529326	371	451	0	80	80	1.0000000
NODE_12771_length_781_cov_10.303519	444	524	6	4	80	0.0500000
NODE_12771_length_781_cov_10.303519	444	524	8	40	80	0.5000000
NODE_12771_length_781_cov_10.303519	444	524	10	36	80	0.4500000
NODE_12772_length_781_cov_9.851906	374	454	0	80	80	1.0000000
NODE_12772_length_781_cov_9.851906	427	507	0	80	80	1.0000000
NODE_12775_length_781_cov_8.557185	113	194	0	56	81	0.6913580
NODE_12775_length_781_cov_8.557185	113	194	4	25	81	0.3086420
NODE_12775_length_781_cov_8.557185	166	239	0	3	73	0.0410959
NODE_12775_length_781_cov_8.557185	166	239	2	15	73	0.2054795
NODE_12775_length_781_cov_8.557185	166	239	4	55	73	0.7534246
NODE_12778_length_781_cov_4.734604	30	110	0	49	80	0.6125000
NODE_12778_length_781_cov_4.734604	30	110	2	31	80	0.3875000
NODE_12778_length_781_cov_4.734604	83	163	0	23	80	0.2875000
NODE_12778_length_781_cov_4.734604	83	163	2	57	80	0.7125000
NODE_12780_length_781_cov_4.077713	269	349	0	80	80	1.0000000
NODE_12780_length_781_cov_4.077713	322	402	0	80	80	1.0000000
NODE_12812_length_780_cov_37.693098	165	245	0	80	80	1.0000000
NODE_12812_length_780_cov_37.693098	218	298	0	65	80	0.8125000
NODE_12812_length_780_cov_37.693098	218	298	2	15	80	0.1875000
NODE_12813_length_780_cov_22.132159	407	487	0	4	80	0.0500000
NODE_12813_length_780_cov_22.132159	407	487	3	1	80	0.0125000
NODE_12813_length_780_cov_22.132159	407	487	4	75	80	0.9375000
NODE_12813_length_780_cov_22.132159	460	540	0	29	80	0.3625000
NODE_12813_length_780_cov_22.132159	460	540	2	28	80	0.3500000
NODE_12813_length_780_cov_22.132159	460	540	3	1	80	0.0125000
NODE_12813_length_780_cov_22.132159	460	540	4	22	80	0.2750000
NODE_12814_length_780_cov_21.831131	299	379	0	8	80	0.1000000
NODE_12814_length_780_cov_21.831131	299	379	4	72	80	0.9000000
NODE_12814_length_780_cov_21.831131	352	432	0	22	80	0.2750000
NODE_12814_length_780_cov_21.831131	352	432	3	1	80	0.0125000
NODE_12814_length_780_cov_21.831131	352	432	4	57	80	0.7125000
NODE_12815_length_780_cov_16.722467	165	245	0	80	80	1.0000000
NODE_12815_length_780_cov_16.722467	218	298	0	80	80	1.0000000
NODE_12816_length_780_cov_13.189427	150	254	0	104	104	1.0000000
NODE_12816_length_780_cov_13.189427	227	307	0	80	80	1.0000000
NODE_12817_length_780_cov_12.910426	276	356	0	14	80	0.1750000
NODE_12817_length_780_cov_12.910426	276	356	2	66	80	0.8250000
NODE_12817_length_780_cov_12.910426	329	409	0	36	80	0.4500000
NODE_12817_length_780_cov_12.910426	329	409	2	44	80	0.5500000
NODE_12818_length_780_cov_8.455213	141	221	0	63	80	0.7875000
NODE_12818_length_780_cov_8.455213	141	221	2	17	80	0.2125000
NODE_12818_length_780_cov_8.455213	194	274	0	11	80	0.1375000
NODE_12818_length_780_cov_8.455213	194	274	2	69	80	0.8625000
NODE_12848_length_779_cov_51.022059	8	43	0	35	35	1.0000000
NODE_12848_length_779_cov_51.022059	53	96	0	43	43	1.0000000
NODE_12848_length_779_cov_51.022059	97	177	0	80	80	1.0000000
NODE_12848_length_779_cov_51.022059	150	230	0	80	80	1.0000000
NODE_12849_length_779_cov_23.682353	362	442	1	36	80	0.4500000
NODE_12849_length_779_cov_23.682353	362	442	2	44	80	0.5500000
NODE_12849_length_779_cov_23.682353	415	495	2	80	80	1.0000000
NODE_12850_length_779_cov_15.994118	320	400	2	80	80	1.0000000
NODE_12850_length_779_cov_15.994118	373	453	0	48	80	0.6000000
NODE_12850_length_779_cov_15.994118	373	453	2	32	80	0.4000000
NODE_12851_length_779_cov_14.386765	258	320	2	19	62	0.3064516
NODE_12851_length_779_cov_14.386765	258	320	4	13	62	0.2096774
NODE_12851_length_779_cov_14.386765	258	320	6	8	62	0.1290323
NODE_12851_length_779_cov_14.386765	258	320	8	21	62	0.3387097
NODE_12851_length_779_cov_14.386765	258	320	10	1	62	0.0161290
NODE_12851_length_779_cov_14.386765	293	368	6	5	75	0.0666667
NODE_12851_length_779_cov_14.386765	293	368	8	29	75	0.3866667
NODE_12851_length_779_cov_14.386765	293	368	10	41	75	0.5466667
NODE_12851_length_779_cov_14.386765	369	443	0	1	74	0.0135135
NODE_12851_length_779_cov_14.386765	369	443	2	5	74	0.0675676
NODE_12851_length_779_cov_14.386765	369	443	4	28	74	0.3783784
NODE_12851_length_779_cov_14.386765	369	443	6	26	74	0.3513514
NODE_12851_length_779_cov_14.386765	369	443	8	9	74	0.1216216
NODE_12851_length_779_cov_14.386765	369	443	10	5	74	0.0675676
NODE_12852_length_779_cov_11.861765	180	263	0	75	83	0.9036145
NODE_12852_length_779_cov_11.861765	180	263	4	8	83	0.0963855
NODE_12852_length_779_cov_11.861765	236	316	0	19	80	0.2375000
NODE_12852_length_779_cov_11.861765	236	316	4	61	80	0.7625000
NODE_12852_length_779_cov_11.861765	312	392	0	52	80	0.6500000
NODE_12852_length_779_cov_11.861765	312	392	2	1	80	0.0125000
NODE_12852_length_779_cov_11.861765	312	392	3	7	80	0.0875000
NODE_12852_length_779_cov_11.861765	312	392	4	20	80	0.2500000
NODE_12852_length_779_cov_11.861765	365	445	0	80	80	1.0000000
NODE_12853_length_779_cov_11.735294	285	365	0	80	80	1.0000000
NODE_12853_length_779_cov_11.735294	338	418	0	80	80	1.0000000
NODE_12854_length_779_cov_7.211765	333	413	0	80	80	1.0000000
NODE_12854_length_779_cov_7.211765	386	466	0	80	80	1.0000000
NODE_12857_length_779_cov_5.611765	271	351	0	79	80	0.9875000
NODE_12857_length_779_cov_5.611765	271	351	2	1	80	0.0125000
NODE_12857_length_779_cov_5.611765	324	404	0	80	80	1.0000000
NODE_12859_length_779_cov_4.695588	216	296	0	80	80	1.0000000
NODE_12859_length_779_cov_4.695588	269	349	0	80	80	1.0000000
NODE_12863_length_779_cov_2.329412	615	672	4	24	57	0.4210526
NODE_12863_length_779_cov_2.329412	615	672	6	10	57	0.1754386
NODE_12863_length_779_cov_2.329412	615	672	8	14	57	0.2456140
NODE_12863_length_779_cov_2.329412	615	672	10	9	57	0.1578947
NODE_12883_length_778_cov_21.615611	325	405	0	47	80	0.5875000
NODE_12883_length_778_cov_21.615611	325	405	2	33	80	0.4125000
NODE_12883_length_778_cov_21.615611	378	458	2	80	80	1.0000000
NODE_12884_length_778_cov_19.549337	348	428	0	80	80	1.0000000
NODE_12884_length_778_cov_19.549337	401	481	0	80	80	1.0000000
NODE_12885_length_778_cov_15.403535	312	392	0	80	80	1.0000000
NODE_12885_length_778_cov_15.403535	365	445	0	80	80	1.0000000
NODE_12886_length_778_cov_14.614138	101	181	0	80	80	1.0000000
NODE_12886_length_778_cov_14.614138	154	234	0	80	80	1.0000000
NODE_12887_length_778_cov_13.368189	256	336	0	80	80	1.0000000
NODE_12887_length_778_cov_13.368189	309	389	0	80	80	1.0000000
NODE_12891_length_778_cov_6.307806	349	429	0	80	80	1.0000000
NODE_12891_length_778_cov_6.307806	402	482	0	80	80	1.0000000
NODE_12893_length_778_cov_5.985272	385	465	0	80	80	1.0000000
NODE_12893_length_778_cov_5.985272	438	518	0	80	80	1.0000000
NODE_12928_length_777_cov_25.504425	323	403	0	9	80	0.1125000
NODE_12928_length_777_cov_25.504425	323	403	2	71	80	0.8875000
NODE_12928_length_777_cov_25.504425	376	456	0	49	80	0.6125000
NODE_12928_length_777_cov_25.504425	376	456	2	31	80	0.3875000
NODE_12929_length_777_cov_25.410029	346	426	2	19	80	0.2375000
NODE_12929_length_777_cov_25.410029	346	426	4	61	80	0.7625000
NODE_12929_length_777_cov_25.410029	399	479	0	44	80	0.5500000
NODE_12929_length_777_cov_25.410029	399	479	2	28	80	0.3500000
NODE_12929_length_777_cov_25.410029	399	479	4	8	80	0.1000000
NODE_12930_length_777_cov_25.333333	97	177	0	80	80	1.0000000
NODE_12930_length_777_cov_25.333333	150	230	0	80	80	1.0000000
NODE_12931_length_777_cov_21.600295	408	485	0	36	77	0.4675325
NODE_12931_length_777_cov_21.600295	408	485	2	41	77	0.5324675
NODE_12931_length_777_cov_21.600295	458	538	0	10	80	0.1250000
NODE_12931_length_777_cov_21.600295	458	538	2	70	80	0.8750000
NODE_12932_length_777_cov_19.561947	343	423	2	2	80	0.0250000
NODE_12932_length_777_cov_19.561947	343	423	8	78	80	0.9750000
NODE_12932_length_777_cov_19.561947	396	476	0	27	80	0.3375000
NODE_12932_length_777_cov_19.561947	396	476	6	12	80	0.1500000
NODE_12932_length_777_cov_19.561947	396	476	8	41	80	0.5125000
NODE_12933_length_777_cov_16.961652	264	344	0	42	80	0.5250000
NODE_12933_length_777_cov_16.961652	264	344	2	38	80	0.4750000
NODE_12933_length_777_cov_16.961652	317	397	2	80	80	1.0000000
NODE_12934_length_777_cov_16.081121	299	379	0	24	80	0.3000000
NODE_12934_length_777_cov_16.081121	299	379	2	5	80	0.0625000
NODE_12934_length_777_cov_16.081121	299	379	4	21	80	0.2625000
NODE_12934_length_777_cov_16.081121	299	379	5	26	80	0.3250000
NODE_12934_length_777_cov_16.081121	299	379	6	4	80	0.0500000
NODE_12934_length_777_cov_16.081121	352	432	3	1	80	0.0125000
NODE_12934_length_777_cov_16.081121	352	432	4	1	80	0.0125000
NODE_12934_length_777_cov_16.081121	352	432	5	27	80	0.3375000
NODE_12934_length_777_cov_16.081121	352	432	6	51	80	0.6375000
NODE_12935_length_777_cov_13.827434	380	460	0	14	80	0.1750000
NODE_12935_length_777_cov_13.827434	380	460	2	5	80	0.0625000
NODE_12935_length_777_cov_13.827434	380	460	4	61	80	0.7625000
NODE_12935_length_777_cov_13.827434	433	513	0	67	80	0.8375000
NODE_12935_length_777_cov_13.827434	433	513	2	5	80	0.0625000
NODE_12935_length_777_cov_13.827434	433	513	4	8	80	0.1000000
NODE_12936_length_777_cov_12.497050	413	493	0	80	80	1.0000000
NODE_12936_length_777_cov_12.497050	466	546	0	80	80	1.0000000
NODE_12937_length_777_cov_10.787611	213	286	0	12	73	0.1643836
NODE_12937_length_777_cov_10.787611	213	286	2	61	73	0.8356164
NODE_12938_length_777_cov_8.530973	362	422	2	60	60	1.0000000
NODE_12939_length_777_cov_7.634218	79	159	2	80	80	1.0000000
NODE_12939_length_777_cov_7.634218	132	212	0	21	80	0.2625000
NODE_12939_length_777_cov_7.634218	132	212	2	59	80	0.7375000
NODE_12940_length_777_cov_6.963127	256	336	0	80	80	1.0000000
NODE_12940_length_777_cov_6.963127	309	389	0	80	80	1.0000000
NODE_12941_length_777_cov_6.417404	565	638	0	73	73	1.0000000
NODE_12942_length_777_cov_5.868732	443	523	0	28	80	0.3500000
NODE_12942_length_777_cov_5.868732	443	523	2	52	80	0.6500000
NODE_12942_length_777_cov_5.868732	496	576	0	80	80	1.0000000
NODE_12971_length_776_cov_81.002954	237	317	0	67	80	0.8375000
NODE_12971_length_776_cov_81.002954	237	317	2	3	80	0.0375000
NODE_12971_length_776_cov_81.002954	237	317	4	1	80	0.0125000
NODE_12971_length_776_cov_81.002954	237	317	6	3	80	0.0375000
NODE_12971_length_776_cov_81.002954	237	317	10	4	80	0.0500000
NODE_12971_length_776_cov_81.002954	237	317	16	2	80	0.0250000
NODE_12971_length_776_cov_81.002954	290	370	0	80	80	1.0000000
NODE_12972_length_776_cov_40.502216	345	425	3	70	80	0.8750000
NODE_12972_length_776_cov_40.502216	345	425	4	10	80	0.1250000
NODE_12972_length_776_cov_40.502216	398	478	0	24	80	0.3000000
NODE_12972_length_776_cov_40.502216	398	478	3	46	80	0.5750000
NODE_12972_length_776_cov_40.502216	398	478	4	10	80	0.1250000
NODE_12973_length_776_cov_34.921713	204	284	0	3	80	0.0375000
NODE_12973_length_776_cov_34.921713	204	284	2	77	80	0.9625000
NODE_12973_length_776_cov_34.921713	257	337	0	56	80	0.7000000
NODE_12973_length_776_cov_34.921713	257	337	2	24	80	0.3000000
NODE_12974_length_776_cov_29.998523	177	257	2	6	80	0.0750000
NODE_12974_length_776_cov_29.998523	177	257	4	74	80	0.9250000
NODE_12974_length_776_cov_29.998523	230	310	0	27	80	0.3375000
NODE_12974_length_776_cov_29.998523	230	310	2	21	80	0.2625000
NODE_12974_length_776_cov_29.998523	230	310	4	32	80	0.4000000
NODE_12975_length_776_cov_25.683900	417	497	0	72	80	0.9000000
NODE_12975_length_776_cov_25.683900	417	497	4	8	80	0.1000000
NODE_12975_length_776_cov_25.683900	470	550	0	19	80	0.2375000
NODE_12975_length_776_cov_25.683900	470	550	4	61	80	0.7625000
NODE_12976_length_776_cov_22.276219	367	447	2	7	80	0.0875000
NODE_12976_length_776_cov_22.276219	367	447	6	39	80	0.4875000
NODE_12976_length_776_cov_22.276219	367	447	8	34	80	0.4250000
NODE_12976_length_776_cov_22.276219	420	500	6	16	80	0.2000000
NODE_12976_length_776_cov_22.276219	420	500	8	64	80	0.8000000
NODE_12977_length_776_cov_19.574594	242	322	2	79	80	0.9875000
NODE_12977_length_776_cov_19.574594	242	322	4	1	80	0.0125000
NODE_12977_length_776_cov_19.574594	295	375	2	80	80	1.0000000
NODE_12978_length_776_cov_18.262925	384	464	0	19	80	0.2375000
NODE_12978_length_776_cov_18.262925	384	464	2	61	80	0.7625000
NODE_12978_length_776_cov_18.262925	437	517	0	56	80	0.7000000
NODE_12978_length_776_cov_18.262925	437	517	2	24	80	0.3000000
NODE_12979_length_776_cov_16.023634	334	414	0	80	80	1.0000000
NODE_12979_length_776_cov_16.023634	387	467	0	80	80	1.0000000
NODE_12980_length_776_cov_15.841950	282	362	0	80	80	1.0000000
NODE_12980_length_776_cov_15.841950	335	415	0	80	80	1.0000000
NODE_12981_length_776_cov_14.131462	240	320	0	80	80	1.0000000
NODE_12981_length_776_cov_14.131462	293	373	0	80	80	1.0000000
NODE_12981_length_776_cov_14.131462	369	449	0	80	80	1.0000000
NODE_12981_length_776_cov_14.131462	422	502	0	80	80	1.0000000
NODE_12983_length_776_cov_13.890694	302	382	0	80	80	1.0000000
NODE_12983_length_776_cov_13.890694	355	435	0	80	80	1.0000000
NODE_12984_length_776_cov_12.097489	488	568	0	16	80	0.2000000
NODE_12984_length_776_cov_12.097489	488	568	2	9	80	0.1125000
NODE_12984_length_776_cov_12.097489	488	568	4	55	80	0.6875000
NODE_12984_length_776_cov_12.097489	541	621	0	69	80	0.8625000
NODE_12984_length_776_cov_12.097489	541	621	2	9	80	0.1125000
NODE_12984_length_776_cov_12.097489	541	621	4	2	80	0.0250000
NODE_12985_length_776_cov_11.923191	422	498	0	76	76	1.0000000
NODE_12985_length_776_cov_11.923191	475	551	0	76	76	1.0000000
NODE_12986_length_776_cov_11.163959	312	392	0	80	80	1.0000000
NODE_12986_length_776_cov_11.163959	365	445	0	80	80	1.0000000
NODE_12987_length_776_cov_9.754801	370	450	0	80	80	1.0000000
NODE_12987_length_776_cov_9.754801	423	503	0	80	80	1.0000000
NODE_12989_length_776_cov_8.271787	332	412	0	12	80	0.1500000
NODE_12989_length_776_cov_8.271787	332	412	2	68	80	0.8500000
NODE_12989_length_776_cov_8.271787	385	465	0	65	80	0.8125000
NODE_12989_length_776_cov_8.271787	385	465	2	15	80	0.1875000
NODE_12990_length_776_cov_4.874446	330	410	0	80	80	1.0000000
NODE_12990_length_776_cov_4.874446	383	463	0	80	80	1.0000000
NODE_13022_length_775_cov_33.612426	372	452	0	10	80	0.1250000
NODE_13022_length_775_cov_33.612426	372	452	4	7	80	0.0875000
NODE_13022_length_775_cov_33.612426	372	452	6	63	80	0.7875000
NODE_13022_length_775_cov_33.612426	425	505	0	21	80	0.2625000
NODE_13022_length_775_cov_33.612426	425	505	2	4	80	0.0500000
NODE_13022_length_775_cov_33.612426	425	505	4	13	80	0.1625000
NODE_13022_length_775_cov_33.612426	425	505	6	42	80	0.5250000
NODE_13023_length_775_cov_25.500000	361	434	0	15	73	0.2054795
NODE_13023_length_775_cov_25.500000	361	434	6	58	73	0.7945206
NODE_13023_length_775_cov_25.500000	413	487	0	28	74	0.3783784
NODE_13023_length_775_cov_25.500000	413	487	6	46	74	0.6216216
NODE_13024_length_775_cov_24.128698	220	300	0	18	80	0.2250000
NODE_13024_length_775_cov_24.128698	220	300	2	62	80	0.7750000
NODE_13024_length_775_cov_24.128698	273	353	0	22	80	0.2750000
NODE_13024_length_775_cov_24.128698	273	353	2	58	80	0.7250000
NODE_13026_length_775_cov_16.165680	358	438	2	22	80	0.2750000
NODE_13026_length_775_cov_16.165680	358	438	4	27	80	0.3375000
NODE_13026_length_775_cov_16.165680	358	438	6	31	80	0.3875000
NODE_13026_length_775_cov_16.165680	411	491	2	36	80	0.4500000
NODE_13026_length_775_cov_16.165680	411	491	4	21	80	0.2625000
NODE_13026_length_775_cov_16.165680	411	491	6	23	80	0.2875000
NODE_13027_length_775_cov_8.522189	440	520	2	20	80	0.2500000
NODE_13027_length_775_cov_8.522189	440	520	4	48	80	0.6000000
NODE_13027_length_775_cov_8.522189	440	520	6	12	80	0.1500000
NODE_13027_length_775_cov_8.522189	493	573	0	2	80	0.0250000
NODE_13027_length_775_cov_8.522189	493	573	2	5	80	0.0625000
NODE_13027_length_775_cov_8.522189	493	573	4	61	80	0.7625000
NODE_13027_length_775_cov_8.522189	493	573	6	12	80	0.1500000
NODE_13028_length_775_cov_8.258876	247	327	0	63	80	0.7875000
NODE_13028_length_775_cov_8.258876	247	327	2	17	80	0.2125000
NODE_13028_length_775_cov_8.258876	300	380	0	10	80	0.1250000
NODE_13028_length_775_cov_8.258876	300	380	2	70	80	0.8750000
NODE_13031_length_775_cov_3.786982	299	379	0	14	80	0.1750000
NODE_13031_length_775_cov_3.786982	299	379	2	66	80	0.8250000
NODE_13031_length_775_cov_3.786982	352	432	0	23	80	0.2875000
NODE_13031_length_775_cov_3.786982	352	432	2	57	80	0.7125000
NODE_13059_length_774_cov_27.386667	433	514	0	51	81	0.6296296
NODE_13059_length_774_cov_27.386667	433	514	2	30	81	0.3703704
NODE_13059_length_774_cov_27.386667	487	567	0	3	80	0.0375000
NODE_13059_length_774_cov_27.386667	487	567	2	77	80	0.9625000
NODE_13060_length_774_cov_19.721481	239	319	2	80	80	1.0000000
NODE_13060_length_774_cov_19.721481	292	372	0	51	80	0.6375000
NODE_13060_length_774_cov_19.721481	292	372	2	29	80	0.3625000
NODE_13063_length_774_cov_4.594074	216	294	0	30	78	0.3846154
NODE_13063_length_774_cov_4.594074	216	294	2	48	78	0.6153846
NODE_13063_length_774_cov_4.594074	269	347	0	29	78	0.3717949
NODE_13063_length_774_cov_4.594074	269	347	2	49	78	0.6282051
NODE_13063_length_774_cov_4.594074	405	485	6	79	80	0.9875000
NODE_13063_length_774_cov_4.594074	405	485	8	1	80	0.0125000
NODE_13103_length_773_cov_60.566766	249	328	0	79	79	1.0000000
NODE_13103_length_773_cov_60.566766	304	381	0	77	77	1.0000000
NODE_13104_length_773_cov_27.299703	230	310	2	80	80	1.0000000
NODE_13104_length_773_cov_27.299703	283	363	0	46	80	0.5750000
NODE_13104_length_773_cov_27.299703	283	363	2	34	80	0.4250000
NODE_13105_length_773_cov_24.250742	392	470	2	2	78	0.0256410
NODE_13105_length_773_cov_24.250742	392	470	4	13	78	0.1666667
NODE_13105_length_773_cov_24.250742	392	470	5	1	78	0.0128205
NODE_13105_length_773_cov_24.250742	392	470	6	62	78	0.7948718
NODE_13105_length_773_cov_24.250742	443	523	0	25	80	0.3125000
NODE_13105_length_773_cov_24.250742	443	523	2	13	80	0.1625000
NODE_13105_length_773_cov_24.250742	443	523	4	15	80	0.1875000
NODE_13105_length_773_cov_24.250742	443	523	6	27	80	0.3375000
NODE_13106_length_773_cov_20.683976	367	447	0	15	80	0.1875000
NODE_13106_length_773_cov_20.683976	367	447	2	33	80	0.4125000
NODE_13106_length_773_cov_20.683976	367	447	3	1	80	0.0125000
NODE_13106_length_773_cov_20.683976	367	447	4	31	80	0.3875000
NODE_13106_length_773_cov_20.683976	420	500	0	68	80	0.8500000
NODE_13106_length_773_cov_20.683976	420	500	2	12	80	0.1500000
NODE_13107_length_773_cov_18.498516	248	328	0	56	80	0.7000000
NODE_13107_length_773_cov_18.498516	248	328	2	24	80	0.3000000
NODE_13107_length_773_cov_18.498516	301	381	0	9	80	0.1125000
NODE_13107_length_773_cov_18.498516	301	381	2	71	80	0.8875000
NODE_13108_length_773_cov_14.063798	405	485	0	80	80	1.0000000
NODE_13108_length_773_cov_14.063798	458	538	0	80	80	1.0000000
NODE_13109_length_773_cov_12.482196	421	501	0	40	80	0.5000000
NODE_13109_length_773_cov_12.482196	421	501	2	40	80	0.5000000
NODE_13109_length_773_cov_12.482196	474	554	2	80	80	1.0000000
NODE_13114_length_773_cov_9.136499	214	294	0	3	80	0.0375000
NODE_13114_length_773_cov_9.136499	214	294	2	4	80	0.0500000
NODE_13114_length_773_cov_9.136499	214	294	4	5	80	0.0625000
NODE_13114_length_773_cov_9.136499	214	294	6	68	80	0.8500000
NODE_13114_length_773_cov_9.136499	267	347	0	56	80	0.7000000
NODE_13114_length_773_cov_9.136499	267	347	2	4	80	0.0500000
NODE_13114_length_773_cov_9.136499	267	347	6	20	80	0.2500000
NODE_13115_length_773_cov_8.609792	461	541	0	80	80	1.0000000
NODE_13115_length_773_cov_8.609792	514	594	0	80	80	1.0000000
NODE_13116_length_773_cov_7.224036	200	280	0	25	80	0.3125000
NODE_13116_length_773_cov_7.224036	200	280	2	55	80	0.6875000
NODE_13116_length_773_cov_7.224036	253	333	2	80	80	1.0000000
NODE_13117_length_773_cov_6.910979	522	615	0	56	93	0.6021506
NODE_13117_length_773_cov_6.910979	522	615	2	37	93	0.3978495
NODE_13117_length_773_cov_6.910979	588	668	0	38	80	0.4750000
NODE_13117_length_773_cov_6.910979	588	668	2	42	80	0.5250000
NODE_13147_length_772_cov_28.044577	231	311	0	41	80	0.5125000
NODE_13147_length_772_cov_28.044577	231	311	2	2	80	0.0250000
NODE_13147_length_772_cov_28.044577	231	311	4	9	80	0.1125000
NODE_13147_length_772_cov_28.044577	231	311	6	28	80	0.3500000
NODE_13147_length_772_cov_28.044577	284	364	6	80	80	1.0000000
NODE_13149_length_772_cov_9.523031	288	368	2	80	80	1.0000000
NODE_13149_length_772_cov_9.523031	341	421	0	11	80	0.1375000
NODE_13149_length_772_cov_9.523031	341	421	2	69	80	0.8625000
NODE_13150_length_772_cov_8.778603	133	213	0	80	80	1.0000000
NODE_13150_length_772_cov_8.778603	186	266	0	80	80	1.0000000
NODE_13151_length_772_cov_7.921248	351	431	0	80	80	1.0000000
NODE_13151_length_772_cov_7.921248	404	480	0	76	76	1.0000000
NODE_13152_length_772_cov_7.059435	276	356	0	30	80	0.3750000
NODE_13152_length_772_cov_7.059435	276	356	2	50	80	0.6250000
NODE_13152_length_772_cov_7.059435	329	409	0	26	80	0.3250000
NODE_13152_length_772_cov_7.059435	329	409	2	54	80	0.6750000
NODE_13153_length_772_cov_5.536404	269	299	0	30	30	1.0000000
NODE_13153_length_772_cov_5.536404	272	341	0	68	69	0.9855072
NODE_13153_length_772_cov_5.536404	272	341	2	1	69	0.0144928
NODE_13156_length_772_cov_4.838039	430	510	0	80	80	1.0000000
NODE_13156_length_772_cov_4.838039	483	563	0	80	80	1.0000000
NODE_13162_length_772_cov_3.041605	339	419	0	80	80	1.0000000
NODE_13162_length_772_cov_3.041605	392	472	0	80	80	1.0000000
NODE_13195_length_771_cov_36.729167	223	304	0	81	81	1.0000000
NODE_13195_length_771_cov_36.729167	277	357	0	80	80	1.0000000
NODE_13195_length_771_cov_36.729167	353	434	0	50	81	0.6172839
NODE_13195_length_771_cov_36.729167	353	434	2	31	81	0.3827161
NODE_13195_length_771_cov_36.729167	407	487	0	23	80	0.2875000
NODE_13195_length_771_cov_36.729167	407	487	2	57	80	0.7125000
NODE_13196_length_771_cov_28.903274	337	417	0	1	80	0.0125000
NODE_13196_length_771_cov_28.903274	337	417	2	17	80	0.2125000
NODE_13196_length_771_cov_28.903274	337	417	4	38	80	0.4750000
NODE_13196_length_771_cov_28.903274	337	417	6	24	80	0.3000000
NODE_13196_length_771_cov_28.903274	390	470	0	54	80	0.6750000
NODE_13196_length_771_cov_28.903274	390	470	2	17	80	0.2125000
NODE_13196_length_771_cov_28.903274	390	470	4	9	80	0.1125000
NODE_13197_length_771_cov_28.165179	453	533	0	80	80	1.0000000
NODE_13197_length_771_cov_28.165179	506	586	0	80	80	1.0000000
NODE_13198_length_771_cov_14.336310	259	339	16	66	80	0.8250000
NODE_13198_length_771_cov_14.336310	259	339	19	14	80	0.1750000
NODE_13198_length_771_cov_14.336310	312	392	0	16	80	0.2000000
NODE_13198_length_771_cov_14.336310	312	392	7	1	80	0.0125000
NODE_13198_length_771_cov_14.336310	312	392	8	1	80	0.0125000
NODE_13198_length_771_cov_14.336310	312	392	16	13	80	0.1625000
NODE_13198_length_771_cov_14.336310	312	392	17	24	80	0.3000000
NODE_13198_length_771_cov_14.336310	312	392	19	25	80	0.3125000
NODE_13199_length_771_cov_13.592262	428	508	0	7	80	0.0875000
NODE_13199_length_771_cov_13.592262	428	508	2	73	80	0.9125000
NODE_13199_length_771_cov_13.592262	481	561	0	31	80	0.3875000
NODE_13199_length_771_cov_13.592262	481	561	2	49	80	0.6125000
NODE_13200_length_771_cov_12.226190	407	487	2	5	80	0.0625000
NODE_13200_length_771_cov_12.226190	407	487	3	1	80	0.0125000
NODE_13200_length_771_cov_12.226190	407	487	4	13	80	0.1625000
NODE_13200_length_771_cov_12.226190	407	487	5	1	80	0.0125000
NODE_13200_length_771_cov_12.226190	407	487	6	60	80	0.7500000
NODE_13200_length_771_cov_12.226190	460	540	0	28	80	0.3500000
NODE_13200_length_771_cov_12.226190	460	540	2	25	80	0.3125000
NODE_13200_length_771_cov_12.226190	460	540	4	6	80	0.0750000
NODE_13200_length_771_cov_12.226190	460	540	5	1	80	0.0125000
NODE_13200_length_771_cov_12.226190	460	540	6	20	80	0.2500000
NODE_13201_length_771_cov_11.188988	348	428	0	10	80	0.1250000
NODE_13201_length_771_cov_11.188988	348	428	2	70	80	0.8750000
NODE_13201_length_771_cov_11.188988	401	481	0	63	80	0.7875000
NODE_13201_length_771_cov_11.188988	401	481	2	17	80	0.2125000
NODE_13202_length_771_cov_10.525298	171	251	0	33	80	0.4125000
NODE_13202_length_771_cov_10.525298	171	251	2	47	80	0.5875000
NODE_13202_length_771_cov_10.525298	224	304	0	26	80	0.3250000
NODE_13202_length_771_cov_10.525298	224	304	2	54	80	0.6750000
NODE_13207_length_771_cov_3.357143	238	318	0	78	80	0.9750000
NODE_13207_length_771_cov_3.357143	238	318	2	2	80	0.0250000
NODE_13207_length_771_cov_3.357143	291	371	0	28	80	0.3500000
NODE_13207_length_771_cov_3.357143	291	371	2	14	80	0.1750000
NODE_13207_length_771_cov_3.357143	291	371	4	5	80	0.0625000
NODE_13207_length_771_cov_3.357143	291	371	6	33	80	0.4125000
NODE_13209_length_771_cov_3.129464	476	518	0	42	42	1.0000000
NODE_13238_length_770_cov_45.312966	212	292	2	41	80	0.5125000
NODE_13238_length_770_cov_45.312966	212	292	4	39	80	0.4875000
NODE_13238_length_770_cov_45.312966	265	345	2	56	80	0.7000000
NODE_13238_length_770_cov_45.312966	265	345	4	24	80	0.3000000
NODE_13239_length_770_cov_23.153502	348	428	0	52	80	0.6500000
NODE_13239_length_770_cov_23.153502	348	428	2	28	80	0.3500000
NODE_13239_length_770_cov_23.153502	401	481	2	63	80	0.7875000
NODE_13239_length_770_cov_23.153502	401	481	4	13	80	0.1625000
NODE_13239_length_770_cov_23.153502	401	481	6	4	80	0.0500000
NODE_13240_length_770_cov_22.463487	340	420	0	12	80	0.1500000
NODE_13240_length_770_cov_22.463487	340	420	4	37	80	0.4625000
NODE_13240_length_770_cov_22.463487	340	420	5	1	80	0.0125000
NODE_13240_length_770_cov_22.463487	340	420	6	30	80	0.3750000
NODE_13240_length_770_cov_22.463487	393	473	6	80	80	1.0000000
NODE_13241_length_770_cov_18.594635	335	416	0	81	81	1.0000000
NODE_13241_length_770_cov_18.594635	389	469	0	80	80	1.0000000
NODE_13242_length_770_cov_18.092399	292	372	0	8	80	0.1000000
NODE_13242_length_770_cov_18.092399	292	372	2	24	80	0.3000000
NODE_13242_length_770_cov_18.092399	292	372	4	2	80	0.0250000
NODE_13242_length_770_cov_18.092399	292	372	6	20	80	0.2500000
NODE_13242_length_770_cov_18.092399	292	372	10	26	80	0.3250000
NODE_13242_length_770_cov_18.092399	345	425	6	20	80	0.2500000
NODE_13242_length_770_cov_18.092399	345	425	8	30	80	0.3750000
NODE_13242_length_770_cov_18.092399	345	425	10	30	80	0.3750000
NODE_13243_length_770_cov_7.064083	294	374	0	80	80	1.0000000
NODE_13243_length_770_cov_7.064083	347	426	0	79	79	1.0000000
NODE_13246_length_770_cov_5.184799	341	421	0	80	80	1.0000000
NODE_13246_length_770_cov_5.184799	394	474	0	80	80	1.0000000
NODE_13250_length_770_cov_4.120715	325	405	0	23	80	0.2875000
NODE_13250_length_770_cov_4.120715	325	405	2	57	80	0.7125000
NODE_13250_length_770_cov_4.120715	378	458	0	76	80	0.9500000
NODE_13250_length_770_cov_4.120715	378	458	2	4	80	0.0500000
NODE_13272_length_769_cov_11.008955	355	435	0	12	80	0.1500000
NODE_13272_length_769_cov_11.008955	355	435	2	12	80	0.1500000
NODE_13272_length_769_cov_11.008955	355	435	4	56	80	0.7000000
NODE_13272_length_769_cov_11.008955	408	488	0	38	80	0.4750000
NODE_13272_length_769_cov_11.008955	408	488	3	1	80	0.0125000
NODE_13272_length_769_cov_11.008955	408	488	4	41	80	0.5125000
NODE_13274_length_769_cov_9.077612	263	343	0	80	80	1.0000000
NODE_13274_length_769_cov_9.077612	316	396	0	66	80	0.8250000
NODE_13274_length_769_cov_9.077612	316	396	2	14	80	0.1750000
NODE_13275_length_769_cov_7.034328	289	367	0	78	78	1.0000000
NODE_13275_length_769_cov_7.034328	340	420	0	80	80	1.0000000
NODE_13307_length_769_cov_1.262687	620	668	0	33	48	0.6875000
NODE_13307_length_769_cov_1.262687	620	668	2	15	48	0.3125000
NODE_13316_length_768_cov_19.195815	266	346	0	80	80	1.0000000
NODE_13316_length_768_cov_19.195815	319	399	0	80	80	1.0000000
NODE_13316_length_768_cov_19.195815	395	475	0	80	80	1.0000000
NODE_13316_length_768_cov_19.195815	448	528	0	80	80	1.0000000
NODE_13317_length_768_cov_16.420030	246	326	0	80	80	1.0000000
NODE_13317_length_768_cov_16.420030	299	379	0	80	80	1.0000000
NODE_13318_length_768_cov_14.508221	309	389	0	80	80	1.0000000
NODE_13318_length_768_cov_14.508221	362	442	0	80	80	1.0000000
NODE_13319_length_768_cov_11.635277	309	389	0	24	80	0.3000000
NODE_13319_length_768_cov_11.635277	309	389	4	56	80	0.7000000
NODE_13319_length_768_cov_11.635277	362	442	0	30	80	0.3750000
NODE_13319_length_768_cov_11.635277	362	442	4	50	80	0.6250000
NODE_13321_length_768_cov_9.064275	392	472	0	9	80	0.1125000
NODE_13321_length_768_cov_9.064275	392	472	2	71	80	0.8875000
NODE_13321_length_768_cov_9.064275	445	525	0	57	80	0.7125000
NODE_13321_length_768_cov_9.064275	445	525	2	23	80	0.2875000
NODE_13324_length_768_cov_3.605381	512	592	0	80	80	1.0000000
NODE_13324_length_768_cov_3.605381	565	645	0	80	80	1.0000000
NODE_13354_length_767_cov_38.161677	28	108	8	7	80	0.0875000
NODE_13354_length_767_cov_38.161677	28	108	12	73	80	0.9125000
NODE_13354_length_767_cov_38.161677	254	334	0	80	80	1.0000000
NODE_13354_length_767_cov_38.161677	307	387	0	80	80	1.0000000
NODE_13355_length_767_cov_24.107784	279	359	2	49	80	0.6125000
NODE_13355_length_767_cov_24.107784	279	359	4	31	80	0.3875000
NODE_13355_length_767_cov_24.107784	332	412	0	4	80	0.0500000
NODE_13355_length_767_cov_24.107784	332	412	2	5	80	0.0625000
NODE_13355_length_767_cov_24.107784	332	412	4	71	80	0.8875000
NODE_13356_length_767_cov_22.823353	286	366	0	80	80	1.0000000
NODE_13356_length_767_cov_22.823353	339	419	0	80	80	1.0000000
NODE_13357_length_767_cov_20.898204	312	392	0	80	80	1.0000000
NODE_13357_length_767_cov_20.898204	365	445	0	80	80	1.0000000
NODE_13358_length_767_cov_20.058383	357	439	0	82	82	1.0000000
NODE_13358_length_767_cov_20.058383	410	490	0	80	80	1.0000000
NODE_13359_length_767_cov_20.020958	191	271	0	25	80	0.3125000
NODE_13359_length_767_cov_20.020958	191	271	2	55	80	0.6875000
NODE_13359_length_767_cov_20.020958	244	324	0	78	80	0.9750000
NODE_13359_length_767_cov_20.020958	244	324	2	2	80	0.0250000
NODE_13360_length_767_cov_18.687126	270	350	0	80	80	1.0000000
NODE_13360_length_767_cov_18.687126	323	403	0	80	80	1.0000000
NODE_13362_length_767_cov_13.323353	45	125	0	80	80	1.0000000
NODE_13362_length_767_cov_13.323353	98	178	0	80	80	1.0000000
NODE_13366_length_767_cov_8.787425	377	447	0	70	70	1.0000000
NODE_13366_length_767_cov_8.787425	420	500	0	80	80	1.0000000
NODE_13367_length_767_cov_7.206587	306	386	0	80	80	1.0000000
NODE_13367_length_767_cov_7.206587	359	440	0	81	81	1.0000000
NODE_13403_length_766_cov_59.388306	322	402	0	5	80	0.0625000
NODE_13403_length_766_cov_59.388306	322	402	2	7	80	0.0875000
NODE_13403_length_766_cov_59.388306	322	402	4	44	80	0.5500000
NODE_13403_length_766_cov_59.388306	322	402	6	24	80	0.3000000
NODE_13403_length_766_cov_59.388306	375	455	0	1	80	0.0125000
NODE_13403_length_766_cov_59.388306	375	455	4	79	80	0.9875000
NODE_13403_length_766_cov_59.388306	451	531	0	65	80	0.8125000
NODE_13403_length_766_cov_59.388306	451	531	4	15	80	0.1875000
NODE_13403_length_766_cov_59.388306	504	584	0	80	80	1.0000000
NODE_13404_length_766_cov_23.361319	308	388	0	36	80	0.4500000
NODE_13404_length_766_cov_23.361319	308	388	4	44	80	0.5500000
NODE_13404_length_766_cov_23.361319	361	441	2	17	80	0.2125000
NODE_13404_length_766_cov_23.361319	361	441	4	63	80	0.7875000
NODE_13405_length_766_cov_22.751124	229	309	0	30	80	0.3750000
NODE_13405_length_766_cov_22.751124	229	309	2	50	80	0.6250000
NODE_13405_length_766_cov_22.751124	282	362	2	73	80	0.9125000
NODE_13405_length_766_cov_22.751124	282	362	4	7	80	0.0875000
NODE_13406_length_766_cov_20.011994	285	363	0	78	78	1.0000000
NODE_13406_length_766_cov_20.011994	336	416	0	80	80	1.0000000
NODE_13407_length_766_cov_18.685157	288	368	0	11	80	0.1375000
NODE_13407_length_766_cov_18.685157	288	368	2	69	80	0.8625000
NODE_13407_length_766_cov_18.685157	341	421	0	52	80	0.6500000
NODE_13407_length_766_cov_18.685157	341	421	2	28	80	0.3500000
NODE_13408_length_766_cov_13.131934	271	351	0	80	80	1.0000000
NODE_13408_length_766_cov_13.131934	324	404	0	80	80	1.0000000
NODE_13410_length_766_cov_9.479760	274	354	0	27	80	0.3375000
NODE_13410_length_766_cov_9.479760	274	354	2	53	80	0.6625000
NODE_13410_length_766_cov_9.479760	327	407	0	80	80	1.0000000
NODE_13415_length_766_cov_4.500750	333	413	4	6	80	0.0750000
NODE_13415_length_766_cov_4.500750	333	413	5	1	80	0.0125000
NODE_13415_length_766_cov_4.500750	333	413	6	73	80	0.9125000
NODE_13415_length_766_cov_4.500750	369	404	6	35	35	1.0000000
NODE_13415_length_766_cov_4.500750	371	413	4	2	42	0.0476190
NODE_13415_length_766_cov_4.500750	371	413	6	40	42	0.9523810
NODE_13415_length_766_cov_4.500750	397	466	2	41	69	0.5942029
NODE_13415_length_766_cov_4.500750	397	466	4	14	69	0.2028985
NODE_13415_length_766_cov_4.500750	397	466	6	14	69	0.2028985
NODE_13447_length_765_cov_92.851351	16	96	6	2	80	0.0250000
NODE_13447_length_765_cov_92.851351	16	96	8	11	80	0.1375000
NODE_13447_length_765_cov_92.851351	16	96	12	2	80	0.0250000
NODE_13447_length_765_cov_92.851351	16	96	14	5	80	0.0625000
NODE_13447_length_765_cov_92.851351	16	96	16	1	80	0.0125000
NODE_13447_length_765_cov_92.851351	16	96	18	2	80	0.0250000
NODE_13447_length_765_cov_92.851351	16	96	20	3	80	0.0375000
NODE_13447_length_765_cov_92.851351	16	96	22	6	80	0.0750000
NODE_13447_length_765_cov_92.851351	16	96	24	9	80	0.1125000
NODE_13447_length_765_cov_92.851351	16	96	26	1	80	0.0125000
NODE_13447_length_765_cov_92.851351	16	96	28	6	80	0.0750000
NODE_13447_length_765_cov_92.851351	16	96	30	10	80	0.1250000
NODE_13447_length_765_cov_92.851351	16	96	32	2	80	0.0250000
NODE_13447_length_765_cov_92.851351	16	96	33	2	80	0.0250000
NODE_13447_length_765_cov_92.851351	16	96	35	9	80	0.1125000
NODE_13447_length_765_cov_92.851351	16	96	37	4	80	0.0500000
NODE_13447_length_765_cov_92.851351	16	96	39	2	80	0.0250000
NODE_13447_length_765_cov_92.851351	16	96	41	3	80	0.0375000
NODE_13448_length_765_cov_36.345345	504	584	0	80	80	1.0000000
NODE_13448_length_765_cov_36.345345	557	637	0	80	80	1.0000000
NODE_13449_length_765_cov_27.334835	370	450	0	80	80	1.0000000
NODE_13449_length_765_cov_27.334835	423	503	0	77	80	0.9625000
NODE_13449_length_765_cov_27.334835	423	503	1	1	80	0.0125000
NODE_13449_length_765_cov_27.334835	423	503	2	2	80	0.0250000
NODE_13450_length_765_cov_23.355856	251	331	0	80	80	1.0000000
NODE_13450_length_765_cov_23.355856	304	384	0	80	80	1.0000000
NODE_13450_length_765_cov_23.355856	380	460	0	34	80	0.4250000
NODE_13450_length_765_cov_23.355856	380	460	2	46	80	0.5750000
NODE_13450_length_765_cov_23.355856	433	506	2	73	73	1.0000000
NODE_13451_length_765_cov_23.322823	256	336	0	80	80	1.0000000
NODE_13451_length_765_cov_23.322823	309	389	0	80	80	1.0000000
NODE_13452_length_765_cov_21.741742	379	452	0	73	73	1.0000000
NODE_13452_length_765_cov_21.741742	425	505	0	80	80	1.0000000
NODE_13453_length_765_cov_14.253754	450	530	6	38	80	0.4750000
NODE_13453_length_765_cov_14.253754	450	530	8	42	80	0.5250000
NODE_13453_length_765_cov_14.253754	503	583	0	39	80	0.4875000
NODE_13453_length_765_cov_14.253754	503	583	6	41	80	0.5125000
NODE_13454_length_765_cov_13.627628	313	393	0	80	80	1.0000000
NODE_13454_length_765_cov_13.627628	366	446	0	80	80	1.0000000
NODE_13455_length_765_cov_5.561562	319	349	0	30	30	1.0000000
NODE_13458_length_765_cov_4.367868	433	513	0	80	80	1.0000000
NODE_13458_length_765_cov_4.367868	486	566	0	47	80	0.5875000
NODE_13458_length_765_cov_4.367868	486	566	2	33	80	0.4125000
NODE_13483_length_764_cov_30.096241	436	516	0	80	80	1.0000000
NODE_13483_length_764_cov_30.096241	489	569	0	80	80	1.0000000
NODE_13484_length_764_cov_29.218045	304	384	2	70	80	0.8750000
NODE_13484_length_764_cov_29.218045	304	384	4	10	80	0.1250000
NODE_13484_length_764_cov_29.218045	357	437	0	30	80	0.3750000
NODE_13484_length_764_cov_29.218045	357	437	2	50	80	0.6250000
NODE_13485_length_764_cov_25.951880	421	501	2	80	80	1.0000000
NODE_13485_length_764_cov_25.951880	474	554	0	11	80	0.1375000
NODE_13485_length_764_cov_25.951880	474	554	2	69	80	0.8625000
NODE_13486_length_764_cov_23.590977	204	284	0	25	80	0.3125000
NODE_13486_length_764_cov_23.590977	204	284	2	55	80	0.6875000
NODE_13486_length_764_cov_23.590977	257	337	0	6	80	0.0750000
NODE_13486_length_764_cov_23.590977	257	337	2	74	80	0.9250000
NODE_13488_length_764_cov_6.804511	281	361	0	80	80	1.0000000
NODE_13488_length_764_cov_6.804511	334	414	0	80	80	1.0000000
NODE_13489_length_764_cov_6.700752	392	458	0	8	66	0.1212121
NODE_13489_length_764_cov_6.700752	392	458	2	30	66	0.4545455
NODE_13489_length_764_cov_6.700752	392	458	4	28	66	0.4242424
NODE_13508_length_764_cov_1.171429	475	537	0	62	62	1.0000000
NODE_13520_length_763_cov_28.807229	311	391	0	45	80	0.5625000
NODE_13520_length_763_cov_28.807229	311	391	4	35	80	0.4375000
NODE_13520_length_763_cov_28.807229	364	444	0	11	80	0.1375000
NODE_13520_length_763_cov_28.807229	364	444	2	19	80	0.2375000
NODE_13520_length_763_cov_28.807229	364	444	4	50	80	0.6250000
NODE_13521_length_763_cov_25.299699	598	673	0	75	75	1.0000000
NODE_13521_length_763_cov_25.299699	598	678	0	80	80	1.0000000
NODE_13521_length_763_cov_25.299699	605	675	0	70	70	1.0000000
NODE_13521_length_763_cov_25.299699	607	678	0	71	71	1.0000000
NODE_13521_length_763_cov_25.299699	651	731	0	80	80	1.0000000
NODE_13521_length_763_cov_25.299699	651	731	0	80	80	1.0000000
NODE_13521_length_763_cov_25.299699	651	731	0	80	80	1.0000000
NODE_13521_length_763_cov_25.299699	651	731	0	80	80	1.0000000
NODE_13522_length_763_cov_12.887048	336	416	0	35	80	0.4375000
NODE_13522_length_763_cov_12.887048	336	416	2	45	80	0.5625000
NODE_13522_length_763_cov_12.887048	389	469	0	80	80	1.0000000
NODE_13523_length_763_cov_11.599398	547	627	0	80	80	1.0000000
NODE_13523_length_763_cov_11.599398	600	680	0	80	80	1.0000000
NODE_13524_length_763_cov_9.378012	297	377	0	80	80	1.0000000
NODE_13524_length_763_cov_9.378012	350	430	0	80	80	1.0000000
NODE_13526_length_763_cov_7.246988	368	448	0	80	80	1.0000000
NODE_13526_length_763_cov_7.246988	421	501	0	80	80	1.0000000
NODE_13527_length_763_cov_6.414157	371	451	0	45	80	0.5625000
NODE_13527_length_763_cov_6.414157	371	451	2	35	80	0.4375000
NODE_13527_length_763_cov_6.414157	424	504	2	80	80	1.0000000
NODE_13558_length_762_cov_21.236802	368	448	0	34	80	0.4250000
NODE_13558_length_762_cov_21.236802	368	448	2	46	80	0.5750000
NODE_13558_length_762_cov_21.236802	421	501	0	16	80	0.2000000
NODE_13558_length_762_cov_21.236802	421	501	2	64	80	0.8000000
NODE_13559_length_762_cov_19.984917	327	407	0	38	80	0.4750000
NODE_13559_length_762_cov_19.984917	327	407	2	42	80	0.5250000
NODE_13559_length_762_cov_19.984917	380	460	0	51	80	0.6375000
NODE_13559_length_762_cov_19.984917	380	460	2	29	80	0.3625000
NODE_13560_length_762_cov_15.975867	318	398	0	80	80	1.0000000
NODE_13560_length_762_cov_15.975867	371	439	0	68	68	1.0000000
NODE_13561_length_762_cov_12.728507	381	461	0	1	80	0.0125000
NODE_13561_length_762_cov_12.728507	381	461	2	10	80	0.1250000
NODE_13561_length_762_cov_12.728507	381	461	3	1	80	0.0125000
NODE_13561_length_762_cov_12.728507	381	461	4	4	80	0.0500000
NODE_13561_length_762_cov_12.728507	381	461	5	3	80	0.0375000
NODE_13561_length_762_cov_12.728507	381	461	6	61	80	0.7625000
NODE_13561_length_762_cov_12.728507	434	514	4	28	80	0.3500000
NODE_13561_length_762_cov_12.728507	434	514	6	52	80	0.6500000
NODE_13562_length_762_cov_10.078431	277	357	0	80	80	1.0000000
NODE_13562_length_762_cov_10.078431	330	410	0	80	80	1.0000000
NODE_13563_length_762_cov_9.705882	339	419	0	80	80	1.0000000
NODE_13563_length_762_cov_9.705882	392	472	0	80	80	1.0000000
NODE_13564_length_762_cov_7.276018	316	395	0	79	79	1.0000000
NODE_13564_length_762_cov_7.276018	368	448	0	80	80	1.0000000
NODE_13565_length_762_cov_6.168929	222	302	0	16	80	0.2000000
NODE_13565_length_762_cov_6.168929	222	302	2	64	80	0.8000000
NODE_13565_length_762_cov_6.168929	275	355	0	35	80	0.4375000
NODE_13565_length_762_cov_6.168929	275	355	2	45	80	0.5625000
NODE_13613_length_761_cov_44.243202	531	582	6	11	51	0.2156863
NODE_13613_length_761_cov_44.243202	531	582	8	40	51	0.7843137
NODE_13614_length_761_cov_38.809668	342	422	7	4	80	0.0500000
NODE_13614_length_761_cov_38.809668	342	422	9	64	80	0.8000000
NODE_13614_length_761_cov_38.809668	342	422	10	8	80	0.1000000
NODE_13614_length_761_cov_38.809668	342	422	11	4	80	0.0500000
NODE_13614_length_761_cov_38.809668	395	475	0	31	80	0.3875000
NODE_13614_length_761_cov_38.809668	395	475	2	4	80	0.0500000
NODE_13614_length_761_cov_38.809668	395	475	4	11	80	0.1375000
NODE_13614_length_761_cov_38.809668	395	475	7	3	80	0.0375000
NODE_13614_length_761_cov_38.809668	395	475	9	31	80	0.3875000
NODE_13615_length_761_cov_38.694864	314	394	0	18	80	0.2250000
NODE_13615_length_761_cov_38.694864	314	394	2	62	80	0.7750000
NODE_13615_length_761_cov_38.694864	367	447	0	71	80	0.8875000
NODE_13615_length_761_cov_38.694864	367	447	2	9	80	0.1125000
NODE_13616_length_761_cov_32.382175	432	512	4	7	80	0.0875000
NODE_13616_length_761_cov_32.382175	432	512	6	14	80	0.1750000
NODE_13616_length_761_cov_32.382175	432	512	8	59	80	0.7375000
NODE_13616_length_761_cov_32.382175	485	565	0	24	80	0.3000000
NODE_13616_length_761_cov_32.382175	485	565	4	22	80	0.2750000
NODE_13616_length_761_cov_32.382175	485	565	6	16	80	0.2000000
NODE_13616_length_761_cov_32.382175	485	565	8	18	80	0.2250000
NODE_13617_length_761_cov_31.444109	323	403	0	3	80	0.0375000
NODE_13617_length_761_cov_31.444109	323	403	2	67	80	0.8375000
NODE_13617_length_761_cov_31.444109	323	403	4	10	80	0.1250000
NODE_13617_length_761_cov_31.444109	376	467	2	74	91	0.8131868
NODE_13617_length_761_cov_31.444109	376	467	4	17	91	0.1868132
NODE_13618_length_761_cov_14.004532	366	446	0	5	80	0.0625000
NODE_13618_length_761_cov_14.004532	366	446	2	46	80	0.5750000
NODE_13618_length_761_cov_14.004532	366	446	4	29	80	0.3625000
NODE_13618_length_761_cov_14.004532	419	499	0	14	80	0.1750000
NODE_13618_length_761_cov_14.004532	419	499	2	31	80	0.3875000
NODE_13618_length_761_cov_14.004532	419	499	4	35	80	0.4375000
NODE_13619_length_761_cov_13.287009	336	415	0	79	79	1.0000000
NODE_13619_length_761_cov_13.287009	388	468	0	80	80	1.0000000
NODE_13621_length_761_cov_9.654079	274	354	0	80	80	1.0000000
NODE_13621_length_761_cov_9.654079	327	407	0	80	80	1.0000000
NODE_13622_length_761_cov_7.306647	308	388	0	42	80	0.5250000
NODE_13622_length_761_cov_7.306647	308	388	1	38	80	0.4750000
NODE_13622_length_761_cov_7.306647	361	441	1	80	80	1.0000000
NODE_13625_length_761_cov_4.314199	354	434	0	4	80	0.0500000
NODE_13625_length_761_cov_4.314199	354	434	2	76	80	0.9500000
NODE_13625_length_761_cov_4.314199	407	487	0	25	80	0.3125000
NODE_13625_length_761_cov_4.314199	407	487	2	55	80	0.6875000
NODE_13658_length_760_cov_48.290469	215	295	6	49	80	0.6125000
NODE_13658_length_760_cov_48.290469	215	295	8	31	80	0.3875000
NODE_13658_length_760_cov_48.290469	268	348	0	17	80	0.2125000
NODE_13658_length_760_cov_48.290469	268	348	2	17	80	0.2125000
NODE_13658_length_760_cov_48.290469	268	348	4	10	80	0.1250000
NODE_13658_length_760_cov_48.290469	268	348	6	25	80	0.3125000
NODE_13658_length_760_cov_48.290469	268	348	8	11	80	0.1375000
NODE_13658_length_760_cov_48.290469	344	424	0	55	80	0.6875000
NODE_13658_length_760_cov_48.290469	344	424	2	25	80	0.3125000
NODE_13658_length_760_cov_48.290469	397	477	0	9	80	0.1125000
NODE_13658_length_760_cov_48.290469	397	477	2	71	80	0.8875000
NODE_13659_length_760_cov_28.314675	384	464	2	80	80	1.0000000
NODE_13659_length_760_cov_28.314675	437	517	0	45	80	0.5625000
NODE_13659_length_760_cov_28.314675	437	517	2	35	80	0.4375000
NODE_13660_length_760_cov_27.981846	432	512	0	80	80	1.0000000
NODE_13660_length_760_cov_27.981846	485	565	0	80	80	1.0000000
NODE_13661_length_760_cov_17.500756	372	452	0	67	80	0.8375000
NODE_13661_length_760_cov_17.500756	372	452	2	13	80	0.1625000
NODE_13661_length_760_cov_17.500756	425	505	0	80	80	1.0000000
NODE_13662_length_760_cov_17.420575	183	263	0	12	80	0.1500000
NODE_13662_length_760_cov_17.420575	183	263	1	1	80	0.0125000
NODE_13662_length_760_cov_17.420575	183	263	2	42	80	0.5250000
NODE_13662_length_760_cov_17.420575	183	263	4	25	80	0.3125000
NODE_13662_length_760_cov_17.420575	236	316	2	15	80	0.1875000
NODE_13662_length_760_cov_17.420575	236	316	4	65	80	0.8125000
NODE_13663_length_760_cov_13.444781	357	437	0	60	80	0.7500000
NODE_13663_length_760_cov_13.444781	357	437	2	20	80	0.2500000
NODE_13663_length_760_cov_13.444781	410	490	0	7	80	0.0875000
NODE_13663_length_760_cov_13.444781	410	490	2	73	80	0.9125000
NODE_13664_length_760_cov_13.196672	282	362	0	80	80	1.0000000
NODE_13664_length_760_cov_13.196672	335	415	0	80	80	1.0000000
NODE_13665_length_760_cov_12.692890	295	375	2	73	80	0.9125000
NODE_13665_length_760_cov_12.692890	295	375	3	7	80	0.0875000
NODE_13665_length_760_cov_12.692890	348	428	2	20	80	0.2500000
NODE_13665_length_760_cov_12.692890	348	428	3	17	80	0.2125000
NODE_13665_length_760_cov_12.692890	348	428	4	43	80	0.5375000
NODE_13671_length_760_cov_4.282905	388	468	0	40	80	0.5000000
NODE_13671_length_760_cov_4.282905	388	468	2	2	80	0.0250000
NODE_13671_length_760_cov_4.282905	388	468	4	38	80	0.4750000
NODE_13671_length_760_cov_4.282905	441	521	4	80	80	1.0000000
NODE_13671_length_760_cov_4.282905	517	597	0	50	80	0.6250000
NODE_13671_length_760_cov_4.282905	517	597	2	26	80	0.3250000
NODE_13671_length_760_cov_4.282905	517	597	4	4	80	0.0500000
NODE_13683_length_760_cov_1.990923	490	570	0	63	80	0.7875000
NODE_13683_length_760_cov_1.990923	490	570	2	17	80	0.2125000
NODE_13683_length_760_cov_1.990923	543	623	0	10	80	0.1250000
NODE_13683_length_760_cov_1.990923	543	623	2	68	80	0.8500000
NODE_13683_length_760_cov_1.990923	543	623	4	2	80	0.0250000
NODE_13709_length_759_cov_24.757576	376	456	2	41	80	0.5125000
NODE_13709_length_759_cov_24.757576	376	456	4	39	80	0.4875000
NODE_13709_length_759_cov_24.757576	429	509	0	51	80	0.6375000
NODE_13709_length_759_cov_24.757576	429	509	2	29	80	0.3625000
NODE_13710_length_759_cov_14.356061	210	290	0	80	80	1.0000000
NODE_13710_length_759_cov_14.356061	263	343	0	80	80	1.0000000
NODE_13711_length_759_cov_10.956061	328	408	0	19	80	0.2375000
NODE_13711_length_759_cov_10.956061	328	408	2	15	80	0.1875000
NODE_13711_length_759_cov_10.956061	328	408	4	9	80	0.1125000
NODE_13711_length_759_cov_10.956061	328	408	5	5	80	0.0625000
NODE_13711_length_759_cov_10.956061	328	408	6	5	80	0.0625000
NODE_13711_length_759_cov_10.956061	328	408	7	4	80	0.0500000
NODE_13711_length_759_cov_10.956061	328	408	8	23	80	0.2875000
NODE_13711_length_759_cov_10.956061	381	461	0	19	80	0.2375000
NODE_13711_length_759_cov_10.956061	381	461	4	61	80	0.7625000
NODE_13712_length_759_cov_10.639394	330	410	0	16	80	0.2000000
NODE_13712_length_759_cov_10.639394	330	410	2	64	80	0.8000000
NODE_13712_length_759_cov_10.639394	383	463	2	80	80	1.0000000
NODE_13713_length_759_cov_9.192424	209	290	16	5	81	0.0617284
NODE_13713_length_759_cov_9.192424	209	290	18	3	81	0.0370370
NODE_13713_length_759_cov_9.192424	209	290	22	2	81	0.0246914
NODE_13713_length_759_cov_9.192424	209	290	28	6	81	0.0740741
NODE_13713_length_759_cov_9.192424	209	290	30	3	81	0.0370370
NODE_13713_length_759_cov_9.192424	209	290	38	6	81	0.0740741
NODE_13713_length_759_cov_9.192424	209	290	39	6	81	0.0740741
NODE_13713_length_759_cov_9.192424	209	290	40	5	81	0.0617284
NODE_13713_length_759_cov_9.192424	209	290	41	2	81	0.0246914
NODE_13713_length_759_cov_9.192424	209	290	42	8	81	0.0987654
NODE_13713_length_759_cov_9.192424	209	290	43	1	81	0.0123457
NODE_13713_length_759_cov_9.192424	209	290	44	7	81	0.0864198
NODE_13713_length_759_cov_9.192424	209	290	46	8	81	0.0987654
NODE_13713_length_759_cov_9.192424	209	290	47	1	81	0.0123457
NODE_13713_length_759_cov_9.192424	209	290	48	7	81	0.0864198
NODE_13713_length_759_cov_9.192424	209	290	50	9	81	0.1111111
NODE_13713_length_759_cov_9.192424	209	290	52	1	81	0.0123457
NODE_13713_length_759_cov_9.192424	209	290	54	1	81	0.0123457
NODE_13713_length_759_cov_9.192424	262	310	6	2	48	0.0416667
NODE_13713_length_759_cov_9.192424	262	310	10	1	48	0.0208333
NODE_13713_length_759_cov_9.192424	262	310	12	6	48	0.1250000
NODE_13713_length_759_cov_9.192424	262	310	14	7	48	0.1458333
NODE_13713_length_759_cov_9.192424	262	310	16	9	48	0.1875000
NODE_13713_length_759_cov_9.192424	262	310	18	3	48	0.0625000
NODE_13713_length_759_cov_9.192424	262	310	22	2	48	0.0416667
NODE_13713_length_759_cov_9.192424	262	310	28	6	48	0.1250000
NODE_13713_length_759_cov_9.192424	262	310	30	3	48	0.0625000
NODE_13713_length_759_cov_9.192424	262	310	38	6	48	0.1250000
NODE_13713_length_759_cov_9.192424	262	310	39	3	48	0.0625000
NODE_13714_length_759_cov_8.771212	292	372	0	40	80	0.5000000
NODE_13714_length_759_cov_8.771212	292	372	2	40	80	0.5000000
NODE_13714_length_759_cov_8.771212	345	425	0	5	80	0.0625000
NODE_13714_length_759_cov_8.771212	345	425	2	75	80	0.9375000
NODE_13715_length_759_cov_8.650000	324	404	0	80	80	1.0000000
NODE_13715_length_759_cov_8.650000	377	457	0	80	80	1.0000000
NODE_13716_length_759_cov_8.268182	604	684	0	80	80	1.0000000
NODE_13716_length_759_cov_8.268182	657	737	0	80	80	1.0000000
NODE_13717_length_759_cov_6.833333	381	461	0	80	80	1.0000000
NODE_13717_length_759_cov_6.833333	434	515	0	81	81	1.0000000
NODE_13718_length_759_cov_6.407576	319	399	0	80	80	1.0000000
NODE_13718_length_759_cov_6.407576	372	452	0	80	80	1.0000000
NODE_13725_length_759_cov_3.400000	355	435	0	80	80	1.0000000
NODE_13725_length_759_cov_3.400000	408	488	0	80	80	1.0000000
NODE_13726_length_759_cov_3.346970	240	322	0	15	82	0.1829268
NODE_13726_length_759_cov_3.346970	240	322	2	67	82	0.8170732
NODE_13760_length_758_cov_38.414264	215	295	0	14	80	0.1750000
NODE_13760_length_758_cov_38.414264	215	295	2	66	80	0.8250000
NODE_13760_length_758_cov_38.414264	268	348	0	30	80	0.3750000
NODE_13760_length_758_cov_38.414264	268	348	2	50	80	0.6250000
NODE_13760_length_758_cov_38.414264	344	424	0	80	80	1.0000000
NODE_13760_length_758_cov_38.414264	397	477	0	80	80	1.0000000
NODE_13761_length_758_cov_36.722307	331	411	0	43	80	0.5375000
NODE_13761_length_758_cov_36.722307	331	411	2	37	80	0.4625000
NODE_13761_length_758_cov_36.722307	384	464	0	16	80	0.2000000
NODE_13761_length_758_cov_36.722307	384	464	2	64	80	0.8000000
NODE_13762_length_758_cov_29.910470	235	315	4	16	80	0.2000000
NODE_13762_length_758_cov_29.910470	235	315	6	64	80	0.8000000
NODE_13762_length_758_cov_29.910470	288	368	0	37	80	0.4625000
NODE_13762_length_758_cov_29.910470	288	368	2	10	80	0.1250000
NODE_13762_length_758_cov_29.910470	288	368	4	14	80	0.1750000
NODE_13762_length_758_cov_29.910470	288	368	6	19	80	0.2375000
NODE_13763_length_758_cov_16.226100	386	466	0	20	80	0.2500000
NODE_13763_length_758_cov_16.226100	386	466	4	60	80	0.7500000
NODE_13763_length_758_cov_16.226100	439	519	2	27	80	0.3375000
NODE_13763_length_758_cov_16.226100	439	519	4	30	80	0.3750000
NODE_13763_length_758_cov_16.226100	439	519	5	18	80	0.2250000
NODE_13763_length_758_cov_16.226100	439	519	6	5	80	0.0625000
NODE_13764_length_758_cov_16.097117	311	391	0	80	80	1.0000000
NODE_13764_length_758_cov_16.097117	364	444	0	80	80	1.0000000
NODE_13765_length_758_cov_15.525038	260	340	0	9	80	0.1125000
NODE_13765_length_758_cov_15.525038	260	340	2	12	80	0.1500000
NODE_13765_length_758_cov_15.525038	260	340	4	59	80	0.7375000
NODE_13765_length_758_cov_15.525038	313	393	0	15	80	0.1875000
NODE_13765_length_758_cov_15.525038	313	393	2	14	80	0.1750000
NODE_13765_length_758_cov_15.525038	313	393	4	51	80	0.6375000
NODE_13768_length_758_cov_9.153263	224	299	0	8	75	0.1066667
NODE_13768_length_758_cov_9.153263	224	299	2	67	75	0.8933333
NODE_13771_length_758_cov_4.241275	508	588	0	80	80	1.0000000
NODE_13772_length_758_cov_3.902883	346	426	0	80	80	1.0000000
NODE_13772_length_758_cov_3.902883	399	479	0	80	80	1.0000000
NODE_13794_length_757_cov_49.057751	155	235	0	27	80	0.3375000
NODE_13794_length_757_cov_49.057751	155	235	2	53	80	0.6625000
NODE_13794_length_757_cov_49.057751	208	288	0	26	80	0.3250000
NODE_13794_length_757_cov_49.057751	208	288	2	54	80	0.6750000
NODE_13795_length_757_cov_29.954407	181	262	0	81	81	1.0000000
NODE_13795_length_757_cov_29.954407	235	315	0	80	80	1.0000000
NODE_13795_length_757_cov_29.954407	311	391	0	80	80	1.0000000
NODE_13795_length_757_cov_29.954407	364	444	0	80	80	1.0000000
NODE_13796_length_757_cov_25.565350	352	432	0	80	80	1.0000000
NODE_13796_length_757_cov_25.565350	405	483	0	78	78	1.0000000
NODE_13797_length_757_cov_18.338906	264	344	0	80	80	1.0000000
NODE_13797_length_757_cov_18.338906	317	397	0	80	80	1.0000000
NODE_13798_length_757_cov_15.879939	58	138	2	65	80	0.8125000
NODE_13798_length_757_cov_15.879939	58	138	4	15	80	0.1875000
NODE_13798_length_757_cov_15.879939	111	191	2	41	80	0.5125000
NODE_13798_length_757_cov_15.879939	111	191	4	39	80	0.4875000
NODE_13800_length_757_cov_15.291793	314	394	4	9	80	0.1125000
NODE_13800_length_757_cov_15.291793	314	394	5	24	80	0.3000000
NODE_13800_length_757_cov_15.291793	314	394	6	26	80	0.3250000
NODE_13800_length_757_cov_15.291793	314	394	7	21	80	0.2625000
NODE_13800_length_757_cov_15.291793	367	447	2	12	80	0.1500000
NODE_13800_length_757_cov_15.291793	367	447	4	50	80	0.6250000
NODE_13800_length_757_cov_15.291793	367	447	6	14	80	0.1750000
NODE_13800_length_757_cov_15.291793	367	447	7	4	80	0.0500000
NODE_13807_length_757_cov_3.182371	423	503	0	74	80	0.9250000
NODE_13807_length_757_cov_3.182371	423	503	2	6	80	0.0750000
NODE_13807_length_757_cov_3.182371	476	556	0	80	80	1.0000000
NODE_13832_length_756_cov_26.441400	287	367	2	80	80	1.0000000
NODE_13832_length_756_cov_26.441400	340	420	0	50	80	0.6250000
NODE_13832_length_756_cov_26.441400	340	420	2	30	80	0.3750000
NODE_13834_length_756_cov_13.097412	154	234	0	53	80	0.6625000
NODE_13834_length_756_cov_13.097412	154	234	2	2	80	0.0250000
NODE_13834_length_756_cov_13.097412	154	234	4	25	80	0.3125000
NODE_13834_length_756_cov_13.097412	207	287	2	2	80	0.0250000
NODE_13834_length_756_cov_13.097412	207	287	4	78	80	0.9750000
NODE_13835_length_756_cov_12.732116	377	457	2	34	80	0.4250000
NODE_13835_length_756_cov_12.732116	377	457	4	46	80	0.5750000
NODE_13836_length_756_cov_9.254186	241	321	2	80	80	1.0000000
NODE_13836_length_756_cov_9.254186	294	374	0	15	80	0.1875000
NODE_13836_length_756_cov_9.254186	294	374	2	32	80	0.4000000
NODE_13836_length_756_cov_9.254186	294	374	3	31	80	0.3875000
NODE_13836_length_756_cov_9.254186	294	374	4	2	80	0.0250000
NODE_13837_length_756_cov_8.304414	363	409	0	46	46	1.0000000
NODE_13838_length_756_cov_8.105023	271	351	2	8	80	0.1000000
NODE_13838_length_756_cov_8.105023	271	351	4	18	80	0.2250000
NODE_13838_length_756_cov_8.105023	271	351	6	54	80	0.6750000
NODE_13838_length_756_cov_8.105023	324	404	0	40	80	0.5000000
NODE_13838_length_756_cov_8.105023	324	404	2	21	80	0.2625000
NODE_13838_length_756_cov_8.105023	324	404	4	6	80	0.0750000
NODE_13838_length_756_cov_8.105023	324	404	6	13	80	0.1625000
NODE_13840_length_756_cov_6.622527	431	511	6	80	80	1.0000000
NODE_13840_length_756_cov_6.622527	484	565	0	11	81	0.1358025
NODE_13840_length_756_cov_6.622527	484	565	4	40	81	0.4938272
NODE_13840_length_756_cov_6.622527	484	565	6	30	81	0.3703704
NODE_13888_length_755_cov_64.705793	303	383	0	74	80	0.9250000
NODE_13888_length_755_cov_64.705793	303	383	2	6	80	0.0750000
NODE_13888_length_755_cov_64.705793	356	436	0	21	80	0.2625000
NODE_13888_length_755_cov_64.705793	356	436	2	59	80	0.7375000
NODE_13889_length_755_cov_58.214939	425	505	0	80	80	1.0000000
NODE_13889_length_755_cov_58.214939	425	505	0	80	80	1.0000000
NODE_13889_length_755_cov_58.214939	478	556	0	40	78	0.5128205
NODE_13889_length_755_cov_58.214939	478	556	4	38	78	0.4871795
NODE_13889_length_755_cov_58.214939	478	556	0	40	78	0.5128205
NODE_13889_length_755_cov_58.214939	478	556	4	38	78	0.4871795
NODE_13890_length_755_cov_25.945122	237	317	0	36	80	0.4500000
NODE_13890_length_755_cov_25.945122	237	317	2	2	80	0.0250000
NODE_13890_length_755_cov_25.945122	237	317	6	42	80	0.5250000
NODE_13890_length_755_cov_25.945122	290	370	0	6	80	0.0750000
NODE_13890_length_755_cov_25.945122	290	370	2	6	80	0.0750000
NODE_13890_length_755_cov_25.945122	290	370	6	68	80	0.8500000
NODE_13891_length_755_cov_24.263720	334	414	0	10	80	0.1250000
NODE_13891_length_755_cov_24.263720	334	414	2	70	80	0.8750000
NODE_13891_length_755_cov_24.263720	387	467	0	63	80	0.7875000
NODE_13891_length_755_cov_24.263720	387	467	2	17	80	0.2125000
NODE_13892_length_755_cov_15.559451	306	386	0	53	80	0.6625000
NODE_13892_length_755_cov_15.559451	306	386	2	27	80	0.3375000
NODE_13892_length_755_cov_15.559451	359	439	0	14	80	0.1750000
NODE_13892_length_755_cov_15.559451	359	439	2	66	80	0.8250000
NODE_13894_length_755_cov_10.196646	332	412	0	80	80	1.0000000
NODE_13894_length_755_cov_10.196646	385	465	0	80	80	1.0000000
NODE_13895_length_755_cov_9.772866	210	290	0	80	80	1.0000000
NODE_13895_length_755_cov_9.772866	263	343	0	66	80	0.8250000
NODE_13895_length_755_cov_9.772866	263	343	2	14	80	0.1750000
NODE_13936_length_754_cov_87.432061	208	288	0	41	80	0.5125000
NODE_13936_length_754_cov_87.432061	208	288	2	39	80	0.4875000
NODE_13936_length_754_cov_87.432061	261	341	0	6	80	0.0750000
NODE_13936_length_754_cov_87.432061	261	341	2	74	80	0.9250000
NODE_13937_length_754_cov_16.549618	156	236	0	80	80	1.0000000
NODE_13937_length_754_cov_16.549618	209	289	0	80	80	1.0000000
NODE_13939_length_754_cov_9.068702	316	396	0	80	80	1.0000000
NODE_13939_length_754_cov_9.068702	369	449	0	80	80	1.0000000
NODE_13940_length_754_cov_5.925191	287	367	2	5	80	0.0625000
NODE_13940_length_754_cov_5.925191	287	367	6	75	80	0.9375000
NODE_13940_length_754_cov_5.925191	340	420	0	53	80	0.6625000
NODE_13940_length_754_cov_5.925191	340	420	2	5	80	0.0625000
NODE_13940_length_754_cov_5.925191	340	420	6	22	80	0.2750000
NODE_13974_length_753_cov_10.434251	386	466	0	80	80	1.0000000
NODE_13974_length_753_cov_10.434251	439	519	0	80	80	1.0000000
NODE_13976_length_753_cov_7.056575	344	424	0	80	80	1.0000000
NODE_13976_length_753_cov_7.056575	397	477	0	80	80	1.0000000
NODE_13977_length_753_cov_4.597859	321	401	0	80	80	1.0000000
NODE_13977_length_753_cov_4.597859	374	454	0	80	80	1.0000000
NODE_14003_length_752_cov_66.281776	617	697	6	4	80	0.0500000
NODE_14003_length_752_cov_66.281776	617	697	8	6	80	0.0750000
NODE_14003_length_752_cov_66.281776	617	697	10	2	80	0.0250000
NODE_14003_length_752_cov_66.281776	617	697	12	3	80	0.0375000
NODE_14003_length_752_cov_66.281776	617	697	14	16	80	0.2000000
NODE_14003_length_752_cov_66.281776	617	697	16	42	80	0.5250000
NODE_14003_length_752_cov_66.281776	617	697	18	7	80	0.0875000
NODE_14003_length_752_cov_66.281776	670	751	0	16	81	0.1975309
NODE_14003_length_752_cov_66.281776	670	751	2	35	81	0.4320988
NODE_14003_length_752_cov_66.281776	670	751	4	1	81	0.0123457
NODE_14003_length_752_cov_66.281776	670	751	6	6	81	0.0740741
NODE_14003_length_752_cov_66.281776	670	751	8	6	81	0.0740741
NODE_14003_length_752_cov_66.281776	670	751	10	2	81	0.0246914
NODE_14003_length_752_cov_66.281776	670	751	12	3	81	0.0370370
NODE_14003_length_752_cov_66.281776	670	751	14	4	81	0.0493827
NODE_14003_length_752_cov_66.281776	670	751	16	8	81	0.0987654
NODE_14004_length_752_cov_60.274119	193	273	0	8	80	0.1000000
NODE_14004_length_752_cov_60.274119	193	273	2	17	80	0.2125000
NODE_14004_length_752_cov_60.274119	193	273	4	7	80	0.0875000
NODE_14004_length_752_cov_60.274119	193	273	12	9	80	0.1125000
NODE_14004_length_752_cov_60.274119	193	273	13	26	80	0.3250000
NODE_14004_length_752_cov_60.274119	193	273	14	13	80	0.1625000
NODE_14004_length_752_cov_60.274119	246	326	10	18	80	0.2250000
NODE_14004_length_752_cov_60.274119	246	326	11	30	80	0.3750000
NODE_14004_length_752_cov_60.274119	246	326	13	31	80	0.3875000
NODE_14004_length_752_cov_60.274119	246	326	14	1	80	0.0125000
NODE_14005_length_752_cov_19.811639	299	379	2	52	80	0.6500000
NODE_14005_length_752_cov_19.811639	299	379	4	28	80	0.3500000
NODE_14005_length_752_cov_19.811639	352	432	0	35	80	0.4375000
NODE_14005_length_752_cov_19.811639	352	432	2	43	80	0.5375000
NODE_14005_length_752_cov_19.811639	352	432	4	2	80	0.0250000
NODE_14006_length_752_cov_17.661562	118	198	0	42	80	0.5250000
NODE_14006_length_752_cov_17.661562	118	198	1	38	80	0.4750000
NODE_14006_length_752_cov_17.661562	171	251	1	69	80	0.8625000
NODE_14006_length_752_cov_17.661562	171	251	2	11	80	0.1375000
NODE_14007_length_752_cov_13.275651	241	321	0	17	80	0.2125000
NODE_14007_length_752_cov_13.275651	241	321	2	21	80	0.2625000
NODE_14007_length_752_cov_13.275651	241	321	3	1	80	0.0125000
NODE_14007_length_752_cov_13.275651	241	321	4	41	80	0.5125000
NODE_14007_length_752_cov_13.275651	294	374	4	34	80	0.4250000
NODE_14007_length_752_cov_13.275651	294	374	6	46	80	0.5750000
NODE_14008_length_752_cov_10.928025	313	393	12	48	80	0.6000000
NODE_14008_length_752_cov_10.928025	313	393	16	18	80	0.2250000
NODE_14008_length_752_cov_10.928025	313	393	17	1	80	0.0125000
NODE_14008_length_752_cov_10.928025	313	393	18	13	80	0.1625000
NODE_14011_length_752_cov_9.558959	249	329	0	80	80	1.0000000
NODE_14011_length_752_cov_9.558959	302	382	0	80	80	1.0000000
NODE_14014_length_752_cov_8.281776	237	317	0	80	80	1.0000000
NODE_14014_length_752_cov_8.281776	290	370	0	80	80	1.0000000
NODE_14015_length_752_cov_8.082695	352	432	0	34	80	0.4250000
NODE_14015_length_752_cov_8.082695	352	432	2	46	80	0.5750000
NODE_14015_length_752_cov_8.082695	405	485	0	2	80	0.0250000
NODE_14015_length_752_cov_8.082695	405	485	2	78	80	0.9750000
NODE_14044_length_751_cov_20.730061	238	318	0	24	80	0.3000000
NODE_14044_length_751_cov_20.730061	238	318	2	13	80	0.1625000
NODE_14044_length_751_cov_20.730061	238	318	4	17	80	0.2125000
NODE_14044_length_751_cov_20.730061	238	318	6	26	80	0.3250000
NODE_14044_length_751_cov_20.730061	291	371	4	20	80	0.2500000
NODE_14044_length_751_cov_20.730061	291	371	6	60	80	0.7500000
NODE_14045_length_751_cov_18.478528	328	409	0	19	81	0.2345679
NODE_14045_length_751_cov_18.478528	328	409	2	62	81	0.7654321
NODE_14045_length_751_cov_18.478528	382	462	0	29	80	0.3625000
NODE_14045_length_751_cov_18.478528	382	462	2	51	80	0.6375000
NODE_14046_length_751_cov_13.016871	172	252	0	80	80	1.0000000
NODE_14046_length_751_cov_13.016871	225	305	0	80	80	1.0000000
NODE_14047_length_751_cov_12.363497	397	477	0	80	80	1.0000000
NODE_14047_length_751_cov_12.363497	450	530	0	80	80	1.0000000
NODE_14085_length_750_cov_46.371736	396	476	2	10	80	0.1250000
NODE_14085_length_750_cov_46.371736	396	476	4	6	80	0.0750000
NODE_14085_length_750_cov_46.371736	396	476	6	64	80	0.8000000
NODE_14085_length_750_cov_46.371736	449	529	0	45	80	0.5625000
NODE_14085_length_750_cov_46.371736	449	529	2	18	80	0.2250000
NODE_14085_length_750_cov_46.371736	449	529	6	17	80	0.2125000
NODE_14086_length_750_cov_24.428571	524	604	14	1	80	0.0125000
NODE_14086_length_750_cov_24.428571	524	604	18	3	80	0.0375000
NODE_14086_length_750_cov_24.428571	524	604	22	1	80	0.0125000
NODE_14086_length_750_cov_24.428571	524	604	24	2	80	0.0250000
NODE_14086_length_750_cov_24.428571	524	604	31	10	80	0.1250000
NODE_14086_length_750_cov_24.428571	524	604	33	3	80	0.0375000
NODE_14086_length_750_cov_24.428571	524	604	37	10	80	0.1250000
NODE_14086_length_750_cov_24.428571	524	604	39	18	80	0.2250000
NODE_14086_length_750_cov_24.428571	524	604	41	10	80	0.1250000
NODE_14086_length_750_cov_24.428571	524	604	42	13	80	0.1625000
NODE_14086_length_750_cov_24.428571	524	604	46	8	80	0.1000000
NODE_14086_length_750_cov_24.428571	524	604	47	1	80	0.0125000
NODE_14086_length_750_cov_24.428571	683	746	0	63	63	1.0000000
NODE_14087_length_750_cov_24.311828	325	405	0	22	80	0.2750000
NODE_14087_length_750_cov_24.311828	325	405	2	37	80	0.4625000
NODE_14087_length_750_cov_24.311828	325	405	4	21	80	0.2625000
NODE_14087_length_750_cov_24.311828	378	458	0	75	80	0.9375000
NODE_14087_length_750_cov_24.311828	378	458	2	5	80	0.0625000
NODE_14089_length_750_cov_8.529954	336	416	0	80	80	1.0000000
NODE_14089_length_750_cov_8.529954	395	469	0	74	74	1.0000000
NODE_14137_length_749_cov_18.986154	221	301	0	80	80	1.0000000
NODE_14137_length_749_cov_18.986154	274	354	0	80	80	1.0000000
NODE_14138_length_749_cov_18.836923	273	355	0	51	82	0.6219512
NODE_14138_length_749_cov_18.836923	273	355	2	31	82	0.3780488
NODE_14138_length_749_cov_18.836923	328	408	2	80	80	1.0000000
NODE_14138_length_749_cov_18.836923	404	484	0	43	80	0.5375000
NODE_14138_length_749_cov_18.836923	404	484	2	37	80	0.4625000
NODE_14138_length_749_cov_18.836923	457	535	0	78	78	1.0000000
NODE_14139_length_749_cov_16.160000	232	253	10	2	21	0.0952381
NODE_14139_length_749_cov_16.160000	232	253	16	19	21	0.9047619
NODE_14139_length_749_cov_16.160000	232	306	10	2	74	0.0270270
NODE_14139_length_749_cov_16.160000	232	306	16	72	74	0.9729730
NODE_14140_length_749_cov_16.115385	307	387	0	80	80	1.0000000
NODE_14140_length_749_cov_16.115385	360	440	0	80	80	1.0000000
NODE_14141_length_749_cov_11.210769	340	420	0	80	80	1.0000000
NODE_14141_length_749_cov_11.210769	393	473	0	80	80	1.0000000
NODE_14142_length_749_cov_8.424615	372	452	0	80	80	1.0000000
NODE_14142_length_749_cov_8.424615	425	505	0	80	80	1.0000000
NODE_14145_length_749_cov_4.521538	550	630	0	80	80	1.0000000
NODE_14145_length_749_cov_4.521538	603	683	0	80	80	1.0000000
NODE_14185_length_748_cov_55.348228	393	473	0	38	80	0.4750000
NODE_14185_length_748_cov_55.348228	393	473	2	24	80	0.3000000
NODE_14185_length_748_cov_55.348228	393	473	4	1	80	0.0125000
NODE_14185_length_748_cov_55.348228	393	473	5	1	80	0.0125000
NODE_14185_length_748_cov_55.348228	393	473	6	1	80	0.0125000
NODE_14185_length_748_cov_55.348228	393	473	7	15	80	0.1875000
NODE_14185_length_748_cov_55.348228	446	526	2	9	80	0.1125000
NODE_14185_length_748_cov_55.348228	446	526	4	1	80	0.0125000
NODE_14185_length_748_cov_55.348228	446	526	5	1	80	0.0125000
NODE_14185_length_748_cov_55.348228	446	526	6	8	80	0.1000000
NODE_14185_length_748_cov_55.348228	446	526	7	17	80	0.2125000
NODE_14185_length_748_cov_55.348228	446	526	8	44	80	0.5500000
NODE_14186_length_748_cov_51.838213	369	449	0	41	80	0.5125000
NODE_14186_length_748_cov_51.838213	369	449	2	39	80	0.4875000
NODE_14186_length_748_cov_51.838213	422	502	2	80	80	1.0000000
NODE_14187_length_748_cov_46.952234	293	373	0	80	80	1.0000000
NODE_14187_length_748_cov_46.952234	346	426	0	80	80	1.0000000
NODE_14188_length_748_cov_45.001541	272	352	0	80	80	1.0000000
NODE_14188_length_748_cov_45.001541	325	405	0	80	80	1.0000000
NODE_14189_length_748_cov_34.355932	488	568	2	33	80	0.4125000
NODE_14189_length_748_cov_34.355932	488	568	4	47	80	0.5875000
NODE_14189_length_748_cov_34.355932	541	621	0	17	80	0.2125000
NODE_14189_length_748_cov_34.355932	541	621	2	15	80	0.1875000
NODE_14189_length_748_cov_34.355932	541	621	4	48	80	0.6000000
NODE_14190_length_748_cov_25.972265	297	377	10	1	80	0.0125000
NODE_14190_length_748_cov_25.972265	297	377	12	14	80	0.1750000
NODE_14190_length_748_cov_25.972265	297	377	14	9	80	0.1125000
NODE_14190_length_748_cov_25.972265	297	377	15	2	80	0.0250000
NODE_14190_length_748_cov_25.972265	297	377	16	10	80	0.1250000
NODE_14190_length_748_cov_25.972265	297	377	17	38	80	0.4750000
NODE_14190_length_748_cov_25.972265	297	377	19	6	80	0.0750000
NODE_14190_length_748_cov_25.972265	350	430	2	40	80	0.5000000
NODE_14190_length_748_cov_25.972265	350	430	8	9	80	0.1125000
NODE_14190_length_748_cov_25.972265	350	430	10	5	80	0.0625000
NODE_14190_length_748_cov_25.972265	350	430	12	5	80	0.0625000
NODE_14190_length_748_cov_25.972265	350	430	14	9	80	0.1125000
NODE_14190_length_748_cov_25.972265	350	430	15	2	80	0.0250000
NODE_14190_length_748_cov_25.972265	350	430	16	10	80	0.1250000
NODE_14191_length_748_cov_21.050847	362	442	0	80	80	1.0000000
NODE_14191_length_748_cov_21.050847	415	495	0	80	80	1.0000000
NODE_14192_length_748_cov_20.682589	353	433	0	80	80	1.0000000
NODE_14192_length_748_cov_20.682589	406	486	0	80	80	1.0000000
NODE_14193_length_748_cov_19.081664	261	341	0	80	80	1.0000000
NODE_14193_length_748_cov_19.081664	314	394	0	80	80	1.0000000
NODE_14193_length_748_cov_19.081664	390	470	0	80	80	1.0000000
NODE_14193_length_748_cov_19.081664	443	522	0	79	79	1.0000000
NODE_14194_length_748_cov_16.579353	81	161	0	1	80	0.0125000
NODE_14194_length_748_cov_16.579353	81	161	2	79	80	0.9875000
NODE_14194_length_748_cov_16.579353	134	214	0	54	80	0.6750000
NODE_14194_length_748_cov_16.579353	134	214	2	26	80	0.3250000
NODE_14194_length_748_cov_16.579353	210	290	0	80	80	1.0000000
NODE_14194_length_748_cov_16.579353	263	343	0	80	80	1.0000000
NODE_14196_length_748_cov_11.983051	375	455	0	7	80	0.0875000
NODE_14196_length_748_cov_11.983051	375	455	2	73	80	0.9125000
NODE_14196_length_748_cov_11.983051	428	508	0	4	80	0.0500000
NODE_14196_length_748_cov_11.983051	428	508	2	76	80	0.9500000
NODE_14197_length_748_cov_11.474576	257	337	0	80	80	1.0000000
NODE_14197_length_748_cov_11.474576	310	390	0	80	80	1.0000000
NODE_14200_length_748_cov_7.979969	223	303	0	80	80	1.0000000
NODE_14200_length_748_cov_7.979969	276	356	0	80	80	1.0000000
NODE_14240_length_747_cov_24.279321	205	285	0	37	80	0.4625000
NODE_14240_length_747_cov_24.279321	205	285	2	43	80	0.5375000
NODE_14240_length_747_cov_24.279321	258	338	0	27	80	0.3375000
NODE_14240_length_747_cov_24.279321	258	338	2	53	80	0.6625000
NODE_14241_length_747_cov_15.438272	352	432	0	80	80	1.0000000
NODE_14241_length_747_cov_15.438272	405	485	0	80	80	1.0000000
NODE_14244_length_747_cov_7.979938	237	317	0	80	80	1.0000000
NODE_14244_length_747_cov_7.979938	290	370	0	80	80	1.0000000
NODE_14248_length_747_cov_4.918210	157	237	0	80	80	1.0000000
NODE_14248_length_747_cov_4.918210	210	290	0	80	80	1.0000000
NODE_14277_length_746_cov_44.041731	153	233	0	24	80	0.3000000
NODE_14277_length_746_cov_44.041731	153	233	2	56	80	0.7000000
NODE_14277_length_746_cov_44.041731	206	286	0	77	80	0.9625000
NODE_14277_length_746_cov_44.041731	206	286	2	3	80	0.0375000
NODE_14278_length_746_cov_24.435858	334	414	0	80	80	1.0000000
NODE_14278_length_746_cov_24.435858	387	467	0	76	80	0.9500000
NODE_14278_length_746_cov_24.435858	387	467	2	4	80	0.0500000
NODE_14279_length_746_cov_20.225657	114	194	0	80	80	1.0000000
NODE_14279_length_746_cov_20.225657	167	247	0	80	80	1.0000000
NODE_14280_length_746_cov_17.919629	330	410	0	39	80	0.4875000
NODE_14280_length_746_cov_17.919629	330	410	2	41	80	0.5125000
NODE_14280_length_746_cov_17.919629	383	463	0	22	80	0.2750000
NODE_14280_length_746_cov_17.919629	383	463	2	58	80	0.7250000
NODE_14281_length_746_cov_17.523957	292	372	0	62	80	0.7750000
NODE_14281_length_746_cov_17.523957	292	372	2	18	80	0.2250000
NODE_14281_length_746_cov_17.523957	345	425	0	9	80	0.1125000
NODE_14281_length_746_cov_17.523957	345	425	2	71	80	0.8875000
NODE_14282_length_746_cov_17.214838	306	386	0	80	80	1.0000000
NODE_14282_length_746_cov_17.214838	359	439	0	80	80	1.0000000
NODE_14283_length_746_cov_16.765070	344	424	0	80	80	1.0000000
NODE_14283_length_746_cov_16.765070	397	477	0	80	80	1.0000000
NODE_14284_length_746_cov_13.153014	126	206	0	80	80	1.0000000
NODE_14284_length_746_cov_13.153014	179	259	0	80	80	1.0000000
NODE_14284_length_746_cov_13.153014	244	263	0	19	19	1.0000000
NODE_14285_length_746_cov_12.316847	364	442	0	78	78	1.0000000
NODE_14286_length_746_cov_11.301391	349	429	0	80	80	1.0000000
NODE_14286_length_746_cov_11.301391	402	482	0	80	80	1.0000000
NODE_14302_length_746_cov_2.639876	331	411	0	28	80	0.3500000
NODE_14302_length_746_cov_2.639876	331	411	2	52	80	0.6500000
NODE_14307_length_746_cov_1.879444	435	502	0	67	67	1.0000000
NODE_14310_length_746_cov_1.727975	65	121	0	56	56	1.0000000
NODE_14310_length_746_cov_1.727975	494	540	0	46	46	1.0000000
NODE_14329_length_745_cov_40.360681	257	337	0	49	80	0.6125000
NODE_14329_length_745_cov_40.360681	257	337	2	1	80	0.0125000
NODE_14329_length_745_cov_40.360681	257	337	4	30	80	0.3750000
NODE_14329_length_745_cov_40.360681	310	390	0	7	80	0.0875000
NODE_14329_length_745_cov_40.360681	310	390	2	2	80	0.0250000
NODE_14329_length_745_cov_40.360681	310	390	4	71	80	0.8875000
NODE_14330_length_745_cov_30.817337	339	419	0	39	80	0.4875000
NODE_14330_length_745_cov_30.817337	339	419	2	8	80	0.1000000
NODE_14330_length_745_cov_30.817337	339	419	4	33	80	0.4125000
NODE_14330_length_745_cov_30.817337	392	459	0	67	67	1.0000000
NODE_14335_length_745_cov_8.620743	225	275	0	20	50	0.4000000
NODE_14335_length_745_cov_8.620743	225	275	2	30	50	0.6000000
NODE_14335_length_745_cov_8.620743	248	328	2	80	80	1.0000000
NODE_14343_length_745_cov_3.922601	249	280	16	3	31	0.0967742
NODE_14343_length_745_cov_3.922601	249	280	22	28	31	0.9032258
NODE_14343_length_745_cov_3.922601	253	333	16	11	80	0.1375000
NODE_14343_length_745_cov_3.922601	253	333	18	20	80	0.2500000
NODE_14343_length_745_cov_3.922601	253	333	20	7	80	0.0875000
NODE_14343_length_745_cov_3.922601	253	333	22	39	80	0.4875000
NODE_14343_length_745_cov_3.922601	253	333	24	3	80	0.0375000
NODE_14381_length_744_cov_44.953488	553	633	0	10	80	0.1250000
NODE_14381_length_744_cov_44.953488	553	633	2	70	80	0.8750000
NODE_14381_length_744_cov_44.953488	553	633	0	10	80	0.1250000
NODE_14381_length_744_cov_44.953488	553	633	2	70	80	0.8750000
NODE_14381_length_744_cov_44.953488	553	633	0	10	80	0.1250000
NODE_14381_length_744_cov_44.953488	553	633	2	70	80	0.8750000
NODE_14381_length_744_cov_44.953488	553	633	0	10	80	0.1250000
NODE_14381_length_744_cov_44.953488	553	633	2	70	80	0.8750000
NODE_14382_length_744_cov_35.333333	163	243	0	35	80	0.4375000
NODE_14382_length_744_cov_35.333333	163	243	2	45	80	0.5625000
NODE_14382_length_744_cov_35.333333	216	296	0	80	80	1.0000000
NODE_14382_length_744_cov_35.333333	292	372	0	58	80	0.7250000
NODE_14382_length_744_cov_35.333333	292	372	2	22	80	0.2750000
NODE_14382_length_744_cov_35.333333	345	425	0	5	80	0.0625000
NODE_14382_length_744_cov_35.333333	345	425	2	66	80	0.8250000
NODE_14382_length_744_cov_35.333333	345	425	4	9	80	0.1125000
NODE_14383_length_744_cov_34.503876	294	374	0	80	80	1.0000000
NODE_14383_length_744_cov_34.503876	347	427	0	80	80	1.0000000
NODE_14384_length_744_cov_32.282171	333	403	0	70	70	1.0000000
NODE_14384_length_744_cov_32.282171	440	520	0	80	80	1.0000000
NODE_14384_length_744_cov_32.282171	493	573	0	80	80	1.0000000
NODE_14390_length_744_cov_4.537984	260	340	0	80	80	1.0000000
NODE_14390_length_744_cov_4.537984	313	393	0	80	80	1.0000000
NODE_14396_length_744_cov_2.784496	335	387	2	52	52	1.0000000
NODE_14396_length_744_cov_2.784496	360	437	0	36	77	0.4675325
NODE_14396_length_744_cov_2.784496	360	437	2	41	77	0.5324675
NODE_14427_length_743_cov_26.369565	354	434	0	70	80	0.8750000
NODE_14427_length_743_cov_26.369565	354	434	2	10	80	0.1250000
NODE_14427_length_743_cov_26.369565	407	487	0	17	80	0.2125000
NODE_14427_length_743_cov_26.369565	407	487	2	11	80	0.1375000
NODE_14427_length_743_cov_26.369565	407	487	4	52	80	0.6500000
NODE_14428_length_743_cov_21.759317	138	218	0	56	80	0.7000000
NODE_14428_length_743_cov_21.759317	138	218	6	24	80	0.3000000
NODE_14428_length_743_cov_21.759317	191	271	0	3	80	0.0375000
NODE_14428_length_743_cov_21.759317	191	271	6	77	80	0.9625000
NODE_14429_length_743_cov_18.173913	213	293	0	80	80	1.0000000
NODE_14429_length_743_cov_18.173913	266	346	0	80	80	1.0000000
NODE_14431_length_743_cov_17.066770	400	480	0	80	80	1.0000000
NODE_14431_length_743_cov_17.066770	453	532	0	79	79	1.0000000
NODE_14432_length_743_cov_16.354037	350	430	0	24	80	0.3000000
NODE_14432_length_743_cov_16.354037	350	430	2	56	80	0.7000000
NODE_14432_length_743_cov_16.354037	403	483	0	77	80	0.9625000
NODE_14432_length_743_cov_16.354037	403	483	2	3	80	0.0375000
NODE_14433_length_743_cov_15.667702	220	300	0	80	80	1.0000000
NODE_14433_length_743_cov_15.667702	273	353	0	80	80	1.0000000
NODE_14433_length_743_cov_15.667702	349	429	0	80	80	1.0000000
NODE_14433_length_743_cov_15.667702	402	482	0	73	80	0.9125000
NODE_14433_length_743_cov_15.667702	402	482	2	7	80	0.0875000
NODE_14434_length_743_cov_14.975155	289	362	6	8	73	0.1095890
NODE_14434_length_743_cov_14.975155	289	362	8	5	73	0.0684932
NODE_14434_length_743_cov_14.975155	289	362	10	9	73	0.1232877
NODE_14434_length_743_cov_14.975155	289	362	12	28	73	0.3835616
NODE_14434_length_743_cov_14.975155	289	362	14	23	73	0.3150685
NODE_14435_length_743_cov_14.100932	232	312	0	8	80	0.1000000
NODE_14435_length_743_cov_14.100932	232	312	2	72	80	0.9000000
NODE_14435_length_743_cov_14.100932	285	365	0	50	80	0.6250000
NODE_14435_length_743_cov_14.100932	285	365	2	30	80	0.3750000
NODE_14435_length_743_cov_14.100932	361	441	0	45	80	0.5625000
NODE_14435_length_743_cov_14.100932	361	441	4	35	80	0.4375000
NODE_14435_length_743_cov_14.100932	414	494	4	80	80	1.0000000
NODE_14436_length_743_cov_12.968944	268	348	0	34	80	0.4250000
NODE_14436_length_743_cov_12.968944	268	348	2	46	80	0.5750000
NODE_14436_length_743_cov_12.968944	321	401	0	37	80	0.4625000
NODE_14436_length_743_cov_12.968944	321	401	2	43	80	0.5375000
NODE_14437_length_743_cov_12.847826	485	565	2	22	80	0.2750000
NODE_14437_length_743_cov_12.847826	485	565	3	6	80	0.0750000
NODE_14437_length_743_cov_12.847826	485	565	4	33	80	0.4125000
NODE_14437_length_743_cov_12.847826	485	565	6	19	80	0.2375000
NODE_14437_length_743_cov_12.847826	538	618	0	11	80	0.1375000
NODE_14437_length_743_cov_12.847826	538	618	2	64	80	0.8000000
NODE_14437_length_743_cov_12.847826	538	618	6	5	80	0.0625000
NODE_14438_length_743_cov_11.871118	403	483	0	80	80	1.0000000
NODE_14438_length_743_cov_11.871118	456	536	0	80	80	1.0000000
NODE_14439_length_743_cov_11.760870	337	417	0	8	80	0.1000000
NODE_14439_length_743_cov_11.760870	337	417	2	42	80	0.5250000
NODE_14439_length_743_cov_11.760870	337	417	4	30	80	0.3750000
NODE_14439_length_743_cov_11.760870	390	470	2	16	80	0.2000000
NODE_14439_length_743_cov_11.760870	390	470	4	64	80	0.8000000
NODE_14440_length_743_cov_9.006211	351	431	0	80	80	1.0000000
NODE_14440_length_743_cov_9.006211	404	484	0	80	80	1.0000000
NODE_14441_length_743_cov_8.063665	290	370	0	80	80	1.0000000
NODE_14441_length_743_cov_8.063665	343	423	0	80	80	1.0000000
NODE_14456_length_743_cov_2.029503	260	284	0	24	24	1.0000000
NODE_14456_length_743_cov_2.029503	301	363	0	62	62	1.0000000
NODE_14473_length_743_cov_0.989130	592	670	16	4	78	0.0512821
NODE_14473_length_743_cov_0.989130	592	670	19	2	78	0.0256410
NODE_14473_length_743_cov_0.989130	592	670	32	7	78	0.0897436
NODE_14473_length_743_cov_0.989130	592	670	33	2	78	0.0256410
NODE_14473_length_743_cov_0.989130	592	670	39	1	78	0.0128205
NODE_14473_length_743_cov_0.989130	592	670	47	2	78	0.0256410
NODE_14473_length_743_cov_0.989130	592	670	50	1	78	0.0128205
NODE_14473_length_743_cov_0.989130	592	670	52	2	78	0.0256410
NODE_14473_length_743_cov_0.989130	592	670	54	9	78	0.1153846
NODE_14473_length_743_cov_0.989130	592	670	56	9	78	0.1153846
NODE_14473_length_743_cov_0.989130	592	670	57	6	78	0.0769231
NODE_14473_length_743_cov_0.989130	592	670	60	2	78	0.0256410
NODE_14473_length_743_cov_0.989130	592	670	61	7	78	0.0897436
NODE_14473_length_743_cov_0.989130	592	670	63	1	78	0.0128205
NODE_14473_length_743_cov_0.989130	592	670	65	23	78	0.2948718
NODE_14477_length_742_cov_23.664075	271	351	0	65	80	0.8125000
NODE_14477_length_742_cov_23.664075	271	351	2	15	80	0.1875000
NODE_14477_length_742_cov_23.664075	324	404	0	12	80	0.1500000
NODE_14477_length_742_cov_23.664075	324	404	2	68	80	0.8500000
NODE_14478_length_742_cov_19.488336	288	368	0	80	80	1.0000000
NODE_14478_length_742_cov_19.488336	341	421	0	80	80	1.0000000
NODE_14479_length_742_cov_18.528771	319	399	2	72	80	0.9000000
NODE_14479_length_742_cov_18.528771	319	399	4	8	80	0.1000000
NODE_14479_length_742_cov_18.528771	372	452	0	29	80	0.3625000
NODE_14479_length_742_cov_18.528771	372	452	2	51	80	0.6375000
NODE_14480_length_742_cov_17.401244	126	206	0	80	80	1.0000000
NODE_14480_length_742_cov_17.401244	179	259	0	80	80	1.0000000
NODE_14482_length_742_cov_7.679627	274	354	0	80	80	1.0000000
NODE_14482_length_742_cov_7.679627	327	407	0	80	80	1.0000000
NODE_14521_length_741_cov_12.168224	316	392	2	68	76	0.8947368
NODE_14521_length_741_cov_12.168224	316	392	4	8	76	0.1052632
NODE_14521_length_741_cov_12.168224	598	663	0	65	65	1.0000000
NODE_14522_length_741_cov_8.542056	198	278	0	80	80	1.0000000
NODE_14522_length_741_cov_8.542056	251	331	0	80	80	1.0000000
NODE_14525_length_741_cov_5.989097	457	538	2	22	81	0.2716049
NODE_14525_length_741_cov_5.989097	457	538	4	6	81	0.0740741
NODE_14525_length_741_cov_5.989097	457	538	6	9	81	0.1111111
NODE_14525_length_741_cov_5.989097	457	538	8	44	81	0.5432099
NODE_14536_length_741_cov_2.556075	212	289	0	39	77	0.5064935
NODE_14536_length_741_cov_2.556075	212	289	2	37	77	0.4805195
NODE_14536_length_741_cov_2.556075	212	289	4	1	77	0.0129870
NODE_14571_length_740_cov_54.372855	192	272	0	12	80	0.1500000
NODE_14571_length_740_cov_54.372855	192	272	2	68	80	0.8500000
NODE_14571_length_740_cov_54.372855	245	325	2	80	80	1.0000000
NODE_14571_length_740_cov_54.372855	321	401	0	71	80	0.8875000
NODE_14571_length_740_cov_54.372855	321	401	2	9	80	0.1125000
NODE_14571_length_740_cov_54.372855	374	454	0	80	80	1.0000000
NODE_14572_length_740_cov_51.758190	194	274	0	80	80	1.0000000
NODE_14572_length_740_cov_51.758190	247	327	0	80	80	1.0000000
NODE_14573_length_740_cov_34.185647	359	439	0	80	80	1.0000000
NODE_14573_length_740_cov_34.185647	412	492	0	80	80	1.0000000
NODE_14574_length_740_cov_24.794072	286	366	0	80	80	1.0000000
NODE_14574_length_740_cov_24.794072	339	419	0	80	80	1.0000000
NODE_14575_length_740_cov_20.361934	316	396	0	80	80	1.0000000
NODE_14575_length_740_cov_20.361934	369	449	0	80	80	1.0000000
NODE_14576_length_740_cov_18.982839	266	348	0	82	82	1.0000000
NODE_14576_length_740_cov_18.982839	321	401	0	80	80	1.0000000
NODE_14577_length_740_cov_16.755070	354	434	0	80	80	1.0000000
NODE_14577_length_740_cov_16.755070	407	487	0	80	80	1.0000000
NODE_14579_length_740_cov_7.585023	206	286	0	80	80	1.0000000
NODE_14579_length_740_cov_7.585023	259	339	0	80	80	1.0000000
NODE_14580_length_740_cov_7.174727	165	245	0	76	80	0.9500000
NODE_14580_length_740_cov_7.174727	165	245	2	4	80	0.0500000
NODE_14580_length_740_cov_7.174727	218	298	0	23	80	0.2875000
NODE_14580_length_740_cov_7.174727	218	298	2	14	80	0.1750000
NODE_14580_length_740_cov_7.174727	218	298	4	3	80	0.0375000
NODE_14580_length_740_cov_7.174727	218	298	5	1	80	0.0125000
NODE_14580_length_740_cov_7.174727	218	298	6	39	80	0.4875000
NODE_14614_length_739_cov_52.970312	346	426	2	80	80	1.0000000
NODE_14614_length_739_cov_52.970312	399	479	2	60	80	0.7500000
NODE_14614_length_739_cov_52.970312	399	479	4	20	80	0.2500000
NODE_14615_length_739_cov_31.175000	204	284	4	55	80	0.6875000
NODE_14615_length_739_cov_31.175000	204	284	6	25	80	0.3125000
NODE_14615_length_739_cov_31.175000	257	337	0	9	80	0.1125000
NODE_14615_length_739_cov_31.175000	257	337	2	11	80	0.1375000
NODE_14615_length_739_cov_31.175000	257	337	3	1	80	0.0125000
NODE_14615_length_739_cov_31.175000	257	337	4	43	80	0.5375000
NODE_14615_length_739_cov_31.175000	257	337	6	16	80	0.2000000
NODE_14616_length_739_cov_25.482813	487	567	0	26	80	0.3250000
NODE_14616_length_739_cov_25.482813	487	567	4	54	80	0.6750000
NODE_14616_length_739_cov_25.482813	540	620	0	79	80	0.9875000
NODE_14616_length_739_cov_25.482813	540	620	4	1	80	0.0125000
NODE_14617_length_739_cov_24.871875	191	271	0	80	80	1.0000000
NODE_14617_length_739_cov_24.871875	244	324	0	80	80	1.0000000
NODE_14618_length_739_cov_18.360937	146	226	0	80	80	1.0000000
NODE_14618_length_739_cov_18.360937	199	279	0	80	80	1.0000000
NODE_14619_length_739_cov_13.195312	273	353	0	47	80	0.5875000
NODE_14619_length_739_cov_13.195312	273	353	4	33	80	0.4125000
NODE_14619_length_739_cov_13.195312	326	406	4	80	80	1.0000000
NODE_14620_length_739_cov_10.314063	231	311	0	47	80	0.5875000
NODE_14620_length_739_cov_10.314063	231	311	2	33	80	0.4125000
NODE_14620_length_739_cov_10.314063	284	364	0	11	80	0.1375000
NODE_14620_length_739_cov_10.314063	284	364	2	69	80	0.8625000
NODE_14622_length_739_cov_8.523438	468	548	0	80	80	1.0000000
NODE_14622_length_739_cov_8.523438	521	600	0	79	79	1.0000000
NODE_14623_length_739_cov_7.398438	342	422	0	25	80	0.3125000
NODE_14623_length_739_cov_7.398438	342	422	2	6	80	0.0750000
NODE_14623_length_739_cov_7.398438	342	422	4	37	80	0.4625000
NODE_14623_length_739_cov_7.398438	342	422	6	12	80	0.1500000
NODE_14623_length_739_cov_7.398438	395	475	0	37	80	0.4625000
NODE_14623_length_739_cov_7.398438	395	475	2	43	80	0.5375000
NODE_14625_length_739_cov_5.826562	252	332	0	80	80	1.0000000
NODE_14625_length_739_cov_5.826562	305	385	0	80	80	1.0000000
NODE_14634_length_739_cov_3.232813	355	435	0	80	80	1.0000000
NODE_14634_length_739_cov_3.232813	408	488	0	80	80	1.0000000
NODE_14679_length_738_cov_35.278560	274	318	55	2	44	0.0454545
NODE_14679_length_738_cov_35.278560	274	318	57	6	44	0.1363636
NODE_14679_length_738_cov_35.278560	274	318	58	1	44	0.0227273
NODE_14679_length_738_cov_35.278560	274	318	59	2	44	0.0454545
NODE_14679_length_738_cov_35.278560	274	318	60	9	44	0.2045455
NODE_14679_length_738_cov_35.278560	274	318	61	8	44	0.1818182
NODE_14679_length_738_cov_35.278560	274	318	62	8	44	0.1818182
NODE_14679_length_738_cov_35.278560	274	318	63	5	44	0.1136364
NODE_14679_length_738_cov_35.278560	274	318	64	2	44	0.0454545
NODE_14679_length_738_cov_35.278560	274	318	65	1	44	0.0227273
NODE_14680_length_738_cov_21.672926	208	288	0	37	80	0.4625000
NODE_14680_length_738_cov_21.672926	208	288	2	43	80	0.5375000
NODE_14680_length_738_cov_21.672926	261	341	2	80	80	1.0000000
NODE_14681_length_738_cov_15.665102	302	382	0	35	80	0.4375000
NODE_14681_length_738_cov_15.665102	302	382	2	45	80	0.5625000
NODE_14681_length_738_cov_15.665102	355	435	0	17	80	0.2125000
NODE_14681_length_738_cov_15.665102	355	435	2	63	80	0.7875000
NODE_14682_length_738_cov_15.661972	338	418	0	56	80	0.7000000
NODE_14682_length_738_cov_15.661972	338	418	2	24	80	0.3000000
NODE_14682_length_738_cov_15.661972	391	471	0	18	80	0.2250000
NODE_14682_length_738_cov_15.661972	391	471	2	62	80	0.7750000
NODE_14683_length_738_cov_12.594679	49	129	0	17	80	0.2125000
NODE_14683_length_738_cov_12.594679	49	129	2	18	80	0.2250000
NODE_14683_length_738_cov_12.594679	49	129	4	45	80	0.5625000
NODE_14683_length_738_cov_12.594679	102	182	2	27	80	0.3375000
NODE_14683_length_738_cov_12.594679	102	182	4	53	80	0.6625000
NODE_14683_length_738_cov_12.594679	178	258	0	73	80	0.9125000
NODE_14683_length_738_cov_12.594679	178	258	2	7	80	0.0875000
NODE_14683_length_738_cov_12.594679	231	311	0	80	80	1.0000000
NODE_14691_length_738_cov_4.056338	254	326	0	72	72	1.0000000
NODE_14691_length_738_cov_4.056338	437	528	4	86	91	0.9450549
NODE_14691_length_738_cov_4.056338	437	528	6	4	91	0.0439560
NODE_14691_length_738_cov_4.056338	437	528	8	1	91	0.0109890
NODE_14724_length_737_cov_22.363636	303	383	0	15	80	0.1875000
NODE_14724_length_737_cov_22.363636	303	383	2	65	80	0.8125000
NODE_14724_length_737_cov_22.363636	356	436	0	26	80	0.3250000
NODE_14724_length_737_cov_22.363636	356	436	2	54	80	0.6750000
NODE_14725_length_737_cov_21.318182	208	288	0	10	80	0.1250000
NODE_14725_length_737_cov_21.318182	208	288	2	70	80	0.8750000
NODE_14725_length_737_cov_21.318182	261	341	0	63	80	0.7875000
NODE_14725_length_737_cov_21.318182	261	341	2	17	80	0.2125000
NODE_14726_length_737_cov_17.161442	346	426	0	19	80	0.2375000
NODE_14726_length_737_cov_17.161442	346	426	2	61	80	0.7625000
NODE_14726_length_737_cov_17.161442	399	479	0	3	80	0.0375000
NODE_14726_length_737_cov_17.161442	399	479	2	77	80	0.9625000
NODE_14727_length_737_cov_11.835423	211	291	2	43	80	0.5375000
NODE_14727_length_737_cov_11.835423	211	291	4	37	80	0.4625000
NODE_14727_length_737_cov_11.835423	264	344	0	6	80	0.0750000
NODE_14727_length_737_cov_11.835423	264	344	2	40	80	0.5000000
NODE_14727_length_737_cov_11.835423	264	344	4	34	80	0.4250000
NODE_14729_length_737_cov_6.782132	488	548	0	60	60	1.0000000
NODE_14732_length_737_cov_6.089342	241	321	2	78	80	0.9750000
NODE_14732_length_737_cov_6.089342	241	321	4	2	80	0.0250000
NODE_14732_length_737_cov_6.089342	294	374	0	10	80	0.1250000
NODE_14732_length_737_cov_6.089342	294	374	2	68	80	0.8500000
NODE_14732_length_737_cov_6.089342	294	374	4	2	80	0.0250000
NODE_14747_length_737_cov_2.548589	386	416	0	30	30	1.0000000
NODE_14781_length_736_cov_46.601256	226	306	0	80	80	1.0000000
NODE_14781_length_736_cov_46.601256	279	359	0	73	80	0.9125000
NODE_14781_length_736_cov_46.601256	279	359	2	7	80	0.0875000
NODE_14782_length_736_cov_32.442700	215	295	4	80	80	1.0000000
NODE_14782_length_736_cov_32.442700	268	350	0	54	82	0.6585366
NODE_14782_length_736_cov_32.442700	268	350	4	28	82	0.3414634
NODE_14783_length_736_cov_26.364207	220	300	0	80	80	1.0000000
NODE_14783_length_736_cov_26.364207	273	353	0	80	80	1.0000000
NODE_14785_length_736_cov_10.317111	313	393	0	80	80	1.0000000
NODE_14785_length_736_cov_10.317111	366	446	0	80	80	1.0000000
NODE_14786_length_736_cov_9.188383	292	372	0	80	80	1.0000000
NODE_14786_length_736_cov_9.188383	345	425	0	80	80	1.0000000
NODE_14787_length_736_cov_8.149137	315	391	0	76	76	1.0000000
NODE_14787_length_736_cov_8.149137	365	445	0	80	80	1.0000000
NODE_14788_length_736_cov_8.103611	295	375	0	80	80	1.0000000
NODE_14788_length_736_cov_8.103611	348	428	0	80	80	1.0000000
NODE_14789_length_736_cov_7.513344	239	319	0	60	80	0.7500000
NODE_14789_length_736_cov_7.513344	239	319	2	20	80	0.2500000
NODE_14789_length_736_cov_7.513344	292	372	0	80	80	1.0000000
NODE_14792_length_736_cov_5.967033	253	333	0	80	80	1.0000000
NODE_14792_length_736_cov_5.967033	306	386	0	80	80	1.0000000
NODE_14795_length_736_cov_4.908948	258	338	0	80	80	1.0000000
NODE_14795_length_736_cov_4.908948	311	391	0	80	80	1.0000000
NODE_14825_length_735_cov_21.099057	265	345	0	80	80	1.0000000
NODE_14825_length_735_cov_21.099057	318	398	0	80	80	1.0000000
NODE_14826_length_735_cov_16.696541	190	270	0	80	80	1.0000000
NODE_14826_length_735_cov_16.696541	243	323	0	80	80	1.0000000
NODE_14826_length_735_cov_16.696541	479	538	0	24	59	0.4067796
NODE_14826_length_735_cov_16.696541	479	538	2	35	59	0.5932204
NODE_14827_length_735_cov_13.143082	231	311	0	34	80	0.4250000
NODE_14827_length_735_cov_13.143082	231	311	4	46	80	0.5750000
NODE_14827_length_735_cov_13.143082	284	364	0	11	80	0.1375000
NODE_14827_length_735_cov_13.143082	284	364	4	69	80	0.8625000
NODE_14828_length_735_cov_12.415094	434	514	0	80	80	1.0000000
NODE_14828_length_735_cov_12.415094	487	567	0	80	80	1.0000000
NODE_14836_length_735_cov_5.603774	326	394	0	68	68	1.0000000
NODE_14836_length_735_cov_5.603774	367	409	0	42	42	1.0000000
NODE_14880_length_734_cov_26.787402	209	289	0	80	80	1.0000000
NODE_14880_length_734_cov_26.787402	262	342	0	80	80	1.0000000
NODE_14881_length_734_cov_23.214173	200	280	0	34	80	0.4250000
NODE_14881_length_734_cov_23.214173	200	280	2	46	80	0.5750000
NODE_14881_length_734_cov_23.214173	253	333	0	31	80	0.3875000
NODE_14881_length_734_cov_23.214173	253	333	2	49	80	0.6125000
NODE_14883_length_734_cov_21.645669	245	325	0	25	80	0.3125000
NODE_14883_length_734_cov_21.645669	245	325	2	55	80	0.6875000
NODE_14883_length_734_cov_21.645669	298	378	0	78	80	0.9750000
NODE_14883_length_734_cov_21.645669	298	378	2	2	80	0.0250000
NODE_14884_length_734_cov_14.393701	249	329	0	5	80	0.0625000
NODE_14884_length_734_cov_14.393701	249	329	2	75	80	0.9375000
NODE_14884_length_734_cov_14.393701	302	382	0	58	80	0.7250000
NODE_14884_length_734_cov_14.393701	302	382	2	22	80	0.2750000
NODE_14885_length_734_cov_11.324409	133	196	0	7	63	0.1111111
NODE_14885_length_734_cov_11.324409	133	196	2	56	63	0.8888889
NODE_14885_length_734_cov_11.324409	169	229	2	60	60	1.0000000
NODE_14886_length_734_cov_10.872441	302	331	0	7	29	0.2413793
NODE_14886_length_734_cov_10.872441	302	331	2	22	29	0.7586207
NODE_14890_length_734_cov_6.352756	371	451	0	28	80	0.3500000
NODE_14890_length_734_cov_6.352756	371	451	2	52	80	0.6500000
NODE_14890_length_734_cov_6.352756	424	504	0	1	80	0.0125000
NODE_14890_length_734_cov_6.352756	424	504	2	79	80	0.9875000
NODE_14896_length_734_cov_2.705512	231	302	0	71	71	1.0000000
NODE_14934_length_733_cov_35.041009	268	348	4	13	80	0.1625000
NODE_14934_length_733_cov_35.041009	268	348	6	67	80	0.8375000
NODE_14934_length_733_cov_35.041009	321	402	0	38	81	0.4691358
NODE_14934_length_733_cov_35.041009	321	402	4	29	81	0.3580247
NODE_14934_length_733_cov_35.041009	321	402	6	14	81	0.1728395
NODE_14935_length_733_cov_29.810726	28	108	0	80	80	1.0000000
NODE_14935_length_733_cov_29.810726	81	161	0	80	80	1.0000000
NODE_14935_length_733_cov_29.810726	157	237	0	7	80	0.0875000
NODE_14935_length_733_cov_29.810726	157	237	2	17	80	0.2125000
NODE_14935_length_733_cov_29.810726	157	237	4	41	80	0.5125000
NODE_14935_length_733_cov_29.810726	157	237	6	15	80	0.1875000
NODE_14935_length_733_cov_29.810726	210	290	0	10	80	0.1250000
NODE_14935_length_733_cov_29.810726	210	290	2	32	80	0.4000000
NODE_14935_length_733_cov_29.810726	210	290	4	30	80	0.3750000
NODE_14935_length_733_cov_29.810726	210	290	6	8	80	0.1000000
NODE_14936_length_733_cov_13.738170	333	413	0	80	80	1.0000000
NODE_14936_length_733_cov_13.738170	386	466	0	80	80	1.0000000
NODE_14937_length_733_cov_11.471609	314	389	2	1	75	0.0133333
NODE_14937_length_733_cov_11.471609	314	389	4	74	75	0.9866667
NODE_14938_length_733_cov_11.321767	245	325	2	80	80	1.0000000
NODE_14938_length_733_cov_11.321767	298	378	0	37	80	0.4625000
NODE_14938_length_733_cov_11.321767	298	378	2	43	80	0.5375000
NODE_14940_length_733_cov_8.481073	318	395	0	77	77	1.0000000
NODE_14940_length_733_cov_8.481073	371	451	0	80	80	1.0000000
NODE_14944_length_733_cov_5.485804	659	715	26	7	56	0.1250000
NODE_14944_length_733_cov_5.485804	659	715	28	1	56	0.0178571
NODE_14944_length_733_cov_5.485804	659	715	32	1	56	0.0178571
NODE_14944_length_733_cov_5.485804	659	715	34	4	56	0.0714286
NODE_14944_length_733_cov_5.485804	659	715	36	7	56	0.1250000
NODE_14944_length_733_cov_5.485804	659	715	38	3	56	0.0535714
NODE_14944_length_733_cov_5.485804	659	715	40	1	56	0.0178571
NODE_14944_length_733_cov_5.485804	659	715	42	5	56	0.0892857
NODE_14944_length_733_cov_5.485804	659	715	44	1	56	0.0178571
NODE_14944_length_733_cov_5.485804	659	715	46	25	56	0.4464286
NODE_14944_length_733_cov_5.485804	659	715	50	1	56	0.0178571
NODE_14944_length_733_cov_5.485804	696	733	16	3	37	0.0810811
NODE_14944_length_733_cov_5.485804	696	733	18	1	37	0.0270270
NODE_14944_length_733_cov_5.485804	696	733	22	3	37	0.0810811
NODE_14944_length_733_cov_5.485804	696	733	24	1	37	0.0270270
NODE_14944_length_733_cov_5.485804	696	733	26	17	37	0.4594595
NODE_14944_length_733_cov_5.485804	696	733	28	1	37	0.0270270
NODE_14944_length_733_cov_5.485804	696	733	32	1	37	0.0270270
NODE_14944_length_733_cov_5.485804	696	733	34	4	37	0.1081081
NODE_14944_length_733_cov_5.485804	696	733	36	6	37	0.1621622
NODE_14957_length_733_cov_2.272871	312	392	0	80	80	1.0000000
NODE_14957_length_733_cov_2.272871	365	445	0	80	80	1.0000000
NODE_14975_length_732_cov_19.519747	229	309	0	80	80	1.0000000
NODE_14975_length_732_cov_19.519747	282	362	0	80	80	1.0000000
NODE_14976_length_732_cov_10.846761	247	327	0	20	80	0.2500000
NODE_14976_length_732_cov_10.846761	247	327	2	60	80	0.7500000
NODE_14976_length_732_cov_10.846761	300	380	0	25	80	0.3125000
NODE_14976_length_732_cov_10.846761	300	380	2	55	80	0.6875000
NODE_14977_length_732_cov_9.807267	276	356	0	80	80	1.0000000
NODE_14977_length_732_cov_9.807267	329	409	0	80	80	1.0000000
NODE_14978_length_732_cov_8.053712	415	495	0	26	80	0.3250000
NODE_14978_length_732_cov_8.053712	415	495	4	54	80	0.6750000
NODE_14978_length_732_cov_8.053712	468	548	0	13	80	0.1625000
NODE_14978_length_732_cov_8.053712	468	548	4	67	80	0.8375000
NODE_14980_length_732_cov_5.194313	319	399	0	80	80	1.0000000
NODE_14980_length_732_cov_5.194313	372	452	0	80	80	1.0000000
NODE_14981_length_732_cov_4.998420	293	373	0	80	80	1.0000000
NODE_14981_length_732_cov_4.998420	346	426	0	80	80	1.0000000
NODE_14983_length_732_cov_4.758294	483	524	0	41	41	1.0000000
NODE_15021_length_731_cov_36.123418	464	544	8	7	80	0.0875000
NODE_15021_length_731_cov_36.123418	464	544	10	73	80	0.9125000
NODE_15021_length_731_cov_36.123418	517	597	0	38	80	0.4750000
NODE_15021_length_731_cov_36.123418	517	597	2	11	80	0.1375000
NODE_15021_length_731_cov_36.123418	517	597	8	11	80	0.1375000
NODE_15021_length_731_cov_36.123418	517	597	10	20	80	0.2500000
NODE_15022_length_731_cov_27.721519	294	374	0	32	80	0.4000000
NODE_15022_length_731_cov_27.721519	294	374	4	35	80	0.4375000
NODE_15022_length_731_cov_27.721519	294	374	6	13	80	0.1625000
NODE_15022_length_731_cov_27.721519	347	427	4	14	80	0.1750000
NODE_15022_length_731_cov_27.721519	347	427	6	66	80	0.8250000
NODE_15023_length_731_cov_19.655063	394	474	0	80	80	1.0000000
NODE_15023_length_731_cov_19.655063	447	527	0	80	80	1.0000000
NODE_15024_length_731_cov_16.346519	429	509	0	46	80	0.5750000
NODE_15024_length_731_cov_16.346519	429	509	2	25	80	0.3125000
NODE_15024_length_731_cov_16.346519	429	509	4	9	80	0.1125000
NODE_15024_length_731_cov_16.346519	482	562	2	18	80	0.2250000
NODE_15024_length_731_cov_16.346519	482	562	4	25	80	0.3125000
NODE_15024_length_731_cov_16.346519	482	562	6	37	80	0.4625000
NODE_15025_length_731_cov_13.892405	321	401	0	80	80	1.0000000
NODE_15025_length_731_cov_13.892405	374	454	0	80	80	1.0000000
NODE_15027_length_731_cov_8.800633	218	298	0	40	80	0.5000000
NODE_15027_length_731_cov_8.800633	218	298	2	40	80	0.5000000
NODE_15027_length_731_cov_8.800633	271	352	0	31	81	0.3827161
NODE_15027_length_731_cov_8.800633	271	352	2	50	81	0.6172839
NODE_15028_length_731_cov_7.658228	335	406	0	10	71	0.1408451
NODE_15028_length_731_cov_7.658228	335	406	1	28	71	0.3943662
NODE_15028_length_731_cov_7.658228	335	406	2	33	71	0.4647887
NODE_15028_length_731_cov_7.658228	387	468	2	81	81	1.0000000
NODE_15031_length_731_cov_5.471519	261	341	0	80	80	1.0000000
NODE_15031_length_731_cov_5.471519	314	394	0	80	80	1.0000000
NODE_15034_length_731_cov_4.083861	361	441	0	80	80	1.0000000
NODE_15034_length_731_cov_4.083861	458	482	0	24	24	1.0000000
NODE_15050_length_731_cov_2.226266	466	548	0	82	82	1.0000000
NODE_15077_length_730_cov_51.556260	349	429	2	20	80	0.2500000
NODE_15077_length_730_cov_51.556260	349	429	4	53	80	0.6625000
NODE_15077_length_730_cov_51.556260	349	429	6	7	80	0.0875000
NODE_15077_length_730_cov_51.556260	402	482	0	14	80	0.1750000
NODE_15077_length_730_cov_51.556260	402	482	2	59	80	0.7375000
NODE_15077_length_730_cov_51.556260	402	482	4	7	80	0.0875000
NODE_15078_length_730_cov_39.862124	370	450	2	63	80	0.7875000
NODE_15078_length_730_cov_39.862124	370	450	4	17	80	0.2125000
NODE_15078_length_730_cov_39.862124	423	503	0	13	80	0.1625000
NODE_15078_length_730_cov_39.862124	423	503	2	63	80	0.7875000
NODE_15078_length_730_cov_39.862124	423	503	4	4	80	0.0500000
NODE_15079_length_730_cov_15.801902	261	341	0	80	80	1.0000000
NODE_15079_length_730_cov_15.801902	314	394	0	80	80	1.0000000
NODE_15080_length_730_cov_11.746434	242	322	0	70	80	0.8750000
NODE_15080_length_730_cov_11.746434	242	322	2	10	80	0.1250000
NODE_15080_length_730_cov_11.746434	295	375	0	80	80	1.0000000
NODE_15081_length_730_cov_9.209192	358	438	0	47	80	0.5875000
NODE_15081_length_730_cov_9.209192	358	438	2	9	80	0.1125000
NODE_15081_length_730_cov_9.209192	358	438	4	24	80	0.3000000
NODE_15081_length_730_cov_9.209192	411	483	0	6	72	0.0833333
NODE_15081_length_730_cov_9.209192	411	483	2	3	72	0.0416667
NODE_15081_length_730_cov_9.209192	411	483	4	63	72	0.8750000
NODE_15131_length_729_cov_44.188889	418	498	0	25	80	0.3125000
NODE_15131_length_729_cov_44.188889	418	498	4	55	80	0.6875000
NODE_15131_length_729_cov_44.188889	471	551	0	6	80	0.0750000
NODE_15131_length_729_cov_44.188889	471	551	4	74	80	0.9250000
NODE_15132_length_729_cov_40.390476	330	410	0	80	80	1.0000000
NODE_15132_length_729_cov_40.390476	383	463	0	80	80	1.0000000
NODE_15133_length_729_cov_35.973016	231	311	0	80	80	1.0000000
NODE_15133_length_729_cov_35.973016	284	363	0	79	79	1.0000000
NODE_15134_length_729_cov_18.357143	170	250	0	40	80	0.5000000
NODE_15134_length_729_cov_18.357143	170	250	2	40	80	0.5000000
NODE_15134_length_729_cov_18.357143	223	303	2	80	80	1.0000000
NODE_15135_length_729_cov_17.928571	194	274	2	2	80	0.0250000
NODE_15135_length_729_cov_17.928571	194	274	4	63	80	0.7875000
NODE_15135_length_729_cov_17.928571	194	274	6	15	80	0.1875000
NODE_15135_length_729_cov_17.928571	247	327	2	17	80	0.2125000
NODE_15135_length_729_cov_17.928571	247	327	4	50	80	0.6250000
NODE_15135_length_729_cov_17.928571	247	327	6	13	80	0.1625000
NODE_15136_length_729_cov_17.373016	369	449	0	80	80	1.0000000
NODE_15136_length_729_cov_17.373016	422	502	0	80	80	1.0000000
NODE_15137_length_729_cov_12.452381	347	427	0	15	80	0.1875000
NODE_15137_length_729_cov_12.452381	347	427	1	6	80	0.0750000
NODE_15137_length_729_cov_12.452381	347	427	2	56	80	0.7000000
NODE_15137_length_729_cov_12.452381	347	427	4	3	80	0.0375000
NODE_15137_length_729_cov_12.452381	400	480	2	24	80	0.3000000
NODE_15137_length_729_cov_12.452381	400	480	4	56	80	0.7000000
NODE_15138_length_729_cov_10.388889	296	376	0	80	80	1.0000000
NODE_15138_length_729_cov_10.388889	349	429	0	80	80	1.0000000
NODE_15185_length_728_cov_23.503975	338	418	0	80	80	1.0000000
NODE_15185_length_728_cov_23.503975	391	471	0	80	80	1.0000000
NODE_15186_length_728_cov_22.496025	310	390	0	77	80	0.9625000
NODE_15186_length_728_cov_22.496025	310	390	2	3	80	0.0375000
NODE_15186_length_728_cov_22.496025	363	443	0	80	80	1.0000000
NODE_15187_length_728_cov_16.596184	257	337	0	3	80	0.0375000
NODE_15187_length_728_cov_16.596184	257	337	1	10	80	0.1250000
NODE_15187_length_728_cov_16.596184	257	337	2	67	80	0.8375000
NODE_15187_length_728_cov_16.596184	310	387	0	53	77	0.6883117
NODE_15187_length_728_cov_16.596184	310	387	1	10	77	0.1298701
NODE_15187_length_728_cov_16.596184	310	387	2	14	77	0.1818182
NODE_15188_length_728_cov_16.114467	192	272	0	80	80	1.0000000
NODE_15188_length_728_cov_16.114467	245	325	0	80	80	1.0000000
NODE_15189_length_728_cov_15.128776	298	377	0	21	79	0.2658228
NODE_15189_length_728_cov_15.128776	298	377	4	58	79	0.7341772
NODE_15189_length_728_cov_15.128776	350	430	4	80	80	1.0000000
NODE_15190_length_728_cov_10.613672	269	349	0	80	80	1.0000000
NODE_15190_length_728_cov_10.613672	322	402	0	80	80	1.0000000
NODE_15191_length_728_cov_7.613672	408	488	0	8	80	0.1000000
NODE_15191_length_728_cov_7.613672	408	488	2	72	80	0.9000000
NODE_15191_length_728_cov_7.613672	461	541	0	50	80	0.6250000
NODE_15191_length_728_cov_7.613672	461	541	2	30	80	0.3750000
NODE_15196_length_728_cov_3.405405	335	415	0	80	80	1.0000000
NODE_15244_length_727_cov_34.883758	57	137	2	54	80	0.6750000
NODE_15244_length_727_cov_34.883758	57	137	4	26	80	0.3250000
NODE_15244_length_727_cov_34.883758	57	137	2	54	80	0.6750000
NODE_15244_length_727_cov_34.883758	57	137	4	26	80	0.3250000
NODE_15244_length_727_cov_34.883758	57	137	2	54	80	0.6750000
NODE_15244_length_727_cov_34.883758	57	137	4	26	80	0.3250000
NODE_15244_length_727_cov_34.883758	110	190	0	2	80	0.0250000
NODE_15244_length_727_cov_34.883758	110	190	2	78	80	0.9750000
NODE_15244_length_727_cov_34.883758	110	190	0	2	80	0.0250000
NODE_15244_length_727_cov_34.883758	110	190	2	78	80	0.9750000
NODE_15245_length_727_cov_32.025478	275	355	0	7	80	0.0875000
NODE_15245_length_727_cov_32.025478	275	355	6	15	80	0.1875000
NODE_15245_length_727_cov_32.025478	275	355	10	7	80	0.0875000
NODE_15245_length_727_cov_32.025478	275	355	12	1	80	0.0125000
NODE_15245_length_727_cov_32.025478	275	355	14	15	80	0.1875000
NODE_15245_length_727_cov_32.025478	275	355	16	35	80	0.4375000
NODE_15245_length_727_cov_32.025478	328	408	2	16	80	0.2000000
NODE_15245_length_727_cov_32.025478	328	408	7	1	80	0.0125000
NODE_15245_length_727_cov_32.025478	328	408	8	7	80	0.0875000
NODE_15245_length_727_cov_32.025478	328	408	12	16	80	0.2000000
NODE_15245_length_727_cov_32.025478	328	408	14	16	80	0.2000000
NODE_15245_length_727_cov_32.025478	328	408	16	24	80	0.3000000
NODE_15246_length_727_cov_28.523885	307	381	0	74	74	1.0000000
NODE_15246_length_727_cov_28.523885	360	381	0	21	21	1.0000000
NODE_15246_length_727_cov_28.523885	378	415	0	37	37	1.0000000
NODE_15247_length_727_cov_25.826433	325	405	0	29	80	0.3625000
NODE_15247_length_727_cov_25.826433	325	405	2	51	80	0.6375000
NODE_15247_length_727_cov_25.826433	378	458	0	4	80	0.0500000
NODE_15247_length_727_cov_25.826433	378	458	2	76	80	0.9500000
NODE_15248_length_727_cov_22.253185	150	230	0	1	80	0.0125000
NODE_15248_length_727_cov_22.253185	150	230	2	79	80	0.9875000
NODE_15248_length_727_cov_22.253185	203	283	0	1	80	0.0125000
NODE_15248_length_727_cov_22.253185	203	283	2	79	80	0.9875000
NODE_15249_length_727_cov_18.972930	263	343	2	8	80	0.1000000
NODE_15249_length_727_cov_18.972930	263	343	4	33	80	0.4125000
NODE_15249_length_727_cov_18.972930	263	343	6	39	80	0.4875000
NODE_15249_length_727_cov_18.972930	316	396	0	28	80	0.3500000
NODE_15249_length_727_cov_18.972930	316	396	2	33	80	0.4125000
NODE_15249_length_727_cov_18.972930	316	396	4	19	80	0.2375000
NODE_15250_length_727_cov_15.531847	269	349	2	34	80	0.4250000
NODE_15250_length_727_cov_15.531847	269	349	4	17	80	0.2125000
NODE_15250_length_727_cov_15.531847	269	349	6	29	80	0.3625000
NODE_15250_length_727_cov_15.531847	322	402	0	14	80	0.1750000
NODE_15250_length_727_cov_15.531847	322	402	2	11	80	0.1375000
NODE_15250_length_727_cov_15.531847	322	402	4	45	80	0.5625000
NODE_15250_length_727_cov_15.531847	322	402	6	10	80	0.1250000
NODE_15252_length_727_cov_10.178344	280	360	0	34	80	0.4250000
NODE_15252_length_727_cov_10.178344	280	360	2	46	80	0.5750000
NODE_15252_length_727_cov_10.178344	333	413	0	6	80	0.0750000
NODE_15252_length_727_cov_10.178344	333	413	2	74	80	0.9250000
NODE_15258_length_727_cov_4.955414	360	440	0	80	80	1.0000000
NODE_15258_length_727_cov_4.955414	413	493	0	80	80	1.0000000
NODE_15287_length_726_cov_52.923445	415	495	4	52	80	0.6500000
NODE_15287_length_726_cov_52.923445	415	495	6	12	80	0.1500000
NODE_15287_length_726_cov_52.923445	415	495	8	16	80	0.2000000
NODE_15287_length_726_cov_52.923445	468	548	2	6	80	0.0750000
NODE_15287_length_726_cov_52.923445	468	548	4	62	80	0.7750000
NODE_15287_length_726_cov_52.923445	468	548	8	12	80	0.1500000
NODE_15288_length_726_cov_35.896332	108	188	0	80	80	1.0000000
NODE_15288_length_726_cov_35.896332	161	241	0	74	80	0.9250000
NODE_15288_length_726_cov_35.896332	161	241	2	6	80	0.0750000
NODE_15288_length_726_cov_35.896332	237	317	2	24	80	0.3000000
NODE_15288_length_726_cov_35.896332	237	317	4	56	80	0.7000000
NODE_15288_length_726_cov_35.896332	290	370	0	10	80	0.1250000
NODE_15288_length_726_cov_35.896332	290	370	2	22	80	0.2750000
NODE_15288_length_726_cov_35.896332	290	370	4	48	80	0.6000000
NODE_15291_length_726_cov_8.534290	355	435	0	80	80	1.0000000
NODE_15291_length_726_cov_8.534290	408	488	0	80	80	1.0000000
NODE_15330_length_725_cov_40.856230	203	283	0	80	80	1.0000000
NODE_15330_length_725_cov_40.856230	256	336	0	27	80	0.3375000
NODE_15330_length_725_cov_40.856230	256	336	1	39	80	0.4875000
NODE_15330_length_725_cov_40.856230	256	336	2	14	80	0.1750000
NODE_15330_length_725_cov_40.856230	332	412	2	29	80	0.3625000
NODE_15330_length_725_cov_40.856230	332	412	4	3	80	0.0375000
NODE_15330_length_725_cov_40.856230	332	412	6	12	80	0.1500000
NODE_15330_length_725_cov_40.856230	332	412	8	1	80	0.0125000
NODE_15330_length_725_cov_40.856230	332	412	14	16	80	0.2000000
NODE_15330_length_725_cov_40.856230	332	412	15	1	80	0.0125000
NODE_15330_length_725_cov_40.856230	332	412	16	18	80	0.2250000
NODE_15330_length_725_cov_40.856230	385	465	11	12	80	0.1500000
NODE_15330_length_725_cov_40.856230	385	465	13	11	80	0.1375000
NODE_15330_length_725_cov_40.856230	385	465	14	8	80	0.1000000
NODE_15330_length_725_cov_40.856230	385	465	15	10	80	0.1250000
NODE_15330_length_725_cov_40.856230	385	465	16	39	80	0.4875000
NODE_15331_length_725_cov_25.036741	366	446	0	80	80	1.0000000
NODE_15331_length_725_cov_25.036741	419	499	0	80	80	1.0000000
NODE_15332_length_725_cov_23.009585	455	536	4	81	81	1.0000000
NODE_15333_length_725_cov_20.474441	112	192	0	80	80	1.0000000
NODE_15333_length_725_cov_20.474441	165	245	0	80	80	1.0000000
NODE_15334_length_725_cov_15.455272	106	186	0	80	80	1.0000000
NODE_15334_length_725_cov_15.455272	159	239	0	80	80	1.0000000
NODE_15334_length_725_cov_15.455272	235	315	0	8	80	0.1000000
NODE_15334_length_725_cov_15.455272	235	315	4	37	80	0.4625000
NODE_15334_length_725_cov_15.455272	235	315	6	35	80	0.4375000
NODE_15334_length_725_cov_15.455272	288	368	2	12	80	0.1500000
NODE_15334_length_725_cov_15.455272	288	368	6	68	80	0.8500000
NODE_15335_length_725_cov_10.426518	289	369	0	80	80	1.0000000
NODE_15335_length_725_cov_10.426518	342	422	0	80	80	1.0000000
NODE_15337_length_725_cov_7.781150	189	269	0	80	80	1.0000000
NODE_15337_length_725_cov_7.781150	242	322	0	80	80	1.0000000
NODE_15388_length_724_cov_28.132800	354	434	0	80	80	1.0000000
NODE_15388_length_724_cov_28.132800	407	473	0	66	66	1.0000000
NODE_15389_length_724_cov_24.710400	376	461	0	43	85	0.5058824
NODE_15389_length_724_cov_24.710400	376	461	2	42	85	0.4941176
NODE_15389_length_724_cov_24.710400	434	514	0	80	80	1.0000000
NODE_15390_length_724_cov_13.960000	152	232	0	58	80	0.7250000
NODE_15390_length_724_cov_13.960000	152	232	2	22	80	0.2750000
NODE_15390_length_724_cov_13.960000	205	248	0	43	43	1.0000000
NODE_15390_length_724_cov_13.960000	237	286	0	49	49	1.0000000
NODE_15390_length_724_cov_13.960000	259	302	0	43	43	1.0000000
NODE_15390_length_724_cov_13.960000	288	340	0	52	52	1.0000000
NODE_15390_length_724_cov_13.960000	313	393	0	80	80	1.0000000
NODE_15391_length_724_cov_13.065600	215	295	0	80	80	1.0000000
NODE_15391_length_724_cov_13.065600	268	347	0	79	79	1.0000000
NODE_15393_length_724_cov_10.358400	257	337	0	80	80	1.0000000
NODE_15393_length_724_cov_10.358400	310	385	0	75	75	1.0000000
NODE_15396_length_724_cov_6.451200	151	231	2	16	80	0.2000000
NODE_15396_length_724_cov_6.451200	151	231	4	42	80	0.5250000
NODE_15396_length_724_cov_6.451200	151	231	6	22	80	0.2750000
NODE_15396_length_724_cov_6.451200	202	282	0	8	80	0.1000000
NODE_15396_length_724_cov_6.451200	202	282	2	19	80	0.2375000
NODE_15396_length_724_cov_6.451200	202	282	4	46	80	0.5750000
NODE_15396_length_724_cov_6.451200	202	282	6	7	80	0.0875000
NODE_15397_length_724_cov_5.921600	165	213	0	48	48	1.0000000
NODE_15399_length_724_cov_5.028800	416	469	0	53	53	1.0000000
NODE_15399_length_724_cov_5.028800	488	526	0	16	38	0.4210526
NODE_15399_length_724_cov_5.028800	488	526	2	22	38	0.5789474
NODE_15403_length_724_cov_3.315200	166	246	0	80	80	1.0000000
NODE_15403_length_724_cov_3.315200	219	299	0	80	80	1.0000000
NODE_15442_length_723_cov_81.453526	205	285	4	7	80	0.0875000
NODE_15442_length_723_cov_81.453526	205	285	6	23	80	0.2875000
NODE_15442_length_723_cov_81.453526	205	285	8	38	80	0.4750000
NODE_15442_length_723_cov_81.453526	205	285	10	12	80	0.1500000
NODE_15442_length_723_cov_81.453526	258	338	4	12	80	0.1500000
NODE_15442_length_723_cov_81.453526	258	338	6	54	80	0.6750000
NODE_15442_length_723_cov_81.453526	258	338	8	10	80	0.1250000
NODE_15442_length_723_cov_81.453526	258	338	10	4	80	0.0500000
NODE_15443_length_723_cov_33.075321	254	329	0	75	75	1.0000000
NODE_15443_length_723_cov_33.075321	307	387	0	80	80	1.0000000
NODE_15444_length_723_cov_25.410256	291	371	0	80	80	1.0000000
NODE_15444_length_723_cov_25.410256	344	424	0	80	80	1.0000000
NODE_15445_length_723_cov_18.097756	233	313	0	24	80	0.3000000
NODE_15445_length_723_cov_18.097756	233	313	2	56	80	0.7000000
NODE_15445_length_723_cov_18.097756	286	351	2	65	65	1.0000000
NODE_15446_length_723_cov_14.113782	311	391	0	80	80	1.0000000
NODE_15446_length_723_cov_14.113782	364	444	0	80	80	1.0000000
NODE_15447_length_723_cov_11.634615	299	379	0	80	80	1.0000000
NODE_15447_length_723_cov_11.634615	352	432	0	80	80	1.0000000
NODE_15448_length_723_cov_8.342949	357	437	0	80	80	1.0000000
NODE_15448_length_723_cov_8.342949	410	490	0	80	80	1.0000000
NODE_15455_length_723_cov_2.711538	379	422	0	1	43	0.0232558
NODE_15455_length_723_cov_2.711538	379	422	2	42	43	0.9767442
NODE_15459_length_723_cov_2.573718	383	413	4	30	30	1.0000000
NODE_15495_length_722_cov_19.182986	180	260	0	12	80	0.1500000
NODE_15495_length_722_cov_19.182986	180	260	8	68	80	0.8500000
NODE_15495_length_722_cov_19.182986	233	313	8	80	80	1.0000000
NODE_15496_length_722_cov_13.582665	192	272	0	75	80	0.9375000
NODE_15496_length_722_cov_13.582665	192	272	2	5	80	0.0625000
NODE_15496_length_722_cov_13.582665	245	326	0	22	81	0.2716049
NODE_15496_length_722_cov_13.582665	245	326	2	59	81	0.7283950
NODE_15497_length_722_cov_9.202247	347	427	0	80	80	1.0000000
NODE_15497_length_722_cov_9.202247	400	480	0	80	80	1.0000000
NODE_15500_length_722_cov_6.707865	343	423	2	78	80	0.9750000
NODE_15500_length_722_cov_6.707865	343	423	4	2	80	0.0250000
NODE_15500_length_722_cov_6.707865	396	476	2	65	80	0.8125000
NODE_15500_length_722_cov_6.707865	396	476	4	15	80	0.1875000
NODE_15504_length_722_cov_4.985554	332	393	0	5	61	0.0819672
NODE_15504_length_722_cov_4.985554	332	393	2	56	61	0.9180328
NODE_15508_length_722_cov_3.977528	217	297	0	80	80	1.0000000
NODE_15508_length_722_cov_3.977528	270	350	0	80	80	1.0000000
NODE_15553_length_721_cov_105.927653	425	505	0	80	80	1.0000000
NODE_15553_length_721_cov_105.927653	478	558	0	61	80	0.7625000
NODE_15553_length_721_cov_105.927653	478	558	2	19	80	0.2375000
NODE_15554_length_721_cov_49.660772	304	384	0	80	80	1.0000000
NODE_15554_length_721_cov_49.660772	357	437	0	80	80	1.0000000
NODE_15555_length_721_cov_46.991961	341	421	0	80	80	1.0000000
NODE_15555_length_721_cov_46.991961	394	474	0	80	80	1.0000000
NODE_15556_length_721_cov_38.864952	208	288	0	67	80	0.8375000
NODE_15556_length_721_cov_38.864952	208	288	2	13	80	0.1625000
NODE_15556_length_721_cov_38.864952	269	341	0	6	72	0.0833333
NODE_15556_length_721_cov_38.864952	269	341	2	66	72	0.9166667
NODE_15556_length_721_cov_38.864952	337	417	0	55	80	0.6875000
NODE_15556_length_721_cov_38.864952	337	417	2	25	80	0.3125000
NODE_15556_length_721_cov_38.864952	390	467	0	77	77	1.0000000
NODE_15557_length_721_cov_29.016077	192	272	0	80	80	1.0000000
NODE_15557_length_721_cov_29.016077	251	325	0	74	74	1.0000000
NODE_15558_length_721_cov_26.196141	398	478	0	1	80	0.0125000
NODE_15558_length_721_cov_26.196141	398	478	2	79	80	0.9875000
NODE_15558_length_721_cov_26.196141	451	531	0	19	80	0.2375000
NODE_15558_length_721_cov_26.196141	451	531	2	61	80	0.7625000
NODE_15560_length_721_cov_20.054662	178	258	0	11	80	0.1375000
NODE_15560_length_721_cov_20.054662	178	258	2	69	80	0.8625000
NODE_15560_length_721_cov_20.054662	231	311	0	36	80	0.4500000
NODE_15560_length_721_cov_20.054662	231	311	2	44	80	0.5500000
NODE_15561_length_721_cov_13.670418	263	343	0	21	80	0.2625000
NODE_15561_length_721_cov_13.670418	263	343	2	59	80	0.7375000
NODE_15561_length_721_cov_13.670418	316	396	0	74	80	0.9250000
NODE_15561_length_721_cov_13.670418	316	396	2	6	80	0.0750000
NODE_15562_length_721_cov_13.652733	268	350	0	9	82	0.1097561
NODE_15562_length_721_cov_13.652733	268	350	2	73	82	0.8902439
NODE_15562_length_721_cov_13.652733	321	403	0	46	82	0.5609756
NODE_15562_length_721_cov_13.652733	321	403	2	36	82	0.4390244
NODE_15563_length_721_cov_13.120579	312	392	0	6	80	0.0750000
NODE_15563_length_721_cov_13.120579	312	392	4	62	80	0.7750000
NODE_15563_length_721_cov_13.120579	312	392	6	1	80	0.0125000
NODE_15563_length_721_cov_13.120579	312	392	8	1	80	0.0125000
NODE_15563_length_721_cov_13.120579	312	392	10	10	80	0.1250000
NODE_15563_length_721_cov_13.120579	365	445	4	15	80	0.1875000
NODE_15563_length_721_cov_13.120579	365	445	6	1	80	0.0125000
NODE_15563_length_721_cov_13.120579	365	445	8	30	80	0.3750000
NODE_15563_length_721_cov_13.120579	365	445	10	28	80	0.3500000
NODE_15563_length_721_cov_13.120579	365	445	12	6	80	0.0750000
NODE_15572_length_721_cov_4.491961	210	280	0	39	70	0.5571429
NODE_15572_length_721_cov_4.491961	210	280	2	31	70	0.4428571
NODE_15572_length_721_cov_4.491961	253	333	0	76	80	0.9500000
NODE_15572_length_721_cov_4.491961	253	333	2	4	80	0.0500000
NODE_15572_length_721_cov_4.491961	470	521	0	51	51	1.0000000
NODE_15608_length_720_cov_17.449275	267	347	0	1	80	0.0125000
NODE_15608_length_720_cov_17.449275	267	347	2	34	80	0.4250000
NODE_15608_length_720_cov_17.449275	267	347	4	45	80	0.5625000
NODE_15608_length_720_cov_17.449275	320	400	2	58	80	0.7250000
NODE_15608_length_720_cov_17.449275	320	400	4	22	80	0.2750000
NODE_15609_length_720_cov_14.814815	261	341	0	80	80	1.0000000
NODE_15609_length_720_cov_14.814815	314	394	0	80	80	1.0000000
NODE_15610_length_720_cov_14.107890	290	370	4	80	80	1.0000000
NODE_15610_length_720_cov_14.107890	343	423	0	42	80	0.5250000
NODE_15610_length_720_cov_14.107890	343	423	4	38	80	0.4750000
NODE_15612_length_720_cov_12.924316	314	394	0	16	80	0.2000000
NODE_15612_length_720_cov_12.924316	314	394	2	64	80	0.8000000
NODE_15612_length_720_cov_12.924316	367	447	0	34	80	0.4250000
NODE_15612_length_720_cov_12.924316	367	447	2	46	80	0.5750000
NODE_15614_length_720_cov_10.389694	435	515	2	80	80	1.0000000
NODE_15614_length_720_cov_10.389694	488	568	0	42	80	0.5250000
NODE_15614_length_720_cov_10.389694	488	568	2	38	80	0.4750000
NODE_15620_length_720_cov_5.278583	309	389	0	6	80	0.0750000
NODE_15620_length_720_cov_5.278583	309	389	1	44	80	0.5500000
NODE_15620_length_720_cov_5.278583	309	389	2	30	80	0.3750000
NODE_15620_length_720_cov_5.278583	362	442	1	80	80	1.0000000
NODE_15624_length_720_cov_3.792271	157	235	0	78	78	1.0000000
NODE_15624_length_720_cov_3.792271	215	265	0	50	50	1.0000000
NODE_15658_length_719_cov_30.256452	279	359	0	80	80	1.0000000
NODE_15658_length_719_cov_30.256452	332	412	0	80	80	1.0000000
NODE_15659_length_719_cov_29.093548	310	390	0	80	80	1.0000000
NODE_15659_length_719_cov_29.093548	363	443	0	80	80	1.0000000
NODE_15660_length_719_cov_10.988710	195	275	0	3	80	0.0375000
NODE_15660_length_719_cov_10.988710	195	275	1	37	80	0.4625000
NODE_15660_length_719_cov_10.988710	195	275	2	14	80	0.1750000
NODE_15660_length_719_cov_10.988710	195	275	3	26	80	0.3250000
NODE_15660_length_719_cov_10.988710	248	328	1	47	80	0.5875000
NODE_15660_length_719_cov_10.988710	248	328	2	33	80	0.4125000
NODE_15661_length_719_cov_10.837097	259	339	0	80	80	1.0000000
NODE_15661_length_719_cov_10.837097	312	392	0	80	80	1.0000000
NODE_15662_length_719_cov_7.622581	288	368	0	80	80	1.0000000
NODE_15662_length_719_cov_7.622581	341	421	0	80	80	1.0000000
NODE_15663_length_719_cov_7.570968	351	431	0	80	80	1.0000000
NODE_15663_length_719_cov_7.570968	404	484	0	80	80	1.0000000
NODE_15672_length_719_cov_4.264516	251	281	2	30	30	1.0000000
NODE_15684_length_719_cov_1.629032	88	163	0	13	75	0.1733333
NODE_15684_length_719_cov_1.629032	88	163	2	62	75	0.8266667
NODE_15706_length_718_cov_35.382876	296	376	0	80	80	1.0000000
NODE_15706_length_718_cov_35.382876	296	376	0	80	80	1.0000000
NODE_15706_length_718_cov_35.382876	349	429	0	80	80	1.0000000
NODE_15706_length_718_cov_35.382876	349	429	0	80	80	1.0000000
NODE_15707_length_718_cov_24.211632	313	393	0	80	80	1.0000000
NODE_15707_length_718_cov_24.211632	366	446	0	80	80	1.0000000
NODE_15708_length_718_cov_18.300485	217	297	2	9	80	0.1125000
NODE_15708_length_718_cov_18.300485	217	297	4	23	80	0.2875000
NODE_15708_length_718_cov_18.300485	217	297	6	48	80	0.6000000
NODE_15708_length_718_cov_18.300485	270	350	2	62	80	0.7750000
NODE_15708_length_718_cov_18.300485	270	350	4	2	80	0.0250000
NODE_15708_length_718_cov_18.300485	270	350	6	16	80	0.2000000
NODE_15709_length_718_cov_14.757674	383	463	0	80	80	1.0000000
NODE_15709_length_718_cov_14.757674	436	516	0	80	80	1.0000000
NODE_15710_length_718_cov_14.355412	254	334	0	53	80	0.6625000
NODE_15710_length_718_cov_14.355412	254	334	2	2	80	0.0250000
NODE_15710_length_718_cov_14.355412	254	334	4	25	80	0.3125000
NODE_15710_length_718_cov_14.355412	307	387	2	15	80	0.1875000
NODE_15710_length_718_cov_14.355412	307	387	4	65	80	0.8125000
NODE_15715_length_718_cov_4.804523	263	343	0	65	80	0.8125000
NODE_15715_length_718_cov_4.804523	263	343	8	15	80	0.1875000
NODE_15715_length_718_cov_4.804523	316	396	0	12	80	0.1500000
NODE_15715_length_718_cov_4.804523	316	396	8	68	80	0.8500000
NODE_15750_length_717_cov_28.377023	335	415	0	6	80	0.0750000
NODE_15750_length_717_cov_28.377023	335	415	2	12	80	0.1500000
NODE_15750_length_717_cov_28.377023	335	415	7	62	80	0.7750000
NODE_15750_length_717_cov_28.377023	388	468	0	59	80	0.7375000
NODE_15750_length_717_cov_28.377023	388	468	2	12	80	0.1500000
NODE_15750_length_717_cov_28.377023	388	468	7	9	80	0.1125000
NODE_15751_length_717_cov_23.275081	162	242	0	80	80	1.0000000
NODE_15751_length_717_cov_23.275081	215	295	0	80	80	1.0000000
NODE_15752_length_717_cov_18.564725	319	399	0	53	80	0.6625000
NODE_15752_length_717_cov_18.564725	319	399	2	27	80	0.3375000
NODE_15752_length_717_cov_18.564725	372	452	2	80	80	1.0000000
NODE_15753_length_717_cov_18.389968	358	438	0	27	80	0.3375000
NODE_15753_length_717_cov_18.389968	358	438	2	21	80	0.2625000
NODE_15753_length_717_cov_18.389968	358	438	4	14	80	0.1750000
NODE_15753_length_717_cov_18.389968	358	438	6	18	80	0.2250000
NODE_15753_length_717_cov_18.389968	411	491	0	5	80	0.0625000
NODE_15753_length_717_cov_18.389968	411	491	2	5	80	0.0625000
NODE_15753_length_717_cov_18.389968	411	491	3	1	80	0.0125000
NODE_15753_length_717_cov_18.389968	411	491	4	16	80	0.2000000
NODE_15753_length_717_cov_18.389968	411	491	6	53	80	0.6625000
NODE_15754_length_717_cov_17.932039	241	321	14	8	80	0.1000000
NODE_15754_length_717_cov_17.932039	241	321	16	8	80	0.1000000
NODE_15754_length_717_cov_17.932039	241	321	18	23	80	0.2875000
NODE_15754_length_717_cov_17.932039	241	321	19	9	80	0.1125000
NODE_15754_length_717_cov_17.932039	241	321	20	18	80	0.2250000
NODE_15754_length_717_cov_17.932039	241	321	21	14	80	0.1750000
NODE_15754_length_717_cov_17.932039	294	374	4	12	80	0.1500000
NODE_15754_length_717_cov_17.932039	294	374	7	13	80	0.1625000
NODE_15754_length_717_cov_17.932039	294	374	11	4	80	0.0500000
NODE_15754_length_717_cov_17.932039	294	374	16	20	80	0.2500000
NODE_15754_length_717_cov_17.932039	294	374	18	3	80	0.0375000
NODE_15754_length_717_cov_17.932039	294	374	19	9	80	0.1125000
NODE_15754_length_717_cov_17.932039	294	374	20	5	80	0.0625000
NODE_15754_length_717_cov_17.932039	294	374	21	14	80	0.1750000
NODE_15755_length_717_cov_14.637540	298	378	0	80	80	1.0000000
NODE_15755_length_717_cov_14.637540	351	431	0	80	80	1.0000000
NODE_15756_length_717_cov_12.279935	113	196	0	76	83	0.9156626
NODE_15756_length_717_cov_12.279935	113	196	2	7	83	0.0843373
NODE_15756_length_717_cov_12.279935	169	249	0	20	80	0.2500000
NODE_15756_length_717_cov_12.279935	169	249	2	60	80	0.7500000
NODE_15757_length_717_cov_10.711974	353	431	0	43	78	0.5512820
NODE_15757_length_717_cov_10.711974	353	431	2	8	78	0.1025641
NODE_15757_length_717_cov_10.711974	353	431	4	27	78	0.3461539
NODE_15758_length_717_cov_9.399676	331	411	0	80	80	1.0000000
NODE_15758_length_717_cov_9.399676	384	464	0	80	80	1.0000000
NODE_15762_length_717_cov_5.341424	475	555	2	64	80	0.8000000
NODE_15762_length_717_cov_5.341424	475	555	4	16	80	0.2000000
NODE_15762_length_717_cov_5.341424	528	608	2	28	80	0.3500000
NODE_15762_length_717_cov_5.341424	528	608	4	52	80	0.6500000
NODE_15770_length_717_cov_3.187702	285	322	0	37	37	1.0000000
NODE_15805_length_716_cov_16.800648	430	510	0	80	80	1.0000000
NODE_15805_length_716_cov_16.800648	483	563	0	80	80	1.0000000
NODE_15806_length_716_cov_12.565640	356	436	0	80	80	1.0000000
NODE_15806_length_716_cov_12.565640	409	489	0	80	80	1.0000000
NODE_15807_length_716_cov_9.277147	385	465	0	15	80	0.1875000
NODE_15807_length_716_cov_9.277147	385	465	2	4	80	0.0500000
NODE_15807_length_716_cov_9.277147	385	465	4	61	80	0.7625000
NODE_15807_length_716_cov_9.277147	438	518	0	68	80	0.8500000
NODE_15807_length_716_cov_9.277147	438	518	2	4	80	0.0500000
NODE_15807_length_716_cov_9.277147	438	518	4	8	80	0.1000000
NODE_15808_length_716_cov_9.257699	302	382	0	80	80	1.0000000
NODE_15808_length_716_cov_9.257699	355	435	0	80	80	1.0000000
NODE_15809_length_716_cov_6.761750	263	343	0	80	80	1.0000000
NODE_15809_length_716_cov_6.761750	316	396	0	80	80	1.0000000
NODE_15812_length_716_cov_4.909238	236	316	0	80	80	1.0000000
NODE_15812_length_716_cov_4.909238	289	369	0	64	80	0.8000000
NODE_15812_length_716_cov_4.909238	289	369	2	16	80	0.2000000
NODE_15824_length_716_cov_2.068071	453	481	2	28	28	1.0000000
NODE_15853_length_715_cov_38.795455	260	340	0	80	80	1.0000000
NODE_15853_length_715_cov_38.795455	313	393	0	80	80	1.0000000
NODE_15854_length_715_cov_30.344156	316	396	0	80	80	1.0000000
NODE_15854_length_715_cov_30.344156	369	449	0	80	80	1.0000000
NODE_15857_length_715_cov_11.209416	484	564	0	14	80	0.1750000
NODE_15857_length_715_cov_11.209416	484	564	2	66	80	0.8250000
NODE_15857_length_715_cov_11.209416	537	617	0	67	80	0.8375000
NODE_15857_length_715_cov_11.209416	537	617	2	13	80	0.1625000
NODE_15858_length_715_cov_10.894481	189	242	2	53	53	1.0000000
NODE_15859_length_715_cov_10.628247	502	582	0	24	80	0.3000000
NODE_15859_length_715_cov_10.628247	502	582	4	56	80	0.7000000
NODE_15859_length_715_cov_10.628247	555	635	0	13	80	0.1625000
NODE_15859_length_715_cov_10.628247	555	635	4	67	80	0.8375000
NODE_15860_length_715_cov_8.647727	138	218	0	60	80	0.7500000
NODE_15860_length_715_cov_8.647727	138	218	2	20	80	0.2500000
NODE_15860_length_715_cov_8.647727	191	271	0	80	80	1.0000000
NODE_15861_length_715_cov_8.412338	364	444	0	80	80	1.0000000
NODE_15861_length_715_cov_8.412338	417	497	0	80	80	1.0000000
NODE_15864_length_715_cov_5.373377	318	398	0	16	80	0.2000000
NODE_15864_length_715_cov_5.373377	318	398	2	64	80	0.8000000
NODE_15864_length_715_cov_5.373377	371	451	0	47	80	0.5875000
NODE_15864_length_715_cov_5.373377	371	451	2	33	80	0.4125000
NODE_15898_length_715_cov_1.271104	331	397	0	66	66	1.0000000
NODE_15910_length_714_cov_18.621138	297	377	0	75	80	0.9375000
NODE_15910_length_714_cov_18.621138	297	377	2	5	80	0.0625000
NODE_15910_length_714_cov_18.621138	350	430	0	80	80	1.0000000
NODE_15911_length_714_cov_15.468293	268	348	0	80	80	1.0000000
NODE_15911_length_714_cov_15.468293	321	401	0	80	80	1.0000000
NODE_15913_length_714_cov_10.530081	218	298	0	80	80	1.0000000
NODE_15913_length_714_cov_10.530081	271	351	0	80	80	1.0000000
NODE_15913_length_714_cov_10.530081	354	434	0	80	80	1.0000000
NODE_15913_length_714_cov_10.530081	407	487	0	80	80	1.0000000
NODE_15914_length_714_cov_8.365854	285	365	0	80	80	1.0000000
NODE_15914_length_714_cov_8.365854	338	418	0	80	80	1.0000000
NODE_15919_length_714_cov_6.993496	263	343	6	42	80	0.5250000
NODE_15919_length_714_cov_6.993496	263	343	8	38	80	0.4750000
NODE_15919_length_714_cov_6.993496	316	384	0	7	68	0.1029412
NODE_15919_length_714_cov_6.993496	316	384	2	12	68	0.1764706
NODE_15919_length_714_cov_6.993496	316	384	4	1	68	0.0147059
NODE_15919_length_714_cov_6.993496	316	384	6	48	68	0.7058824
NODE_15921_length_714_cov_4.224390	218	288	2	70	70	1.0000000
NODE_15921_length_714_cov_4.224390	271	351	0	52	80	0.6500000
NODE_15921_length_714_cov_4.224390	271	351	2	28	80	0.3500000
NODE_15969_length_713_cov_19.304560	271	351	2	72	80	0.9000000
NODE_15969_length_713_cov_19.304560	271	351	4	8	80	0.1000000
NODE_15969_length_713_cov_19.304560	324	404	0	5	80	0.0625000
NODE_15969_length_713_cov_19.304560	324	404	2	75	80	0.9375000
NODE_15970_length_713_cov_16.926710	262	342	0	61	80	0.7625000
NODE_15970_length_713_cov_16.926710	262	342	2	8	80	0.1000000
NODE_15970_length_713_cov_16.926710	262	342	3	3	80	0.0375000
NODE_15970_length_713_cov_16.926710	262	342	4	8	80	0.1000000
NODE_15970_length_713_cov_16.926710	315	395	0	8	80	0.1000000
NODE_15970_length_713_cov_16.926710	315	395	2	8	80	0.1000000
NODE_15970_length_713_cov_16.926710	315	395	3	3	80	0.0375000
NODE_15970_length_713_cov_16.926710	315	395	4	61	80	0.7625000
NODE_15973_length_713_cov_7.159609	351	431	0	80	80	1.0000000
NODE_15973_length_713_cov_7.159609	404	484	0	80	80	1.0000000
NODE_15974_length_713_cov_6.723127	379	427	8	14	48	0.2916667
NODE_15974_length_713_cov_6.723127	379	427	10	34	48	0.7083333
NODE_15975_length_713_cov_4.954397	90	171	0	65	81	0.8024691
NODE_15975_length_713_cov_4.954397	90	171	2	16	81	0.1975309
NODE_15975_length_713_cov_4.954397	144	224	0	80	80	1.0000000
NODE_15980_length_713_cov_4.302932	402	482	0	80	80	1.0000000
NODE_15980_length_713_cov_4.302932	455	535	0	80	80	1.0000000
NODE_16004_length_713_cov_1.939739	15	75	0	60	60	1.0000000
NODE_16010_length_713_cov_1.605863	81	161	0	80	80	1.0000000
NODE_16010_length_713_cov_1.605863	134	214	0	80	80	1.0000000
NODE_16052_length_712_cov_32.931485	289	369	0	80	80	1.0000000
NODE_16052_length_712_cov_32.931485	342	422	0	80	80	1.0000000
NODE_16053_length_712_cov_31.752039	185	251	0	66	66	1.0000000
NODE_16053_length_712_cov_31.752039	228	307	0	79	79	1.0000000
NODE_16054_length_712_cov_22.567700	228	308	0	80	80	1.0000000
NODE_16054_length_712_cov_22.567700	281	361	0	80	80	1.0000000
NODE_16055_length_712_cov_19.306688	238	318	2	80	80	1.0000000
NODE_16055_length_712_cov_19.306688	291	371	0	37	80	0.4625000
NODE_16055_length_712_cov_19.306688	291	371	2	43	80	0.5375000
NODE_16056_length_712_cov_14.929853	332	412	0	3	80	0.0375000
NODE_16056_length_712_cov_14.929853	332	412	2	77	80	0.9625000
NODE_16056_length_712_cov_14.929853	385	465	0	45	80	0.5625000
NODE_16056_length_712_cov_14.929853	385	465	2	35	80	0.4375000
NODE_16057_length_712_cov_14.228385	250	330	1	21	80	0.2625000
NODE_16057_length_712_cov_14.228385	250	330	3	10	80	0.1250000
NODE_16057_length_712_cov_14.228385	250	330	4	43	80	0.5375000
NODE_16057_length_712_cov_14.228385	250	330	5	6	80	0.0750000
NODE_16057_length_712_cov_14.228385	303	383	1	2	80	0.0250000
NODE_16057_length_712_cov_14.228385	303	383	3	26	80	0.3250000
NODE_16057_length_712_cov_14.228385	303	383	4	52	80	0.6500000
NODE_16059_length_712_cov_9.221860	326	406	0	80	80	1.0000000
NODE_16059_length_712_cov_9.221860	379	463	0	84	84	1.0000000
NODE_16060_length_712_cov_8.368679	331	411	0	50	80	0.6250000
NODE_16060_length_712_cov_8.368679	331	411	2	30	80	0.3750000
NODE_16060_length_712_cov_8.368679	384	464	2	80	80	1.0000000
NODE_16079_length_712_cov_2.350734	466	510	0	43	44	0.9772727
NODE_16079_length_712_cov_2.350734	466	510	2	1	44	0.0227273
NODE_16118_length_711_cov_36.459150	146	223	0	36	77	0.4675325
NODE_16118_length_711_cov_36.459150	146	223	4	41	77	0.5324675
NODE_16118_length_711_cov_36.459150	199	280	0	40	81	0.4938272
NODE_16118_length_711_cov_36.459150	199	280	4	41	81	0.5061728
NODE_16119_length_711_cov_26.702614	460	540	0	30	80	0.3750000
NODE_16119_length_711_cov_26.702614	460	540	2	4	80	0.0500000
NODE_16119_length_711_cov_26.702614	460	540	4	46	80	0.5750000
NODE_16119_length_711_cov_26.702614	513	593	4	27	80	0.3375000
NODE_16119_length_711_cov_26.702614	513	593	6	53	80	0.6625000
NODE_16120_length_711_cov_19.632353	329	409	0	55	80	0.6875000
NODE_16120_length_711_cov_19.632353	329	409	4	25	80	0.3125000
NODE_16120_length_711_cov_19.632353	382	462	0	2	80	0.0250000
NODE_16120_length_711_cov_19.632353	382	462	4	31	80	0.3875000
NODE_16120_length_711_cov_19.632353	382	462	8	47	80	0.5875000
NODE_16121_length_711_cov_19.267974	283	363	0	21	80	0.2625000
NODE_16121_length_711_cov_19.267974	283	363	2	59	80	0.7375000
NODE_16121_length_711_cov_19.267974	336	416	0	23	80	0.2875000
NODE_16121_length_711_cov_19.267974	336	416	2	57	80	0.7125000
NODE_16122_length_711_cov_12.813725	255	334	0	79	79	1.0000000
NODE_16123_length_711_cov_12.147059	314	394	0	71	80	0.8875000
NODE_16123_length_711_cov_12.147059	314	394	2	9	80	0.1125000
NODE_16123_length_711_cov_12.147059	367	447	0	18	80	0.2250000
NODE_16123_length_711_cov_12.147059	367	447	2	62	80	0.7750000
NODE_16124_length_711_cov_10.009804	336	415	2	2	79	0.0253165
NODE_16124_length_711_cov_10.009804	336	415	4	77	79	0.9746835
NODE_16127_length_711_cov_5.619281	276	356	0	80	80	1.0000000
NODE_16127_length_711_cov_5.619281	329	409	0	80	80	1.0000000
NODE_16130_length_711_cov_4.040850	165	245	0	80	80	1.0000000
NODE_16130_length_711_cov_4.040850	218	298	0	80	80	1.0000000
NODE_16167_length_710_cov_73.721768	626	706	0	80	80	1.0000000
NODE_16168_length_710_cov_21.772504	292	372	2	37	80	0.4625000
NODE_16168_length_710_cov_21.772504	292	372	4	17	80	0.2125000
NODE_16168_length_710_cov_21.772504	292	372	6	4	80	0.0500000
NODE_16168_length_710_cov_21.772504	292	372	8	11	80	0.1375000
NODE_16168_length_710_cov_21.772504	292	372	12	11	80	0.1375000
NODE_16168_length_710_cov_21.772504	345	425	4	1	80	0.0125000
NODE_16168_length_710_cov_21.772504	345	425	6	4	80	0.0500000
NODE_16168_length_710_cov_21.772504	345	425	8	11	80	0.1375000
NODE_16168_length_710_cov_21.772504	345	425	10	5	80	0.0625000
NODE_16168_length_710_cov_21.772504	345	425	12	59	80	0.7375000
NODE_16169_length_710_cov_21.597381	18	54	0	36	36	1.0000000
NODE_16170_length_710_cov_13.155483	306	386	2	7	80	0.0875000
NODE_16170_length_710_cov_13.155483	306	386	4	73	80	0.9125000
NODE_16170_length_710_cov_13.155483	359	439	2	59	80	0.7375000
NODE_16170_length_710_cov_13.155483	359	439	4	21	80	0.2625000
NODE_16173_length_710_cov_8.031097	316	396	0	2	80	0.0250000
NODE_16173_length_710_cov_8.031097	316	396	2	18	80	0.2250000
NODE_16173_length_710_cov_8.031097	316	396	4	60	80	0.7500000
NODE_16173_length_710_cov_8.031097	369	449	2	42	80	0.5250000
NODE_16173_length_710_cov_8.031097	369	449	4	38	80	0.4750000
NODE_16175_length_710_cov_6.664484	264	344	0	21	80	0.2625000
NODE_16175_length_710_cov_6.664484	264	344	2	59	80	0.7375000
NODE_16178_length_710_cov_5.590835	352	421	0	55	69	0.7971014
NODE_16178_length_710_cov_5.590835	352	421	4	4	69	0.0579710
NODE_16178_length_710_cov_5.590835	352	421	6	10	69	0.1449275
NODE_16178_length_710_cov_5.590835	394	474	0	13	80	0.1625000
NODE_16178_length_710_cov_5.590835	394	474	4	4	80	0.0500000
NODE_16178_length_710_cov_5.590835	394	474	6	63	80	0.7875000
NODE_16180_length_710_cov_5.356792	248	328	10	14	80	0.1750000
NODE_16180_length_710_cov_5.356792	248	328	12	18	80	0.2250000
NODE_16180_length_710_cov_5.356792	248	328	14	21	80	0.2625000
NODE_16180_length_710_cov_5.356792	248	328	16	3	80	0.0375000
NODE_16180_length_710_cov_5.356792	248	328	18	23	80	0.2875000
NODE_16180_length_710_cov_5.356792	248	328	20	1	80	0.0125000
NODE_16180_length_710_cov_5.356792	301	381	4	14	80	0.1750000
NODE_16180_length_710_cov_5.356792	301	381	6	3	80	0.0375000
NODE_16180_length_710_cov_5.356792	301	381	8	2	80	0.0250000
NODE_16180_length_710_cov_5.356792	301	381	16	3	80	0.0375000
NODE_16180_length_710_cov_5.356792	301	381	17	1	80	0.0125000
NODE_16180_length_710_cov_5.356792	301	381	18	56	80	0.7000000
NODE_16180_length_710_cov_5.356792	301	381	20	1	80	0.0125000
NODE_16233_length_709_cov_12.227869	347	427	0	46	80	0.5750000
NODE_16233_length_709_cov_12.227869	347	427	2	34	80	0.4250000
NODE_16233_length_709_cov_12.227869	400	480	2	80	80	1.0000000
NODE_16234_length_709_cov_10.531148	279	359	0	80	80	1.0000000
NODE_16234_length_709_cov_10.531148	332	412	0	80	80	1.0000000
NODE_16238_length_709_cov_7.181967	225	305	0	80	80	1.0000000
NODE_16238_length_709_cov_7.181967	279	312	0	33	33	1.0000000
NODE_16241_length_709_cov_5.888525	239	319	0	21	80	0.2625000
NODE_16241_length_709_cov_5.888525	239	319	2	59	80	0.7375000
NODE_16241_length_709_cov_5.888525	292	372	0	74	80	0.9250000
NODE_16241_length_709_cov_5.888525	292	372	2	6	80	0.0750000
NODE_16294_length_708_cov_42.435140	307	387	2	66	80	0.8250000
NODE_16294_length_708_cov_42.435140	307	387	4	14	80	0.1750000
NODE_16294_length_708_cov_42.435140	360	440	0	45	80	0.5625000
NODE_16294_length_708_cov_42.435140	360	440	2	35	80	0.4375000
NODE_16296_length_708_cov_33.412151	235	315	0	36	80	0.4500000
NODE_16296_length_708_cov_33.412151	235	315	2	44	80	0.5500000
NODE_16296_length_708_cov_33.412151	288	368	0	25	80	0.3125000
NODE_16296_length_708_cov_33.412151	288	368	2	55	80	0.6875000
NODE_16297_length_708_cov_23.034483	316	396	0	80	80	1.0000000
NODE_16297_length_708_cov_23.034483	369	449	0	80	80	1.0000000
NODE_16298_length_708_cov_20.449918	254	334	0	80	80	1.0000000
NODE_16298_length_708_cov_20.449918	307	387	0	80	80	1.0000000
NODE_16299_length_708_cov_19.998358	238	318	0	80	80	1.0000000
NODE_16299_length_708_cov_19.998358	291	371	0	80	80	1.0000000
NODE_16300_length_708_cov_19.021346	366	446	0	80	80	1.0000000
NODE_16300_length_708_cov_19.021346	419	499	0	80	80	1.0000000
NODE_16302_length_708_cov_12.228243	181	263	2	82	82	1.0000000
NODE_16302_length_708_cov_12.228243	188	268	2	80	80	1.0000000
NODE_16302_length_708_cov_12.228243	236	316	0	47	80	0.5875000
NODE_16302_length_708_cov_12.228243	236	316	2	33	80	0.4125000
NODE_16302_length_708_cov_12.228243	312	392	0	3	80	0.0375000
NODE_16302_length_708_cov_12.228243	312	392	2	52	80	0.6500000
NODE_16302_length_708_cov_12.228243	312	392	4	8	80	0.1000000
NODE_16302_length_708_cov_12.228243	312	392	6	6	80	0.0750000
NODE_16302_length_708_cov_12.228243	312	392	8	2	80	0.0250000
NODE_16302_length_708_cov_12.228243	312	392	10	9	80	0.1125000
NODE_16302_length_708_cov_12.228243	312	392	0	3	80	0.0375000
NODE_16302_length_708_cov_12.228243	312	392	2	52	80	0.6500000
NODE_16302_length_708_cov_12.228243	312	392	4	8	80	0.1000000
NODE_16302_length_708_cov_12.228243	312	392	6	6	80	0.0750000
NODE_16302_length_708_cov_12.228243	312	392	8	2	80	0.0250000
NODE_16302_length_708_cov_12.228243	312	392	10	9	80	0.1125000
NODE_16302_length_708_cov_12.228243	365	445	2	2	80	0.0250000
NODE_16302_length_708_cov_12.228243	365	445	4	8	80	0.1000000
NODE_16302_length_708_cov_12.228243	365	445	6	6	80	0.0750000
NODE_16302_length_708_cov_12.228243	365	445	8	55	80	0.6875000
NODE_16302_length_708_cov_12.228243	365	445	10	9	80	0.1125000
NODE_16303_length_708_cov_11.338259	255	335	0	80	80	1.0000000
NODE_16303_length_708_cov_11.338259	308	388	0	80	80	1.0000000
NODE_16305_length_708_cov_9.676519	219	299	0	80	80	1.0000000
NODE_16305_length_708_cov_9.676519	272	352	0	80	80	1.0000000
NODE_16306_length_708_cov_8.638752	324	399	0	75	75	1.0000000
NODE_16330_length_708_cov_2.699507	358	398	0	40	40	1.0000000
NODE_16370_length_707_cov_30.067434	325	405	4	12	80	0.1500000
NODE_16370_length_707_cov_30.067434	325	405	6	68	80	0.8500000
NODE_16370_length_707_cov_30.067434	378	458	0	36	80	0.4500000
NODE_16370_length_707_cov_30.067434	378	458	4	29	80	0.3625000
NODE_16370_length_707_cov_30.067434	378	458	6	15	80	0.1875000
NODE_16371_length_707_cov_26.555921	241	321	0	18	80	0.2250000
NODE_16371_length_707_cov_26.555921	241	321	2	62	80	0.7750000
NODE_16371_length_707_cov_26.555921	294	374	0	23	80	0.2875000
NODE_16371_length_707_cov_26.555921	294	374	2	57	80	0.7125000
NODE_16372_length_707_cov_23.972039	322	402	0	80	80	1.0000000
NODE_16372_length_707_cov_23.972039	375	455	0	80	80	1.0000000
NODE_16373_length_707_cov_20.348684	157	237	0	57	80	0.7125000
NODE_16373_length_707_cov_20.348684	157	237	3	1	80	0.0125000
NODE_16373_length_707_cov_20.348684	157	237	4	22	80	0.2750000
NODE_16373_length_707_cov_20.348684	210	281	0	4	71	0.0563380
NODE_16373_length_707_cov_20.348684	210	281	3	1	71	0.0140845
NODE_16373_length_707_cov_20.348684	210	281	4	66	71	0.9295775
NODE_16374_length_707_cov_18.970395	253	333	0	43	80	0.5375000
NODE_16374_length_707_cov_18.970395	253	333	2	37	80	0.4625000
NODE_16374_length_707_cov_18.970395	306	386	0	17	80	0.2125000
NODE_16374_length_707_cov_18.970395	306	386	2	63	80	0.7875000
NODE_16375_length_707_cov_14.324013	302	382	2	80	80	1.0000000
NODE_16375_length_707_cov_14.324013	355	435	0	7	80	0.0875000
NODE_16375_length_707_cov_14.324013	355	435	2	73	80	0.9125000
NODE_16378_length_707_cov_5.062500	313	393	0	9	80	0.1125000
NODE_16378_length_707_cov_5.062500	313	393	2	71	80	0.8875000
NODE_16441_length_706_cov_34.116969	272	352	0	36	80	0.4500000
NODE_16441_length_706_cov_34.116969	272	352	2	44	80	0.5500000
NODE_16441_length_706_cov_34.116969	325	405	0	28	80	0.3500000
NODE_16441_length_706_cov_34.116969	325	405	2	52	80	0.6500000
NODE_16442_length_706_cov_27.220758	229	309	0	16	80	0.2000000
NODE_16442_length_706_cov_27.220758	229	309	2	64	80	0.8000000
NODE_16442_length_706_cov_27.220758	282	362	0	28	80	0.3500000
NODE_16442_length_706_cov_27.220758	282	362	2	52	80	0.6500000
NODE_16443_length_706_cov_20.380560	264	344	0	21	80	0.2625000
NODE_16443_length_706_cov_20.380560	264	344	2	59	80	0.7375000
NODE_16443_length_706_cov_20.380560	317	397	0	45	80	0.5625000
NODE_16443_length_706_cov_20.380560	317	397	2	35	80	0.4375000
NODE_16444_length_706_cov_19.525535	289	369	0	80	80	1.0000000
NODE_16444_length_706_cov_19.525535	342	422	0	80	80	1.0000000
NODE_16454_length_706_cov_3.344316	465	545	2	49	80	0.6125000
NODE_16454_length_706_cov_3.344316	465	545	4	2	80	0.0250000
NODE_16454_length_706_cov_3.344316	465	545	6	29	80	0.3625000
NODE_16454_length_706_cov_3.344316	518	598	0	51	80	0.6375000
NODE_16454_length_706_cov_3.344316	518	598	2	29	80	0.3625000
NODE_16494_length_705_cov_19.211221	118	198	0	80	80	1.0000000
NODE_16494_length_705_cov_19.211221	171	250	0	79	79	1.0000000
NODE_16495_length_705_cov_16.338284	291	339	2	45	48	0.9375000
NODE_16495_length_705_cov_16.338284	291	339	6	3	48	0.0625000
NODE_16495_length_705_cov_16.338284	336	406	5	48	70	0.6857143
NODE_16495_length_705_cov_16.338284	336	406	6	12	70	0.1714286
NODE_16495_length_705_cov_16.338284	336	406	7	10	70	0.1428571
NODE_16496_length_705_cov_14.354785	209	289	0	80	80	1.0000000
NODE_16496_length_705_cov_14.354785	262	342	0	80	80	1.0000000
NODE_16497_length_705_cov_12.231023	293	373	0	44	80	0.5500000
NODE_16497_length_705_cov_12.231023	293	373	2	36	80	0.4500000
NODE_16497_length_705_cov_12.231023	346	426	0	80	80	1.0000000
NODE_16498_length_705_cov_11.836634	390	470	0	28	80	0.3500000
NODE_16498_length_705_cov_11.836634	390	470	1	3	80	0.0375000
NODE_16498_length_705_cov_11.836634	390	470	2	49	80	0.6125000
NODE_16498_length_705_cov_11.836634	443	523	2	80	80	1.0000000
NODE_16499_length_705_cov_10.049505	382	479	0	25	97	0.2577319
NODE_16499_length_705_cov_10.049505	382	479	2	72	97	0.7422680
NODE_16499_length_705_cov_10.049505	452	532	2	80	80	1.0000000
NODE_16507_length_705_cov_4.275578	358	438	0	80	80	1.0000000
NODE_16507_length_705_cov_4.275578	411	491	0	80	80	1.0000000
NODE_16509_length_705_cov_4.018152	306	364	4	58	58	1.0000000
NODE_16509_length_705_cov_4.018152	337	410	4	35	73	0.4794520
NODE_16509_length_705_cov_4.018152	337	410	6	38	73	0.5205479
NODE_16511_length_705_cov_3.620462	253	315	4	3	62	0.0483871
NODE_16511_length_705_cov_3.620462	253	315	6	59	62	0.9516129
NODE_16511_length_705_cov_3.620462	308	368	2	1	60	0.0166667
NODE_16511_length_705_cov_3.620462	308	368	4	31	60	0.5166667
NODE_16511_length_705_cov_3.620462	308	368	6	28	60	0.4666667
NODE_16527_length_705_cov_1.607261	462	531	0	36	69	0.5217391
NODE_16527_length_705_cov_1.607261	462	531	2	33	69	0.4782609
NODE_16549_length_705_cov_0.529703	33	97	0	36	64	0.5625000
NODE_16549_length_705_cov_0.529703	33	97	2	28	64	0.4375000
NODE_16549_length_705_cov_0.529703	86	150	2	64	64	1.0000000
NODE_16550_length_704_cov_18.256198	295	375	0	80	80	1.0000000
NODE_16550_length_704_cov_18.256198	348	428	0	80	80	1.0000000
NODE_16552_length_704_cov_16.662810	264	344	0	34	80	0.4250000
NODE_16552_length_704_cov_16.662810	264	344	2	6	80	0.0750000
NODE_16552_length_704_cov_16.662810	264	344	4	19	80	0.2375000
NODE_16552_length_704_cov_16.662810	264	344	8	21	80	0.2625000
NODE_16552_length_704_cov_16.662810	317	397	4	6	80	0.0750000
NODE_16552_length_704_cov_16.662810	317	397	6	13	80	0.1625000
NODE_16552_length_704_cov_16.662810	317	397	8	61	80	0.7625000
NODE_16553_length_704_cov_12.641322	294	374	0	80	80	1.0000000
NODE_16553_length_704_cov_12.641322	347	427	0	80	80	1.0000000
NODE_16557_length_704_cov_5.603306	440	498	0	58	58	1.0000000
NODE_16564_length_704_cov_3.535537	303	383	0	8	80	0.1000000
NODE_16564_length_704_cov_3.535537	303	383	2	7	80	0.0875000
NODE_16564_length_704_cov_3.535537	303	383	3	9	80	0.1125000
NODE_16564_length_704_cov_3.535537	303	383	4	20	80	0.2500000
NODE_16564_length_704_cov_3.535537	303	383	6	36	80	0.4500000
NODE_16564_length_704_cov_3.535537	369	436	4	8	67	0.1194030
NODE_16564_length_704_cov_3.535537	369	436	6	59	67	0.8805970
NODE_16578_length_704_cov_1.963636	345	425	4	9	80	0.1125000
NODE_16578_length_704_cov_1.963636	345	425	6	15	80	0.1875000
NODE_16578_length_704_cov_1.963636	345	425	8	9	80	0.1125000
NODE_16578_length_704_cov_1.963636	345	425	10	47	80	0.5875000
NODE_16578_length_704_cov_1.963636	398	478	2	13	80	0.1625000
NODE_16578_length_704_cov_1.963636	398	478	4	7	80	0.0875000
NODE_16578_length_704_cov_1.963636	398	478	6	9	80	0.1125000
NODE_16578_length_704_cov_1.963636	398	478	8	10	80	0.1250000
NODE_16578_length_704_cov_1.963636	398	478	10	41	80	0.5125000
NODE_16598_length_703_cov_44.102649	514	594	2	3	80	0.0375000
NODE_16598_length_703_cov_44.102649	514	594	4	77	80	0.9625000
NODE_16598_length_703_cov_44.102649	567	647	0	15	80	0.1875000
NODE_16598_length_703_cov_44.102649	567	647	2	39	80	0.4875000
NODE_16598_length_703_cov_44.102649	567	647	4	26	80	0.3250000
NODE_16599_length_703_cov_33.067881	521	594	30	6	73	0.0821918
NODE_16599_length_703_cov_33.067881	521	594	32	3	73	0.0410959
NODE_16599_length_703_cov_33.067881	521	594	34	1	73	0.0136986
NODE_16599_length_703_cov_33.067881	521	594	36	2	73	0.0273973
NODE_16599_length_703_cov_33.067881	521	594	38	4	73	0.0547945
NODE_16599_length_703_cov_33.067881	521	594	40	3	73	0.0410959
NODE_16599_length_703_cov_33.067881	521	594	42	14	73	0.1917808
NODE_16599_length_703_cov_33.067881	521	594	43	1	73	0.0136986
NODE_16599_length_703_cov_33.067881	521	594	44	13	73	0.1780822
NODE_16599_length_703_cov_33.067881	521	594	46	7	73	0.0958904
NODE_16599_length_703_cov_33.067881	521	594	48	4	73	0.0547945
NODE_16599_length_703_cov_33.067881	521	594	51	1	73	0.0136986
NODE_16599_length_703_cov_33.067881	521	594	53	1	73	0.0136986
NODE_16599_length_703_cov_33.067881	521	594	58	1	73	0.0136986
NODE_16599_length_703_cov_33.067881	521	594	60	2	73	0.0273973
NODE_16599_length_703_cov_33.067881	521	594	64	1	73	0.0136986
NODE_16599_length_703_cov_33.067881	521	594	66	9	73	0.1232877
NODE_16599_length_703_cov_33.067881	561	602	38	4	41	0.0975610
NODE_16599_length_703_cov_33.067881	561	602	40	1	41	0.0243902
NODE_16599_length_703_cov_33.067881	561	602	42	9	41	0.2195122
NODE_16599_length_703_cov_33.067881	561	602	44	2	41	0.0487805
NODE_16599_length_703_cov_33.067881	561	602	48	2	41	0.0487805
NODE_16599_length_703_cov_33.067881	561	602	51	1	41	0.0243902
NODE_16599_length_703_cov_33.067881	561	602	53	1	41	0.0243902
NODE_16599_length_703_cov_33.067881	561	602	58	1	41	0.0243902
NODE_16599_length_703_cov_33.067881	561	602	60	2	41	0.0487805
NODE_16599_length_703_cov_33.067881	561	602	64	1	41	0.0243902
NODE_16599_length_703_cov_33.067881	561	602	66	10	41	0.2439024
NODE_16599_length_703_cov_33.067881	561	602	68	1	41	0.0243902
NODE_16599_length_703_cov_33.067881	561	602	70	1	41	0.0243902
NODE_16599_length_703_cov_33.067881	561	602	74	3	41	0.0731707
NODE_16599_length_703_cov_33.067881	561	602	76	2	41	0.0487805
NODE_16600_length_703_cov_30.266556	312	392	0	26	80	0.3250000
NODE_16600_length_703_cov_30.266556	312	392	5	1	80	0.0125000
NODE_16600_length_703_cov_30.266556	312	392	6	16	80	0.2000000
NODE_16600_length_703_cov_30.266556	312	392	8	37	80	0.4625000
NODE_16600_length_703_cov_30.266556	365	445	0	79	80	0.9875000
NODE_16600_length_703_cov_30.266556	365	445	5	1	80	0.0125000
NODE_16601_length_703_cov_17.006623	449	529	0	31	80	0.3875000
NODE_16601_length_703_cov_17.006623	449	529	2	49	80	0.6125000
NODE_16601_length_703_cov_17.006623	502	582	0	25	80	0.3125000
NODE_16601_length_703_cov_17.006623	502	582	2	55	80	0.6875000
NODE_16602_length_703_cov_14.801325	383	463	0	10	80	0.1250000
NODE_16602_length_703_cov_14.801325	383	463	2	70	80	0.8750000
NODE_16602_length_703_cov_14.801325	436	516	0	63	80	0.7875000
NODE_16602_length_703_cov_14.801325	436	516	2	17	80	0.2125000
NODE_16603_length_703_cov_11.766556	308	388	0	16	80	0.2000000
NODE_16603_length_703_cov_11.766556	308	388	2	39	80	0.4875000
NODE_16603_length_703_cov_11.766556	308	388	4	25	80	0.3125000
NODE_16603_length_703_cov_11.766556	361	441	2	3	80	0.0375000
NODE_16603_length_703_cov_11.766556	361	441	4	77	80	0.9625000
NODE_16604_length_703_cov_10.405629	213	293	4	24	80	0.3000000
NODE_16604_length_703_cov_10.405629	213	293	6	9	80	0.1125000
NODE_16604_length_703_cov_10.405629	213	293	8	11	80	0.1375000
NODE_16604_length_703_cov_10.405629	213	293	12	5	80	0.0625000
NODE_16604_length_703_cov_10.405629	213	293	14	29	80	0.3625000
NODE_16604_length_703_cov_10.405629	213	293	16	2	80	0.0250000
NODE_16604_length_703_cov_10.405629	266	301	4	32	35	0.9142857
NODE_16604_length_703_cov_10.405629	266	301	6	3	35	0.0857143
NODE_16605_length_703_cov_6.966887	381	440	0	59	59	1.0000000
NODE_16616_length_703_cov_3.491722	256	309	0	53	53	1.0000000
NODE_16616_length_703_cov_3.491722	257	337	0	80	80	1.0000000
NODE_16616_length_703_cov_3.491722	305	362	0	57	57	1.0000000
NODE_16624_length_703_cov_2.687086	216	296	0	80	80	1.0000000
NODE_16624_length_703_cov_2.687086	269	349	0	80	80	1.0000000
NODE_16663_length_702_cov_49.784411	221	299	0	63	78	0.8076923
NODE_16663_length_702_cov_49.784411	221	299	2	15	78	0.1923077
NODE_16663_length_702_cov_49.784411	277	352	0	7	75	0.0933333
NODE_16663_length_702_cov_49.784411	277	352	2	68	75	0.9066667
NODE_16664_length_702_cov_26.570481	201	281	2	80	80	1.0000000
NODE_16664_length_702_cov_26.570481	254	334	0	33	80	0.4125000
NODE_16664_length_702_cov_26.570481	254	334	2	47	80	0.5875000
NODE_16665_length_702_cov_23.971808	139	219	2	80	80	1.0000000
NODE_16665_length_702_cov_23.971808	192	272	0	19	80	0.2375000
NODE_16665_length_702_cov_23.971808	192	272	1	10	80	0.1250000
NODE_16665_length_702_cov_23.971808	192	272	2	51	80	0.6375000
NODE_16665_length_702_cov_23.971808	268	348	0	80	80	1.0000000
NODE_16665_length_702_cov_23.971808	321	401	0	80	80	1.0000000
NODE_16666_length_702_cov_23.827529	448	528	0	80	80	1.0000000
NODE_16666_length_702_cov_23.827529	501	581	0	80	80	1.0000000
NODE_16667_length_702_cov_14.661692	424	504	2	80	80	1.0000000
NODE_16667_length_702_cov_14.661692	477	557	0	34	80	0.4250000
NODE_16667_length_702_cov_14.661692	477	557	2	46	80	0.5750000
NODE_16668_length_702_cov_13.908789	259	304	0	9	45	0.2000000
NODE_16668_length_702_cov_13.908789	259	304	2	19	45	0.4222222
NODE_16668_length_702_cov_13.908789	259	304	4	17	45	0.3777778
NODE_16668_length_702_cov_13.908789	277	357	2	10	80	0.1250000
NODE_16668_length_702_cov_13.908789	277	357	4	51	80	0.6375000
NODE_16668_length_702_cov_13.908789	277	357	6	19	80	0.2375000
NODE_16668_length_702_cov_13.908789	289	357	4	49	68	0.7205882
NODE_16668_length_702_cov_13.908789	289	357	6	19	68	0.2794118
NODE_16669_length_702_cov_8.502488	337	417	0	80	80	1.0000000
NODE_16669_length_702_cov_8.502488	390	470	0	80	80	1.0000000
NODE_16671_length_702_cov_6.470978	209	289	0	80	80	1.0000000
NODE_16671_length_702_cov_6.470978	262	342	0	80	80	1.0000000
NODE_16729_length_701_cov_38.715947	178	258	0	62	80	0.7750000
NODE_16729_length_701_cov_38.715947	178	258	2	18	80	0.2250000
NODE_16729_length_701_cov_38.715947	231	311	0	9	80	0.1125000
NODE_16729_length_701_cov_38.715947	231	311	2	71	80	0.8875000
NODE_16729_length_701_cov_38.715947	307	387	2	79	80	0.9875000
NODE_16729_length_701_cov_38.715947	307	387	4	1	80	0.0125000
NODE_16729_length_701_cov_38.715947	360	440	0	32	80	0.4000000
NODE_16729_length_701_cov_38.715947	360	440	2	48	80	0.6000000
NODE_16730_length_701_cov_28.059801	432	513	0	54	81	0.6666667
NODE_16730_length_701_cov_28.059801	432	513	2	27	81	0.3333333
NODE_16730_length_701_cov_28.059801	486	566	0	80	80	1.0000000
NODE_16731_length_701_cov_18.387043	258	338	0	20	80	0.2500000
NODE_16731_length_701_cov_18.387043	258	338	2	60	80	0.7500000
NODE_16731_length_701_cov_18.387043	311	391	0	16	80	0.2000000
NODE_16731_length_701_cov_18.387043	311	391	2	64	80	0.8000000
NODE_16732_length_701_cov_17.122924	295	367	4	29	72	0.4027778
NODE_16732_length_701_cov_17.122924	295	367	6	31	72	0.4305556
NODE_16732_length_701_cov_17.122924	295	367	8	12	72	0.1666667
NODE_16733_length_701_cov_16.114618	242	322	0	58	80	0.7250000
NODE_16733_length_701_cov_16.114618	242	322	1	1	80	0.0125000
NODE_16733_length_701_cov_16.114618	242	322	2	21	80	0.2625000
NODE_16733_length_701_cov_16.114618	295	375	0	5	80	0.0625000
NODE_16733_length_701_cov_16.114618	295	375	1	1	80	0.0125000
NODE_16733_length_701_cov_16.114618	295	375	2	74	80	0.9250000
NODE_16734_length_701_cov_15.588040	399	479	2	67	80	0.8375000
NODE_16734_length_701_cov_15.588040	399	479	4	13	80	0.1625000
NODE_16734_length_701_cov_15.588040	452	532	0	14	80	0.1750000
NODE_16734_length_701_cov_15.588040	452	532	2	66	80	0.8250000
NODE_16736_length_701_cov_11.420266	229	309	0	80	80	1.0000000
NODE_16736_length_701_cov_11.420266	282	362	0	80	80	1.0000000
NODE_16737_length_701_cov_10.411960	202	283	0	81	81	1.0000000
NODE_16737_length_701_cov_10.411960	256	336	0	80	80	1.0000000
NODE_16738_length_701_cov_9.107973	400	480	0	5	80	0.0625000
NODE_16738_length_701_cov_9.107973	400	480	2	75	80	0.9375000
NODE_16738_length_701_cov_9.107973	453	533	0	58	80	0.7250000
NODE_16738_length_701_cov_9.107973	453	533	2	22	80	0.2750000
NODE_16739_length_701_cov_8.877076	283	363	0	80	80	1.0000000
NODE_16739_length_701_cov_8.877076	336	416	0	80	80	1.0000000
NODE_16740_length_701_cov_8.543189	341	421	0	80	80	1.0000000
NODE_16740_length_701_cov_8.543189	394	474	0	80	80	1.0000000
NODE_16742_length_701_cov_6.317276	273	353	0	65	80	0.8125000
NODE_16742_length_701_cov_6.317276	273	353	2	15	80	0.1875000
NODE_16742_length_701_cov_6.317276	326	382	0	12	56	0.2142857
NODE_16742_length_701_cov_6.317276	326	382	2	44	56	0.7857143
NODE_16747_length_701_cov_5.081395	318	374	8	3	56	0.0535714
NODE_16747_length_701_cov_5.081395	318	374	9	31	56	0.5535714
NODE_16747_length_701_cov_5.081395	318	374	10	22	56	0.3928571
NODE_16752_length_701_cov_3.320598	207	287	0	37	80	0.4625000
NODE_16752_length_701_cov_3.320598	207	287	2	21	80	0.2625000
NODE_16752_length_701_cov_3.320598	207	287	4	22	80	0.2750000
NODE_16752_length_701_cov_3.320598	260	340	2	27	80	0.3375000
NODE_16752_length_701_cov_3.320598	260	340	4	53	80	0.6625000
NODE_16794_length_700_cov_22.241265	326	406	6	3	80	0.0375000
NODE_16794_length_700_cov_22.241265	326	406	7	14	80	0.1750000
NODE_16794_length_700_cov_22.241265	326	406	8	26	80	0.3250000
NODE_16794_length_700_cov_22.241265	326	406	9	2	80	0.0250000
NODE_16794_length_700_cov_22.241265	326	406	10	4	80	0.0500000
NODE_16794_length_700_cov_22.241265	326	406	12	9	80	0.1125000
NODE_16794_length_700_cov_22.241265	326	406	14	22	80	0.2750000
NODE_16796_length_700_cov_11.730449	294	374	0	80	80	1.0000000
NODE_16796_length_700_cov_11.730449	347	427	0	80	80	1.0000000
NODE_16800_length_700_cov_7.291181	317	397	0	80	80	1.0000000
NODE_16800_length_700_cov_7.291181	370	450	0	80	80	1.0000000
NODE_16801_length_700_cov_6.557404	353	404	0	22	51	0.4313726
NODE_16801_length_700_cov_6.557404	353	404	2	29	51	0.5686275
NODE_16802_length_700_cov_5.475874	301	381	0	80	80	1.0000000
NODE_16802_length_700_cov_5.475874	354	434	0	80	80	1.0000000
NODE_16803_length_700_cov_3.960067	158	234	0	76	76	1.0000000
NODE_16803_length_700_cov_3.960067	209	291	0	82	82	1.0000000
NODE_16822_length_700_cov_1.517471	324	404	0	80	80	1.0000000
NODE_16822_length_700_cov_1.517471	377	457	0	80	80	1.0000000
NODE_16844_length_699_cov_18.446667	185	265	0	80	80	1.0000000
NODE_16844_length_699_cov_18.446667	238	318	0	80	80	1.0000000
NODE_16845_length_699_cov_18.383333	258	338	0	80	80	1.0000000
NODE_16845_length_699_cov_18.383333	311	391	0	80	80	1.0000000
NODE_16846_length_699_cov_18.103333	218	298	0	80	80	1.0000000
NODE_16846_length_699_cov_18.103333	271	351	0	80	80	1.0000000
NODE_16847_length_699_cov_15.636667	279	359	2	80	80	1.0000000
NODE_16847_length_699_cov_15.636667	332	412	0	32	80	0.4000000
NODE_16847_length_699_cov_15.636667	332	412	2	48	80	0.6000000
NODE_16848_length_699_cov_15.113333	313	393	0	80	80	1.0000000
NODE_16848_length_699_cov_15.113333	366	446	0	80	80	1.0000000
NODE_16849_length_699_cov_10.070000	233	313	0	80	80	1.0000000
NODE_16849_length_699_cov_10.070000	286	366	0	80	80	1.0000000
NODE_16849_length_699_cov_10.070000	362	442	0	80	80	1.0000000
NODE_16849_length_699_cov_10.070000	415	495	0	80	80	1.0000000
NODE_16850_length_699_cov_8.083333	347	427	0	80	80	1.0000000
NODE_16850_length_699_cov_8.083333	400	480	0	80	80	1.0000000
NODE_16851_length_699_cov_7.758333	307	387	0	80	80	1.0000000
NODE_16851_length_699_cov_7.758333	360	440	0	80	80	1.0000000
NODE_16852_length_699_cov_7.713333	252	332	0	23	80	0.2875000
NODE_16852_length_699_cov_7.713333	252	332	2	57	80	0.7125000
NODE_16852_length_699_cov_7.713333	305	385	0	27	80	0.3375000
NODE_16852_length_699_cov_7.713333	305	385	2	53	80	0.6625000
NODE_16853_length_699_cov_7.186667	271	332	0	4	61	0.0655738
NODE_16853_length_699_cov_7.186667	271	332	2	57	61	0.9344262
NODE_16853_length_699_cov_7.186667	348	428	2	77	80	0.9625000
NODE_16853_length_699_cov_7.186667	348	428	4	3	80	0.0375000
NODE_16857_length_699_cov_5.815000	243	316	0	73	73	1.0000000
NODE_16857_length_699_cov_5.815000	293	374	0	81	81	1.0000000
NODE_16858_length_699_cov_5.520000	302	382	0	51	80	0.6375000
NODE_16858_length_699_cov_5.520000	302	382	2	29	80	0.3625000
NODE_16858_length_699_cov_5.520000	355	435	0	80	80	1.0000000
NODE_16860_length_699_cov_4.051667	289	369	2	46	80	0.5750000
NODE_16860_length_699_cov_4.051667	289	369	6	25	80	0.3125000
NODE_16860_length_699_cov_4.051667	289	369	8	9	80	0.1125000
NODE_16860_length_699_cov_4.051667	342	422	6	71	80	0.8875000
NODE_16860_length_699_cov_4.051667	342	422	8	9	80	0.1125000
NODE_16868_length_699_cov_2.498333	204	284	2	25	80	0.3125000
NODE_16868_length_699_cov_2.498333	204	284	4	55	80	0.6875000
NODE_16868_length_699_cov_2.498333	257	337	1	39	80	0.4875000
NODE_16868_length_699_cov_2.498333	257	337	2	39	80	0.4875000
NODE_16868_length_699_cov_2.498333	257	337	4	2	80	0.0250000
NODE_16908_length_698_cov_47.350584	321	401	2	39	80	0.4875000
NODE_16908_length_698_cov_47.350584	321	401	4	33	80	0.4125000
NODE_16908_length_698_cov_47.350584	321	401	6	8	80	0.1000000
NODE_16908_length_698_cov_47.350584	374	454	2	38	80	0.4750000
NODE_16908_length_698_cov_47.350584	374	454	4	42	80	0.5250000
NODE_16909_length_698_cov_42.848080	255	335	0	80	80	1.0000000
NODE_16909_length_698_cov_42.848080	308	388	0	80	80	1.0000000
NODE_16910_length_698_cov_36.697830	366	446	0	23	80	0.2875000
NODE_16910_length_698_cov_36.697830	366	446	2	57	80	0.7125000
NODE_16910_length_698_cov_36.697830	419	484	0	1	65	0.0153846
NODE_16910_length_698_cov_36.697830	419	484	2	64	65	0.9846154
NODE_16911_length_698_cov_23.874791	222	302	0	20	80	0.2500000
NODE_16911_length_698_cov_23.874791	222	302	2	60	80	0.7500000
NODE_16911_length_698_cov_23.874791	275	355	0	12	80	0.1500000
NODE_16911_length_698_cov_23.874791	275	355	2	68	80	0.8500000
NODE_16912_length_698_cov_7.133556	360	440	0	80	80	1.0000000
NODE_16912_length_698_cov_7.133556	413	493	0	80	80	1.0000000
NODE_16913_length_698_cov_6.520868	267	347	0	13	80	0.1625000
NODE_16913_length_698_cov_6.520868	267	347	1	7	80	0.0875000
NODE_16913_length_698_cov_6.520868	267	347	2	60	80	0.7500000
NODE_16913_length_698_cov_6.520868	320	400	0	66	80	0.8250000
NODE_16913_length_698_cov_6.520868	320	400	1	7	80	0.0875000
NODE_16913_length_698_cov_6.520868	320	400	2	7	80	0.0875000
NODE_16917_length_698_cov_4.762938	329	359	4	30	30	1.0000000
NODE_16926_length_698_cov_2.577629	309	389	0	8	80	0.1000000
NODE_16926_length_698_cov_2.577629	309	389	2	72	80	0.9000000
NODE_16926_length_698_cov_2.577629	362	442	0	61	80	0.7625000
NODE_16926_length_698_cov_2.577629	362	442	2	19	80	0.2375000
NODE_16962_length_697_cov_16.013378	305	385	1	80	80	1.0000000
NODE_16962_length_697_cov_16.013378	358	438	0	15	80	0.1875000
NODE_16962_length_697_cov_16.013378	358	438	1	65	80	0.8125000
NODE_16963_length_697_cov_14.411371	440	520	0	80	80	1.0000000
NODE_16963_length_697_cov_14.411371	493	573	0	80	80	1.0000000
NODE_16964_length_697_cov_14.282609	257	354	2	97	97	1.0000000
NODE_16964_length_697_cov_14.282609	327	385	0	22	58	0.3793103
NODE_16964_length_697_cov_14.282609	327	385	1	5	58	0.0862069
NODE_16964_length_697_cov_14.282609	327	385	2	31	58	0.5344828
NODE_16965_length_697_cov_9.969900	360	440	0	80	80	1.0000000
NODE_16965_length_697_cov_9.969900	413	493	0	80	80	1.0000000
NODE_16968_length_697_cov_6.117057	236	316	0	80	80	1.0000000
NODE_16968_length_697_cov_6.117057	289	369	0	80	80	1.0000000
NODE_17025_length_696_cov_28.360134	319	399	0	60	80	0.7500000
NODE_17025_length_696_cov_28.360134	319	399	2	20	80	0.2500000
NODE_17025_length_696_cov_28.360134	372	452	0	80	80	1.0000000
NODE_17026_length_696_cov_18.708543	367	447	0	80	80	1.0000000
NODE_17026_length_696_cov_18.708543	420	500	0	80	80	1.0000000
NODE_17027_length_696_cov_18.170854	390	470	0	80	80	1.0000000
NODE_17027_length_696_cov_18.170854	443	523	0	80	80	1.0000000
NODE_17028_length_696_cov_13.738693	266	346	0	25	80	0.3125000
NODE_17028_length_696_cov_13.738693	266	346	2	55	80	0.6875000
NODE_17028_length_696_cov_13.738693	319	399	0	11	80	0.1375000
NODE_17028_length_696_cov_13.738693	319	399	2	69	80	0.8625000
NODE_17030_length_696_cov_10.693467	239	266	0	27	27	1.0000000
NODE_17031_length_696_cov_9.949749	248	328	0	80	80	1.0000000
NODE_17031_length_696_cov_9.949749	301	381	0	46	80	0.5750000
NODE_17031_length_696_cov_9.949749	301	381	2	34	80	0.4250000
NODE_17032_length_696_cov_8.658291	247	327	0	80	80	1.0000000
NODE_17032_length_696_cov_8.658291	300	380	0	80	80	1.0000000
NODE_17032_length_696_cov_8.658291	376	456	0	80	80	1.0000000
NODE_17032_length_696_cov_8.658291	429	509	0	80	80	1.0000000
NODE_17068_length_696_cov_1.675042	498	543	0	45	45	1.0000000
NODE_17100_length_695_cov_24.112416	388	468	0	4	80	0.0500000
NODE_17100_length_695_cov_24.112416	388	468	2	76	80	0.9500000
NODE_17100_length_695_cov_24.112416	441	521	0	25	80	0.3125000
NODE_17100_length_695_cov_24.112416	441	521	2	55	80	0.6875000
NODE_17101_length_695_cov_12.152685	349	429	0	14	80	0.1750000
NODE_17101_length_695_cov_12.152685	349	429	2	66	80	0.8250000
NODE_17101_length_695_cov_12.152685	402	482	2	80	80	1.0000000
NODE_17103_length_695_cov_8.466443	345	425	0	80	80	1.0000000
NODE_17103_length_695_cov_8.466443	398	478	0	80	80	1.0000000
NODE_17106_length_695_cov_5.661074	283	363	0	80	80	1.0000000
NODE_17106_length_695_cov_5.661074	346	416	0	23	70	0.3285714
NODE_17106_length_695_cov_5.661074	346	416	2	47	70	0.6714286
NODE_17124_length_695_cov_2.050336	36	112	0	76	76	1.0000000
NODE_17161_length_694_cov_46.675630	30	110	0	80	80	1.0000000
NODE_17161_length_694_cov_46.675630	83	163	0	80	80	1.0000000
NODE_17161_length_694_cov_46.675630	159	239	0	80	80	1.0000000
NODE_17161_length_694_cov_46.675630	212	292	0	80	80	1.0000000
NODE_17162_length_694_cov_12.850420	326	406	0	5	80	0.0625000
NODE_17162_length_694_cov_12.850420	326	406	2	14	80	0.1750000
NODE_17162_length_694_cov_12.850420	326	406	4	61	80	0.7625000
NODE_17162_length_694_cov_12.850420	379	459	0	58	80	0.7250000
NODE_17162_length_694_cov_12.850420	379	459	2	10	80	0.1250000
NODE_17162_length_694_cov_12.850420	379	459	4	12	80	0.1500000
NODE_17163_length_694_cov_7.236975	318	396	0	66	78	0.8461539
NODE_17163_length_694_cov_7.236975	318	396	2	12	78	0.1538462
NODE_17163_length_694_cov_7.236975	371	450	0	79	79	1.0000000
NODE_17166_length_694_cov_5.554622	404	484	0	33	80	0.4125000
NODE_17166_length_694_cov_5.554622	404	484	2	47	80	0.5875000
NODE_17166_length_694_cov_5.554622	457	537	2	72	80	0.9000000
NODE_17166_length_694_cov_5.554622	457	537	4	8	80	0.1000000
NODE_17168_length_694_cov_5.373109	152	232	0	80	80	1.0000000
NODE_17168_length_694_cov_5.373109	205	285	0	80	80	1.0000000
NODE_17227_length_693_cov_26.616162	435	515	0	47	80	0.5875000
NODE_17227_length_693_cov_26.616162	435	515	2	33	80	0.4125000
NODE_17227_length_693_cov_26.616162	488	568	0	80	80	1.0000000
NODE_17228_length_693_cov_23.552189	193	273	2	8	80	0.1000000
NODE_17228_length_693_cov_23.552189	193	273	4	72	80	0.9000000
NODE_17228_length_693_cov_23.552189	246	326	2	43	80	0.5375000
NODE_17228_length_693_cov_23.552189	246	326	4	37	80	0.4625000
NODE_17229_length_693_cov_22.848485	231	311	0	28	80	0.3500000
NODE_17229_length_693_cov_22.848485	231	311	2	52	80	0.6500000
NODE_17229_length_693_cov_22.848485	284	364	0	14	80	0.1750000
NODE_17229_length_693_cov_22.848485	284	364	2	66	80	0.8250000
NODE_17230_length_693_cov_13.616162	219	299	0	12	80	0.1500000
NODE_17230_length_693_cov_13.616162	219	299	1	4	80	0.0500000
NODE_17230_length_693_cov_13.616162	219	299	2	11	80	0.1375000
NODE_17230_length_693_cov_13.616162	219	299	4	53	80	0.6625000
NODE_17230_length_693_cov_13.616162	272	352	0	12	80	0.1500000
NODE_17230_length_693_cov_13.616162	272	352	2	19	80	0.2375000
NODE_17230_length_693_cov_13.616162	272	352	4	49	80	0.6125000
NODE_17231_length_693_cov_12.382155	305	385	0	17	80	0.2125000
NODE_17231_length_693_cov_12.382155	305	385	2	63	80	0.7875000
NODE_17231_length_693_cov_12.382155	358	424	0	19	66	0.2878788
NODE_17231_length_693_cov_12.382155	358	424	2	47	66	0.7121212
NODE_17232_length_693_cov_10.053872	279	359	0	19	80	0.2375000
NODE_17232_length_693_cov_10.053872	279	359	2	61	80	0.7625000
NODE_17232_length_693_cov_10.053872	332	412	0	40	80	0.5000000
NODE_17232_length_693_cov_10.053872	332	412	2	40	80	0.5000000
NODE_17233_length_693_cov_9.659933	247	327	0	80	80	1.0000000
NODE_17233_length_693_cov_9.659933	300	380	0	80	80	1.0000000
NODE_17235_length_693_cov_8.077441	343	423	0	80	80	1.0000000
NODE_17235_length_693_cov_8.077441	396	476	0	80	80	1.0000000
NODE_17243_length_693_cov_3.680135	250	321	0	17	71	0.2394366
NODE_17243_length_693_cov_3.680135	250	321	2	54	71	0.7605634
NODE_17280_length_692_cov_33.416526	462	542	0	3	80	0.0375000
NODE_17280_length_692_cov_33.416526	462	542	2	6	80	0.0750000
NODE_17280_length_692_cov_33.416526	462	542	4	20	80	0.2500000
NODE_17280_length_692_cov_33.416526	462	542	6	3	80	0.0375000
NODE_17280_length_692_cov_33.416526	462	542	8	48	80	0.6000000
NODE_17280_length_692_cov_33.416526	515	595	0	19	80	0.2375000
NODE_17280_length_692_cov_33.416526	515	595	2	16	80	0.2000000
NODE_17280_length_692_cov_33.416526	515	595	4	7	80	0.0875000
NODE_17280_length_692_cov_33.416526	515	595	8	38	80	0.4750000
NODE_17281_length_692_cov_17.559865	291	371	0	80	80	1.0000000
NODE_17282_length_692_cov_15.070826	304	375	0	71	71	1.0000000
NODE_17283_length_692_cov_13.279933	308	388	4	9	80	0.1125000
NODE_17283_length_692_cov_13.279933	308	388	6	2	80	0.0250000
NODE_17283_length_692_cov_13.279933	308	388	8	17	80	0.2125000
NODE_17283_length_692_cov_13.279933	308	388	10	52	80	0.6500000
NODE_17283_length_692_cov_13.279933	361	441	4	27	80	0.3375000
NODE_17283_length_692_cov_13.279933	361	441	6	11	80	0.1375000
NODE_17283_length_692_cov_13.279933	361	441	10	42	80	0.5250000
NODE_17285_length_692_cov_10.750422	317	397	0	80	80	1.0000000
NODE_17287_length_692_cov_7.497470	175	255	0	80	80	1.0000000
NODE_17287_length_692_cov_7.497470	228	312	0	84	84	1.0000000
NODE_17289_length_692_cov_7.370995	235	315	4	6	80	0.0750000
NODE_17289_length_692_cov_7.370995	235	315	6	9	80	0.1125000
NODE_17289_length_692_cov_7.370995	235	315	8	5	80	0.0625000
NODE_17289_length_692_cov_7.370995	235	315	10	6	80	0.0750000
NODE_17289_length_692_cov_7.370995	235	315	12	1	80	0.0125000
NODE_17289_length_692_cov_7.370995	235	315	14	53	80	0.6625000
NODE_17289_length_692_cov_7.370995	288	369	0	1	81	0.0123457
NODE_17289_length_692_cov_7.370995	288	369	2	6	81	0.0740741
NODE_17289_length_692_cov_7.370995	288	369	4	11	81	0.1358025
NODE_17289_length_692_cov_7.370995	288	369	6	8	81	0.0987654
NODE_17289_length_692_cov_7.370995	288	369	7	6	81	0.0740741
NODE_17289_length_692_cov_7.370995	288	369	9	3	81	0.0370370
NODE_17289_length_692_cov_7.370995	288	369	10	15	81	0.1851852
NODE_17289_length_692_cov_7.370995	288	369	12	5	81	0.0617284
NODE_17289_length_692_cov_7.370995	288	369	14	26	81	0.3209876
NODE_17328_length_692_cov_1.514334	404	484	0	22	80	0.2750000
NODE_17328_length_692_cov_1.514334	404	484	3	1	80	0.0125000
NODE_17328_length_692_cov_1.514334	404	484	4	34	80	0.4250000
NODE_17328_length_692_cov_1.514334	404	484	6	23	80	0.2875000
NODE_17350_length_691_cov_115.233108	276	356	8	13	80	0.1625000
NODE_17350_length_691_cov_115.233108	276	356	10	8	80	0.1000000
NODE_17350_length_691_cov_115.233108	276	356	11	1	80	0.0125000
NODE_17350_length_691_cov_115.233108	276	356	12	23	80	0.2875000
NODE_17350_length_691_cov_115.233108	276	356	14	35	80	0.4375000
NODE_17350_length_691_cov_115.233108	329	409	0	11	80	0.1375000
NODE_17350_length_691_cov_115.233108	329	409	2	4	80	0.0500000
NODE_17350_length_691_cov_115.233108	329	409	4	17	80	0.2125000
NODE_17350_length_691_cov_115.233108	329	409	6	2	80	0.0250000
NODE_17350_length_691_cov_115.233108	329	409	8	32	80	0.4000000
NODE_17350_length_691_cov_115.233108	329	409	10	8	80	0.1000000
NODE_17350_length_691_cov_115.233108	329	409	12	6	80	0.0750000
NODE_17350_length_691_cov_115.233108	405	485	4	7	80	0.0875000
NODE_17350_length_691_cov_115.233108	405	485	6	17	80	0.2125000
NODE_17350_length_691_cov_115.233108	405	485	8	7	80	0.0875000
NODE_17350_length_691_cov_115.233108	405	485	9	2	80	0.0250000
NODE_17350_length_691_cov_115.233108	405	485	12	1	80	0.0125000
NODE_17350_length_691_cov_115.233108	405	485	13	7	80	0.0875000
NODE_17350_length_691_cov_115.233108	405	485	15	2	80	0.0250000
NODE_17350_length_691_cov_115.233108	405	485	19	12	80	0.1500000
NODE_17350_length_691_cov_115.233108	405	485	21	1	80	0.0125000
NODE_17350_length_691_cov_115.233108	405	485	22	4	80	0.0500000
NODE_17350_length_691_cov_115.233108	405	485	25	1	80	0.0125000
NODE_17350_length_691_cov_115.233108	405	485	26	2	80	0.0250000
NODE_17350_length_691_cov_115.233108	405	485	28	1	80	0.0125000
NODE_17350_length_691_cov_115.233108	405	485	30	2	80	0.0250000
NODE_17350_length_691_cov_115.233108	405	485	34	2	80	0.0250000
NODE_17350_length_691_cov_115.233108	405	485	36	7	80	0.0875000
NODE_17350_length_691_cov_115.233108	405	485	38	4	80	0.0500000
NODE_17350_length_691_cov_115.233108	405	485	40	1	80	0.0125000
NODE_17350_length_691_cov_115.233108	458	538	19	2	80	0.0250000
NODE_17350_length_691_cov_115.233108	458	538	21	1	80	0.0125000
NODE_17350_length_691_cov_115.233108	458	538	22	4	80	0.0500000
NODE_17350_length_691_cov_115.233108	458	538	25	1	80	0.0125000
NODE_17350_length_691_cov_115.233108	458	538	26	2	80	0.0250000
NODE_17350_length_691_cov_115.233108	458	538	28	1	80	0.0125000
NODE_17350_length_691_cov_115.233108	458	538	30	2	80	0.0250000
NODE_17350_length_691_cov_115.233108	458	538	34	2	80	0.0250000
NODE_17350_length_691_cov_115.233108	458	538	36	7	80	0.0875000
NODE_17350_length_691_cov_115.233108	458	538	38	4	80	0.0500000
NODE_17350_length_691_cov_115.233108	458	538	40	9	80	0.1125000
NODE_17350_length_691_cov_115.233108	458	538	42	31	80	0.3875000
NODE_17350_length_691_cov_115.233108	458	538	43	2	80	0.0250000
NODE_17350_length_691_cov_115.233108	458	538	44	7	80	0.0875000
NODE_17350_length_691_cov_115.233108	458	538	46	5	80	0.0625000
NODE_17351_length_691_cov_26.076014	188	268	0	66	80	0.8250000
NODE_17351_length_691_cov_26.076014	188	268	2	14	80	0.1750000
NODE_17351_length_691_cov_26.076014	241	321	0	34	80	0.4250000
NODE_17351_length_691_cov_26.076014	241	321	2	46	80	0.5750000
NODE_17352_length_691_cov_21.991554	288	368	0	80	80	1.0000000
NODE_17352_length_691_cov_21.991554	341	419	0	78	78	1.0000000
NODE_17353_length_691_cov_14.908784	226	306	0	80	80	1.0000000
NODE_17353_length_691_cov_14.908784	279	359	0	80	80	1.0000000
NODE_17358_length_691_cov_5.670608	325	402	0	77	77	1.0000000
NODE_17358_length_691_cov_5.670608	375	455	0	68	80	0.8500000
NODE_17358_length_691_cov_5.670608	375	455	2	12	80	0.1500000
NODE_17361_length_691_cov_4.866554	103	183	0	80	80	1.0000000
NODE_17361_length_691_cov_4.866554	156	236	0	80	80	1.0000000
NODE_17367_length_691_cov_3.388514	304	384	0	38	80	0.4750000
NODE_17367_length_691_cov_3.388514	304	384	4	42	80	0.5250000
NODE_17367_length_691_cov_3.388514	357	437	0	80	80	1.0000000
NODE_17415_length_690_cov_39.538071	563	612	0	7	49	0.1428571
NODE_17415_length_690_cov_39.538071	563	612	2	42	49	0.8571429
NODE_17415_length_690_cov_39.538071	598	678	0	13	80	0.1625000
NODE_17415_length_690_cov_39.538071	598	678	1	5	80	0.0625000
NODE_17415_length_690_cov_39.538071	598	678	2	62	80	0.7750000
NODE_17415_length_690_cov_39.538071	651	690	0	25	39	0.6410257
NODE_17415_length_690_cov_39.538071	651	690	1	5	39	0.1282051
NODE_17415_length_690_cov_39.538071	651	690	2	9	39	0.2307692
NODE_17417_length_690_cov_30.336717	319	394	0	75	75	1.0000000
NODE_17417_length_690_cov_30.336717	372	453	0	81	81	1.0000000
NODE_17417_length_690_cov_30.336717	449	529	0	80	80	1.0000000
NODE_17417_length_690_cov_30.336717	502	582	0	80	80	1.0000000
NODE_17418_length_690_cov_26.888325	270	350	0	20	80	0.2500000
NODE_17418_length_690_cov_26.888325	270	350	2	60	80	0.7500000
NODE_17418_length_690_cov_26.888325	323	403	0	73	80	0.9125000
NODE_17418_length_690_cov_26.888325	323	403	2	7	80	0.0875000
NODE_17419_length_690_cov_23.360406	131	211	0	60	80	0.7500000
NODE_17419_length_690_cov_23.360406	131	211	2	20	80	0.2500000
NODE_17419_length_690_cov_23.360406	188	264	0	3	76	0.0394737
NODE_17419_length_690_cov_23.360406	188	264	1	36	76	0.4736842
NODE_17419_length_690_cov_23.360406	188	264	2	37	76	0.4868421
NODE_17420_length_690_cov_18.737733	316	396	0	56	80	0.7000000
NODE_17420_length_690_cov_18.737733	316	396	4	4	80	0.0500000
NODE_17420_length_690_cov_18.737733	316	396	6	20	80	0.2500000
NODE_17420_length_690_cov_18.737733	369	449	0	3	80	0.0375000
NODE_17420_length_690_cov_18.737733	369	449	4	4	80	0.0500000
NODE_17420_length_690_cov_18.737733	369	449	6	73	80	0.9125000
NODE_17421_length_690_cov_16.593909	364	444	0	80	80	1.0000000
NODE_17421_length_690_cov_16.593909	417	497	0	80	80	1.0000000
NODE_17422_length_690_cov_12.896785	320	400	0	8	80	0.1000000
NODE_17422_length_690_cov_12.896785	320	400	2	72	80	0.9000000
NODE_17422_length_690_cov_12.896785	373	453	0	28	80	0.3500000
NODE_17422_length_690_cov_12.896785	373	453	2	52	80	0.6500000
NODE_17423_length_690_cov_10.818951	349	429	2	80	80	1.0000000
NODE_17424_length_690_cov_7.015228	273	353	0	80	80	1.0000000
NODE_17424_length_690_cov_7.015228	326	406	0	80	80	1.0000000
NODE_17429_length_690_cov_4.793570	316	365	44	6	49	0.1224490
NODE_17429_length_690_cov_4.793570	316	365	46	4	49	0.0816327
NODE_17429_length_690_cov_4.793570	316	365	48	1	49	0.0204082
NODE_17429_length_690_cov_4.793570	316	365	50	4	49	0.0816327
NODE_17429_length_690_cov_4.793570	316	365	52	1	49	0.0204082
NODE_17429_length_690_cov_4.793570	316	365	58	5	49	0.1020408
NODE_17429_length_690_cov_4.793570	316	365	59	1	49	0.0204082
NODE_17429_length_690_cov_4.793570	316	365	60	11	49	0.2244898
NODE_17429_length_690_cov_4.793570	316	365	61	4	49	0.0816327
NODE_17429_length_690_cov_4.793570	316	365	62	1	49	0.0204082
NODE_17429_length_690_cov_4.793570	316	365	64	7	49	0.1428571
NODE_17429_length_690_cov_4.793570	316	365	66	4	49	0.0816327
NODE_17430_length_690_cov_4.717428	316	396	0	11	80	0.1375000
NODE_17430_length_690_cov_4.717428	316	396	2	69	80	0.8625000
NODE_17430_length_690_cov_4.717428	369	449	0	51	80	0.6375000
NODE_17430_length_690_cov_4.717428	369	449	2	29	80	0.3625000
NODE_17484_length_689_cov_45.984746	244	322	0	78	78	1.0000000
NODE_17484_length_689_cov_45.984746	297	377	0	80	80	1.0000000
NODE_17485_length_689_cov_35.705085	436	516	0	80	80	1.0000000
NODE_17485_length_689_cov_35.705085	489	569	0	80	80	1.0000000
NODE_17486_length_689_cov_25.372881	211	291	0	2	80	0.0250000
NODE_17486_length_689_cov_25.372881	211	291	2	40	80	0.5000000
NODE_17486_length_689_cov_25.372881	211	291	4	38	80	0.4750000
NODE_17486_length_689_cov_25.372881	264	344	0	5	80	0.0625000
NODE_17486_length_689_cov_25.372881	264	344	2	8	80	0.1000000
NODE_17486_length_689_cov_25.372881	264	344	4	67	80	0.8375000
NODE_17487_length_689_cov_20.138983	319	399	3	25	80	0.3125000
NODE_17487_length_689_cov_20.138983	319	399	4	55	80	0.6875000
NODE_17487_length_689_cov_20.138983	372	452	0	41	80	0.5125000
NODE_17487_length_689_cov_20.138983	372	452	1	2	80	0.0250000
NODE_17487_length_689_cov_20.138983	372	452	3	35	80	0.4375000
NODE_17487_length_689_cov_20.138983	372	452	4	2	80	0.0250000
NODE_17488_length_689_cov_14.377966	351	431	0	80	80	1.0000000
NODE_17488_length_689_cov_14.377966	404	484	0	80	80	1.0000000
NODE_17489_length_689_cov_9.477966	201	281	0	80	80	1.0000000
NODE_17489_length_689_cov_9.477966	254	334	0	80	80	1.0000000
NODE_17491_length_689_cov_7.367797	122	207	2	46	85	0.5411765
NODE_17491_length_689_cov_7.367797	122	207	4	39	85	0.4588235
NODE_17492_length_689_cov_6.649153	242	322	0	80	80	1.0000000
NODE_17492_length_689_cov_6.649153	295	375	0	55	80	0.6875000
NODE_17492_length_689_cov_6.649153	295	375	2	25	80	0.3125000
NODE_17504_length_689_cov_2.788136	128	208	0	80	80	1.0000000
NODE_17504_length_689_cov_2.788136	181	261	0	80	80	1.0000000
NODE_17548_length_688_cov_52.256367	198	278	0	80	80	1.0000000
NODE_17548_length_688_cov_52.256367	251	331	0	80	80	1.0000000
NODE_17549_length_688_cov_37.563667	373	453	2	78	80	0.9750000
NODE_17549_length_688_cov_37.563667	373	453	4	2	80	0.0250000
NODE_17549_length_688_cov_37.563667	426	506	0	17	80	0.2125000
NODE_17549_length_688_cov_37.563667	426	506	2	63	80	0.7875000
NODE_17549_length_688_cov_37.563667	514	594	0	22	80	0.2750000
NODE_17549_length_688_cov_37.563667	514	594	2	14	80	0.1750000
NODE_17549_length_688_cov_37.563667	514	594	4	1	80	0.0125000
NODE_17549_length_688_cov_37.563667	514	594	6	2	80	0.0250000
NODE_17549_length_688_cov_37.563667	514	594	8	19	80	0.2375000
NODE_17549_length_688_cov_37.563667	514	594	10	13	80	0.1625000
NODE_17549_length_688_cov_37.563667	514	594	12	9	80	0.1125000
NODE_17549_length_688_cov_37.563667	514	594	0	22	80	0.2750000
NODE_17549_length_688_cov_37.563667	514	594	2	14	80	0.1750000
NODE_17549_length_688_cov_37.563667	514	594	4	1	80	0.0125000
NODE_17549_length_688_cov_37.563667	514	594	6	2	80	0.0250000
NODE_17549_length_688_cov_37.563667	514	594	8	19	80	0.2375000
NODE_17549_length_688_cov_37.563667	514	594	10	13	80	0.1625000
NODE_17549_length_688_cov_37.563667	514	594	12	9	80	0.1125000
NODE_17549_length_688_cov_37.563667	514	584	0	22	70	0.3142857
NODE_17549_length_688_cov_37.563667	514	584	2	14	70	0.2000000
NODE_17549_length_688_cov_37.563667	514	584	4	1	70	0.0142857
NODE_17549_length_688_cov_37.563667	514	584	6	2	70	0.0285714
NODE_17549_length_688_cov_37.563667	514	584	8	19	70	0.2714286
NODE_17549_length_688_cov_37.563667	514	584	10	12	70	0.1714286
NODE_17549_length_688_cov_37.563667	567	647	8	19	80	0.2375000
NODE_17549_length_688_cov_37.563667	567	647	10	29	80	0.3625000
NODE_17549_length_688_cov_37.563667	567	647	12	32	80	0.4000000
NODE_17549_length_688_cov_37.563667	567	646	8	18	79	0.2278481
NODE_17549_length_688_cov_37.563667	567	646	10	29	79	0.3670886
NODE_17549_length_688_cov_37.563667	567	646	12	32	79	0.4050633
NODE_17550_length_688_cov_33.898132	373	453	0	1	80	0.0125000
NODE_17550_length_688_cov_33.898132	373	453	2	3	80	0.0375000
NODE_17550_length_688_cov_33.898132	373	453	4	9	80	0.1125000
NODE_17550_length_688_cov_33.898132	373	453	6	33	80	0.4125000
NODE_17550_length_688_cov_33.898132	373	453	8	2	80	0.0250000
NODE_17550_length_688_cov_33.898132	373	453	10	13	80	0.1625000
NODE_17550_length_688_cov_33.898132	373	453	12	19	80	0.2375000
NODE_17550_length_688_cov_33.898132	426	506	4	5	80	0.0625000
NODE_17550_length_688_cov_33.898132	426	506	6	7	80	0.0875000
NODE_17550_length_688_cov_33.898132	426	506	8	8	80	0.1000000
NODE_17550_length_688_cov_33.898132	426	506	10	46	80	0.5750000
NODE_17550_length_688_cov_33.898132	426	506	12	14	80	0.1750000
NODE_17551_length_688_cov_26.769100	457	537	0	79	80	0.9875000
NODE_17551_length_688_cov_26.769100	457	537	2	1	80	0.0125000
NODE_17551_length_688_cov_26.769100	510	590	0	80	80	1.0000000
NODE_17552_length_688_cov_22.517827	332	412	0	80	80	1.0000000
NODE_17552_length_688_cov_22.517827	385	465	0	80	80	1.0000000
NODE_17553_length_688_cov_16.796265	225	305	0	6	80	0.0750000
NODE_17553_length_688_cov_16.796265	225	305	1	6	80	0.0750000
NODE_17553_length_688_cov_16.796265	225	305	2	68	80	0.8500000
NODE_17553_length_688_cov_16.796265	278	358	0	59	80	0.7375000
NODE_17553_length_688_cov_16.796265	278	358	1	6	80	0.0750000
NODE_17553_length_688_cov_16.796265	278	358	2	15	80	0.1875000
NODE_17555_length_688_cov_13.758913	378	458	2	73	80	0.9125000
NODE_17555_length_688_cov_13.758913	378	458	4	7	80	0.0875000
NODE_17555_length_688_cov_13.758913	431	511	0	4	80	0.0500000
NODE_17555_length_688_cov_13.758913	431	511	2	76	80	0.9500000
NODE_17556_length_688_cov_12.511036	330	410	0	2	80	0.0250000
NODE_17556_length_688_cov_12.511036	330	410	2	78	80	0.9750000
NODE_17556_length_688_cov_12.511036	383	463	0	29	80	0.3625000
NODE_17556_length_688_cov_12.511036	383	463	2	51	80	0.6375000
NODE_17561_length_688_cov_5.446520	366	414	0	1	48	0.0208333
NODE_17561_length_688_cov_5.446520	366	414	2	29	48	0.6041667
NODE_17561_length_688_cov_5.446520	366	414	4	18	48	0.3750000
NODE_17567_length_688_cov_3.692699	265	345	0	13	80	0.1625000
NODE_17567_length_688_cov_3.692699	265	345	2	22	80	0.2750000
NODE_17567_length_688_cov_3.692699	265	345	6	45	80	0.5625000
NODE_17567_length_688_cov_3.692699	322	380	6	58	58	1.0000000
NODE_17621_length_687_cov_50.214286	430	510	0	8	80	0.1000000
NODE_17621_length_687_cov_50.214286	430	510	2	72	80	0.9000000
NODE_17621_length_687_cov_50.214286	483	563	0	48	80	0.6000000
NODE_17621_length_687_cov_50.214286	483	563	2	32	80	0.4000000
NODE_17622_length_687_cov_32.564626	204	284	2	80	80	1.0000000
NODE_17622_length_687_cov_32.564626	257	337	0	53	80	0.6625000
NODE_17622_length_687_cov_32.564626	257	337	2	27	80	0.3375000
NODE_17623_length_687_cov_22.365646	231	311	0	41	80	0.5125000
NODE_17623_length_687_cov_22.365646	231	311	2	39	80	0.4875000
NODE_17623_length_687_cov_22.365646	284	364	2	80	80	1.0000000
NODE_17626_length_687_cov_11.943878	233	313	0	80	80	1.0000000
NODE_17626_length_687_cov_11.943878	286	366	0	80	80	1.0000000
NODE_17627_length_687_cov_7.865646	311	391	0	45	80	0.5625000
NODE_17627_length_687_cov_7.865646	311	391	2	35	80	0.4375000
NODE_17627_length_687_cov_7.865646	364	444	0	80	80	1.0000000
NODE_17628_length_687_cov_7.353741	286	366	0	80	80	1.0000000
NODE_17628_length_687_cov_7.353741	339	419	0	80	80	1.0000000
NODE_17631_length_687_cov_5.903061	369	449	0	80	80	1.0000000
NODE_17631_length_687_cov_5.903061	422	502	0	80	80	1.0000000
NODE_17695_length_686_cov_34.642249	355	440	0	85	85	1.0000000
NODE_17695_length_686_cov_34.642249	413	493	0	80	80	1.0000000
NODE_17697_length_686_cov_26.357751	413	493	0	80	80	1.0000000
NODE_17697_length_686_cov_26.357751	466	546	0	80	80	1.0000000
NODE_17698_length_686_cov_16.715503	400	480	0	80	80	1.0000000
NODE_17698_length_686_cov_16.715503	453	533	0	80	80	1.0000000
NODE_17757_length_685_cov_8.769625	178	258	2	31	80	0.3875000
NODE_17757_length_685_cov_8.769625	178	258	3	1	80	0.0125000
NODE_17757_length_685_cov_8.769625	178	258	4	48	80	0.6000000
NODE_17757_length_685_cov_8.769625	222	250	2	23	28	0.8214286
NODE_17757_length_685_cov_8.769625	222	250	4	5	28	0.1785714
NODE_17757_length_685_cov_8.769625	231	311	1	34	80	0.4250000
NODE_17757_length_685_cov_8.769625	231	311	2	46	80	0.5750000
NODE_17764_length_685_cov_4.447099	249	329	0	6	80	0.0750000
NODE_17764_length_685_cov_4.447099	249	329	2	74	80	0.9250000
NODE_17764_length_685_cov_4.447099	302	382	0	59	80	0.7375000
NODE_17764_length_685_cov_4.447099	302	382	2	21	80	0.2625000
NODE_17768_length_685_cov_3.556314	338	418	2	38	80	0.4750000
NODE_17768_length_685_cov_3.556314	338	418	4	26	80	0.3250000
NODE_17768_length_685_cov_3.556314	338	418	6	16	80	0.2000000
NODE_17768_length_685_cov_3.556314	391	471	4	79	80	0.9875000
NODE_17768_length_685_cov_3.556314	391	471	6	1	80	0.0125000
NODE_17821_length_684_cov_7.521368	189	269	0	80	80	1.0000000
NODE_17821_length_684_cov_7.521368	242	322	0	80	80	1.0000000
NODE_17832_length_684_cov_3.639316	306	386	0	80	80	1.0000000
NODE_17832_length_684_cov_3.639316	359	439	0	80	80	1.0000000
NODE_17866_length_683_cov_27.493151	346	426	0	80	80	1.0000000
NODE_17866_length_683_cov_27.493151	399	479	0	80	80	1.0000000
NODE_17867_length_683_cov_12.880137	242	321	2	79	79	1.0000000
NODE_17868_length_683_cov_11.772260	218	274	0	56	56	1.0000000
NODE_17868_length_683_cov_11.772260	247	333	0	86	86	1.0000000
NODE_17869_length_683_cov_9.936644	435	515	2	6	80	0.0750000
NODE_17869_length_683_cov_9.936644	435	515	4	37	80	0.4625000
NODE_17869_length_683_cov_9.936644	435	515	6	37	80	0.4625000
NODE_17869_length_683_cov_9.936644	488	568	2	38	80	0.4750000
NODE_17869_length_683_cov_9.936644	488	568	4	19	80	0.2375000
NODE_17869_length_683_cov_9.936644	488	568	6	23	80	0.2875000
NODE_17871_length_683_cov_9.017123	296	364	0	68	68	1.0000000
NODE_17871_length_683_cov_9.017123	337	417	0	80	80	1.0000000
NODE_17873_length_683_cov_6.797945	359	415	0	56	56	1.0000000
NODE_17884_length_683_cov_3.176370	113	186	0	73	73	1.0000000
NODE_17947_length_682_cov_33.516295	423	503	0	80	80	1.0000000
NODE_17947_length_682_cov_33.516295	476	556	0	80	80	1.0000000
NODE_17948_length_682_cov_27.022298	479	559	2	13	80	0.1625000
NODE_17948_length_682_cov_27.022298	479	559	4	11	80	0.1375000
NODE_17948_length_682_cov_27.022298	479	559	6	15	80	0.1875000
NODE_17948_length_682_cov_27.022298	479	559	8	34	80	0.4250000
NODE_17948_length_682_cov_27.022298	479	559	12	2	80	0.0250000
NODE_17948_length_682_cov_27.022298	479	559	17	1	80	0.0125000
NODE_17948_length_682_cov_27.022298	479	559	18	3	80	0.0375000
NODE_17948_length_682_cov_27.022298	479	559	20	1	80	0.0125000
NODE_17948_length_682_cov_27.022298	532	612	8	20	80	0.2500000
NODE_17948_length_682_cov_27.022298	532	612	12	2	80	0.0250000
NODE_17948_length_682_cov_27.022298	532	612	17	1	80	0.0125000
NODE_17948_length_682_cov_27.022298	532	612	18	27	80	0.3375000
NODE_17948_length_682_cov_27.022298	532	612	20	18	80	0.2250000
NODE_17948_length_682_cov_27.022298	532	612	22	7	80	0.0875000
NODE_17948_length_682_cov_27.022298	532	612	24	5	80	0.0625000
NODE_17949_length_682_cov_19.612350	434	514	0	10	80	0.1250000
NODE_17949_length_682_cov_19.612350	434	514	2	1	80	0.0125000
NODE_17949_length_682_cov_19.612350	434	514	4	69	80	0.8625000
NODE_17949_length_682_cov_19.612350	487	567	0	63	80	0.7875000
NODE_17949_length_682_cov_19.612350	487	567	2	1	80	0.0125000
NODE_17949_length_682_cov_19.612350	487	567	4	16	80	0.2000000
NODE_17950_length_682_cov_16.620926	261	341	0	80	80	1.0000000
NODE_17950_length_682_cov_16.620926	314	394	0	68	80	0.8500000
NODE_17950_length_682_cov_16.620926	314	394	2	12	80	0.1500000
NODE_17951_length_682_cov_13.735849	251	331	0	80	80	1.0000000
NODE_17951_length_682_cov_13.735849	304	384	0	80	80	1.0000000
NODE_17952_length_682_cov_12.835334	228	308	2	80	80	1.0000000
NODE_17952_length_682_cov_12.835334	281	361	0	48	80	0.6000000
NODE_17952_length_682_cov_12.835334	281	361	2	32	80	0.4000000
NODE_17956_length_682_cov_7.504288	224	304	0	80	80	1.0000000
NODE_17956_length_682_cov_7.504288	277	357	0	80	80	1.0000000
NODE_17960_length_682_cov_5.102916	314	351	0	37	37	1.0000000
NODE_17963_length_682_cov_4.579760	152	232	0	80	80	1.0000000
NODE_17963_length_682_cov_4.579760	205	285	0	80	80	1.0000000
NODE_17967_length_682_cov_4.006861	317	397	0	80	80	1.0000000
NODE_17967_length_682_cov_4.006861	370	450	0	80	80	1.0000000
NODE_17968_length_682_cov_3.859348	160	240	0	80	80	1.0000000
NODE_17968_length_682_cov_3.859348	213	293	0	80	80	1.0000000
NODE_18010_length_681_cov_51.810997	181	261	0	80	80	1.0000000
NODE_18010_length_681_cov_51.810997	234	316	0	82	82	1.0000000
NODE_18011_length_681_cov_32.128866	347	427	0	80	80	1.0000000
NODE_18011_length_681_cov_32.128866	400	475	0	75	75	1.0000000
NODE_18012_length_681_cov_19.079038	282	362	0	80	80	1.0000000
NODE_18012_length_681_cov_19.079038	335	415	0	80	80	1.0000000
NODE_18013_length_681_cov_17.053265	294	374	0	80	80	1.0000000
NODE_18013_length_681_cov_17.053265	347	427	0	80	80	1.0000000
NODE_18014_length_681_cov_11.183849	306	386	2	80	80	1.0000000
NODE_18014_length_681_cov_11.183849	359	439	0	40	80	0.5000000
NODE_18014_length_681_cov_11.183849	359	439	2	40	80	0.5000000
NODE_18015_length_681_cov_8.065292	236	316	0	80	80	1.0000000
NODE_18015_length_681_cov_8.065292	289	369	0	80	80	1.0000000
NODE_18017_length_681_cov_6.888316	344	424	0	80	80	1.0000000
NODE_18017_length_681_cov_6.888316	397	477	0	80	80	1.0000000
NODE_18080_length_680_cov_35.695353	348	428	2	80	80	1.0000000
NODE_18080_length_680_cov_35.695353	401	481	0	23	80	0.2875000
NODE_18080_length_680_cov_35.695353	401	481	2	57	80	0.7125000
NODE_18081_length_680_cov_17.500861	296	376	0	80	80	1.0000000
NODE_18081_length_680_cov_17.500861	349	429	0	80	80	1.0000000
NODE_18082_length_680_cov_16.685026	260	340	0	80	80	1.0000000
NODE_18082_length_680_cov_16.685026	313	393	0	80	80	1.0000000
NODE_18083_length_680_cov_15.345955	332	412	0	17	80	0.2125000
NODE_18083_length_680_cov_15.345955	332	412	2	63	80	0.7875000
NODE_18083_length_680_cov_15.345955	385	465	0	12	80	0.1500000
NODE_18083_length_680_cov_15.345955	385	465	2	68	80	0.8500000
NODE_18089_length_680_cov_3.858864	458	538	0	80	80	1.0000000
NODE_18107_length_680_cov_1.879518	236	256	0	20	20	1.0000000
NODE_18146_length_679_cov_52.046552	367	447	2	38	80	0.4750000
NODE_18146_length_679_cov_52.046552	367	447	4	42	80	0.5250000
NODE_18146_length_679_cov_52.046552	420	500	0	42	80	0.5250000
NODE_18146_length_679_cov_52.046552	420	500	2	38	80	0.4750000
NODE_18147_length_679_cov_40.353448	179	259	0	40	80	0.5000000
NODE_18147_length_679_cov_40.353448	179	259	2	40	80	0.5000000
NODE_18147_length_679_cov_40.353448	232	312	2	49	80	0.6125000
NODE_18147_length_679_cov_40.353448	232	312	4	31	80	0.3875000
NODE_18148_length_679_cov_38.144828	364	428	0	36	64	0.5625000
NODE_18148_length_679_cov_38.144828	364	428	2	28	64	0.4375000
NODE_18148_length_679_cov_38.144828	401	481	2	43	80	0.5375000
NODE_18148_length_679_cov_38.144828	401	481	4	37	80	0.4625000
NODE_18149_length_679_cov_17.134483	277	357	0	80	80	1.0000000
NODE_18149_length_679_cov_17.134483	330	410	0	80	80	1.0000000
NODE_18150_length_679_cov_15.046552	310	375	0	65	65	1.0000000
NODE_18151_length_679_cov_12.586207	247	327	0	21	80	0.2625000
NODE_18151_length_679_cov_12.586207	247	327	2	59	80	0.7375000
NODE_18151_length_679_cov_12.586207	303	381	0	75	78	0.9615384
NODE_18151_length_679_cov_12.586207	303	381	2	3	78	0.0384615
NODE_18152_length_679_cov_12.282759	337	417	0	67	80	0.8375000
NODE_18152_length_679_cov_12.282759	337	417	2	13	80	0.1625000
NODE_18152_length_679_cov_12.282759	390	470	0	80	80	1.0000000
NODE_18153_length_679_cov_11.532759	205	285	0	65	80	0.8125000
NODE_18153_length_679_cov_11.532759	205	285	2	15	80	0.1875000
NODE_18153_length_679_cov_11.532759	258	338	0	12	80	0.1500000
NODE_18153_length_679_cov_11.532759	258	338	2	68	80	0.8500000
NODE_18155_length_679_cov_8.043103	269	341	0	72	72	1.0000000
NODE_18155_length_679_cov_8.043103	314	394	0	43	80	0.5375000
NODE_18155_length_679_cov_8.043103	314	394	2	9	80	0.1125000
NODE_18155_length_679_cov_8.043103	314	394	4	5	80	0.0625000
NODE_18155_length_679_cov_8.043103	314	394	6	23	80	0.2875000
NODE_18156_length_679_cov_7.267241	191	271	0	80	80	1.0000000
NODE_18156_length_679_cov_7.267241	244	324	0	80	80	1.0000000
NODE_18162_length_679_cov_5.391379	279	331	0	4	52	0.0769231
NODE_18162_length_679_cov_5.391379	279	331	2	48	52	0.9230769
NODE_18164_length_679_cov_3.813793	10	69	2	6	59	0.1016949
NODE_18164_length_679_cov_3.813793	10	69	4	16	59	0.2711864
NODE_18164_length_679_cov_3.813793	10	69	6	37	59	0.6271186
NODE_18164_length_679_cov_3.813793	48	122	0	30	74	0.4054054
NODE_18164_length_679_cov_3.813793	48	122	2	29	74	0.3918919
NODE_18164_length_679_cov_3.813793	48	122	6	15	74	0.2027027
NODE_18217_length_678_cov_38.910190	252	332	0	80	80	1.0000000
NODE_18217_length_678_cov_38.910190	305	385	0	80	80	1.0000000
NODE_18217_length_678_cov_38.910190	381	461	0	15	80	0.1875000
NODE_18217_length_678_cov_38.910190	381	461	4	32	80	0.4000000
NODE_18217_length_678_cov_38.910190	381	461	6	33	80	0.4125000
NODE_18217_length_678_cov_38.910190	434	514	4	21	80	0.2625000
NODE_18217_length_678_cov_38.910190	434	514	6	59	80	0.7375000
NODE_18218_length_678_cov_20.663212	243	323	0	41	80	0.5125000
NODE_18218_length_678_cov_20.663212	243	323	4	12	80	0.1500000
NODE_18218_length_678_cov_20.663212	243	323	6	27	80	0.3375000
NODE_18218_length_678_cov_20.663212	296	376	6	80	80	1.0000000
NODE_18219_length_678_cov_12.081174	243	323	0	80	80	1.0000000
NODE_18219_length_678_cov_12.081174	296	376	0	80	80	1.0000000
NODE_18224_length_678_cov_6.559585	195	264	0	69	69	1.0000000
NODE_18224_length_678_cov_6.559585	237	317	0	80	80	1.0000000
NODE_18228_length_678_cov_4.462867	133	213	1	77	80	0.9625000
NODE_18228_length_678_cov_4.462867	133	213	3	3	80	0.0375000
NODE_18228_length_678_cov_4.462867	186	266	1	24	80	0.3000000
NODE_18228_length_678_cov_4.462867	186	266	3	31	80	0.3875000
NODE_18228_length_678_cov_4.462867	186	266	4	25	80	0.3125000
NODE_18239_length_678_cov_2.716753	351	431	0	80	80	1.0000000
NODE_18239_length_678_cov_2.716753	404	484	0	80	80	1.0000000
NODE_18289_length_677_cov_22.235294	274	354	0	80	80	1.0000000
NODE_18289_length_677_cov_22.235294	327	407	0	80	80	1.0000000
NODE_18290_length_677_cov_16.410035	124	206	2	9	82	0.1097561
NODE_18290_length_677_cov_16.410035	124	206	4	73	82	0.8902439
NODE_18290_length_677_cov_16.410035	177	261	0	12	84	0.1428571
NODE_18290_length_677_cov_16.410035	177	261	2	50	84	0.5952381
NODE_18290_length_677_cov_16.410035	177	261	4	22	84	0.2619048
NODE_18291_length_677_cov_11.031142	393	473	0	80	80	1.0000000
NODE_18291_length_677_cov_11.031142	446	526	0	80	80	1.0000000
NODE_18292_length_677_cov_10.129758	258	338	0	50	80	0.6250000
NODE_18292_length_677_cov_10.129758	258	338	2	30	80	0.3750000
NODE_18292_length_677_cov_10.129758	311	391	2	80	80	1.0000000
NODE_18295_length_677_cov_6.660900	217	297	33	2	80	0.0250000
NODE_18295_length_677_cov_6.660900	217	297	34	8	80	0.1000000
NODE_18295_length_677_cov_6.660900	217	297	36	6	80	0.0750000
NODE_18295_length_677_cov_6.660900	217	297	38	2	80	0.0250000
NODE_18295_length_677_cov_6.660900	217	297	40	2	80	0.0250000
NODE_18295_length_677_cov_6.660900	217	297	42	2	80	0.0250000
NODE_18295_length_677_cov_6.660900	217	297	46	2	80	0.0250000
NODE_18295_length_677_cov_6.660900	217	297	48	9	80	0.1125000
NODE_18295_length_677_cov_6.660900	217	297	50	47	80	0.5875000
NODE_18297_length_677_cov_5.228374	366	446	0	80	80	1.0000000
NODE_18312_length_677_cov_2.306228	230	278	0	48	48	1.0000000
NODE_18329_length_677_cov_1.709343	369	449	0	24	80	0.3000000
NODE_18329_length_677_cov_1.709343	369	449	2	28	80	0.3500000
NODE_18329_length_677_cov_1.709343	369	449	4	15	80	0.1875000
NODE_18329_length_677_cov_1.709343	369	449	6	13	80	0.1625000
NODE_18329_length_677_cov_1.709343	422	502	4	63	80	0.7875000
NODE_18329_length_677_cov_1.709343	422	502	6	17	80	0.2125000
NODE_18368_length_676_cov_66.473137	286	366	0	80	80	1.0000000
NODE_18368_length_676_cov_66.473137	339	419	0	48	80	0.6000000
NODE_18368_length_676_cov_66.473137	339	419	2	2	80	0.0250000
NODE_18368_length_676_cov_66.473137	339	419	4	30	80	0.3750000
NODE_18368_length_676_cov_66.473137	383	419	0	4	36	0.1111111
NODE_18368_length_676_cov_66.473137	383	419	2	2	36	0.0555556
NODE_18368_length_676_cov_66.473137	383	419	4	30	36	0.8333333
NODE_18368_length_676_cov_66.473137	383	419	0	4	36	0.1111111
NODE_18368_length_676_cov_66.473137	383	419	2	2	36	0.0555556
NODE_18368_length_676_cov_66.473137	383	419	4	30	36	0.8333333
NODE_18368_length_676_cov_66.473137	398	419	4	21	21	1.0000000
NODE_18369_length_676_cov_14.429809	259	330	0	61	71	0.8591549
NODE_18369_length_676_cov_14.429809	259	330	2	10	71	0.1408451
NODE_18370_length_676_cov_13.882149	292	372	0	80	80	1.0000000
NODE_18370_length_676_cov_13.882149	345	425	0	80	80	1.0000000
NODE_18374_length_676_cov_7.225303	363	443	0	80	80	1.0000000
NODE_18374_length_676_cov_7.225303	416	496	0	80	80	1.0000000
NODE_18375_length_676_cov_6.740035	373	433	0	60	60	1.0000000
NODE_18375_length_676_cov_6.740035	406	486	0	80	80	1.0000000
NODE_18378_length_676_cov_4.658579	167	240	0	2	73	0.0273973
NODE_18378_length_676_cov_4.658579	167	240	2	71	73	0.9726027
NODE_18397_length_676_cov_2.292894	146	226	2	80	80	1.0000000
NODE_18401_length_676_cov_2.157712	175	226	2	51	51	1.0000000
NODE_18417_length_676_cov_1.547660	133	164	0	31	31	1.0000000
NODE_18447_length_675_cov_27.574653	190	270	0	13	80	0.1625000
NODE_18447_length_675_cov_27.574653	190	270	2	67	80	0.8375000
NODE_18447_length_675_cov_27.574653	243	323	0	48	80	0.6000000
NODE_18447_length_675_cov_27.574653	243	323	2	32	80	0.4000000
NODE_18448_length_675_cov_11.895833	336	416	0	29	80	0.3625000
NODE_18448_length_675_cov_11.895833	336	416	2	51	80	0.6375000
NODE_18448_length_675_cov_11.895833	389	469	0	22	80	0.2750000
NODE_18448_length_675_cov_11.895833	389	469	2	58	80	0.7250000
NODE_18449_length_675_cov_8.157986	414	494	0	2	80	0.0250000
NODE_18449_length_675_cov_8.157986	414	494	2	78	80	0.9750000
NODE_18449_length_675_cov_8.157986	467	547	0	21	80	0.2625000
NODE_18449_length_675_cov_8.157986	467	547	2	25	80	0.3125000
NODE_18449_length_675_cov_8.157986	467	547	5	34	80	0.4250000
NODE_18450_length_675_cov_8.026042	320	400	0	80	80	1.0000000
NODE_18450_length_675_cov_8.026042	373	453	0	80	80	1.0000000
NODE_18451_length_675_cov_7.277778	317	397	0	80	80	1.0000000
NODE_18455_length_675_cov_5.666667	142	222	0	80	80	1.0000000
NODE_18455_length_675_cov_5.666667	195	275	0	80	80	1.0000000
NODE_18464_length_675_cov_2.751736	67	122	2	3	55	0.0545455
NODE_18464_length_675_cov_2.751736	67	122	4	52	55	0.9454545
NODE_18467_length_675_cov_2.623264	251	289	2	38	38	1.0000000
NODE_18467_length_675_cov_2.623264	279	343	0	17	64	0.2656250
NODE_18467_length_675_cov_2.623264	279	343	2	47	64	0.7343750
NODE_18467_length_675_cov_2.623264	432	494	0	62	62	1.0000000
NODE_18515_length_674_cov_38.401739	225	305	0	11	80	0.1375000
NODE_18515_length_674_cov_38.401739	225	305	2	69	80	0.8625000
NODE_18515_length_674_cov_38.401739	278	358	0	50	80	0.6250000
NODE_18515_length_674_cov_38.401739	278	358	2	30	80	0.3750000
NODE_18516_length_674_cov_30.215652	519	599	14	7	80	0.0875000
NODE_18516_length_674_cov_30.215652	519	599	16	9	80	0.1125000
NODE_18516_length_674_cov_30.215652	519	599	18	9	80	0.1125000
NODE_18516_length_674_cov_30.215652	519	599	20	55	80	0.6875000
NODE_18516_length_674_cov_30.215652	572	602	14	10	30	0.3333333
NODE_18516_length_674_cov_30.215652	572	602	16	4	30	0.1333333
NODE_18516_length_674_cov_30.215652	572	602	18	6	30	0.2000000
NODE_18516_length_674_cov_30.215652	572	602	20	10	30	0.3333333
NODE_18517_length_674_cov_19.636522	283	363	0	80	80	1.0000000
NODE_18517_length_674_cov_19.636522	336	416	0	80	80	1.0000000
NODE_18518_length_674_cov_19.436522	81	161	0	27	80	0.3375000
NODE_18518_length_674_cov_19.436522	81	161	2	21	80	0.2625000
NODE_18518_length_674_cov_19.436522	81	161	4	32	80	0.4000000
NODE_18518_length_674_cov_19.436522	134	214	0	2	80	0.0250000
NODE_18518_length_674_cov_19.436522	134	214	2	42	80	0.5250000
NODE_18518_length_674_cov_19.436522	134	214	4	36	80	0.4500000
NODE_18519_length_674_cov_16.819130	185	265	0	53	80	0.6625000
NODE_18519_length_674_cov_16.819130	185	265	2	27	80	0.3375000
NODE_18519_length_674_cov_16.819130	238	318	0	26	80	0.3250000
NODE_18519_length_674_cov_16.819130	238	318	2	25	80	0.3125000
NODE_18519_length_674_cov_16.819130	238	318	4	29	80	0.3625000
NODE_18520_length_674_cov_14.733913	169	249	0	37	80	0.4625000
NODE_18520_length_674_cov_14.733913	169	249	3	19	80	0.2375000
NODE_18520_length_674_cov_14.733913	169	249	5	5	80	0.0625000
NODE_18520_length_674_cov_14.733913	169	249	6	19	80	0.2375000
NODE_18520_length_674_cov_14.733913	222	302	3	3	80	0.0375000
NODE_18520_length_674_cov_14.733913	222	302	4	18	80	0.2250000
NODE_18520_length_674_cov_14.733913	222	302	5	5	80	0.0625000
NODE_18520_length_674_cov_14.733913	222	302	6	32	80	0.4000000
NODE_18520_length_674_cov_14.733913	222	302	8	22	80	0.2750000
NODE_18524_length_674_cov_7.086957	357	437	0	80	80	1.0000000
NODE_18524_length_674_cov_7.086957	410	490	0	73	80	0.9125000
NODE_18524_length_674_cov_7.086957	410	490	1	1	80	0.0125000
NODE_18524_length_674_cov_7.086957	410	490	2	6	80	0.0750000
NODE_18528_length_674_cov_4.808696	262	342	0	80	80	1.0000000
NODE_18528_length_674_cov_4.808696	315	395	0	80	80	1.0000000
NODE_18592_length_673_cov_47.109756	405	485	0	28	80	0.3500000
NODE_18592_length_673_cov_47.109756	405	485	2	52	80	0.6500000
NODE_18592_length_673_cov_47.109756	458	538	0	80	80	1.0000000
NODE_18593_length_673_cov_20.548780	214	294	0	25	80	0.3125000
NODE_18593_length_673_cov_20.548780	214	294	2	36	80	0.4500000
NODE_18593_length_673_cov_20.548780	214	294	4	19	80	0.2375000
NODE_18593_length_673_cov_20.548780	267	347	2	43	80	0.5375000
NODE_18593_length_673_cov_20.548780	267	347	4	37	80	0.4625000
NODE_18596_length_673_cov_8.306620	337	426	0	89	89	1.0000000
NODE_18607_length_673_cov_3.041812	196	276	0	80	80	1.0000000
NODE_18607_length_673_cov_3.041812	249	329	0	80	80	1.0000000
NODE_18660_length_672_cov_15.380454	282	362	0	17	80	0.2125000
NODE_18660_length_672_cov_15.380454	282	362	2	63	80	0.7875000
NODE_18660_length_672_cov_15.380454	335	415	2	80	80	1.0000000
NODE_18661_length_672_cov_9.902269	328	408	0	80	80	1.0000000
NODE_18661_length_672_cov_9.902269	381	461	0	80	80	1.0000000
NODE_18662_length_672_cov_9.462478	309	389	0	15	80	0.1875000
NODE_18662_length_672_cov_9.462478	309	389	2	65	80	0.8125000
NODE_18662_length_672_cov_9.462478	362	442	0	68	80	0.8500000
NODE_18662_length_672_cov_9.462478	362	442	2	12	80	0.1500000
NODE_18666_length_672_cov_6.516579	354	434	0	80	80	1.0000000
NODE_18666_length_672_cov_6.516579	407	487	0	80	80	1.0000000
NODE_18668_length_672_cov_6.108202	135	215	0	80	80	1.0000000
NODE_18668_length_672_cov_6.108202	188	268	0	80	80	1.0000000
NODE_18670_length_672_cov_4.949389	115	152	0	37	37	1.0000000
NODE_18670_length_672_cov_4.949389	125	205	0	80	80	1.0000000
NODE_18670_length_672_cov_4.949389	278	326	0	48	48	1.0000000
NODE_18672_length_672_cov_4.753927	378	450	0	72	72	1.0000000
NODE_18704_length_672_cov_1.713787	340	401	2	13	61	0.2131148
NODE_18704_length_672_cov_1.713787	340	401	3	1	61	0.0163934
NODE_18704_length_672_cov_1.713787	340	401	4	47	61	0.7704918
NODE_18742_length_671_cov_28.874126	306	387	2	81	81	1.0000000
NODE_18742_length_671_cov_28.874126	360	440	0	16	80	0.2000000
NODE_18742_length_671_cov_28.874126	360	440	2	64	80	0.8000000
NODE_18744_length_671_cov_18.526224	294	333	0	39	39	1.0000000
NODE_18744_length_671_cov_18.526224	331	404	0	12	73	0.1643836
NODE_18744_length_671_cov_18.526224	331	404	2	61	73	0.8356164
NODE_18744_length_671_cov_18.526224	331	351	0	12	20	0.6000000
NODE_18744_length_671_cov_18.526224	331	351	2	8	20	0.4000000
NODE_18745_length_671_cov_16.094406	417	497	0	40	80	0.5000000
NODE_18745_length_671_cov_16.094406	417	497	2	40	80	0.5000000
NODE_18745_length_671_cov_16.094406	470	550	0	30	80	0.3750000
NODE_18745_length_671_cov_16.094406	470	550	2	50	80	0.6250000
NODE_18746_length_671_cov_11.756993	337	417	0	29	80	0.3625000
NODE_18746_length_671_cov_11.756993	337	417	2	8	80	0.1000000
NODE_18746_length_671_cov_11.756993	337	417	4	26	80	0.3250000
NODE_18746_length_671_cov_11.756993	337	417	5	17	80	0.2125000
NODE_18746_length_671_cov_11.756993	390	470	0	80	80	1.0000000
NODE_18747_length_671_cov_9.237762	305	382	0	77	77	1.0000000
NODE_18748_length_671_cov_8.491259	298	379	0	81	81	1.0000000
NODE_18748_length_671_cov_8.491259	352	430	0	78	78	1.0000000
NODE_18749_length_671_cov_8.241259	97	128	2	31	31	1.0000000
NODE_18752_length_671_cov_7.201049	368	448	0	80	80	1.0000000
NODE_18752_length_671_cov_7.201049	421	501	0	80	80	1.0000000
NODE_18753_length_671_cov_5.680070	370	450	2	80	80	1.0000000
NODE_18753_length_671_cov_5.680070	423	503	0	53	80	0.6625000
NODE_18753_length_671_cov_5.680070	423	503	2	27	80	0.3375000
NODE_18754_length_671_cov_4.769231	362	414	0	16	52	0.3076923
NODE_18754_length_671_cov_4.769231	362	414	2	1	52	0.0192308
NODE_18754_length_671_cov_4.769231	362	414	4	35	52	0.6730769
NODE_18760_length_671_cov_3.804196	360	440	0	16	80	0.2000000
NODE_18760_length_671_cov_3.804196	360	440	2	11	80	0.1375000
NODE_18760_length_671_cov_3.804196	360	440	8	4	80	0.0500000
NODE_18760_length_671_cov_3.804196	360	440	10	49	80	0.6125000
NODE_18812_length_670_cov_21.017513	443	523	0	80	80	1.0000000
NODE_18812_length_670_cov_21.017513	496	576	0	80	80	1.0000000
NODE_18813_length_670_cov_20.346760	372	452	0	80	80	1.0000000
NODE_18813_length_670_cov_20.346760	425	505	0	80	80	1.0000000
NODE_18814_length_670_cov_15.728546	157	237	0	80	80	1.0000000
NODE_18814_length_670_cov_15.728546	210	290	0	80	80	1.0000000
NODE_18814_length_670_cov_15.728546	286	366	0	71	80	0.8875000
NODE_18814_length_670_cov_15.728546	286	366	2	9	80	0.1125000
NODE_18814_length_670_cov_15.728546	339	419	0	18	80	0.2250000
NODE_18814_length_670_cov_15.728546	339	419	2	62	80	0.7750000
NODE_18818_length_670_cov_6.499124	390	470	2	7	80	0.0875000
NODE_18818_length_670_cov_6.499124	390	470	4	73	80	0.9125000
NODE_18834_length_670_cov_3.099825	159	217	0	58	58	1.0000000
NODE_18838_length_670_cov_2.700525	252	332	0	80	80	1.0000000
NODE_18838_length_670_cov_2.700525	305	385	0	80	80	1.0000000
NODE_18883_length_669_cov_13.307018	432	512	0	75	80	0.9375000
NODE_18883_length_669_cov_13.307018	432	512	2	5	80	0.0625000
NODE_18883_length_669_cov_13.307018	485	565	0	80	80	1.0000000
NODE_18886_length_669_cov_6.921053	245	325	0	80	80	1.0000000
NODE_18886_length_669_cov_6.921053	298	370	0	32	72	0.4444444
NODE_18886_length_669_cov_6.921053	298	370	2	40	72	0.5555556
NODE_18901_length_669_cov_3.633333	277	347	0	70	70	1.0000000
NODE_18909_length_669_cov_2.361404	434	490	0	56	56	1.0000000
NODE_18958_length_668_cov_23.131810	275	355	2	9	80	0.1125000
NODE_18958_length_668_cov_23.131810	275	355	4	71	80	0.8875000
NODE_18958_length_668_cov_23.131810	328	408	2	5	80	0.0625000
NODE_18958_length_668_cov_23.131810	328	408	4	42	80	0.5250000
NODE_18958_length_668_cov_23.131810	328	408	6	33	80	0.4125000
NODE_18959_length_668_cov_14.978910	324	404	0	80	80	1.0000000
NODE_18959_length_668_cov_14.978910	377	457	0	80	80	1.0000000
NODE_18962_length_668_cov_11.184534	187	267	0	80	80	1.0000000
NODE_18962_length_668_cov_11.184534	240	320	0	48	80	0.6000000
NODE_18962_length_668_cov_11.184534	240	320	2	32	80	0.4000000
NODE_18963_length_668_cov_10.548330	211	291	0	80	80	1.0000000
NODE_18963_length_668_cov_10.548330	264	344	0	80	80	1.0000000
NODE_18964_length_668_cov_10.370826	226	308	0	20	82	0.2439024
NODE_18964_length_668_cov_10.370826	226	308	2	62	82	0.7560976
NODE_18964_length_668_cov_10.370826	279	361	2	82	82	1.0000000
NODE_18965_length_668_cov_10.223199	238	318	0	80	80	1.0000000
NODE_18965_length_668_cov_10.223199	291	371	0	80	80	1.0000000
NODE_18967_length_668_cov_9.340949	310	390	0	80	80	1.0000000
NODE_18967_length_668_cov_9.340949	363	443	0	80	80	1.0000000
NODE_18975_length_668_cov_4.077329	304	384	0	18	80	0.2250000
NODE_18975_length_668_cov_4.077329	304	384	2	15	80	0.1875000
NODE_18975_length_668_cov_4.077329	304	384	4	47	80	0.5875000
NODE_18975_length_668_cov_4.077329	338	367	0	1	29	0.0344828
NODE_18975_length_668_cov_4.077329	338	367	2	15	29	0.5172414
NODE_18975_length_668_cov_4.077329	338	367	4	13	29	0.4482759
NODE_18975_length_668_cov_4.077329	358	427	0	61	69	0.8840580
NODE_18975_length_668_cov_4.077329	358	427	2	8	69	0.1159420
NODE_19032_length_667_cov_33.848592	168	248	0	59	80	0.7375000
NODE_19032_length_667_cov_33.848592	168	248	2	21	80	0.2625000
NODE_19032_length_667_cov_33.848592	221	301	0	80	80	1.0000000
NODE_19033_length_667_cov_21.218310	270	350	0	80	80	1.0000000
NODE_19033_length_667_cov_21.218310	323	403	0	80	80	1.0000000
NODE_19034_length_667_cov_19.204225	258	338	0	80	80	1.0000000
NODE_19034_length_667_cov_19.204225	311	391	0	80	80	1.0000000
NODE_19036_length_667_cov_8.264085	299	379	0	80	80	1.0000000
NODE_19036_length_667_cov_8.264085	352	432	0	80	80	1.0000000
NODE_19037_length_667_cov_8.248239	76	156	0	32	80	0.4000000
NODE_19037_length_667_cov_8.248239	76	156	2	48	80	0.6000000
NODE_19037_length_667_cov_8.248239	129	209	2	80	80	1.0000000
NODE_19038_length_667_cov_8.207746	257	323	0	66	66	1.0000000
NODE_19038_length_667_cov_8.207746	296	376	0	80	80	1.0000000
NODE_19039_length_667_cov_7.232394	357	437	0	80	80	1.0000000
NODE_19039_length_667_cov_7.232394	410	490	0	76	80	0.9500000
NODE_19039_length_667_cov_7.232394	410	490	2	4	80	0.0500000
NODE_19042_length_667_cov_4.941901	199	279	0	80	80	1.0000000
NODE_19042_length_667_cov_4.941901	252	332	0	80	80	1.0000000
NODE_19053_length_667_cov_3.404930	501	536	2	9	35	0.2571429
NODE_19053_length_667_cov_3.404930	501	536	4	26	35	0.7428572
NODE_19053_length_667_cov_3.404930	503	533	2	6	30	0.2000000
NODE_19053_length_667_cov_3.404930	503	533	4	24	30	0.8000000
NODE_19100_length_666_cov_24.811287	179	254	8	10	75	0.1333333
NODE_19100_length_666_cov_24.811287	179	254	10	65	75	0.8666667
NODE_19100_length_666_cov_24.811287	182	254	8	10	72	0.1388889
NODE_19100_length_666_cov_24.811287	182	254	10	62	72	0.8611111
NODE_19100_length_666_cov_24.811287	227	307	0	22	80	0.2750000
NODE_19100_length_666_cov_24.811287	227	307	2	23	80	0.2875000
NODE_19100_length_666_cov_24.811287	227	307	6	5	80	0.0625000
NODE_19100_length_666_cov_24.811287	227	307	8	13	80	0.1625000
NODE_19100_length_666_cov_24.811287	227	307	10	17	80	0.2125000
NODE_19100_length_666_cov_24.811287	227	307	0	22	80	0.2750000
NODE_19100_length_666_cov_24.811287	227	307	2	23	80	0.2875000
NODE_19100_length_666_cov_24.811287	227	307	6	5	80	0.0625000
NODE_19100_length_666_cov_24.811287	227	307	8	13	80	0.1625000
NODE_19100_length_666_cov_24.811287	227	307	10	17	80	0.2125000
NODE_19100_length_666_cov_24.811287	303	383	0	10	80	0.1250000
NODE_19100_length_666_cov_24.811287	303	383	2	15	80	0.1875000
NODE_19100_length_666_cov_24.811287	303	383	4	3	80	0.0375000
NODE_19100_length_666_cov_24.811287	303	383	6	2	80	0.0250000
NODE_19100_length_666_cov_24.811287	303	383	8	1	80	0.0125000
NODE_19100_length_666_cov_24.811287	303	383	17	4	80	0.0500000
NODE_19100_length_666_cov_24.811287	303	383	19	1	80	0.0125000
NODE_19100_length_666_cov_24.811287	303	383	21	3	80	0.0375000
NODE_19100_length_666_cov_24.811287	303	383	27	3	80	0.0375000
NODE_19100_length_666_cov_24.811287	303	383	29	2	80	0.0250000
NODE_19100_length_666_cov_24.811287	303	383	30	1	80	0.0125000
NODE_19100_length_666_cov_24.811287	303	383	34	2	80	0.0250000
NODE_19100_length_666_cov_24.811287	303	383	36	5	80	0.0625000
NODE_19100_length_666_cov_24.811287	303	383	38	2	80	0.0250000
NODE_19100_length_666_cov_24.811287	303	383	39	4	80	0.0500000
NODE_19100_length_666_cov_24.811287	303	383	41	1	80	0.0125000
NODE_19100_length_666_cov_24.811287	303	383	42	21	80	0.2625000
NODE_19100_length_666_cov_24.811287	356	436	12	4	80	0.0500000
NODE_19100_length_666_cov_24.811287	356	436	14	4	80	0.0500000
NODE_19100_length_666_cov_24.811287	356	436	28	4	80	0.0500000
NODE_19100_length_666_cov_24.811287	356	436	32	1	80	0.0125000
NODE_19100_length_666_cov_24.811287	356	436	34	3	80	0.0375000
NODE_19100_length_666_cov_24.811287	356	436	36	3	80	0.0375000
NODE_19100_length_666_cov_24.811287	356	436	38	2	80	0.0250000
NODE_19100_length_666_cov_24.811287	356	436	39	4	80	0.0500000
NODE_19100_length_666_cov_24.811287	356	436	40	25	80	0.3125000
NODE_19100_length_666_cov_24.811287	356	436	41	1	80	0.0125000
NODE_19100_length_666_cov_24.811287	356	436	42	29	80	0.3625000
NODE_19102_length_666_cov_20.114638	172	252	0	80	80	1.0000000
NODE_19102_length_666_cov_20.114638	225	305	0	80	80	1.0000000
NODE_19103_length_666_cov_16.813051	220	286	0	40	66	0.6060606
NODE_19103_length_666_cov_16.813051	220	286	4	26	66	0.3939394
NODE_19103_length_666_cov_16.813051	259	344	0	9	85	0.1058824
NODE_19103_length_666_cov_16.813051	259	344	1	4	85	0.0470588
NODE_19103_length_666_cov_16.813051	259	344	3	5	85	0.0588235
NODE_19103_length_666_cov_16.813051	259	344	4	67	85	0.7882353
NODE_19104_length_666_cov_15.384480	306	386	0	80	80	1.0000000
NODE_19104_length_666_cov_15.384480	359	439	0	80	80	1.0000000
NODE_19105_length_666_cov_14.195767	485	565	0	80	80	1.0000000
NODE_19105_length_666_cov_14.195767	538	618	0	80	80	1.0000000
NODE_19108_length_666_cov_7.770723	226	306	0	80	80	1.0000000
NODE_19108_length_666_cov_7.770723	279	359	0	80	80	1.0000000
NODE_19163_length_665_cov_28.786219	391	471	0	64	80	0.8000000
NODE_19163_length_665_cov_28.786219	391	471	2	16	80	0.2000000
NODE_19163_length_665_cov_28.786219	444	524	0	16	80	0.2000000
NODE_19163_length_665_cov_28.786219	444	524	2	64	80	0.8000000
NODE_19164_length_665_cov_21.740283	311	391	2	61	80	0.7625000
NODE_19164_length_665_cov_21.740283	311	391	4	19	80	0.2375000
NODE_19164_length_665_cov_21.740283	364	444	0	50	80	0.6250000
NODE_19164_length_665_cov_21.740283	364	444	2	30	80	0.3750000
NODE_19165_length_665_cov_15.904594	390	470	0	80	80	1.0000000
NODE_19165_length_665_cov_15.904594	443	523	0	80	80	1.0000000
NODE_19224_length_664_cov_27.208850	259	339	0	80	80	1.0000000
NODE_19224_length_664_cov_27.208850	345	404	0	59	59	1.0000000
NODE_19225_length_664_cov_16.116814	241	321	0	80	80	1.0000000
NODE_19225_length_664_cov_16.116814	294	374	0	80	80	1.0000000
NODE_19227_length_664_cov_14.185841	332	412	2	10	80	0.1250000
NODE_19227_length_664_cov_14.185841	332	412	6	1	80	0.0125000
NODE_19227_length_664_cov_14.185841	332	412	8	69	80	0.8625000
NODE_19227_length_664_cov_14.185841	385	465	0	52	80	0.6500000
NODE_19227_length_664_cov_14.185841	385	465	2	11	80	0.1375000
NODE_19227_length_664_cov_14.185841	385	465	6	1	80	0.0125000
NODE_19227_length_664_cov_14.185841	385	465	8	16	80	0.2000000
NODE_19228_length_664_cov_12.256637	325	405	0	80	80	1.0000000
NODE_19228_length_664_cov_12.256637	378	454	0	76	76	1.0000000
NODE_19229_length_664_cov_8.378761	252	332	2	40	80	0.5000000
NODE_19229_length_664_cov_8.378761	252	332	4	40	80	0.5000000
NODE_19229_length_664_cov_8.378761	305	385	0	29	80	0.3625000
NODE_19229_length_664_cov_8.378761	305	385	2	7	80	0.0875000
NODE_19229_length_664_cov_8.378761	305	385	3	14	80	0.1750000
NODE_19229_length_664_cov_8.378761	305	385	4	30	80	0.3750000
NODE_19229_length_664_cov_8.378761	381	461	0	80	80	1.0000000
NODE_19229_length_664_cov_8.378761	434	514	0	80	80	1.0000000
NODE_19254_length_664_cov_1.922124	393	434	0	11	41	0.2682927
NODE_19254_length_664_cov_1.922124	393	434	2	2	41	0.0487805
NODE_19254_length_664_cov_1.922124	393	434	4	28	41	0.6829268
NODE_19298_length_663_cov_26.601064	398	478	0	80	80	1.0000000
NODE_19298_length_663_cov_26.601064	451	531	0	80	80	1.0000000
NODE_19299_length_663_cov_16.948582	368	448	4	11	80	0.1375000
NODE_19299_length_663_cov_16.948582	368	448	6	3	80	0.0375000
NODE_19299_length_663_cov_16.948582	368	448	8	66	80	0.8250000
NODE_19299_length_663_cov_16.948582	421	501	0	8	80	0.1000000
NODE_19299_length_663_cov_16.948582	421	501	2	38	80	0.4750000
NODE_19299_length_663_cov_16.948582	421	501	4	8	80	0.1000000
NODE_19299_length_663_cov_16.948582	421	501	6	3	80	0.0375000
NODE_19299_length_663_cov_16.948582	421	501	8	23	80	0.2875000
NODE_19300_length_663_cov_16.225177	118	198	0	80	80	1.0000000
NODE_19300_length_663_cov_16.225177	171	251	0	70	80	0.8750000
NODE_19300_length_663_cov_16.225177	171	251	2	10	80	0.1250000
NODE_19302_length_663_cov_13.748227	277	357	2	4	80	0.0500000
NODE_19302_length_663_cov_13.748227	277	357	4	10	80	0.1250000
NODE_19302_length_663_cov_13.748227	277	357	6	2	80	0.0250000
NODE_19302_length_663_cov_13.748227	277	357	7	14	80	0.1750000
NODE_19302_length_663_cov_13.748227	277	357	8	35	80	0.4375000
NODE_19302_length_663_cov_13.748227	277	357	10	15	80	0.1875000
NODE_19302_length_663_cov_13.748227	330	410	4	28	80	0.3500000
NODE_19302_length_663_cov_13.748227	330	410	8	13	80	0.1625000
NODE_19302_length_663_cov_13.748227	330	410	10	39	80	0.4875000
NODE_19303_length_663_cov_10.377660	300	380	0	4	80	0.0500000
NODE_19303_length_663_cov_10.377660	300	380	2	76	80	0.9500000
NODE_19304_length_663_cov_9.549645	199	279	0	49	80	0.6125000
NODE_19304_length_663_cov_9.549645	199	279	2	31	80	0.3875000
NODE_19304_length_663_cov_9.549645	252	332	0	8	80	0.1000000
NODE_19304_length_663_cov_9.549645	252	332	2	72	80	0.9000000
NODE_19305_length_663_cov_7.397163	151	231	0	80	80	1.0000000
NODE_19305_length_663_cov_7.397163	204	284	0	52	80	0.6500000
NODE_19305_length_663_cov_7.397163	204	284	2	28	80	0.3500000
NODE_19307_length_663_cov_5.081560	317	397	0	80	80	1.0000000
NODE_19368_length_662_cov_29.218472	233	313	0	68	80	0.8500000
NODE_19368_length_662_cov_29.218472	233	313	2	12	80	0.1500000
NODE_19368_length_662_cov_29.218472	286	366	0	15	80	0.1875000
NODE_19368_length_662_cov_29.218472	286	366	2	65	80	0.8125000
NODE_19369_length_662_cov_18.717584	193	273	0	80	80	1.0000000
NODE_19369_length_662_cov_18.717584	246	326	0	80	80	1.0000000
NODE_19370_length_662_cov_16.358792	258	338	0	80	80	1.0000000
NODE_19370_length_662_cov_16.358792	311	391	0	80	80	1.0000000
NODE_19371_length_662_cov_12.845471	259	339	0	80	80	1.0000000
NODE_19371_length_662_cov_12.845471	312	392	0	80	80	1.0000000
NODE_19372_length_662_cov_12.476021	299	379	0	80	80	1.0000000
NODE_19372_length_662_cov_12.476021	352	432	0	80	80	1.0000000
NODE_19373_length_662_cov_10.252220	239	319	0	80	80	1.0000000
NODE_19373_length_662_cov_10.252220	292	372	0	80	80	1.0000000
NODE_19376_length_662_cov_6.335702	267	347	2	18	80	0.2250000
NODE_19376_length_662_cov_6.335702	267	347	6	62	80	0.7750000
NODE_19376_length_662_cov_6.335702	320	400	1	18	80	0.2250000
NODE_19376_length_662_cov_6.335702	320	400	5	19	80	0.2375000
NODE_19376_length_662_cov_6.335702	320	400	6	43	80	0.5375000
NODE_19378_length_662_cov_5.738899	295	331	0	7	36	0.1944444
NODE_19378_length_662_cov_5.738899	295	331	4	29	36	0.8055556
NODE_19378_length_662_cov_5.738899	301	322	4	21	21	1.0000000
NODE_19402_length_662_cov_1.905861	150	230	2	80	80	1.0000000
NODE_19402_length_662_cov_1.905861	203	277	0	37	74	0.5000000
NODE_19402_length_662_cov_1.905861	203	277	2	37	74	0.5000000
NODE_19441_length_661_cov_55.176157	236	316	0	9	80	0.1125000
NODE_19441_length_661_cov_55.176157	236	316	2	12	80	0.1500000
NODE_19441_length_661_cov_55.176157	236	316	4	59	80	0.7375000
NODE_19441_length_661_cov_55.176157	289	369	0	62	80	0.7750000
NODE_19441_length_661_cov_55.176157	289	369	2	12	80	0.1500000
NODE_19441_length_661_cov_55.176157	289	369	4	6	80	0.0750000
NODE_19442_length_661_cov_38.501779	231	311	0	22	80	0.2750000
NODE_19442_length_661_cov_38.501779	231	311	2	58	80	0.7250000
NODE_19442_length_661_cov_38.501779	284	364	0	12	80	0.1500000
NODE_19442_length_661_cov_38.501779	284	364	2	68	80	0.8500000
NODE_19442_length_661_cov_38.501779	360	440	0	18	80	0.2250000
NODE_19442_length_661_cov_38.501779	360	440	2	62	80	0.7750000
NODE_19442_length_661_cov_38.501779	413	493	2	57	80	0.7125000
NODE_19442_length_661_cov_38.501779	413	493	4	12	80	0.1500000
NODE_19442_length_661_cov_38.501779	413	493	6	11	80	0.1375000
NODE_19443_length_661_cov_31.460854	128	208	0	68	80	0.8500000
NODE_19443_length_661_cov_31.460854	128	208	2	12	80	0.1500000
NODE_19443_length_661_cov_31.460854	181	261	0	21	80	0.2625000
NODE_19443_length_661_cov_31.460854	181	261	2	59	80	0.7375000
NODE_19444_length_661_cov_18.960854	216	296	0	80	80	1.0000000
NODE_19444_length_661_cov_18.960854	269	349	0	80	80	1.0000000
NODE_19445_length_661_cov_16.035587	201	281	0	80	80	1.0000000
NODE_19445_length_661_cov_16.035587	254	334	0	80	80	1.0000000
NODE_19447_length_661_cov_13.005338	281	343	0	62	62	1.0000000
NODE_19447_length_661_cov_13.005338	353	433	0	80	80	1.0000000
NODE_19447_length_661_cov_13.005338	406	486	0	80	80	1.0000000
NODE_19452_length_661_cov_5.670819	374	454	2	24	80	0.3000000
NODE_19452_length_661_cov_5.670819	374	454	4	56	80	0.7000000
NODE_19452_length_661_cov_5.670819	427	507	0	16	80	0.2000000
NODE_19452_length_661_cov_5.670819	427	507	2	39	80	0.4875000
NODE_19452_length_661_cov_5.670819	427	507	4	25	80	0.3125000
NODE_19457_length_661_cov_4.601423	319	395	0	76	76	1.0000000
NODE_19459_length_661_cov_3.532028	282	362	0	8	80	0.1000000
NODE_19459_length_661_cov_3.532028	282	362	2	72	80	0.9000000
NODE_19459_length_661_cov_3.532028	335	415	0	38	80	0.4750000
NODE_19459_length_661_cov_3.532028	335	415	2	42	80	0.5250000
NODE_19515_length_660_cov_20.741533	343	423	2	39	80	0.4875000
NODE_19515_length_660_cov_20.741533	343	423	7	1	80	0.0125000
NODE_19515_length_660_cov_20.741533	343	423	8	40	80	0.5000000
NODE_19515_length_660_cov_20.741533	396	476	0	20	80	0.2500000
NODE_19515_length_660_cov_20.741533	396	476	5	13	80	0.1625000
NODE_19515_length_660_cov_20.741533	396	476	7	2	80	0.0250000
NODE_19515_length_660_cov_20.741533	396	476	8	45	80	0.5625000
NODE_19516_length_660_cov_15.089127	148	228	0	80	80	1.0000000
NODE_19516_length_660_cov_15.089127	201	281	0	80	80	1.0000000
NODE_19518_length_660_cov_13.301248	276	356	0	80	80	1.0000000
NODE_19518_length_660_cov_13.301248	329	409	0	80	80	1.0000000
NODE_19519_length_660_cov_12.393939	234	314	0	80	80	1.0000000
NODE_19519_length_660_cov_12.393939	287	367	0	80	80	1.0000000
NODE_19521_length_660_cov_11.495544	399	479	0	80	80	1.0000000
NODE_19521_length_660_cov_11.495544	452	532	0	80	80	1.0000000
NODE_19522_length_660_cov_10.522282	177	257	0	80	80	1.0000000
NODE_19522_length_660_cov_10.522282	230	311	0	81	81	1.0000000
NODE_19524_length_660_cov_8.887701	254	325	0	15	71	0.2112676
NODE_19524_length_660_cov_8.887701	254	325	2	4	71	0.0563380
NODE_19524_length_660_cov_8.887701	254	325	4	52	71	0.7323943
NODE_19527_length_660_cov_7.278075	225	305	0	80	80	1.0000000
NODE_19527_length_660_cov_7.278075	278	358	0	80	80	1.0000000
NODE_19529_length_660_cov_6.577540	350	430	0	80	80	1.0000000
NODE_19529_length_660_cov_6.577540	403	483	0	73	80	0.9125000
NODE_19529_length_660_cov_6.577540	403	483	4	7	80	0.0875000
NODE_19549_length_660_cov_2.354724	421	470	0	38	49	0.7755102
NODE_19549_length_660_cov_2.354724	421	470	2	11	49	0.2244898
NODE_19594_length_659_cov_43.587500	2	82	0	21	80	0.2625000
NODE_19594_length_659_cov_43.587500	2	82	1	22	80	0.2750000
NODE_19594_length_659_cov_43.587500	2	82	2	37	80	0.4625000
NODE_19594_length_659_cov_43.587500	55	135	2	80	80	1.0000000
NODE_19594_length_659_cov_43.587500	131	211	2	21	80	0.2625000
NODE_19594_length_659_cov_43.587500	131	211	3	22	80	0.2750000
NODE_19594_length_659_cov_43.587500	131	211	4	37	80	0.4625000
NODE_19594_length_659_cov_43.587500	184	264	0	37	80	0.4625000
NODE_19594_length_659_cov_43.587500	184	264	2	32	80	0.4000000
NODE_19594_length_659_cov_43.587500	184	264	3	11	80	0.1375000
NODE_19595_length_659_cov_23.330357	236	316	0	80	80	1.0000000
NODE_19595_length_659_cov_23.330357	289	369	0	80	80	1.0000000
NODE_19596_length_659_cov_12.775000	255	335	0	17	80	0.2125000
NODE_19596_length_659_cov_12.775000	255	335	2	63	80	0.7875000
NODE_19596_length_659_cov_12.775000	308	388	2	79	80	0.9875000
NODE_19596_length_659_cov_12.775000	308	388	4	1	80	0.0125000
NODE_19598_length_659_cov_9.683929	220	298	0	78	78	1.0000000
NODE_19598_length_659_cov_9.683929	271	351	0	80	80	1.0000000
NODE_19613_length_659_cov_3.658929	305	385	0	80	80	1.0000000
NODE_19613_length_659_cov_3.658929	358	438	0	80	80	1.0000000
NODE_19678_length_658_cov_38.479428	289	369	0	48	80	0.6000000
NODE_19678_length_658_cov_38.479428	289	369	2	32	80	0.4000000
NODE_19678_length_658_cov_38.479428	342	422	2	80	80	1.0000000
NODE_19679_length_658_cov_35.409660	242	322	0	27	80	0.3375000
NODE_19679_length_658_cov_35.409660	242	322	2	53	80	0.6625000
NODE_19679_length_658_cov_35.409660	295	375	0	80	80	1.0000000
NODE_19680_length_658_cov_20.322004	191	271	0	10	80	0.1250000
NODE_19680_length_658_cov_20.322004	191	271	2	70	80	0.8750000
NODE_19680_length_658_cov_20.322004	244	321	0	60	77	0.7792208
NODE_19680_length_658_cov_20.322004	244	321	2	17	77	0.2207792
NODE_19680_length_658_cov_20.322004	317	397	0	80	80	1.0000000
NODE_19680_length_658_cov_20.322004	370	449	0	79	79	1.0000000
NODE_19681_length_658_cov_11.352415	324	404	0	15	80	0.1875000
NODE_19681_length_658_cov_11.352415	324	404	2	11	80	0.1375000
NODE_19681_length_658_cov_11.352415	324	404	4	54	80	0.6750000
NODE_19681_length_658_cov_11.352415	377	457	0	16	80	0.2000000
NODE_19681_length_658_cov_11.352415	377	457	2	27	80	0.3375000
NODE_19681_length_658_cov_11.352415	377	457	4	37	80	0.4625000
NODE_19685_length_658_cov_8.241503	227	307	0	80	80	1.0000000
NODE_19685_length_658_cov_8.241503	280	360	0	80	80	1.0000000
NODE_19689_length_658_cov_5.477639	450	530	0	42	80	0.5250000
NODE_19689_length_658_cov_5.477639	450	530	2	38	80	0.4750000
NODE_19705_length_658_cov_2.277281	286	366	0	65	80	0.8125000
NODE_19705_length_658_cov_2.277281	286	366	2	15	80	0.1875000
NODE_19705_length_658_cov_2.277281	339	419	0	12	80	0.1500000
NODE_19705_length_658_cov_2.277281	339	419	2	56	80	0.7000000
NODE_19705_length_658_cov_2.277281	339	419	8	12	80	0.1500000
NODE_19750_length_657_cov_71.087814	306	372	4	47	66	0.7121212
NODE_19750_length_657_cov_71.087814	306	372	6	19	66	0.2878788
NODE_19750_length_657_cov_71.087814	382	462	8	7	80	0.0875000
NODE_19750_length_657_cov_71.087814	382	462	10	9	80	0.1125000
NODE_19750_length_657_cov_71.087814	382	462	12	6	80	0.0750000
NODE_19750_length_657_cov_71.087814	382	462	14	46	80	0.5750000
NODE_19750_length_657_cov_71.087814	382	462	16	12	80	0.1500000
NODE_19750_length_657_cov_71.087814	382	462	8	7	80	0.0875000
NODE_19750_length_657_cov_71.087814	382	462	10	9	80	0.1125000
NODE_19750_length_657_cov_71.087814	382	462	12	6	80	0.0750000
NODE_19750_length_657_cov_71.087814	382	462	14	46	80	0.5750000
NODE_19750_length_657_cov_71.087814	382	462	16	12	80	0.1500000
NODE_19750_length_657_cov_71.087814	435	515	2	7	80	0.0875000
NODE_19750_length_657_cov_71.087814	435	515	6	12	80	0.1500000
NODE_19750_length_657_cov_71.087814	435	515	8	10	80	0.1250000
NODE_19750_length_657_cov_71.087814	435	515	10	3	80	0.0375000
NODE_19750_length_657_cov_71.087814	435	515	12	2	80	0.0250000
NODE_19750_length_657_cov_71.087814	435	515	14	34	80	0.4250000
NODE_19750_length_657_cov_71.087814	435	515	16	12	80	0.1500000
NODE_19750_length_657_cov_71.087814	440	515	2	7	75	0.0933333
NODE_19750_length_657_cov_71.087814	440	515	6	12	75	0.1600000
NODE_19750_length_657_cov_71.087814	440	515	8	10	75	0.1333333
NODE_19750_length_657_cov_71.087814	440	515	10	3	75	0.0400000
NODE_19750_length_657_cov_71.087814	440	515	12	2	75	0.0266667
NODE_19750_length_657_cov_71.087814	440	515	14	29	75	0.3866667
NODE_19750_length_657_cov_71.087814	440	515	16	12	75	0.1600000
NODE_19751_length_657_cov_67.408602	98	178	0	80	80	1.0000000
NODE_19751_length_657_cov_67.408602	151	231	0	80	80	1.0000000
NODE_19752_length_657_cov_15.568100	265	345	0	80	80	1.0000000
NODE_19752_length_657_cov_15.568100	341	421	0	80	80	1.0000000
NODE_19759_length_657_cov_5.161290	185	256	0	71	71	1.0000000
NODE_19759_length_657_cov_5.161290	229	309	0	80	80	1.0000000
NODE_19824_length_656_cov_37.023339	470	550	0	8	80	0.1000000
NODE_19824_length_656_cov_37.023339	470	550	2	16	80	0.2000000
NODE_19824_length_656_cov_37.023339	470	550	4	19	80	0.2375000
NODE_19824_length_656_cov_37.023339	470	550	7	1	80	0.0125000
NODE_19824_length_656_cov_37.023339	470	550	8	21	80	0.2625000
NODE_19824_length_656_cov_37.023339	470	550	10	15	80	0.1875000
NODE_19824_length_656_cov_37.023339	523	603	6	9	80	0.1125000
NODE_19824_length_656_cov_37.023339	523	603	8	37	80	0.4625000
NODE_19824_length_656_cov_37.023339	523	603	10	34	80	0.4250000
NODE_19825_length_656_cov_22.804309	173	253	0	80	80	1.0000000
NODE_19825_length_656_cov_22.804309	226	306	0	28	80	0.3500000
NODE_19825_length_656_cov_22.804309	226	306	4	52	80	0.6500000
NODE_19826_length_656_cov_19.280072	345	425	0	80	80	1.0000000
NODE_19826_length_656_cov_19.280072	398	478	0	80	80	1.0000000
NODE_19827_length_656_cov_18.267504	272	352	0	14	80	0.1750000
NODE_19827_length_656_cov_18.267504	272	352	2	66	80	0.8250000
NODE_19827_length_656_cov_18.267504	325	405	0	66	80	0.8250000
NODE_19827_length_656_cov_18.267504	325	405	2	14	80	0.1750000
NODE_19828_length_656_cov_15.928187	223	303	0	80	80	1.0000000
NODE_19829_length_656_cov_15.091562	297	377	2	1	80	0.0125000
NODE_19829_length_656_cov_15.091562	297	377	4	79	80	0.9875000
NODE_19829_length_656_cov_15.091562	350	430	0	53	80	0.6625000
NODE_19829_length_656_cov_15.091562	350	430	2	1	80	0.0125000
NODE_19829_length_656_cov_15.091562	350	430	4	26	80	0.3250000
NODE_19830_length_656_cov_12.773788	269	349	0	80	80	1.0000000
NODE_19830_length_656_cov_12.773788	322	399	0	77	77	1.0000000
NODE_19831_length_656_cov_12.493716	212	292	0	44	80	0.5500000
NODE_19831_length_656_cov_12.493716	212	292	2	36	80	0.4500000
NODE_19831_length_656_cov_12.493716	265	345	2	80	80	1.0000000
NODE_19832_length_656_cov_10.946140	197	277	0	80	80	1.0000000
NODE_19832_length_656_cov_10.946140	250	330	0	55	80	0.6875000
NODE_19832_length_656_cov_10.946140	250	330	4	25	80	0.3125000
NODE_19833_length_656_cov_9.412926	295	375	0	80	80	1.0000000
NODE_19833_length_656_cov_9.412926	348	428	0	80	80	1.0000000
NODE_19904_length_655_cov_31.019784	212	292	0	40	80	0.5000000
NODE_19904_length_655_cov_31.019784	212	292	2	40	80	0.5000000
NODE_19904_length_655_cov_31.019784	265	345	0	9	80	0.1125000
NODE_19904_length_655_cov_31.019784	265	345	2	71	80	0.8875000
NODE_19907_length_655_cov_8.672662	216	296	0	80	80	1.0000000
NODE_19907_length_655_cov_8.672662	269	349	0	80	80	1.0000000
NODE_19908_length_655_cov_8.250000	204	234	0	30	30	1.0000000
NODE_19909_length_655_cov_7.910072	366	446	0	80	80	1.0000000
NODE_19909_length_655_cov_7.910072	419	499	0	80	80	1.0000000
NODE_19916_length_655_cov_5.478417	178	255	0	45	77	0.5844156
NODE_19916_length_655_cov_5.478417	178	255	2	4	77	0.0519481
NODE_19916_length_655_cov_5.478417	178	255	4	28	77	0.3636364
NODE_19916_length_655_cov_5.478417	178	221	0	43	43	1.0000000
NODE_19919_length_655_cov_5.174460	347	428	2	48	81	0.5925926
NODE_19919_length_655_cov_5.174460	347	428	4	33	81	0.4074074
NODE_19919_length_655_cov_5.174460	401	481	0	24	80	0.3000000
NODE_19919_length_655_cov_5.174460	401	481	2	56	80	0.7000000
NODE_19979_length_654_cov_17.086486	323	403	0	80	80	1.0000000
NODE_19979_length_654_cov_17.086486	376	456	0	80	80	1.0000000
NODE_19980_length_654_cov_16.194595	318	398	0	69	80	0.8625000
NODE_19980_length_654_cov_16.194595	318	398	2	11	80	0.1375000
NODE_19980_length_654_cov_16.194595	371	451	0	80	80	1.0000000
NODE_19983_length_654_cov_5.556757	341	412	0	71	71	1.0000000
NODE_19990_length_654_cov_3.236036	105	181	0	76	76	1.0000000
NODE_19990_length_654_cov_3.236036	158	236	0	78	78	1.0000000
NODE_19998_length_654_cov_2.549550	279	366	0	17	87	0.1954023
NODE_19998_length_654_cov_2.549550	279	366	1	1	87	0.0114943
NODE_19998_length_654_cov_2.549550	279	366	2	69	87	0.7931035
NODE_20013_length_654_cov_1.790991	480	560	0	80	80	1.0000000
NODE_20044_length_653_cov_70.296029	277	357	6	43	80	0.5375000
NODE_20044_length_653_cov_70.296029	277	357	8	21	80	0.2625000
NODE_20044_length_653_cov_70.296029	277	357	10	16	80	0.2000000
NODE_20044_length_653_cov_70.296029	330	410	4	17	80	0.2125000
NODE_20044_length_653_cov_70.296029	330	410	8	47	80	0.5875000
NODE_20044_length_653_cov_70.296029	330	410	10	16	80	0.2000000
NODE_20045_length_653_cov_28.072202	302	382	0	80	80	1.0000000
NODE_20045_length_653_cov_28.072202	355	435	0	80	80	1.0000000
NODE_20046_length_653_cov_18.382671	214	294	0	80	80	1.0000000
NODE_20046_length_653_cov_18.382671	267	347	0	80	80	1.0000000
NODE_20047_length_653_cov_8.821300	292	372	0	80	80	1.0000000
NODE_20047_length_653_cov_8.821300	345	425	0	80	80	1.0000000
NODE_20048_length_653_cov_8.660650	200	280	0	80	80	1.0000000
NODE_20048_length_653_cov_8.660650	253	333	0	80	80	1.0000000
NODE_20052_length_653_cov_5.777978	308	383	0	14	75	0.1866667
NODE_20052_length_653_cov_5.777978	308	383	6	61	75	0.8133333
NODE_20052_length_653_cov_5.777978	361	435	6	74	74	1.0000000
NODE_20054_length_653_cov_5.193141	304	356	2	15	52	0.2884615
NODE_20054_length_653_cov_5.193141	304	356	6	37	52	0.7115384
NODE_20058_length_653_cov_4.823105	178	251	2	73	73	1.0000000
NODE_20058_length_653_cov_4.823105	178	256	2	78	78	1.0000000
NODE_20058_length_653_cov_4.823105	229	309	0	48	80	0.6000000
NODE_20058_length_653_cov_4.823105	229	309	2	32	80	0.4000000
NODE_20058_length_653_cov_4.823105	229	309	0	48	80	0.6000000
NODE_20058_length_653_cov_4.823105	229	309	2	32	80	0.4000000
NODE_20058_length_653_cov_4.823105	239	309	0	48	70	0.6857143
NODE_20058_length_653_cov_4.823105	239	309	2	22	70	0.3142857
NODE_20127_length_652_cov_215.211573	185	248	4	18	63	0.2857143
NODE_20127_length_652_cov_215.211573	185	248	8	1	63	0.0158730
NODE_20127_length_652_cov_215.211573	185	248	14	11	63	0.1746032
NODE_20127_length_652_cov_215.211573	185	248	16	22	63	0.3492064
NODE_20127_length_652_cov_215.211573	185	248	18	11	63	0.1746032
NODE_20127_length_652_cov_215.211573	221	301	16	16	80	0.2000000
NODE_20127_length_652_cov_215.211573	221	301	18	12	80	0.1500000
NODE_20127_length_652_cov_215.211573	221	301	20	30	80	0.3750000
NODE_20127_length_652_cov_215.211573	221	301	22	18	80	0.2250000
NODE_20127_length_652_cov_215.211573	221	301	24	4	80	0.0500000
NODE_20128_length_652_cov_21.267631	299	379	0	80	80	1.0000000
NODE_20128_length_652_cov_21.267631	352	432	0	80	80	1.0000000
NODE_20138_length_652_cov_4.622061	266	315	0	25	49	0.5102041
NODE_20138_length_652_cov_4.622061	266	315	2	24	49	0.4897959
NODE_20138_length_652_cov_4.622061	288	368	0	3	80	0.0375000
NODE_20138_length_652_cov_4.622061	288	368	2	77	80	0.9625000
NODE_20210_length_651_cov_49.981884	425	505	0	8	80	0.1000000
NODE_20210_length_651_cov_49.981884	425	505	4	6	80	0.0750000
NODE_20210_length_651_cov_49.981884	425	505	10	66	80	0.8250000
NODE_20210_length_651_cov_49.981884	425	505	0	8	80	0.1000000
NODE_20210_length_651_cov_49.981884	425	505	4	6	80	0.0750000
NODE_20210_length_651_cov_49.981884	425	505	10	66	80	0.8250000
NODE_20210_length_651_cov_49.981884	425	505	0	8	80	0.1000000
NODE_20210_length_651_cov_49.981884	425	505	4	6	80	0.0750000
NODE_20210_length_651_cov_49.981884	425	505	10	66	80	0.8250000
NODE_20210_length_651_cov_49.981884	425	505	0	8	80	0.1000000
NODE_20210_length_651_cov_49.981884	425	505	4	6	80	0.0750000
NODE_20210_length_651_cov_49.981884	425	505	10	66	80	0.8250000
NODE_20210_length_651_cov_49.981884	478	540	0	43	62	0.6935484
NODE_20210_length_651_cov_49.981884	478	540	4	6	62	0.0967742
NODE_20210_length_651_cov_49.981884	478	540	10	13	62	0.2096774
NODE_20210_length_651_cov_49.981884	478	540	0	43	62	0.6935484
NODE_20210_length_651_cov_49.981884	478	540	4	6	62	0.0967742
NODE_20210_length_651_cov_49.981884	478	540	10	13	62	0.2096774
NODE_20210_length_651_cov_49.981884	478	540	0	43	62	0.6935484
NODE_20210_length_651_cov_49.981884	478	540	4	6	62	0.0967742
NODE_20210_length_651_cov_49.981884	478	540	10	13	62	0.2096774
NODE_20210_length_651_cov_49.981884	478	542	0	45	64	0.7031250
NODE_20210_length_651_cov_49.981884	478	542	4	6	64	0.0937500
NODE_20210_length_651_cov_49.981884	478	542	10	13	64	0.2031250
NODE_20211_length_651_cov_36.121377	422	502	9	5	80	0.0625000
NODE_20211_length_651_cov_36.121377	422	502	11	16	80	0.2000000
NODE_20211_length_651_cov_36.121377	422	502	13	37	80	0.4625000
NODE_20211_length_651_cov_36.121377	422	502	15	22	80	0.2750000
NODE_20211_length_651_cov_36.121377	475	555	0	30	80	0.3750000
NODE_20211_length_651_cov_36.121377	475	555	2	2	80	0.0250000
NODE_20211_length_651_cov_36.121377	475	555	4	7	80	0.0875000
NODE_20211_length_651_cov_36.121377	475	555	7	11	80	0.1375000
NODE_20211_length_651_cov_36.121377	475	555	9	8	80	0.1000000
NODE_20211_length_651_cov_36.121377	475	555	11	16	80	0.2000000
NODE_20211_length_651_cov_36.121377	475	555	13	6	80	0.0750000
NODE_20212_length_651_cov_20.045290	252	332	0	80	80	1.0000000
NODE_20212_length_651_cov_20.045290	305	385	0	80	80	1.0000000
NODE_20213_length_651_cov_12.704710	264	344	0	80	80	1.0000000
NODE_20213_length_651_cov_12.704710	317	397	0	80	80	1.0000000
NODE_20214_length_651_cov_11.632246	205	285	0	6	80	0.0750000
NODE_20214_length_651_cov_11.632246	205	285	1	1	80	0.0125000
NODE_20214_length_651_cov_11.632246	205	285	2	73	80	0.9125000
NODE_20214_length_651_cov_11.632246	258	338	0	32	80	0.4000000
NODE_20214_length_651_cov_11.632246	258	338	2	48	80	0.6000000
NODE_20215_length_651_cov_10.074275	369	449	2	51	80	0.6375000
NODE_20215_length_651_cov_10.074275	369	449	4	29	80	0.3625000
NODE_20215_length_651_cov_10.074275	422	502	0	20	80	0.2500000
NODE_20215_length_651_cov_10.074275	422	502	2	46	80	0.5750000
NODE_20215_length_651_cov_10.074275	422	502	4	14	80	0.1750000
NODE_20216_length_651_cov_9.699275	199	279	0	37	80	0.4625000
NODE_20216_length_651_cov_9.699275	199	279	2	43	80	0.5375000
NODE_20216_length_651_cov_9.699275	252	332	0	19	80	0.2375000
NODE_20216_length_651_cov_9.699275	252	332	2	61	80	0.7625000
NODE_20219_length_651_cov_8.309783	217	296	0	29	79	0.3670886
NODE_20219_length_651_cov_8.309783	217	296	1	50	79	0.6329114
NODE_20219_length_651_cov_8.309783	269	349	1	80	80	1.0000000
NODE_20220_length_651_cov_5.621377	148	228	0	80	80	1.0000000
NODE_20220_length_651_cov_5.621377	201	281	0	80	80	1.0000000
NODE_20221_length_651_cov_5.610507	342	422	0	80	80	1.0000000
NODE_20221_length_651_cov_5.610507	395	475	0	80	80	1.0000000
NODE_20225_length_651_cov_4.246377	299	359	0	60	60	1.0000000
NODE_20238_length_651_cov_2.744565	340	421	0	33	81	0.4074074
NODE_20238_length_651_cov_2.744565	340	421	2	48	81	0.5925926
NODE_20252_length_651_cov_2.016304	280	311	0	31	31	1.0000000
NODE_20292_length_650_cov_22.644283	233	313	0	16	80	0.2000000
NODE_20292_length_650_cov_22.644283	233	313	2	64	80	0.8000000
NODE_20292_length_650_cov_22.644283	286	366	0	69	80	0.8625000
NODE_20292_length_650_cov_22.644283	286	366	2	11	80	0.1375000
NODE_20293_length_650_cov_22.156080	269	349	0	80	80	1.0000000
NODE_20293_length_650_cov_22.156080	322	402	0	80	80	1.0000000
NODE_20294_length_650_cov_20.012704	186	266	0	80	80	1.0000000
NODE_20294_length_650_cov_20.012704	239	319	0	80	80	1.0000000
NODE_20295_length_650_cov_17.626134	52	132	0	3	80	0.0375000
NODE_20295_length_650_cov_17.626134	52	132	2	77	80	0.9625000
NODE_20295_length_650_cov_17.626134	105	185	0	52	80	0.6500000
NODE_20295_length_650_cov_17.626134	105	185	2	28	80	0.3500000
NODE_20297_length_650_cov_10.687840	289	369	0	80	80	1.0000000
NODE_20297_length_650_cov_10.687840	342	422	0	80	80	1.0000000
NODE_20301_length_650_cov_6.519056	312	365	4	33	53	0.6226415
NODE_20301_length_650_cov_6.519056	312	365	6	20	53	0.3773585
NODE_20301_length_650_cov_6.519056	338	417	4	61	79	0.7721519
NODE_20301_length_650_cov_6.519056	338	417	6	18	79	0.2278481
NODE_20302_length_650_cov_6.159710	243	323	0	34	80	0.4250000
NODE_20302_length_650_cov_6.159710	243	323	2	46	80	0.5750000
NODE_20302_length_650_cov_6.159710	296	376	0	22	80	0.2750000
NODE_20302_length_650_cov_6.159710	296	376	2	58	80	0.7250000
NODE_20318_length_650_cov_2.488203	213	266	2	31	53	0.5849057
NODE_20318_length_650_cov_2.488203	213	266	4	22	53	0.4150943
NODE_20370_length_649_cov_20.780000	111	140	0	29	29	1.0000000
NODE_20370_length_649_cov_20.780000	111	191	0	41	80	0.5125000
NODE_20370_length_649_cov_20.780000	111	191	2	2	80	0.0250000
NODE_20370_length_649_cov_20.780000	111	191	6	37	80	0.4625000
NODE_20370_length_649_cov_20.780000	138	161	0	14	23	0.6086956
NODE_20370_length_649_cov_20.780000	138	161	2	2	23	0.0869565
NODE_20370_length_649_cov_20.780000	138	161	6	7	23	0.3043478
NODE_20370_length_649_cov_20.780000	138	214	0	14	76	0.1842105
NODE_20370_length_649_cov_20.780000	138	214	2	2	76	0.0263158
NODE_20370_length_649_cov_20.780000	138	214	6	60	76	0.7894737
NODE_20370_length_649_cov_20.780000	164	244	4	24	80	0.3000000
NODE_20370_length_649_cov_20.780000	164	244	6	56	80	0.7000000
NODE_20371_length_649_cov_17.938182	162	242	0	11	80	0.1375000
NODE_20371_length_649_cov_17.938182	162	242	2	56	80	0.7000000
NODE_20371_length_649_cov_17.938182	162	242	4	13	80	0.1625000
NODE_20371_length_649_cov_17.938182	215	295	2	67	80	0.8375000
NODE_20371_length_649_cov_17.938182	215	295	4	13	80	0.1625000
NODE_20372_length_649_cov_16.761818	395	475	0	55	80	0.6875000
NODE_20372_length_649_cov_16.761818	395	475	2	25	80	0.3125000
NODE_20372_length_649_cov_16.761818	448	528	0	2	80	0.0250000
NODE_20372_length_649_cov_16.761818	448	528	2	78	80	0.9750000
NODE_20373_length_649_cov_15.632727	226	306	0	56	80	0.7000000
NODE_20373_length_649_cov_15.632727	226	306	2	24	80	0.3000000
NODE_20373_length_649_cov_15.632727	279	359	0	80	80	1.0000000
NODE_20374_length_649_cov_15.516364	329	409	4	14	80	0.1750000
NODE_20374_length_649_cov_15.516364	329	409	6	7	80	0.0875000
NODE_20374_length_649_cov_15.516364	329	409	8	28	80	0.3500000
NODE_20374_length_649_cov_15.516364	329	409	10	31	80	0.3875000
NODE_20374_length_649_cov_15.516364	382	462	0	19	80	0.2375000
NODE_20374_length_649_cov_15.516364	382	462	2	8	80	0.1000000
NODE_20374_length_649_cov_15.516364	382	462	4	13	80	0.1625000
NODE_20374_length_649_cov_15.516364	382	462	6	4	80	0.0500000
NODE_20374_length_649_cov_15.516364	382	462	8	31	80	0.3875000
NODE_20374_length_649_cov_15.516364	382	462	10	5	80	0.0625000
NODE_20375_length_649_cov_10.374545	453	533	0	80	80	1.0000000
NODE_20375_length_649_cov_10.374545	506	586	0	80	80	1.0000000
NODE_20382_length_649_cov_4.403636	213	293	0	38	80	0.4750000
NODE_20382_length_649_cov_4.403636	213	293	2	42	80	0.5250000
NODE_20382_length_649_cov_4.403636	266	346	0	35	80	0.4375000
NODE_20382_length_649_cov_4.403636	266	346	2	45	80	0.5625000
NODE_20454_length_648_cov_34.287796	343	423	0	80	80	1.0000000
NODE_20454_length_648_cov_34.287796	396	476	0	80	80	1.0000000
NODE_20454_length_648_cov_34.287796	472	552	0	80	80	1.0000000
NODE_20454_length_648_cov_34.287796	525	605	0	80	80	1.0000000
NODE_20455_length_648_cov_19.433515	259	339	0	43	80	0.5375000
NODE_20455_length_648_cov_19.433515	259	339	2	37	80	0.4625000
NODE_20455_length_648_cov_19.433515	312	392	0	5	80	0.0625000
NODE_20455_length_648_cov_19.433515	312	392	2	75	80	0.9375000
NODE_20457_length_648_cov_8.391621	206	286	0	80	80	1.0000000
NODE_20457_length_648_cov_8.391621	259	339	0	80	80	1.0000000
NODE_20459_length_648_cov_6.573770	293	373	0	52	80	0.6500000
NODE_20459_length_648_cov_6.573770	293	373	4	28	80	0.3500000
NODE_20459_length_648_cov_6.573770	346	426	4	80	80	1.0000000
NODE_20460_length_648_cov_6.431694	285	328	0	43	43	1.0000000
NODE_20463_length_648_cov_6.085610	257	337	0	80	80	1.0000000
NODE_20463_length_648_cov_6.085610	310	390	0	80	80	1.0000000
NODE_20483_length_648_cov_2.333333	19	86	2	2	67	0.0298507
NODE_20483_length_648_cov_2.333333	19	86	8	65	67	0.9701493
NODE_20531_length_647_cov_18.489051	295	375	0	24	80	0.3000000
NODE_20531_length_647_cov_18.489051	295	375	2	50	80	0.6250000
NODE_20531_length_647_cov_18.489051	295	375	4	6	80	0.0750000
NODE_20531_length_647_cov_18.489051	348	428	2	21	80	0.2625000
NODE_20531_length_647_cov_18.489051	348	428	4	14	80	0.1750000
NODE_20531_length_647_cov_18.489051	348	428	5	24	80	0.3000000
NODE_20531_length_647_cov_18.489051	348	428	6	3	80	0.0375000
NODE_20531_length_647_cov_18.489051	348	428	7	18	80	0.2250000
NODE_20532_length_647_cov_14.677007	286	366	0	43	80	0.5375000
NODE_20532_length_647_cov_14.677007	286	366	1	37	80	0.4625000
NODE_20532_length_647_cov_14.677007	339	419	1	80	80	1.0000000
NODE_20533_length_647_cov_10.895985	231	311	0	80	80	1.0000000
NODE_20533_length_647_cov_10.895985	284	364	0	46	80	0.5750000
NODE_20533_length_647_cov_10.895985	284	364	2	34	80	0.4250000
NODE_20534_length_647_cov_9.116788	372	452	0	71	80	0.8875000
NODE_20534_length_647_cov_9.116788	372	452	2	9	80	0.1125000
NODE_20534_length_647_cov_9.116788	425	505	0	80	80	1.0000000
NODE_20536_length_647_cov_6.410584	150	221	0	71	71	1.0000000
NODE_20536_length_647_cov_6.410584	194	274	0	80	80	1.0000000
NODE_20539_length_647_cov_5.567518	239	319	0	22	80	0.2750000
NODE_20539_length_647_cov_5.567518	239	319	1	1	80	0.0125000
NODE_20539_length_647_cov_5.567518	239	319	2	20	80	0.2500000
NODE_20539_length_647_cov_5.567518	239	319	4	9	80	0.1125000
NODE_20539_length_647_cov_5.567518	239	319	6	28	80	0.3500000
NODE_20539_length_647_cov_5.567518	292	355	4	15	63	0.2380952
NODE_20539_length_647_cov_5.567518	292	355	5	6	63	0.0952381
NODE_20539_length_647_cov_5.567518	292	355	6	42	63	0.6666667
NODE_20539_length_647_cov_5.567518	348	416	2	5	68	0.0735294
NODE_20539_length_647_cov_5.567518	348	416	4	60	68	0.8823529
NODE_20539_length_647_cov_5.567518	348	416	6	3	68	0.0441176
NODE_20539_length_647_cov_5.567518	401	469	4	68	68	1.0000000
NODE_20544_length_647_cov_3.775547	356	399	0	8	43	0.1860465
NODE_20544_length_647_cov_3.775547	356	399	2	35	43	0.8139535
NODE_20550_length_647_cov_2.678832	239	319	0	32	80	0.4000000
NODE_20550_length_647_cov_2.678832	239	319	2	48	80	0.6000000
NODE_20550_length_647_cov_2.678832	292	372	0	17	80	0.2125000
NODE_20550_length_647_cov_2.678832	292	372	2	63	80	0.7875000
NODE_20561_length_647_cov_1.937956	254	304	0	13	50	0.2600000
NODE_20561_length_647_cov_1.937956	254	304	2	37	50	0.7400000
NODE_20607_length_646_cov_56.226691	267	347	0	80	80	1.0000000
NODE_20607_length_646_cov_56.226691	320	400	0	80	80	1.0000000
NODE_20608_length_646_cov_23.747715	76	153	0	38	77	0.4935065
NODE_20608_length_646_cov_23.747715	76	153	2	39	77	0.5064935
NODE_20608_length_646_cov_23.747715	129	209	2	80	80	1.0000000
NODE_20609_length_646_cov_22.740402	326	406	0	80	80	1.0000000
NODE_20609_length_646_cov_22.740402	379	459	0	41	80	0.5125000
NODE_20609_length_646_cov_22.740402	379	459	2	4	80	0.0500000
NODE_20609_length_646_cov_22.740402	379	459	4	35	80	0.4375000
NODE_20610_length_646_cov_15.160878	363	443	0	80	80	1.0000000
NODE_20610_length_646_cov_15.160878	416	496	0	80	80	1.0000000
NODE_20611_length_646_cov_9.429616	309	389	0	80	80	1.0000000
NODE_20611_length_646_cov_9.429616	362	442	0	80	80	1.0000000
NODE_20612_length_646_cov_9.246801	149	221	0	9	72	0.1250000
NODE_20612_length_646_cov_9.246801	149	221	2	63	72	0.8750000
NODE_20613_length_646_cov_7.539305	227	307	0	63	80	0.7875000
NODE_20613_length_646_cov_7.539305	227	307	2	17	80	0.2125000
NODE_20613_length_646_cov_7.539305	280	360	0	10	80	0.1250000
NODE_20613_length_646_cov_7.539305	280	360	1	3	80	0.0375000
NODE_20613_length_646_cov_7.539305	280	360	2	65	80	0.8125000
NODE_20613_length_646_cov_7.539305	280	360	3	2	80	0.0250000
NODE_20614_length_646_cov_6.756856	236	316	0	31	80	0.3875000
NODE_20614_length_646_cov_6.756856	236	316	2	49	80	0.6125000
NODE_20614_length_646_cov_6.756856	289	369	0	80	80	1.0000000
NODE_20615_length_646_cov_6.480804	373	437	2	64	64	1.0000000
NODE_20615_length_646_cov_6.480804	410	490	0	11	80	0.1375000
NODE_20615_length_646_cov_6.480804	410	490	2	69	80	0.8625000
NODE_20616_length_646_cov_6.396709	194	274	0	80	80	1.0000000
NODE_20616_length_646_cov_6.396709	254	327	0	73	73	1.0000000
NODE_20619_length_646_cov_4.652651	265	345	0	80	80	1.0000000
NODE_20623_length_646_cov_4.122486	401	452	0	51	51	1.0000000
NODE_20688_length_645_cov_95.882784	179	259	0	58	80	0.7250000
NODE_20688_length_645_cov_95.882784	179	259	2	22	80	0.2750000
NODE_20688_length_645_cov_95.882784	232	312	0	5	80	0.0625000
NODE_20688_length_645_cov_95.882784	232	312	2	40	80	0.5000000
NODE_20688_length_645_cov_95.882784	232	312	4	31	80	0.3875000
NODE_20688_length_645_cov_95.882784	232	312	6	4	80	0.0500000
NODE_20689_length_645_cov_12.985348	343	423	0	80	80	1.0000000
NODE_20689_length_645_cov_12.985348	396	476	0	80	80	1.0000000
NODE_20691_length_645_cov_9.228938	254	334	0	41	80	0.5125000
NODE_20691_length_645_cov_9.228938	254	334	2	39	80	0.4875000
NODE_20691_length_645_cov_9.228938	307	387	2	48	80	0.6000000
NODE_20691_length_645_cov_9.228938	307	387	4	32	80	0.4000000
NODE_20692_length_645_cov_9.172161	293	373	0	80	80	1.0000000
NODE_20692_length_645_cov_9.172161	346	426	0	80	80	1.0000000
NODE_20697_length_645_cov_5.609890	461	541	0	80	80	1.0000000
NODE_20697_length_645_cov_5.609890	514	594	0	80	80	1.0000000
NODE_20698_length_645_cov_4.743590	237	317	0	80	80	1.0000000
NODE_20698_length_645_cov_4.743590	290	370	0	80	80	1.0000000
NODE_20716_length_645_cov_2.177656	373	416	0	43	43	1.0000000
NODE_20762_length_644_cov_59.286239	323	401	52	2	78	0.0256410
NODE_20762_length_644_cov_59.286239	323	401	60	2	78	0.0256410
NODE_20762_length_644_cov_59.286239	323	401	62	1	78	0.0128205
NODE_20762_length_644_cov_59.286239	323	401	65	1	78	0.0128205
NODE_20762_length_644_cov_59.286239	323	401	68	3	78	0.0384615
NODE_20762_length_644_cov_59.286239	323	401	71	1	78	0.0128205
NODE_20762_length_644_cov_59.286239	323	401	79	3	78	0.0384615
NODE_20762_length_644_cov_59.286239	323	401	80	1	78	0.0128205
NODE_20762_length_644_cov_59.286239	323	401	81	1	78	0.0128205
NODE_20762_length_644_cov_59.286239	323	401	83	1	78	0.0128205
NODE_20762_length_644_cov_59.286239	323	401	85	2	78	0.0256410
NODE_20762_length_644_cov_59.286239	323	401	87	1	78	0.0128205
NODE_20762_length_644_cov_59.286239	323	401	91	4	78	0.0512821
NODE_20762_length_644_cov_59.286239	323	401	93	1	78	0.0128205
NODE_20762_length_644_cov_59.286239	323	401	95	1	78	0.0128205
NODE_20762_length_644_cov_59.286239	323	401	97	1	78	0.0128205
NODE_20762_length_644_cov_59.286239	323	401	99	1	78	0.0128205
NODE_20762_length_644_cov_59.286239	323	401	104	1	78	0.0128205
NODE_20762_length_644_cov_59.286239	323	401	106	1	78	0.0128205
NODE_20762_length_644_cov_59.286239	323	401	108	2	78	0.0256410
NODE_20762_length_644_cov_59.286239	323	401	112	1	78	0.0128205
NODE_20762_length_644_cov_59.286239	323	401	116	4	78	0.0512821
NODE_20762_length_644_cov_59.286239	323	401	120	1	78	0.0128205
NODE_20762_length_644_cov_59.286239	323	401	124	3	78	0.0384615
NODE_20762_length_644_cov_59.286239	323	401	126	3	78	0.0384615
NODE_20762_length_644_cov_59.286239	323	401	132	2	78	0.0256410
NODE_20762_length_644_cov_59.286239	323	401	134	2	78	0.0256410
NODE_20762_length_644_cov_59.286239	323	401	136	1	78	0.0128205
NODE_20762_length_644_cov_59.286239	323	401	138	2	78	0.0256410
NODE_20762_length_644_cov_59.286239	323	401	142	5	78	0.0641026
NODE_20762_length_644_cov_59.286239	323	401	143	1	78	0.0128205
NODE_20762_length_644_cov_59.286239	323	401	144	1	78	0.0128205
NODE_20762_length_644_cov_59.286239	323	401	145	3	78	0.0384615
NODE_20762_length_644_cov_59.286239	323	401	146	1	78	0.0128205
NODE_20762_length_644_cov_59.286239	323	401	148	2	78	0.0256410
NODE_20762_length_644_cov_59.286239	323	401	150	1	78	0.0128205
NODE_20762_length_644_cov_59.286239	323	401	154	1	78	0.0128205
NODE_20762_length_644_cov_59.286239	323	401	162	1	78	0.0128205
NODE_20762_length_644_cov_59.286239	323	401	164	1	78	0.0128205
NODE_20762_length_644_cov_59.286239	323	401	166	3	78	0.0384615
NODE_20762_length_644_cov_59.286239	323	401	168	5	78	0.0641026
NODE_20762_length_644_cov_59.286239	323	401	172	3	78	0.0384615
NODE_20763_length_644_cov_27.577982	63	143	0	15	80	0.1875000
NODE_20763_length_644_cov_27.577982	63	143	2	65	80	0.8125000
NODE_20763_length_644_cov_27.577982	116	196	2	80	80	1.0000000
NODE_20765_length_644_cov_10.073394	284	364	0	23	80	0.2875000
NODE_20765_length_644_cov_10.073394	284	364	2	57	80	0.7125000
NODE_20765_length_644_cov_10.073394	337	417	0	15	80	0.1875000
NODE_20765_length_644_cov_10.073394	337	417	2	65	80	0.8125000
NODE_20845_length_643_cov_27.562500	201	281	0	80	80	1.0000000
NODE_20845_length_643_cov_27.562500	254	334	0	80	80	1.0000000
NODE_20845_length_643_cov_27.562500	330	410	0	80	80	1.0000000
NODE_20845_length_643_cov_27.562500	383	463	0	80	80	1.0000000
NODE_20846_length_643_cov_12.895221	203	283	0	80	80	1.0000000
NODE_20846_length_643_cov_12.895221	256	336	0	80	80	1.0000000
NODE_20847_length_643_cov_10.501838	280	360	0	80	80	1.0000000
NODE_20847_length_643_cov_10.501838	333	413	0	80	80	1.0000000
NODE_20848_length_643_cov_9.136029	307	385	0	78	78	1.0000000
NODE_20848_length_643_cov_9.136029	358	438	0	80	80	1.0000000
NODE_20849_length_643_cov_8.264706	202	282	0	35	80	0.4375000
NODE_20849_length_643_cov_8.264706	202	282	2	45	80	0.5625000
NODE_20849_length_643_cov_8.264706	255	335	0	29	80	0.3625000
NODE_20849_length_643_cov_8.264706	255	335	2	51	80	0.6375000
NODE_20851_length_643_cov_7.137868	173	253	0	48	80	0.6000000
NODE_20851_length_643_cov_7.137868	173	253	2	32	80	0.4000000
NODE_20851_length_643_cov_7.137868	226	306	0	20	80	0.2500000
NODE_20851_length_643_cov_7.137868	226	306	2	60	80	0.7500000
NODE_20855_length_643_cov_5.851103	255	335	6	2	80	0.0250000
NODE_20855_length_643_cov_5.851103	255	335	8	2	80	0.0250000
NODE_20855_length_643_cov_5.851103	255	335	12	2	80	0.0250000
NODE_20855_length_643_cov_5.851103	255	335	14	2	80	0.0250000
NODE_20855_length_643_cov_5.851103	255	335	16	3	80	0.0375000
NODE_20855_length_643_cov_5.851103	255	335	18	1	80	0.0125000
NODE_20855_length_643_cov_5.851103	255	335	20	24	80	0.3000000
NODE_20855_length_643_cov_5.851103	255	335	22	30	80	0.3750000
NODE_20855_length_643_cov_5.851103	255	335	24	14	80	0.1750000
NODE_20855_length_643_cov_5.851103	308	388	0	37	80	0.4625000
NODE_20855_length_643_cov_5.851103	308	388	2	4	80	0.0500000
NODE_20855_length_643_cov_5.851103	308	388	4	1	80	0.0125000
NODE_20855_length_643_cov_5.851103	308	388	6	13	80	0.1625000
NODE_20855_length_643_cov_5.851103	308	388	8	2	80	0.0250000
NODE_20855_length_643_cov_5.851103	308	388	12	2	80	0.0250000
NODE_20855_length_643_cov_5.851103	308	388	14	2	80	0.0250000
NODE_20855_length_643_cov_5.851103	308	388	16	3	80	0.0375000
NODE_20855_length_643_cov_5.851103	308	388	18	1	80	0.0125000
NODE_20855_length_643_cov_5.851103	308	388	20	15	80	0.1875000
NODE_20869_length_643_cov_3.121324	283	348	0	29	65	0.4461538
NODE_20869_length_643_cov_3.121324	283	348	2	36	65	0.5538462
NODE_20872_length_643_cov_2.806985	387	451	0	6	64	0.0937500
NODE_20872_length_643_cov_2.806985	387	451	2	58	64	0.9062500
NODE_20942_length_642_cov_36.309392	156	236	0	80	80	1.0000000
NODE_20942_length_642_cov_36.309392	209	289	0	80	80	1.0000000
NODE_20943_length_642_cov_27.046041	154	234	0	80	80	1.0000000
NODE_20943_length_642_cov_27.046041	207	287	0	80	80	1.0000000
NODE_20944_length_642_cov_26.290976	209	289	0	80	80	1.0000000
NODE_20944_length_642_cov_26.290976	262	342	0	80	80	1.0000000
NODE_20945_length_642_cov_11.651934	309	389	0	80	80	1.0000000
NODE_20945_length_642_cov_11.651934	362	442	0	80	80	1.0000000
NODE_20947_length_642_cov_6.692449	453	533	0	80	80	1.0000000
NODE_20947_length_642_cov_6.692449	506	586	0	80	80	1.0000000
NODE_20951_length_642_cov_5.933702	260	340	2	8	80	0.1000000
NODE_20951_length_642_cov_5.933702	260	340	4	8	80	0.1000000
NODE_20951_length_642_cov_5.933702	260	340	6	40	80	0.5000000
NODE_20951_length_642_cov_5.933702	260	340	8	24	80	0.3000000
NODE_20951_length_642_cov_5.933702	313	391	2	2	78	0.0256410
NODE_20951_length_642_cov_5.933702	313	391	5	1	78	0.0128205
NODE_20951_length_642_cov_5.933702	313	391	6	34	78	0.4358974
NODE_20951_length_642_cov_5.933702	313	391	8	41	78	0.5256410
NODE_20967_length_642_cov_2.823204	115	158	6	16	43	0.3720930
NODE_20967_length_642_cov_2.823204	115	158	8	3	43	0.0697674
NODE_20967_length_642_cov_2.823204	115	158	10	3	43	0.0697674
NODE_20967_length_642_cov_2.823204	115	158	14	1	43	0.0232558
NODE_20967_length_642_cov_2.823204	115	158	18	4	43	0.0930233
NODE_20967_length_642_cov_2.823204	115	158	20	16	43	0.3720930
NODE_20967_length_642_cov_2.823204	245	300	0	8	55	0.1454545
NODE_20967_length_642_cov_2.823204	245	300	2	10	55	0.1818182
NODE_20967_length_642_cov_2.823204	245	300	4	6	55	0.1090909
NODE_20967_length_642_cov_2.823204	245	300	8	4	55	0.0727273
NODE_20967_length_642_cov_2.823204	245	300	10	2	55	0.0363636
NODE_20967_length_642_cov_2.823204	245	300	14	25	55	0.4545455
NODE_20967_length_642_cov_2.823204	329	410	2	17	81	0.2098765
NODE_20967_length_642_cov_2.823204	329	410	4	64	81	0.7901235
NODE_20991_length_642_cov_1.357274	0	75	0	75	75	1.0000000
NODE_21018_length_641_cov_38.675277	284	345	6	1	61	0.0163934
NODE_21018_length_641_cov_38.675277	284	345	12	2	61	0.0327869
NODE_21018_length_641_cov_38.675277	284	345	14	3	61	0.0491803
NODE_21018_length_641_cov_38.675277	284	345	16	6	61	0.0983607
NODE_21018_length_641_cov_38.675277	284	345	18	1	61	0.0163934
NODE_21018_length_641_cov_38.675277	284	345	22	5	61	0.0819672
NODE_21018_length_641_cov_38.675277	284	345	24	2	61	0.0327869
NODE_21018_length_641_cov_38.675277	284	345	26	5	61	0.0819672
NODE_21018_length_641_cov_38.675277	284	345	28	4	61	0.0655738
NODE_21018_length_641_cov_38.675277	284	345	30	2	61	0.0327869
NODE_21018_length_641_cov_38.675277	284	345	32	3	61	0.0491803
NODE_21018_length_641_cov_38.675277	284	345	34	4	61	0.0655738
NODE_21018_length_641_cov_38.675277	284	345	36	2	61	0.0327869
NODE_21018_length_641_cov_38.675277	284	345	38	2	61	0.0327869
NODE_21018_length_641_cov_38.675277	284	345	40	2	61	0.0327869
NODE_21018_length_641_cov_38.675277	284	345	42	6	61	0.0983607
NODE_21018_length_641_cov_38.675277	284	345	44	11	61	0.1803279
NODE_21018_length_641_cov_38.675277	318	369	34	4	51	0.0784314
NODE_21018_length_641_cov_38.675277	318	369	36	2	51	0.0392157
NODE_21018_length_641_cov_38.675277	318	369	38	2	51	0.0392157
NODE_21018_length_641_cov_38.675277	318	369	40	2	51	0.0392157
NODE_21018_length_641_cov_38.675277	318	369	42	10	51	0.1960784
NODE_21018_length_641_cov_38.675277	318	369	44	23	51	0.4509804
NODE_21018_length_641_cov_38.675277	318	369	46	8	51	0.1568628
NODE_21019_length_641_cov_15.271218	260	340	0	7	80	0.0875000
NODE_21019_length_641_cov_15.271218	260	340	2	16	80	0.2000000
NODE_21019_length_641_cov_15.271218	260	340	4	57	80	0.7125000
NODE_21019_length_641_cov_15.271218	313	393	0	31	80	0.3875000
NODE_21019_length_641_cov_15.271218	313	393	2	9	80	0.1125000
NODE_21019_length_641_cov_15.271218	313	393	4	40	80	0.5000000
NODE_21021_length_641_cov_12.584871	363	443	0	80	80	1.0000000
NODE_21021_length_641_cov_12.584871	416	496	0	80	80	1.0000000
NODE_21022_length_641_cov_11.125461	38	118	0	80	80	1.0000000
NODE_21022_length_641_cov_11.125461	91	171	0	80	80	1.0000000
NODE_21025_length_641_cov_7.719557	84	138	0	54	54	1.0000000
NODE_21025_length_641_cov_7.719557	113	193	0	80	80	1.0000000
NODE_21026_length_641_cov_7.675277	232	312	0	80	80	1.0000000
NODE_21026_length_641_cov_7.675277	285	365	0	80	80	1.0000000
NODE_21027_length_641_cov_7.675277	255	335	0	80	80	1.0000000
NODE_21027_length_641_cov_7.675277	308	388	0	80	80	1.0000000
NODE_21028_length_641_cov_7.627306	262	342	2	80	80	1.0000000
NODE_21028_length_641_cov_7.627306	315	395	0	17	80	0.2125000
NODE_21028_length_641_cov_7.627306	315	395	2	63	80	0.7875000
NODE_21029_length_641_cov_7.282288	247	300	0	53	53	1.0000000
NODE_21031_length_641_cov_5.029520	138	218	2	45	80	0.5625000
NODE_21031_length_641_cov_5.029520	138	218	4	35	80	0.4375000
NODE_21031_length_641_cov_5.029520	191	271	2	80	80	1.0000000
NODE_21034_length_641_cov_4.701107	238	282	0	44	44	1.0000000
NODE_21109_length_640_cov_39.676525	524	597	13	5	73	0.0684932
NODE_21109_length_640_cov_39.676525	524	597	15	6	73	0.0821918
NODE_21109_length_640_cov_39.676525	524	597	17	1	73	0.0136986
NODE_21109_length_640_cov_39.676525	524	597	19	4	73	0.0547945
NODE_21109_length_640_cov_39.676525	524	597	22	5	73	0.0684932
NODE_21109_length_640_cov_39.676525	524	597	23	3	73	0.0410959
NODE_21109_length_640_cov_39.676525	524	597	25	4	73	0.0547945
NODE_21109_length_640_cov_39.676525	524	597	27	4	73	0.0547945
NODE_21109_length_640_cov_39.676525	524	597	31	5	73	0.0684932
NODE_21109_length_640_cov_39.676525	524	597	33	4	73	0.0547945
NODE_21109_length_640_cov_39.676525	524	597	35	4	73	0.0547945
NODE_21109_length_640_cov_39.676525	524	597	36	1	73	0.0136986
NODE_21109_length_640_cov_39.676525	524	597	38	6	73	0.0821918
NODE_21109_length_640_cov_39.676525	524	597	40	5	73	0.0684932
NODE_21109_length_640_cov_39.676525	524	597	42	5	73	0.0684932
NODE_21109_length_640_cov_39.676525	524	597	43	3	73	0.0410959
NODE_21109_length_640_cov_39.676525	524	597	44	3	73	0.0410959
NODE_21109_length_640_cov_39.676525	524	597	45	1	73	0.0136986
NODE_21109_length_640_cov_39.676525	524	597	47	2	73	0.0273973
NODE_21109_length_640_cov_39.676525	524	597	51	2	73	0.0273973
NODE_21109_length_640_cov_39.676525	564	605	12	2	41	0.0487805
NODE_21109_length_640_cov_39.676525	564	605	13	11	41	0.2682927
NODE_21109_length_640_cov_39.676525	564	605	15	6	41	0.1463415
NODE_21109_length_640_cov_39.676525	564	605	17	1	41	0.0243902
NODE_21109_length_640_cov_39.676525	564	605	19	4	41	0.0975610
NODE_21109_length_640_cov_39.676525	564	605	22	5	41	0.1219512
NODE_21109_length_640_cov_39.676525	564	605	23	3	41	0.0731707
NODE_21109_length_640_cov_39.676525	564	605	25	4	41	0.0975610
NODE_21109_length_640_cov_39.676525	564	605	27	4	41	0.0975610
NODE_21109_length_640_cov_39.676525	564	605	31	1	41	0.0243902
NODE_21110_length_640_cov_19.578558	273	353	0	80	80	1.0000000
NODE_21110_length_640_cov_19.578558	326	406	0	80	80	1.0000000
NODE_21111_length_640_cov_15.717190	178	258	0	80	80	1.0000000
NODE_21111_length_640_cov_15.717190	231	311	0	80	80	1.0000000
NODE_21112_length_640_cov_15.338262	319	399	0	80	80	1.0000000
NODE_21112_length_640_cov_15.338262	372	452	0	80	80	1.0000000
NODE_21113_length_640_cov_9.523105	20	43	0	23	23	1.0000000
NODE_21118_length_640_cov_5.123845	272	335	0	63	63	1.0000000
NODE_21121_length_640_cov_4.410351	254	334	0	80	80	1.0000000
NODE_21121_length_640_cov_4.410351	307	387	0	80	80	1.0000000
NODE_21129_length_640_cov_3.406654	244	324	2	80	80	1.0000000
NODE_21140_length_640_cov_2.316081	21	57	0	36	36	1.0000000
NODE_21190_length_639_cov_58.092593	302	377	0	75	75	1.0000000
NODE_21190_length_639_cov_58.092593	350	430	0	80	80	1.0000000
NODE_21191_length_639_cov_32.951852	213	293	2	80	80	1.0000000
NODE_21191_length_639_cov_32.951852	266	346	0	2	80	0.0250000
NODE_21191_length_639_cov_32.951852	266	346	1	6	80	0.0750000
NODE_21191_length_639_cov_32.951852	266	346	2	72	80	0.9000000
NODE_21192_length_639_cov_24.564815	290	370	0	80	80	1.0000000
NODE_21192_length_639_cov_24.564815	343	423	0	80	80	1.0000000
NODE_21193_length_639_cov_14.448148	288	368	0	43	80	0.5375000
NODE_21193_length_639_cov_14.448148	288	368	4	37	80	0.4625000
NODE_21193_length_639_cov_14.448148	341	421	4	80	80	1.0000000
NODE_21195_length_639_cov_9.001852	265	345	0	47	80	0.5875000
NODE_21195_length_639_cov_9.001852	265	345	2	33	80	0.4125000
NODE_21195_length_639_cov_9.001852	318	398	2	80	80	1.0000000
NODE_21197_length_639_cov_8.444444	161	241	0	22	80	0.2750000
NODE_21197_length_639_cov_8.444444	161	241	2	58	80	0.7250000
NODE_21197_length_639_cov_8.444444	214	294	0	67	80	0.8375000
NODE_21197_length_639_cov_8.444444	214	294	2	13	80	0.1625000
NODE_21202_length_639_cov_6.283333	157	176	0	19	19	1.0000000
NODE_21207_length_639_cov_4.188889	258	335	0	77	77	1.0000000
NODE_21207_length_639_cov_4.188889	308	354	0	46	46	1.0000000
NODE_21213_length_639_cov_3.448148	126	206	0	80	80	1.0000000
NODE_21213_length_639_cov_3.448148	179	259	0	80	80	1.0000000
NODE_21223_length_639_cov_2.683333	256	288	0	32	32	1.0000000
NODE_21224_length_639_cov_2.555556	189	240	2	11	51	0.2156863
NODE_21224_length_639_cov_2.555556	189	240	4	40	51	0.7843137
NODE_21225_length_639_cov_2.477778	562	635	0	5	73	0.0684932
NODE_21225_length_639_cov_2.477778	562	635	2	24	73	0.3287671
NODE_21225_length_639_cov_2.477778	562	635	4	13	73	0.1780822
NODE_21225_length_639_cov_2.477778	562	635	6	31	73	0.4246575
NODE_21265_length_639_cov_1.179630	542	564	0	22	22	1.0000000
NODE_21269_length_639_cov_1.051852	404	455	2	51	51	1.0000000
NODE_21278_length_638_cov_13.018553	273	353	0	21	80	0.2625000
NODE_21278_length_638_cov_13.018553	273	353	2	59	80	0.7375000
NODE_21278_length_638_cov_13.018553	326	406	0	23	80	0.2875000
NODE_21278_length_638_cov_13.018553	326	406	2	57	80	0.7125000
NODE_21279_length_638_cov_12.656772	343	423	0	14	80	0.1750000
NODE_21279_length_638_cov_12.656772	343	423	2	66	80	0.8250000
NODE_21279_length_638_cov_12.656772	396	476	0	59	80	0.7375000
NODE_21279_length_638_cov_12.656772	396	476	2	21	80	0.2625000
NODE_21280_length_638_cov_11.877551	298	378	0	80	80	1.0000000
NODE_21280_length_638_cov_11.877551	351	431	0	80	80	1.0000000
NODE_21281_length_638_cov_8.779221	330	408	0	32	78	0.4102564
NODE_21281_length_638_cov_8.779221	330	408	2	4	78	0.0512821
NODE_21281_length_638_cov_8.779221	330	408	4	42	78	0.5384616
NODE_21281_length_638_cov_8.779221	383	461	0	14	78	0.1794872
NODE_21281_length_638_cov_8.779221	383	461	2	3	78	0.0384615
NODE_21281_length_638_cov_8.779221	383	461	4	61	78	0.7820513
NODE_21284_length_638_cov_5.543599	315	395	0	80	80	1.0000000
NODE_21290_length_638_cov_3.966605	307	387	0	80	80	1.0000000
NODE_21301_length_638_cov_2.786642	157	208	0	7	51	0.1372549
NODE_21301_length_638_cov_2.786642	157	208	2	31	51	0.6078432
NODE_21301_length_638_cov_2.786642	157	208	6	13	51	0.2549020
NODE_21301_length_638_cov_2.786642	181	261	2	14	80	0.1750000
NODE_21301_length_638_cov_2.786642	181	261	6	25	80	0.3125000
NODE_21301_length_638_cov_2.786642	181	261	8	41	80	0.5125000
NODE_21364_length_637_cov_67.157993	285	365	0	30	80	0.3750000
NODE_21364_length_637_cov_67.157993	285	365	2	50	80	0.6250000
NODE_21364_length_637_cov_67.157993	338	418	0	80	80	1.0000000
NODE_21364_length_637_cov_67.157993	414	494	0	80	80	1.0000000
NODE_21364_length_637_cov_67.157993	467	547	0	80	80	1.0000000
NODE_21365_length_637_cov_63.029740	195	275	0	80	80	1.0000000
NODE_21365_length_637_cov_63.029740	248	328	0	80	80	1.0000000
NODE_21366_length_637_cov_44.923792	53	133	0	80	80	1.0000000
NODE_21366_length_637_cov_44.923792	54	133	0	79	79	1.0000000
NODE_21366_length_637_cov_44.923792	106	186	0	80	80	1.0000000
NODE_21366_length_637_cov_44.923792	106	186	0	80	80	1.0000000
NODE_21366_length_637_cov_44.923792	182	262	0	48	80	0.6000000
NODE_21366_length_637_cov_44.923792	182	262	2	32	80	0.4000000
NODE_21366_length_637_cov_44.923792	235	315	2	80	80	1.0000000
NODE_21367_length_637_cov_44.193309	193	273	0	80	80	1.0000000
NODE_21367_length_637_cov_44.193309	246	326	0	80	80	1.0000000
NODE_21368_length_637_cov_37.855019	215	295	4	14	80	0.1750000
NODE_21368_length_637_cov_37.855019	215	295	6	17	80	0.2125000
NODE_21368_length_637_cov_37.855019	215	295	8	2	80	0.0250000
NODE_21368_length_637_cov_37.855019	215	295	10	34	80	0.4250000
NODE_21368_length_637_cov_37.855019	215	295	12	13	80	0.1625000
NODE_21368_length_637_cov_37.855019	268	347	2	6	79	0.0759494
NODE_21368_length_637_cov_37.855019	268	347	3	3	79	0.0379747
NODE_21368_length_637_cov_37.855019	268	347	5	5	79	0.0632911
NODE_21368_length_637_cov_37.855019	268	347	7	7	79	0.0886076
NODE_21368_length_637_cov_37.855019	268	347	8	3	79	0.0379747
NODE_21368_length_637_cov_37.855019	268	347	10	42	79	0.5316456
NODE_21368_length_637_cov_37.855019	268	347	12	13	79	0.1645570
NODE_21369_length_637_cov_33.957249	332	412	0	4	80	0.0500000
NODE_21369_length_637_cov_33.957249	332	412	2	76	80	0.9500000
NODE_21369_length_637_cov_33.957249	385	465	0	57	80	0.7125000
NODE_21369_length_637_cov_33.957249	385	465	2	23	80	0.2875000
NODE_21370_length_637_cov_23.682156	275	355	0	80	80	1.0000000
NODE_21370_length_637_cov_23.682156	328	408	0	80	80	1.0000000
NODE_21371_length_637_cov_19.676580	267	347	2	80	80	1.0000000
NODE_21371_length_637_cov_19.676580	320	400	0	34	80	0.4250000
NODE_21371_length_637_cov_19.676580	320	400	2	46	80	0.5750000
NODE_21373_length_637_cov_9.182156	226	276	0	50	50	1.0000000
NODE_21373_length_637_cov_9.182156	312	357	0	45	45	1.0000000
NODE_21374_length_637_cov_9.078067	276	357	2	44	81	0.5432099
NODE_21374_length_637_cov_9.078067	276	357	4	3	81	0.0370370
NODE_21374_length_637_cov_9.078067	276	357	6	16	81	0.1975309
NODE_21374_length_637_cov_9.078067	276	357	8	18	81	0.2222222
NODE_21374_length_637_cov_9.078067	330	410	0	40	80	0.5000000
NODE_21374_length_637_cov_9.078067	330	410	2	40	80	0.5000000
NODE_21375_length_637_cov_8.566914	235	315	0	80	80	1.0000000
NODE_21375_length_637_cov_8.566914	288	368	0	80	80	1.0000000
NODE_21378_length_637_cov_6.652416	337	415	0	31	78	0.3974359
NODE_21378_length_637_cov_6.652416	337	415	2	47	78	0.6025641
NODE_21378_length_637_cov_6.652416	390	472	0	28	82	0.3414634
NODE_21378_length_637_cov_6.652416	390	472	2	54	82	0.6585366
NODE_21385_length_637_cov_4.522305	284	364	0	80	80	1.0000000
NODE_21385_length_637_cov_4.522305	337	417	0	80	80	1.0000000
NODE_21389_length_637_cov_4.131970	292	370	0	78	78	1.0000000
NODE_21389_length_637_cov_4.131970	343	423	0	80	80	1.0000000
NODE_21457_length_636_cov_19.938547	214	294	0	50	80	0.6250000
NODE_21457_length_636_cov_19.938547	214	294	2	30	80	0.3750000
NODE_21457_length_636_cov_19.938547	267	347	0	80	80	1.0000000
NODE_21458_length_636_cov_12.283054	295	375	2	56	80	0.7000000
NODE_21458_length_636_cov_12.283054	295	375	4	24	80	0.3000000
NODE_21458_length_636_cov_12.283054	348	428	0	20	80	0.2500000
NODE_21458_length_636_cov_12.283054	348	428	2	60	80	0.7500000
NODE_21460_length_636_cov_8.312849	346	413	0	67	67	1.0000000
NODE_21460_length_636_cov_8.312849	399	479	0	80	80	1.0000000
NODE_21467_length_636_cov_4.324022	185	251	0	30	66	0.4545455
NODE_21467_length_636_cov_4.324022	185	251	2	9	66	0.1363636
NODE_21467_length_636_cov_4.324022	185	251	4	27	66	0.4090909
NODE_21467_length_636_cov_4.324022	224	266	4	42	42	1.0000000
NODE_21467_length_636_cov_4.324022	224	264	4	40	40	1.0000000
NODE_21539_length_635_cov_45.483209	195	239	119	1	44	0.0227273
NODE_21539_length_635_cov_45.483209	195	239	121	1	44	0.0227273
NODE_21539_length_635_cov_45.483209	195	239	123	5	44	0.1136364
NODE_21539_length_635_cov_45.483209	195	239	125	3	44	0.0681818
NODE_21539_length_635_cov_45.483209	195	239	126	3	44	0.0681818
NODE_21539_length_635_cov_45.483209	195	239	127	6	44	0.1363636
NODE_21539_length_635_cov_45.483209	195	239	129	13	44	0.2954545
NODE_21539_length_635_cov_45.483209	195	239	131	8	44	0.1818182
NODE_21539_length_635_cov_45.483209	195	239	133	4	44	0.0909091
NODE_21539_length_635_cov_45.483209	225	268	84	2	43	0.0465116
NODE_21539_length_635_cov_45.483209	225	268	85	1	43	0.0232558
NODE_21539_length_635_cov_45.483209	225	268	92	1	43	0.0232558
NODE_21539_length_635_cov_45.483209	225	268	94	2	43	0.0465116
NODE_21539_length_635_cov_45.483209	225	268	96	1	43	0.0232558
NODE_21539_length_635_cov_45.483209	225	268	100	1	43	0.0232558
NODE_21539_length_635_cov_45.483209	225	268	106	5	43	0.1162791
NODE_21539_length_635_cov_45.483209	225	268	108	1	43	0.0232558
NODE_21539_length_635_cov_45.483209	225	268	110	5	43	0.1162791
NODE_21539_length_635_cov_45.483209	225	268	112	4	43	0.0930233
NODE_21539_length_635_cov_45.483209	225	268	114	2	43	0.0465116
NODE_21539_length_635_cov_45.483209	225	268	116	3	43	0.0697674
NODE_21539_length_635_cov_45.483209	225	268	119	1	43	0.0232558
NODE_21539_length_635_cov_45.483209	225	268	120	1	43	0.0232558
NODE_21539_length_635_cov_45.483209	225	268	121	1	43	0.0232558
NODE_21539_length_635_cov_45.483209	225	268	123	3	43	0.0697674
NODE_21539_length_635_cov_45.483209	225	268	125	2	43	0.0465116
NODE_21539_length_635_cov_45.483209	225	268	127	5	43	0.1162791
NODE_21539_length_635_cov_45.483209	225	268	129	2	43	0.0465116
NODE_21539_length_635_cov_45.483209	248	298	57	2	50	0.0400000
NODE_21539_length_635_cov_45.483209	248	298	59	1	50	0.0200000
NODE_21539_length_635_cov_45.483209	248	298	61	1	50	0.0200000
NODE_21539_length_635_cov_45.483209	248	298	62	1	50	0.0200000
NODE_21539_length_635_cov_45.483209	248	298	64	1	50	0.0200000
NODE_21539_length_635_cov_45.483209	248	298	66	1	50	0.0200000
NODE_21539_length_635_cov_45.483209	248	298	70	1	50	0.0200000
NODE_21539_length_635_cov_45.483209	248	298	72	1	50	0.0200000
NODE_21539_length_635_cov_45.483209	248	298	74	3	50	0.0600000
NODE_21539_length_635_cov_45.483209	248	298	76	1	50	0.0200000
NODE_21539_length_635_cov_45.483209	248	298	78	2	50	0.0400000
NODE_21539_length_635_cov_45.483209	248	298	80	1	50	0.0200000
NODE_21539_length_635_cov_45.483209	248	298	82	8	50	0.1600000
NODE_21539_length_635_cov_45.483209	248	298	83	1	50	0.0200000
NODE_21539_length_635_cov_45.483209	248	298	84	4	50	0.0800000
NODE_21539_length_635_cov_45.483209	248	298	85	4	50	0.0800000
NODE_21539_length_635_cov_45.483209	248	298	92	1	50	0.0200000
NODE_21539_length_635_cov_45.483209	248	298	94	2	50	0.0400000
NODE_21539_length_635_cov_45.483209	248	298	96	1	50	0.0200000
NODE_21539_length_635_cov_45.483209	248	298	100	1	50	0.0200000
NODE_21539_length_635_cov_45.483209	248	298	106	5	50	0.1000000
NODE_21539_length_635_cov_45.483209	248	298	108	1	50	0.0200000
NODE_21539_length_635_cov_45.483209	248	298	110	5	50	0.1000000
NODE_21539_length_635_cov_45.483209	248	298	112	1	50	0.0200000
NODE_21541_length_635_cov_23.895522	179	259	0	80	80	1.0000000
NODE_21541_length_635_cov_23.895522	232	312	0	80	80	1.0000000
NODE_21543_length_635_cov_14.772388	48	128	0	80	80	1.0000000
NODE_21543_length_635_cov_14.772388	101	181	0	80	80	1.0000000
NODE_21549_length_635_cov_6.180970	276	356	0	80	80	1.0000000
NODE_21549_length_635_cov_6.180970	329	409	0	80	80	1.0000000
NODE_21554_length_635_cov_4.421642	442	522	0	80	80	1.0000000
NODE_21560_length_635_cov_2.985075	296	376	10	2	80	0.0250000
NODE_21560_length_635_cov_2.985075	296	376	12	3	80	0.0375000
NODE_21560_length_635_cov_2.985075	296	376	16	4	80	0.0500000
NODE_21560_length_635_cov_2.985075	296	376	18	20	80	0.2500000
NODE_21560_length_635_cov_2.985075	296	376	20	5	80	0.0625000
NODE_21560_length_635_cov_2.985075	296	376	22	13	80	0.1625000
NODE_21560_length_635_cov_2.985075	296	376	24	33	80	0.4125000
NODE_21625_length_634_cov_53.315888	349	429	2	4	80	0.0500000
NODE_21625_length_634_cov_53.315888	349	429	6	13	80	0.1625000
NODE_21625_length_634_cov_53.315888	349	429	7	1	80	0.0125000
NODE_21625_length_634_cov_53.315888	349	429	8	62	80	0.7750000
NODE_21625_length_634_cov_53.315888	402	482	0	35	80	0.4375000
NODE_21625_length_634_cov_53.315888	402	482	2	15	80	0.1875000
NODE_21625_length_634_cov_53.315888	402	482	6	16	80	0.2000000
NODE_21625_length_634_cov_53.315888	402	482	8	14	80	0.1750000
NODE_21626_length_634_cov_28.530841	156	236	0	80	80	1.0000000
NODE_21626_length_634_cov_28.530841	209	289	0	80	80	1.0000000
NODE_21627_length_634_cov_19.117757	151	229	0	78	78	1.0000000
NODE_21627_length_634_cov_19.117757	204	268	0	64	64	1.0000000
NODE_21628_length_634_cov_18.762617	84	164	0	80	80	1.0000000
NODE_21628_length_634_cov_18.762617	137	217	0	80	80	1.0000000
NODE_21629_length_634_cov_18.136449	162	242	0	80	80	1.0000000
NODE_21629_length_634_cov_18.136449	215	295	0	80	80	1.0000000
NODE_21635_length_634_cov_9.988785	508	553	0	45	45	1.0000000
NODE_21636_length_634_cov_9.381308	267	353	0	86	86	1.0000000
NODE_21636_length_634_cov_9.381308	324	404	0	80	80	1.0000000
NODE_21651_length_634_cov_3.702804	460	532	0	72	72	1.0000000
NODE_21720_length_633_cov_30.076779	180	214	0	34	34	1.0000000
NODE_21720_length_633_cov_30.076779	187	267	0	80	80	1.0000000
NODE_21720_length_633_cov_30.076779	263	343	0	80	80	1.0000000
NODE_21720_length_633_cov_30.076779	316	396	0	80	80	1.0000000
NODE_21721_length_633_cov_17.595506	282	362	0	80	80	1.0000000
NODE_21721_length_633_cov_17.595506	335	415	0	80	80	1.0000000
NODE_21722_length_633_cov_17.327715	228	308	0	80	80	1.0000000
NODE_21722_length_633_cov_17.327715	281	361	0	80	80	1.0000000
NODE_21723_length_633_cov_9.689139	79	147	0	16	68	0.2352941
NODE_21723_length_633_cov_9.689139	79	147	2	48	68	0.7058824
NODE_21723_length_633_cov_9.689139	79	147	4	1	68	0.0147059
NODE_21723_length_633_cov_9.689139	79	147	6	3	68	0.0441176
NODE_21729_length_633_cov_7.018727	309	389	2	78	80	0.9750000
NODE_21729_length_633_cov_7.018727	309	389	3	2	80	0.0250000
NODE_21729_length_633_cov_7.018727	362	442	0	12	80	0.1500000
NODE_21729_length_633_cov_7.018727	362	442	2	68	80	0.8500000
NODE_21755_length_633_cov_2.644195	166	240	0	74	74	1.0000000
NODE_21816_length_632_cov_25.425891	332	412	0	80	80	1.0000000
NODE_21816_length_632_cov_25.425891	385	465	0	80	80	1.0000000
NODE_21817_length_632_cov_21.613508	243	323	0	80	80	1.0000000
NODE_21817_length_632_cov_21.613508	296	376	0	80	80	1.0000000
NODE_21818_length_632_cov_16.465291	293	373	0	13	80	0.1625000
NODE_21818_length_632_cov_16.465291	293	373	2	67	80	0.8375000
NODE_21818_length_632_cov_16.465291	346	426	0	28	80	0.3500000
NODE_21818_length_632_cov_16.465291	346	426	2	52	80	0.6500000
NODE_21819_length_632_cov_13.260788	232	312	0	80	80	1.0000000
NODE_21819_length_632_cov_13.260788	285	365	0	43	80	0.5375000
NODE_21819_length_632_cov_13.260788	285	365	1	37	80	0.4625000
NODE_21821_length_632_cov_9.106942	188	268	0	80	80	1.0000000
NODE_21821_length_632_cov_9.106942	241	321	0	80	80	1.0000000
NODE_21834_length_632_cov_4.135084	229	309	0	80	80	1.0000000
NODE_21834_length_632_cov_4.135084	282	359	0	77	77	1.0000000
NODE_21841_length_632_cov_2.939962	216	274	2	10	58	0.1724138
NODE_21841_length_632_cov_2.939962	216	274	4	48	58	0.8275862
NODE_21841_length_632_cov_2.939962	247	327	0	14	80	0.1750000
NODE_21841_length_632_cov_2.939962	247	327	2	48	80	0.6000000
NODE_21841_length_632_cov_2.939962	247	327	4	18	80	0.2250000
NODE_21848_length_632_cov_2.330206	57	76	0	19	19	1.0000000
NODE_21912_length_631_cov_31.469925	321	396	0	6	75	0.0800000
NODE_21912_length_631_cov_31.469925	321	396	2	69	75	0.9200000
NODE_21912_length_631_cov_31.469925	369	449	0	41	80	0.5125000
NODE_21912_length_631_cov_31.469925	369	449	2	39	80	0.4875000
NODE_21913_length_631_cov_26.453008	383	463	0	80	80	1.0000000
NODE_21913_length_631_cov_26.453008	436	516	0	80	80	1.0000000
NODE_21917_length_631_cov_8.374060	318	398	0	80	80	1.0000000
NODE_21917_length_631_cov_8.374060	371	451	0	80	80	1.0000000
NODE_21924_length_631_cov_5.507519	335	386	2	7	51	0.1372549
NODE_21924_length_631_cov_5.507519	335	386	4	6	51	0.1176471
NODE_21924_length_631_cov_5.507519	335	386	6	38	51	0.7450981
NODE_21927_length_631_cov_5.227444	443	523	0	31	80	0.3875000
NODE_21927_length_631_cov_5.227444	443	523	2	49	80	0.6125000
NODE_21927_length_631_cov_5.227444	496	576	0	6	80	0.0750000
NODE_21927_length_631_cov_5.227444	496	576	2	74	80	0.9250000
NODE_21942_length_631_cov_2.926692	307	354	2	47	47	1.0000000
NODE_21983_length_631_cov_1.383459	248	267	0	19	19	1.0000000
NODE_22011_length_630_cov_41.728814	6	86	0	16	80	0.2000000
NODE_22011_length_630_cov_41.728814	6	86	4	52	80	0.6500000
NODE_22011_length_630_cov_41.728814	6	86	10	12	80	0.1500000
NODE_22011_length_630_cov_41.728814	59	139	4	15	80	0.1875000
NODE_22011_length_630_cov_41.728814	59	139	6	19	80	0.2375000
NODE_22011_length_630_cov_41.728814	59	139	10	46	80	0.5750000
NODE_22012_length_630_cov_24.856874	421	501	2	16	80	0.2000000
NODE_22012_length_630_cov_24.856874	421	501	4	46	80	0.5750000
NODE_22012_length_630_cov_24.856874	421	501	6	18	80	0.2250000
NODE_22012_length_630_cov_24.856874	474	554	2	69	80	0.8625000
NODE_22012_length_630_cov_24.856874	474	554	6	11	80	0.1375000
NODE_22013_length_630_cov_14.323917	196	276	0	77	80	0.9625000
NODE_22013_length_630_cov_14.323917	196	276	2	3	80	0.0375000
NODE_22013_length_630_cov_14.323917	249	329	0	24	80	0.3000000
NODE_22013_length_630_cov_14.323917	249	329	2	56	80	0.7000000
NODE_22014_length_630_cov_9.964218	284	364	0	80	80	1.0000000
NODE_22014_length_630_cov_9.964218	337	417	0	80	80	1.0000000
NODE_22086_length_629_cov_38.271698	288	368	0	28	80	0.3500000
NODE_22086_length_629_cov_38.271698	288	368	2	52	80	0.6500000
NODE_22086_length_629_cov_38.271698	341	421	0	24	80	0.3000000
NODE_22086_length_629_cov_38.271698	341	421	2	56	80	0.7000000
NODE_22087_length_629_cov_27.556604	212	292	0	49	80	0.6125000
NODE_22087_length_629_cov_27.556604	212	292	2	31	80	0.3875000
NODE_22087_length_629_cov_27.556604	265	345	2	80	80	1.0000000
NODE_22088_length_629_cov_24.150943	356	436	0	2	80	0.0250000
NODE_22088_length_629_cov_24.150943	356	436	2	78	80	0.9750000
NODE_22088_length_629_cov_24.150943	409	489	0	28	80	0.3500000
NODE_22088_length_629_cov_24.150943	409	489	2	52	80	0.6500000
NODE_22091_length_629_cov_13.641509	176	256	0	80	80	1.0000000
NODE_22091_length_629_cov_13.641509	229	309	0	39	80	0.4875000
NODE_22091_length_629_cov_13.641509	229	309	2	41	80	0.5125000
NODE_22101_length_629_cov_4.264151	362	442	0	5	80	0.0625000
NODE_22101_length_629_cov_4.264151	362	442	2	75	80	0.9375000
NODE_22188_length_628_cov_5.015123	210	274	2	64	64	1.0000000
NODE_22257_length_627_cov_24.500000	217	297	0	80	80	1.0000000
NODE_22257_length_627_cov_24.500000	270	350	0	80	80	1.0000000
NODE_22258_length_627_cov_20.395833	84	164	0	80	80	1.0000000
NODE_22258_length_627_cov_20.395833	137	217	0	80	80	1.0000000
NODE_22259_length_627_cov_19.676136	308	388	0	23	80	0.2875000
NODE_22259_length_627_cov_19.676136	308	388	5	1	80	0.0125000
NODE_22259_length_627_cov_19.676136	308	388	6	56	80	0.7000000
NODE_22259_length_627_cov_19.676136	361	441	6	80	80	1.0000000
NODE_22260_length_627_cov_17.634470	264	296	0	32	32	1.0000000
NODE_22260_length_627_cov_17.634470	360	385	0	25	25	1.0000000
NODE_22260_length_627_cov_17.634470	365	385	0	20	20	1.0000000
NODE_22260_length_627_cov_17.634470	385	424	0	39	39	1.0000000
NODE_22267_length_627_cov_5.634470	298	346	0	48	48	1.0000000
NODE_22274_length_627_cov_4.517045	323	403	0	80	80	1.0000000
NODE_22274_length_627_cov_4.517045	376	456	0	80	80	1.0000000
NODE_22357_length_626_cov_24.184061	140	220	0	45	80	0.5625000
NODE_22357_length_626_cov_24.184061	140	220	2	35	80	0.4375000
NODE_22357_length_626_cov_24.184061	193	273	2	80	80	1.0000000
NODE_22358_length_626_cov_21.189753	342	419	0	77	77	1.0000000
NODE_22358_length_626_cov_21.189753	342	419	0	77	77	1.0000000
NODE_22358_length_626_cov_21.189753	392	453	0	61	61	1.0000000
NODE_22364_length_626_cov_7.100569	236	311	0	75	75	1.0000000
NODE_22364_length_626_cov_7.100569	284	364	0	27	80	0.3375000
NODE_22364_length_626_cov_7.100569	284	364	2	47	80	0.5875000
NODE_22364_length_626_cov_7.100569	284	364	4	6	80	0.0750000
NODE_22366_length_626_cov_6.296015	193	273	0	80	80	1.0000000
NODE_22366_length_626_cov_6.296015	246	326	0	80	80	1.0000000
NODE_22367_length_626_cov_6.163188	257	337	0	66	80	0.8250000
NODE_22367_length_626_cov_6.163188	257	337	2	14	80	0.1750000
NODE_22367_length_626_cov_6.163188	310	390	0	13	80	0.1625000
NODE_22367_length_626_cov_6.163188	310	390	2	17	80	0.2125000
NODE_22367_length_626_cov_6.163188	310	390	4	50	80	0.6250000
NODE_22438_length_625_cov_33.100760	239	319	0	80	80	1.0000000
NODE_22438_length_625_cov_33.100760	292	372	0	80	80	1.0000000
NODE_22438_length_625_cov_33.100760	368	448	0	80	80	1.0000000
NODE_22438_length_625_cov_33.100760	421	501	0	80	80	1.0000000
NODE_22439_length_625_cov_21.062738	267	347	0	33	80	0.4125000
NODE_22439_length_625_cov_21.062738	267	347	2	47	80	0.5875000
NODE_22439_length_625_cov_21.062738	320	400	0	10	80	0.1250000
NODE_22439_length_625_cov_21.062738	320	400	2	70	80	0.8750000
NODE_22440_length_625_cov_14.237643	28	108	0	33	80	0.4125000
NODE_22440_length_625_cov_14.237643	28	108	2	47	80	0.5875000
NODE_22440_length_625_cov_14.237643	81	161	2	80	80	1.0000000
NODE_22441_length_625_cov_14.207224	358	438	0	4	80	0.0500000
NODE_22441_length_625_cov_14.207224	358	438	2	32	80	0.4000000
NODE_22441_length_625_cov_14.207224	358	438	4	44	80	0.5500000
NODE_22441_length_625_cov_14.207224	411	491	0	57	80	0.7125000
NODE_22441_length_625_cov_14.207224	411	491	2	16	80	0.2000000
NODE_22441_length_625_cov_14.207224	411	491	4	7	80	0.0875000
NODE_22455_length_625_cov_4.157795	548	600	0	52	52	1.0000000
NODE_22466_length_625_cov_2.929658	118	198	0	80	80	1.0000000
NODE_22466_length_625_cov_2.929658	171	251	0	80	80	1.0000000
NODE_22491_length_625_cov_1.570342	471	502	0	31	31	1.0000000
NODE_22542_length_624_cov_9.598095	77	126	0	49	49	1.0000000
NODE_22542_length_624_cov_9.598095	103	183	0	80	80	1.0000000
NODE_22544_length_624_cov_8.485714	271	351	0	5	80	0.0625000
NODE_22544_length_624_cov_8.485714	271	351	2	31	80	0.3875000
NODE_22544_length_624_cov_8.485714	271	351	4	44	80	0.5500000
NODE_22544_length_624_cov_8.485714	324	404	2	7	80	0.0875000
NODE_22544_length_624_cov_8.485714	324	404	4	73	80	0.9125000
NODE_22546_length_624_cov_6.691429	386	466	0	80	80	1.0000000
NODE_22546_length_624_cov_6.691429	439	519	0	80	80	1.0000000
NODE_22547_length_624_cov_5.592381	312	387	0	32	75	0.4266667
NODE_22547_length_624_cov_5.592381	312	387	2	43	75	0.5733333
NODE_22551_length_624_cov_4.638095	328	388	0	11	60	0.1833333
NODE_22551_length_624_cov_4.638095	328	388	2	49	60	0.8166667
NODE_22642_length_623_cov_41.877863	419	499	2	7	80	0.0875000
NODE_22642_length_623_cov_41.877863	419	499	4	73	80	0.9125000
NODE_22642_length_623_cov_41.877863	472	552	0	47	80	0.5875000
NODE_22642_length_623_cov_41.877863	472	552	2	13	80	0.1625000
NODE_22642_length_623_cov_41.877863	472	552	4	20	80	0.2500000
NODE_22643_length_623_cov_31.875954	148	228	1	4	80	0.0500000
NODE_22643_length_623_cov_31.875954	148	228	2	37	80	0.4625000
NODE_22643_length_623_cov_31.875954	148	228	4	39	80	0.4875000
NODE_22643_length_623_cov_31.875954	201	281	0	46	80	0.5750000
NODE_22643_length_623_cov_31.875954	201	281	1	11	80	0.1375000
NODE_22643_length_623_cov_31.875954	201	281	2	23	80	0.2875000
NODE_22644_length_623_cov_31.192748	313	393	0	69	80	0.8625000
NODE_22644_length_623_cov_31.192748	313	393	1	1	80	0.0125000
NODE_22644_length_623_cov_31.192748	313	393	2	10	80	0.1250000
NODE_22644_length_623_cov_31.192748	366	446	0	16	80	0.2000000
NODE_22644_length_623_cov_31.192748	366	446	1	1	80	0.0125000
NODE_22644_length_623_cov_31.192748	366	446	2	63	80	0.7875000
NODE_22645_length_623_cov_20.187023	287	367	0	80	80	1.0000000
NODE_22645_length_623_cov_20.187023	340	420	0	80	80	1.0000000
NODE_22646_length_623_cov_12.045802	377	457	0	4	80	0.0500000
NODE_22646_length_623_cov_12.045802	377	457	2	76	80	0.9500000
NODE_22646_length_623_cov_12.045802	430	510	0	51	80	0.6375000
NODE_22646_length_623_cov_12.045802	430	510	2	29	80	0.3625000
NODE_22668_length_623_cov_2.891221	457	535	0	78	78	1.0000000
NODE_22725_length_622_cov_19.042065	368	448	0	80	80	1.0000000
NODE_22725_length_622_cov_19.042065	421	501	0	80	80	1.0000000
NODE_22726_length_622_cov_13.470363	109	189	0	25	80	0.3125000
NODE_22726_length_622_cov_13.470363	109	189	2	55	80	0.6875000
NODE_22726_length_622_cov_13.470363	162	242	0	27	80	0.3375000
NODE_22726_length_622_cov_13.470363	162	242	1	1	80	0.0125000
NODE_22726_length_622_cov_13.470363	162	242	2	52	80	0.6500000
NODE_22752_length_622_cov_2.407266	94	170	0	55	76	0.7236842
NODE_22752_length_622_cov_2.407266	94	170	1	1	76	0.0131579
NODE_22752_length_622_cov_2.407266	94	170	2	20	76	0.2631579
NODE_22796_length_622_cov_1.353728	346	376	0	30	30	1.0000000
NODE_22819_length_621_cov_46.247126	0	52	0	52	52	1.0000000
NODE_22819_length_621_cov_46.247126	25	105	0	80	80	1.0000000
NODE_22819_length_621_cov_46.247126	101	181	0	80	80	1.0000000
NODE_22819_length_621_cov_46.247126	154	234	0	80	80	1.0000000
NODE_22820_length_621_cov_45.764368	344	424	2	80	80	1.0000000
NODE_22820_length_621_cov_45.764368	397	477	0	47	80	0.5875000
NODE_22820_length_621_cov_45.764368	397	477	2	33	80	0.4125000
NODE_22821_length_621_cov_35.147510	393	473	0	80	80	1.0000000
NODE_22821_length_621_cov_35.147510	446	526	0	80	80	1.0000000
NODE_22822_length_621_cov_13.842912	231	311	0	80	80	1.0000000
NODE_22822_length_621_cov_13.842912	284	364	0	80	80	1.0000000
NODE_22825_length_621_cov_6.279693	376	406	2	30	30	1.0000000
NODE_22845_length_621_cov_2.645594	367	426	0	12	59	0.2033898
NODE_22845_length_621_cov_2.645594	367	426	2	47	59	0.7966102
NODE_22914_length_620_cov_23.913628	433	513	0	32	80	0.4000000
NODE_22914_length_620_cov_23.913628	433	513	2	48	80	0.6000000
NODE_22914_length_620_cov_23.913628	486	566	0	80	80	1.0000000
NODE_22915_length_620_cov_9.222649	186	266	0	80	80	1.0000000
NODE_22915_length_620_cov_9.222649	239	319	0	80	80	1.0000000
NODE_22919_length_620_cov_7.804223	57	137	2	27	80	0.3375000
NODE_22919_length_620_cov_7.804223	57	137	4	53	80	0.6625000
NODE_22919_length_620_cov_7.804223	110	190	0	30	80	0.3750000
NODE_22919_length_620_cov_7.804223	110	190	2	32	80	0.4000000
NODE_22919_length_620_cov_7.804223	110	190	4	18	80	0.2250000
NODE_22920_length_620_cov_6.909789	199	279	0	80	80	1.0000000
NODE_22920_length_620_cov_6.909789	252	332	0	80	80	1.0000000
NODE_22930_length_620_cov_4.560461	309	347	12	11	38	0.2894737
NODE_22930_length_620_cov_4.560461	309	347	14	27	38	0.7105263
NODE_22930_length_620_cov_4.560461	395	421	0	24	26	0.9230769
NODE_22930_length_620_cov_4.560461	395	421	2	2	26	0.0769231
NODE_22930_length_620_cov_4.560461	395	451	0	54	56	0.9642857
NODE_22930_length_620_cov_4.560461	395	451	2	2	56	0.0357143
NODE_23031_length_619_cov_26.309615	118	198	4	7	80	0.0875000
NODE_23031_length_619_cov_26.309615	118	198	6	73	80	0.9125000
NODE_23031_length_619_cov_26.309615	171	251	0	45	80	0.5625000
NODE_23031_length_619_cov_26.309615	171	251	4	8	80	0.1000000
NODE_23031_length_619_cov_26.309615	171	251	6	27	80	0.3375000
NODE_23033_length_619_cov_10.417308	427	487	6	32	60	0.5333334
NODE_23033_length_619_cov_10.417308	427	487	8	28	60	0.4666667
NODE_23034_length_619_cov_7.944231	213	293	0	58	80	0.7250000
NODE_23034_length_619_cov_7.944231	213	293	2	22	80	0.2750000
NODE_23034_length_619_cov_7.944231	266	346	0	14	80	0.1750000
NODE_23034_length_619_cov_7.944231	266	346	2	66	80	0.8250000
NODE_23135_length_618_cov_14.477842	223	299	2	56	76	0.7368421
NODE_23135_length_618_cov_14.477842	223	299	4	9	76	0.1184211
NODE_23135_length_618_cov_14.477842	223	299	6	11	76	0.1447368
NODE_23135_length_618_cov_14.477842	223	299	2	56	76	0.7368421
NODE_23135_length_618_cov_14.477842	223	299	4	9	76	0.1184211
NODE_23135_length_618_cov_14.477842	223	299	6	11	76	0.1447368
NODE_23135_length_618_cov_14.477842	276	337	2	12	61	0.1967213
NODE_23135_length_618_cov_14.477842	276	337	6	25	61	0.4098361
NODE_23135_length_618_cov_14.477842	276	337	10	22	61	0.3606557
NODE_23135_length_618_cov_14.477842	276	337	11	1	61	0.0163934
NODE_23135_length_618_cov_14.477842	276	337	12	1	61	0.0163934
NODE_23136_length_618_cov_13.840077	377	457	0	65	80	0.8125000
NODE_23136_length_618_cov_13.840077	377	457	4	15	80	0.1875000
NODE_23136_length_618_cov_13.840077	430	510	0	12	80	0.1500000
NODE_23136_length_618_cov_13.840077	430	510	4	68	80	0.8500000
NODE_23137_length_618_cov_12.048170	348	428	0	10	80	0.1250000
NODE_23137_length_618_cov_12.048170	348	428	2	70	80	0.8750000
NODE_23137_length_618_cov_12.048170	401	481	0	63	80	0.7875000
NODE_23137_length_618_cov_12.048170	401	481	2	17	80	0.2125000
NODE_23138_length_618_cov_8.799615	353	433	0	80	80	1.0000000
NODE_23138_length_618_cov_8.799615	406	486	0	80	80	1.0000000
NODE_23147_length_618_cov_3.793834	412	478	0	41	66	0.6212121
NODE_23147_length_618_cov_3.793834	412	478	2	25	66	0.3787879
NODE_23148_length_618_cov_3.761079	305	385	0	80	80	1.0000000
NODE_23252_length_617_cov_29.565637	378	458	0	80	80	1.0000000
NODE_23252_length_617_cov_29.565637	431	511	0	80	80	1.0000000
NODE_23253_length_617_cov_16.781853	253	333	0	80	80	1.0000000
NODE_23253_length_617_cov_16.781853	306	386	0	80	80	1.0000000
NODE_23254_length_617_cov_9.175676	373	453	0	80	80	1.0000000
NODE_23254_length_617_cov_9.175676	426	506	0	80	80	1.0000000
NODE_23255_length_617_cov_8.774131	320	406	0	22	86	0.2558140
NODE_23255_length_617_cov_8.774131	320	406	2	30	86	0.3488372
NODE_23255_length_617_cov_8.774131	320	406	4	2	86	0.0232558
NODE_23255_length_617_cov_8.774131	320	406	6	32	86	0.3720930
NODE_23255_length_617_cov_8.774131	379	458	4	5	79	0.0632911
NODE_23255_length_617_cov_8.774131	379	458	6	74	79	0.9367089
NODE_23257_length_617_cov_8.416988	359	439	0	80	80	1.0000000
NODE_23257_length_617_cov_8.416988	412	492	0	80	80	1.0000000
NODE_23259_length_617_cov_7.683398	197	275	0	13	78	0.1666667
NODE_23259_length_617_cov_7.683398	197	275	2	65	78	0.8333333
NODE_23259_length_617_cov_7.683398	250	330	0	11	80	0.1375000
NODE_23259_length_617_cov_7.683398	250	330	2	69	80	0.8625000
NODE_23263_length_617_cov_5.330116	288	360	0	49	72	0.6805556
NODE_23263_length_617_cov_5.330116	288	360	4	23	72	0.3194444
NODE_23263_length_617_cov_5.330116	333	413	0	80	80	1.0000000
NODE_23302_length_617_cov_1.967181	384	430	0	46	46	1.0000000
NODE_23311_length_617_cov_1.847490	273	344	0	71	71	1.0000000
NODE_23331_length_617_cov_1.322394	269	318	6	11	49	0.2244898
NODE_23331_length_617_cov_1.322394	269	318	8	28	49	0.5714286
NODE_23331_length_617_cov_1.322394	269	318	10	10	49	0.2040816
NODE_23365_length_616_cov_15.914894	292	370	0	14	78	0.1794872
NODE_23365_length_616_cov_15.914894	292	370	2	7	78	0.0897436
NODE_23365_length_616_cov_15.914894	292	370	3	1	78	0.0128205
NODE_23365_length_616_cov_15.914894	292	370	4	56	78	0.7179487
NODE_23365_length_616_cov_15.914894	343	423	2	27	80	0.3375000
NODE_23365_length_616_cov_15.914894	343	423	4	53	80	0.6625000
NODE_23366_length_616_cov_14.276596	191	271	0	80	80	1.0000000
NODE_23366_length_616_cov_14.276596	244	319	0	45	75	0.6000000
NODE_23366_length_616_cov_14.276596	244	319	2	30	75	0.4000000
NODE_23366_length_616_cov_14.276596	368	448	2	66	80	0.8250000
NODE_23366_length_616_cov_14.276596	368	448	4	14	80	0.1750000
NODE_23367_length_616_cov_12.119923	273	353	0	80	80	1.0000000
NODE_23367_length_616_cov_12.119923	326	406	0	80	80	1.0000000
NODE_23373_length_616_cov_6.379110	305	385	0	45	80	0.5625000
NODE_23373_length_616_cov_6.379110	305	385	2	35	80	0.4375000
NODE_23373_length_616_cov_6.379110	358	438	0	80	80	1.0000000
NODE_23381_length_616_cov_4.441006	286	350	2	64	64	1.0000000
NODE_23381_length_616_cov_4.441006	286	306	2	20	20	1.0000000
NODE_23400_length_616_cov_2.541586	375	415	0	40	40	1.0000000
NODE_23430_length_616_cov_1.491296	105	183	0	35	78	0.4487180
NODE_23430_length_616_cov_1.491296	105	183	2	43	78	0.5512820
NODE_23474_length_615_cov_27.519380	302	382	2	22	80	0.2750000
NODE_23474_length_615_cov_27.519380	302	382	4	58	80	0.7250000
NODE_23474_length_615_cov_27.519380	355	435	2	40	80	0.5000000
NODE_23474_length_615_cov_27.519380	355	435	4	40	80	0.5000000
NODE_23475_length_615_cov_17.792636	239	319	0	80	80	1.0000000
NODE_23475_length_615_cov_17.792636	292	372	0	80	80	1.0000000
NODE_23477_length_615_cov_11.835271	240	320	0	80	80	1.0000000
NODE_23477_length_615_cov_11.835271	293	373	0	80	80	1.0000000
NODE_23478_length_615_cov_8.591085	287	367	0	79	80	0.9875000
NODE_23478_length_615_cov_8.591085	287	367	2	1	80	0.0125000
NODE_23478_length_615_cov_8.591085	340	420	0	26	80	0.3250000
NODE_23478_length_615_cov_8.591085	340	420	2	15	80	0.1875000
NODE_23478_length_615_cov_8.591085	340	420	4	39	80	0.4875000
NODE_23513_length_615_cov_2.461240	429	509	0	80	80	1.0000000
NODE_23513_length_615_cov_2.461240	482	562	0	80	80	1.0000000
NODE_23516_length_615_cov_2.379845	405	467	2	8	62	0.1290323
NODE_23516_length_615_cov_2.379845	405	467	6	54	62	0.8709677
NODE_23516_length_615_cov_2.379845	440	520	4	29	80	0.3625000
NODE_23516_length_615_cov_2.379845	440	520	6	50	80	0.6250000
NODE_23516_length_615_cov_2.379845	440	520	8	1	80	0.0125000
NODE_23517_length_615_cov_2.294574	205	268	0	63	63	1.0000000
NODE_23554_length_615_cov_1.122093	255	335	0	80	80	1.0000000
NODE_23566_length_615_cov_0.887597	561	582	2	13	21	0.6190476
NODE_23566_length_615_cov_0.887597	561	582	4	8	21	0.3809524
NODE_23575_length_614_cov_17.772816	257	337	0	80	80	1.0000000
NODE_23575_length_614_cov_17.772816	310	390	0	80	80	1.0000000
NODE_23576_length_614_cov_10.706796	425	505	2	26	80	0.3250000
NODE_23576_length_614_cov_10.706796	425	505	6	54	80	0.6750000
NODE_23576_length_614_cov_10.706796	478	558	0	37	80	0.4625000
NODE_23576_length_614_cov_10.706796	478	558	2	42	80	0.5250000
NODE_23576_length_614_cov_10.706796	478	558	6	1	80	0.0125000
NODE_23578_length_614_cov_8.545631	193	273	0	37	80	0.4625000
NODE_23578_length_614_cov_8.545631	193	273	2	14	80	0.1750000
NODE_23578_length_614_cov_8.545631	193	273	6	1	80	0.0125000
NODE_23578_length_614_cov_8.545631	193	273	10	3	80	0.0375000
NODE_23578_length_614_cov_8.545631	193	273	14	4	80	0.0500000
NODE_23578_length_614_cov_8.545631	193	273	21	5	80	0.0625000
NODE_23578_length_614_cov_8.545631	193	273	24	1	80	0.0125000
NODE_23578_length_614_cov_8.545631	193	273	32	1	80	0.0125000
NODE_23578_length_614_cov_8.545631	193	273	34	4	80	0.0500000
NODE_23578_length_614_cov_8.545631	193	273	36	10	80	0.1250000
NODE_23578_length_614_cov_8.545631	246	326	0	14	80	0.1750000
NODE_23578_length_614_cov_8.545631	246	326	2	50	80	0.6250000
NODE_23578_length_614_cov_8.545631	246	326	4	7	80	0.0875000
NODE_23578_length_614_cov_8.545631	246	326	6	9	80	0.1125000
NODE_23604_length_614_cov_2.450485	315	393	0	78	78	1.0000000
NODE_23604_length_614_cov_2.450485	355	383	0	28	28	1.0000000
NODE_23604_length_614_cov_2.450485	368	448	0	30	80	0.3750000
NODE_23604_length_614_cov_2.450485	368	448	2	50	80	0.6250000
NODE_23604_length_614_cov_2.450485	379	448	0	19	69	0.2753623
NODE_23604_length_614_cov_2.450485	379	448	2	50	69	0.7246377
NODE_23662_length_613_cov_18.075875	211	291	0	20	80	0.2500000
NODE_23662_length_613_cov_18.075875	211	291	2	60	80	0.7500000
NODE_23662_length_613_cov_18.075875	264	344	0	73	80	0.9125000
NODE_23662_length_613_cov_18.075875	264	344	2	7	80	0.0875000
NODE_23663_length_613_cov_16.118677	283	363	0	78	80	0.9750000
NODE_23663_length_613_cov_16.118677	283	363	2	2	80	0.0250000
NODE_23663_length_613_cov_16.118677	336	416	0	80	80	1.0000000
NODE_23665_length_613_cov_12.883268	155	235	0	80	80	1.0000000
NODE_23665_length_613_cov_12.883268	208	288	0	80	80	1.0000000
NODE_23674_length_613_cov_3.857977	167	247	0	80	80	1.0000000
NODE_23674_length_613_cov_3.857977	220	300	0	80	80	1.0000000
NODE_23771_length_612_cov_24.023392	173	253	0	50	80	0.6250000
NODE_23771_length_612_cov_24.023392	173	253	2	30	80	0.3750000
NODE_23771_length_612_cov_24.023392	226	306	0	80	80	1.0000000
NODE_23772_length_612_cov_23.846004	141	221	2	4	80	0.0500000
NODE_23772_length_612_cov_23.846004	141	221	4	6	80	0.0750000
NODE_23772_length_612_cov_23.846004	141	221	6	13	80	0.1625000
NODE_23772_length_612_cov_23.846004	141	221	7	1	80	0.0125000
NODE_23772_length_612_cov_23.846004	141	221	8	22	80	0.2750000
NODE_23772_length_612_cov_23.846004	141	221	10	18	80	0.2250000
NODE_23772_length_612_cov_23.846004	141	221	11	1	80	0.0125000
NODE_23772_length_612_cov_23.846004	141	221	12	15	80	0.1875000
NODE_23772_length_612_cov_23.846004	194	274	2	57	80	0.7125000
NODE_23772_length_612_cov_23.846004	194	274	4	6	80	0.0750000
NODE_23772_length_612_cov_23.846004	194	274	7	1	80	0.0125000
NODE_23772_length_612_cov_23.846004	194	274	8	16	80	0.2000000
NODE_23773_length_612_cov_12.448343	244	324	0	80	80	1.0000000
NODE_23773_length_612_cov_12.448343	297	377	0	80	80	1.0000000
NODE_23774_length_612_cov_12.068226	267	347	0	3	80	0.0375000
NODE_23774_length_612_cov_12.068226	267	347	2	26	80	0.3250000
NODE_23774_length_612_cov_12.068226	267	347	4	8	80	0.1000000
NODE_23774_length_612_cov_12.068226	267	347	6	43	80	0.5375000
NODE_23774_length_612_cov_12.068226	320	400	0	56	80	0.7000000
NODE_23774_length_612_cov_12.068226	320	400	2	24	80	0.3000000
NODE_23779_length_612_cov_6.393762	242	322	0	55	80	0.6875000
NODE_23779_length_612_cov_6.393762	242	322	2	25	80	0.3125000
NODE_23779_length_612_cov_6.393762	295	375	0	4	80	0.0500000
NODE_23779_length_612_cov_6.393762	295	375	2	76	80	0.9500000
NODE_23814_length_612_cov_1.904483	288	354	0	42	66	0.6363636
NODE_23814_length_612_cov_1.904483	288	354	1	24	66	0.3636364
NODE_23869_length_611_cov_38.705078	132	212	2	24	80	0.3000000
NODE_23869_length_611_cov_38.705078	132	212	4	33	80	0.4125000
NODE_23869_length_611_cov_38.705078	132	212	8	23	80	0.2875000
NODE_23869_length_611_cov_38.705078	185	262	0	16	77	0.2077922
NODE_23869_length_611_cov_38.705078	185	262	2	58	77	0.7532467
NODE_23869_length_611_cov_38.705078	185	262	4	3	77	0.0389610
NODE_23869_length_611_cov_38.705078	185	262	0	16	77	0.2077922
NODE_23869_length_611_cov_38.705078	185	262	2	58	77	0.7532467
NODE_23869_length_611_cov_38.705078	185	262	4	3	77	0.0389610
NODE_23871_length_611_cov_12.669922	264	344	0	12	80	0.1500000
NODE_23871_length_611_cov_12.669922	264	344	2	29	80	0.3625000
NODE_23871_length_611_cov_12.669922	264	344	4	14	80	0.1750000
NODE_23871_length_611_cov_12.669922	264	344	6	25	80	0.3125000
NODE_23871_length_611_cov_12.669922	317	397	0	1	80	0.0125000
NODE_23871_length_611_cov_12.669922	317	397	2	2	80	0.0250000
NODE_23871_length_611_cov_12.669922	317	397	3	1	80	0.0125000
NODE_23871_length_611_cov_12.669922	317	397	4	28	80	0.3500000
NODE_23871_length_611_cov_12.669922	317	397	6	48	80	0.6000000
NODE_23880_length_611_cov_4.943359	27	107	0	80	80	1.0000000
NODE_23880_length_611_cov_4.943359	80	137	0	57	57	1.0000000
NODE_23880_length_611_cov_4.943359	143	209	0	66	66	1.0000000
NODE_23880_length_611_cov_4.943359	182	262	0	80	80	1.0000000
NODE_23894_length_611_cov_3.294922	271	300	0	29	29	1.0000000
NODE_23894_length_611_cov_3.294922	434	469	0	2	35	0.0571429
NODE_23894_length_611_cov_3.294922	434	469	3	1	35	0.0285714
NODE_23894_length_611_cov_3.294922	434	469	4	18	35	0.5142857
NODE_23894_length_611_cov_3.294922	434	469	6	14	35	0.4000000
NODE_23897_length_611_cov_3.162109	313	342	2	29	29	1.0000000
NODE_23973_length_610_cov_20.673190	87	167	2	22	80	0.2750000
NODE_23973_length_610_cov_20.673190	87	167	4	33	80	0.4125000
NODE_23973_length_610_cov_20.673190	87	167	6	25	80	0.3125000
NODE_23973_length_610_cov_20.673190	140	220	2	4	80	0.0500000
NODE_23973_length_610_cov_20.673190	140	220	4	12	80	0.1500000
NODE_23973_length_610_cov_20.673190	140	220	6	64	80	0.8000000
NODE_23974_length_610_cov_10.191781	250	330	0	80	80	1.0000000
NODE_23974_length_610_cov_10.191781	303	383	0	80	80	1.0000000
NODE_23980_length_610_cov_4.998043	129	181	2	52	52	1.0000000
NODE_23980_length_610_cov_4.998043	182	234	0	27	52	0.5192308
NODE_23980_length_610_cov_4.998043	182	234	2	25	52	0.4807692
NODE_23989_length_610_cov_3.479452	215	267	0	52	52	1.0000000
NODE_24059_length_609_cov_21.117647	80	160	0	15	80	0.1875000
NODE_24059_length_609_cov_21.117647	80	160	2	33	80	0.4125000
NODE_24059_length_609_cov_21.117647	80	160	4	5	80	0.0625000
NODE_24059_length_609_cov_21.117647	80	160	6	27	80	0.3375000
NODE_24059_length_609_cov_21.117647	133	213	6	35	80	0.4375000
NODE_24059_length_609_cov_21.117647	133	213	8	45	80	0.5625000
NODE_24060_length_609_cov_11.300000	218	298	0	80	80	1.0000000
NODE_24060_length_609_cov_11.300000	271	351	0	80	80	1.0000000
NODE_24061_length_609_cov_10.778431	239	319	0	80	80	1.0000000
NODE_24061_length_609_cov_10.778431	292	372	0	80	80	1.0000000
NODE_24062_length_609_cov_10.298039	340	420	0	80	80	1.0000000
NODE_24062_length_609_cov_10.298039	393	473	0	80	80	1.0000000
NODE_24062_length_609_cov_10.298039	469	537	0	68	68	1.0000000
NODE_24063_length_609_cov_10.270588	217	297	0	36	80	0.4500000
NODE_24063_length_609_cov_10.270588	217	297	2	29	80	0.3625000
NODE_24063_length_609_cov_10.270588	217	297	6	15	80	0.1875000
NODE_24063_length_609_cov_10.270588	270	353	2	12	83	0.1445783
NODE_24063_length_609_cov_10.270588	270	353	5	14	83	0.1686747
NODE_24063_length_609_cov_10.270588	270	353	6	57	83	0.6867470
NODE_24064_length_609_cov_8.345098	408	488	0	25	80	0.3125000
NODE_24064_length_609_cov_8.345098	408	488	2	55	80	0.6875000
NODE_24064_length_609_cov_8.345098	461	515	0	52	54	0.9629630
NODE_24064_length_609_cov_8.345098	461	515	2	2	54	0.0370370
NODE_24064_length_609_cov_8.345098	537	566	0	29	29	1.0000000
NODE_24066_length_609_cov_6.054902	219	299	0	80	80	1.0000000
NODE_24066_length_609_cov_6.054902	272	352	0	80	80	1.0000000
NODE_24067_length_609_cov_5.986275	219	299	0	80	80	1.0000000
NODE_24067_length_609_cov_5.986275	272	352	0	80	80	1.0000000
NODE_24160_length_608_cov_76.257367	300	380	4	31	80	0.3875000
NODE_24160_length_608_cov_76.257367	300	380	6	49	80	0.6125000
NODE_24160_length_608_cov_76.257367	353	433	0	5	80	0.0625000
NODE_24160_length_608_cov_76.257367	353	433	4	8	80	0.1000000
NODE_24160_length_608_cov_76.257367	353	433	6	67	80	0.8375000
NODE_24161_length_608_cov_13.271120	252	332	0	80	80	1.0000000
NODE_24161_length_608_cov_13.271120	305	385	0	80	80	1.0000000
NODE_24162_length_608_cov_11.583497	63	139	0	28	76	0.3684210
NODE_24162_length_608_cov_11.583497	63	139	2	48	76	0.6315789
NODE_24162_length_608_cov_11.583497	112	192	0	80	80	1.0000000
NODE_24164_length_608_cov_8.076621	53	133	42	1	80	0.0125000
NODE_24164_length_608_cov_8.076621	53	133	46	2	80	0.0250000
NODE_24164_length_608_cov_8.076621	53	133	48	1	80	0.0125000
NODE_24164_length_608_cov_8.076621	53	133	50	4	80	0.0500000
NODE_24164_length_608_cov_8.076621	53	133	58	2	80	0.0250000
NODE_24164_length_608_cov_8.076621	53	133	60	2	80	0.0250000
NODE_24164_length_608_cov_8.076621	53	133	64	2	80	0.0250000
NODE_24164_length_608_cov_8.076621	53	133	66	3	80	0.0375000
NODE_24164_length_608_cov_8.076621	53	133	68	8	80	0.1000000
NODE_24164_length_608_cov_8.076621	53	133	70	7	80	0.0875000
NODE_24164_length_608_cov_8.076621	53	133	72	5	80	0.0625000
NODE_24164_length_608_cov_8.076621	53	133	74	13	80	0.1625000
NODE_24164_length_608_cov_8.076621	53	133	76	10	80	0.1250000
NODE_24164_length_608_cov_8.076621	53	133	78	20	80	0.2500000
NODE_24164_length_608_cov_8.076621	106	186	0	25	80	0.3125000
NODE_24164_length_608_cov_8.076621	106	186	2	1	80	0.0125000
NODE_24164_length_608_cov_8.076621	106	186	4	1	80	0.0125000
NODE_24164_length_608_cov_8.076621	106	186	6	2	80	0.0250000
NODE_24164_length_608_cov_8.076621	106	186	8	2	80	0.0250000
NODE_24164_length_608_cov_8.076621	106	186	10	2	80	0.0250000
NODE_24164_length_608_cov_8.076621	106	186	12	3	80	0.0375000
NODE_24164_length_608_cov_8.076621	106	186	14	1	80	0.0125000
NODE_24164_length_608_cov_8.076621	106	186	16	2	80	0.0250000
NODE_24164_length_608_cov_8.076621	106	186	18	3	80	0.0375000
NODE_24164_length_608_cov_8.076621	106	186	26	1	80	0.0125000
NODE_24164_length_608_cov_8.076621	106	186	30	2	80	0.0250000
NODE_24164_length_608_cov_8.076621	106	186	32	4	80	0.0500000
NODE_24164_length_608_cov_8.076621	106	186	36	1	80	0.0125000
NODE_24164_length_608_cov_8.076621	106	186	38	1	80	0.0125000
NODE_24164_length_608_cov_8.076621	106	186	40	2	80	0.0250000
NODE_24164_length_608_cov_8.076621	106	186	42	1	80	0.0125000
NODE_24164_length_608_cov_8.076621	106	186	46	2	80	0.0250000
NODE_24164_length_608_cov_8.076621	106	186	48	1	80	0.0125000
NODE_24164_length_608_cov_8.076621	106	186	50	4	80	0.0500000
NODE_24164_length_608_cov_8.076621	106	186	58	2	80	0.0250000
NODE_24164_length_608_cov_8.076621	106	186	60	2	80	0.0250000
NODE_24164_length_608_cov_8.076621	106	186	64	2	80	0.0250000
NODE_24164_length_608_cov_8.076621	106	186	66	3	80	0.0375000
NODE_24164_length_608_cov_8.076621	106	186	68	5	80	0.0625000
NODE_24164_length_608_cov_8.076621	106	186	70	2	80	0.0250000
NODE_24164_length_608_cov_8.076621	106	186	72	3	80	0.0375000
NODE_24165_length_608_cov_7.994106	279	326	0	47	47	1.0000000
NODE_24165_length_608_cov_7.994106	348	373	0	25	25	1.0000000
NODE_24166_length_608_cov_7.939096	247	277	0	30	30	1.0000000
NODE_24177_length_608_cov_3.829077	313	393	0	80	80	1.0000000
NODE_24177_length_608_cov_3.829077	366	446	0	80	80	1.0000000
NODE_24251_length_608_cov_1.064833	472	512	2	40	40	1.0000000
NODE_24281_length_607_cov_61.316929	347	427	8	6	80	0.0750000
NODE_24281_length_607_cov_61.316929	347	427	10	11	80	0.1375000
NODE_24281_length_607_cov_61.316929	347	427	12	24	80	0.3000000
NODE_24281_length_607_cov_61.316929	347	427	14	15	80	0.1875000
NODE_24281_length_607_cov_61.316929	347	427	16	1	80	0.0125000
NODE_24281_length_607_cov_61.316929	347	427	18	2	80	0.0250000
NODE_24281_length_607_cov_61.316929	347	427	20	20	80	0.2500000
NODE_24281_length_607_cov_61.316929	347	427	22	1	80	0.0125000
NODE_24281_length_607_cov_61.316929	347	427	8	6	80	0.0750000
NODE_24281_length_607_cov_61.316929	347	427	10	11	80	0.1375000
NODE_24281_length_607_cov_61.316929	347	427	12	24	80	0.3000000
NODE_24281_length_607_cov_61.316929	347	427	14	15	80	0.1875000
NODE_24281_length_607_cov_61.316929	347	427	16	1	80	0.0125000
NODE_24281_length_607_cov_61.316929	347	427	18	2	80	0.0250000
NODE_24281_length_607_cov_61.316929	347	427	20	20	80	0.2500000
NODE_24281_length_607_cov_61.316929	347	427	22	1	80	0.0125000
NODE_24281_length_607_cov_61.316929	347	427	8	6	80	0.0750000
NODE_24281_length_607_cov_61.316929	347	427	10	11	80	0.1375000
NODE_24281_length_607_cov_61.316929	347	427	12	24	80	0.3000000
NODE_24281_length_607_cov_61.316929	347	427	14	15	80	0.1875000
NODE_24281_length_607_cov_61.316929	347	427	16	1	80	0.0125000
NODE_24281_length_607_cov_61.316929	347	427	18	2	80	0.0250000
NODE_24281_length_607_cov_61.316929	347	427	20	20	80	0.2500000
NODE_24281_length_607_cov_61.316929	347	427	22	1	80	0.0125000
NODE_24281_length_607_cov_61.316929	364	427	12	24	63	0.3809524
NODE_24281_length_607_cov_61.316929	364	427	14	15	63	0.2380952
NODE_24281_length_607_cov_61.316929	364	427	16	1	63	0.0158730
NODE_24281_length_607_cov_61.316929	364	427	18	2	63	0.0317460
NODE_24281_length_607_cov_61.316929	364	427	20	20	63	0.3174603
NODE_24281_length_607_cov_61.316929	364	427	22	1	63	0.0158730
NODE_24281_length_607_cov_61.316929	400	480	8	5	80	0.0625000
NODE_24281_length_607_cov_61.316929	400	480	10	8	80	0.1000000
NODE_24281_length_607_cov_61.316929	400	480	12	1	80	0.0125000
NODE_24281_length_607_cov_61.316929	400	480	14	20	80	0.2500000
NODE_24281_length_607_cov_61.316929	400	480	16	3	80	0.0375000
NODE_24281_length_607_cov_61.316929	400	480	18	4	80	0.0500000
NODE_24281_length_607_cov_61.316929	400	480	20	33	80	0.4125000
NODE_24281_length_607_cov_61.316929	400	480	22	6	80	0.0750000
NODE_24281_length_607_cov_61.316929	400	480	8	5	80	0.0625000
NODE_24281_length_607_cov_61.316929	400	480	10	8	80	0.1000000
NODE_24281_length_607_cov_61.316929	400	480	12	1	80	0.0125000
NODE_24281_length_607_cov_61.316929	400	480	14	20	80	0.2500000
NODE_24281_length_607_cov_61.316929	400	480	16	3	80	0.0375000
NODE_24281_length_607_cov_61.316929	400	480	18	4	80	0.0500000
NODE_24281_length_607_cov_61.316929	400	480	20	33	80	0.4125000
NODE_24281_length_607_cov_61.316929	400	480	22	6	80	0.0750000
NODE_24281_length_607_cov_61.316929	400	480	8	5	80	0.0625000
NODE_24281_length_607_cov_61.316929	400	480	10	8	80	0.1000000
NODE_24281_length_607_cov_61.316929	400	480	12	1	80	0.0125000
NODE_24281_length_607_cov_61.316929	400	480	14	20	80	0.2500000
NODE_24281_length_607_cov_61.316929	400	480	16	3	80	0.0375000
NODE_24281_length_607_cov_61.316929	400	480	18	4	80	0.0500000
NODE_24281_length_607_cov_61.316929	400	480	20	33	80	0.4125000
NODE_24281_length_607_cov_61.316929	400	480	22	6	80	0.0750000
NODE_24281_length_607_cov_61.316929	400	480	8	5	80	0.0625000
NODE_24281_length_607_cov_61.316929	400	480	10	8	80	0.1000000
NODE_24281_length_607_cov_61.316929	400	480	12	1	80	0.0125000
NODE_24281_length_607_cov_61.316929	400	480	14	20	80	0.2500000
NODE_24281_length_607_cov_61.316929	400	480	16	3	80	0.0375000
NODE_24281_length_607_cov_61.316929	400	480	18	4	80	0.0500000
NODE_24281_length_607_cov_61.316929	400	480	20	33	80	0.4125000
NODE_24281_length_607_cov_61.316929	400	480	22	6	80	0.0750000
NODE_24281_length_607_cov_61.316929	476	556	10	5	80	0.0625000
NODE_24281_length_607_cov_61.316929	476	556	11	1	80	0.0125000
NODE_24281_length_607_cov_61.316929	476	556	12	8	80	0.1000000
NODE_24281_length_607_cov_61.316929	476	556	14	14	80	0.1750000
NODE_24281_length_607_cov_61.316929	476	556	16	32	80	0.4000000
NODE_24281_length_607_cov_61.316929	476	556	18	20	80	0.2500000
NODE_24281_length_607_cov_61.316929	476	556	10	5	80	0.0625000
NODE_24281_length_607_cov_61.316929	476	556	11	1	80	0.0125000
NODE_24281_length_607_cov_61.316929	476	556	12	8	80	0.1000000
NODE_24281_length_607_cov_61.316929	476	556	14	14	80	0.1750000
NODE_24281_length_607_cov_61.316929	476	556	16	32	80	0.4000000
NODE_24281_length_607_cov_61.316929	476	556	18	20	80	0.2500000
NODE_24281_length_607_cov_61.316929	476	556	10	5	80	0.0625000
NODE_24281_length_607_cov_61.316929	476	556	11	1	80	0.0125000
NODE_24281_length_607_cov_61.316929	476	556	12	8	80	0.1000000
NODE_24281_length_607_cov_61.316929	476	556	14	14	80	0.1750000
NODE_24281_length_607_cov_61.316929	476	556	16	32	80	0.4000000
NODE_24281_length_607_cov_61.316929	476	556	18	20	80	0.2500000
NODE_24281_length_607_cov_61.316929	529	595	8	6	66	0.0909091
NODE_24281_length_607_cov_61.316929	529	595	10	19	66	0.2878788
NODE_24281_length_607_cov_61.316929	529	595	12	21	66	0.3181818
NODE_24281_length_607_cov_61.316929	529	595	14	13	66	0.1969697
NODE_24281_length_607_cov_61.316929	529	595	16	7	66	0.1060606
NODE_24281_length_607_cov_61.316929	529	607	2	3	78	0.0384615
NODE_24281_length_607_cov_61.316929	529	607	8	15	78	0.1923077
NODE_24281_length_607_cov_61.316929	529	607	10	19	78	0.2435897
NODE_24281_length_607_cov_61.316929	529	607	12	21	78	0.2692308
NODE_24281_length_607_cov_61.316929	529	607	14	13	78	0.1666667
NODE_24281_length_607_cov_61.316929	529	607	16	7	78	0.0897436
NODE_24281_length_607_cov_61.316929	529	600	8	11	71	0.1549296
NODE_24281_length_607_cov_61.316929	529	600	10	19	71	0.2676056
NODE_24281_length_607_cov_61.316929	529	600	12	21	71	0.2957746
NODE_24281_length_607_cov_61.316929	529	600	14	13	71	0.1830986
NODE_24281_length_607_cov_61.316929	529	600	16	7	71	0.0985916
NODE_24281_length_607_cov_61.316929	534	607	2	3	73	0.0410959
NODE_24281_length_607_cov_61.316929	534	607	8	15	73	0.2054795
NODE_24281_length_607_cov_61.316929	534	607	10	19	73	0.2602740
NODE_24281_length_607_cov_61.316929	534	607	12	21	73	0.2876712
NODE_24281_length_607_cov_61.316929	534	607	14	13	73	0.1780822
NODE_24281_length_607_cov_61.316929	534	607	16	2	73	0.0273973
NODE_24282_length_607_cov_16.852362	383	463	0	80	80	1.0000000
NODE_24282_length_607_cov_16.852362	436	516	0	80	80	1.0000000
NODE_24283_length_607_cov_12.889764	67	147	0	77	80	0.9625000
NODE_24283_length_607_cov_12.889764	67	147	2	3	80	0.0375000
NODE_24283_length_607_cov_12.889764	120	200	0	24	80	0.3000000
NODE_24283_length_607_cov_12.889764	120	200	2	56	80	0.7000000
NODE_24284_length_607_cov_11.023622	122	202	0	80	80	1.0000000
NODE_24284_length_607_cov_11.023622	175	255	0	80	80	1.0000000
NODE_24285_length_607_cov_10.690945	199	279	0	28	80	0.3500000
NODE_24285_length_607_cov_10.690945	199	279	3	1	80	0.0125000
NODE_24285_length_607_cov_10.690945	199	279	4	51	80	0.6375000
NODE_24285_length_607_cov_10.690945	252	332	4	80	80	1.0000000
NODE_24290_length_607_cov_5.818898	301	386	0	85	85	1.0000000
NODE_24291_length_607_cov_5.771654	278	358	0	80	80	1.0000000
NODE_24291_length_607_cov_5.771654	331	411	0	80	80	1.0000000
NODE_24295_length_607_cov_4.816929	282	362	0	80	80	1.0000000
NODE_24295_length_607_cov_4.816929	335	415	0	80	80	1.0000000
NODE_24300_length_607_cov_4.015748	295	354	2	45	59	0.7627119
NODE_24300_length_607_cov_4.015748	295	354	4	14	59	0.2372881
NODE_24310_length_607_cov_3.088583	107	158	0	51	51	1.0000000
NODE_24331_length_607_cov_1.791339	204	247	0	11	43	0.2558140
NODE_24331_length_607_cov_1.791339	204	247	2	32	43	0.7441860
NODE_24400_length_606_cov_42.264300	182	262	0	31	80	0.3875000
NODE_24400_length_606_cov_42.264300	182	262	2	49	80	0.6125000
NODE_24400_length_606_cov_42.264300	235	315	2	80	80	1.0000000
NODE_24402_length_606_cov_26.341223	371	451	0	51	80	0.6375000
NODE_24402_length_606_cov_26.341223	371	451	2	29	80	0.3625000
NODE_24402_length_606_cov_26.341223	424	504	0	20	80	0.2500000
NODE_24402_length_606_cov_26.341223	424	504	2	60	80	0.7500000
NODE_24403_length_606_cov_14.895464	308	388	0	80	80	1.0000000
NODE_24403_length_606_cov_14.895464	361	441	0	80	80	1.0000000
NODE_24406_length_606_cov_7.934911	412	492	0	80	80	1.0000000
NODE_24406_length_606_cov_7.934911	465	545	0	80	80	1.0000000
NODE_24407_length_606_cov_7.481262	250	330	0	80	80	1.0000000
NODE_24407_length_606_cov_7.481262	303	383	0	51	80	0.6375000
NODE_24407_length_606_cov_7.481262	303	383	2	6	80	0.0750000
NODE_24407_length_606_cov_7.481262	303	383	6	4	80	0.0500000
NODE_24407_length_606_cov_7.481262	303	383	8	7	80	0.0875000
NODE_24407_length_606_cov_7.481262	303	383	10	12	80	0.1500000
NODE_24409_length_606_cov_6.842209	139	219	0	80	80	1.0000000
NODE_24409_length_606_cov_6.842209	192	272	0	80	80	1.0000000
NODE_24428_length_606_cov_3.384615	156	206	0	50	50	1.0000000
NODE_24433_length_606_cov_2.670611	113	193	0	5	80	0.0625000
NODE_24433_length_606_cov_2.670611	113	193	2	67	80	0.8375000
NODE_24433_length_606_cov_2.670611	113	193	4	8	80	0.1000000
NODE_24525_length_605_cov_63.343874	7	83	0	76	76	1.0000000
NODE_24525_length_605_cov_63.343874	12	83	0	71	71	1.0000000
NODE_24525_length_605_cov_63.343874	17	83	0	66	66	1.0000000
NODE_24525_length_605_cov_63.343874	56	136	0	79	80	0.9875000
NODE_24525_length_605_cov_63.343874	56	136	2	1	80	0.0125000
NODE_24525_length_605_cov_63.343874	56	136	0	79	80	0.9875000
NODE_24525_length_605_cov_63.343874	56	136	2	1	80	0.0125000
NODE_24525_length_605_cov_63.343874	56	136	0	79	80	0.9875000
NODE_24525_length_605_cov_63.343874	56	136	2	1	80	0.0125000
NODE_24525_length_605_cov_63.343874	132	212	0	3	80	0.0375000
NODE_24525_length_605_cov_63.343874	132	212	2	10	80	0.1250000
NODE_24525_length_605_cov_63.343874	132	212	4	67	80	0.8375000
NODE_24525_length_605_cov_63.343874	132	212	0	3	80	0.0375000
NODE_24525_length_605_cov_63.343874	132	212	2	10	80	0.1250000
NODE_24525_length_605_cov_63.343874	132	212	4	67	80	0.8375000
NODE_24525_length_605_cov_63.343874	132	210	0	3	78	0.0384615
NODE_24525_length_605_cov_63.343874	132	210	2	10	78	0.1282051
NODE_24525_length_605_cov_63.343874	132	210	4	65	78	0.8333333
NODE_24525_length_605_cov_63.343874	132	212	0	3	80	0.0375000
NODE_24525_length_605_cov_63.343874	132	212	2	10	80	0.1250000
NODE_24525_length_605_cov_63.343874	132	212	4	67	80	0.8375000
NODE_24525_length_605_cov_63.343874	132	212	0	3	80	0.0375000
NODE_24525_length_605_cov_63.343874	132	212	2	10	80	0.1250000
NODE_24525_length_605_cov_63.343874	132	212	4	67	80	0.8375000
NODE_24525_length_605_cov_63.343874	185	265	2	4	80	0.0500000
NODE_24525_length_605_cov_63.343874	185	265	4	72	80	0.9000000
NODE_24525_length_605_cov_63.343874	185	265	6	4	80	0.0500000
NODE_24526_length_605_cov_48.191700	298	374	0	76	76	1.0000000
NODE_24526_length_605_cov_48.191700	347	427	0	80	80	1.0000000
NODE_24528_length_605_cov_33.328063	57	137	118	6	80	0.0750000
NODE_24528_length_605_cov_33.328063	57	137	120	4	80	0.0500000
NODE_24528_length_605_cov_33.328063	57	137	122	1	80	0.0125000
NODE_24528_length_605_cov_33.328063	57	137	126	1	80	0.0125000
NODE_24528_length_605_cov_33.328063	57	137	127	4	80	0.0500000
NODE_24528_length_605_cov_33.328063	57	137	129	1	80	0.0125000
NODE_24528_length_605_cov_33.328063	57	137	131	1	80	0.0125000
NODE_24528_length_605_cov_33.328063	57	137	135	1	80	0.0125000
NODE_24528_length_605_cov_33.328063	57	137	140	1	80	0.0125000
NODE_24528_length_605_cov_33.328063	57	137	141	1	80	0.0125000
NODE_24528_length_605_cov_33.328063	57	137	143	1	80	0.0125000
NODE_24528_length_605_cov_33.328063	57	137	145	2	80	0.0250000
NODE_24528_length_605_cov_33.328063	57	137	149	2	80	0.0250000
NODE_24528_length_605_cov_33.328063	57	137	151	1	80	0.0125000
NODE_24528_length_605_cov_33.328063	57	137	153	1	80	0.0125000
NODE_24528_length_605_cov_33.328063	57	137	155	1	80	0.0125000
NODE_24528_length_605_cov_33.328063	57	137	157	1	80	0.0125000
NODE_24528_length_605_cov_33.328063	57	137	161	1	80	0.0125000
NODE_24528_length_605_cov_33.328063	57	137	163	1	80	0.0125000
NODE_24528_length_605_cov_33.328063	57	137	168	1	80	0.0125000
NODE_24528_length_605_cov_33.328063	57	137	170	2	80	0.0250000
NODE_24528_length_605_cov_33.328063	57	137	172	1	80	0.0125000
NODE_24528_length_605_cov_33.328063	57	137	177	1	80	0.0125000
NODE_24528_length_605_cov_33.328063	57	137	178	2	80	0.0250000
NODE_24528_length_605_cov_33.328063	57	137	181	3	80	0.0375000
NODE_24528_length_605_cov_33.328063	57	137	182	1	80	0.0125000
NODE_24528_length_605_cov_33.328063	57	137	183	1	80	0.0125000
NODE_24528_length_605_cov_33.328063	57	137	184	2	80	0.0250000
NODE_24528_length_605_cov_33.328063	57	137	185	3	80	0.0375000
NODE_24528_length_605_cov_33.328063	57	137	186	3	80	0.0375000
NODE_24528_length_605_cov_33.328063	57	137	188	3	80	0.0375000
NODE_24528_length_605_cov_33.328063	57	137	189	7	80	0.0875000
NODE_24528_length_605_cov_33.328063	57	137	190	5	80	0.0625000
NODE_24528_length_605_cov_33.328063	57	137	191	4	80	0.0500000
NODE_24528_length_605_cov_33.328063	57	137	192	1	80	0.0125000
NODE_24528_length_605_cov_33.328063	57	137	193	5	80	0.0625000
NODE_24528_length_605_cov_33.328063	57	137	196	1	80	0.0125000
NODE_24528_length_605_cov_33.328063	57	137	198	1	80	0.0125000
NODE_24528_length_605_cov_33.328063	57	137	200	1	80	0.0125000
NODE_24528_length_605_cov_33.328063	140	175	240	2	35	0.0571429
NODE_24528_length_605_cov_33.328063	140	175	244	1	35	0.0285714
NODE_24528_length_605_cov_33.328063	140	175	249	1	35	0.0285714
NODE_24528_length_605_cov_33.328063	140	175	250	1	35	0.0285714
NODE_24528_length_605_cov_33.328063	140	175	251	1	35	0.0285714
NODE_24528_length_605_cov_33.328063	140	175	253	1	35	0.0285714
NODE_24528_length_605_cov_33.328063	140	175	256	1	35	0.0285714
NODE_24528_length_605_cov_33.328063	140	175	261	1	35	0.0285714
NODE_24528_length_605_cov_33.328063	140	175	265	2	35	0.0571429
NODE_24528_length_605_cov_33.328063	140	175	271	3	35	0.0857143
NODE_24528_length_605_cov_33.328063	140	175	280	1	35	0.0285714
NODE_24528_length_605_cov_33.328063	140	175	288	1	35	0.0285714
NODE_24528_length_605_cov_33.328063	140	175	291	1	35	0.0285714
NODE_24528_length_605_cov_33.328063	140	175	295	1	35	0.0285714
NODE_24528_length_605_cov_33.328063	140	175	304	1	35	0.0285714
NODE_24528_length_605_cov_33.328063	140	175	308	1	35	0.0285714
NODE_24528_length_605_cov_33.328063	140	175	309	2	35	0.0571429
NODE_24528_length_605_cov_33.328063	140	175	311	1	35	0.0285714
NODE_24528_length_605_cov_33.328063	140	175	312	5	35	0.1428571
NODE_24528_length_605_cov_33.328063	140	175	313	1	35	0.0285714
NODE_24528_length_605_cov_33.328063	140	175	314	2	35	0.0571429
NODE_24528_length_605_cov_33.328063	140	175	316	2	35	0.0571429
NODE_24528_length_605_cov_33.328063	140	175	318	2	35	0.0571429
NODE_24529_length_605_cov_26.717391	353	433	0	80	80	1.0000000
NODE_24529_length_605_cov_26.717391	406	486	0	80	80	1.0000000
NODE_24530_length_605_cov_17.677866	215	295	0	54	80	0.6750000
NODE_24530_length_605_cov_17.677866	215	295	2	26	80	0.3250000
NODE_24530_length_605_cov_17.677866	268	348	0	1	80	0.0125000
NODE_24530_length_605_cov_17.677866	268	348	2	46	80	0.5750000
NODE_24530_length_605_cov_17.677866	268	348	8	33	80	0.4125000
NODE_24531_length_605_cov_15.225296	144	224	0	80	80	1.0000000
NODE_24531_length_605_cov_15.225296	197	277	0	80	80	1.0000000
NODE_24532_length_605_cov_14.990119	136	216	0	4	80	0.0500000
NODE_24532_length_605_cov_14.990119	136	216	8	1	80	0.0125000
NODE_24532_length_605_cov_14.990119	136	216	10	57	80	0.7125000
NODE_24532_length_605_cov_14.990119	136	216	12	18	80	0.2250000
NODE_24532_length_605_cov_14.990119	189	269	0	4	80	0.0500000
NODE_24532_length_605_cov_14.990119	189	269	10	9	80	0.1125000
NODE_24532_length_605_cov_14.990119	189	269	12	67	80	0.8375000
NODE_24533_length_605_cov_10.835968	103	183	0	80	80	1.0000000
NODE_24533_length_605_cov_10.835968	156	236	0	42	80	0.5250000
NODE_24533_length_605_cov_10.835968	156	236	2	38	80	0.4750000
NODE_24534_length_605_cov_9.169960	306	377	0	71	71	1.0000000
NODE_24534_length_605_cov_9.169960	359	432	0	73	73	1.0000000
NODE_24546_length_605_cov_4.308300	159	239	0	47	80	0.5875000
NODE_24546_length_605_cov_4.308300	159	239	2	33	80	0.4125000
NODE_24546_length_605_cov_4.308300	271	338	6	6	67	0.0895522
NODE_24546_length_605_cov_4.308300	271	338	10	2	67	0.0298507
NODE_24546_length_605_cov_4.308300	271	338	12	5	67	0.0746269
NODE_24546_length_605_cov_4.308300	271	338	14	13	67	0.1940299
NODE_24546_length_605_cov_4.308300	271	338	16	41	67	0.6119403
NODE_24546_length_605_cov_4.308300	275	350	6	2	75	0.0266667
NODE_24546_length_605_cov_4.308300	275	350	10	2	75	0.0266667
NODE_24546_length_605_cov_4.308300	275	350	12	7	75	0.0933333
NODE_24546_length_605_cov_4.308300	275	350	14	23	75	0.3066667
NODE_24546_length_605_cov_4.308300	275	350	16	41	75	0.5466667
NODE_24546_length_605_cov_4.308300	315	372	2	2	57	0.0350877
NODE_24546_length_605_cov_4.308300	315	372	4	6	57	0.1052632
NODE_24546_length_605_cov_4.308300	315	372	6	3	57	0.0526316
NODE_24546_length_605_cov_4.308300	315	372	8	5	57	0.0877193
NODE_24546_length_605_cov_4.308300	315	372	12	8	57	0.1403509
NODE_24546_length_605_cov_4.308300	315	372	14	15	57	0.2631579
NODE_24546_length_605_cov_4.308300	315	372	16	18	57	0.3157895
NODE_24546_length_605_cov_4.308300	328	373	2	3	45	0.0666667
NODE_24546_length_605_cov_4.308300	328	373	4	6	45	0.1333333
NODE_24546_length_605_cov_4.308300	328	373	6	3	45	0.0666667
NODE_24546_length_605_cov_4.308300	328	373	8	5	45	0.1111111
NODE_24546_length_605_cov_4.308300	328	373	12	8	45	0.1777778
NODE_24546_length_605_cov_4.308300	328	373	14	15	45	0.3333333
NODE_24546_length_605_cov_4.308300	328	373	16	5	45	0.1111111
NODE_24558_length_605_cov_3.120553	216	287	0	9	71	0.1267606
NODE_24558_length_605_cov_3.120553	216	287	1	11	71	0.1549296
NODE_24558_length_605_cov_3.120553	216	287	2	51	71	0.7183099
NODE_24561_length_605_cov_2.909091	408	487	1	3	79	0.0379747
NODE_24561_length_605_cov_2.909091	408	487	3	2	79	0.0253165
NODE_24561_length_605_cov_2.909091	408	487	4	14	79	0.1772152
NODE_24561_length_605_cov_2.909091	408	487	8	23	79	0.2911392
NODE_24561_length_605_cov_2.909091	408	487	10	3	79	0.0379747
NODE_24561_length_605_cov_2.909091	408	487	12	10	79	0.1265823
NODE_24561_length_605_cov_2.909091	408	487	14	10	79	0.1265823
NODE_24561_length_605_cov_2.909091	408	487	16	14	79	0.1772152
NODE_24577_length_605_cov_1.897233	230	273	0	43	43	1.0000000
NODE_24603_length_605_cov_1.339921	168	210	0	42	42	1.0000000
NODE_24636_length_604_cov_30.411881	93	173	0	80	80	1.0000000
NODE_24636_length_604_cov_30.411881	146	226	0	80	80	1.0000000
NODE_24637_length_604_cov_20.099010	414	494	0	80	80	1.0000000
NODE_24637_length_604_cov_20.099010	467	547	0	80	80	1.0000000
NODE_24639_length_604_cov_10.291089	184	264	0	80	80	1.0000000
NODE_24639_length_604_cov_10.291089	237	317	0	80	80	1.0000000
NODE_24646_length_604_cov_6.033663	265	345	0	80	80	1.0000000
NODE_24646_length_604_cov_6.033663	318	397	0	28	79	0.3544304
NODE_24646_length_604_cov_6.033663	318	397	2	4	79	0.0506329
NODE_24646_length_604_cov_6.033663	318	397	4	47	79	0.5949367
NODE_24654_length_604_cov_4.316832	40	106	0	66	66	1.0000000
NODE_24654_length_604_cov_4.316832	377	435	0	58	58	1.0000000
NODE_24692_length_604_cov_1.805941	299	380	0	81	81	1.0000000
NODE_24692_length_604_cov_1.805941	353	433	0	80	80	1.0000000
NODE_24732_length_603_cov_18.761905	108	188	0	53	80	0.6625000
NODE_24732_length_603_cov_18.761905	108	188	1	27	80	0.3375000
NODE_24732_length_603_cov_18.761905	161	241	1	80	80	1.0000000
NODE_24734_length_603_cov_8.996032	163	243	0	80	80	1.0000000
NODE_24734_length_603_cov_8.996032	216	296	0	36	80	0.4500000
NODE_24734_length_603_cov_8.996032	216	296	2	44	80	0.5500000
NODE_24735_length_603_cov_8.970238	413	493	1	9	80	0.1125000
NODE_24735_length_603_cov_8.970238	413	493	2	1	80	0.0125000
NODE_24735_length_603_cov_8.970238	413	493	3	47	80	0.5875000
NODE_24735_length_603_cov_8.970238	413	493	4	23	80	0.2875000
NODE_24736_length_603_cov_7.212302	324	404	0	80	80	1.0000000
NODE_24736_length_603_cov_7.212302	377	457	0	80	80	1.0000000
NODE_24739_length_603_cov_5.831349	351	385	0	34	34	1.0000000
NODE_24744_length_603_cov_4.744048	103	183	0	28	80	0.3500000
NODE_24744_length_603_cov_4.744048	103	183	2	52	80	0.6500000
NODE_24744_length_603_cov_4.744048	156	236	2	80	80	1.0000000
NODE_24748_length_603_cov_4.115079	219	259	0	2	40	0.0500000
NODE_24748_length_603_cov_4.115079	219	259	2	38	40	0.9500000
NODE_24755_length_603_cov_3.269841	186	223	0	37	37	1.0000000
NODE_24755_length_603_cov_3.269841	196	276	0	80	80	1.0000000
NODE_24755_length_603_cov_3.269841	367	441	0	74	74	1.0000000
NODE_24843_length_602_cov_33.208748	106	186	0	46	80	0.5750000
NODE_24843_length_602_cov_33.208748	106	186	2	34	80	0.4250000
NODE_24843_length_602_cov_33.208748	159	239	2	80	80	1.0000000
NODE_24844_length_602_cov_28.922465	319	399	0	3	80	0.0375000
NODE_24844_length_602_cov_28.922465	319	399	2	13	80	0.1625000
NODE_24844_length_602_cov_28.922465	319	399	4	5	80	0.0625000
NODE_24844_length_602_cov_28.922465	319	399	8	14	80	0.1750000
NODE_24844_length_602_cov_28.922465	319	399	10	45	80	0.5625000
NODE_24844_length_602_cov_28.922465	372	452	2	4	80	0.0500000
NODE_24844_length_602_cov_28.922465	372	452	6	25	80	0.3125000
NODE_24844_length_602_cov_28.922465	372	452	8	1	80	0.0125000
NODE_24844_length_602_cov_28.922465	372	452	10	50	80	0.6250000
NODE_24846_length_602_cov_10.930417	248	328	0	31	80	0.3875000
NODE_24846_length_602_cov_10.930417	248	328	2	49	80	0.6125000
NODE_24846_length_602_cov_10.930417	301	381	0	2	80	0.0250000
NODE_24846_length_602_cov_10.930417	301	381	2	78	80	0.9750000
NODE_24847_length_602_cov_10.447316	148	207	2	8	59	0.1355932
NODE_24847_length_602_cov_10.447316	148	207	4	30	59	0.5084746
NODE_24847_length_602_cov_10.447316	148	207	6	21	59	0.3559322
NODE_24847_length_602_cov_10.447316	181	207	4	5	26	0.1923077
NODE_24847_length_602_cov_10.447316	181	207	6	21	26	0.8076923
NODE_24847_length_602_cov_10.447316	259	291	0	15	32	0.4687500
NODE_24847_length_602_cov_10.447316	259	291	2	17	32	0.5312500
NODE_24851_length_602_cov_7.787276	544	565	0	21	21	1.0000000
NODE_24875_length_602_cov_3.332008	157	239	0	61	82	0.7439024
NODE_24875_length_602_cov_3.332008	157	239	2	21	82	0.2560976
NODE_24957_length_601_cov_14.952191	183	263	0	80	80	1.0000000
NODE_24957_length_601_cov_14.952191	236	316	0	80	80	1.0000000
NODE_24958_length_601_cov_14.747012	324	404	2	80	80	1.0000000
NODE_24958_length_601_cov_14.747012	377	457	0	39	80	0.4875000
NODE_24958_length_601_cov_14.747012	377	457	2	41	80	0.5125000
NODE_24959_length_601_cov_11.561753	226	306	1	5	80	0.0625000
NODE_24959_length_601_cov_11.561753	226	306	2	75	80	0.9375000
NODE_24959_length_601_cov_11.561753	279	359	0	34	80	0.4250000
NODE_24959_length_601_cov_11.561753	279	359	2	46	80	0.5750000
NODE_24960_length_601_cov_10.826693	320	388	0	68	68	1.0000000
NODE_24961_length_601_cov_10.392430	243	323	0	80	80	1.0000000
NODE_24961_length_601_cov_10.392430	296	375	0	79	79	1.0000000
NODE_24965_length_601_cov_7.037849	236	316	0	35	80	0.4375000
NODE_24965_length_601_cov_7.037849	236	316	2	18	80	0.2250000
NODE_24965_length_601_cov_7.037849	236	316	4	27	80	0.3375000
NODE_24965_length_601_cov_7.037849	289	369	4	80	80	1.0000000
NODE_24969_length_601_cov_5.798805	290	361	0	71	71	1.0000000
NODE_24970_length_601_cov_5.657371	228	308	0	45	80	0.5625000
NODE_24970_length_601_cov_5.657371	228	308	2	35	80	0.4375000
NODE_24973_length_601_cov_5.039841	395	462	0	67	67	1.0000000
NODE_24975_length_601_cov_4.735060	184	247	0	63	63	1.0000000
NODE_24995_length_601_cov_2.599602	371	430	0	59	59	1.0000000
NODE_24995_length_601_cov_2.599602	441	494	6	53	53	1.0000000
NODE_25090_length_600_cov_6.341317	125	147	5	7	22	0.3181818
NODE_25090_length_600_cov_6.341317	125	147	7	15	22	0.6818182
NODE_25103_length_600_cov_3.754491	142	222	4	8	80	0.1000000
NODE_25103_length_600_cov_3.754491	142	222	6	3	80	0.0375000
NODE_25103_length_600_cov_3.754491	142	222	8	51	80	0.6375000
NODE_25103_length_600_cov_3.754491	142	222	10	18	80	0.2250000
NODE_25126_length_600_cov_2.081836	282	328	0	46	46	1.0000000
NODE_25141_length_600_cov_1.728543	381	423	4	42	42	1.0000000
NODE_25190_length_599_cov_36.488000	25	105	28	3	80	0.0375000
NODE_25190_length_599_cov_36.488000	25	105	30	6	80	0.0750000
NODE_25190_length_599_cov_36.488000	25	105	32	3	80	0.0375000
NODE_25190_length_599_cov_36.488000	25	105	34	2	80	0.0250000
NODE_25190_length_599_cov_36.488000	25	105	35	2	80	0.0250000
NODE_25190_length_599_cov_36.488000	25	105	36	3	80	0.0375000
NODE_25190_length_599_cov_36.488000	25	105	38	11	80	0.1375000
NODE_25190_length_599_cov_36.488000	25	105	39	3	80	0.0375000
NODE_25190_length_599_cov_36.488000	25	105	40	47	80	0.5875000
NODE_25191_length_599_cov_27.870000	255	335	0	80	80	1.0000000
NODE_25191_length_599_cov_27.870000	308	388	0	80	80	1.0000000
NODE_25192_length_599_cov_22.640000	229	309	2	11	80	0.1375000
NODE_25192_length_599_cov_22.640000	229	309	6	12	80	0.1500000
NODE_25192_length_599_cov_22.640000	229	309	8	57	80	0.7125000
NODE_25192_length_599_cov_22.640000	229	309	2	11	80	0.1375000
NODE_25192_length_599_cov_22.640000	229	309	6	12	80	0.1500000
NODE_25192_length_599_cov_22.640000	229	309	8	57	80	0.7125000
NODE_25192_length_599_cov_22.640000	229	309	2	11	80	0.1375000
NODE_25192_length_599_cov_22.640000	229	309	6	12	80	0.1500000
NODE_25192_length_599_cov_22.640000	229	309	8	57	80	0.7125000
NODE_25192_length_599_cov_22.640000	229	309	2	11	80	0.1375000
NODE_25192_length_599_cov_22.640000	229	309	6	12	80	0.1500000
NODE_25192_length_599_cov_22.640000	229	309	8	57	80	0.7125000
NODE_25192_length_599_cov_22.640000	229	309	2	11	80	0.1375000
NODE_25192_length_599_cov_22.640000	229	309	6	12	80	0.1500000
NODE_25192_length_599_cov_22.640000	229	309	8	57	80	0.7125000
NODE_25192_length_599_cov_22.640000	282	362	0	40	80	0.5000000
NODE_25192_length_599_cov_22.640000	282	362	2	8	80	0.1000000
NODE_25192_length_599_cov_22.640000	282	362	4	5	80	0.0625000
NODE_25192_length_599_cov_22.640000	282	362	6	4	80	0.0500000
NODE_25192_length_599_cov_22.640000	282	362	8	23	80	0.2875000
NODE_25192_length_599_cov_22.640000	282	362	0	40	80	0.5000000
NODE_25192_length_599_cov_22.640000	282	362	2	8	80	0.1000000
NODE_25192_length_599_cov_22.640000	282	362	4	5	80	0.0625000
NODE_25192_length_599_cov_22.640000	282	362	6	4	80	0.0500000
NODE_25192_length_599_cov_22.640000	282	362	8	23	80	0.2875000
NODE_25192_length_599_cov_22.640000	282	353	0	31	71	0.4366197
NODE_25192_length_599_cov_22.640000	282	353	2	8	71	0.1126761
NODE_25192_length_599_cov_22.640000	282	353	4	5	71	0.0704225
NODE_25192_length_599_cov_22.640000	282	353	6	4	71	0.0563380
NODE_25192_length_599_cov_22.640000	282	353	8	23	71	0.3239437
NODE_25192_length_599_cov_22.640000	285	355	0	33	70	0.4714286
NODE_25192_length_599_cov_22.640000	285	355	2	8	70	0.1142857
NODE_25192_length_599_cov_22.640000	285	355	4	5	70	0.0714286
NODE_25192_length_599_cov_22.640000	285	355	6	4	70	0.0571429
NODE_25192_length_599_cov_22.640000	285	355	8	20	70	0.2857143
NODE_25192_length_599_cov_22.640000	287	362	0	40	75	0.5333334
NODE_25192_length_599_cov_22.640000	287	362	2	8	75	0.1066667
NODE_25192_length_599_cov_22.640000	287	362	4	5	75	0.0666667
NODE_25192_length_599_cov_22.640000	287	362	6	4	75	0.0533333
NODE_25192_length_599_cov_22.640000	287	362	8	18	75	0.2400000
NODE_25193_length_599_cov_14.618000	279	359	0	10	80	0.1250000
NODE_25193_length_599_cov_14.618000	279	359	2	70	80	0.8750000
NODE_25193_length_599_cov_14.618000	332	412	0	55	80	0.6875000
NODE_25193_length_599_cov_14.618000	332	412	2	25	80	0.3125000
NODE_25195_length_599_cov_10.308000	245	325	0	80	80	1.0000000
NODE_25195_length_599_cov_10.308000	298	378	0	80	80	1.0000000
NODE_25196_length_599_cov_9.224000	160	240	0	80	80	1.0000000
NODE_25196_length_599_cov_9.224000	213	297	0	77	84	0.9166667
NODE_25196_length_599_cov_9.224000	213	297	2	7	84	0.0833333
NODE_25201_length_599_cov_5.536000	58	112	0	54	54	1.0000000
NODE_25208_length_599_cov_3.810000	271	334	0	20	63	0.3174603
NODE_25208_length_599_cov_3.810000	271	334	2	43	63	0.6825397
NODE_25208_length_599_cov_3.810000	324	390	0	66	66	1.0000000
NODE_25211_length_599_cov_3.598000	238	318	0	80	80	1.0000000
NODE_25211_length_599_cov_3.598000	291	371	0	80	80	1.0000000
NODE_25308_length_598_cov_54.450902	264	344	0	80	80	1.0000000
NODE_25308_length_598_cov_54.450902	317	397	0	80	80	1.0000000
NODE_25309_length_598_cov_8.326653	204	284	0	80	80	1.0000000
NODE_25309_length_598_cov_8.326653	257	337	0	80	80	1.0000000
NODE_25316_length_598_cov_5.623246	169	240	0	71	71	1.0000000
NODE_25320_length_598_cov_4.929860	73	153	0	17	80	0.2125000
NODE_25320_length_598_cov_4.929860	73	153	2	63	80	0.7875000
NODE_25320_length_598_cov_4.929860	126	206	0	2	80	0.0250000
NODE_25320_length_598_cov_4.929860	126	206	2	78	80	0.9750000
NODE_25421_length_597_cov_15.142570	197	277	2	80	80	1.0000000
NODE_25421_length_597_cov_15.142570	250	330	0	32	80	0.4000000
NODE_25421_length_597_cov_15.142570	250	330	2	48	80	0.6000000
NODE_25422_length_597_cov_12.387550	118	198	0	5	80	0.0625000
NODE_25422_length_597_cov_12.387550	118	198	2	75	80	0.9375000
NODE_25422_length_597_cov_12.387550	171	251	0	36	80	0.4500000
NODE_25422_length_597_cov_12.387550	171	251	2	44	80	0.5500000
NODE_25423_length_597_cov_7.016064	213	293	0	80	80	1.0000000
NODE_25423_length_597_cov_7.016064	266	346	0	80	80	1.0000000
NODE_25426_length_597_cov_6.212851	374	449	2	52	75	0.6933333
NODE_25426_length_597_cov_6.212851	374	449	4	23	75	0.3066667
NODE_25434_length_597_cov_4.273092	368	448	0	80	80	1.0000000
NODE_25434_length_597_cov_4.273092	421	507	0	86	86	1.0000000
NODE_25464_length_597_cov_2.162651	92	172	0	50	80	0.6250000
NODE_25464_length_597_cov_2.162651	92	172	4	30	80	0.3750000
NODE_25464_length_597_cov_2.162651	145	225	4	80	80	1.0000000
NODE_25467_length_597_cov_2.096386	440	509	0	69	69	1.0000000
NODE_25469_length_597_cov_1.977912	392	472	6	3	80	0.0375000
NODE_25469_length_597_cov_1.977912	392	472	8	15	80	0.1875000
NODE_25469_length_597_cov_1.977912	392	472	10	20	80	0.2500000
NODE_25469_length_597_cov_1.977912	392	472	12	22	80	0.2750000
NODE_25469_length_597_cov_1.977912	392	472	14	20	80	0.2500000
NODE_25469_length_597_cov_1.977912	437	494	4	18	57	0.3157895
NODE_25469_length_597_cov_1.977912	437	494	6	3	57	0.0526316
NODE_25469_length_597_cov_1.977912	437	494	8	12	57	0.2105263
NODE_25469_length_597_cov_1.977912	437	494	10	20	57	0.3508772
NODE_25469_length_597_cov_1.977912	437	494	12	4	57	0.0701754
NODE_25469_length_597_cov_1.977912	445	525	0	14	80	0.1750000
NODE_25469_length_597_cov_1.977912	445	525	2	9	80	0.1125000
NODE_25469_length_597_cov_1.977912	445	525	4	26	80	0.3250000
NODE_25469_length_597_cov_1.977912	445	525	6	3	80	0.0375000
NODE_25469_length_597_cov_1.977912	445	525	8	12	80	0.1500000
NODE_25469_length_597_cov_1.977912	445	525	10	16	80	0.2000000
NODE_25552_length_596_cov_32.293763	221	301	4	80	80	1.0000000
NODE_25552_length_596_cov_32.293763	274	354	0	41	80	0.5125000
NODE_25552_length_596_cov_32.293763	274	354	4	39	80	0.4875000
NODE_25552_length_596_cov_32.293763	351	406	0	55	55	1.0000000
NODE_25552_length_596_cov_32.293763	381	459	0	49	78	0.6282051
NODE_25552_length_596_cov_32.293763	381	459	2	29	78	0.3717949
NODE_25553_length_596_cov_26.891348	199	279	0	80	80	1.0000000
NODE_25553_length_596_cov_26.891348	252	332	0	80	80	1.0000000
NODE_25554_length_596_cov_17.082495	179	259	0	80	80	1.0000000
NODE_25554_length_596_cov_17.082495	232	312	0	80	80	1.0000000
NODE_25555_length_596_cov_10.372233	354	434	0	80	80	1.0000000
NODE_25555_length_596_cov_10.372233	407	487	0	80	80	1.0000000
NODE_25557_length_596_cov_6.955734	142	222	2	32	80	0.4000000
NODE_25557_length_596_cov_6.955734	142	222	4	48	80	0.6000000
NODE_25558_length_596_cov_6.225352	242	322	0	80	80	1.0000000
NODE_25558_length_596_cov_6.225352	308	375	0	67	67	1.0000000
NODE_25567_length_596_cov_4.197183	369	444	0	75	75	1.0000000
NODE_25593_length_596_cov_2.066398	534	583	0	49	49	1.0000000
NODE_25666_length_595_cov_52.532258	248	328	0	12	80	0.1500000
NODE_25666_length_595_cov_52.532258	248	328	2	68	80	0.8500000
NODE_25666_length_595_cov_52.532258	301	381	0	37	80	0.4625000
NODE_25666_length_595_cov_52.532258	301	381	2	43	80	0.5375000
NODE_25667_length_595_cov_38.584677	122	202	0	60	80	0.7500000
NODE_25667_length_595_cov_38.584677	122	202	2	2	80	0.0250000
NODE_25667_length_595_cov_38.584677	122	202	4	18	80	0.2250000
NODE_25667_length_595_cov_38.584677	175	255	0	7	80	0.0875000
NODE_25667_length_595_cov_38.584677	175	255	2	2	80	0.0250000
NODE_25667_length_595_cov_38.584677	175	255	4	62	80	0.7750000
NODE_25667_length_595_cov_38.584677	175	255	6	9	80	0.1125000
NODE_25669_length_595_cov_10.576613	323	403	0	28	80	0.3500000
NODE_25669_length_595_cov_10.576613	323	403	2	52	80	0.6500000
NODE_25669_length_595_cov_10.576613	376	456	2	80	80	1.0000000
NODE_25672_length_595_cov_7.917339	342	415	8	57	73	0.7808219
NODE_25672_length_595_cov_7.917339	342	415	10	11	73	0.1506849
NODE_25672_length_595_cov_7.917339	342	415	12	5	73	0.0684932
NODE_25672_length_595_cov_7.917339	388	438	8	37	50	0.7400000
NODE_25672_length_595_cov_7.917339	388	438	10	8	50	0.1600000
NODE_25672_length_595_cov_7.917339	388	438	12	5	50	0.1000000
NODE_25702_length_595_cov_2.792339	178	258	0	56	80	0.7000000
NODE_25702_length_595_cov_2.792339	178	258	2	24	80	0.3000000
NODE_25702_length_595_cov_2.792339	231	311	0	3	80	0.0375000
NODE_25702_length_595_cov_2.792339	231	311	2	77	80	0.9625000
NODE_25807_length_594_cov_34.157576	283	363	2	32	80	0.4000000
NODE_25807_length_594_cov_34.157576	283	363	4	48	80	0.6000000
NODE_25807_length_594_cov_34.157576	336	416	0	5	80	0.0625000
NODE_25807_length_594_cov_34.157576	336	416	2	50	80	0.6250000
NODE_25807_length_594_cov_34.157576	336	416	4	25	80	0.3125000
NODE_25811_length_594_cov_8.933333	258	338	0	80	80	1.0000000
NODE_25811_length_594_cov_8.933333	311	389	0	78	78	1.0000000
NODE_25815_length_594_cov_5.759596	82	118	0	14	36	0.3888889
NODE_25815_length_594_cov_5.759596	82	118	2	22	36	0.6111111
NODE_25815_length_594_cov_5.759596	114	194	0	25	80	0.3125000
NODE_25815_length_594_cov_5.759596	114	194	2	55	80	0.6875000
NODE_25815_length_594_cov_5.759596	167	242	0	73	75	0.9733334
NODE_25815_length_594_cov_5.759596	167	242	2	2	75	0.0266667
NODE_25825_length_594_cov_3.913131	275	355	0	80	80	1.0000000
NODE_25844_length_594_cov_2.470707	209	247	2	38	38	1.0000000
NODE_25919_length_594_cov_0.698990	33	73	0	40	40	1.0000000
NODE_25928_length_593_cov_124.985830	247	285	5	4	38	0.1052632
NODE_25928_length_593_cov_124.985830	247	285	7	1	38	0.0263158
NODE_25928_length_593_cov_124.985830	247	285	8	1	38	0.0263158
NODE_25928_length_593_cov_124.985830	247	285	9	4	38	0.1052632
NODE_25928_length_593_cov_124.985830	247	285	11	2	38	0.0526316
NODE_25928_length_593_cov_124.985830	247	285	13	12	38	0.3157895
NODE_25928_length_593_cov_124.985830	247	285	25	4	38	0.1052632
NODE_25928_length_593_cov_124.985830	247	285	27	10	38	0.2631579
NODE_25929_length_593_cov_36.161943	150	230	2	80	80	1.0000000
NODE_25929_length_593_cov_36.161943	203	283	1	36	80	0.4500000
NODE_25929_length_593_cov_36.161943	203	283	2	44	80	0.5500000
NODE_25930_length_593_cov_14.979757	219	299	0	80	80	1.0000000
NODE_25930_length_593_cov_14.979757	272	352	0	80	80	1.0000000
NODE_25931_length_593_cov_11.018219	324	404	0	80	80	1.0000000
NODE_25931_length_593_cov_11.018219	377	457	0	80	80	1.0000000
NODE_25946_length_593_cov_3.232794	210	273	0	62	63	0.9841270
NODE_25946_length_593_cov_3.232794	210	273	2	1	63	0.0158730
NODE_25946_length_593_cov_3.232794	263	326	0	63	63	1.0000000
NODE_25996_length_593_cov_1.261134	227	249	0	22	22	1.0000000
NODE_26033_length_592_cov_18.908722	163	243	0	14	80	0.1750000
NODE_26033_length_592_cov_18.908722	163	243	2	54	80	0.6750000
NODE_26033_length_592_cov_18.908722	163	243	4	11	80	0.1375000
NODE_26033_length_592_cov_18.908722	163	243	6	1	80	0.0125000
NODE_26033_length_592_cov_18.908722	230	296	2	1	66	0.0151515
NODE_26033_length_592_cov_18.908722	230	296	4	11	66	0.1666667
NODE_26033_length_592_cov_18.908722	230	296	6	25	66	0.3787879
NODE_26033_length_592_cov_18.908722	230	296	8	29	66	0.4393939
NODE_26034_length_592_cov_7.531440	232	312	0	80	80	1.0000000
NODE_26034_length_592_cov_7.531440	285	361	0	76	76	1.0000000
NODE_26035_length_592_cov_7.000000	77	157	0	80	80	1.0000000
NODE_26035_length_592_cov_7.000000	130	210	0	80	80	1.0000000
NODE_26040_length_592_cov_5.036511	270	349	4	76	79	0.9620253
NODE_26040_length_592_cov_5.036511	270	349	6	3	79	0.0379747
NODE_26041_length_592_cov_5.024341	205	285	0	40	80	0.5000000
NODE_26041_length_592_cov_5.024341	205	285	2	40	80	0.5000000
NODE_26041_length_592_cov_5.024341	258	309	2	51	51	1.0000000
NODE_26062_length_592_cov_2.866126	61	127	0	66	66	1.0000000
NODE_26069_length_592_cov_2.361055	476	526	0	12	50	0.2400000
NODE_26069_length_592_cov_2.361055	476	526	4	6	50	0.1200000
NODE_26069_length_592_cov_2.361055	476	526	6	3	50	0.0600000
NODE_26069_length_592_cov_2.361055	476	526	8	29	50	0.5800000
NODE_26142_length_591_cov_11.286585	245	325	0	80	80	1.0000000
NODE_26142_length_591_cov_11.286585	298	378	0	80	80	1.0000000
NODE_26143_length_591_cov_9.432927	241	321	0	80	80	1.0000000
NODE_26143_length_591_cov_9.432927	294	374	0	80	80	1.0000000
NODE_26184_length_591_cov_2.365854	396	476	0	80	80	1.0000000
NODE_26184_length_591_cov_2.365854	449	529	0	80	80	1.0000000
NODE_26272_length_590_cov_29.661914	26	106	0	33	80	0.4125000
NODE_26272_length_590_cov_29.661914	26	106	2	47	80	0.5875000
NODE_26272_length_590_cov_29.661914	79	159	0	4	80	0.0500000
NODE_26272_length_590_cov_29.661914	79	159	2	76	80	0.9500000
NODE_26272_length_590_cov_29.661914	155	235	0	80	80	1.0000000
NODE_26272_length_590_cov_29.661914	208	288	0	80	80	1.0000000
NODE_26273_length_590_cov_21.360489	178	258	0	80	80	1.0000000
NODE_26273_length_590_cov_21.360489	231	311	0	80	80	1.0000000
NODE_26274_length_590_cov_18.395112	161	241	0	55	80	0.6875000
NODE_26274_length_590_cov_18.395112	161	241	2	10	80	0.1250000
NODE_26274_length_590_cov_18.395112	161	241	4	15	80	0.1875000
NODE_26274_length_590_cov_18.395112	214	294	0	2	80	0.0250000
NODE_26274_length_590_cov_18.395112	214	294	2	10	80	0.1250000
NODE_26274_length_590_cov_18.395112	214	294	4	68	80	0.8500000
NODE_26275_length_590_cov_17.376782	238	318	1	37	80	0.4625000
NODE_26275_length_590_cov_17.376782	238	318	2	6	80	0.0750000
NODE_26275_length_590_cov_17.376782	238	318	4	37	80	0.4625000
NODE_26275_length_590_cov_17.376782	291	371	1	80	80	1.0000000
NODE_26279_length_590_cov_6.205703	262	333	0	30	71	0.4225352
NODE_26279_length_590_cov_6.205703	262	333	2	41	71	0.5774648
NODE_26283_length_590_cov_5.319756	224	304	0	51	80	0.6375000
NODE_26283_length_590_cov_5.319756	224	304	2	29	80	0.3625000
NODE_26283_length_590_cov_5.319756	277	357	0	6	80	0.0750000
NODE_26283_length_590_cov_5.319756	277	357	2	74	80	0.9250000
NODE_26366_length_590_cov_0.971487	0	32	0	29	32	0.9062500
NODE_26366_length_590_cov_0.971487	0	32	2	3	32	0.0937500
NODE_26390_length_589_cov_15.810204	384	464	0	68	80	0.8500000
NODE_26390_length_589_cov_15.810204	384	464	2	12	80	0.1500000
NODE_26390_length_589_cov_15.810204	437	517	0	21	80	0.2625000
NODE_26390_length_589_cov_15.810204	437	517	2	59	80	0.7375000
NODE_26391_length_589_cov_13.855102	320	400	2	80	80	1.0000000
NODE_26391_length_589_cov_13.855102	373	453	2	66	80	0.8250000
NODE_26391_length_589_cov_13.855102	373	453	4	14	80	0.1750000
NODE_26395_length_589_cov_6.297959	186	266	0	80	80	1.0000000
NODE_26395_length_589_cov_6.297959	239	319	0	80	80	1.0000000
NODE_26430_length_589_cov_2.320408	431	511	0	34	80	0.4250000
NODE_26430_length_589_cov_2.320408	431	511	2	30	80	0.3750000
NODE_26430_length_589_cov_2.320408	431	511	3	1	80	0.0125000
NODE_26430_length_589_cov_2.320408	431	511	4	15	80	0.1875000
NODE_26515_length_588_cov_49.936605	264	341	0	29	77	0.3766234
NODE_26515_length_588_cov_49.936605	264	341	2	15	77	0.1948052
NODE_26515_length_588_cov_49.936605	264	341	8	33	77	0.4285714
NODE_26515_length_588_cov_49.936605	314	394	0	6	80	0.0750000
NODE_26515_length_588_cov_49.936605	314	394	6	36	80	0.4500000
NODE_26515_length_588_cov_49.936605	314	394	8	38	80	0.4750000
NODE_26516_length_588_cov_33.691207	273	353	0	15	80	0.1875000
NODE_26516_length_588_cov_33.691207	273	353	2	65	80	0.8125000
NODE_26516_length_588_cov_33.691207	326	406	0	35	80	0.4375000
NODE_26516_length_588_cov_33.691207	326	406	2	45	80	0.5625000
NODE_26517_length_588_cov_16.564417	245	325	0	80	80	1.0000000
NODE_26517_length_588_cov_16.564417	298	378	0	80	80	1.0000000
NODE_26518_length_588_cov_14.595092	266	346	2	31	80	0.3875000
NODE_26518_length_588_cov_14.595092	266	346	4	49	80	0.6125000
NODE_26518_length_588_cov_14.595092	319	399	0	11	80	0.1375000
NODE_26518_length_588_cov_14.595092	319	399	2	16	80	0.2000000
NODE_26518_length_588_cov_14.595092	319	399	4	53	80	0.6625000
NODE_26522_length_588_cov_7.439673	155	235	0	58	80	0.7250000
NODE_26522_length_588_cov_7.439673	155	235	2	8	80	0.1000000
NODE_26522_length_588_cov_7.439673	155	235	4	14	80	0.1750000
NODE_26522_length_588_cov_7.439673	208	288	0	5	80	0.0625000
NODE_26522_length_588_cov_7.439673	208	288	2	8	80	0.1000000
NODE_26522_length_588_cov_7.439673	208	288	4	67	80	0.8375000
NODE_26523_length_588_cov_7.094070	191	263	0	31	72	0.4305556
NODE_26523_length_588_cov_7.094070	191	263	2	41	72	0.5694444
NODE_26523_length_588_cov_7.094070	244	310	0	52	66	0.7878788
NODE_26523_length_588_cov_7.094070	244	310	2	14	66	0.2121212
NODE_26523_length_588_cov_7.094070	439	519	0	80	80	1.0000000
NODE_26523_length_588_cov_7.094070	492	572	0	80	80	1.0000000
NODE_26534_length_588_cov_4.167689	65	122	0	57	57	1.0000000
NODE_26634_length_587_cov_39.782787	123	203	4	46	80	0.5750000
NODE_26634_length_587_cov_39.782787	123	203	6	34	80	0.4250000
NODE_26634_length_587_cov_39.782787	176	256	2	38	80	0.4750000
NODE_26634_length_587_cov_39.782787	176	256	4	27	80	0.3375000
NODE_26634_length_587_cov_39.782787	176	256	6	15	80	0.1875000
NODE_26634_length_587_cov_39.782787	252	332	0	41	80	0.5125000
NODE_26634_length_587_cov_39.782787	252	332	2	5	80	0.0625000
NODE_26634_length_587_cov_39.782787	252	332	4	34	80	0.4250000
NODE_26634_length_587_cov_39.782787	305	385	4	80	80	1.0000000
NODE_26635_length_587_cov_31.807377	141	221	0	80	80	1.0000000
NODE_26635_length_587_cov_31.807377	194	274	0	80	80	1.0000000
NODE_26636_length_587_cov_12.629098	219	299	0	29	80	0.3625000
NODE_26636_length_587_cov_12.629098	219	299	2	1	80	0.0125000
NODE_26636_length_587_cov_12.629098	219	299	6	49	80	0.6125000
NODE_26636_length_587_cov_12.629098	219	299	8	1	80	0.0125000
NODE_26636_length_587_cov_12.629098	272	352	0	80	80	1.0000000
NODE_26639_length_587_cov_9.067623	203	283	0	30	80	0.3750000
NODE_26639_length_587_cov_9.067623	203	283	2	50	80	0.6250000
NODE_26639_length_587_cov_9.067623	256	336	2	80	80	1.0000000
NODE_26640_length_587_cov_8.411885	253	311	0	7	58	0.1206897
NODE_26640_length_587_cov_8.411885	253	311	2	51	58	0.8793104
NODE_26656_length_587_cov_3.231557	201	256	4	1	55	0.0181818
NODE_26656_length_587_cov_3.231557	201	256	5	3	55	0.0545455
NODE_26656_length_587_cov_3.231557	201	256	6	20	55	0.3636364
NODE_26656_length_587_cov_3.231557	201	256	8	31	55	0.5636364
NODE_26665_length_587_cov_2.850410	255	288	6	33	33	1.0000000
NODE_26749_length_586_cov_37.843943	268	348	4	80	80	1.0000000
NODE_26749_length_586_cov_37.843943	321	401	0	22	80	0.2750000
NODE_26749_length_586_cov_37.843943	321	401	2	21	80	0.2625000
NODE_26749_length_586_cov_37.843943	321	401	4	37	80	0.4625000
NODE_26749_length_586_cov_37.843943	397	477	2	80	80	1.0000000
NODE_26749_length_586_cov_37.843943	450	531	0	49	81	0.6049383
NODE_26749_length_586_cov_37.843943	450	531	1	1	81	0.0123457
NODE_26749_length_586_cov_37.843943	450	531	2	31	81	0.3827161
NODE_26750_length_586_cov_12.831622	186	266	0	80	80	1.0000000
NODE_26750_length_586_cov_12.831622	239	319	0	80	80	1.0000000
NODE_26752_length_586_cov_11.264887	108	188	0	80	80	1.0000000
NODE_26752_length_586_cov_11.264887	161	241	0	80	80	1.0000000
NODE_26754_length_586_cov_9.624230	299	360	0	18	61	0.2950820
NODE_26754_length_586_cov_9.624230	299	360	1	1	61	0.0163934
NODE_26754_length_586_cov_9.624230	299	360	2	30	61	0.4918033
NODE_26754_length_586_cov_9.624230	299	360	4	12	61	0.1967213
NODE_26754_length_586_cov_9.624230	299	360	0	18	61	0.2950820
NODE_26754_length_586_cov_9.624230	299	360	1	1	61	0.0163934
NODE_26754_length_586_cov_9.624230	299	360	2	30	61	0.4918033
NODE_26754_length_586_cov_9.624230	299	360	4	12	61	0.1967213
NODE_26754_length_586_cov_9.624230	299	360	0	18	61	0.2950820
NODE_26754_length_586_cov_9.624230	299	360	1	1	61	0.0163934
NODE_26754_length_586_cov_9.624230	299	360	2	30	61	0.4918033
NODE_26754_length_586_cov_9.624230	299	360	4	12	61	0.1967213
NODE_26754_length_586_cov_9.624230	301	360	0	18	59	0.3050847
NODE_26754_length_586_cov_9.624230	301	360	1	1	59	0.0169492
NODE_26754_length_586_cov_9.624230	301	360	2	30	59	0.5084746
NODE_26754_length_586_cov_9.624230	301	360	4	10	59	0.1694915
NODE_26756_length_586_cov_8.591376	273	353	0	80	80	1.0000000
NODE_26756_length_586_cov_8.591376	326	406	0	80	80	1.0000000
NODE_26758_length_586_cov_6.135524	334	375	0	41	41	1.0000000
NODE_26758_length_586_cov_6.135524	334	375	0	41	41	1.0000000
NODE_26760_length_586_cov_5.634497	150	230	0	80	80	1.0000000
NODE_26760_length_586_cov_5.634497	203	283	0	80	80	1.0000000
NODE_26765_length_586_cov_4.626283	296	362	10	25	66	0.3787879
NODE_26765_length_586_cov_4.626283	296	362	14	24	66	0.3636364
NODE_26765_length_586_cov_4.626283	296	362	16	17	66	0.2575758
NODE_26765_length_586_cov_4.626283	453	533	0	60	80	0.7500000
NODE_26765_length_586_cov_4.626283	453	533	2	20	80	0.2500000
NODE_26885_length_585_cov_112.094650	456	536	40	2	80	0.0250000
NODE_26885_length_585_cov_112.094650	456	536	42	2	80	0.0250000
NODE_26885_length_585_cov_112.094650	456	536	44	4	80	0.0500000
NODE_26885_length_585_cov_112.094650	456	536	46	1	80	0.0125000
NODE_26885_length_585_cov_112.094650	456	536	48	2	80	0.0250000
NODE_26885_length_585_cov_112.094650	456	536	50	3	80	0.0375000
NODE_26885_length_585_cov_112.094650	456	536	54	3	80	0.0375000
NODE_26885_length_585_cov_112.094650	456	536	56	9	80	0.1125000
NODE_26885_length_585_cov_112.094650	456	536	58	4	80	0.0500000
NODE_26885_length_585_cov_112.094650	456	536	60	3	80	0.0375000
NODE_26885_length_585_cov_112.094650	456	536	62	1	80	0.0125000
NODE_26885_length_585_cov_112.094650	456	536	64	4	80	0.0500000
NODE_26885_length_585_cov_112.094650	456	536	66	4	80	0.0500000
NODE_26885_length_585_cov_112.094650	456	536	68	18	80	0.2250000
NODE_26885_length_585_cov_112.094650	456	536	72	12	80	0.1500000
NODE_26885_length_585_cov_112.094650	456	536	74	6	80	0.0750000
NODE_26885_length_585_cov_112.094650	456	536	76	2	80	0.0250000
NODE_26885_length_585_cov_112.094650	509	585	0	6	76	0.0789474
NODE_26885_length_585_cov_112.094650	509	585	4	3	76	0.0394737
NODE_26885_length_585_cov_112.094650	509	585	6	11	76	0.1447368
NODE_26885_length_585_cov_112.094650	509	585	16	5	76	0.0657895
NODE_26885_length_585_cov_112.094650	509	585	24	6	76	0.0789474
NODE_26885_length_585_cov_112.094650	509	585	28	5	76	0.0657895
NODE_26885_length_585_cov_112.094650	509	585	30	4	76	0.0526316
NODE_26885_length_585_cov_112.094650	509	585	32	4	76	0.0526316
NODE_26885_length_585_cov_112.094650	509	585	36	1	76	0.0131579
NODE_26885_length_585_cov_112.094650	509	585	40	6	76	0.0789474
NODE_26885_length_585_cov_112.094650	509	585	44	2	76	0.0263158
NODE_26885_length_585_cov_112.094650	509	585	46	1	76	0.0131579
NODE_26885_length_585_cov_112.094650	509	585	50	2	76	0.0263158
NODE_26885_length_585_cov_112.094650	509	585	54	2	76	0.0263158
NODE_26885_length_585_cov_112.094650	509	585	58	1	76	0.0131579
NODE_26885_length_585_cov_112.094650	509	585	62	1	76	0.0131579
NODE_26885_length_585_cov_112.094650	509	585	64	3	76	0.0394737
NODE_26885_length_585_cov_112.094650	509	585	66	2	76	0.0263158
NODE_26885_length_585_cov_112.094650	509	585	68	11	76	0.1447368
NODE_26886_length_585_cov_23.872428	168	248	0	46	80	0.5750000
NODE_26886_length_585_cov_23.872428	168	248	4	34	80	0.4250000
NODE_26886_length_585_cov_23.872428	222	301	4	79	79	1.0000000
NODE_26887_length_585_cov_18.981481	360	440	4	21	80	0.2625000
NODE_26887_length_585_cov_18.981481	360	440	8	59	80	0.7375000
NODE_26887_length_585_cov_18.981481	413	493	0	34	80	0.4250000
NODE_26887_length_585_cov_18.981481	413	493	4	35	80	0.4375000
NODE_26887_length_585_cov_18.981481	413	493	8	11	80	0.1375000
NODE_26888_length_585_cov_13.967078	323	387	0	64	64	1.0000000
NODE_26889_length_585_cov_10.555556	229	309	0	80	80	1.0000000
NODE_26889_length_585_cov_10.555556	282	362	0	80	80	1.0000000
NODE_26891_length_585_cov_9.216049	233	313	0	80	80	1.0000000
NODE_26891_length_585_cov_9.216049	286	366	0	80	80	1.0000000
NODE_26894_length_585_cov_8.090535	292	372	0	60	80	0.7500000
NODE_26894_length_585_cov_8.090535	292	372	2	20	80	0.2500000
NODE_26894_length_585_cov_8.090535	345	425	0	7	80	0.0875000
NODE_26894_length_585_cov_8.090535	345	425	2	56	80	0.7000000
NODE_26894_length_585_cov_8.090535	345	425	4	14	80	0.1750000
NODE_26894_length_585_cov_8.090535	345	425	6	3	80	0.0375000
NODE_26895_length_585_cov_8.018519	339	381	0	42	42	1.0000000
NODE_26895_length_585_cov_8.018519	354	419	0	65	65	1.0000000
NODE_26900_length_585_cov_4.954733	147	227	0	57	80	0.7125000
NODE_26900_length_585_cov_4.954733	147	227	1	23	80	0.2875000
NODE_26912_length_585_cov_3.751029	288	368	7	4	80	0.0500000
NODE_26912_length_585_cov_3.751029	288	368	9	6	80	0.0750000
NODE_26912_length_585_cov_3.751029	288	368	17	20	80	0.2500000
NODE_26912_length_585_cov_3.751029	288	368	19	34	80	0.4250000
NODE_26912_length_585_cov_3.751029	288	368	21	16	80	0.2000000
NODE_26912_length_585_cov_3.751029	341	421	4	20	80	0.2500000
NODE_26912_length_585_cov_3.751029	341	421	5	22	80	0.2750000
NODE_26912_length_585_cov_3.751029	341	421	7	15	80	0.1875000
NODE_26912_length_585_cov_3.751029	341	421	9	6	80	0.0750000
NODE_26912_length_585_cov_3.751029	341	421	17	1	80	0.0125000
NODE_26912_length_585_cov_3.751029	341	421	19	16	80	0.2000000
NODE_27019_length_584_cov_21.657732	57	137	0	19	80	0.2375000
NODE_27019_length_584_cov_21.657732	57	137	2	61	80	0.7625000
NODE_27019_length_584_cov_21.657732	110	190	0	5	80	0.0625000
NODE_27019_length_584_cov_21.657732	110	190	2	75	80	0.9375000
NODE_27020_length_584_cov_11.915464	280	360	0	80	80	1.0000000
NODE_27020_length_584_cov_11.915464	333	413	0	49	80	0.6125000
NODE_27020_length_584_cov_11.915464	333	413	2	31	80	0.3875000
NODE_27021_length_584_cov_11.197938	217	297	0	80	80	1.0000000
NODE_27021_length_584_cov_11.197938	270	350	0	44	80	0.5500000
NODE_27021_length_584_cov_11.197938	270	350	2	36	80	0.4500000
NODE_27022_length_584_cov_9.824742	375	441	0	66	66	1.0000000
NODE_27022_length_584_cov_9.824742	375	441	0	66	66	1.0000000
NODE_27023_length_584_cov_9.160825	369	449	0	13	80	0.1625000
NODE_27023_length_584_cov_9.160825	369	449	2	67	80	0.8375000
NODE_27023_length_584_cov_9.160825	422	502	0	66	80	0.8250000
NODE_27023_length_584_cov_9.160825	422	502	2	14	80	0.1750000
NODE_27023_length_584_cov_9.160825	422	502	0	66	80	0.8250000
NODE_27023_length_584_cov_9.160825	422	502	2	14	80	0.1750000
NODE_27026_length_584_cov_7.736082	51	131	0	51	80	0.6375000
NODE_27026_length_584_cov_7.736082	51	131	2	29	80	0.3625000
NODE_27026_length_584_cov_7.736082	104	184	2	80	80	1.0000000
NODE_27031_length_584_cov_7.113402	213	293	0	80	80	1.0000000
NODE_27031_length_584_cov_7.113402	266	346	0	80	80	1.0000000
NODE_27035_length_584_cov_5.843299	281	341	0	5	60	0.0833333
NODE_27035_length_584_cov_5.843299	281	341	2	10	60	0.1666667
NODE_27035_length_584_cov_5.843299	281	341	4	1	60	0.0166667
NODE_27035_length_584_cov_5.843299	281	341	6	44	60	0.7333333
NODE_27039_length_584_cov_5.032990	240	320	0	44	80	0.5500000
NODE_27039_length_584_cov_5.032990	240	320	2	36	80	0.4500000
NODE_27039_length_584_cov_5.032990	293	373	0	12	80	0.1500000
NODE_27039_length_584_cov_5.032990	293	373	2	68	80	0.8500000
NODE_27061_length_584_cov_2.707216	186	257	0	71	71	1.0000000
NODE_27147_length_583_cov_7.973140	232	312	0	80	80	1.0000000
NODE_27147_length_583_cov_7.973140	285	365	0	80	80	1.0000000
NODE_27148_length_583_cov_6.731405	328	408	0	80	80	1.0000000
NODE_27148_length_583_cov_6.731405	381	461	0	80	80	1.0000000
NODE_27149_length_583_cov_6.363636	161	231	0	64	70	0.9142857
NODE_27149_length_583_cov_6.363636	161	231	2	6	70	0.0857143
NODE_27152_length_583_cov_5.766529	132	186	0	54	54	1.0000000
NODE_27263_length_583_cov_0.762397	9	50	0	41	41	1.0000000
NODE_27278_length_582_cov_74.269151	295	375	0	16	80	0.2000000
NODE_27278_length_582_cov_74.269151	295	375	6	1	80	0.0125000
NODE_27278_length_582_cov_74.269151	295	375	8	33	80	0.4125000
NODE_27278_length_582_cov_74.269151	295	375	10	6	80	0.0750000
NODE_27278_length_582_cov_74.269151	295	375	12	5	80	0.0625000
NODE_27278_length_582_cov_74.269151	295	375	14	19	80	0.2375000
NODE_27278_length_582_cov_74.269151	348	428	4	14	80	0.1750000
NODE_27278_length_582_cov_74.269151	348	428	10	16	80	0.2000000
NODE_27278_length_582_cov_74.269151	348	428	12	19	80	0.2375000
NODE_27278_length_582_cov_74.269151	348	428	14	31	80	0.3875000
NODE_27279_length_582_cov_53.093168	11	91	0	80	80	1.0000000
NODE_27279_length_582_cov_53.093168	64	144	0	80	80	1.0000000
NODE_27279_length_582_cov_53.093168	140	220	0	80	80	1.0000000
NODE_27279_length_582_cov_53.093168	193	273	0	80	80	1.0000000
NODE_27280_length_582_cov_47.393375	345	425	0	80	80	1.0000000
NODE_27280_length_582_cov_47.393375	398	478	0	40	80	0.5000000
NODE_27280_length_582_cov_47.393375	398	478	2	40	80	0.5000000
NODE_27281_length_582_cov_16.358178	297	377	0	26	80	0.3250000
NODE_27281_length_582_cov_16.358178	297	377	2	54	80	0.6750000
NODE_27281_length_582_cov_16.358178	350	431	0	20	81	0.2469136
NODE_27281_length_582_cov_16.358178	350	431	2	61	81	0.7530864
NODE_27282_length_582_cov_14.107660	128	208	0	8	80	0.1000000
NODE_27282_length_582_cov_14.107660	128	208	2	72	80	0.9000000
NODE_27282_length_582_cov_14.107660	181	261	0	47	80	0.5875000
NODE_27282_length_582_cov_14.107660	181	261	2	33	80	0.4125000
NODE_27283_length_582_cov_7.923395	208	287	0	22	79	0.2784810
NODE_27283_length_582_cov_7.923395	208	287	2	57	79	0.7215190
NODE_27283_length_582_cov_7.923395	262	340	0	75	78	0.9615384
NODE_27283_length_582_cov_7.923395	262	340	2	3	78	0.0384615
NODE_27284_length_582_cov_7.722567	216	296	0	80	80	1.0000000
NODE_27284_length_582_cov_7.722567	269	349	0	80	80	1.0000000
NODE_27289_length_582_cov_4.956522	294	325	0	31	31	1.0000000
NODE_27295_length_582_cov_4.308489	151	192	8	8	41	0.1951219
NODE_27295_length_582_cov_4.308489	151	192	10	10	41	0.2439024
NODE_27295_length_582_cov_4.308489	151	192	12	23	41	0.5609756
NODE_27297_length_582_cov_3.838509	223	299	0	76	76	1.0000000
NODE_27297_length_582_cov_3.838509	272	354	0	82	82	1.0000000
NODE_27350_length_582_cov_1.650104	375	450	0	5	75	0.0666667
NODE_27350_length_582_cov_1.650104	375	450	2	70	75	0.9333333
NODE_27405_length_581_cov_16.890041	244	316	2	72	72	1.0000000
NODE_27413_length_581_cov_6.340249	262	342	0	80	80	1.0000000
NODE_27413_length_581_cov_6.340249	315	395	0	80	80	1.0000000
NODE_27416_length_581_cov_5.827801	122	192	0	56	70	0.8000000
NODE_27416_length_581_cov_5.827801	122	192	2	14	70	0.2000000
NODE_27420_length_581_cov_5.072614	392	466	0	38	74	0.5135135
NODE_27420_length_581_cov_5.072614	392	466	2	36	74	0.4864865
NODE_27420_length_581_cov_5.072614	424	444	0	6	20	0.3000000
NODE_27420_length_581_cov_5.072614	424	444	2	14	20	0.7000000
NODE_27464_length_581_cov_1.881743	474	538	0	64	64	1.0000000
NODE_27541_length_580_cov_39.353430	358	438	0	43	80	0.5375000
NODE_27541_length_580_cov_39.353430	358	438	2	37	80	0.4625000
NODE_27541_length_580_cov_39.353430	411	491	0	45	80	0.5625000
NODE_27541_length_580_cov_39.353430	411	491	2	3	80	0.0375000
NODE_27541_length_580_cov_39.353430	411	491	4	5	80	0.0625000
NODE_27541_length_580_cov_39.353430	411	491	12	27	80	0.3375000
NODE_27541_length_580_cov_39.353430	487	567	8	2	80	0.0250000
NODE_27541_length_580_cov_39.353430	487	567	10	2	80	0.0250000
NODE_27541_length_580_cov_39.353430	487	567	12	76	80	0.9500000
NODE_27541_length_580_cov_39.353430	487	567	8	2	80	0.0250000
NODE_27541_length_580_cov_39.353430	487	567	10	2	80	0.0250000
NODE_27541_length_580_cov_39.353430	487	567	12	76	80	0.9500000
NODE_27541_length_580_cov_39.353430	487	567	8	2	80	0.0250000
NODE_27541_length_580_cov_39.353430	487	567	10	2	80	0.0250000
NODE_27541_length_580_cov_39.353430	487	567	12	76	80	0.9500000
NODE_27541_length_580_cov_39.353430	487	567	8	2	80	0.0250000
NODE_27541_length_580_cov_39.353430	487	567	10	2	80	0.0250000
NODE_27541_length_580_cov_39.353430	487	567	12	76	80	0.9500000
NODE_27541_length_580_cov_39.353430	487	567	8	2	80	0.0250000
NODE_27541_length_580_cov_39.353430	487	567	10	2	80	0.0250000
NODE_27541_length_580_cov_39.353430	487	567	12	76	80	0.9500000
NODE_27541_length_580_cov_39.353430	487	567	8	2	80	0.0250000
NODE_27541_length_580_cov_39.353430	487	567	10	2	80	0.0250000
NODE_27541_length_580_cov_39.353430	487	567	12	76	80	0.9500000
NODE_27544_length_580_cov_8.925156	198	238	0	40	40	1.0000000
NODE_27544_length_580_cov_8.925156	258	338	0	80	80	1.0000000
NODE_27545_length_580_cov_8.634096	197	277	2	31	80	0.3875000
NODE_27545_length_580_cov_8.634096	197	277	4	49	80	0.6125000
NODE_27545_length_580_cov_8.634096	250	330	0	28	80	0.3500000
NODE_27545_length_580_cov_8.634096	250	330	2	52	80	0.6500000
NODE_27551_length_580_cov_6.291060	356	398	0	42	42	1.0000000
NODE_27554_length_580_cov_5.494802	110	190	0	63	80	0.7875000
NODE_27554_length_580_cov_5.494802	110	190	2	17	80	0.2125000
NODE_27554_length_580_cov_5.494802	163	243	0	10	80	0.1250000
NODE_27554_length_580_cov_5.494802	163	243	2	39	80	0.4875000
NODE_27554_length_580_cov_5.494802	163	243	4	31	80	0.3875000
NODE_27559_length_580_cov_4.563410	231	292	0	5	61	0.0819672
NODE_27559_length_580_cov_4.563410	231	292	2	56	61	0.9180328
NODE_27559_length_580_cov_4.563410	322	357	0	18	35	0.5142857
NODE_27559_length_580_cov_4.563410	322	357	2	17	35	0.4857143
NODE_27590_length_580_cov_2.264033	215	277	0	62	62	1.0000000
NODE_27597_length_580_cov_2.116424	265	345	0	80	80	1.0000000
NODE_27659_length_579_cov_24.231250	159	239	0	80	80	1.0000000
NODE_27659_length_579_cov_24.231250	212	287	0	75	75	1.0000000
NODE_27660_length_579_cov_12.602083	246	326	0	80	80	1.0000000
NODE_27660_length_579_cov_12.602083	299	377	0	78	78	1.0000000
NODE_27663_length_579_cov_9.195833	254	334	8	8	80	0.1000000
NODE_27663_length_579_cov_9.195833	254	334	10	11	80	0.1375000
NODE_27663_length_579_cov_9.195833	254	334	12	61	80	0.7625000
NODE_27663_length_579_cov_9.195833	307	387	0	37	80	0.4625000
NODE_27663_length_579_cov_9.195833	307	387	2	9	80	0.1125000
NODE_27663_length_579_cov_9.195833	307	387	6	7	80	0.0875000
NODE_27663_length_579_cov_9.195833	307	387	8	8	80	0.1000000
NODE_27663_length_579_cov_9.195833	307	387	10	9	80	0.1125000
NODE_27663_length_579_cov_9.195833	307	387	12	10	80	0.1250000
NODE_27663_length_579_cov_9.195833	383	463	0	60	80	0.7500000
NODE_27663_length_579_cov_9.195833	383	463	2	20	80	0.2500000
NODE_27664_length_579_cov_6.600000	169	249	0	33	80	0.4125000
NODE_27664_length_579_cov_6.600000	169	249	4	47	80	0.5875000
NODE_27664_length_579_cov_6.600000	222	302	0	19	80	0.2375000
NODE_27664_length_579_cov_6.600000	222	302	3	1	80	0.0125000
NODE_27664_length_579_cov_6.600000	222	302	4	60	80	0.7500000
NODE_27667_length_579_cov_5.956250	225	295	6	7	70	0.1000000
NODE_27667_length_579_cov_5.956250	225	295	10	21	70	0.3000000
NODE_27667_length_579_cov_5.956250	225	295	12	42	70	0.6000000
NODE_27667_length_579_cov_5.956250	279	316	2	10	37	0.2702703
NODE_27667_length_579_cov_5.956250	279	316	4	4	37	0.1081081
NODE_27667_length_579_cov_5.956250	279	316	6	2	37	0.0540541
NODE_27667_length_579_cov_5.956250	279	316	8	5	37	0.1351351
NODE_27667_length_579_cov_5.956250	279	316	10	14	37	0.3783784
NODE_27667_length_579_cov_5.956250	279	316	12	2	37	0.0540541
NODE_27674_length_579_cov_4.850000	105	185	0	80	80	1.0000000
NODE_27674_length_579_cov_4.850000	158	238	0	80	80	1.0000000
NODE_27688_length_579_cov_3.291667	290	343	0	53	53	1.0000000
NODE_27695_length_579_cov_2.420833	251	331	0	75	80	0.9375000
NODE_27695_length_579_cov_2.420833	251	331	2	5	80	0.0625000
NODE_27695_length_579_cov_2.420833	304	384	0	80	80	1.0000000
NODE_27724_length_579_cov_1.435417	463	497	2	4	34	0.1176471
NODE_27724_length_579_cov_1.435417	463	497	4	30	34	0.8823529
NODE_27781_length_578_cov_70.192067	100	180	2	64	80	0.8000000
NODE_27781_length_578_cov_70.192067	100	180	4	16	80	0.2000000
NODE_27781_length_578_cov_70.192067	153	233	2	11	80	0.1375000
NODE_27781_length_578_cov_70.192067	153	233	4	24	80	0.3000000
NODE_27781_length_578_cov_70.192067	153	233	6	33	80	0.4125000
NODE_27781_length_578_cov_70.192067	153	233	8	12	80	0.1500000
NODE_27782_length_578_cov_51.676409	129	209	0	37	80	0.4625000
NODE_27782_length_578_cov_51.676409	129	209	2	43	80	0.5375000
NODE_27782_length_578_cov_51.676409	182	262	0	9	80	0.1125000
NODE_27782_length_578_cov_51.676409	182	262	2	71	80	0.8875000
NODE_27783_length_578_cov_32.152401	310	390	0	29	80	0.3625000
NODE_27783_length_578_cov_32.152401	310	390	2	51	80	0.6375000
NODE_27783_length_578_cov_32.152401	363	443	0	80	80	1.0000000
NODE_27784_length_578_cov_30.484342	215	295	0	80	80	1.0000000
NODE_27784_length_578_cov_30.484342	268	348	0	80	80	1.0000000
NODE_27785_length_578_cov_15.983299	213	265	4	15	52	0.2884615
NODE_27785_length_578_cov_15.983299	213	265	6	22	52	0.4230769
NODE_27785_length_578_cov_15.983299	213	265	8	15	52	0.2884615
NODE_27786_length_578_cov_14.968685	147	227	0	80	80	1.0000000
NODE_27786_length_578_cov_14.968685	200	280	0	80	80	1.0000000
NODE_27787_length_578_cov_9.567850	273	328	0	48	55	0.8727273
NODE_27787_length_578_cov_9.567850	273	328	2	7	55	0.1272727
NODE_27792_length_578_cov_6.670146	273	353	0	51	80	0.6375000
NODE_27792_length_578_cov_6.670146	273	353	3	29	80	0.3625000
NODE_27792_length_578_cov_6.670146	326	406	0	80	80	1.0000000
NODE_27793_length_578_cov_6.465553	320	400	0	40	80	0.5000000
NODE_27793_length_578_cov_6.465553	320	400	3	4	80	0.0500000
NODE_27793_length_578_cov_6.465553	320	400	4	36	80	0.4500000
NODE_27793_length_578_cov_6.465553	373	453	0	7	80	0.0875000
NODE_27793_length_578_cov_6.465553	373	453	4	73	80	0.9125000
NODE_27863_length_578_cov_1.480167	185	265	0	80	80	1.0000000
NODE_27863_length_578_cov_1.480167	238	318	0	80	80	1.0000000
NODE_27935_length_577_cov_11.638075	312	392	0	80	80	1.0000000
NODE_27942_length_577_cov_4.912134	218	249	6	31	31	1.0000000
NODE_27942_length_577_cov_4.912134	301	330	6	2	29	0.0689655
NODE_27942_length_577_cov_4.912134	301	330	10	4	29	0.1379310
NODE_27942_length_577_cov_4.912134	301	330	12	16	29	0.5517241
NODE_27942_length_577_cov_4.912134	301	330	14	7	29	0.2413793
NODE_27961_length_577_cov_2.970711	78	126	10	8	48	0.1666667
NODE_27961_length_577_cov_2.970711	78	126	12	40	48	0.8333333
NODE_27968_length_577_cov_2.631799	169	253	2	60	84	0.7142857
NODE_27968_length_577_cov_2.631799	169	253	4	24	84	0.2857143
NODE_27968_length_577_cov_2.631799	226	269	2	40	43	0.9302326
NODE_27968_length_577_cov_2.631799	226	269	4	3	43	0.0697674
NODE_28003_length_577_cov_1.468619	71	146	0	20	75	0.2666667
NODE_28003_length_577_cov_1.468619	71	146	2	20	75	0.2666667
NODE_28003_length_577_cov_1.468619	71	146	4	35	75	0.4666667
NODE_28003_length_577_cov_1.468619	119	199	0	42	80	0.5250000
NODE_28003_length_577_cov_1.468619	119	199	2	21	80	0.2625000
NODE_28003_length_577_cov_1.468619	119	199	4	17	80	0.2125000
NODE_28058_length_576_cov_10.903564	194	274	0	80	80	1.0000000
NODE_28059_length_576_cov_9.039832	271	351	2	80	80	1.0000000
NODE_28059_length_576_cov_9.039832	324	404	0	30	80	0.3750000
NODE_28059_length_576_cov_9.039832	324	404	2	50	80	0.6250000
NODE_28060_length_576_cov_8.490566	338	418	0	80	80	1.0000000
NODE_28060_length_576_cov_8.490566	391	471	0	80	80	1.0000000
NODE_28061_length_576_cov_7.002096	157	237	0	52	80	0.6500000
NODE_28061_length_576_cov_7.002096	157	237	2	28	80	0.3500000
NODE_28061_length_576_cov_7.002096	210	290	0	7	80	0.0875000
NODE_28061_length_576_cov_7.002096	210	290	2	73	80	0.9125000
NODE_28076_length_576_cov_3.322851	118	183	8	7	65	0.1076923
NODE_28076_length_576_cov_3.322851	118	183	10	20	65	0.3076923
NODE_28076_length_576_cov_3.322851	118	183	12	4	65	0.0615385
NODE_28076_length_576_cov_3.322851	118	183	14	34	65	0.5230770
NODE_28102_length_576_cov_1.964361	148	228	0	7	80	0.0875000
NODE_28102_length_576_cov_1.964361	148	228	2	73	80	0.9125000
NODE_28102_length_576_cov_1.964361	201	281	0	60	80	0.7500000
NODE_28102_length_576_cov_1.964361	201	281	2	20	80	0.2500000
NODE_28104_length_576_cov_1.951782	159	239	0	80	80	1.0000000
NODE_28104_length_576_cov_1.951782	212	292	0	80	80	1.0000000
NODE_28116_length_576_cov_1.584906	381	455	0	74	74	1.0000000
NODE_28179_length_575_cov_15.319328	319	399	0	37	80	0.4625000
NODE_28179_length_575_cov_15.319328	319	399	2	43	80	0.5375000
NODE_28179_length_575_cov_15.319328	372	452	0	80	80	1.0000000
NODE_28181_length_575_cov_8.254202	286	366	0	80	80	1.0000000
NODE_28181_length_575_cov_8.254202	339	419	0	80	80	1.0000000
NODE_28182_length_575_cov_7.558824	300	380	4	31	80	0.3875000
NODE_28182_length_575_cov_7.558824	300	380	6	28	80	0.3500000
NODE_28182_length_575_cov_7.558824	300	380	8	21	80	0.2625000
NODE_28313_length_574_cov_6.282105	185	265	0	64	80	0.8000000
NODE_28313_length_574_cov_6.282105	185	265	2	12	80	0.1500000
NODE_28313_length_574_cov_6.282105	185	265	4	4	80	0.0500000
NODE_28313_length_574_cov_6.282105	238	318	0	80	80	1.0000000
NODE_28330_length_574_cov_2.993684	215	234	0	19	19	1.0000000
NODE_28438_length_573_cov_53.668776	393	473	2	80	80	1.0000000
NODE_28438_length_573_cov_53.668776	446	526	0	39	80	0.4875000
NODE_28438_length_573_cov_53.668776	446	526	2	41	80	0.5125000
NODE_28439_length_573_cov_30.658228	451	531	0	80	80	1.0000000
NODE_28440_length_573_cov_30.116034	435	515	15	2	80	0.0250000
NODE_28440_length_573_cov_30.116034	435	515	17	11	80	0.1375000
NODE_28440_length_573_cov_30.116034	435	515	19	5	80	0.0625000
NODE_28440_length_573_cov_30.116034	435	515	21	1	80	0.0125000
NODE_28440_length_573_cov_30.116034	435	515	24	3	80	0.0375000
NODE_28440_length_573_cov_30.116034	435	515	25	12	80	0.1500000
NODE_28440_length_573_cov_30.116034	435	515	26	2	80	0.0250000
NODE_28440_length_573_cov_30.116034	435	515	27	6	80	0.0750000
NODE_28440_length_573_cov_30.116034	435	515	29	7	80	0.0875000
NODE_28440_length_573_cov_30.116034	435	515	31	7	80	0.0875000
NODE_28440_length_573_cov_30.116034	435	515	33	18	80	0.2250000
NODE_28440_length_573_cov_30.116034	435	515	35	6	80	0.0750000
NODE_28440_length_573_cov_30.116034	488	568	7	3	80	0.0375000
NODE_28440_length_573_cov_30.116034	488	568	9	5	80	0.0625000
NODE_28440_length_573_cov_30.116034	488	568	11	13	80	0.1625000
NODE_28440_length_573_cov_30.116034	488	568	13	2	80	0.0250000
NODE_28440_length_573_cov_30.116034	488	568	15	32	80	0.4000000
NODE_28440_length_573_cov_30.116034	488	568	17	11	80	0.1375000
NODE_28440_length_573_cov_30.116034	488	568	19	5	80	0.0625000
NODE_28440_length_573_cov_30.116034	488	568	21	1	80	0.0125000
NODE_28440_length_573_cov_30.116034	488	568	25	8	80	0.1000000
NODE_28441_length_573_cov_24.234177	210	290	0	80	80	1.0000000
NODE_28441_length_573_cov_24.234177	263	343	0	80	80	1.0000000
NODE_28442_length_573_cov_13.464135	278	358	0	80	80	1.0000000
NODE_28442_length_573_cov_13.464135	331	411	0	80	80	1.0000000
NODE_28443_length_573_cov_8.761603	124	204	0	80	80	1.0000000
NODE_28443_length_573_cov_8.761603	177	257	0	80	80	1.0000000
NODE_28456_length_573_cov_3.364979	365	398	17	8	33	0.2424242
NODE_28456_length_573_cov_3.364979	365	398	18	3	33	0.0909091
NODE_28456_length_573_cov_3.364979	365	398	19	5	33	0.1515152
NODE_28456_length_573_cov_3.364979	365	398	20	17	33	0.5151515
NODE_28565_length_572_cov_17.530655	312	392	0	80	80	1.0000000
NODE_28565_length_572_cov_17.530655	365	445	0	80	80	1.0000000
NODE_28567_length_572_cov_8.059197	250	321	0	71	71	1.0000000
NODE_28568_length_572_cov_7.873150	134	214	0	80	80	1.0000000
NODE_28568_length_572_cov_7.873150	187	267	0	80	80	1.0000000
NODE_28570_length_572_cov_6.706131	365	445	0	23	80	0.2875000
NODE_28570_length_572_cov_6.706131	365	445	2	57	80	0.7125000
NODE_28570_length_572_cov_6.706131	418	498	0	23	80	0.2875000
NODE_28570_length_572_cov_6.706131	418	498	2	57	80	0.7125000
NODE_28573_length_572_cov_5.625793	137	217	0	80	80	1.0000000
NODE_28573_length_572_cov_5.625793	190	270	0	80	80	1.0000000
NODE_28574_length_572_cov_5.617336	331	401	0	60	70	0.8571429
NODE_28574_length_572_cov_5.617336	331	401	2	10	70	0.1428571
NODE_28578_length_572_cov_4.596195	212	288	0	76	76	1.0000000
NODE_28578_length_572_cov_4.596195	261	341	0	80	80	1.0000000
NODE_28585_length_572_cov_3.843552	210	290	4	80	80	1.0000000
NODE_28585_length_572_cov_3.843552	263	343	0	46	80	0.5750000
NODE_28585_length_572_cov_3.843552	263	343	4	34	80	0.4250000
NODE_28621_length_572_cov_2.319239	357	431	0	74	74	1.0000000
NODE_28621_length_572_cov_2.319239	410	478	0	45	68	0.6617647
NODE_28621_length_572_cov_2.319239	410	478	2	23	68	0.3382353
NODE_28625_length_572_cov_2.107822	184	254	0	70	70	1.0000000
NODE_28625_length_572_cov_2.107822	415	493	0	63	78	0.8076923
NODE_28625_length_572_cov_2.107822	415	493	2	15	78	0.1923077
NODE_28631_length_572_cov_1.947146	327	363	0	36	36	1.0000000
NODE_28631_length_572_cov_1.947146	328	354	0	26	26	1.0000000
NODE_28700_length_571_cov_14.262712	237	317	0	80	80	1.0000000
NODE_28700_length_571_cov_14.262712	290	370	0	80	80	1.0000000
NODE_28717_length_571_cov_4.033898	154	234	0	80	80	1.0000000
NODE_28717_length_571_cov_4.033898	207	273	0	66	66	1.0000000
NODE_28809_length_570_cov_28.269639	487	559	7	14	72	0.1944444
NODE_28809_length_570_cov_28.269639	487	559	9	3	72	0.0416667
NODE_28809_length_570_cov_28.269639	487	559	18	8	72	0.1111111
NODE_28809_length_570_cov_28.269639	487	559	20	5	72	0.0694444
NODE_28809_length_570_cov_28.269639	487	559	22	2	72	0.0277778
NODE_28809_length_570_cov_28.269639	487	559	26	19	72	0.2638889
NODE_28809_length_570_cov_28.269639	487	559	27	14	72	0.1944444
NODE_28809_length_570_cov_28.269639	487	559	28	2	72	0.0277778
NODE_28809_length_570_cov_28.269639	487	559	30	2	72	0.0277778
NODE_28809_length_570_cov_28.269639	487	559	31	3	72	0.0416667
NODE_28812_length_570_cov_10.161359	167	247	0	67	80	0.8375000
NODE_28812_length_570_cov_10.161359	167	247	2	13	80	0.1625000
NODE_28812_length_570_cov_10.161359	220	256	0	14	36	0.3888889
NODE_28812_length_570_cov_10.161359	220	256	2	22	36	0.6111111
NODE_28819_length_570_cov_5.010616	179	216	0	37	37	1.0000000
NODE_28819_length_570_cov_5.010616	189	269	0	80	80	1.0000000
NODE_28828_length_570_cov_3.898089	236	316	0	80	80	1.0000000
NODE_28828_length_570_cov_3.898089	289	369	0	80	80	1.0000000
NODE_28840_length_570_cov_2.938429	202	280	0	52	78	0.6666667
NODE_28840_length_570_cov_2.938429	202	280	2	26	78	0.3333333
NODE_28840_length_570_cov_2.938429	262	333	0	71	71	1.0000000
NODE_28842_length_570_cov_2.891720	204	260	0	15	56	0.2678571
NODE_28842_length_570_cov_2.891720	204	260	2	41	56	0.7321429
NODE_28950_length_569_cov_20.559574	275	355	0	34	80	0.4250000
NODE_28950_length_569_cov_20.559574	275	355	2	46	80	0.5750000
NODE_28950_length_569_cov_20.559574	328	408	0	80	80	1.0000000
NODE_28951_length_569_cov_15.282979	272	352	0	78	80	0.9750000
NODE_28951_length_569_cov_15.282979	272	352	3	2	80	0.0250000
NODE_28951_length_569_cov_15.282979	325	405	0	42	80	0.5250000
NODE_28951_length_569_cov_15.282979	325	405	2	38	80	0.4750000
NODE_28952_length_569_cov_11.023404	280	360	0	80	80	1.0000000
NODE_28952_length_569_cov_11.023404	333	413	0	80	80	1.0000000
NODE_28953_length_569_cov_9.310638	231	277	6	46	46	1.0000000
NODE_28956_length_569_cov_6.989362	258	338	0	80	80	1.0000000
NODE_28956_length_569_cov_6.989362	294	329	0	35	35	1.0000000
NODE_28956_length_569_cov_6.989362	296	338	0	42	42	1.0000000
NODE_28957_length_569_cov_6.978723	264	344	0	80	80	1.0000000
NODE_28957_length_569_cov_6.978723	317	397	0	80	80	1.0000000
NODE_28960_length_569_cov_6.434043	228	308	0	60	80	0.7500000
NODE_28960_length_569_cov_6.434043	228	308	2	18	80	0.2250000
NODE_28960_length_569_cov_6.434043	228	308	6	2	80	0.0250000
NODE_28973_length_569_cov_3.353191	340	419	0	67	79	0.8481013
NODE_28973_length_569_cov_3.353191	340	419	2	3	79	0.0379747
NODE_28973_length_569_cov_3.353191	340	419	4	9	79	0.1139240
NODE_28981_length_569_cov_3.027660	277	348	0	71	71	1.0000000
NODE_29072_length_568_cov_59.729211	124	204	0	80	80	1.0000000
NODE_29072_length_568_cov_59.729211	177	257	0	80	80	1.0000000
NODE_29075_length_568_cov_7.763326	215	294	0	79	79	1.0000000
NODE_29075_length_568_cov_7.763326	267	347	0	80	80	1.0000000
NODE_29078_length_568_cov_6.257996	397	471	0	51	74	0.6891892
NODE_29078_length_568_cov_6.257996	397	471	1	23	74	0.3108108
NODE_29091_length_568_cov_3.748401	170	236	0	66	66	1.0000000
NODE_29091_length_568_cov_3.748401	262	311	0	49	49	1.0000000
NODE_29133_length_568_cov_1.769723	192	233	0	41	41	1.0000000
NODE_29160_length_568_cov_1.358209	355	432	2	71	77	0.9220779
NODE_29160_length_568_cov_1.358209	355	432	4	6	77	0.0779221
NODE_29182_length_568_cov_1.038380	195	275	0	80	80	1.0000000
NODE_29216_length_567_cov_21.155983	347	427	0	80	80	1.0000000
NODE_29216_length_567_cov_21.155983	400	480	0	80	80	1.0000000
NODE_29217_length_567_cov_18.292735	367	447	0	80	80	1.0000000
NODE_29217_length_567_cov_18.292735	420	500	0	80	80	1.0000000
NODE_29218_length_567_cov_17.579060	259	339	0	15	80	0.1875000
NODE_29218_length_567_cov_17.579060	259	339	2	65	80	0.8125000
NODE_29218_length_567_cov_17.579060	312	392	0	24	80	0.3000000
NODE_29218_length_567_cov_17.579060	312	392	2	56	80	0.7000000
NODE_29220_length_567_cov_15.457265	276	356	0	3	80	0.0375000
NODE_29220_length_567_cov_15.457265	276	356	2	33	80	0.4125000
NODE_29220_length_567_cov_15.457265	276	356	4	44	80	0.5500000
NODE_29220_length_567_cov_15.457265	329	409	0	9	80	0.1125000
NODE_29220_length_567_cov_15.457265	329	409	2	71	80	0.8875000
NODE_29221_length_567_cov_14.393162	270	350	0	64	80	0.8000000
NODE_29221_length_567_cov_14.393162	270	350	2	16	80	0.2000000
NODE_29221_length_567_cov_14.393162	323	403	0	11	80	0.1375000
NODE_29221_length_567_cov_14.393162	323	403	2	69	80	0.8625000
NODE_29225_length_567_cov_6.611111	356	436	0	80	80	1.0000000
NODE_29225_length_567_cov_6.611111	409	489	0	80	80	1.0000000
NODE_29245_length_567_cov_2.884615	204	284	0	80	80	1.0000000
NODE_29245_length_567_cov_2.884615	204	254	0	50	50	1.0000000
NODE_29245_length_567_cov_2.884615	266	297	0	31	31	1.0000000
NODE_29363_length_566_cov_47.747323	157	237	0	14	80	0.1750000
NODE_29363_length_566_cov_47.747323	157	237	2	24	80	0.3000000
NODE_29363_length_566_cov_47.747323	157	237	4	5	80	0.0625000
NODE_29363_length_566_cov_47.747323	157	237	6	9	80	0.1125000
NODE_29363_length_566_cov_47.747323	157	237	8	28	80	0.3500000
NODE_29363_length_566_cov_47.747323	210	290	6	18	80	0.2250000
NODE_29363_length_566_cov_47.747323	210	290	8	62	80	0.7750000
NODE_29364_length_566_cov_44.824411	14	94	9	1	80	0.0125000
NODE_29364_length_566_cov_44.824411	14	94	12	2	80	0.0250000
NODE_29364_length_566_cov_44.824411	14	94	16	4	80	0.0500000
NODE_29364_length_566_cov_44.824411	14	94	18	5	80	0.0625000
NODE_29364_length_566_cov_44.824411	14	94	20	2	80	0.0250000
NODE_29364_length_566_cov_44.824411	14	94	22	1	80	0.0125000
NODE_29364_length_566_cov_44.824411	14	94	24	1	80	0.0125000
NODE_29364_length_566_cov_44.824411	14	94	25	1	80	0.0125000
NODE_29364_length_566_cov_44.824411	14	94	30	1	80	0.0125000
NODE_29364_length_566_cov_44.824411	14	94	32	2	80	0.0250000
NODE_29364_length_566_cov_44.824411	14	94	36	3	80	0.0375000
NODE_29364_length_566_cov_44.824411	14	94	38	6	80	0.0750000
NODE_29364_length_566_cov_44.824411	14	94	40	1	80	0.0125000
NODE_29364_length_566_cov_44.824411	14	94	42	10	80	0.1250000
NODE_29364_length_566_cov_44.824411	14	94	44	1	80	0.0125000
NODE_29364_length_566_cov_44.824411	14	94	46	39	80	0.4875000
NODE_29364_length_566_cov_44.824411	15	94	12	2	79	0.0253165
NODE_29364_length_566_cov_44.824411	15	94	16	4	79	0.0506329
NODE_29364_length_566_cov_44.824411	15	94	18	5	79	0.0632911
NODE_29364_length_566_cov_44.824411	15	94	20	2	79	0.0253165
NODE_29364_length_566_cov_44.824411	15	94	22	1	79	0.0126582
NODE_29364_length_566_cov_44.824411	15	94	24	1	79	0.0126582
NODE_29364_length_566_cov_44.824411	15	94	25	1	79	0.0126582
NODE_29364_length_566_cov_44.824411	15	94	30	1	79	0.0126582
NODE_29364_length_566_cov_44.824411	15	94	32	2	79	0.0253165
NODE_29364_length_566_cov_44.824411	15	94	36	3	79	0.0379747
NODE_29364_length_566_cov_44.824411	15	94	38	6	79	0.0759494
NODE_29364_length_566_cov_44.824411	15	94	40	1	79	0.0126582
NODE_29364_length_566_cov_44.824411	15	94	42	10	79	0.1265823
NODE_29364_length_566_cov_44.824411	15	94	44	1	79	0.0126582
NODE_29364_length_566_cov_44.824411	15	94	46	39	79	0.4936709
NODE_29364_length_566_cov_44.824411	67	147	5	2	80	0.0250000
NODE_29364_length_566_cov_44.824411	67	147	7	3	80	0.0375000
NODE_29364_length_566_cov_44.824411	67	147	12	1	80	0.0125000
NODE_29364_length_566_cov_44.824411	67	147	14	3	80	0.0375000
NODE_29364_length_566_cov_44.824411	67	147	16	9	80	0.1125000
NODE_29364_length_566_cov_44.824411	67	147	20	1	80	0.0125000
NODE_29364_length_566_cov_44.824411	67	147	22	1	80	0.0125000
NODE_29364_length_566_cov_44.824411	67	147	24	1	80	0.0125000
NODE_29364_length_566_cov_44.824411	67	147	26	1	80	0.0125000
NODE_29364_length_566_cov_44.824411	67	147	28	2	80	0.0250000
NODE_29364_length_566_cov_44.824411	67	147	36	4	80	0.0500000
NODE_29364_length_566_cov_44.824411	67	147	38	1	80	0.0125000
NODE_29364_length_566_cov_44.824411	67	147	40	1	80	0.0125000
NODE_29364_length_566_cov_44.824411	67	147	42	8	80	0.1000000
NODE_29364_length_566_cov_44.824411	67	147	44	5	80	0.0625000
NODE_29364_length_566_cov_44.824411	67	147	46	37	80	0.4625000
NODE_29364_length_566_cov_44.824411	67	147	5	2	80	0.0250000
NODE_29364_length_566_cov_44.824411	67	147	7	3	80	0.0375000
NODE_29364_length_566_cov_44.824411	67	147	12	1	80	0.0125000
NODE_29364_length_566_cov_44.824411	67	147	14	3	80	0.0375000
NODE_29364_length_566_cov_44.824411	67	147	16	9	80	0.1125000
NODE_29364_length_566_cov_44.824411	67	147	20	1	80	0.0125000
NODE_29364_length_566_cov_44.824411	67	147	22	1	80	0.0125000
NODE_29364_length_566_cov_44.824411	67	147	24	1	80	0.0125000
NODE_29364_length_566_cov_44.824411	67	147	26	1	80	0.0125000
NODE_29364_length_566_cov_44.824411	67	147	28	2	80	0.0250000
NODE_29364_length_566_cov_44.824411	67	147	36	4	80	0.0500000
NODE_29364_length_566_cov_44.824411	67	147	38	1	80	0.0125000
NODE_29364_length_566_cov_44.824411	67	147	40	1	80	0.0125000
NODE_29364_length_566_cov_44.824411	67	147	42	8	80	0.1000000
NODE_29364_length_566_cov_44.824411	67	147	44	5	80	0.0625000
NODE_29364_length_566_cov_44.824411	67	147	46	37	80	0.4625000
NODE_29364_length_566_cov_44.824411	77	147	5	2	70	0.0285714
NODE_29364_length_566_cov_44.824411	77	147	7	3	70	0.0428571
NODE_29364_length_566_cov_44.824411	77	147	12	1	70	0.0142857
NODE_29364_length_566_cov_44.824411	77	147	14	3	70	0.0428571
NODE_29364_length_566_cov_44.824411	77	147	16	9	70	0.1285714
NODE_29364_length_566_cov_44.824411	77	147	20	1	70	0.0142857
NODE_29364_length_566_cov_44.824411	77	147	22	1	70	0.0142857
NODE_29364_length_566_cov_44.824411	77	147	24	1	70	0.0142857
NODE_29364_length_566_cov_44.824411	77	147	26	1	70	0.0142857
NODE_29364_length_566_cov_44.824411	77	147	28	2	70	0.0285714
NODE_29364_length_566_cov_44.824411	77	147	36	4	70	0.0571429
NODE_29364_length_566_cov_44.824411	77	147	38	1	70	0.0142857
NODE_29364_length_566_cov_44.824411	77	147	40	1	70	0.0142857
NODE_29364_length_566_cov_44.824411	77	147	42	8	70	0.1142857
NODE_29364_length_566_cov_44.824411	77	147	44	5	70	0.0714286
NODE_29364_length_566_cov_44.824411	77	147	46	27	70	0.3857143
NODE_29364_length_566_cov_44.824411	143	223	0	11	80	0.1375000
NODE_29364_length_566_cov_44.824411	143	223	2	22	80	0.2750000
NODE_29364_length_566_cov_44.824411	143	223	3	9	80	0.1125000
NODE_29364_length_566_cov_44.824411	143	223	4	8	80	0.1000000
NODE_29364_length_566_cov_44.824411	143	223	5	4	80	0.0500000
NODE_29364_length_566_cov_44.824411	143	223	6	19	80	0.2375000
NODE_29364_length_566_cov_44.824411	143	223	7	2	80	0.0250000
NODE_29364_length_566_cov_44.824411	143	223	8	5	80	0.0625000
NODE_29364_length_566_cov_44.824411	196	276	4	3	80	0.0375000
NODE_29364_length_566_cov_44.824411	196	276	6	23	80	0.2875000
NODE_29364_length_566_cov_44.824411	196	276	8	54	80	0.6750000
NODE_29367_length_566_cov_18.494647	344	424	2	33	80	0.4125000
NODE_29367_length_566_cov_18.494647	344	424	4	47	80	0.5875000
NODE_29367_length_566_cov_18.494647	397	477	0	15	80	0.1875000
NODE_29367_length_566_cov_18.494647	397	477	2	65	80	0.8125000
NODE_29368_length_566_cov_17.537473	324	404	0	42	80	0.5250000
NODE_29368_length_566_cov_17.537473	324	404	2	38	80	0.4750000
NODE_29368_length_566_cov_17.537473	377	457	0	80	80	1.0000000
NODE_29369_length_566_cov_13.019272	157	237	0	80	80	1.0000000
NODE_29369_length_566_cov_13.019272	210	290	0	80	80	1.0000000
NODE_29371_length_566_cov_9.513919	191	279	0	53	88	0.6022727
NODE_29371_length_566_cov_9.513919	191	279	2	35	88	0.3977273
NODE_29371_length_566_cov_9.513919	252	332	0	80	80	1.0000000
NODE_29397_length_566_cov_3.239829	292	334	0	42	42	1.0000000
NODE_29397_length_566_cov_3.239829	351	375	0	24	24	1.0000000
NODE_29437_length_566_cov_1.698073	432	481	0	13	49	0.2653061
NODE_29437_length_566_cov_1.698073	432	481	2	11	49	0.2244898
NODE_29437_length_566_cov_1.698073	432	481	4	25	49	0.5102041
NODE_29472_length_566_cov_0.957173	378	405	0	27	27	1.0000000
NODE_29503_length_565_cov_10.508584	202	280	0	78	78	1.0000000
NODE_29503_length_565_cov_10.508584	253	334	0	38	81	0.4691358
NODE_29503_length_565_cov_10.508584	253	334	2	43	81	0.5308642
NODE_29509_length_565_cov_7.560086	170	246	2	30	76	0.3947369
NODE_29509_length_565_cov_7.560086	170	246	4	46	76	0.6052632
NODE_29520_length_565_cov_4.045064	231	311	0	80	80	1.0000000
NODE_29520_length_565_cov_4.045064	284	364	0	80	80	1.0000000
NODE_29528_length_565_cov_3.399142	161	241	0	80	80	1.0000000
NODE_29528_length_565_cov_3.399142	214	294	0	80	80	1.0000000
NODE_29542_length_565_cov_2.542918	302	382	0	80	80	1.0000000
NODE_29542_length_565_cov_2.542918	355	435	0	80	80	1.0000000
NODE_29650_length_564_cov_46.901075	129	209	2	12	80	0.1500000
NODE_29650_length_564_cov_46.901075	129	209	6	14	80	0.1750000
NODE_29650_length_564_cov_46.901075	129	209	7	32	80	0.4000000
NODE_29650_length_564_cov_46.901075	129	209	8	22	80	0.2750000
NODE_29650_length_564_cov_46.901075	182	262	2	65	80	0.8125000
NODE_29650_length_564_cov_46.901075	182	262	6	14	80	0.1750000
NODE_29650_length_564_cov_46.901075	182	262	8	1	80	0.0125000
NODE_29651_length_564_cov_13.520430	300	380	0	80	80	1.0000000
NODE_29651_length_564_cov_13.520430	353	433	0	80	80	1.0000000
NODE_29653_length_564_cov_7.965591	291	332	2	41	41	1.0000000
NODE_29796_length_563_cov_24.487069	97	177	0	18	80	0.2250000
NODE_29796_length_563_cov_24.487069	97	177	2	62	80	0.7750000
NODE_29796_length_563_cov_24.487069	150	230	0	71	80	0.8875000
NODE_29796_length_563_cov_24.487069	150	230	2	9	80	0.1125000
NODE_29800_length_563_cov_6.758621	301	367	0	3	66	0.0454545
NODE_29800_length_563_cov_6.758621	301	367	2	10	66	0.1515152
NODE_29800_length_563_cov_6.758621	301	367	4	4	66	0.0606061
NODE_29800_length_563_cov_6.758621	301	367	6	49	66	0.7424242
NODE_29800_length_563_cov_6.758621	378	422	0	42	44	0.9545454
NODE_29800_length_563_cov_6.758621	378	422	2	2	44	0.0454545
NODE_29802_length_563_cov_5.762931	48	135	2	87	87	1.0000000
NODE_29802_length_563_cov_5.762931	108	188	0	48	80	0.6000000
NODE_29802_length_563_cov_5.762931	108	188	2	32	80	0.4000000
NODE_29808_length_563_cov_4.176724	197	277	0	80	80	1.0000000
NODE_29808_length_563_cov_4.176724	250	330	0	80	80	1.0000000
NODE_29809_length_563_cov_4.155172	273	315	2	42	42	1.0000000
NODE_29809_length_563_cov_4.155172	288	358	2	70	70	1.0000000
NODE_29925_length_562_cov_31.194384	47	127	0	80	80	1.0000000
NODE_29925_length_562_cov_31.194384	100	180	0	80	80	1.0000000
NODE_29926_length_562_cov_29.857451	33	113	0	80	80	1.0000000
NODE_29926_length_562_cov_29.857451	86	166	0	80	80	1.0000000
NODE_29927_length_562_cov_23.194384	245	325	4	3	80	0.0375000
NODE_29927_length_562_cov_23.194384	245	325	5	1	80	0.0125000
NODE_29927_length_562_cov_23.194384	245	325	7	1	80	0.0125000
NODE_29927_length_562_cov_23.194384	245	325	8	73	80	0.9125000
NODE_29927_length_562_cov_23.194384	245	325	9	2	80	0.0250000
NODE_29927_length_562_cov_23.194384	298	378	1	22	80	0.2750000
NODE_29927_length_562_cov_23.194384	298	378	5	32	80	0.4000000
NODE_29927_length_562_cov_23.194384	298	378	7	1	80	0.0125000
NODE_29927_length_562_cov_23.194384	298	378	8	25	80	0.3125000
NODE_29930_length_562_cov_10.304536	271	321	3	1	50	0.0200000
NODE_29930_length_562_cov_10.304536	271	321	4	17	50	0.3400000
NODE_29930_length_562_cov_10.304536	271	321	5	4	50	0.0800000
NODE_29930_length_562_cov_10.304536	271	321	6	5	50	0.1000000
NODE_29930_length_562_cov_10.304536	271	321	8	21	50	0.4200000
NODE_29930_length_562_cov_10.304536	271	321	10	2	50	0.0400000
NODE_29931_length_562_cov_9.131749	265	346	0	81	81	1.0000000
NODE_29931_length_562_cov_9.131749	319	399	0	80	80	1.0000000
NODE_29960_length_562_cov_2.961123	350	398	0	48	48	1.0000000
NODE_30083_length_561_cov_18.049784	54	134	0	26	80	0.3250000
NODE_30083_length_561_cov_18.049784	54	134	2	54	80	0.6750000
NODE_30083_length_561_cov_18.049784	107	187	0	9	80	0.1125000
NODE_30083_length_561_cov_18.049784	107	187	2	71	80	0.8875000
NODE_30087_length_561_cov_5.348485	208	274	0	66	66	1.0000000
NODE_30105_length_561_cov_2.787879	216	285	0	69	69	1.0000000
NODE_30120_length_561_cov_2.233766	339	419	0	80	80	1.0000000
NODE_30120_length_561_cov_2.233766	391	445	0	54	54	1.0000000
NODE_30120_length_561_cov_2.233766	392	438	0	46	46	1.0000000
NODE_30133_length_561_cov_1.803030	258	334	0	61	76	0.8026316
NODE_30133_length_561_cov_1.803030	258	334	2	15	76	0.1973684
NODE_30224_length_560_cov_41.433839	67	147	0	66	80	0.8250000
NODE_30224_length_560_cov_41.433839	67	147	2	14	80	0.1750000
NODE_30224_length_560_cov_41.433839	120	200	0	13	80	0.1625000
NODE_30224_length_560_cov_41.433839	120	200	2	67	80	0.8375000
NODE_30225_length_560_cov_35.993492	366	446	0	80	80	1.0000000
NODE_30225_length_560_cov_35.993492	419	499	0	80	80	1.0000000
NODE_30226_length_560_cov_20.433839	342	422	0	80	80	1.0000000
NODE_30226_length_560_cov_20.433839	395	475	0	80	80	1.0000000
NODE_30227_length_560_cov_13.850325	274	327	0	53	53	1.0000000
NODE_30228_length_560_cov_12.075922	233	314	2	12	81	0.1481481
NODE_30228_length_560_cov_12.075922	233	314	4	69	81	0.8518519
NODE_30229_length_560_cov_8.594360	263	343	0	80	80	1.0000000
NODE_30229_length_560_cov_8.594360	316	396	0	80	80	1.0000000
NODE_30237_length_560_cov_5.227766	264	328	2	8	64	0.1250000
NODE_30237_length_560_cov_5.227766	264	328	6	3	64	0.0468750
NODE_30237_length_560_cov_5.227766	264	328	8	11	64	0.1718750
NODE_30237_length_560_cov_5.227766	264	328	10	1	64	0.0156250
NODE_30237_length_560_cov_5.227766	264	328	12	1	64	0.0156250
NODE_30237_length_560_cov_5.227766	264	328	14	37	64	0.5781250
NODE_30237_length_560_cov_5.227766	264	328	16	3	64	0.0468750
NODE_30238_length_560_cov_5.056399	299	379	0	80	80	1.0000000
NODE_30238_length_560_cov_5.056399	352	432	0	80	80	1.0000000
NODE_30244_length_560_cov_4.518438	156	236	0	80	80	1.0000000
NODE_30281_length_560_cov_2.154013	204	275	0	71	71	1.0000000
NODE_30281_length_560_cov_2.154013	255	335	0	80	80	1.0000000
NODE_30288_length_560_cov_2.017354	52	114	0	62	62	1.0000000
NODE_30363_length_559_cov_37.526087	289	370	2	81	81	1.0000000
NODE_30363_length_559_cov_37.526087	343	423	0	3	80	0.0375000
NODE_30363_length_559_cov_37.526087	343	423	2	77	80	0.9625000
NODE_30363_length_559_cov_37.526087	419	500	0	80	81	0.9876543
NODE_30363_length_559_cov_37.526087	419	500	2	1	81	0.0123457
NODE_30363_length_559_cov_37.526087	473	553	0	80	80	1.0000000
NODE_30365_length_559_cov_19.126087	388	468	0	6	80	0.0750000
NODE_30365_length_559_cov_19.126087	388	468	2	74	80	0.9250000
NODE_30365_length_559_cov_19.126087	441	521	0	39	80	0.4875000
NODE_30365_length_559_cov_19.126087	441	521	2	41	80	0.5125000
NODE_30366_length_559_cov_12.489130	262	341	0	79	79	1.0000000
NODE_30366_length_559_cov_12.489130	316	394	0	78	78	1.0000000
NODE_30370_length_559_cov_6.530435	283	363	0	80	80	1.0000000
NODE_30377_length_559_cov_4.930435	112	192	0	80	80	1.0000000
NODE_30377_length_559_cov_4.930435	165	244	0	79	79	1.0000000
NODE_30419_length_559_cov_1.776087	395	433	58	4	38	0.1052632
NODE_30419_length_559_cov_1.776087	395	433	60	6	38	0.1578947
NODE_30419_length_559_cov_1.776087	395	433	62	16	38	0.4210526
NODE_30419_length_559_cov_1.776087	395	433	64	12	38	0.3157895
NODE_30480_length_558_cov_13.102397	297	364	0	30	67	0.4477612
NODE_30480_length_558_cov_13.102397	297	364	4	13	67	0.1940299
NODE_30480_length_558_cov_13.102397	297	364	6	3	67	0.0447761
NODE_30480_length_558_cov_13.102397	297	364	7	13	67	0.1940299
NODE_30480_length_558_cov_13.102397	297	364	8	8	67	0.1194030
NODE_30482_length_558_cov_9.309368	369	449	0	80	80	1.0000000
NODE_30482_length_558_cov_9.309368	422	502	0	80	80	1.0000000
NODE_30489_length_558_cov_5.921569	304	361	0	57	57	1.0000000
NODE_30493_length_558_cov_4.801743	197	266	0	69	69	1.0000000
NODE_30493_length_558_cov_4.801743	197	277	0	80	80	1.0000000
NODE_30493_length_558_cov_4.801743	250	330	0	56	80	0.7000000
NODE_30493_length_558_cov_4.801743	250	330	2	24	80	0.3000000
NODE_30493_length_558_cov_4.801743	250	330	0	56	80	0.7000000
NODE_30493_length_558_cov_4.801743	250	330	2	24	80	0.3000000
NODE_30495_length_558_cov_4.570806	188	244	4	14	56	0.2500000
NODE_30495_length_558_cov_4.570806	188	244	5	2	56	0.0357143
NODE_30495_length_558_cov_4.570806	188	244	6	8	56	0.1428571
NODE_30495_length_558_cov_4.570806	188	244	7	32	56	0.5714286
NODE_30536_length_558_cov_2.259259	236	294	0	58	58	1.0000000
NODE_30536_length_558_cov_2.259259	267	347	0	80	80	1.0000000
NODE_30568_length_558_cov_1.544662	403	483	0	80	80	1.0000000
NODE_30568_length_558_cov_1.544662	456	536	0	80	80	1.0000000
NODE_30623_length_557_cov_9.141921	255	335	0	80	80	1.0000000
NODE_30623_length_557_cov_9.141921	308	388	0	80	80	1.0000000
NODE_30626_length_557_cov_7.316594	210	290	6	25	80	0.3125000
NODE_30626_length_557_cov_7.316594	210	290	8	55	80	0.6875000
NODE_30626_length_557_cov_7.316594	263	341	2	30	78	0.3846154
NODE_30626_length_557_cov_7.316594	263	341	6	22	78	0.2820513
NODE_30626_length_557_cov_7.316594	263	341	8	26	78	0.3333333
NODE_30636_length_557_cov_4.259825	185	267	0	3	82	0.0365854
NODE_30636_length_557_cov_4.259825	185	267	2	13	82	0.1585366
NODE_30636_length_557_cov_4.259825	185	267	4	6	82	0.0731707
NODE_30636_length_557_cov_4.259825	185	267	6	60	82	0.7317073
NODE_30646_length_557_cov_3.794760	131	188	0	57	57	1.0000000
NODE_30646_length_557_cov_3.794760	139	219	0	80	80	1.0000000
NODE_30650_length_557_cov_3.517467	246	325	0	79	79	1.0000000
NODE_30650_length_557_cov_3.517467	298	378	0	80	80	1.0000000
NODE_30652_length_557_cov_3.390830	366	395	15	1	29	0.0344828
NODE_30652_length_557_cov_3.390830	366	395	18	1	29	0.0344828
NODE_30652_length_557_cov_3.390830	366	395	20	6	29	0.2068966
NODE_30652_length_557_cov_3.390830	366	395	24	4	29	0.1379310
NODE_30652_length_557_cov_3.390830	366	395	26	6	29	0.2068966
NODE_30652_length_557_cov_3.390830	366	395	31	11	29	0.3793103
NODE_30792_length_556_cov_37.258206	122	202	0	21	80	0.2625000
NODE_30792_length_556_cov_37.258206	122	202	2	59	80	0.7375000
NODE_30792_length_556_cov_37.258206	175	255	0	17	80	0.2125000
NODE_30792_length_556_cov_37.258206	175	255	2	63	80	0.7875000
NODE_30793_length_556_cov_15.266958	360	440	0	80	80	1.0000000
NODE_30793_length_556_cov_15.266958	413	493	0	80	80	1.0000000
NODE_30794_length_556_cov_12.781182	341	421	4	40	80	0.5000000
NODE_30794_length_556_cov_12.781182	341	421	6	40	80	0.5000000
NODE_30794_length_556_cov_12.781182	394	474	0	15	80	0.1875000
NODE_30794_length_556_cov_12.781182	394	474	2	20	80	0.2500000
NODE_30794_length_556_cov_12.781182	394	474	6	45	80	0.5625000
NODE_30795_length_556_cov_11.131291	304	384	0	80	80	1.0000000
NODE_30795_length_556_cov_11.131291	357	437	0	80	80	1.0000000
NODE_30797_length_556_cov_7.168490	163	243	0	80	80	1.0000000
NODE_30797_length_556_cov_7.168490	216	296	0	80	80	1.0000000
NODE_30798_length_556_cov_7.089716	325	379	0	54	54	1.0000000
NODE_30801_length_556_cov_6.505470	232	312	0	80	80	1.0000000
NODE_30801_length_556_cov_6.505470	285	365	0	80	80	1.0000000
NODE_30802_length_556_cov_6.496718	140	179	0	39	39	1.0000000
NODE_30802_length_556_cov_6.496718	226	255	0	6	29	0.2068966
NODE_30802_length_556_cov_6.496718	226	255	2	23	29	0.7931035
NODE_30809_length_556_cov_4.457330	197	277	8	41	80	0.5125000
NODE_30809_length_556_cov_4.457330	197	277	9	13	80	0.1625000
NODE_30809_length_556_cov_4.457330	197	277	10	20	80	0.2500000
NODE_30809_length_556_cov_4.457330	197	277	12	6	80	0.0750000
NODE_30818_length_556_cov_3.761488	234	307	0	73	73	1.0000000
NODE_30930_length_555_cov_20.949561	322	402	0	80	80	1.0000000
NODE_30930_length_555_cov_20.949561	375	455	0	80	80	1.0000000
NODE_30931_length_555_cov_16.822368	268	348	0	16	80	0.2000000
NODE_30931_length_555_cov_16.822368	268	348	2	21	80	0.2625000
NODE_30931_length_555_cov_16.822368	268	348	4	43	80	0.5375000
NODE_30931_length_555_cov_16.822368	321	401	0	3	80	0.0375000
NODE_30931_length_555_cov_16.822368	321	401	2	21	80	0.2625000
NODE_30931_length_555_cov_16.822368	321	401	4	56	80	0.7000000
NODE_30933_length_555_cov_9.912281	313	393	0	80	80	1.0000000
NODE_30935_length_555_cov_8.057018	277	357	0	43	80	0.5375000
NODE_30935_length_555_cov_8.057018	277	357	2	37	80	0.4625000
NODE_30935_length_555_cov_8.057018	330	410	0	48	80	0.6000000
NODE_30935_length_555_cov_8.057018	330	410	2	32	80	0.4000000
NODE_30938_length_555_cov_6.778509	62	92	0	30	30	1.0000000
NODE_30986_length_555_cov_2.177632	208	288	0	68	80	0.8500000
NODE_30986_length_555_cov_2.177632	208	288	1	12	80	0.1500000
NODE_30986_length_555_cov_2.177632	261	329	0	68	68	1.0000000
NODE_31092_length_554_cov_11.942857	118	198	0	80	80	1.0000000
NODE_31092_length_554_cov_11.942857	171	251	0	80	80	1.0000000
NODE_31096_length_554_cov_8.426374	242	322	0	80	80	1.0000000
NODE_31096_length_554_cov_8.426374	295	375	0	80	80	1.0000000
NODE_31101_length_554_cov_6.116484	264	344	0	40	80	0.5000000
NODE_31101_length_554_cov_6.116484	264	344	4	18	80	0.2250000
NODE_31101_length_554_cov_6.116484	264	344	8	22	80	0.2750000
NODE_31101_length_554_cov_6.116484	317	393	4	11	76	0.1447368
NODE_31101_length_554_cov_6.116484	317	393	8	65	76	0.8552632
NODE_31115_length_554_cov_3.586813	207	286	0	79	79	1.0000000
NODE_31240_length_553_cov_42.017621	197	277	0	80	80	1.0000000
NODE_31240_length_553_cov_42.017621	250	330	0	35	80	0.4375000
NODE_31240_length_553_cov_42.017621	250	330	2	31	80	0.3875000
NODE_31240_length_553_cov_42.017621	250	330	4	1	80	0.0125000
NODE_31240_length_553_cov_42.017621	250	330	6	13	80	0.1625000
NODE_31241_length_553_cov_28.944934	333	413	0	80	80	1.0000000
NODE_31241_length_553_cov_28.944934	386	466	0	80	80	1.0000000
NODE_31242_length_553_cov_12.176211	242	322	0	80	80	1.0000000
NODE_31242_length_553_cov_12.176211	295	375	0	80	80	1.0000000
NODE_31244_length_553_cov_9.876652	232	312	0	80	80	1.0000000
NODE_31244_length_553_cov_9.876652	285	365	0	80	80	1.0000000
NODE_31246_length_553_cov_9.306167	207	287	0	11	80	0.1375000
NODE_31246_length_553_cov_9.306167	207	287	2	69	80	0.8625000
NODE_31246_length_553_cov_9.306167	207	287	0	11	80	0.1375000
NODE_31246_length_553_cov_9.306167	207	287	2	69	80	0.8625000
NODE_31246_length_553_cov_9.306167	260	340	0	46	80	0.5750000
NODE_31246_length_553_cov_9.306167	260	340	2	34	80	0.4250000
NODE_31259_length_553_cov_3.729075	36	93	0	4	57	0.0701754
NODE_31259_length_553_cov_3.729075	36	93	2	53	57	0.9298246
NODE_31259_length_553_cov_3.729075	89	146	0	23	57	0.4035088
NODE_31259_length_553_cov_3.729075	89	146	2	34	57	0.5964912
NODE_31266_length_553_cov_3.310573	226	293	0	67	67	1.0000000
NODE_31279_length_553_cov_2.678414	102	180	0	78	78	1.0000000
NODE_31279_length_553_cov_2.678414	248	275	0	27	27	1.0000000
NODE_31295_length_553_cov_1.958150	416	462	0	3	46	0.0652174
NODE_31295_length_553_cov_1.958150	416	462	2	3	46	0.0652174
NODE_31295_length_553_cov_1.958150	416	462	4	11	46	0.2391304
NODE_31295_length_553_cov_1.958150	416	462	6	3	46	0.0652174
NODE_31295_length_553_cov_1.958150	416	462	8	26	46	0.5652174
NODE_31295_length_553_cov_1.958150	469	515	6	6	46	0.1304348
NODE_31295_length_553_cov_1.958150	469	515	8	40	46	0.8695652
NODE_31377_length_552_cov_92.070640	298	378	0	38	80	0.4750000
NODE_31377_length_552_cov_92.070640	298	378	4	3	80	0.0375000
NODE_31377_length_552_cov_92.070640	298	378	6	6	80	0.0750000
NODE_31377_length_552_cov_92.070640	298	378	8	25	80	0.3125000
NODE_31377_length_552_cov_92.070640	298	378	10	4	80	0.0500000
NODE_31377_length_552_cov_92.070640	298	378	14	4	80	0.0500000
NODE_31377_length_552_cov_92.070640	298	378	0	38	80	0.4750000
NODE_31377_length_552_cov_92.070640	298	378	4	3	80	0.0375000
NODE_31377_length_552_cov_92.070640	298	378	6	6	80	0.0750000
NODE_31377_length_552_cov_92.070640	298	378	8	25	80	0.3125000
NODE_31377_length_552_cov_92.070640	298	378	10	4	80	0.0500000
NODE_31377_length_552_cov_92.070640	298	378	14	4	80	0.0500000
NODE_31377_length_552_cov_92.070640	374	454	14	19	80	0.2375000
NODE_31377_length_552_cov_92.070640	374	454	16	3	80	0.0375000
NODE_31377_length_552_cov_92.070640	374	454	18	4	80	0.0500000
NODE_31377_length_552_cov_92.070640	374	454	20	10	80	0.1250000
NODE_31377_length_552_cov_92.070640	374	454	22	9	80	0.1125000
NODE_31377_length_552_cov_92.070640	374	454	24	5	80	0.0625000
NODE_31377_length_552_cov_92.070640	374	454	26	30	80	0.3750000
NODE_31377_length_552_cov_92.070640	374	454	14	19	80	0.2375000
NODE_31377_length_552_cov_92.070640	374	454	16	3	80	0.0375000
NODE_31377_length_552_cov_92.070640	374	454	18	4	80	0.0500000
NODE_31377_length_552_cov_92.070640	374	454	20	10	80	0.1250000
NODE_31377_length_552_cov_92.070640	374	454	22	9	80	0.1125000
NODE_31377_length_552_cov_92.070640	374	454	24	5	80	0.0625000
NODE_31377_length_552_cov_92.070640	374	454	26	30	80	0.3750000
NODE_31377_length_552_cov_92.070640	374	454	14	19	80	0.2375000
NODE_31377_length_552_cov_92.070640	374	454	16	3	80	0.0375000
NODE_31377_length_552_cov_92.070640	374	454	18	4	80	0.0500000
NODE_31377_length_552_cov_92.070640	374	454	20	10	80	0.1250000
NODE_31377_length_552_cov_92.070640	374	454	22	9	80	0.1125000
NODE_31377_length_552_cov_92.070640	374	454	24	5	80	0.0625000
NODE_31377_length_552_cov_92.070640	374	454	26	30	80	0.3750000
NODE_31377_length_552_cov_92.070640	374	454	14	19	80	0.2375000
NODE_31377_length_552_cov_92.070640	374	454	16	3	80	0.0375000
NODE_31377_length_552_cov_92.070640	374	454	18	4	80	0.0500000
NODE_31377_length_552_cov_92.070640	374	454	20	10	80	0.1250000
NODE_31377_length_552_cov_92.070640	374	454	22	9	80	0.1125000
NODE_31377_length_552_cov_92.070640	374	454	24	5	80	0.0625000
NODE_31377_length_552_cov_92.070640	374	454	26	30	80	0.3750000
NODE_31377_length_552_cov_92.070640	374	450	14	19	76	0.2500000
NODE_31377_length_552_cov_92.070640	374	450	16	3	76	0.0394737
NODE_31377_length_552_cov_92.070640	374	450	20	10	76	0.1315790
NODE_31377_length_552_cov_92.070640	374	450	22	9	76	0.1184211
NODE_31377_length_552_cov_92.070640	374	450	24	5	76	0.0657895
NODE_31377_length_552_cov_92.070640	374	450	26	30	76	0.3947369
NODE_31377_length_552_cov_92.070640	427	507	12	18	80	0.2250000
NODE_31377_length_552_cov_92.070640	427	507	14	2	80	0.0250000
NODE_31377_length_552_cov_92.070640	427	507	16	30	80	0.3750000
NODE_31377_length_552_cov_92.070640	427	507	18	7	80	0.0875000
NODE_31377_length_552_cov_92.070640	427	507	20	10	80	0.1250000
NODE_31377_length_552_cov_92.070640	427	507	22	9	80	0.1125000
NODE_31377_length_552_cov_92.070640	427	507	26	4	80	0.0500000
NODE_31377_length_552_cov_92.070640	427	507	12	18	80	0.2250000
NODE_31377_length_552_cov_92.070640	427	507	14	2	80	0.0250000
NODE_31377_length_552_cov_92.070640	427	507	16	30	80	0.3750000
NODE_31377_length_552_cov_92.070640	427	507	18	7	80	0.0875000
NODE_31377_length_552_cov_92.070640	427	507	20	10	80	0.1250000
NODE_31377_length_552_cov_92.070640	427	507	22	9	80	0.1125000
NODE_31377_length_552_cov_92.070640	427	507	26	4	80	0.0500000
NODE_31377_length_552_cov_92.070640	427	498	12	9	71	0.1267606
NODE_31377_length_552_cov_92.070640	427	498	14	2	71	0.0281690
NODE_31377_length_552_cov_92.070640	427	498	16	30	71	0.4225352
NODE_31377_length_552_cov_92.070640	427	498	18	7	71	0.0985916
NODE_31377_length_552_cov_92.070640	427	498	20	10	71	0.1408451
NODE_31377_length_552_cov_92.070640	427	498	22	9	71	0.1267606
NODE_31377_length_552_cov_92.070640	427	498	26	4	71	0.0563380
NODE_31377_length_552_cov_92.070640	430	500	12	11	70	0.1571429
NODE_31377_length_552_cov_92.070640	430	500	14	2	70	0.0285714
NODE_31377_length_552_cov_92.070640	430	500	16	30	70	0.4285714
NODE_31377_length_552_cov_92.070640	430	500	18	7	70	0.1000000
NODE_31377_length_552_cov_92.070640	430	500	20	10	70	0.1428571
NODE_31377_length_552_cov_92.070640	430	500	22	9	70	0.1285714
NODE_31377_length_552_cov_92.070640	430	500	26	1	70	0.0142857
NODE_31377_length_552_cov_92.070640	432	507	12	18	75	0.2400000
NODE_31377_length_552_cov_92.070640	432	507	14	2	75	0.0266667
NODE_31377_length_552_cov_92.070640	432	507	16	30	75	0.4000000
NODE_31377_length_552_cov_92.070640	432	507	18	7	75	0.0933333
NODE_31377_length_552_cov_92.070640	432	507	20	10	75	0.1333333
NODE_31377_length_552_cov_92.070640	432	507	22	8	75	0.1066667
NODE_31378_length_552_cov_20.432671	151	231	2	51	80	0.6375000
NODE_31378_length_552_cov_20.432671	151	231	4	29	80	0.3625000
NODE_31378_length_552_cov_20.432671	204	284	2	70	80	0.8750000
NODE_31378_length_552_cov_20.432671	204	284	4	10	80	0.1250000
NODE_31379_length_552_cov_18.075055	257	333	0	76	76	1.0000000
NODE_31380_length_552_cov_13.331126	214	294	0	46	80	0.5750000
NODE_31380_length_552_cov_13.331126	214	294	2	17	80	0.2125000
NODE_31380_length_552_cov_13.331126	214	294	4	4	80	0.0500000
NODE_31380_length_552_cov_13.331126	214	294	6	13	80	0.1625000
NODE_31380_length_552_cov_13.331126	267	347	0	80	80	1.0000000
NODE_31381_length_552_cov_12.774834	360	440	0	39	80	0.4875000
NODE_31381_length_552_cov_12.774834	360	440	2	41	80	0.5125000
NODE_31381_length_552_cov_12.774834	413	493	0	42	80	0.5250000
NODE_31381_length_552_cov_12.774834	413	493	2	38	80	0.4750000
NODE_31384_length_552_cov_8.883002	310	390	0	1	80	0.0125000
NODE_31384_length_552_cov_8.883002	310	390	2	79	80	0.9875000
NODE_31384_length_552_cov_8.883002	363	443	0	54	80	0.6750000
NODE_31384_length_552_cov_8.883002	363	443	2	26	80	0.3250000
NODE_31385_length_552_cov_6.916115	206	281	0	7	75	0.0933333
NODE_31385_length_552_cov_6.916115	206	281	1	1	75	0.0133333
NODE_31385_length_552_cov_6.916115	206	281	2	67	75	0.8933333
NODE_31538_length_551_cov_34.070796	324	406	0	82	82	1.0000000
NODE_31538_length_551_cov_34.070796	379	444	0	65	65	1.0000000
NODE_31541_length_551_cov_10.252212	164	244	0	80	80	1.0000000
NODE_31541_length_551_cov_10.252212	217	297	0	32	80	0.4000000
NODE_31541_length_551_cov_10.252212	217	297	2	48	80	0.6000000
NODE_31543_length_551_cov_8.075221	363	406	0	1	43	0.0232558
NODE_31543_length_551_cov_8.075221	363	406	2	42	43	0.9767442
NODE_31547_length_551_cov_5.668142	213	293	0	80	80	1.0000000
NODE_31547_length_551_cov_5.668142	266	346	0	80	80	1.0000000
NODE_31552_length_551_cov_4.212389	171	242	6	18	71	0.2535211
NODE_31552_length_551_cov_4.212389	171	242	8	32	71	0.4507042
NODE_31552_length_551_cov_4.212389	171	242	10	21	71	0.2957746
NODE_31552_length_551_cov_4.212389	215	263	6	37	48	0.7708333
NODE_31552_length_551_cov_4.212389	215	263	8	11	48	0.2291667
NODE_31563_length_551_cov_3.307522	227	307	0	80	80	1.0000000
NODE_31563_length_551_cov_3.307522	280	360	0	80	80	1.0000000
NODE_31693_length_550_cov_17.308204	101	181	0	56	80	0.7000000
NODE_31693_length_550_cov_17.308204	101	181	2	24	80	0.3000000
NODE_31693_length_550_cov_17.308204	154	234	0	3	80	0.0375000
NODE_31693_length_550_cov_17.308204	154	234	2	77	80	0.9625000
NODE_31700_length_550_cov_5.580931	286	329	0	43	43	1.0000000
NODE_31701_length_550_cov_5.490022	458	500	0	42	42	1.0000000
NODE_31701_length_550_cov_5.490022	459	523	0	64	64	1.0000000
NODE_31703_length_550_cov_5.243902	194	274	0	80	80	1.0000000
NODE_31703_length_550_cov_5.243902	247	327	0	80	80	1.0000000
NODE_31706_length_550_cov_4.815965	184	264	0	80	80	1.0000000
NODE_31726_length_550_cov_3.252772	308	388	2	30	80	0.3750000
NODE_31726_length_550_cov_3.252772	308	388	6	50	80	0.6250000
NODE_31756_length_550_cov_1.864745	189	259	2	70	70	1.0000000
NODE_31756_length_550_cov_1.864745	189	258	2	69	69	1.0000000
NODE_31847_length_549_cov_31.826667	216	292	18	10	76	0.1315790
NODE_31847_length_549_cov_31.826667	216	292	20	9	76	0.1184211
NODE_31847_length_549_cov_31.826667	216	292	22	8	76	0.1052632
NODE_31847_length_549_cov_31.826667	216	292	24	17	76	0.2236842
NODE_31847_length_549_cov_31.826667	216	292	26	8	76	0.1052632
NODE_31847_length_549_cov_31.826667	216	292	28	18	76	0.2368421
NODE_31847_length_549_cov_31.826667	216	292	30	6	76	0.0789474
NODE_31847_length_549_cov_31.826667	267	331	10	3	64	0.0468750
NODE_31847_length_549_cov_31.826667	267	331	12	3	64	0.0468750
NODE_31847_length_549_cov_31.826667	267	331	14	4	64	0.0625000
NODE_31847_length_549_cov_31.826667	267	331	16	3	64	0.0468750
NODE_31847_length_549_cov_31.826667	267	331	18	1	64	0.0156250
NODE_31847_length_549_cov_31.826667	267	331	20	3	64	0.0468750
NODE_31847_length_549_cov_31.826667	267	331	22	2	64	0.0312500
NODE_31847_length_549_cov_31.826667	267	331	24	32	64	0.5000000
NODE_31847_length_549_cov_31.826667	267	331	26	4	64	0.0625000
NODE_31847_length_549_cov_31.826667	267	331	28	7	64	0.1093750
NODE_31847_length_549_cov_31.826667	267	331	30	2	64	0.0312500
NODE_31848_length_549_cov_14.124444	174	263	0	32	89	0.3595506
NODE_31848_length_549_cov_14.124444	174	263	1	57	89	0.6404495
NODE_31848_length_549_cov_14.124444	242	315	1	22	73	0.3013699
NODE_31848_length_549_cov_14.124444	242	315	3	34	73	0.4657534
NODE_31848_length_549_cov_14.124444	242	315	4	17	73	0.2328767
NODE_31857_length_549_cov_5.375556	181	257	56	1	76	0.0131579
NODE_31857_length_549_cov_5.375556	181	257	58	4	76	0.0526316
NODE_31857_length_549_cov_5.375556	181	257	62	2	76	0.0263158
NODE_31857_length_549_cov_5.375556	181	257	64	2	76	0.0263158
NODE_31857_length_549_cov_5.375556	181	257	68	1	76	0.0131579
NODE_31857_length_549_cov_5.375556	181	257	70	1	76	0.0131579
NODE_31857_length_549_cov_5.375556	181	257	79	1	76	0.0131579
NODE_31857_length_549_cov_5.375556	181	257	81	1	76	0.0131579
NODE_31857_length_549_cov_5.375556	181	257	83	2	76	0.0263158
NODE_31857_length_549_cov_5.375556	181	257	86	4	76	0.0526316
NODE_31857_length_549_cov_5.375556	181	257	87	1	76	0.0131579
NODE_31857_length_549_cov_5.375556	181	257	88	2	76	0.0263158
NODE_31857_length_549_cov_5.375556	181	257	92	7	76	0.0921053
NODE_31857_length_549_cov_5.375556	181	257	94	1	76	0.0131579
NODE_31857_length_549_cov_5.375556	181	257	96	4	76	0.0526316
NODE_31857_length_549_cov_5.375556	181	257	98	3	76	0.0394737
NODE_31857_length_549_cov_5.375556	181	257	102	1	76	0.0131579
NODE_31857_length_549_cov_5.375556	181	257	104	6	76	0.0789474
NODE_31857_length_549_cov_5.375556	181	257	108	2	76	0.0263158
NODE_31857_length_549_cov_5.375556	181	257	112	1	76	0.0131579
NODE_31857_length_549_cov_5.375556	181	257	114	2	76	0.0263158
NODE_31857_length_549_cov_5.375556	181	257	115	5	76	0.0657895
NODE_31857_length_549_cov_5.375556	181	257	117	1	76	0.0131579
NODE_31857_length_549_cov_5.375556	181	257	118	2	76	0.0263158
NODE_31857_length_549_cov_5.375556	181	257	119	1	76	0.0131579
NODE_31857_length_549_cov_5.375556	181	257	120	6	76	0.0789474
NODE_31857_length_549_cov_5.375556	181	257	122	2	76	0.0263158
NODE_31857_length_549_cov_5.375556	181	257	123	1	76	0.0131579
NODE_31857_length_549_cov_5.375556	181	257	124	3	76	0.0394737
NODE_31857_length_549_cov_5.375556	181	257	126	6	76	0.0789474
NODE_31859_length_549_cov_4.933333	260	340	0	80	80	1.0000000
NODE_31864_length_549_cov_4.537778	345	430	0	85	85	1.0000000
NODE_31864_length_549_cov_4.537778	403	483	0	80	80	1.0000000
NODE_31865_length_549_cov_4.124444	406	486	3	8	80	0.1000000
NODE_31865_length_549_cov_4.124444	406	486	4	7	80	0.0875000
NODE_31865_length_549_cov_4.124444	406	486	5	19	80	0.2375000
NODE_31865_length_549_cov_4.124444	406	486	6	46	80	0.5750000
NODE_31866_length_549_cov_3.931111	182	219	0	37	37	1.0000000
NODE_31868_length_549_cov_3.893333	287	367	0	63	80	0.7875000
NODE_31868_length_549_cov_3.893333	287	367	4	17	80	0.2125000
NODE_31868_length_549_cov_3.893333	340	420	0	10	80	0.1250000
NODE_31868_length_549_cov_3.893333	340	420	4	70	80	0.8750000
NODE_31887_length_549_cov_2.673333	282	343	0	8	61	0.1311475
NODE_31887_length_549_cov_2.673333	282	343	4	12	61	0.1967213
NODE_31887_length_549_cov_2.673333	282	343	6	41	61	0.6721311
NODE_31890_length_549_cov_2.622222	144	220	0	3	76	0.0394737
NODE_31890_length_549_cov_2.622222	144	220	2	73	76	0.9605263
NODE_32013_length_548_cov_13.962138	285	371	0	12	86	0.1395349
NODE_32013_length_548_cov_13.962138	285	371	2	74	86	0.8604651
NODE_32013_length_548_cov_13.962138	344	424	0	65	80	0.8125000
NODE_32013_length_548_cov_13.962138	344	424	2	15	80	0.1875000
NODE_32022_length_548_cov_4.683742	261	336	0	35	75	0.4666667
NODE_32022_length_548_cov_4.683742	261	336	2	40	75	0.5333334
NODE_32023_length_548_cov_4.670379	140	182	0	42	42	1.0000000
NODE_32023_length_548_cov_4.670379	282	311	0	29	29	1.0000000
NODE_32023_length_548_cov_4.670379	410	455	6	23	45	0.5111111
NODE_32023_length_548_cov_4.670379	410	455	8	15	45	0.3333333
NODE_32023_length_548_cov_4.670379	410	455	10	7	45	0.1555556
NODE_32029_length_548_cov_3.630290	111	177	0	6	66	0.0909091
NODE_32029_length_548_cov_3.630290	111	177	2	29	66	0.4393939
NODE_32029_length_548_cov_3.630290	111	177	6	31	66	0.4696970
NODE_32039_length_548_cov_3.080178	142	191	0	49	49	1.0000000
NODE_32180_length_547_cov_23.982143	243	323	2	10	80	0.1250000
NODE_32180_length_547_cov_23.982143	243	323	4	9	80	0.1125000
NODE_32180_length_547_cov_23.982143	243	323	6	61	80	0.7625000
NODE_32180_length_547_cov_23.982143	243	323	2	10	80	0.1250000
NODE_32180_length_547_cov_23.982143	243	323	4	9	80	0.1125000
NODE_32180_length_547_cov_23.982143	243	323	6	61	80	0.7625000
NODE_32180_length_547_cov_23.982143	252	323	2	1	71	0.0140845
NODE_32180_length_547_cov_23.982143	252	323	4	9	71	0.1267606
NODE_32180_length_547_cov_23.982143	252	323	6	61	71	0.8591549
NODE_32181_length_547_cov_23.555804	42	122	0	80	80	1.0000000
NODE_32181_length_547_cov_23.555804	95	175	0	80	80	1.0000000
NODE_32183_length_547_cov_12.819196	190	270	0	6	80	0.0750000
NODE_32183_length_547_cov_12.819196	190	270	2	74	80	0.9250000
NODE_32195_length_547_cov_5.207589	290	370	0	27	80	0.3375000
NODE_32195_length_547_cov_5.207589	290	370	2	51	80	0.6375000
NODE_32195_length_547_cov_5.207589	290	370	4	2	80	0.0250000
NODE_32195_length_547_cov_5.207589	343	423	0	22	80	0.2750000
NODE_32195_length_547_cov_5.207589	343	423	2	3	80	0.0375000
NODE_32195_length_547_cov_5.207589	343	423	4	4	80	0.0500000
NODE_32195_length_547_cov_5.207589	343	423	6	39	80	0.4875000
NODE_32195_length_547_cov_5.207589	343	423	10	12	80	0.1500000
NODE_32197_length_547_cov_4.975446	411	488	0	77	77	1.0000000
NODE_32197_length_547_cov_4.975446	461	542	0	81	81	1.0000000
NODE_32199_length_547_cov_4.683036	451	492	2	41	41	1.0000000
NODE_32204_length_547_cov_4.138393	97	175	6	78	78	1.0000000
NODE_32204_length_547_cov_4.138393	151	228	0	39	77	0.5064935
NODE_32204_length_547_cov_4.138393	151	228	6	38	77	0.4935065
NODE_32206_length_547_cov_4.026786	136	216	4	11	80	0.1375000
NODE_32206_length_547_cov_4.026786	136	216	5	58	80	0.7250000
NODE_32206_length_547_cov_4.026786	136	216	6	11	80	0.1375000
NODE_32206_length_547_cov_4.026786	189	269	0	6	80	0.0750000
NODE_32206_length_547_cov_4.026786	189	269	4	16	80	0.2000000
NODE_32206_length_547_cov_4.026786	189	269	5	16	80	0.2000000
NODE_32206_length_547_cov_4.026786	189	269	6	42	80	0.5250000
NODE_32215_length_547_cov_3.468750	219	299	0	80	80	1.0000000
NODE_32222_length_547_cov_2.901786	304	384	0	54	80	0.6750000
NODE_32222_length_547_cov_2.901786	304	384	1	26	80	0.3250000
NODE_32347_length_546_cov_17.733781	159	239	4	80	80	1.0000000
NODE_32347_length_546_cov_17.733781	212	293	0	39	81	0.4814815
NODE_32347_length_546_cov_17.733781	212	293	2	5	81	0.0617284
NODE_32347_length_546_cov_17.733781	212	293	4	37	81	0.4567901
NODE_32348_length_546_cov_16.275168	272	352	0	80	80	1.0000000
NODE_32348_length_546_cov_16.275168	325	405	0	80	80	1.0000000
NODE_32349_length_546_cov_8.201342	179	259	0	13	80	0.1625000
NODE_32349_length_546_cov_8.201342	179	259	2	67	80	0.8375000
NODE_32351_length_546_cov_7.454139	241	321	0	80	80	1.0000000
NODE_32351_length_546_cov_7.454139	294	374	0	80	80	1.0000000
NODE_32380_length_546_cov_3.192394	171	251	0	80	80	1.0000000
NODE_32510_length_545_cov_31.524664	38	118	0	80	80	1.0000000
NODE_32510_length_545_cov_31.524664	91	171	0	80	80	1.0000000
NODE_32517_length_545_cov_5.524664	268	348	0	80	80	1.0000000
NODE_32525_length_545_cov_3.885650	137	217	2	17	80	0.2125000
NODE_32525_length_545_cov_3.885650	137	217	4	21	80	0.2625000
NODE_32525_length_545_cov_3.885650	137	217	6	37	80	0.4625000
NODE_32525_length_545_cov_3.885650	137	217	8	5	80	0.0625000
NODE_32571_length_545_cov_2.013453	246	318	0	72	72	1.0000000
NODE_32599_length_545_cov_1.450673	130	179	0	34	49	0.6938776
NODE_32599_length_545_cov_1.450673	130	179	2	15	49	0.3061225
NODE_32616_length_545_cov_1.179372	431	469	0	38	38	1.0000000
NODE_32673_length_544_cov_37.705618	258	338	0	80	80	1.0000000
NODE_32673_length_544_cov_37.705618	311	391	0	80	80	1.0000000
NODE_32674_length_544_cov_33.847191	189	269	0	80	80	1.0000000
NODE_32674_length_544_cov_33.847191	242	327	0	85	85	1.0000000
NODE_32675_length_544_cov_19.467416	251	331	0	80	80	1.0000000
NODE_32675_length_544_cov_19.467416	304	384	0	80	80	1.0000000
NODE_32676_length_544_cov_16.775281	163	243	0	80	80	1.0000000
NODE_32676_length_544_cov_16.775281	216	296	0	80	80	1.0000000
NODE_32677_length_544_cov_8.943820	81	161	0	80	80	1.0000000
NODE_32677_length_544_cov_8.943820	134	214	0	80	80	1.0000000
NODE_32678_length_544_cov_8.537079	283	363	0	58	80	0.7250000
NODE_32678_length_544_cov_8.537079	283	363	2	22	80	0.2750000
NODE_32678_length_544_cov_8.537079	336	416	0	10	80	0.1250000
NODE_32678_length_544_cov_8.537079	336	416	2	70	80	0.8750000
NODE_32680_length_544_cov_8.440449	209	289	2	52	80	0.6500000
NODE_32680_length_544_cov_8.440449	209	289	4	28	80	0.3500000
NODE_32680_length_544_cov_8.440449	262	342	0	26	80	0.3250000
NODE_32680_length_544_cov_8.440449	262	342	2	54	80	0.6750000
NODE_32681_length_544_cov_7.604494	332	412	0	80	80	1.0000000
NODE_32681_length_544_cov_7.604494	385	465	0	80	80	1.0000000
NODE_32684_length_544_cov_6.000000	461	513	10	8	52	0.1538462
NODE_32684_length_544_cov_6.000000	461	513	12	22	52	0.4230769
NODE_32684_length_544_cov_6.000000	461	513	14	22	52	0.4230769
NODE_32830_length_543_cov_38.790541	116	196	0	14	80	0.1750000
NODE_32830_length_543_cov_38.790541	116	196	2	7	80	0.0875000
NODE_32830_length_543_cov_38.790541	116	196	4	59	80	0.7375000
NODE_32830_length_543_cov_38.790541	169	249	4	29	80	0.3625000
NODE_32830_length_543_cov_38.790541	169	249	8	10	80	0.1250000
NODE_32830_length_543_cov_38.790541	169	249	9	1	80	0.0125000
NODE_32830_length_543_cov_38.790541	169	249	10	31	80	0.3875000
NODE_32830_length_543_cov_38.790541	169	249	12	9	80	0.1125000
NODE_32831_length_543_cov_31.713964	193	273	0	80	80	1.0000000
NODE_32831_length_543_cov_31.713964	246	326	0	80	80	1.0000000
NODE_32832_length_543_cov_13.689189	118	198	0	80	80	1.0000000
NODE_32832_length_543_cov_13.689189	171	251	0	80	80	1.0000000
NODE_32833_length_543_cov_10.601351	271	351	0	80	80	1.0000000
NODE_32833_length_543_cov_10.601351	324	404	0	80	80	1.0000000
NODE_32833_length_543_cov_10.601351	400	480	0	10	80	0.1250000
NODE_32833_length_543_cov_10.601351	400	480	2	70	80	0.8750000
NODE_32833_length_543_cov_10.601351	453	533	0	57	80	0.7125000
NODE_32833_length_543_cov_10.601351	453	533	2	23	80	0.2875000
NODE_32834_length_543_cov_9.202703	291	341	4	50	50	1.0000000
NODE_32834_length_543_cov_9.202703	347	384	2	32	37	0.8648649
NODE_32834_length_543_cov_9.202703	347	384	4	5	37	0.1351351
NODE_32835_length_543_cov_7.722973	300	378	0	44	78	0.5641026
NODE_32835_length_543_cov_7.722973	300	378	2	34	78	0.4358974
NODE_32835_length_543_cov_7.722973	351	431	0	18	80	0.2250000
NODE_32835_length_543_cov_7.722973	351	431	2	62	80	0.7750000
NODE_32836_length_543_cov_6.815315	181	260	0	79	79	1.0000000
NODE_32845_length_543_cov_4.704955	145	225	0	80	80	1.0000000
NODE_32845_length_543_cov_4.704955	198	275	0	77	77	1.0000000
NODE_32864_length_543_cov_3.301802	247	312	0	65	65	1.0000000
NODE_32875_length_543_cov_2.635135	253	316	2	58	63	0.9206349
NODE_32875_length_543_cov_2.635135	253	316	4	5	63	0.0793651
NODE_32875_length_543_cov_2.635135	293	373	2	18	80	0.2250000
NODE_32875_length_543_cov_2.635135	293	373	4	25	80	0.3125000
NODE_32875_length_543_cov_2.635135	293	373	6	37	80	0.4625000
NODE_33002_length_543_cov_0.682432	98	178	0	27	80	0.3375000
NODE_33002_length_543_cov_0.682432	98	178	1	48	80	0.6000000
NODE_33002_length_543_cov_0.682432	98	178	2	5	80	0.0625000
NODE_33012_length_542_cov_57.370203	287	367	0	80	80	1.0000000
NODE_33012_length_542_cov_57.370203	340	378	0	38	38	1.0000000
NODE_33014_length_542_cov_11.616253	277	357	0	9	80	0.1125000
NODE_33014_length_542_cov_11.616253	277	357	2	71	80	0.8875000
NODE_33014_length_542_cov_11.616253	330	410	0	18	80	0.2250000
NODE_33014_length_542_cov_11.616253	330	410	2	62	80	0.7750000
NODE_33015_length_542_cov_9.988713	253	333	0	80	80	1.0000000
NODE_33015_length_542_cov_9.988713	306	386	0	80	80	1.0000000
NODE_33018_length_542_cov_7.934537	215	295	2	80	80	1.0000000
NODE_33018_length_542_cov_7.934537	268	348	0	52	80	0.6500000
NODE_33018_length_542_cov_7.934537	268	348	2	28	80	0.3500000
NODE_33020_length_542_cov_7.266366	159	239	0	80	80	1.0000000
NODE_33021_length_542_cov_7.069977	230	304	0	74	74	1.0000000
NODE_33021_length_542_cov_7.069977	284	362	0	78	78	1.0000000
NODE_33025_length_542_cov_4.783296	237	267	0	4	30	0.1333333
NODE_33025_length_542_cov_4.783296	237	267	2	13	30	0.4333333
NODE_33025_length_542_cov_4.783296	237	267	4	13	30	0.4333333
NODE_33035_length_542_cov_3.882619	275	303	0	28	28	1.0000000
NODE_33040_length_542_cov_3.600451	82	131	0	43	49	0.8775510
NODE_33040_length_542_cov_3.600451	82	131	2	5	49	0.1020408
NODE_33040_length_542_cov_3.600451	82	131	4	1	49	0.0204082
NODE_33188_length_541_cov_22.463801	247	327	0	46	80	0.5750000
NODE_33188_length_541_cov_22.463801	247	327	2	18	80	0.2250000
NODE_33188_length_541_cov_22.463801	247	327	4	16	80	0.2000000
NODE_33188_length_541_cov_22.463801	300	380	2	14	80	0.1750000
NODE_33188_length_541_cov_22.463801	300	380	4	66	80	0.8250000
NODE_33190_length_541_cov_11.070136	60	140	0	80	80	1.0000000
NODE_33190_length_541_cov_11.070136	113	193	0	80	80	1.0000000
NODE_33204_length_541_cov_3.690045	179	250	0	4	71	0.0563380
NODE_33204_length_541_cov_3.690045	179	250	2	27	71	0.3802817
NODE_33204_length_541_cov_3.690045	179	250	4	40	71	0.5633803
NODE_33300_length_541_cov_1.187783	352	400	2	48	48	1.0000000
NODE_33359_length_540_cov_78.353741	219	299	6	80	80	1.0000000
NODE_33359_length_540_cov_78.353741	272	352	0	25	80	0.3125000
NODE_33359_length_540_cov_78.353741	272	352	3	1	80	0.0125000
NODE_33359_length_540_cov_78.353741	272	352	4	23	80	0.2875000
NODE_33359_length_540_cov_78.353741	272	352	6	31	80	0.3875000
NODE_33360_length_540_cov_33.473923	59	139	0	80	80	1.0000000
NODE_33360_length_540_cov_33.473923	112	192	0	80	80	1.0000000
NODE_33361_length_540_cov_20.380952	97	177	0	80	80	1.0000000
NODE_33361_length_540_cov_20.380952	150	230	0	28	80	0.3500000
NODE_33361_length_540_cov_20.380952	150	230	2	34	80	0.4250000
NODE_33361_length_540_cov_20.380952	150	230	4	18	80	0.2250000
NODE_33362_length_540_cov_12.657596	248	328	0	80	80	1.0000000
NODE_33362_length_540_cov_12.657596	301	381	0	80	80	1.0000000
NODE_33363_length_540_cov_11.111111	180	260	0	29	80	0.3625000
NODE_33363_length_540_cov_11.111111	180	260	2	51	80	0.6375000
NODE_33363_length_540_cov_11.111111	233	313	0	17	80	0.2125000
NODE_33363_length_540_cov_11.111111	233	313	2	63	80	0.7875000
NODE_33365_length_540_cov_6.328798	260	340	0	80	80	1.0000000
NODE_33365_length_540_cov_6.328798	313	393	0	80	80	1.0000000
NODE_33382_length_540_cov_3.587302	351	411	0	44	60	0.7333333
NODE_33382_length_540_cov_3.587302	351	411	4	16	60	0.2666667
NODE_33503_length_539_cov_1023.604545	264	344	135	1	80	0.0125000
NODE_33503_length_539_cov_1023.604545	264	344	138	1	80	0.0125000
NODE_33503_length_539_cov_1023.604545	264	344	141	1	80	0.0125000
NODE_33503_length_539_cov_1023.604545	264	344	150	2	80	0.0250000
NODE_33503_length_539_cov_1023.604545	264	344	152	1	80	0.0125000
NODE_33503_length_539_cov_1023.604545	264	344	158	2	80	0.0250000
NODE_33503_length_539_cov_1023.604545	264	344	159	1	80	0.0125000
NODE_33503_length_539_cov_1023.604545	264	344	160	2	80	0.0250000
NODE_33503_length_539_cov_1023.604545	264	344	180	1	80	0.0125000
NODE_33503_length_539_cov_1023.604545	264	344	187	1	80	0.0125000
NODE_33503_length_539_cov_1023.604545	264	344	192	1	80	0.0125000
NODE_33503_length_539_cov_1023.604545	264	344	198	1	80	0.0125000
NODE_33503_length_539_cov_1023.604545	264	344	205	1	80	0.0125000
NODE_33503_length_539_cov_1023.604545	264	344	209	1	80	0.0125000
NODE_33503_length_539_cov_1023.604545	264	344	225	2	80	0.0250000
NODE_33503_length_539_cov_1023.604545	264	344	227	2	80	0.0250000
NODE_33503_length_539_cov_1023.604545	264	344	243	1	80	0.0125000
NODE_33503_length_539_cov_1023.604545	264	344	261	1	80	0.0125000
NODE_33503_length_539_cov_1023.604545	264	344	274	1	80	0.0125000
NODE_33503_length_539_cov_1023.604545	264	344	284	1	80	0.0125000
NODE_33503_length_539_cov_1023.604545	264	344	293	1	80	0.0125000
NODE_33503_length_539_cov_1023.604545	264	344	295	1	80	0.0125000
NODE_33503_length_539_cov_1023.604545	264	344	300	1	80	0.0125000
NODE_33503_length_539_cov_1023.604545	264	344	309	1	80	0.0125000
NODE_33503_length_539_cov_1023.604545	264	344	311	1	80	0.0125000
NODE_33503_length_539_cov_1023.604545	264	344	317	1	80	0.0125000
NODE_33503_length_539_cov_1023.604545	264	344	325	1	80	0.0125000
NODE_33503_length_539_cov_1023.604545	264	344	329	1	80	0.0125000
NODE_33503_length_539_cov_1023.604545	264	344	330	1	80	0.0125000
NODE_33503_length_539_cov_1023.604545	264	344	334	1	80	0.0125000
NODE_33503_length_539_cov_1023.604545	264	344	339	1	80	0.0125000
NODE_33503_length_539_cov_1023.604545	264	344	355	1	80	0.0125000
NODE_33503_length_539_cov_1023.604545	264	344	364	1	80	0.0125000
NODE_33503_length_539_cov_1023.604545	264	344	380	1	80	0.0125000
NODE_33503_length_539_cov_1023.604545	264	344	389	1	80	0.0125000
NODE_33503_length_539_cov_1023.604545	264	344	397	1	80	0.0125000
NODE_33503_length_539_cov_1023.604545	264	344	399	1	80	0.0125000
NODE_33503_length_539_cov_1023.604545	264	344	405	1	80	0.0125000
NODE_33503_length_539_cov_1023.604545	264	344	409	1	80	0.0125000
NODE_33503_length_539_cov_1023.604545	264	344	410	1	80	0.0125000
NODE_33503_length_539_cov_1023.604545	264	344	412	1	80	0.0125000
NODE_33503_length_539_cov_1023.604545	264	344	417	1	80	0.0125000
NODE_33503_length_539_cov_1023.604545	264	344	418	1	80	0.0125000
NODE_33503_length_539_cov_1023.604545	264	344	419	1	80	0.0125000
NODE_33503_length_539_cov_1023.604545	264	344	420	1	80	0.0125000
NODE_33503_length_539_cov_1023.604545	264	344	431	1	80	0.0125000
NODE_33503_length_539_cov_1023.604545	264	344	442	1	80	0.0125000
NODE_33503_length_539_cov_1023.604545	264	344	447	1	80	0.0125000
NODE_33503_length_539_cov_1023.604545	264	344	449	2	80	0.0250000
NODE_33503_length_539_cov_1023.604545	264	344	452	1	80	0.0125000
NODE_33503_length_539_cov_1023.604545	264	344	455	1	80	0.0125000
NODE_33503_length_539_cov_1023.604545	264	344	459	1	80	0.0125000
NODE_33503_length_539_cov_1023.604545	264	344	467	2	80	0.0250000
NODE_33503_length_539_cov_1023.604545	264	344	468	1	80	0.0125000
NODE_33503_length_539_cov_1023.604545	264	344	469	1	80	0.0125000
NODE_33503_length_539_cov_1023.604545	264	344	471	1	80	0.0125000
NODE_33503_length_539_cov_1023.604545	264	344	488	1	80	0.0125000
NODE_33503_length_539_cov_1023.604545	264	344	493	1	80	0.0125000
NODE_33503_length_539_cov_1023.604545	264	344	505	1	80	0.0125000
NODE_33503_length_539_cov_1023.604545	264	344	514	1	80	0.0125000
NODE_33503_length_539_cov_1023.604545	264	344	525	1	80	0.0125000
NODE_33503_length_539_cov_1023.604545	264	344	529	1	80	0.0125000
NODE_33503_length_539_cov_1023.604545	264	344	536	1	80	0.0125000
NODE_33503_length_539_cov_1023.604545	264	344	560	1	80	0.0125000
NODE_33503_length_539_cov_1023.604545	264	344	574	1	80	0.0125000
NODE_33503_length_539_cov_1023.604545	264	344	582	1	80	0.0125000
NODE_33503_length_539_cov_1023.604545	264	344	590	1	80	0.0125000
NODE_33503_length_539_cov_1023.604545	264	344	600	1	80	0.0125000
NODE_33503_length_539_cov_1023.604545	264	344	606	1	80	0.0125000
NODE_33503_length_539_cov_1023.604545	264	344	619	1	80	0.0125000
NODE_33503_length_539_cov_1023.604545	264	344	626	1	80	0.0125000
NODE_33503_length_539_cov_1023.604545	264	344	629	1	80	0.0125000
NODE_33503_length_539_cov_1023.604545	264	344	632	1	80	0.0125000
NODE_33503_length_539_cov_1023.604545	317	397	449	2	80	0.0250000
NODE_33503_length_539_cov_1023.604545	317	397	452	1	80	0.0125000
NODE_33503_length_539_cov_1023.604545	317	397	455	1	80	0.0125000
NODE_33503_length_539_cov_1023.604545	317	397	459	1	80	0.0125000
NODE_33503_length_539_cov_1023.604545	317	397	467	2	80	0.0250000
NODE_33503_length_539_cov_1023.604545	317	397	468	1	80	0.0125000
NODE_33503_length_539_cov_1023.604545	317	397	469	1	80	0.0125000
NODE_33503_length_539_cov_1023.604545	317	397	471	1	80	0.0125000
NODE_33503_length_539_cov_1023.604545	317	397	488	1	80	0.0125000
NODE_33503_length_539_cov_1023.604545	317	397	493	1	80	0.0125000
NODE_33503_length_539_cov_1023.604545	317	397	505	1	80	0.0125000
NODE_33503_length_539_cov_1023.604545	317	397	514	1	80	0.0125000
NODE_33503_length_539_cov_1023.604545	317	397	525	1	80	0.0125000
NODE_33503_length_539_cov_1023.604545	317	397	529	1	80	0.0125000
NODE_33503_length_539_cov_1023.604545	317	397	536	1	80	0.0125000
NODE_33503_length_539_cov_1023.604545	317	397	560	1	80	0.0125000
NODE_33503_length_539_cov_1023.604545	317	397	574	1	80	0.0125000
NODE_33503_length_539_cov_1023.604545	317	397	582	1	80	0.0125000
NODE_33503_length_539_cov_1023.604545	317	397	590	1	80	0.0125000
NODE_33503_length_539_cov_1023.604545	317	397	600	1	80	0.0125000
NODE_33503_length_539_cov_1023.604545	317	397	606	1	80	0.0125000
NODE_33503_length_539_cov_1023.604545	317	397	619	1	80	0.0125000
NODE_33503_length_539_cov_1023.604545	317	397	626	1	80	0.0125000
NODE_33503_length_539_cov_1023.604545	317	397	629	2	80	0.0250000
NODE_33503_length_539_cov_1023.604545	317	397	630	1	80	0.0125000
NODE_33503_length_539_cov_1023.604545	317	397	632	1	80	0.0125000
NODE_33503_length_539_cov_1023.604545	317	397	634	2	80	0.0250000
NODE_33503_length_539_cov_1023.604545	317	397	636	1	80	0.0125000
NODE_33503_length_539_cov_1023.604545	317	397	639	1	80	0.0125000
NODE_33503_length_539_cov_1023.604545	317	397	641	2	80	0.0250000
NODE_33503_length_539_cov_1023.604545	317	397	642	1	80	0.0125000
NODE_33503_length_539_cov_1023.604545	317	397	644	1	80	0.0125000
NODE_33503_length_539_cov_1023.604545	317	397	645	1	80	0.0125000
NODE_33503_length_539_cov_1023.604545	317	397	646	3	80	0.0375000
NODE_33503_length_539_cov_1023.604545	317	397	648	3	80	0.0375000
NODE_33503_length_539_cov_1023.604545	317	397	649	2	80	0.0250000
NODE_33503_length_539_cov_1023.604545	317	397	650	1	80	0.0125000
NODE_33503_length_539_cov_1023.604545	317	397	651	3	80	0.0375000
NODE_33503_length_539_cov_1023.604545	317	397	653	2	80	0.0250000
NODE_33503_length_539_cov_1023.604545	317	397	657	1	80	0.0125000
NODE_33503_length_539_cov_1023.604545	317	397	658	2	80	0.0250000
NODE_33503_length_539_cov_1023.604545	317	397	659	1	80	0.0125000
NODE_33503_length_539_cov_1023.604545	317	397	670	3	80	0.0375000
NODE_33503_length_539_cov_1023.604545	317	397	672	1	80	0.0125000
NODE_33503_length_539_cov_1023.604545	317	397	675	1	80	0.0125000
NODE_33503_length_539_cov_1023.604545	317	397	676	1	80	0.0125000
NODE_33503_length_539_cov_1023.604545	317	397	677	1	80	0.0125000
NODE_33503_length_539_cov_1023.604545	317	397	680	1	80	0.0125000
NODE_33503_length_539_cov_1023.604545	317	397	682	1	80	0.0125000
NODE_33503_length_539_cov_1023.604545	317	397	686	1	80	0.0125000
NODE_33503_length_539_cov_1023.604545	317	397	688	1	80	0.0125000
NODE_33503_length_539_cov_1023.604545	317	397	690	1	80	0.0125000
NODE_33503_length_539_cov_1023.604545	317	397	692	1	80	0.0125000
NODE_33503_length_539_cov_1023.604545	317	397	697	2	80	0.0250000
NODE_33503_length_539_cov_1023.604545	317	397	698	1	80	0.0125000
NODE_33503_length_539_cov_1023.604545	317	397	699	2	80	0.0250000
NODE_33503_length_539_cov_1023.604545	317	397	700	2	80	0.0250000
NODE_33503_length_539_cov_1023.604545	317	397	701	1	80	0.0125000
NODE_33503_length_539_cov_1023.604545	317	397	702	1	80	0.0125000
NODE_33503_length_539_cov_1023.604545	317	397	703	2	80	0.0250000
NODE_33504_length_539_cov_99.579545	478	539	0	61	61	1.0000000
NODE_33505_length_539_cov_15.247727	217	297	2	30	80	0.3750000
NODE_33505_length_539_cov_15.247727	217	297	4	50	80	0.6250000
NODE_33505_length_539_cov_15.247727	270	350	0	47	80	0.5875000
NODE_33505_length_539_cov_15.247727	270	350	2	23	80	0.2875000
NODE_33505_length_539_cov_15.247727	270	350	4	10	80	0.1250000
NODE_33506_length_539_cov_14.172727	278	350	0	72	72	1.0000000
NODE_33507_length_539_cov_13.154545	118	198	0	17	80	0.2125000
NODE_33507_length_539_cov_13.154545	118	198	2	32	80	0.4000000
NODE_33507_length_539_cov_13.154545	118	198	4	31	80	0.3875000
NODE_33507_length_539_cov_13.154545	171	251	2	29	80	0.3625000
NODE_33507_length_539_cov_13.154545	171	251	4	51	80	0.6375000
NODE_33508_length_539_cov_10.811364	48	128	0	80	80	1.0000000
NODE_33508_length_539_cov_10.811364	101	181	0	80	80	1.0000000
NODE_33509_length_539_cov_9.563636	201	277	6	18	76	0.2368421
NODE_33509_length_539_cov_9.563636	201	277	8	33	76	0.4342105
NODE_33509_length_539_cov_9.563636	201	277	10	21	76	0.2763158
NODE_33509_length_539_cov_9.563636	201	277	12	4	76	0.0526316
NODE_33510_length_539_cov_7.934091	311	369	4	3	58	0.0517241
NODE_33510_length_539_cov_7.934091	311	369	6	4	58	0.0689655
NODE_33510_length_539_cov_7.934091	311	369	8	4	58	0.0689655
NODE_33510_length_539_cov_7.934091	311	369	14	2	58	0.0344828
NODE_33510_length_539_cov_7.934091	311	369	16	45	58	0.7758621
NODE_33510_length_539_cov_7.934091	342	422	6	6	80	0.0750000
NODE_33510_length_539_cov_7.934091	342	422	8	16	80	0.2000000
NODE_33510_length_539_cov_7.934091	342	422	10	1	80	0.0125000
NODE_33510_length_539_cov_7.934091	342	422	12	2	80	0.0250000
NODE_33510_length_539_cov_7.934091	342	422	16	55	80	0.6875000
NODE_33517_length_539_cov_5.740909	251	319	0	68	68	1.0000000
NODE_33517_length_539_cov_5.740909	301	372	0	71	71	1.0000000
NODE_33533_length_539_cov_3.627273	80	157	0	19	77	0.2467532
NODE_33533_length_539_cov_3.627273	80	157	2	58	77	0.7532467
NODE_33533_length_539_cov_3.627273	130	175	2	45	45	1.0000000
NODE_33569_length_539_cov_2.143182	325	371	2	46	46	1.0000000
NODE_33595_length_539_cov_1.618182	408	456	0	48	48	1.0000000
NODE_33623_length_539_cov_1.129545	97	134	0	37	37	1.0000000
NODE_33669_length_538_cov_23.193622	171	256	0	85	85	1.0000000
NODE_33669_length_538_cov_23.193622	225	305	0	80	80	1.0000000
NODE_33672_length_538_cov_7.378132	145	225	0	80	80	1.0000000
NODE_33672_length_538_cov_7.378132	198	278	0	66	80	0.8250000
NODE_33672_length_538_cov_7.378132	198	278	2	6	80	0.0750000
NODE_33672_length_538_cov_7.378132	198	278	4	8	80	0.1000000
NODE_33683_length_538_cov_4.496583	277	357	2	3	80	0.0375000
NODE_33683_length_538_cov_4.496583	277	357	4	15	80	0.1875000
NODE_33683_length_538_cov_4.496583	277	357	6	62	80	0.7750000
NODE_33683_length_538_cov_4.496583	330	410	2	16	80	0.2000000
NODE_33683_length_538_cov_4.496583	330	410	4	30	80	0.3750000
NODE_33683_length_538_cov_4.496583	330	410	6	34	80	0.4250000
NODE_33687_length_538_cov_3.753986	251	309	0	58	58	1.0000000
NODE_33713_length_538_cov_2.239180	256	338	0	82	82	1.0000000
NODE_33814_length_538_cov_0.822323	397	477	0	80	80	1.0000000
NODE_33852_length_537_cov_13.031963	258	309	12	51	51	1.0000000
NODE_33854_length_537_cov_9.552511	198	278	0	80	80	1.0000000
NODE_33854_length_537_cov_9.552511	251	332	0	81	81	1.0000000
NODE_33960_length_537_cov_1.244292	107	187	0	7	80	0.0875000
NODE_33960_length_537_cov_1.244292	107	187	2	1	80	0.0125000
NODE_33960_length_537_cov_1.244292	107	187	4	12	80	0.1500000
NODE_33960_length_537_cov_1.244292	107	187	5	1	80	0.0125000
NODE_33960_length_537_cov_1.244292	107	187	6	2	80	0.0250000
NODE_33960_length_537_cov_1.244292	107	187	8	5	80	0.0625000
NODE_33960_length_537_cov_1.244292	107	187	10	2	80	0.0250000
NODE_33960_length_537_cov_1.244292	107	187	12	1	80	0.0125000
NODE_33960_length_537_cov_1.244292	107	187	16	2	80	0.0250000
NODE_33960_length_537_cov_1.244292	107	187	18	1	80	0.0125000
NODE_33960_length_537_cov_1.244292	107	187	22	3	80	0.0375000
NODE_33960_length_537_cov_1.244292	107	187	24	1	80	0.0125000
NODE_33960_length_537_cov_1.244292	107	187	26	4	80	0.0500000
NODE_33960_length_537_cov_1.244292	107	187	32	1	80	0.0125000
NODE_33960_length_537_cov_1.244292	107	187	34	4	80	0.0500000
NODE_33960_length_537_cov_1.244292	107	187	36	4	80	0.0500000
NODE_33960_length_537_cov_1.244292	107	187	38	2	80	0.0250000
NODE_33960_length_537_cov_1.244292	107	187	40	1	80	0.0125000
NODE_33960_length_537_cov_1.244292	107	187	41	2	80	0.0250000
NODE_33960_length_537_cov_1.244292	107	187	43	1	80	0.0125000
NODE_33960_length_537_cov_1.244292	107	187	47	1	80	0.0125000
NODE_33960_length_537_cov_1.244292	107	187	51	6	80	0.0750000
NODE_33960_length_537_cov_1.244292	107	187	55	1	80	0.0125000
NODE_33960_length_537_cov_1.244292	107	187	57	2	80	0.0250000
NODE_33960_length_537_cov_1.244292	107	187	58	3	80	0.0375000
NODE_33960_length_537_cov_1.244292	107	187	60	1	80	0.0125000
NODE_33960_length_537_cov_1.244292	107	187	62	1	80	0.0125000
NODE_33960_length_537_cov_1.244292	107	187	64	1	80	0.0125000
NODE_33960_length_537_cov_1.244292	107	187	66	2	80	0.0250000
NODE_33960_length_537_cov_1.244292	107	187	68	3	80	0.0375000
NODE_33960_length_537_cov_1.244292	107	187	70	1	80	0.0125000
NODE_33960_length_537_cov_1.244292	107	187	72	1	80	0.0125000
NODE_34029_length_536_cov_87.622426	430	462	59	1	32	0.0312500
NODE_34029_length_536_cov_87.622426	430	462	61	1	32	0.0312500
NODE_34029_length_536_cov_87.622426	430	462	63	1	32	0.0312500
NODE_34029_length_536_cov_87.622426	430	462	65	2	32	0.0625000
NODE_34029_length_536_cov_87.622426	430	462	67	2	32	0.0625000
NODE_34029_length_536_cov_87.622426	430	462	69	3	32	0.0937500
NODE_34029_length_536_cov_87.622426	430	462	71	1	32	0.0312500
NODE_34029_length_536_cov_87.622426	430	462	73	3	32	0.0937500
NODE_34029_length_536_cov_87.622426	430	462	75	4	32	0.1250000
NODE_34029_length_536_cov_87.622426	430	462	77	4	32	0.1250000
NODE_34029_length_536_cov_87.622426	430	462	79	7	32	0.2187500
NODE_34029_length_536_cov_87.622426	430	462	81	3	32	0.0937500
NODE_34030_length_536_cov_11.629291	119	199	0	80	80	1.0000000
NODE_34030_length_536_cov_11.629291	172	252	0	80	80	1.0000000
NODE_34032_length_536_cov_6.613272	286	372	4	37	86	0.4302326
NODE_34032_length_536_cov_6.613272	286	372	6	49	86	0.5697674
NODE_34035_length_536_cov_5.810069	191	271	0	15	80	0.1875000
NODE_34035_length_536_cov_5.810069	191	271	2	65	80	0.8125000
NODE_34035_length_536_cov_5.810069	244	324	0	68	80	0.8500000
NODE_34035_length_536_cov_5.810069	244	324	2	12	80	0.1500000
NODE_34035_length_536_cov_5.810069	374	404	2	30	30	1.0000000
NODE_34039_length_536_cov_4.729977	202	245	0	43	43	1.0000000
NODE_34057_length_536_cov_3.297483	86	126	0	40	40	1.0000000
NODE_34068_length_536_cov_2.796339	223	280	0	57	57	1.0000000
NODE_34094_length_536_cov_1.956522	181	230	10	1	49	0.0204082
NODE_34094_length_536_cov_1.956522	181	230	12	7	49	0.1428571
NODE_34094_length_536_cov_1.956522	181	230	14	3	49	0.0612245
NODE_34094_length_536_cov_1.956522	181	230	18	13	49	0.2653061
NODE_34094_length_536_cov_1.956522	181	230	20	8	49	0.1632653
NODE_34094_length_536_cov_1.956522	181	230	22	11	49	0.2244898
NODE_34094_length_536_cov_1.956522	181	230	27	6	49	0.1224490
NODE_34095_length_536_cov_1.951945	203	284	4	7	81	0.0864198
NODE_34095_length_536_cov_1.951945	203	284	6	44	81	0.5432099
NODE_34095_length_536_cov_1.951945	203	284	8	9	81	0.1111111
NODE_34095_length_536_cov_1.951945	203	284	9	1	81	0.0123457
NODE_34095_length_536_cov_1.951945	203	284	10	20	81	0.2469136
NODE_34095_length_536_cov_1.951945	306	368	0	31	62	0.5000000
NODE_34095_length_536_cov_1.951945	306	368	4	31	62	0.5000000
NODE_34209_length_535_cov_32.277523	158	238	0	80	80	1.0000000
NODE_34209_length_535_cov_32.277523	211	291	0	80	80	1.0000000
NODE_34215_length_535_cov_5.910550	110	162	0	52	52	1.0000000
NODE_34229_length_535_cov_3.795872	217	297	4	15	80	0.1875000
NODE_34229_length_535_cov_3.795872	217	297	10	23	80	0.2875000
NODE_34229_length_535_cov_3.795872	217	297	12	42	80	0.5250000
NODE_34375_length_534_cov_54.331034	435	498	0	55	63	0.8730159
NODE_34375_length_534_cov_54.331034	435	498	2	2	63	0.0317460
NODE_34375_length_534_cov_54.331034	435	498	4	1	63	0.0158730
NODE_34375_length_534_cov_54.331034	435	498	6	1	63	0.0158730
NODE_34375_length_534_cov_54.331034	435	498	24	1	63	0.0158730
NODE_34375_length_534_cov_54.331034	435	498	26	3	63	0.0476190
NODE_34375_length_534_cov_54.331034	471	534	0	63	63	1.0000000
NODE_34377_length_534_cov_15.462069	460	534	0	8	74	0.1081081
NODE_34377_length_534_cov_15.462069	460	534	2	66	74	0.8918919
NODE_34377_length_534_cov_15.462069	512	534	0	8	22	0.3636364
NODE_34377_length_534_cov_15.462069	512	534	2	14	22	0.6363636
NODE_34378_length_534_cov_10.308046	268	348	0	80	80	1.0000000
NODE_34378_length_534_cov_10.308046	321	401	0	80	80	1.0000000
NODE_34380_length_534_cov_9.041379	204	284	4	1	80	0.0125000
NODE_34380_length_534_cov_9.041379	204	284	6	54	80	0.6750000
NODE_34380_length_534_cov_9.041379	204	284	8	25	80	0.3125000
NODE_34380_length_534_cov_9.041379	257	332	2	8	75	0.1066667
NODE_34380_length_534_cov_9.041379	257	332	4	36	75	0.4800000
NODE_34380_length_534_cov_9.041379	257	332	6	15	75	0.2000000
NODE_34380_length_534_cov_9.041379	257	332	8	16	75	0.2133333
NODE_34383_length_534_cov_6.958621	273	303	0	30	30	1.0000000
NODE_34392_length_534_cov_5.022989	291	371	0	30	80	0.3750000
NODE_34392_length_534_cov_5.022989	291	371	2	31	80	0.3875000
NODE_34392_length_534_cov_5.022989	291	371	4	19	80	0.2375000
NODE_34402_length_534_cov_3.873563	110	190	0	26	80	0.3250000
NODE_34402_length_534_cov_3.873563	110	190	2	54	80	0.6750000
NODE_34409_length_534_cov_3.202299	221	301	0	15	80	0.1875000
NODE_34409_length_534_cov_3.202299	221	301	2	7	80	0.0875000
NODE_34409_length_534_cov_3.202299	221	301	4	32	80	0.4000000
NODE_34409_length_534_cov_3.202299	221	301	6	26	80	0.3250000
NODE_34411_length_534_cov_3.158621	171	200	10	10	29	0.3448276
NODE_34411_length_534_cov_3.158621	171	200	12	1	29	0.0344828
NODE_34411_length_534_cov_3.158621	171	200	13	18	29	0.6206896
NODE_34418_length_534_cov_3.002299	175	219	0	44	44	1.0000000
NODE_34489_length_534_cov_1.344828	475	518	0	43	43	1.0000000
NODE_34494_length_534_cov_1.291954	273	336	6	25	63	0.3968254
NODE_34494_length_534_cov_1.291954	273	336	8	38	63	0.6031746
NODE_34511_length_534_cov_1.160920	227	264	2	15	37	0.4054054
NODE_34511_length_534_cov_1.160920	227	264	4	3	37	0.0810811
NODE_34511_length_534_cov_1.160920	227	264	7	19	37	0.5135135
NODE_34570_length_533_cov_13.956221	216	296	0	80	80	1.0000000
NODE_34570_length_533_cov_13.956221	269	349	0	80	80	1.0000000
NODE_34575_length_533_cov_8.207373	244	322	0	78	78	1.0000000
NODE_34576_length_533_cov_8.023041	230	310	0	4	80	0.0500000
NODE_34576_length_533_cov_8.023041	230	310	2	76	80	0.9500000
NODE_34576_length_533_cov_8.023041	283	364	0	20	81	0.2469136
NODE_34576_length_533_cov_8.023041	283	364	2	26	81	0.3209876
NODE_34576_length_533_cov_8.023041	283	364	4	35	81	0.4320988
NODE_34585_length_533_cov_5.170507	308	369	0	19	61	0.3114754
NODE_34585_length_533_cov_5.170507	308	369	2	42	61	0.6885246
NODE_34588_length_533_cov_4.988479	229	309	0	76	80	0.9500000
NODE_34588_length_533_cov_4.988479	229	309	2	4	80	0.0500000
NODE_34588_length_533_cov_4.988479	282	362	0	80	80	1.0000000
NODE_34600_length_533_cov_3.638249	201	265	5	20	64	0.3125000
NODE_34600_length_533_cov_3.638249	201	265	6	27	64	0.4218750
NODE_34600_length_533_cov_3.638249	201	265	7	14	64	0.2187500
NODE_34600_length_533_cov_3.638249	201	265	8	3	64	0.0468750
NODE_34603_length_533_cov_3.511521	138	218	0	79	80	0.9875000
NODE_34603_length_533_cov_3.511521	138	218	2	1	80	0.0125000
NODE_34615_length_533_cov_3.073733	294	340	0	46	46	1.0000000
NODE_34617_length_533_cov_3.052995	256	304	0	48	48	1.0000000
NODE_34631_length_533_cov_2.366359	229	311	0	82	82	1.0000000
NODE_34635_length_533_cov_2.288018	468	490	0	22	22	1.0000000
NODE_34767_length_532_cov_73.279446	0	64	0	20	64	0.3125000
NODE_34767_length_532_cov_73.279446	0	64	2	8	64	0.1250000
NODE_34767_length_532_cov_73.279446	0	64	4	36	64	0.5625000
NODE_34768_length_532_cov_23.055427	168	248	2	16	80	0.2000000
NODE_34768_length_532_cov_23.055427	168	248	4	63	80	0.7875000
NODE_34768_length_532_cov_23.055427	168	248	6	1	80	0.0125000
NODE_34768_length_532_cov_23.055427	221	301	2	4	80	0.0500000
NODE_34768_length_532_cov_23.055427	221	301	4	75	80	0.9375000
NODE_34768_length_532_cov_23.055427	221	301	6	1	80	0.0125000
NODE_34769_length_532_cov_22.778291	256	336	0	7	80	0.0875000
NODE_34769_length_532_cov_22.778291	256	336	2	5	80	0.0625000
NODE_34769_length_532_cov_22.778291	256	336	4	21	80	0.2625000
NODE_34769_length_532_cov_22.778291	256	336	11	47	80	0.5875000
NODE_34769_length_532_cov_22.778291	309	389	6	2	80	0.0250000
NODE_34769_length_532_cov_22.778291	309	389	7	34	80	0.4250000
NODE_34769_length_532_cov_22.778291	309	389	9	9	80	0.1125000
NODE_34769_length_532_cov_22.778291	309	389	11	35	80	0.4375000
NODE_34770_length_532_cov_13.279446	85	165	0	80	80	1.0000000
NODE_34770_length_532_cov_13.279446	138	218	0	80	80	1.0000000
NODE_34774_length_532_cov_7.591224	171	235	0	16	64	0.2500000
NODE_34774_length_532_cov_7.591224	171	235	2	48	64	0.7500000
NODE_34774_length_532_cov_7.591224	172	235	0	15	63	0.2380952
NODE_34774_length_532_cov_7.591224	172	235	2	48	63	0.7619048
NODE_34774_length_532_cov_7.591224	173	226	0	14	53	0.2641509
NODE_34774_length_532_cov_7.591224	173	226	2	39	53	0.7358491
NODE_34774_length_532_cov_7.591224	173	228	0	14	55	0.2545455
NODE_34774_length_532_cov_7.591224	173	228	2	41	55	0.7454545
NODE_34774_length_532_cov_7.591224	208	282	0	2	74	0.0270270
NODE_34774_length_532_cov_7.591224	208	282	2	72	74	0.9729730
NODE_34774_length_532_cov_7.591224	208	282	0	2	74	0.0270270
NODE_34774_length_532_cov_7.591224	208	282	2	72	74	0.9729730
NODE_34774_length_532_cov_7.591224	208	282	0	2	74	0.0270270
NODE_34774_length_532_cov_7.591224	208	282	2	72	74	0.9729730
NODE_34774_length_532_cov_7.591224	208	282	0	2	74	0.0270270
NODE_34774_length_532_cov_7.591224	208	282	2	72	74	0.9729730
NODE_34788_length_532_cov_4.524249	84	151	0	67	67	1.0000000
NODE_34788_length_532_cov_4.524249	137	218	0	81	81	1.0000000
NODE_34838_length_532_cov_1.866051	263	309	0	46	46	1.0000000
NODE_34845_length_532_cov_1.757506	126	146	0	20	20	1.0000000
NODE_34948_length_531_cov_35.539352	7	45	0	38	38	1.0000000
NODE_34948_length_531_cov_35.539352	18	98	0	80	80	1.0000000
NODE_34949_length_531_cov_13.162037	129	209	0	80	80	1.0000000
NODE_34949_length_531_cov_13.162037	182	251	0	69	69	1.0000000
NODE_34953_length_531_cov_6.821759	242	322	0	80	80	1.0000000
NODE_34953_length_531_cov_6.821759	295	375	0	59	80	0.7375000
NODE_34953_length_531_cov_6.821759	295	375	2	21	80	0.2625000
NODE_34958_length_531_cov_5.261574	261	336	14	22	75	0.2933333
NODE_34958_length_531_cov_5.261574	261	336	16	6	75	0.0800000
NODE_34958_length_531_cov_5.261574	261	336	18	2	75	0.0266667
NODE_34958_length_531_cov_5.261574	261	336	20	41	75	0.5466667
NODE_34958_length_531_cov_5.261574	261	336	22	4	75	0.0533333
NODE_34958_length_531_cov_5.261574	309	362	4	1	53	0.0188679
NODE_34958_length_531_cov_5.261574	309	362	6	3	53	0.0566038
NODE_34958_length_531_cov_5.261574	309	362	10	21	53	0.3962264
NODE_34958_length_531_cov_5.261574	309	362	12	1	53	0.0188679
NODE_34958_length_531_cov_5.261574	309	362	14	5	53	0.0943396
NODE_34958_length_531_cov_5.261574	309	362	16	6	53	0.1132075
NODE_34958_length_531_cov_5.261574	309	362	20	16	53	0.3018868
NODE_34963_length_531_cov_4.527778	177	255	0	78	78	1.0000000
NODE_34965_length_531_cov_4.319444	283	363	0	80	80	1.0000000
NODE_34965_length_531_cov_4.319444	336	416	0	80	80	1.0000000
NODE_34979_length_531_cov_3.488426	238	318	0	80	80	1.0000000
NODE_34979_length_531_cov_3.488426	291	371	0	80	80	1.0000000
NODE_34980_length_531_cov_3.375000	153	207	0	11	54	0.2037037
NODE_34980_length_531_cov_3.375000	153	207	2	9	54	0.1666667
NODE_34980_length_531_cov_3.375000	153	207	3	1	54	0.0185185
NODE_34980_length_531_cov_3.375000	153	207	5	1	54	0.0185185
NODE_34980_length_531_cov_3.375000	153	207	6	25	54	0.4629630
NODE_34980_length_531_cov_3.375000	153	207	8	7	54	0.1296296
NODE_34980_length_531_cov_3.375000	180	260	6	20	80	0.2500000
NODE_34980_length_531_cov_3.375000	180	260	8	24	80	0.3000000
NODE_34980_length_531_cov_3.375000	180	260	10	36	80	0.4500000
NODE_34986_length_531_cov_3.111111	243	323	0	80	80	1.0000000
NODE_34986_length_531_cov_3.111111	296	376	0	80	80	1.0000000
NODE_35008_length_531_cov_2.201389	302	373	0	18	71	0.2535211
NODE_35008_length_531_cov_2.201389	302	373	2	53	71	0.7464789
NODE_35008_length_531_cov_2.201389	350	426	0	9	76	0.1184211
NODE_35008_length_531_cov_2.201389	350	426	2	67	76	0.8815789
NODE_35141_length_530_cov_30.605568	250	330	0	11	80	0.1375000
NODE_35141_length_530_cov_30.605568	250	330	2	12	80	0.1500000
NODE_35141_length_530_cov_30.605568	250	330	6	15	80	0.1875000
NODE_35141_length_530_cov_30.605568	250	330	8	9	80	0.1125000
NODE_35141_length_530_cov_30.605568	250	330	12	33	80	0.4125000
NODE_35141_length_530_cov_30.605568	303	383	4	15	80	0.1875000
NODE_35141_length_530_cov_30.605568	303	383	6	7	80	0.0875000
NODE_35141_length_530_cov_30.605568	303	383	10	10	80	0.1250000
NODE_35141_length_530_cov_30.605568	303	383	12	48	80	0.6000000
NODE_35142_length_530_cov_16.937355	404	484	2	3	80	0.0375000
NODE_35142_length_530_cov_16.937355	404	484	4	3	80	0.0375000
NODE_35142_length_530_cov_16.937355	404	484	8	1	80	0.0125000
NODE_35142_length_530_cov_16.937355	404	484	14	5	80	0.0625000
NODE_35142_length_530_cov_16.937355	404	484	16	68	80	0.8500000
NODE_35142_length_530_cov_16.937355	457	530	0	8	73	0.1095890
NODE_35142_length_530_cov_16.937355	457	530	2	2	73	0.0273973
NODE_35142_length_530_cov_16.937355	457	530	8	10	73	0.1369863
NODE_35142_length_530_cov_16.937355	457	530	10	2	73	0.0273973
NODE_35142_length_530_cov_16.937355	457	530	14	3	73	0.0410959
NODE_35142_length_530_cov_16.937355	457	530	16	48	73	0.6575342
NODE_35143_length_530_cov_9.902552	273	353	0	80	80	1.0000000
NODE_35143_length_530_cov_9.902552	326	406	0	80	80	1.0000000
NODE_35144_length_530_cov_7.928074	46	126	0	80	80	1.0000000
NODE_35144_length_530_cov_7.928074	99	179	0	80	80	1.0000000
NODE_35150_length_530_cov_4.647332	188	268	0	20	80	0.2500000
NODE_35150_length_530_cov_4.647332	188	268	1	60	80	0.7500000
NODE_35150_length_530_cov_4.647332	241	321	1	29	80	0.3625000
NODE_35150_length_530_cov_4.647332	241	321	2	51	80	0.6375000
NODE_35154_length_530_cov_4.389791	162	242	8	3	80	0.0375000
NODE_35154_length_530_cov_4.389791	162	242	10	10	80	0.1250000
NODE_35154_length_530_cov_4.389791	162	242	12	4	80	0.0500000
NODE_35154_length_530_cov_4.389791	162	242	14	12	80	0.1500000
NODE_35154_length_530_cov_4.389791	162	242	18	6	80	0.0750000
NODE_35154_length_530_cov_4.389791	162	242	20	1	80	0.0125000
NODE_35154_length_530_cov_4.389791	162	242	22	13	80	0.1625000
NODE_35154_length_530_cov_4.389791	162	242	24	10	80	0.1250000
NODE_35154_length_530_cov_4.389791	162	242	26	6	80	0.0750000
NODE_35154_length_530_cov_4.389791	162	242	28	2	80	0.0250000
NODE_35154_length_530_cov_4.389791	162	242	30	1	80	0.0125000
NODE_35154_length_530_cov_4.389791	162	242	31	7	80	0.0875000
NODE_35154_length_530_cov_4.389791	162	242	32	3	80	0.0375000
NODE_35154_length_530_cov_4.389791	162	242	33	2	80	0.0250000
NODE_35159_length_530_cov_4.046404	76	111	0	2	35	0.0571429
NODE_35159_length_530_cov_4.046404	76	111	2	33	35	0.9428571
NODE_35319_length_529_cov_38.983721	140	220	8	11	80	0.1375000
NODE_35319_length_529_cov_38.983721	140	220	10	1	80	0.0125000
NODE_35319_length_529_cov_38.983721	140	220	12	22	80	0.2750000
NODE_35319_length_529_cov_38.983721	140	220	14	13	80	0.1625000
NODE_35319_length_529_cov_38.983721	140	220	15	6	80	0.0750000
NODE_35319_length_529_cov_38.983721	140	220	17	27	80	0.3375000
NODE_35320_length_529_cov_18.223256	189	269	0	12	80	0.1500000
NODE_35320_length_529_cov_18.223256	189	269	2	68	80	0.8500000
NODE_35320_length_529_cov_18.223256	242	322	0	65	80	0.8125000
NODE_35320_length_529_cov_18.223256	242	322	2	15	80	0.1875000
NODE_35321_length_529_cov_17.009302	358	438	4	5	80	0.0625000
NODE_35321_length_529_cov_17.009302	358	438	8	16	80	0.2000000
NODE_35321_length_529_cov_17.009302	358	438	10	59	80	0.7375000
NODE_35321_length_529_cov_17.009302	411	491	0	10	80	0.1250000
NODE_35321_length_529_cov_17.009302	411	491	2	26	80	0.3250000
NODE_35321_length_529_cov_17.009302	411	491	4	12	80	0.1500000
NODE_35321_length_529_cov_17.009302	411	491	8	20	80	0.2500000
NODE_35321_length_529_cov_17.009302	411	491	10	12	80	0.1500000
NODE_35331_length_529_cov_6.195349	211	291	0	37	80	0.4625000
NODE_35331_length_529_cov_6.195349	211	291	2	43	80	0.5375000
NODE_35331_length_529_cov_6.195349	264	322	2	58	58	1.0000000
NODE_35336_length_529_cov_5.176744	139	207	0	58	68	0.8529412
NODE_35336_length_529_cov_5.176744	139	207	2	10	68	0.1470588
NODE_35336_length_529_cov_5.176744	185	260	0	12	75	0.1600000
NODE_35336_length_529_cov_5.176744	185	260	2	63	75	0.8400000
NODE_35364_length_529_cov_2.883721	223	281	0	31	58	0.5344828
NODE_35364_length_529_cov_2.883721	223	281	2	23	58	0.3965517
NODE_35364_length_529_cov_2.883721	223	281	4	4	58	0.0689655
NODE_35374_length_529_cov_2.660465	89	168	0	34	79	0.4303797
NODE_35374_length_529_cov_2.660465	89	168	2	45	79	0.5696203
NODE_35375_length_529_cov_2.595349	278	321	0	3	43	0.0697674
NODE_35375_length_529_cov_2.595349	278	321	2	40	43	0.9302326
NODE_35384_length_529_cov_2.272093	247	313	0	66	66	1.0000000
NODE_35427_length_529_cov_1.597674	289	332	0	43	43	1.0000000
NODE_35521_length_528_cov_25.808858	233	313	0	48	80	0.6000000
NODE_35521_length_528_cov_25.808858	233	313	2	5	80	0.0625000
NODE_35521_length_528_cov_25.808858	233	313	4	27	80	0.3375000
NODE_35521_length_528_cov_25.808858	286	366	0	80	80	1.0000000
NODE_35522_length_528_cov_17.331002	219	299	0	11	80	0.1375000
NODE_35522_length_528_cov_17.331002	219	299	2	69	80	0.8625000
NODE_35522_length_528_cov_17.331002	272	352	0	15	80	0.1875000
NODE_35522_length_528_cov_17.331002	272	352	2	65	80	0.8125000
NODE_35523_length_528_cov_16.165501	262	342	0	80	80	1.0000000
NODE_35523_length_528_cov_16.165501	315	395	0	80	80	1.0000000
NODE_35529_length_528_cov_5.776224	204	284	0	54	80	0.6750000
NODE_35529_length_528_cov_5.776224	204	284	2	26	80	0.3250000
NODE_35529_length_528_cov_5.776224	257	337	0	1	80	0.0125000
NODE_35529_length_528_cov_5.776224	257	337	2	79	80	0.9875000
NODE_35542_length_528_cov_4.016317	235	315	0	80	80	1.0000000
NODE_35542_length_528_cov_4.016317	288	368	0	80	80	1.0000000
NODE_35545_length_528_cov_3.799534	144	192	0	48	48	1.0000000
NODE_35561_length_528_cov_2.902098	252	305	4	31	53	0.5849057
NODE_35561_length_528_cov_2.902098	252	305	6	22	53	0.4150943
NODE_35575_length_528_cov_2.324009	137	188	0	2	51	0.0392157
NODE_35575_length_528_cov_2.324009	137	188	2	49	51	0.9607843
NODE_35575_length_528_cov_2.324009	161	241	0	55	80	0.6875000
NODE_35575_length_528_cov_2.324009	161	241	2	25	80	0.3125000
NODE_35597_length_528_cov_1.755245	268	348	2	21	80	0.2625000
NODE_35597_length_528_cov_1.755245	268	348	6	38	80	0.4750000
NODE_35597_length_528_cov_1.755245	268	348	8	21	80	0.2625000
NODE_35597_length_528_cov_1.755245	321	401	0	49	80	0.6125000
NODE_35597_length_528_cov_1.755245	321	401	2	25	80	0.3125000
NODE_35597_length_528_cov_1.755245	321	401	6	6	80	0.0750000
NODE_35687_length_527_cov_19.247664	306	386	0	80	80	1.0000000
NODE_35687_length_527_cov_19.247664	359	439	0	80	80	1.0000000
NODE_35688_length_527_cov_15.974299	250	349	0	99	99	1.0000000
NODE_35688_length_527_cov_15.974299	322	402	0	80	80	1.0000000
NODE_35691_length_527_cov_8.221963	235	315	0	67	80	0.8375000
NODE_35691_length_527_cov_8.221963	235	315	2	2	80	0.0250000
NODE_35691_length_527_cov_8.221963	235	315	4	1	80	0.0125000
NODE_35691_length_527_cov_8.221963	235	315	6	1	80	0.0125000
NODE_35691_length_527_cov_8.221963	235	315	8	6	80	0.0750000
NODE_35691_length_527_cov_8.221963	235	315	10	3	80	0.0375000
NODE_35691_length_527_cov_8.221963	288	368	0	14	80	0.1750000
NODE_35691_length_527_cov_8.221963	288	368	2	2	80	0.0250000
NODE_35691_length_527_cov_8.221963	288	368	4	1	80	0.0125000
NODE_35691_length_527_cov_8.221963	288	368	6	1	80	0.0125000
NODE_35691_length_527_cov_8.221963	288	368	8	6	80	0.0750000
NODE_35691_length_527_cov_8.221963	288	368	10	8	80	0.1000000
NODE_35691_length_527_cov_8.221963	288	368	12	48	80	0.6000000
NODE_35693_length_527_cov_7.200935	190	270	0	80	80	1.0000000
NODE_35693_length_527_cov_7.200935	243	346	0	103	103	1.0000000
NODE_35693_length_527_cov_7.200935	342	422	0	80	80	1.0000000
NODE_35693_length_527_cov_7.200935	395	475	0	80	80	1.0000000
NODE_35696_length_527_cov_6.862150	279	359	0	80	80	1.0000000
NODE_35697_length_527_cov_6.046729	155	235	0	80	80	1.0000000
NODE_35697_length_527_cov_6.046729	208	288	0	80	80	1.0000000
NODE_35736_length_527_cov_2.238318	226	306	0	16	80	0.2000000
NODE_35736_length_527_cov_2.238318	226	306	2	64	80	0.8000000
NODE_35858_length_526_cov_50.866511	169	242	0	73	73	1.0000000
NODE_35858_length_526_cov_50.866511	215	295	0	80	80	1.0000000
NODE_35858_length_526_cov_50.866511	291	371	0	42	80	0.5250000
NODE_35858_length_526_cov_50.866511	291	371	2	38	80	0.4750000
NODE_35858_length_526_cov_50.866511	344	424	0	24	80	0.3000000
NODE_35858_length_526_cov_50.866511	344	424	2	56	80	0.7000000
NODE_35860_length_526_cov_26.395785	315	395	6	50	80	0.6250000
NODE_35860_length_526_cov_26.395785	315	395	8	30	80	0.3750000
NODE_35860_length_526_cov_26.395785	368	448	0	18	80	0.2250000
NODE_35860_length_526_cov_26.395785	368	448	2	18	80	0.2250000
NODE_35860_length_526_cov_26.395785	368	448	4	14	80	0.1750000
NODE_35860_length_526_cov_26.395785	368	448	6	30	80	0.3750000
NODE_35861_length_526_cov_16.611241	305	385	0	80	80	1.0000000
NODE_35861_length_526_cov_16.611241	358	438	0	80	80	1.0000000
NODE_35866_length_526_cov_6.215457	303	351	4	48	48	1.0000000
NODE_35877_length_526_cov_3.936768	118	142	0	24	24	1.0000000
NODE_35877_length_526_cov_3.936768	118	163	0	45	45	1.0000000
NODE_35901_length_526_cov_2.466042	138	184	2	46	46	1.0000000
NODE_36055_length_525_cov_33.910798	98	178	0	39	80	0.4875000
NODE_36055_length_525_cov_33.910798	98	178	2	14	80	0.1750000
NODE_36055_length_525_cov_33.910798	98	178	4	9	80	0.1125000
NODE_36055_length_525_cov_33.910798	98	178	5	7	80	0.0875000
NODE_36055_length_525_cov_33.910798	98	178	6	11	80	0.1375000
NODE_36055_length_525_cov_33.910798	151	231	2	15	80	0.1875000
NODE_36055_length_525_cov_33.910798	151	231	4	10	80	0.1250000
NODE_36055_length_525_cov_33.910798	151	231	5	7	80	0.0875000
NODE_36055_length_525_cov_33.910798	151	231	6	48	80	0.6000000
NODE_36055_length_525_cov_33.910798	159	231	2	11	72	0.1527778
NODE_36055_length_525_cov_33.910798	159	231	4	6	72	0.0833333
NODE_36055_length_525_cov_33.910798	159	231	5	7	72	0.0972222
NODE_36055_length_525_cov_33.910798	159	231	6	48	72	0.6666667
NODE_36058_length_525_cov_8.788732	175	255	0	80	80	1.0000000
NODE_36058_length_525_cov_8.788732	228	308	0	80	80	1.0000000
NODE_36059_length_525_cov_7.880282	242	285	0	43	43	1.0000000
NODE_36098_length_525_cov_2.417840	229	306	0	3	77	0.0389610
NODE_36098_length_525_cov_2.417840	229	306	6	74	77	0.9610389
NODE_36230_length_524_cov_21.649412	262	342	2	80	80	1.0000000
NODE_36230_length_524_cov_21.649412	315	395	0	47	80	0.5875000
NODE_36230_length_524_cov_21.649412	315	395	2	33	80	0.4125000
NODE_36231_length_524_cov_14.131765	136	201	0	65	65	1.0000000
NODE_36232_length_524_cov_10.392941	237	317	0	45	80	0.5625000
NODE_36232_length_524_cov_10.392941	237	317	2	35	80	0.4375000
NODE_36232_length_524_cov_10.392941	290	370	2	80	80	1.0000000
NODE_36262_length_524_cov_3.221176	195	272	0	77	77	1.0000000
NODE_36262_length_524_cov_3.221176	253	324	0	71	71	1.0000000
NODE_36264_length_524_cov_3.148235	317	397	0	46	80	0.5750000
NODE_36264_length_524_cov_3.148235	317	397	2	34	80	0.4250000
NODE_36410_length_523_cov_113.438679	0	48	0	48	48	1.0000000
NODE_36410_length_523_cov_113.438679	14	69	0	55	55	1.0000000
NODE_36410_length_523_cov_113.438679	25	101	0	76	76	1.0000000
NODE_36410_length_523_cov_113.438679	105	181	0	21	76	0.2763158
NODE_36410_length_523_cov_113.438679	105	181	2	5	76	0.0657895
NODE_36410_length_523_cov_113.438679	105	181	6	7	76	0.0921053
NODE_36410_length_523_cov_113.438679	105	181	8	1	76	0.0131579
NODE_36410_length_523_cov_113.438679	105	181	13	12	76	0.1578947
NODE_36410_length_523_cov_113.438679	105	181	15	3	76	0.0394737
NODE_36410_length_523_cov_113.438679	105	181	17	1	76	0.0131579
NODE_36410_length_523_cov_113.438679	105	181	20	12	76	0.1578947
NODE_36410_length_523_cov_113.438679	105	181	22	11	76	0.1447368
NODE_36410_length_523_cov_113.438679	105	181	24	3	76	0.0394737
NODE_36410_length_523_cov_113.438679	154	234	17	1	80	0.0125000
NODE_36410_length_523_cov_113.438679	154	234	20	14	80	0.1750000
NODE_36410_length_523_cov_113.438679	154	234	22	18	80	0.2250000
NODE_36410_length_523_cov_113.438679	154	234	24	7	80	0.0875000
NODE_36410_length_523_cov_113.438679	154	234	26	10	80	0.1250000
NODE_36410_length_523_cov_113.438679	154	234	28	2	80	0.0250000
NODE_36410_length_523_cov_113.438679	154	234	30	9	80	0.1125000
NODE_36410_length_523_cov_113.438679	154	234	32	13	80	0.1625000
NODE_36410_length_523_cov_113.438679	154	234	34	6	80	0.0750000
NODE_36410_length_523_cov_113.438679	312	355	2	42	43	0.9767442
NODE_36410_length_523_cov_113.438679	312	355	6	1	43	0.0232558
NODE_36412_length_523_cov_64.695755	35	115	0	80	80	1.0000000
NODE_36412_length_523_cov_64.695755	88	168	0	80	80	1.0000000
NODE_36414_length_523_cov_20.724057	235	315	2	80	80	1.0000000
NODE_36414_length_523_cov_20.724057	288	368	0	27	80	0.3375000
NODE_36414_length_523_cov_20.724057	288	368	1	13	80	0.1625000
NODE_36414_length_523_cov_20.724057	288	368	2	40	80	0.5000000
NODE_36415_length_523_cov_18.500000	164	244	0	80	80	1.0000000
NODE_36415_length_523_cov_18.500000	217	297	0	80	80	1.0000000
NODE_36416_length_523_cov_15.216981	62	142	0	21	80	0.2625000
NODE_36416_length_523_cov_15.216981	62	142	2	25	80	0.3125000
NODE_36416_length_523_cov_15.216981	62	142	4	34	80	0.4250000
NODE_36416_length_523_cov_15.216981	115	195	0	11	80	0.1375000
NODE_36416_length_523_cov_15.216981	115	195	2	1	80	0.0125000
NODE_36416_length_523_cov_15.216981	115	195	4	68	80	0.8500000
NODE_36417_length_523_cov_10.575472	157	183	0	26	26	1.0000000
NODE_36418_length_523_cov_9.962264	212	292	0	12	80	0.1500000
NODE_36418_length_523_cov_9.962264	212	292	4	68	80	0.8500000
NODE_36418_length_523_cov_9.962264	265	345	0	16	80	0.2000000
NODE_36418_length_523_cov_9.962264	265	345	3	1	80	0.0125000
NODE_36418_length_523_cov_9.962264	265	345	4	63	80	0.7875000
NODE_36427_length_523_cov_4.943396	108	188	6	2	80	0.0250000
NODE_36427_length_523_cov_4.943396	108	188	8	12	80	0.1500000
NODE_36427_length_523_cov_4.943396	108	188	9	1	80	0.0125000
NODE_36427_length_523_cov_4.943396	108	188	10	35	80	0.4375000
NODE_36427_length_523_cov_4.943396	108	188	12	27	80	0.3375000
NODE_36427_length_523_cov_4.943396	108	188	14	3	80	0.0375000
NODE_36427_length_523_cov_4.943396	161	241	10	8	80	0.1000000
NODE_36427_length_523_cov_4.943396	161	241	11	7	80	0.0875000
NODE_36427_length_523_cov_4.943396	161	241	12	46	80	0.5750000
NODE_36427_length_523_cov_4.943396	161	241	13	1	80	0.0125000
NODE_36427_length_523_cov_4.943396	161	241	14	18	80	0.2250000
NODE_36429_length_523_cov_4.787736	110	141	12	2	31	0.0645161
NODE_36429_length_523_cov_4.787736	110	141	14	5	31	0.1612903
NODE_36429_length_523_cov_4.787736	110	141	16	2	31	0.0645161
NODE_36429_length_523_cov_4.787736	110	141	18	3	31	0.0967742
NODE_36429_length_523_cov_4.787736	110	141	20	3	31	0.0967742
NODE_36429_length_523_cov_4.787736	110	141	22	16	31	0.5161290
NODE_36429_length_523_cov_4.787736	131	194	10	1	63	0.0158730
NODE_36429_length_523_cov_4.787736	131	194	12	4	63	0.0634921
NODE_36429_length_523_cov_4.787736	131	194	16	7	63	0.1111111
NODE_36429_length_523_cov_4.787736	131	194	18	9	63	0.1428571
NODE_36429_length_523_cov_4.787736	131	194	20	17	63	0.2698413
NODE_36429_length_523_cov_4.787736	131	194	22	25	63	0.3968254
NODE_36439_length_523_cov_3.792453	139	219	0	80	80	1.0000000
NODE_36439_length_523_cov_3.792453	192	272	0	80	80	1.0000000
NODE_36481_length_523_cov_2.259434	337	372	0	35	35	1.0000000
NODE_36490_length_523_cov_2.096698	307	351	0	5	44	0.1136364
NODE_36490_length_523_cov_2.096698	307	351	2	3	44	0.0681818
NODE_36490_length_523_cov_2.096698	307	351	4	1	44	0.0227273
NODE_36490_length_523_cov_2.096698	307	351	6	7	44	0.1590909
NODE_36490_length_523_cov_2.096698	307	351	8	11	44	0.2500000
NODE_36490_length_523_cov_2.096698	307	351	9	1	44	0.0227273
NODE_36490_length_523_cov_2.096698	307	351	11	3	44	0.0681818
NODE_36490_length_523_cov_2.096698	307	351	15	13	44	0.2954545
NODE_36518_length_523_cov_1.700472	176	195	0	5	19	0.2631579
NODE_36518_length_523_cov_1.700472	176	195	2	14	19	0.7368421
NODE_36632_length_522_cov_33.579196	55	135	0	71	80	0.8875000
NODE_36632_length_522_cov_33.579196	55	135	3	1	80	0.0125000
NODE_36632_length_522_cov_33.579196	55	135	4	8	80	0.1000000
NODE_36632_length_522_cov_33.579196	108	188	0	18	80	0.2250000
NODE_36632_length_522_cov_33.579196	108	188	3	1	80	0.0125000
NODE_36632_length_522_cov_33.579196	108	188	4	60	80	0.7500000
NODE_36632_length_522_cov_33.579196	108	188	6	1	80	0.0125000
NODE_36634_length_522_cov_12.851064	266	342	0	76	76	1.0000000
NODE_36634_length_522_cov_12.851064	319	395	0	76	76	1.0000000
NODE_36637_length_522_cov_7.349882	212	283	0	71	71	1.0000000
NODE_36637_length_522_cov_7.349882	400	469	0	69	69	1.0000000
NODE_36670_length_522_cov_2.933806	178	258	0	80	80	1.0000000
NODE_36670_length_522_cov_2.933806	231	311	0	80	80	1.0000000
NODE_36676_length_522_cov_2.661939	187	241	0	54	54	1.0000000
NODE_36820_length_521_cov_9.303318	106	186	0	80	80	1.0000000
NODE_36820_length_521_cov_9.303318	159	239	0	80	80	1.0000000
NODE_36832_length_521_cov_4.971564	218	298	0	80	80	1.0000000
NODE_36832_length_521_cov_4.971564	271	351	0	80	80	1.0000000
NODE_36845_length_521_cov_3.504739	113	191	0	9	78	0.1153846
NODE_36845_length_521_cov_3.504739	113	191	2	3	78	0.0384615
NODE_36845_length_521_cov_3.504739	113	191	4	66	78	0.8461539
NODE_36845_length_521_cov_3.504739	164	205	0	23	41	0.5609756
NODE_36845_length_521_cov_3.504739	164	205	2	3	41	0.0731707
NODE_36845_length_521_cov_3.504739	164	205	4	15	41	0.3658537
NODE_36848_length_521_cov_3.324645	158	244	0	86	86	1.0000000
NODE_36848_length_521_cov_3.324645	217	280	0	63	63	1.0000000
NODE_36916_length_521_cov_1.613744	165	227	2	16	62	0.2580645
NODE_36916_length_521_cov_1.613744	165	227	4	46	62	0.7419355
NODE_37036_length_520_cov_50.676960	0	75	0	75	75	1.0000000
NODE_37036_length_520_cov_50.676960	48	128	0	80	80	1.0000000
NODE_37036_length_520_cov_50.676960	124	204	0	5	80	0.0625000
NODE_37036_length_520_cov_50.676960	124	204	4	75	80	0.9375000
NODE_37036_length_520_cov_50.676960	177	257	0	41	80	0.5125000
NODE_37036_length_520_cov_50.676960	177	257	4	39	80	0.4875000
NODE_37037_length_520_cov_43.294537	10	90	0	80	80	1.0000000
NODE_37037_length_520_cov_43.294537	10	90	0	80	80	1.0000000
NODE_37037_length_520_cov_43.294537	10	90	0	80	80	1.0000000
NODE_37037_length_520_cov_43.294537	10	90	0	80	80	1.0000000
NODE_37037_length_520_cov_43.294537	10	90	0	80	80	1.0000000
NODE_37037_length_520_cov_43.294537	10	90	0	80	80	1.0000000
NODE_37037_length_520_cov_43.294537	63	129	0	66	66	1.0000000
NODE_37037_length_520_cov_43.294537	63	142	0	79	79	1.0000000
NODE_37037_length_520_cov_43.294537	63	143	0	80	80	1.0000000
NODE_37037_length_520_cov_43.294537	63	133	0	70	70	1.0000000
NODE_37037_length_520_cov_43.294537	66	133	0	67	67	1.0000000
NODE_37037_length_520_cov_43.294537	68	143	0	75	75	1.0000000
NODE_37038_length_520_cov_29.427553	224	304	0	80	80	1.0000000
NODE_37038_length_520_cov_29.427553	277	357	0	80	80	1.0000000
NODE_37038_length_520_cov_29.427553	353	433	0	80	80	1.0000000
NODE_37038_length_520_cov_29.427553	406	486	0	80	80	1.0000000
NODE_37039_length_520_cov_14.365796	103	183	0	80	80	1.0000000
NODE_37039_length_520_cov_14.365796	156	237	0	81	81	1.0000000
NODE_37059_length_520_cov_4.121140	79	159	0	80	80	1.0000000
NODE_37059_length_520_cov_4.121140	132	212	0	80	80	1.0000000
NODE_37063_length_520_cov_3.900238	203	233	2	30	30	1.0000000
NODE_37235_length_519_cov_42.842857	8	88	0	12	80	0.1500000
NODE_37235_length_519_cov_42.842857	8	88	4	6	80	0.0750000
NODE_37235_length_519_cov_42.842857	8	88	6	7	80	0.0875000
NODE_37235_length_519_cov_42.842857	8	88	8	55	80	0.6875000
NODE_37235_length_519_cov_42.842857	61	139	2	6	78	0.0769231
NODE_37235_length_519_cov_42.842857	61	139	4	4	78	0.0512821
NODE_37235_length_519_cov_42.842857	61	139	6	2	78	0.0256410
NODE_37235_length_519_cov_42.842857	61	139	8	66	78	0.8461539
NODE_37236_length_519_cov_19.269048	284	363	0	62	79	0.7848101
NODE_37236_length_519_cov_19.269048	284	363	2	17	79	0.2151899
NODE_37236_length_519_cov_19.269048	336	416	0	15	80	0.1875000
NODE_37236_length_519_cov_19.269048	336	416	2	65	80	0.8125000
NODE_37237_length_519_cov_8.500000	195	267	2	4	72	0.0555556
NODE_37237_length_519_cov_8.500000	195	267	4	49	72	0.6805556
NODE_37237_length_519_cov_8.500000	195	267	6	9	72	0.1250000
NODE_37237_length_519_cov_8.500000	195	267	8	10	72	0.1388889
NODE_37245_length_519_cov_5.169048	282	346	0	15	64	0.2343750
NODE_37245_length_519_cov_5.169048	282	346	2	49	64	0.7656250
NODE_37290_length_519_cov_2.783333	174	235	0	61	61	1.0000000
NODE_37349_length_519_cov_1.538095	147	213	0	66	66	1.0000000
NODE_37447_length_518_cov_40.026253	385	465	6	21	80	0.2625000
NODE_37447_length_518_cov_40.026253	385	465	8	59	80	0.7375000
NODE_37447_length_518_cov_40.026253	438	518	0	15	80	0.1875000
NODE_37447_length_518_cov_40.026253	438	518	2	23	80	0.2875000
NODE_37447_length_518_cov_40.026253	438	518	4	14	80	0.1750000
NODE_37447_length_518_cov_40.026253	438	518	6	12	80	0.1500000
NODE_37447_length_518_cov_40.026253	438	518	8	16	80	0.2000000
NODE_37449_length_518_cov_12.083532	144	224	0	80	80	1.0000000
NODE_37449_length_518_cov_12.083532	197	277	0	80	80	1.0000000
NODE_37449_length_518_cov_12.083532	407	481	0	74	74	1.0000000
NODE_37449_length_518_cov_12.083532	454	518	0	64	64	1.0000000
NODE_37450_length_518_cov_11.467780	171	200	0	29	29	1.0000000
NODE_37450_length_518_cov_11.467780	253	320	0	67	67	1.0000000
NODE_37450_length_518_cov_11.467780	253	282	0	29	29	1.0000000
NODE_37454_length_518_cov_7.441527	188	273	0	85	85	1.0000000
NODE_37461_length_518_cov_5.563246	315	366	0	37	51	0.7254902
NODE_37461_length_518_cov_5.563246	315	366	2	4	51	0.0784314
NODE_37461_length_518_cov_5.563246	315	366	4	10	51	0.1960784
NODE_37461_length_518_cov_5.563246	339	383	0	13	44	0.2954545
NODE_37461_length_518_cov_5.563246	339	383	2	4	44	0.0909091
NODE_37461_length_518_cov_5.563246	339	383	4	27	44	0.6136364
NODE_37465_length_518_cov_4.732697	214	276	0	62	62	1.0000000
NODE_37465_length_518_cov_4.732697	350	430	0	80	80	1.0000000
NODE_37479_length_518_cov_3.503580	291	333	4	42	42	1.0000000
NODE_37479_length_518_cov_3.503580	306	363	2	6	57	0.1052632
NODE_37479_length_518_cov_3.503580	306	363	4	51	57	0.8947368
NODE_37483_length_518_cov_3.136038	269	338	0	20	69	0.2898551
NODE_37483_length_518_cov_3.136038	269	338	6	4	69	0.0579710
NODE_37483_length_518_cov_3.136038	269	338	8	41	69	0.5942029
NODE_37483_length_518_cov_3.136038	269	338	10	4	69	0.0579710
NODE_37483_length_518_cov_3.136038	269	348	0	20	79	0.2531646
NODE_37483_length_518_cov_3.136038	269	348	6	4	79	0.0506329
NODE_37483_length_518_cov_3.136038	269	348	8	41	79	0.5189874
NODE_37483_length_518_cov_3.136038	269	348	10	14	79	0.1772152
NODE_37483_length_518_cov_3.136038	269	349	0	20	80	0.2500000
NODE_37483_length_518_cov_3.136038	269	349	6	4	80	0.0500000
NODE_37483_length_518_cov_3.136038	269	349	8	41	80	0.5125000
NODE_37483_length_518_cov_3.136038	269	349	10	15	80	0.1875000
NODE_37483_length_518_cov_3.136038	322	402	2	21	80	0.2625000
NODE_37483_length_518_cov_3.136038	322	402	6	19	80	0.2375000
NODE_37483_length_518_cov_3.136038	322	402	8	15	80	0.1875000
NODE_37483_length_518_cov_3.136038	322	402	10	25	80	0.3125000
NODE_37483_length_518_cov_3.136038	322	364	6	2	42	0.0476190
NODE_37483_length_518_cov_3.136038	322	364	8	15	42	0.3571429
NODE_37483_length_518_cov_3.136038	322	364	10	25	42	0.5952381
NODE_37483_length_518_cov_3.136038	322	368	6	6	46	0.1304348
NODE_37483_length_518_cov_3.136038	322	368	8	15	46	0.3260870
NODE_37483_length_518_cov_3.136038	322	368	10	25	46	0.5434783
NODE_37483_length_518_cov_3.136038	331	366	6	4	35	0.1142857
NODE_37483_length_518_cov_3.136038	331	366	8	6	35	0.1714286
NODE_37483_length_518_cov_3.136038	331	366	10	25	35	0.7142857
NODE_37637_length_517_cov_55.267943	177	257	0	40	80	0.5000000
NODE_37637_length_517_cov_55.267943	177	257	1	7	80	0.0875000
NODE_37637_length_517_cov_55.267943	177	257	2	33	80	0.4125000
NODE_37637_length_517_cov_55.267943	230	310	2	80	80	1.0000000
NODE_37639_length_517_cov_30.863636	0	72	0	32	72	0.4444444
NODE_37639_length_517_cov_30.863636	0	72	2	23	72	0.3194444
NODE_37639_length_517_cov_30.863636	0	72	5	1	72	0.0138889
NODE_37639_length_517_cov_30.863636	0	72	6	16	72	0.2222222
NODE_37639_length_517_cov_30.863636	0	72	0	32	72	0.4444444
NODE_37639_length_517_cov_30.863636	0	72	2	23	72	0.3194444
NODE_37639_length_517_cov_30.863636	0	72	5	1	72	0.0138889
NODE_37639_length_517_cov_30.863636	0	72	6	16	72	0.2222222
NODE_37639_length_517_cov_30.863636	45	125	2	10	80	0.1250000
NODE_37639_length_517_cov_30.863636	45	125	4	3	80	0.0375000
NODE_37639_length_517_cov_30.863636	45	125	5	1	80	0.0125000
NODE_37639_length_517_cov_30.863636	45	125	6	59	80	0.7375000
NODE_37639_length_517_cov_30.863636	45	125	8	7	80	0.0875000
NODE_37639_length_517_cov_30.863636	45	99	2	10	54	0.1851852
NODE_37639_length_517_cov_30.863636	45	99	5	1	54	0.0185185
NODE_37639_length_517_cov_30.863636	45	99	6	43	54	0.7962963
NODE_37641_length_517_cov_12.258373	305	385	0	80	80	1.0000000
NODE_37641_length_517_cov_12.258373	358	438	0	80	80	1.0000000
NODE_37643_length_517_cov_7.131579	100	152	0	52	52	1.0000000
NODE_37662_length_517_cov_4.492823	140	220	2	28	80	0.3500000
NODE_37662_length_517_cov_4.492823	140	220	4	52	80	0.6500000
NODE_37662_length_517_cov_4.492823	193	273	0	28	80	0.3500000
NODE_37662_length_517_cov_4.492823	193	273	2	52	80	0.6500000
NODE_37697_length_517_cov_2.437799	331	388	0	57	57	1.0000000
NODE_37850_length_516_cov_17.570743	147	227	5	4	80	0.0500000
NODE_37850_length_516_cov_17.570743	147	227	6	8	80	0.1000000
NODE_37850_length_516_cov_17.570743	147	227	7	63	80	0.7875000
NODE_37850_length_516_cov_17.570743	147	227	8	5	80	0.0625000
NODE_37850_length_516_cov_17.570743	200	280	1	42	80	0.5250000
NODE_37850_length_516_cov_17.570743	200	280	6	18	80	0.2250000
NODE_37850_length_516_cov_17.570743	200	280	7	15	80	0.1875000
NODE_37850_length_516_cov_17.570743	200	280	8	5	80	0.0625000
NODE_37861_length_516_cov_5.268585	402	448	2	46	46	1.0000000
NODE_37862_length_516_cov_5.067146	114	194	0	80	80	1.0000000
NODE_37862_length_516_cov_5.067146	167	247	0	80	80	1.0000000
NODE_37864_length_516_cov_4.788969	156	236	0	80	80	1.0000000
NODE_37864_length_516_cov_4.788969	209	277	0	68	68	1.0000000
NODE_37881_length_516_cov_3.167866	48	93	0	1	45	0.0222222
NODE_37881_length_516_cov_3.167866	48	93	2	9	45	0.2000000
NODE_37881_length_516_cov_3.167866	48	93	4	35	45	0.7777778
NODE_37881_length_516_cov_3.167866	103	177	0	22	74	0.2972973
NODE_37881_length_516_cov_3.167866	103	177	2	29	74	0.3918919
NODE_37881_length_516_cov_3.167866	103	177	3	1	74	0.0135135
NODE_37881_length_516_cov_3.167866	103	177	4	22	74	0.2972973
NODE_38044_length_515_cov_69.442308	177	257	4	5	80	0.0625000
NODE_38044_length_515_cov_69.442308	177	257	6	8	80	0.1000000
NODE_38044_length_515_cov_69.442308	177	257	10	67	80	0.8375000
NODE_38044_length_515_cov_69.442308	177	257	4	5	80	0.0625000
NODE_38044_length_515_cov_69.442308	177	257	6	8	80	0.1000000
NODE_38044_length_515_cov_69.442308	177	257	10	67	80	0.8375000
NODE_38044_length_515_cov_69.442308	177	257	4	5	80	0.0625000
NODE_38044_length_515_cov_69.442308	177	257	6	8	80	0.1000000
NODE_38044_length_515_cov_69.442308	177	257	10	67	80	0.8375000
NODE_38044_length_515_cov_69.442308	230	291	0	13	61	0.2131148
NODE_38044_length_515_cov_69.442308	230	291	3	1	61	0.0163934
NODE_38044_length_515_cov_69.442308	230	291	4	25	61	0.4098361
NODE_38044_length_515_cov_69.442308	230	291	10	22	61	0.3606557
NODE_38044_length_515_cov_69.442308	230	308	0	30	78	0.3846154
NODE_38044_length_515_cov_69.442308	230	308	3	1	78	0.0128205
NODE_38044_length_515_cov_69.442308	230	308	4	25	78	0.3205128
NODE_38044_length_515_cov_69.442308	230	308	10	22	78	0.2820513
NODE_38044_length_515_cov_69.442308	235	308	0	30	73	0.4109589
NODE_38044_length_515_cov_69.442308	235	308	3	1	73	0.0136986
NODE_38044_length_515_cov_69.442308	235	308	4	25	73	0.3424658
NODE_38044_length_515_cov_69.442308	235	308	10	17	73	0.2328767
NODE_38045_length_515_cov_13.271635	168	248	0	80	80	1.0000000
NODE_38045_length_515_cov_13.271635	221	301	0	80	80	1.0000000
NODE_38048_length_515_cov_8.314904	213	290	0	77	77	1.0000000
NODE_38054_length_515_cov_5.487981	317	402	0	3	85	0.0352941
NODE_38054_length_515_cov_5.487981	317	402	2	5	85	0.0588235
NODE_38054_length_515_cov_5.487981	317	402	4	20	85	0.2352941
NODE_38054_length_515_cov_5.487981	317	402	6	14	85	0.1647059
NODE_38054_length_515_cov_5.487981	317	402	8	27	85	0.3176471
NODE_38054_length_515_cov_5.487981	317	402	10	16	85	0.1882353
NODE_38242_length_514_cov_26.910843	170	250	0	80	80	1.0000000
NODE_38242_length_514_cov_26.910843	223	303	0	80	80	1.0000000
NODE_38243_length_514_cov_12.775904	85	149	2	64	64	1.0000000
NODE_38243_length_514_cov_12.775904	123	202	0	39	79	0.4936709
NODE_38243_length_514_cov_12.775904	123	202	2	40	79	0.5063291
NODE_38244_length_514_cov_11.156627	124	204	0	80	80	1.0000000
NODE_38244_length_514_cov_11.156627	177	257	0	80	80	1.0000000
NODE_38253_length_514_cov_5.802410	165	217	0	35	52	0.6730769
NODE_38253_length_514_cov_5.802410	165	217	2	17	52	0.3269231
NODE_38253_length_514_cov_5.802410	190	270	0	10	80	0.1250000
NODE_38253_length_514_cov_5.802410	190	270	2	70	80	0.8750000
NODE_38254_length_514_cov_5.554217	192	272	0	80	80	1.0000000
NODE_38254_length_514_cov_5.554217	294	340	0	46	46	1.0000000
NODE_38257_length_514_cov_5.322892	230	260	10	30	30	1.0000000
NODE_38262_length_514_cov_4.337349	220	300	0	80	80	1.0000000
NODE_38286_length_514_cov_3.012048	264	328	0	64	64	1.0000000
NODE_38432_length_513_cov_14.613527	118	198	2	38	80	0.4750000
NODE_38432_length_513_cov_14.613527	118	198	4	14	80	0.1750000
NODE_38432_length_513_cov_14.613527	118	198	6	2	80	0.0250000
NODE_38432_length_513_cov_14.613527	118	198	8	4	80	0.0500000
NODE_38432_length_513_cov_14.613527	118	198	10	9	80	0.1125000
NODE_38432_length_513_cov_14.613527	118	198	12	13	80	0.1625000
NODE_38432_length_513_cov_14.613527	171	251	6	6	80	0.0750000
NODE_38432_length_513_cov_14.613527	171	251	8	14	80	0.1750000
NODE_38432_length_513_cov_14.613527	171	251	10	13	80	0.1625000
NODE_38432_length_513_cov_14.613527	171	251	12	44	80	0.5500000
NODE_38432_length_513_cov_14.613527	171	251	14	3	80	0.0375000
NODE_38433_length_513_cov_9.898551	253	333	2	80	80	1.0000000
NODE_38433_length_513_cov_9.898551	306	386	0	7	80	0.0875000
NODE_38433_length_513_cov_9.898551	306	386	2	73	80	0.9125000
NODE_38434_length_513_cov_9.164251	185	265	0	11	80	0.1375000
NODE_38434_length_513_cov_9.164251	185	265	2	69	80	0.8625000
NODE_38434_length_513_cov_9.164251	238	318	0	39	80	0.4875000
NODE_38434_length_513_cov_9.164251	238	318	2	41	80	0.5125000
NODE_38441_length_513_cov_6.123188	284	364	0	80	80	1.0000000
NODE_38441_length_513_cov_6.123188	337	417	0	80	80	1.0000000
NODE_38460_length_513_cov_3.456522	283	350	0	13	67	0.1940299
NODE_38460_length_513_cov_3.456522	283	350	2	4	67	0.0597015
NODE_38460_length_513_cov_3.456522	283	350	4	50	67	0.7462686
NODE_38460_length_513_cov_3.456522	336	398	0	5	62	0.0806452
NODE_38460_length_513_cov_3.456522	336	398	2	17	62	0.2741936
NODE_38460_length_513_cov_3.456522	336	398	4	40	62	0.6451613
NODE_38482_length_513_cov_2.309179	134	174	0	40	40	1.0000000
NODE_38482_length_513_cov_2.309179	170	223	0	53	53	1.0000000
NODE_38482_length_513_cov_2.309179	238	285	0	47	47	1.0000000
NODE_38515_length_513_cov_1.671498	427	476	4	8	49	0.1632653
NODE_38515_length_513_cov_1.671498	427	476	6	41	49	0.8367347
NODE_38646_length_512_cov_45.070218	34	114	0	80	80	1.0000000
NODE_38646_length_512_cov_45.070218	87	167	0	80	80	1.0000000
NODE_38647_length_512_cov_39.639225	323	404	6	4	81	0.0493827
NODE_38647_length_512_cov_39.639225	323	404	8	10	81	0.1234568
NODE_38647_length_512_cov_39.639225	323	404	10	67	81	0.8271605
NODE_38647_length_512_cov_39.639225	377	457	0	23	80	0.2875000
NODE_38647_length_512_cov_39.639225	377	457	2	27	80	0.3375000
NODE_38647_length_512_cov_39.639225	377	457	6	7	80	0.0875000
NODE_38647_length_512_cov_39.639225	377	457	8	10	80	0.1250000
NODE_38647_length_512_cov_39.639225	377	457	10	13	80	0.1625000
NODE_38648_length_512_cov_8.581114	192	256	6	3	64	0.0468750
NODE_38648_length_512_cov_8.581114	192	256	8	19	64	0.2968750
NODE_38648_length_512_cov_8.581114	192	256	10	19	64	0.2968750
NODE_38648_length_512_cov_8.581114	192	256	12	12	64	0.1875000
NODE_38648_length_512_cov_8.581114	192	256	14	11	64	0.1718750
NODE_38661_length_512_cov_4.869249	327	407	0	80	80	1.0000000
NODE_38661_length_512_cov_4.869249	380	460	0	80	80	1.0000000
NODE_38668_length_512_cov_4.157385	161	204	0	43	43	1.0000000
NODE_38668_length_512_cov_4.157385	178	257	0	79	79	1.0000000
NODE_38677_length_512_cov_3.435835	138	218	2	74	80	0.9250000
NODE_38677_length_512_cov_3.435835	138	218	4	6	80	0.0750000
NODE_38677_length_512_cov_3.435835	191	271	2	34	80	0.4250000
NODE_38677_length_512_cov_3.435835	191	271	3	25	80	0.3125000
NODE_38677_length_512_cov_3.435835	191	271	4	21	80	0.2625000
NODE_38693_length_512_cov_2.888620	320	400	0	10	80	0.1250000
NODE_38693_length_512_cov_2.888620	320	400	2	65	80	0.8125000
NODE_38693_length_512_cov_2.888620	320	400	4	5	80	0.0625000
NODE_38768_length_512_cov_1.341404	198	269	0	2	71	0.0281690
NODE_38768_length_512_cov_1.341404	198	269	12	3	71	0.0422535
NODE_38768_length_512_cov_1.341404	198	269	14	6	71	0.0845070
NODE_38768_length_512_cov_1.341404	198	269	16	11	71	0.1549296
NODE_38768_length_512_cov_1.341404	198	269	18	8	71	0.1126761
NODE_38768_length_512_cov_1.341404	198	269	22	5	71	0.0704225
NODE_38768_length_512_cov_1.341404	198	269	26	2	71	0.0281690
NODE_38768_length_512_cov_1.341404	198	269	28	1	71	0.0140845
NODE_38768_length_512_cov_1.341404	198	269	30	5	71	0.0704225
NODE_38768_length_512_cov_1.341404	198	269	32	6	71	0.0845070
NODE_38768_length_512_cov_1.341404	198	269	34	8	71	0.1126761
NODE_38768_length_512_cov_1.341404	198	269	36	5	71	0.0704225
NODE_38768_length_512_cov_1.341404	198	269	40	3	71	0.0422535
NODE_38768_length_512_cov_1.341404	198	269	42	5	71	0.0704225
NODE_38768_length_512_cov_1.341404	198	269	44	1	71	0.0140845
NODE_38866_length_511_cov_9.796117	251	331	2	80	80	1.0000000
NODE_38866_length_511_cov_9.796117	304	370	2	66	66	1.0000000
NODE_38869_length_511_cov_8.873786	239	319	0	26	80	0.3250000
NODE_38869_length_511_cov_8.873786	239	319	2	54	80	0.6750000
NODE_38869_length_511_cov_8.873786	292	356	0	63	64	0.9843750
NODE_38869_length_511_cov_8.873786	292	356	2	1	64	0.0156250
NODE_38870_length_511_cov_8.434466	232	312	0	80	80	1.0000000
NODE_38870_length_511_cov_8.434466	285	366	0	81	81	1.0000000
NODE_38872_length_511_cov_7.519417	157	237	0	61	80	0.7625000
NODE_38872_length_511_cov_7.519417	157	237	2	19	80	0.2375000
NODE_38872_length_511_cov_7.519417	210	290	0	80	80	1.0000000
NODE_38877_length_511_cov_5.762136	102	179	2	17	77	0.2207792
NODE_38877_length_511_cov_5.762136	102	179	4	60	77	0.7792208
NODE_38877_length_511_cov_5.762136	155	230	0	1	75	0.0133333
NODE_38877_length_511_cov_5.762136	155	230	2	34	75	0.4533333
NODE_38877_length_511_cov_5.762136	155	230	3	11	75	0.1466667
NODE_38877_length_511_cov_5.762136	155	230	4	29	75	0.3866667
NODE_38878_length_511_cov_5.655340	133	213	0	80	80	1.0000000
NODE_38878_length_511_cov_5.655340	186	266	0	80	80	1.0000000
NODE_38911_length_511_cov_2.978155	219	255	2	2	36	0.0555556
NODE_38911_length_511_cov_2.978155	219	255	4	3	36	0.0833333
NODE_38911_length_511_cov_2.978155	219	255	6	31	36	0.8611111
NODE_39013_length_511_cov_1.225728	99	127	0	28	28	1.0000000
NODE_39092_length_511_cov_0.708738	98	146	1	1	48	0.0208333
NODE_39092_length_511_cov_0.708738	98	146	2	28	48	0.5833333
NODE_39092_length_511_cov_0.708738	98	146	4	19	48	0.3958333
NODE_39105_length_510_cov_18.206813	334	414	0	79	80	0.9875000
NODE_39105_length_510_cov_18.206813	334	414	2	1	80	0.0125000
NODE_39105_length_510_cov_18.206813	387	467	0	26	80	0.3250000
NODE_39105_length_510_cov_18.206813	387	467	2	54	80	0.6750000
NODE_39110_length_510_cov_8.017032	211	291	0	80	80	1.0000000
NODE_39110_length_510_cov_8.017032	264	344	0	80	80	1.0000000
NODE_39110_length_510_cov_8.017032	391	413	0	22	22	1.0000000
NODE_39112_length_510_cov_6.476886	208	251	0	11	43	0.2558140
NODE_39112_length_510_cov_6.476886	208	251	2	32	43	0.7441860
NODE_39115_length_510_cov_6.133820	149	200	0	51	51	1.0000000
NODE_39122_length_510_cov_4.313869	32	106	0	74	74	1.0000000
NODE_39131_length_510_cov_3.435523	149	213	2	32	64	0.5000000
NODE_39131_length_510_cov_3.435523	149	213	3	3	64	0.0468750
NODE_39131_length_510_cov_3.435523	149	213	4	29	64	0.4531250
NODE_39131_length_510_cov_3.435523	191	249	2	17	58	0.2931035
NODE_39131_length_510_cov_3.435523	191	249	3	5	58	0.0862069
NODE_39131_length_510_cov_3.435523	191	249	4	36	58	0.6206896
NODE_39293_length_509_cov_13.378049	160	240	0	80	80	1.0000000
NODE_39293_length_509_cov_13.378049	213	294	0	81	81	1.0000000
NODE_39302_length_509_cov_5.190244	203	283	6	41	80	0.5125000
NODE_39302_length_509_cov_5.190244	203	283	8	39	80	0.4875000
NODE_39302_length_509_cov_5.190244	256	336	2	46	80	0.5750000
NODE_39302_length_509_cov_5.190244	256	336	4	6	80	0.0750000
NODE_39302_length_509_cov_5.190244	256	336	6	9	80	0.1125000
NODE_39302_length_509_cov_5.190244	256	336	8	19	80	0.2375000
NODE_39309_length_509_cov_4.478049	221	301	0	80	80	1.0000000
NODE_39309_length_509_cov_4.478049	274	354	0	80	80	1.0000000
NODE_39311_length_509_cov_4.451220	203	283	0	13	80	0.1625000
NODE_39311_length_509_cov_4.451220	203	283	2	57	80	0.7125000
NODE_39311_length_509_cov_4.451220	203	283	4	10	80	0.1250000
NODE_39322_length_509_cov_3.443902	133	185	0	51	52	0.9807692
NODE_39322_length_509_cov_3.443902	133	185	2	1	52	0.0192308
NODE_39326_length_509_cov_3.207317	367	445	0	78	78	1.0000000
NODE_39337_length_509_cov_2.853659	194	274	0	80	80	1.0000000
NODE_39480_length_509_cov_0.809756	229	272	0	43	43	1.0000000
NODE_39506_length_508_cov_22.009780	440	508	0	68	68	1.0000000
NODE_39512_length_508_cov_5.158924	248	284	0	36	36	1.0000000
NODE_39539_length_508_cov_2.662592	165	244	6	22	79	0.2784810
NODE_39539_length_508_cov_2.662592	165	244	8	57	79	0.7215190
NODE_39698_length_507_cov_32.286765	0	61	0	1	61	0.0163934
NODE_39698_length_507_cov_32.286765	0	61	2	2	61	0.0327869
NODE_39698_length_507_cov_32.286765	0	61	4	8	61	0.1311475
NODE_39698_length_507_cov_32.286765	0	61	5	1	61	0.0163934
NODE_39698_length_507_cov_32.286765	0	61	7	3	61	0.0491803
NODE_39698_length_507_cov_32.286765	0	61	9	1	61	0.0163934
NODE_39698_length_507_cov_32.286765	0	61	10	2	61	0.0327869
NODE_39698_length_507_cov_32.286765	0	61	11	2	61	0.0327869
NODE_39698_length_507_cov_32.286765	0	61	12	6	61	0.0983607
NODE_39698_length_507_cov_32.286765	0	61	14	1	61	0.0163934
NODE_39698_length_507_cov_32.286765	0	61	15	1	61	0.0163934
NODE_39698_length_507_cov_32.286765	0	61	17	1	61	0.0163934
NODE_39698_length_507_cov_32.286765	0	61	19	1	61	0.0163934
NODE_39698_length_507_cov_32.286765	0	61	21	1	61	0.0163934
NODE_39698_length_507_cov_32.286765	0	61	25	1	61	0.0163934
NODE_39698_length_507_cov_32.286765	0	61	26	1	61	0.0163934
NODE_39698_length_507_cov_32.286765	0	61	28	1	61	0.0163934
NODE_39698_length_507_cov_32.286765	0	61	30	2	61	0.0327869
NODE_39698_length_507_cov_32.286765	0	61	32	13	61	0.2131148
NODE_39698_length_507_cov_32.286765	0	61	42	1	61	0.0163934
NODE_39698_length_507_cov_32.286765	0	61	44	4	61	0.0655738
NODE_39698_length_507_cov_32.286765	0	61	46	6	61	0.0983607
NODE_39698_length_507_cov_32.286765	0	61	50	1	61	0.0163934
NODE_39698_length_507_cov_32.286765	53	97	44	1	44	0.0227273
NODE_39698_length_507_cov_32.286765	53	97	46	6	44	0.1363636
NODE_39698_length_507_cov_32.286765	53	97	50	1	44	0.0227273
NODE_39698_length_507_cov_32.286765	53	97	52	1	44	0.0227273
NODE_39698_length_507_cov_32.286765	53	97	54	4	44	0.0909091
NODE_39698_length_507_cov_32.286765	53	97	56	1	44	0.0227273
NODE_39698_length_507_cov_32.286765	53	97	58	1	44	0.0227273
NODE_39698_length_507_cov_32.286765	53	97	60	1	44	0.0227273
NODE_39698_length_507_cov_32.286765	53	97	62	1	44	0.0227273
NODE_39698_length_507_cov_32.286765	53	97	70	1	44	0.0227273
NODE_39698_length_507_cov_32.286765	53	97	72	2	44	0.0454545
NODE_39698_length_507_cov_32.286765	53	97	73	4	44	0.0909091
NODE_39698_length_507_cov_32.286765	53	97	75	1	44	0.0227273
NODE_39698_length_507_cov_32.286765	53	97	77	2	44	0.0454545
NODE_39698_length_507_cov_32.286765	53	97	78	3	44	0.0681818
NODE_39698_length_507_cov_32.286765	53	97	80	1	44	0.0227273
NODE_39698_length_507_cov_32.286765	53	97	82	1	44	0.0227273
NODE_39698_length_507_cov_32.286765	53	97	84	2	44	0.0454545
NODE_39698_length_507_cov_32.286765	53	97	86	1	44	0.0227273
NODE_39698_length_507_cov_32.286765	53	97	89	3	44	0.0681818
NODE_39698_length_507_cov_32.286765	53	97	90	2	44	0.0454545
NODE_39698_length_507_cov_32.286765	53	97	91	4	44	0.0909091
NODE_39701_length_507_cov_7.553922	203	283	6	28	80	0.3500000
NODE_39701_length_507_cov_7.553922	203	283	8	15	80	0.1875000
NODE_39701_length_507_cov_7.553922	203	283	12	37	80	0.4625000
NODE_39709_length_507_cov_5.154412	296	362	4	5	66	0.0757576
NODE_39709_length_507_cov_5.154412	296	362	6	2	66	0.0303030
NODE_39709_length_507_cov_5.154412	296	362	8	59	66	0.8939394
NODE_39714_length_507_cov_4.710784	248	328	2	52	80	0.6500000
NODE_39714_length_507_cov_4.710784	248	328	4	28	80	0.3500000
NODE_39714_length_507_cov_4.710784	308	379	0	30	71	0.4225352
NODE_39714_length_507_cov_4.710784	308	379	2	41	71	0.5774648
NODE_39728_length_507_cov_3.649510	80	109	10	2	29	0.0689655
NODE_39728_length_507_cov_3.649510	80	109	12	9	29	0.3103448
NODE_39728_length_507_cov_3.649510	80	109	16	18	29	0.6206896
NODE_39728_length_507_cov_3.649510	184	266	4	4	82	0.0487805
NODE_39728_length_507_cov_3.649510	184	266	6	18	82	0.2195122
NODE_39728_length_507_cov_3.649510	184	266	8	22	82	0.2682927
NODE_39728_length_507_cov_3.649510	184	266	12	4	82	0.0487805
NODE_39728_length_507_cov_3.649510	184	266	18	6	82	0.0731707
NODE_39728_length_507_cov_3.649510	184	266	20	1	82	0.0121951
NODE_39728_length_507_cov_3.649510	184	266	21	1	82	0.0121951
NODE_39728_length_507_cov_3.649510	184	266	22	4	82	0.0487805
NODE_39728_length_507_cov_3.649510	184	266	24	5	82	0.0609756
NODE_39728_length_507_cov_3.649510	184	266	26	17	82	0.2073171
NODE_39728_length_507_cov_3.649510	189	273	2	3	84	0.0357143
NODE_39728_length_507_cov_3.649510	189	273	4	8	84	0.0952381
NODE_39728_length_507_cov_3.649510	189	273	6	18	84	0.2142857
NODE_39728_length_507_cov_3.649510	189	273	8	22	84	0.2619048
NODE_39728_length_507_cov_3.649510	189	273	12	4	84	0.0476190
NODE_39728_length_507_cov_3.649510	189	273	18	6	84	0.0714286
NODE_39728_length_507_cov_3.649510	189	273	20	1	84	0.0119048
NODE_39728_length_507_cov_3.649510	189	273	21	1	84	0.0119048
NODE_39728_length_507_cov_3.649510	189	273	22	4	84	0.0476190
NODE_39728_length_507_cov_3.649510	189	273	24	5	84	0.0595238
NODE_39728_length_507_cov_3.649510	189	273	26	12	84	0.1428571
NODE_39728_length_507_cov_3.649510	207	266	4	4	59	0.0677966
NODE_39728_length_507_cov_3.649510	207	266	6	18	59	0.3050847
NODE_39728_length_507_cov_3.649510	207	266	8	22	59	0.3728814
NODE_39728_length_507_cov_3.649510	207	266	12	4	59	0.0677966
NODE_39728_length_507_cov_3.649510	207	266	18	6	59	0.1016949
NODE_39728_length_507_cov_3.649510	207	266	20	1	59	0.0169492
NODE_39728_length_507_cov_3.649510	207	266	21	1	59	0.0169492
NODE_39728_length_507_cov_3.649510	207	266	22	3	59	0.0508475
NODE_39747_length_507_cov_2.754902	345	425	0	80	80	1.0000000
NODE_39747_length_507_cov_2.754902	428	463	0	35	35	1.0000000
NODE_39918_length_506_cov_31.987715	71	156	0	1	85	0.0117647
NODE_39918_length_506_cov_31.987715	71	156	2	11	85	0.1294118
NODE_39918_length_506_cov_31.987715	71	156	3	4	85	0.0470588
NODE_39918_length_506_cov_31.987715	71	156	5	3	85	0.0352941
NODE_39918_length_506_cov_31.987715	71	156	7	13	85	0.1529412
NODE_39918_length_506_cov_31.987715	71	156	8	7	85	0.0823529
NODE_39918_length_506_cov_31.987715	71	156	13	3	85	0.0352941
NODE_39918_length_506_cov_31.987715	71	156	14	28	85	0.3294118
NODE_39918_length_506_cov_31.987715	71	156	16	15	85	0.1764706
NODE_39918_length_506_cov_31.987715	71	156	0	1	85	0.0117647
NODE_39918_length_506_cov_31.987715	71	156	2	11	85	0.1294118
NODE_39918_length_506_cov_31.987715	71	156	3	4	85	0.0470588
NODE_39918_length_506_cov_31.987715	71	156	5	3	85	0.0352941
NODE_39918_length_506_cov_31.987715	71	156	7	13	85	0.1529412
NODE_39918_length_506_cov_31.987715	71	156	8	7	85	0.0823529
NODE_39918_length_506_cov_31.987715	71	156	13	3	85	0.0352941
NODE_39918_length_506_cov_31.987715	71	156	14	28	85	0.3294118
NODE_39918_length_506_cov_31.987715	71	156	16	15	85	0.1764706
NODE_39918_length_506_cov_31.987715	71	156	0	1	85	0.0117647
NODE_39918_length_506_cov_31.987715	71	156	2	11	85	0.1294118
NODE_39918_length_506_cov_31.987715	71	156	3	4	85	0.0470588
NODE_39918_length_506_cov_31.987715	71	156	5	3	85	0.0352941
NODE_39918_length_506_cov_31.987715	71	156	7	13	85	0.1529412
NODE_39918_length_506_cov_31.987715	71	156	8	7	85	0.0823529
NODE_39918_length_506_cov_31.987715	71	156	13	3	85	0.0352941
NODE_39918_length_506_cov_31.987715	71	156	14	28	85	0.3294118
NODE_39918_length_506_cov_31.987715	71	156	16	15	85	0.1764706
NODE_39918_length_506_cov_31.987715	129	209	8	3	80	0.0375000
NODE_39918_length_506_cov_31.987715	129	209	10	25	80	0.3125000
NODE_39918_length_506_cov_31.987715	129	209	12	15	80	0.1875000
NODE_39918_length_506_cov_31.987715	129	209	14	22	80	0.2750000
NODE_39918_length_506_cov_31.987715	129	209	16	15	80	0.1875000
NODE_39919_length_506_cov_15.877150	210	279	0	69	69	1.0000000
NODE_39920_length_506_cov_15.461916	334	414	0	15	80	0.1875000
NODE_39920_length_506_cov_15.461916	334	414	2	65	80	0.8125000
NODE_39920_length_506_cov_15.461916	387	467	0	68	80	0.8500000
NODE_39920_length_506_cov_15.461916	387	467	2	12	80	0.1500000
NODE_39921_length_506_cov_9.749386	197	276	0	79	79	1.0000000
NODE_39921_length_506_cov_9.749386	249	329	0	80	80	1.0000000
NODE_39947_length_506_cov_3.122850	218	298	0	75	80	0.9375000
NODE_39947_length_506_cov_3.122850	218	298	2	5	80	0.0625000
NODE_39947_length_506_cov_3.122850	271	351	0	80	80	1.0000000
NODE_39951_length_506_cov_2.894349	190	270	0	30	80	0.3750000
NODE_39951_length_506_cov_2.894349	190	270	2	50	80	0.6250000
NODE_40133_length_505_cov_35.541872	373	453	0	80	80	1.0000000
NODE_40135_length_505_cov_10.339901	30	110	0	80	80	1.0000000
NODE_40135_length_505_cov_10.339901	83	163	0	80	80	1.0000000
NODE_40158_length_505_cov_3.554187	225	305	0	45	80	0.5625000
NODE_40158_length_505_cov_3.554187	225	305	2	35	80	0.4375000
NODE_40158_length_505_cov_3.554187	278	358	0	9	80	0.1125000
NODE_40158_length_505_cov_3.554187	278	358	2	71	80	0.8875000
NODE_40160_length_505_cov_3.403941	207	287	0	80	80	1.0000000
NODE_40175_length_505_cov_2.975369	162	227	2	65	65	1.0000000
NODE_40222_length_505_cov_1.864532	55	126	0	25	71	0.3521127
NODE_40222_length_505_cov_1.864532	55	126	2	46	71	0.6478873
NODE_40368_length_504_cov_115.891358	122	202	103	2	80	0.0250000
NODE_40368_length_504_cov_115.891358	122	202	105	2	80	0.0250000
NODE_40368_length_504_cov_115.891358	122	202	107	1	80	0.0125000
NODE_40368_length_504_cov_115.891358	122	202	115	2	80	0.0250000
NODE_40368_length_504_cov_115.891358	122	202	119	1	80	0.0125000
NODE_40368_length_504_cov_115.891358	122	202	120	1	80	0.0125000
NODE_40368_length_504_cov_115.891358	122	202	122	3	80	0.0375000
NODE_40368_length_504_cov_115.891358	122	202	124	6	80	0.0750000
NODE_40368_length_504_cov_115.891358	122	202	126	3	80	0.0375000
NODE_40368_length_504_cov_115.891358	122	202	128	1	80	0.0125000
NODE_40368_length_504_cov_115.891358	122	202	130	5	80	0.0625000
NODE_40368_length_504_cov_115.891358	122	202	131	1	80	0.0125000
NODE_40368_length_504_cov_115.891358	122	202	132	3	80	0.0375000
NODE_40368_length_504_cov_115.891358	122	202	133	5	80	0.0625000
NODE_40368_length_504_cov_115.891358	122	202	134	5	80	0.0625000
NODE_40368_length_504_cov_115.891358	122	202	135	4	80	0.0500000
NODE_40368_length_504_cov_115.891358	122	202	136	2	80	0.0250000
NODE_40368_length_504_cov_115.891358	122	202	137	6	80	0.0750000
NODE_40368_length_504_cov_115.891358	122	202	138	7	80	0.0875000
NODE_40368_length_504_cov_115.891358	122	202	139	7	80	0.0875000
NODE_40368_length_504_cov_115.891358	122	202	140	3	80	0.0375000
NODE_40368_length_504_cov_115.891358	122	202	141	2	80	0.0250000
NODE_40368_length_504_cov_115.891358	122	202	143	1	80	0.0125000
NODE_40368_length_504_cov_115.891358	122	202	144	3	80	0.0375000
NODE_40368_length_504_cov_115.891358	122	202	145	1	80	0.0125000
NODE_40368_length_504_cov_115.891358	122	202	146	3	80	0.0375000
NODE_40368_length_504_cov_115.891358	175	255	110	1	80	0.0125000
NODE_40368_length_504_cov_115.891358	175	255	115	3	80	0.0375000
NODE_40368_length_504_cov_115.891358	175	255	118	4	80	0.0500000
NODE_40368_length_504_cov_115.891358	175	255	123	4	80	0.0500000
NODE_40368_length_504_cov_115.891358	175	255	125	2	80	0.0250000
NODE_40368_length_504_cov_115.891358	175	255	128	1	80	0.0125000
NODE_40368_length_504_cov_115.891358	175	255	130	1	80	0.0125000
NODE_40368_length_504_cov_115.891358	175	255	131	1	80	0.0125000
NODE_40368_length_504_cov_115.891358	175	255	132	1	80	0.0125000
NODE_40368_length_504_cov_115.891358	175	255	133	11	80	0.1375000
NODE_40368_length_504_cov_115.891358	175	255	134	6	80	0.0750000
NODE_40368_length_504_cov_115.891358	175	255	135	4	80	0.0500000
NODE_40368_length_504_cov_115.891358	175	255	136	7	80	0.0875000
NODE_40368_length_504_cov_115.891358	175	255	137	1	80	0.0125000
NODE_40368_length_504_cov_115.891358	175	255	138	6	80	0.0750000
NODE_40368_length_504_cov_115.891358	175	255	139	1	80	0.0125000
NODE_40368_length_504_cov_115.891358	175	255	140	2	80	0.0250000
NODE_40368_length_504_cov_115.891358	175	255	141	2	80	0.0250000
NODE_40368_length_504_cov_115.891358	175	255	142	2	80	0.0250000
NODE_40368_length_504_cov_115.891358	175	255	143	3	80	0.0375000
NODE_40368_length_504_cov_115.891358	175	255	144	1	80	0.0125000
NODE_40368_length_504_cov_115.891358	175	255	145	7	80	0.0875000
NODE_40368_length_504_cov_115.891358	175	255	146	2	80	0.0250000
NODE_40368_length_504_cov_115.891358	175	255	147	3	80	0.0375000
NODE_40368_length_504_cov_115.891358	175	255	149	4	80	0.0500000
NODE_40369_length_504_cov_33.360494	28	108	0	80	80	1.0000000
NODE_40369_length_504_cov_33.360494	81	161	0	80	80	1.0000000
NODE_40370_length_504_cov_15.669136	176	256	0	80	80	1.0000000
NODE_40370_length_504_cov_15.669136	229	309	0	80	80	1.0000000
NODE_40371_length_504_cov_13.202469	134	215	0	39	81	0.4814815
NODE_40371_length_504_cov_13.202469	134	215	2	42	81	0.5185185
NODE_40371_length_504_cov_13.202469	188	268	0	13	80	0.1625000
NODE_40371_length_504_cov_13.202469	188	268	2	67	80	0.8375000
NODE_40377_length_504_cov_6.770370	55	135	0	24	80	0.3000000
NODE_40377_length_504_cov_6.770370	55	135	2	56	80	0.7000000
NODE_40377_length_504_cov_6.770370	108	188	0	24	80	0.3000000
NODE_40377_length_504_cov_6.770370	108	188	2	56	80	0.7000000
NODE_40427_length_504_cov_2.234568	359	407	0	48	48	1.0000000
NODE_40428_length_504_cov_2.227160	307	370	2	63	63	1.0000000
NODE_40434_length_504_cov_2.116049	245	325	0	80	80	1.0000000
NODE_40434_length_504_cov_2.116049	298	378	0	80	80	1.0000000
NODE_40446_length_504_cov_1.925926	196	262	0	17	66	0.2575758
NODE_40446_length_504_cov_1.925926	196	262	2	49	66	0.7424242
NODE_40601_length_503_cov_11.356436	268	348	0	80	80	1.0000000
NODE_40601_length_503_cov_11.356436	321	401	0	80	80	1.0000000
NODE_40615_length_503_cov_5.537129	314	381	0	7	67	0.1044776
NODE_40615_length_503_cov_5.537129	314	381	2	3	67	0.0447761
NODE_40615_length_503_cov_5.537129	314	381	4	49	67	0.7313433
NODE_40615_length_503_cov_5.537129	314	381	6	8	67	0.1194030
NODE_40645_length_503_cov_3.012376	264	285	0	21	21	1.0000000
NODE_40652_length_503_cov_2.757426	266	334	0	1	68	0.0147059
NODE_40652_length_503_cov_2.757426	266	334	2	17	68	0.2500000
NODE_40652_length_503_cov_2.757426	266	334	6	4	68	0.0588235
NODE_40652_length_503_cov_2.757426	266	334	7	14	68	0.2058824
NODE_40652_length_503_cov_2.757426	266	334	8	32	68	0.4705882
NODE_40652_length_503_cov_2.757426	307	387	6	20	80	0.2500000
NODE_40652_length_503_cov_2.757426	307	387	8	60	80	0.7500000
NODE_40655_length_503_cov_2.705446	158	237	0	79	79	1.0000000
NODE_40655_length_503_cov_2.705446	211	291	0	80	80	1.0000000
NODE_40656_length_503_cov_2.705446	251	331	2	6	80	0.0750000
NODE_40656_length_503_cov_2.705446	251	331	6	65	80	0.8125000
NODE_40656_length_503_cov_2.705446	251	331	8	9	80	0.1125000
NODE_40656_length_503_cov_2.705446	251	321	2	6	70	0.0857143
NODE_40656_length_503_cov_2.705446	251	321	6	56	70	0.8000000
NODE_40656_length_503_cov_2.705446	251	321	8	8	70	0.1142857
NODE_40656_length_503_cov_2.705446	330	384	6	43	54	0.7962963
NODE_40656_length_503_cov_2.705446	330	384	8	11	54	0.2037037
NODE_40656_length_503_cov_2.705446	338	384	6	43	46	0.9347826
NODE_40656_length_503_cov_2.705446	338	384	8	3	46	0.0652174
NODE_40664_length_503_cov_2.584158	95	163	0	68	68	1.0000000
NODE_40857_length_502_cov_45.292804	353	433	2	2	80	0.0250000
NODE_40857_length_502_cov_45.292804	353	433	4	32	80	0.4000000
NODE_40857_length_502_cov_45.292804	353	433	6	36	80	0.4500000
NODE_40857_length_502_cov_45.292804	353	433	8	10	80	0.1250000
NODE_40864_length_502_cov_5.980149	305	381	8	25	76	0.3289474
NODE_40864_length_502_cov_5.980149	305	381	10	7	76	0.0921053
NODE_40864_length_502_cov_5.980149	305	381	11	3	76	0.0394737
NODE_40864_length_502_cov_5.980149	305	381	12	29	76	0.3815790
NODE_40864_length_502_cov_5.980149	305	381	14	12	76	0.1578947
NODE_41070_length_501_cov_208.708955	288	350	33	1	62	0.0161290
NODE_41070_length_501_cov_208.708955	288	350	34	2	62	0.0322581
NODE_41070_length_501_cov_208.708955	288	350	36	1	62	0.0161290
NODE_41070_length_501_cov_208.708955	288	350	38	2	62	0.0322581
NODE_41070_length_501_cov_208.708955	288	350	47	3	62	0.0483871
NODE_41070_length_501_cov_208.708955	288	350	49	1	62	0.0161290
NODE_41070_length_501_cov_208.708955	288	350	59	2	62	0.0322581
NODE_41070_length_501_cov_208.708955	288	350	64	1	62	0.0161290
NODE_41070_length_501_cov_208.708955	288	350	67	2	62	0.0322581
NODE_41070_length_501_cov_208.708955	288	350	71	1	62	0.0161290
NODE_41070_length_501_cov_208.708955	288	350	72	1	62	0.0161290
NODE_41070_length_501_cov_208.708955	288	350	76	1	62	0.0161290
NODE_41070_length_501_cov_208.708955	288	350	84	1	62	0.0161290
NODE_41070_length_501_cov_208.708955	288	350	88	2	62	0.0322581
NODE_41070_length_501_cov_208.708955	288	350	94	2	62	0.0322581
NODE_41070_length_501_cov_208.708955	288	350	107	1	62	0.0161290
NODE_41070_length_501_cov_208.708955	288	350	111	1	62	0.0161290
NODE_41070_length_501_cov_208.708955	288	350	117	2	62	0.0322581
NODE_41070_length_501_cov_208.708955	288	350	129	1	62	0.0161290
NODE_41070_length_501_cov_208.708955	288	350	131	2	62	0.0322581
NODE_41070_length_501_cov_208.708955	288	350	133	7	62	0.1129032
NODE_41070_length_501_cov_208.708955	288	350	134	1	62	0.0161290
NODE_41070_length_501_cov_208.708955	288	350	136	4	62	0.0645161
NODE_41070_length_501_cov_208.708955	288	350	139	2	62	0.0322581
NODE_41070_length_501_cov_208.708955	288	350	140	9	62	0.1451613
NODE_41070_length_501_cov_208.708955	288	350	141	8	62	0.1290323
NODE_41070_length_501_cov_208.708955	288	350	143	1	62	0.0161290
NODE_41070_length_501_cov_208.708955	327	413	31	4	86	0.0465116
NODE_41070_length_501_cov_208.708955	327	413	41	2	86	0.0232558
NODE_41070_length_501_cov_208.708955	327	413	43	2	86	0.0232558
NODE_41070_length_501_cov_208.708955	327	413	55	1	86	0.0116279
NODE_41070_length_501_cov_208.708955	327	413	58	1	86	0.0116279
NODE_41070_length_501_cov_208.708955	327	413	69	1	86	0.0116279
NODE_41070_length_501_cov_208.708955	327	413	73	1	86	0.0116279
NODE_41070_length_501_cov_208.708955	327	413	79	1	86	0.0116279
NODE_41070_length_501_cov_208.708955	327	413	93	2	86	0.0232558
NODE_41070_length_501_cov_208.708955	327	413	103	5	86	0.0581395
NODE_41070_length_501_cov_208.708955	327	413	105	3	86	0.0348837
NODE_41070_length_501_cov_208.708955	327	413	111	1	86	0.0116279
NODE_41070_length_501_cov_208.708955	327	413	113	2	86	0.0232558
NODE_41070_length_501_cov_208.708955	327	413	123	1	86	0.0116279
NODE_41070_length_501_cov_208.708955	327	413	125	1	86	0.0116279
NODE_41070_length_501_cov_208.708955	327	413	131	6	86	0.0697674
NODE_41070_length_501_cov_208.708955	327	413	133	3	86	0.0348837
NODE_41070_length_501_cov_208.708955	327	413	134	1	86	0.0116279
NODE_41070_length_501_cov_208.708955	327	413	136	2	86	0.0232558
NODE_41070_length_501_cov_208.708955	327	413	139	14	86	0.1627907
NODE_41070_length_501_cov_208.708955	327	413	140	12	86	0.1395349
NODE_41070_length_501_cov_208.708955	327	413	141	8	86	0.0930233
NODE_41070_length_501_cov_208.708955	327	413	142	2	86	0.0232558
NODE_41070_length_501_cov_208.708955	327	413	143	5	86	0.0581395
NODE_41070_length_501_cov_208.708955	327	413	144	1	86	0.0116279
NODE_41070_length_501_cov_208.708955	327	413	145	3	86	0.0348837
NODE_41070_length_501_cov_208.708955	327	413	146	1	86	0.0116279
NODE_41071_length_501_cov_29.126866	23	103	0	80	80	1.0000000
NODE_41071_length_501_cov_29.126866	76	156	0	36	80	0.4500000
NODE_41071_length_501_cov_29.126866	76	156	2	44	80	0.5500000
NODE_41072_length_501_cov_23.736318	85	165	0	80	80	1.0000000
NODE_41072_length_501_cov_23.736318	138	218	0	80	80	1.0000000
NODE_41075_length_501_cov_7.820896	270	350	0	25	80	0.3125000
NODE_41075_length_501_cov_7.820896	270	350	2	55	80	0.6875000
NODE_41075_length_501_cov_7.820896	323	403	0	74	80	0.9250000
NODE_41075_length_501_cov_7.820896	323	403	1	4	80	0.0500000
NODE_41075_length_501_cov_7.820896	323	403	2	2	80	0.0250000
NODE_41080_length_501_cov_6.437811	309	389	2	43	80	0.5375000
NODE_41080_length_501_cov_6.437811	309	389	3	1	80	0.0125000
NODE_41080_length_501_cov_6.437811	309	389	4	26	80	0.3250000
NODE_41080_length_501_cov_6.437811	309	389	6	10	80	0.1250000
NODE_41097_length_501_cov_3.656716	289	312	0	23	23	1.0000000
NODE_41097_length_501_cov_3.656716	355	420	0	65	65	1.0000000
NODE_41103_length_501_cov_3.477612	329	409	0	9	80	0.1125000
NODE_41103_length_501_cov_3.477612	329	409	2	71	80	0.8875000
NODE_41109_length_501_cov_3.134328	266	345	4	21	79	0.2658228
NODE_41109_length_501_cov_3.134328	266	345	6	58	79	0.7341772
NODE_41308_length_500_cov_77.895262	456	500	0	44	44	1.0000000
NODE_41309_length_500_cov_35.805486	326	406	0	80	80	1.0000000
NODE_41309_length_500_cov_35.805486	379	459	0	80	80	1.0000000
NODE_41310_length_500_cov_13.084788	160	221	0	4	61	0.0655738
NODE_41310_length_500_cov_13.084788	160	221	2	57	61	0.9344262
NODE_41311_length_500_cov_12.650873	215	295	0	80	80	1.0000000
NODE_41311_length_500_cov_12.650873	268	348	0	80	80	1.0000000
NODE_41312_length_500_cov_12.009975	203	268	2	59	65	0.9076923
NODE_41312_length_500_cov_12.009975	203	268	4	6	65	0.0923077
NODE_41312_length_500_cov_12.009975	241	321	0	13	80	0.1625000
NODE_41312_length_500_cov_12.009975	241	321	2	61	80	0.7625000
NODE_41312_length_500_cov_12.009975	241	321	4	6	80	0.0750000
NODE_41325_length_500_cov_4.653367	224	295	0	71	71	1.0000000
NODE_41415_length_500_cov_1.650873	355	435	0	80	80	1.0000000
NODE_41415_length_500_cov_1.650873	408	488	0	80	80	1.0000000
NODE_41462_length_500_cov_1.231920	169	212	0	2	43	0.0465116
NODE_41462_length_500_cov_1.231920	169	212	2	41	43	0.9534883
NODE_41542_length_499_cov_358.730000	425	492	8	5	67	0.0746269
NODE_41542_length_499_cov_358.730000	425	492	10	5	67	0.0746269
NODE_41542_length_499_cov_358.730000	425	492	14	2	67	0.0298507
NODE_41542_length_499_cov_358.730000	425	492	16	1	67	0.0149254
NODE_41542_length_499_cov_358.730000	425	492	18	1	67	0.0149254
NODE_41542_length_499_cov_358.730000	425	492	22	5	67	0.0746269
NODE_41542_length_499_cov_358.730000	425	492	24	2	67	0.0298507
NODE_41542_length_499_cov_358.730000	425	492	28	1	67	0.0149254
NODE_41542_length_499_cov_358.730000	425	492	29	1	67	0.0149254
NODE_41542_length_499_cov_358.730000	425	492	38	3	67	0.0447761
NODE_41542_length_499_cov_358.730000	425	492	40	9	67	0.1343284
NODE_41542_length_499_cov_358.730000	425	492	44	1	67	0.0149254
NODE_41542_length_499_cov_358.730000	425	492	46	2	67	0.0298507
NODE_41542_length_499_cov_358.730000	425	492	48	1	67	0.0149254
NODE_41542_length_499_cov_358.730000	425	492	50	4	67	0.0597015
NODE_41542_length_499_cov_358.730000	425	492	52	1	67	0.0149254
NODE_41542_length_499_cov_358.730000	425	492	54	1	67	0.0149254
NODE_41542_length_499_cov_358.730000	425	492	56	1	67	0.0149254
NODE_41542_length_499_cov_358.730000	425	492	60	3	67	0.0447761
NODE_41542_length_499_cov_358.730000	425	492	64	1	67	0.0149254
NODE_41542_length_499_cov_358.730000	425	492	68	1	67	0.0149254
NODE_41542_length_499_cov_358.730000	425	492	70	16	67	0.2388060
NODE_41543_length_499_cov_21.135000	52	132	0	12	80	0.1500000
NODE_41543_length_499_cov_21.135000	52	132	2	68	80	0.8500000
NODE_41543_length_499_cov_21.135000	105	185	0	29	80	0.3625000
NODE_41543_length_499_cov_21.135000	105	185	2	51	80	0.6375000
NODE_41544_length_499_cov_11.917500	50	130	0	80	80	1.0000000
NODE_41544_length_499_cov_11.917500	103	183	0	80	80	1.0000000
NODE_41549_length_499_cov_5.007500	0	54	0	54	54	1.0000000
NODE_41563_length_499_cov_3.482500	307	336	10	17	29	0.5862069
NODE_41563_length_499_cov_3.482500	307	336	12	9	29	0.3103448
NODE_41563_length_499_cov_3.482500	307	336	14	3	29	0.1034483
NODE_41594_length_499_cov_2.420000	198	247	0	49	49	1.0000000
NODE_41662_length_499_cov_1.445000	311	372	0	61	61	1.0000000
NODE_41770_length_498_cov_31.704261	12	92	0	80	80	1.0000000
NODE_41770_length_498_cov_31.704261	65	145	0	80	80	1.0000000
NODE_41775_length_498_cov_7.002506	256	336	0	73	80	0.9125000
NODE_41775_length_498_cov_7.002506	256	336	2	7	80	0.0875000
NODE_41780_length_498_cov_5.759398	217	247	0	30	30	1.0000000
NODE_41814_length_498_cov_3.075188	225	262	8	8	37	0.2162162
NODE_41814_length_498_cov_3.075188	225	262	10	11	37	0.2972973
NODE_41814_length_498_cov_3.075188	225	262	12	3	37	0.0810811
NODE_41814_length_498_cov_3.075188	225	262	14	5	37	0.1351351
NODE_41814_length_498_cov_3.075188	225	262	16	7	37	0.1891892
NODE_41814_length_498_cov_3.075188	225	262	18	3	37	0.0810811
NODE_41814_length_498_cov_3.075188	246	324	12	1	78	0.0128205
NODE_41814_length_498_cov_3.075188	246	324	14	5	78	0.0641026
NODE_41814_length_498_cov_3.075188	246	324	16	7	78	0.0897436
NODE_41814_length_498_cov_3.075188	246	324	18	5	78	0.0641026
NODE_41814_length_498_cov_3.075188	246	324	20	1	78	0.0128205
NODE_41814_length_498_cov_3.075188	246	324	22	2	78	0.0256410
NODE_41814_length_498_cov_3.075188	246	324	24	15	78	0.1923077
NODE_41814_length_498_cov_3.075188	246	324	26	16	78	0.2051282
NODE_41814_length_498_cov_3.075188	246	324	28	11	78	0.1410256
NODE_41814_length_498_cov_3.075188	246	324	30	15	78	0.1923077
NODE_42016_length_497_cov_44.105528	169	249	0	14	80	0.1750000
NODE_42016_length_497_cov_44.105528	169	249	2	66	80	0.8250000
NODE_42016_length_497_cov_44.105528	222	302	0	34	80	0.4250000
NODE_42016_length_497_cov_44.105528	222	302	2	46	80	0.5750000
NODE_42017_length_497_cov_10.145729	85	165	0	40	80	0.5000000
NODE_42017_length_497_cov_10.145729	85	165	2	40	80	0.5000000
NODE_42017_length_497_cov_10.145729	138	226	0	88	88	1.0000000
NODE_42024_length_497_cov_6.618090	231	304	0	73	73	1.0000000
NODE_42024_length_497_cov_6.618090	284	364	0	80	80	1.0000000
NODE_42065_length_497_cov_2.889447	109	189	0	35	80	0.4375000
NODE_42065_length_497_cov_2.889447	109	189	2	45	80	0.5625000
NODE_42065_length_497_cov_2.889447	162	242	2	80	80	1.0000000
NODE_42071_length_497_cov_2.623116	302	368	0	58	66	0.8787879
NODE_42071_length_497_cov_2.623116	302	368	2	8	66	0.1212121
NODE_42071_length_497_cov_2.623116	355	406	0	5	51	0.0980392
NODE_42071_length_497_cov_2.623116	355	406	2	46	51	0.9019608
NODE_42100_length_497_cov_1.909548	106	186	6	5	80	0.0625000
NODE_42100_length_497_cov_1.909548	106	186	7	1	80	0.0125000
NODE_42100_length_497_cov_1.909548	106	186	8	5	80	0.0625000
NODE_42100_length_497_cov_1.909548	106	186	9	1	80	0.0125000
NODE_42100_length_497_cov_1.909548	106	186	11	1	80	0.0125000
NODE_42100_length_497_cov_1.909548	106	186	12	25	80	0.3125000
NODE_42100_length_497_cov_1.909548	106	186	14	1	80	0.0125000
NODE_42100_length_497_cov_1.909548	106	186	16	6	80	0.0750000
NODE_42100_length_497_cov_1.909548	106	186	18	8	80	0.1000000
NODE_42100_length_497_cov_1.909548	106	186	19	1	80	0.0125000
NODE_42100_length_497_cov_1.909548	106	186	20	10	80	0.1250000
NODE_42100_length_497_cov_1.909548	106	186	22	16	80	0.2000000
NODE_42100_length_497_cov_1.909548	159	240	16	5	81	0.0617284
NODE_42100_length_497_cov_1.909548	159	240	18	2	81	0.0246914
NODE_42100_length_497_cov_1.909548	159	240	19	1	81	0.0123457
NODE_42100_length_497_cov_1.909548	159	240	20	10	81	0.1234568
NODE_42100_length_497_cov_1.909548	159	240	22	25	81	0.3086420
NODE_42100_length_497_cov_1.909548	159	240	24	3	81	0.0370370
NODE_42100_length_497_cov_1.909548	159	240	26	1	81	0.0123457
NODE_42100_length_497_cov_1.909548	159	240	30	2	81	0.0246914
NODE_42100_length_497_cov_1.909548	159	240	32	1	81	0.0123457
NODE_42100_length_497_cov_1.909548	159	240	36	9	81	0.1111111
NODE_42100_length_497_cov_1.909548	159	240	38	2	81	0.0246914
NODE_42100_length_497_cov_1.909548	159	240	42	11	81	0.1358025
NODE_42100_length_497_cov_1.909548	159	240	44	8	81	0.0987654
NODE_42100_length_497_cov_1.909548	159	240	46	1	81	0.0123457
NODE_42100_length_497_cov_1.909548	262	324	8	4	62	0.0645161
NODE_42100_length_497_cov_1.909548	262	324	12	1	62	0.0161290
NODE_42100_length_497_cov_1.909548	262	324	14	1	62	0.0161290
NODE_42100_length_497_cov_1.909548	262	324	16	6	62	0.0967742
NODE_42100_length_497_cov_1.909548	262	324	20	1	62	0.0161290
NODE_42100_length_497_cov_1.909548	262	324	22	1	62	0.0161290
NODE_42100_length_497_cov_1.909548	262	324	28	2	62	0.0322581
NODE_42100_length_497_cov_1.909548	262	324	30	3	62	0.0483871
NODE_42100_length_497_cov_1.909548	262	324	32	17	62	0.2741936
NODE_42100_length_497_cov_1.909548	262	324	34	19	62	0.3064516
NODE_42100_length_497_cov_1.909548	262	324	35	4	62	0.0645161
NODE_42100_length_497_cov_1.909548	262	324	37	1	62	0.0161290
NODE_42100_length_497_cov_1.909548	262	324	40	2	62	0.0322581
NODE_42131_length_497_cov_1.500000	259	339	0	80	80	1.0000000
NODE_42136_length_497_cov_1.404523	211	263	0	52	52	1.0000000
NODE_42279_length_496_cov_5.619647	239	269	0	30	30	1.0000000
NODE_42281_length_496_cov_5.392947	103	168	0	36	65	0.5538462
NODE_42281_length_496_cov_5.392947	103	168	2	29	65	0.4461538
NODE_42281_length_496_cov_5.392947	141	221	2	80	80	1.0000000
NODE_42281_length_496_cov_5.392947	217	295	2	42	78	0.5384616
NODE_42281_length_496_cov_5.392947	217	295	4	36	78	0.4615385
NODE_42281_length_496_cov_5.392947	270	295	2	25	25	1.0000000
NODE_42287_length_496_cov_4.397985	388	467	0	18	79	0.2278481
NODE_42287_length_496_cov_4.397985	388	467	3	1	79	0.0126582
NODE_42287_length_496_cov_4.397985	388	467	4	1	79	0.0126582
NODE_42287_length_496_cov_4.397985	388	467	6	59	79	0.7468355
NODE_42288_length_496_cov_4.193955	235	315	0	9	80	0.1125000
NODE_42288_length_496_cov_4.193955	235	315	2	43	80	0.5375000
NODE_42288_length_496_cov_4.193955	235	315	4	28	80	0.3500000
NODE_42297_length_496_cov_3.531486	192	273	2	2	81	0.0246914
NODE_42297_length_496_cov_3.531486	192	273	4	22	81	0.2716049
NODE_42297_length_496_cov_3.531486	192	273	6	57	81	0.7037037
NODE_42297_length_496_cov_3.531486	245	325	0	9	80	0.1125000
NODE_42297_length_496_cov_3.531486	245	325	2	45	80	0.5625000
NODE_42297_length_496_cov_3.531486	245	325	4	14	80	0.1750000
NODE_42297_length_496_cov_3.531486	245	325	6	12	80	0.1500000
NODE_42298_length_496_cov_3.377834	252	332	0	80	80	1.0000000
NODE_42298_length_496_cov_3.377834	305	383	0	78	78	1.0000000
NODE_42316_length_496_cov_2.659950	203	251	0	48	48	1.0000000
NODE_42328_length_496_cov_2.445844	95	165	0	70	70	1.0000000
NODE_42328_length_496_cov_2.445844	148	228	0	80	80	1.0000000
NODE_42333_length_496_cov_2.214106	299	359	6	60	60	1.0000000
NODE_42415_length_496_cov_1.395466	273	317	2	44	44	1.0000000
NODE_42461_length_496_cov_0.979849	214	294	0	22	80	0.2750000
NODE_42461_length_496_cov_0.979849	214	294	2	58	80	0.7250000
NODE_42525_length_495_cov_34.888889	209	264	0	55	55	1.0000000
NODE_42526_length_495_cov_12.800505	268	348	0	80	80	1.0000000
NODE_42526_length_495_cov_12.800505	321	401	0	80	80	1.0000000
NODE_42529_length_495_cov_7.080808	386	416	0	30	30	1.0000000
NODE_42548_length_495_cov_3.868687	218	298	8	21	80	0.2625000
NODE_42548_length_495_cov_3.868687	218	298	10	5	80	0.0625000
NODE_42548_length_495_cov_3.868687	218	298	12	54	80	0.6750000
NODE_42736_length_495_cov_0.792929	274	309	4	30	35	0.8571429
NODE_42736_length_495_cov_0.792929	274	309	6	5	35	0.1428571
NODE_42773_length_494_cov_20.096203	182	262	0	14	80	0.1750000
NODE_42773_length_494_cov_20.096203	182	262	2	62	80	0.7750000
NODE_42773_length_494_cov_20.096203	182	262	4	4	80	0.0500000
NODE_42773_length_494_cov_20.096203	235	315	2	23	80	0.2875000
NODE_42773_length_494_cov_20.096203	235	315	4	46	80	0.5750000
NODE_42773_length_494_cov_20.096203	235	315	6	11	80	0.1375000
NODE_42778_length_494_cov_7.498734	187	240	0	53	53	1.0000000
NODE_42788_length_494_cov_4.283544	255	332	0	15	77	0.1948052
NODE_42788_length_494_cov_4.283544	255	332	2	62	77	0.8051948
NODE_42804_length_494_cov_3.496203	209	276	0	46	67	0.6865672
NODE_42804_length_494_cov_3.496203	209	276	2	21	67	0.3134328
NODE_42812_length_494_cov_3.032911	385	432	0	4	47	0.0851064
NODE_42812_length_494_cov_3.032911	385	432	2	10	47	0.2127660
NODE_42812_length_494_cov_3.032911	385	432	4	33	47	0.7021276
NODE_42816_length_494_cov_2.908861	189	269	0	9	80	0.1125000
NODE_42816_length_494_cov_2.908861	189	269	2	7	80	0.0875000
NODE_42816_length_494_cov_2.908861	189	269	4	5	80	0.0625000
NODE_42816_length_494_cov_2.908861	189	269	6	59	80	0.7375000
NODE_42822_length_494_cov_2.777215	145	188	0	43	43	1.0000000
NODE_42834_length_494_cov_2.531646	371	430	0	59	59	1.0000000
NODE_42834_length_494_cov_2.531646	428	494	0	66	66	1.0000000
NODE_43021_length_493_cov_34.946701	140	220	0	80	80	1.0000000
NODE_43021_length_493_cov_34.946701	193	265	0	72	72	1.0000000
NODE_43022_length_493_cov_12.451777	173	253	0	80	80	1.0000000
NODE_43022_length_493_cov_12.451777	226	306	0	80	80	1.0000000
NODE_43025_length_493_cov_8.540609	116	146	0	30	30	1.0000000
NODE_43025_length_493_cov_8.540609	119	199	0	80	80	1.0000000
NODE_43031_length_493_cov_6.144670	300	380	0	80	80	1.0000000
NODE_43031_length_493_cov_6.144670	353	433	0	80	80	1.0000000
NODE_43046_length_493_cov_3.840102	178	258	0	80	80	1.0000000
NODE_43046_length_493_cov_3.840102	231	311	0	80	80	1.0000000
NODE_43125_length_493_cov_1.588832	126	206	0	80	80	1.0000000
NODE_43125_length_493_cov_1.588832	179	259	0	80	80	1.0000000
NODE_43261_length_492_cov_5.488550	117	197	0	80	80	1.0000000
NODE_43261_length_492_cov_5.488550	170	250	0	80	80	1.0000000
NODE_43270_length_492_cov_4.445293	158	234	0	76	76	1.0000000
NODE_43270_length_492_cov_4.445293	207	285	0	78	78	1.0000000
NODE_43273_length_492_cov_4.244275	272	315	0	43	43	1.0000000
NODE_43293_length_492_cov_3.297710	113	193	4	80	80	1.0000000
NODE_43528_length_491_cov_17.196429	138	218	0	80	80	1.0000000
NODE_43528_length_491_cov_17.196429	191	271	0	80	80	1.0000000
NODE_43529_length_491_cov_17.193878	77	157	0	32	80	0.4000000
NODE_43529_length_491_cov_17.193878	77	157	2	48	80	0.6000000
NODE_43529_length_491_cov_17.193878	130	210	2	80	80	1.0000000
NODE_43535_length_491_cov_5.505102	215	284	0	6	69	0.0869565
NODE_43535_length_491_cov_5.505102	215	284	2	11	69	0.1594203
NODE_43535_length_491_cov_5.505102	215	284	4	52	69	0.7536232
NODE_43535_length_491_cov_5.505102	215	295	0	6	80	0.0750000
NODE_43535_length_491_cov_5.505102	215	295	2	11	80	0.1375000
NODE_43535_length_491_cov_5.505102	215	295	4	63	80	0.7875000
NODE_43535_length_491_cov_5.505102	268	348	0	12	80	0.1500000
NODE_43535_length_491_cov_5.505102	268	348	1	16	80	0.2000000
NODE_43535_length_491_cov_5.505102	268	348	2	1	80	0.0125000
NODE_43535_length_491_cov_5.505102	268	348	4	51	80	0.6375000
NODE_43536_length_491_cov_5.477041	169	222	0	53	53	1.0000000
NODE_43546_length_491_cov_4.176020	383	449	0	10	66	0.1515152
NODE_43546_length_491_cov_4.176020	383	449	2	56	66	0.8484849
NODE_43546_length_491_cov_4.176020	422	476	2	54	54	1.0000000
NODE_43570_length_491_cov_2.887755	348	428	0	80	80	1.0000000
NODE_43570_length_491_cov_2.887755	401	472	0	33	71	0.4647887
NODE_43570_length_491_cov_2.887755	401	472	2	38	71	0.5352113
NODE_43575_length_491_cov_2.693878	239	316	0	30	77	0.3896104
NODE_43575_length_491_cov_2.693878	239	316	2	8	77	0.1038961
NODE_43575_length_491_cov_2.693878	239	316	4	13	77	0.1688312
NODE_43575_length_491_cov_2.693878	239	316	8	26	77	0.3376623
NODE_43744_length_490_cov_10.058824	192	272	0	80	80	1.0000000
NODE_43744_length_490_cov_10.058824	245	325	0	80	80	1.0000000
NODE_43748_length_490_cov_6.652174	304	363	0	59	59	1.0000000
NODE_43816_length_490_cov_2.212276	241	300	0	59	59	1.0000000
NODE_43816_length_490_cov_2.212276	280	358	0	78	78	1.0000000
NODE_43886_length_490_cov_1.360614	97	159	2	28	62	0.4516129
NODE_43886_length_490_cov_1.360614	97	159	4	31	62	0.5000000
NODE_43886_length_490_cov_1.360614	97	159	6	3	62	0.0483871
NODE_43886_length_490_cov_1.360614	132	212	4	24	80	0.3000000
NODE_43886_length_490_cov_1.360614	132	212	6	3	80	0.0375000
NODE_43886_length_490_cov_1.360614	132	212	8	34	80	0.4250000
NODE_43886_length_490_cov_1.360614	132	212	10	19	80	0.2375000
NODE_43993_length_489_cov_55.992308	50	130	0	39	80	0.4875000
NODE_43993_length_489_cov_55.992308	50	130	2	1	80	0.0125000
NODE_43993_length_489_cov_55.992308	50	130	4	40	80	0.5000000
NODE_43993_length_489_cov_55.992308	103	183	4	50	80	0.6250000
NODE_43993_length_489_cov_55.992308	103	183	6	30	80	0.3750000
NODE_43993_length_489_cov_55.992308	179	259	0	1	80	0.0125000
NODE_43993_length_489_cov_55.992308	179	259	2	72	80	0.9000000
NODE_43993_length_489_cov_55.992308	179	259	4	6	80	0.0750000
NODE_43993_length_489_cov_55.992308	179	259	6	1	80	0.0125000
NODE_43993_length_489_cov_55.992308	232	312	0	54	80	0.6750000
NODE_43993_length_489_cov_55.992308	232	312	2	26	80	0.3250000
NODE_43994_length_489_cov_31.707692	299	384	0	31	85	0.3647059
NODE_43994_length_489_cov_31.707692	299	384	4	12	85	0.1411765
NODE_43994_length_489_cov_31.707692	299	384	6	42	85	0.4941176
NODE_43994_length_489_cov_31.707692	299	384	0	31	85	0.3647059
NODE_43994_length_489_cov_31.707692	299	384	4	12	85	0.1411765
NODE_43994_length_489_cov_31.707692	299	384	6	42	85	0.4941176
NODE_43996_length_489_cov_13.661538	227	307	0	30	80	0.3750000
NODE_43996_length_489_cov_13.661538	227	307	2	38	80	0.4750000
NODE_43996_length_489_cov_13.661538	227	307	4	12	80	0.1500000
NODE_43996_length_489_cov_13.661538	280	358	2	33	78	0.4230769
NODE_43996_length_489_cov_13.661538	280	358	4	45	78	0.5769231
NODE_43997_length_489_cov_12.017949	214	294	0	80	80	1.0000000
NODE_43997_length_489_cov_12.017949	267	347	0	80	80	1.0000000
NODE_43998_length_489_cov_10.774359	262	304	0	19	42	0.4523810
NODE_43998_length_489_cov_10.774359	262	304	2	22	42	0.5238096
NODE_43998_length_489_cov_10.774359	262	304	4	1	42	0.0238095
NODE_44001_length_489_cov_8.094872	141	221	0	1	80	0.0125000
NODE_44001_length_489_cov_8.094872	141	221	2	15	80	0.1875000
NODE_44001_length_489_cov_8.094872	141	221	4	64	80	0.8000000
NODE_44001_length_489_cov_8.094872	194	247	2	33	53	0.6226415
NODE_44001_length_489_cov_8.094872	194	247	4	20	53	0.3773585
NODE_44007_length_489_cov_5.284615	176	256	0	11	80	0.1375000
NODE_44007_length_489_cov_5.284615	176	256	2	51	80	0.6375000
NODE_44007_length_489_cov_5.284615	176	256	4	18	80	0.2250000
NODE_44007_length_489_cov_5.284615	229	309	2	9	80	0.1125000
NODE_44007_length_489_cov_5.284615	229	309	4	71	80	0.8875000
NODE_44096_length_489_cov_1.646154	234	278	1	7	44	0.1590909
NODE_44096_length_489_cov_1.646154	234	278	2	37	44	0.8409091
NODE_44105_length_489_cov_1.574359	351	391	0	40	40	1.0000000
NODE_44105_length_489_cov_1.574359	351	383	0	32	32	1.0000000
NODE_44105_length_489_cov_1.574359	365	445	0	80	80	1.0000000
NODE_44105_length_489_cov_1.574359	365	445	0	80	80	1.0000000
NODE_44105_length_489_cov_1.574359	366	445	0	79	79	1.0000000
NODE_44231_length_488_cov_15.406170	235	313	0	78	78	1.0000000
NODE_44231_length_488_cov_15.406170	286	367	0	81	81	1.0000000
NODE_44234_length_488_cov_8.416452	210	290	0	64	80	0.8000000
NODE_44234_length_488_cov_8.416452	210	290	2	16	80	0.2000000
NODE_44234_length_488_cov_8.416452	263	343	0	80	80	1.0000000
NODE_44240_length_488_cov_6.084833	254	302	0	41	48	0.8541667
NODE_44240_length_488_cov_6.084833	254	302	2	7	48	0.1458333
NODE_44243_length_488_cov_5.434447	210	279	0	69	69	1.0000000
NODE_44243_length_488_cov_5.434447	265	300	0	35	35	1.0000000
NODE_44263_length_488_cov_3.431877	212	248	0	36	36	1.0000000
NODE_44264_length_488_cov_3.424165	320	367	0	3	47	0.0638298
NODE_44264_length_488_cov_3.424165	320	367	2	22	47	0.4680851
NODE_44264_length_488_cov_3.424165	320	367	4	22	47	0.4680851
NODE_44264_length_488_cov_3.424165	320	378	0	3	58	0.0517241
NODE_44264_length_488_cov_3.424165	320	378	2	22	58	0.3793103
NODE_44264_length_488_cov_3.424165	320	378	4	33	58	0.5689655
NODE_44264_length_488_cov_3.424165	351	393	4	42	42	1.0000000
NODE_44264_length_488_cov_3.424165	360	395	4	35	35	1.0000000
NODE_44274_length_488_cov_2.850900	276	356	0	67	80	0.8375000
NODE_44274_length_488_cov_2.850900	276	356	4	13	80	0.1625000
NODE_44376_length_488_cov_1.562982	31	67	0	36	36	1.0000000
NODE_44496_length_487_cov_7.028351	278	358	0	4	80	0.0500000
NODE_44496_length_487_cov_7.028351	278	358	5	6	80	0.0750000
NODE_44496_length_487_cov_7.028351	278	358	7	10	80	0.1250000
NODE_44496_length_487_cov_7.028351	278	358	8	33	80	0.4125000
NODE_44496_length_487_cov_7.028351	278	358	10	27	80	0.3375000
NODE_44498_length_487_cov_6.804124	242	313	0	12	71	0.1690141
NODE_44498_length_487_cov_6.804124	242	313	2	1	71	0.0140845
NODE_44498_length_487_cov_6.804124	242	313	4	3	71	0.0422535
NODE_44498_length_487_cov_6.804124	242	313	6	24	71	0.3380282
NODE_44498_length_487_cov_6.804124	242	313	8	17	71	0.2394366
NODE_44498_length_487_cov_6.804124	242	313	10	9	71	0.1267606
NODE_44498_length_487_cov_6.804124	242	313	12	5	71	0.0704225
NODE_44498_length_487_cov_6.804124	286	366	0	65	80	0.8125000
NODE_44498_length_487_cov_6.804124	286	366	2	1	80	0.0125000
NODE_44498_length_487_cov_6.804124	286	366	4	3	80	0.0375000
NODE_44498_length_487_cov_6.804124	286	366	6	11	80	0.1375000
NODE_44500_length_487_cov_5.917526	140	220	0	80	80	1.0000000
NODE_44500_length_487_cov_5.917526	193	273	0	80	80	1.0000000
NODE_44520_length_487_cov_3.296392	235	315	0	27	80	0.3375000
NODE_44520_length_487_cov_3.296392	235	315	1	16	80	0.2000000
NODE_44520_length_487_cov_3.296392	235	315	3	12	80	0.1500000
NODE_44520_length_487_cov_3.296392	235	315	4	2	80	0.0250000
NODE_44520_length_487_cov_3.296392	235	315	6	23	80	0.2875000
NODE_44521_length_487_cov_3.237113	301	363	0	60	62	0.9677419
NODE_44521_length_487_cov_3.237113	301	363	2	2	62	0.0322581
NODE_44525_length_487_cov_3.074742	214	294	4	6	80	0.0750000
NODE_44525_length_487_cov_3.074742	214	294	6	38	80	0.4750000
NODE_44525_length_487_cov_3.074742	214	294	8	36	80	0.4500000
NODE_44723_length_486_cov_6.609819	206	286	0	33	80	0.4125000
NODE_44723_length_486_cov_6.609819	206	286	2	47	80	0.5875000
NODE_44728_length_486_cov_5.428941	147	227	0	32	80	0.4000000
NODE_44728_length_486_cov_5.428941	147	227	2	48	80	0.6000000
NODE_44754_length_486_cov_3.072351	131	211	0	35	80	0.4375000
NODE_44754_length_486_cov_3.072351	131	211	2	45	80	0.5625000
NODE_44754_length_486_cov_3.072351	190	235	0	45	45	1.0000000
NODE_44769_length_486_cov_2.581395	156	236	0	80	80	1.0000000
NODE_44769_length_486_cov_2.581395	209	289	0	80	80	1.0000000
NODE_44781_length_486_cov_2.343669	189	230	2	4	41	0.0975610
NODE_44781_length_486_cov_2.343669	189	230	4	37	41	0.9024390
NODE_44781_length_486_cov_2.343669	242	306	0	36	64	0.5625000
NODE_44781_length_486_cov_2.343669	242	306	2	28	64	0.4375000
NODE_44959_length_485_cov_29.505181	270	350	0	80	80	1.0000000
NODE_44959_length_485_cov_29.505181	323	403	0	80	80	1.0000000
NODE_44959_length_485_cov_29.505181	399	479	0	80	80	1.0000000
NODE_44960_length_485_cov_10.450777	67	153	0	86	86	1.0000000
NODE_44960_length_485_cov_10.450777	133	206	0	73	73	1.0000000
NODE_44965_length_485_cov_5.922280	196	273	2	28	77	0.3636364
NODE_44965_length_485_cov_5.922280	196	273	3	1	77	0.0129870
NODE_44965_length_485_cov_5.922280	196	273	4	48	77	0.6233766
NODE_44965_length_485_cov_5.922280	246	326	0	19	80	0.2375000
NODE_44965_length_485_cov_5.922280	246	326	2	47	80	0.5875000
NODE_44965_length_485_cov_5.922280	246	326	3	1	80	0.0125000
NODE_44965_length_485_cov_5.922280	246	326	4	13	80	0.1625000
NODE_44966_length_485_cov_5.818653	279	359	0	80	80	1.0000000
NODE_44966_length_485_cov_5.818653	332	412	0	80	80	1.0000000
NODE_44968_length_485_cov_5.670984	321	396	0	67	75	0.8933333
NODE_44968_length_485_cov_5.670984	321	396	2	8	75	0.1066667
NODE_44992_length_485_cov_3.518135	162	210	2	48	48	1.0000000
NODE_45005_length_485_cov_2.790155	193	253	2	60	60	1.0000000
NODE_45021_length_485_cov_2.427461	170	249	0	79	79	1.0000000
NODE_45100_length_485_cov_1.264249	232	251	0	19	19	1.0000000
NODE_45193_length_484_cov_33.384416	92	172	1	28	80	0.3500000
NODE_45193_length_484_cov_33.384416	92	172	3	18	80	0.2250000
NODE_45193_length_484_cov_33.384416	92	172	4	34	80	0.4250000
NODE_45193_length_484_cov_33.384416	145	225	4	71	80	0.8875000
NODE_45193_length_484_cov_33.384416	145	225	6	9	80	0.1125000
NODE_45195_length_484_cov_9.111688	136	216	0	80	80	1.0000000
NODE_45195_length_484_cov_9.111688	189	270	0	81	81	1.0000000
NODE_45196_length_484_cov_8.353247	165	244	0	50	79	0.6329114
NODE_45196_length_484_cov_8.353247	165	244	4	29	79	0.3670886
NODE_45196_length_484_cov_8.353247	217	297	4	80	80	1.0000000
NODE_45197_length_484_cov_8.119481	108	188	0	80	80	1.0000000
NODE_45197_length_484_cov_8.119481	161	241	0	80	80	1.0000000
NODE_45200_length_484_cov_7.703896	208	288	0	80	80	1.0000000
NODE_45200_length_484_cov_7.703896	261	341	0	80	80	1.0000000
NODE_45202_length_484_cov_7.153247	230	292	0	62	62	1.0000000
NODE_45204_length_484_cov_6.594805	221	301	0	80	80	1.0000000
NODE_45204_length_484_cov_6.594805	274	354	0	80	80	1.0000000
NODE_45218_length_484_cov_4.044156	267	347	2	3	80	0.0375000
NODE_45218_length_484_cov_4.044156	267	347	4	6	80	0.0750000
NODE_45218_length_484_cov_4.044156	267	347	6	46	80	0.5750000
NODE_45218_length_484_cov_4.044156	267	347	8	8	80	0.1000000
NODE_45218_length_484_cov_4.044156	267	347	10	17	80	0.2125000
NODE_45218_length_484_cov_4.044156	342	396	2	21	54	0.3888889
NODE_45218_length_484_cov_4.044156	342	396	4	12	54	0.2222222
NODE_45218_length_484_cov_4.044156	342	396	6	21	54	0.3888889
NODE_45225_length_484_cov_3.787013	287	331	0	44	44	1.0000000
NODE_45225_length_484_cov_3.787013	307	386	0	79	79	1.0000000
NODE_45225_length_484_cov_3.787013	317	386	0	69	69	1.0000000
NODE_45276_length_484_cov_2.254545	79	132	2	8	53	0.1509434
NODE_45276_length_484_cov_2.254545	79	132	6	45	53	0.8490566
NODE_45352_length_484_cov_1.322078	429	477	0	48	48	1.0000000
NODE_45353_length_484_cov_1.314286	431	472	0	41	41	1.0000000
NODE_45459_length_483_cov_40.815104	396	473	0	77	77	1.0000000
NODE_45459_length_483_cov_40.815104	396	473	0	77	77	1.0000000
NODE_45473_length_483_cov_5.289062	124	185	0	61	61	1.0000000
NODE_45494_length_483_cov_4.114583	226	306	4	56	80	0.7000000
NODE_45494_length_483_cov_4.114583	226	306	6	24	80	0.3000000
NODE_45494_length_483_cov_4.114583	226	305	4	55	79	0.6962025
NODE_45494_length_483_cov_4.114583	226	305	6	24	79	0.3037975
NODE_45494_length_483_cov_4.114583	226	306	4	56	80	0.7000000
NODE_45494_length_483_cov_4.114583	226	306	6	24	80	0.3000000
NODE_45494_length_483_cov_4.114583	226	306	4	56	80	0.7000000
NODE_45494_length_483_cov_4.114583	226	306	6	24	80	0.3000000
NODE_45494_length_483_cov_4.114583	279	359	2	49	80	0.6125000
NODE_45494_length_483_cov_4.114583	279	359	4	29	80	0.3625000
NODE_45494_length_483_cov_4.114583	279	359	6	2	80	0.0250000
NODE_45494_length_483_cov_4.114583	279	325	2	15	46	0.3260870
NODE_45494_length_483_cov_4.114583	279	325	4	29	46	0.6304348
NODE_45494_length_483_cov_4.114583	279	325	6	2	46	0.0434783
NODE_45494_length_483_cov_4.114583	297	323	2	13	26	0.5000000
NODE_45494_length_483_cov_4.114583	297	323	4	13	26	0.5000000
NODE_45495_length_483_cov_4.046875	68	117	0	42	49	0.8571429
NODE_45495_length_483_cov_4.046875	68	117	2	7	49	0.1428571
NODE_45495_length_483_cov_4.046875	184	250	0	66	66	1.0000000
NODE_45635_length_483_cov_1.205729	249	291	0	42	42	1.0000000
NODE_45725_length_482_cov_37.900783	72	152	2	4	80	0.0500000
NODE_45725_length_482_cov_37.900783	72	152	4	5	80	0.0625000
NODE_45725_length_482_cov_37.900783	72	152	6	71	80	0.8875000
NODE_45725_length_482_cov_37.900783	125	205	0	29	80	0.3625000
NODE_45725_length_482_cov_37.900783	125	205	4	29	80	0.3625000
NODE_45725_length_482_cov_37.900783	125	205	6	22	80	0.2750000
NODE_45728_length_482_cov_10.545692	233	297	0	64	64	1.0000000
NODE_45729_length_482_cov_9.342037	281	333	0	52	52	1.0000000
NODE_45730_length_482_cov_8.190601	247	311	0	46	64	0.7187500
NODE_45730_length_482_cov_8.190601	247	311	2	18	64	0.2812500
NODE_45730_length_482_cov_8.190601	284	355	0	71	71	1.0000000
NODE_45734_length_482_cov_6.002611	112	192	0	57	80	0.7125000
NODE_45734_length_482_cov_6.002611	112	192	4	23	80	0.2875000
NODE_45734_length_482_cov_6.002611	165	245	0	11	80	0.1375000
NODE_45734_length_482_cov_6.002611	165	245	4	69	80	0.8625000
NODE_45735_length_482_cov_5.953003	315	395	0	80	80	1.0000000
NODE_45735_length_482_cov_5.953003	368	441	0	73	73	1.0000000
NODE_45748_length_482_cov_4.530026	20	85	0	65	65	1.0000000
NODE_45759_length_482_cov_3.791123	278	358	0	80	80	1.0000000
NODE_45759_length_482_cov_3.791123	331	411	0	80	80	1.0000000
NODE_45842_length_482_cov_1.647520	382	446	0	14	64	0.2187500
NODE_45842_length_482_cov_1.647520	382	446	2	50	64	0.7812500
NODE_45842_length_482_cov_1.647520	435	482	0	9	47	0.1914894
NODE_45842_length_482_cov_1.647520	435	482	2	38	47	0.8085107
NODE_45994_length_481_cov_50.623037	154	234	0	13	80	0.1625000
NODE_45994_length_481_cov_50.623037	154	234	2	6	80	0.0750000
NODE_45994_length_481_cov_50.623037	154	234	6	6	80	0.0750000
NODE_45994_length_481_cov_50.623037	154	234	8	5	80	0.0625000
NODE_45994_length_481_cov_50.623037	154	234	10	50	80	0.6250000
NODE_45994_length_481_cov_50.623037	207	287	2	11	80	0.1375000
NODE_45994_length_481_cov_50.623037	207	287	6	11	80	0.1375000
NODE_45994_length_481_cov_50.623037	207	287	8	5	80	0.0625000
NODE_45994_length_481_cov_50.623037	207	287	10	53	80	0.6625000
NODE_45995_length_481_cov_30.939791	149	198	0	49	49	1.0000000
NODE_45995_length_481_cov_30.939791	171	235	0	64	64	1.0000000
NODE_45995_length_481_cov_30.939791	171	235	0	64	64	1.0000000
NODE_45996_length_481_cov_30.183246	0	41	0	41	41	1.0000000
NODE_45996_length_481_cov_30.183246	0	39	0	39	39	1.0000000
NODE_45996_length_481_cov_30.183246	0	44	0	44	44	1.0000000
NODE_45996_length_481_cov_30.183246	0	44	0	44	44	1.0000000
NODE_45996_length_481_cov_30.183246	0	44	0	44	44	1.0000000
NODE_45996_length_481_cov_30.183246	0	44	0	44	44	1.0000000
NODE_45996_length_481_cov_30.183246	17	97	0	80	80	1.0000000
NODE_45996_length_481_cov_30.183246	17	97	0	80	80	1.0000000
NODE_45996_length_481_cov_30.183246	17	97	0	80	80	1.0000000
NODE_45996_length_481_cov_30.183246	17	97	0	80	80	1.0000000
NODE_45996_length_481_cov_30.183246	17	97	0	80	80	1.0000000
NODE_45996_length_481_cov_30.183246	17	97	0	80	80	1.0000000
NODE_45997_length_481_cov_12.709424	250	330	0	15	80	0.1875000
NODE_45997_length_481_cov_12.709424	250	330	2	65	80	0.8125000
NODE_45997_length_481_cov_12.709424	303	383	0	68	80	0.8500000
NODE_45997_length_481_cov_12.709424	303	383	2	12	80	0.1500000
NODE_46037_length_481_cov_3.002618	197	277	0	80	80	1.0000000
NODE_46064_length_481_cov_2.261780	271	351	0	48	80	0.6000000
NODE_46064_length_481_cov_2.261780	271	351	2	32	80	0.4000000
NODE_46256_length_480_cov_22.346457	318	398	0	48	80	0.6000000
NODE_46256_length_480_cov_22.346457	318	398	2	32	80	0.4000000
NODE_46256_length_480_cov_22.346457	371	451	0	16	80	0.2000000
NODE_46256_length_480_cov_22.346457	371	451	2	64	80	0.8000000
NODE_46257_length_480_cov_16.488189	252	332	0	80	80	1.0000000
NODE_46257_length_480_cov_16.488189	305	385	0	80	80	1.0000000
NODE_46258_length_480_cov_12.874016	164	234	0	30	70	0.4285714
NODE_46258_length_480_cov_12.874016	164	234	2	40	70	0.5714286
NODE_46258_length_480_cov_12.874016	207	273	0	38	66	0.5757576
NODE_46258_length_480_cov_12.874016	207	273	2	28	66	0.4242424
NODE_46260_length_480_cov_11.879265	170	250	0	80	80	1.0000000
NODE_46260_length_480_cov_11.879265	223	303	0	80	80	1.0000000
NODE_46261_length_480_cov_8.774278	114	143	2	29	29	1.0000000
NODE_46261_length_480_cov_8.774278	165	245	2	23	80	0.2875000
NODE_46261_length_480_cov_8.774278	165	245	4	4	80	0.0500000
NODE_46261_length_480_cov_8.774278	165	245	6	46	80	0.5750000
NODE_46261_length_480_cov_8.774278	165	245	8	7	80	0.0875000
NODE_46261_length_480_cov_8.774278	218	298	2	8	80	0.1000000
NODE_46261_length_480_cov_8.774278	218	298	4	3	80	0.0375000
NODE_46261_length_480_cov_8.774278	218	298	6	69	80	0.8625000
NODE_46261_length_480_cov_8.774278	385	428	0	41	43	0.9534883
NODE_46261_length_480_cov_8.774278	385	428	2	2	43	0.0465116
NODE_46271_length_480_cov_5.671916	231	302	0	17	71	0.2394366
NODE_46271_length_480_cov_5.671916	231	302	2	54	71	0.7605634
NODE_46283_length_480_cov_4.354331	126	187	0	57	61	0.9344262
NODE_46283_length_480_cov_4.354331	126	187	2	4	61	0.0655738
NODE_46283_length_480_cov_4.354331	218	298	0	80	80	1.0000000
NODE_46445_length_480_cov_1.152231	142	216	0	58	74	0.7837838
NODE_46445_length_480_cov_1.152231	142	216	2	16	74	0.2162162
NODE_46470_length_480_cov_0.973753	31	71	0	6	40	0.1500000
NODE_46470_length_480_cov_0.973753	31	71	2	34	40	0.8500000
NODE_46533_length_479_cov_28.205263	308	388	4	18	80	0.2250000
NODE_46533_length_479_cov_28.205263	308	388	6	23	80	0.2875000
NODE_46533_length_479_cov_28.205263	308	388	8	39	80	0.4875000
NODE_46533_length_479_cov_28.205263	361	441	2	43	80	0.5375000
NODE_46533_length_479_cov_28.205263	361	441	4	8	80	0.1000000
NODE_46533_length_479_cov_28.205263	361	441	6	23	80	0.2875000
NODE_46533_length_479_cov_28.205263	361	441	8	6	80	0.0750000
NODE_46534_length_479_cov_23.944737	189	269	0	80	80	1.0000000
NODE_46534_length_479_cov_23.944737	242	322	0	80	80	1.0000000
NODE_46554_length_479_cov_4.942105	283	363	0	80	80	1.0000000
NODE_46554_length_479_cov_4.942105	336	416	0	80	80	1.0000000
NODE_46574_length_479_cov_3.494737	217	279	0	54	62	0.8709677
NODE_46574_length_479_cov_3.494737	217	279	2	2	62	0.0322581
NODE_46574_length_479_cov_3.494737	217	279	4	6	62	0.0967742
NODE_46574_length_479_cov_3.494737	272	332	0	60	60	1.0000000
NODE_46611_length_479_cov_2.281579	219	265	0	9	46	0.1956522
NODE_46611_length_479_cov_2.281579	219	265	3	1	46	0.0217391
NODE_46611_length_479_cov_2.281579	219	265	4	4	46	0.0869565
NODE_46611_length_479_cov_2.281579	219	265	6	17	46	0.3695652
NODE_46611_length_479_cov_2.281579	219	265	8	14	46	0.3043478
NODE_46611_length_479_cov_2.281579	219	265	10	1	46	0.0217391
NODE_46638_length_479_cov_1.839474	376	431	0	50	55	0.9090909
NODE_46638_length_479_cov_1.839474	376	431	2	5	55	0.0909091
NODE_46654_length_479_cov_1.710526	203	265	2	62	62	1.0000000
NODE_46654_length_479_cov_1.710526	248	318	2	70	70	1.0000000
NODE_46828_length_478_cov_336.139842	153	233	86	1	80	0.0125000
NODE_46828_length_478_cov_336.139842	153	233	88	2	80	0.0250000
NODE_46828_length_478_cov_336.139842	153	233	90	1	80	0.0125000
NODE_46828_length_478_cov_336.139842	153	233	100	3	80	0.0375000
NODE_46828_length_478_cov_336.139842	153	233	106	5	80	0.0625000
NODE_46828_length_478_cov_336.139842	153	233	112	1	80	0.0125000
NODE_46828_length_478_cov_336.139842	153	233	114	1	80	0.0125000
NODE_46828_length_478_cov_336.139842	153	233	121	1	80	0.0125000
NODE_46828_length_478_cov_336.139842	153	233	126	2	80	0.0250000
NODE_46828_length_478_cov_336.139842	153	233	128	2	80	0.0250000
NODE_46828_length_478_cov_336.139842	153	233	133	1	80	0.0125000
NODE_46828_length_478_cov_336.139842	153	233	134	3	80	0.0375000
NODE_46828_length_478_cov_336.139842	153	233	136	4	80	0.0500000
NODE_46828_length_478_cov_336.139842	153	233	139	1	80	0.0125000
NODE_46828_length_478_cov_336.139842	153	233	141	3	80	0.0375000
NODE_46828_length_478_cov_336.139842	153	233	142	2	80	0.0250000
NODE_46828_length_478_cov_336.139842	153	233	144	2	80	0.0250000
NODE_46828_length_478_cov_336.139842	153	233	146	2	80	0.0250000
NODE_46828_length_478_cov_336.139842	153	233	148	2	80	0.0250000
NODE_46828_length_478_cov_336.139842	153	233	150	1	80	0.0125000
NODE_46828_length_478_cov_336.139842	153	233	152	1	80	0.0125000
NODE_46828_length_478_cov_336.139842	153	233	154	3	80	0.0375000
NODE_46828_length_478_cov_336.139842	153	233	158	2	80	0.0250000
NODE_46828_length_478_cov_336.139842	153	233	160	1	80	0.0125000
NODE_46828_length_478_cov_336.139842	153	233	162	1	80	0.0125000
NODE_46828_length_478_cov_336.139842	153	233	166	1	80	0.0125000
NODE_46828_length_478_cov_336.139842	153	233	174	2	80	0.0250000
NODE_46828_length_478_cov_336.139842	153	233	176	1	80	0.0125000
NODE_46828_length_478_cov_336.139842	153	233	178	1	80	0.0125000
NODE_46828_length_478_cov_336.139842	153	233	180	1	80	0.0125000
NODE_46828_length_478_cov_336.139842	153	233	183	1	80	0.0125000
NODE_46828_length_478_cov_336.139842	153	233	185	1	80	0.0125000
NODE_46828_length_478_cov_336.139842	153	233	186	2	80	0.0250000
NODE_46828_length_478_cov_336.139842	153	233	187	1	80	0.0125000
NODE_46828_length_478_cov_336.139842	153	233	188	3	80	0.0375000
NODE_46828_length_478_cov_336.139842	153	233	189	3	80	0.0375000
NODE_46828_length_478_cov_336.139842	153	233	190	1	80	0.0125000
NODE_46828_length_478_cov_336.139842	153	233	191	1	80	0.0125000
NODE_46828_length_478_cov_336.139842	153	233	192	1	80	0.0125000
NODE_46828_length_478_cov_336.139842	153	233	194	1	80	0.0125000
NODE_46828_length_478_cov_336.139842	153	233	195	1	80	0.0125000
NODE_46828_length_478_cov_336.139842	153	233	196	1	80	0.0125000
NODE_46828_length_478_cov_336.139842	153	233	198	8	80	0.1000000
NODE_46828_length_478_cov_336.139842	153	233	199	1	80	0.0125000
NODE_46828_length_478_cov_336.139842	206	286	148	1	80	0.0125000
NODE_46828_length_478_cov_336.139842	206	286	150	1	80	0.0125000
NODE_46828_length_478_cov_336.139842	206	286	156	1	80	0.0125000
NODE_46828_length_478_cov_336.139842	206	286	158	1	80	0.0125000
NODE_46828_length_478_cov_336.139842	206	286	165	1	80	0.0125000
NODE_46828_length_478_cov_336.139842	206	286	170	1	80	0.0125000
NODE_46828_length_478_cov_336.139842	206	286	176	1	80	0.0125000
NODE_46828_length_478_cov_336.139842	206	286	177	1	80	0.0125000
NODE_46828_length_478_cov_336.139842	206	286	179	3	80	0.0375000
NODE_46828_length_478_cov_336.139842	206	286	180	1	80	0.0125000
NODE_46828_length_478_cov_336.139842	206	286	181	1	80	0.0125000
NODE_46828_length_478_cov_336.139842	206	286	183	4	80	0.0500000
NODE_46828_length_478_cov_336.139842	206	286	184	1	80	0.0125000
NODE_46828_length_478_cov_336.139842	206	286	185	6	80	0.0750000
NODE_46828_length_478_cov_336.139842	206	286	186	3	80	0.0375000
NODE_46828_length_478_cov_336.139842	206	286	187	3	80	0.0375000
NODE_46828_length_478_cov_336.139842	206	286	188	4	80	0.0500000
NODE_46828_length_478_cov_336.139842	206	286	189	3	80	0.0375000
NODE_46828_length_478_cov_336.139842	206	286	190	4	80	0.0500000
NODE_46828_length_478_cov_336.139842	206	286	191	1	80	0.0125000
NODE_46828_length_478_cov_336.139842	206	286	192	5	80	0.0625000
NODE_46828_length_478_cov_336.139842	206	286	194	4	80	0.0500000
NODE_46828_length_478_cov_336.139842	206	286	195	4	80	0.0500000
NODE_46828_length_478_cov_336.139842	206	286	196	2	80	0.0250000
NODE_46828_length_478_cov_336.139842	206	286	197	1	80	0.0125000
NODE_46828_length_478_cov_336.139842	206	286	198	8	80	0.1000000
NODE_46828_length_478_cov_336.139842	206	286	199	4	80	0.0500000
NODE_46828_length_478_cov_336.139842	206	286	200	3	80	0.0375000
NODE_46828_length_478_cov_336.139842	206	286	201	1	80	0.0125000
NODE_46828_length_478_cov_336.139842	206	286	202	5	80	0.0625000
NODE_46828_length_478_cov_336.139842	206	286	203	1	80	0.0125000
NODE_46846_length_478_cov_4.448549	150	230	0	80	80	1.0000000
NODE_46846_length_478_cov_4.448549	203	284	0	81	81	1.0000000
NODE_46874_length_478_cov_2.627968	228	278	0	50	50	1.0000000
NODE_47128_length_477_cov_36.230159	225	305	0	4	80	0.0500000
NODE_47128_length_477_cov_36.230159	225	305	2	76	80	0.9500000
NODE_47128_length_477_cov_36.230159	278	358	2	80	80	1.0000000
NODE_47129_length_477_cov_33.111111	307	387	14	12	80	0.1500000
NODE_47129_length_477_cov_33.111111	307	387	16	25	80	0.3125000
NODE_47129_length_477_cov_33.111111	307	387	18	23	80	0.2875000
NODE_47129_length_477_cov_33.111111	307	387	20	14	80	0.1750000
NODE_47129_length_477_cov_33.111111	307	387	22	6	80	0.0750000
NODE_47129_length_477_cov_33.111111	360	440	6	25	80	0.3125000
NODE_47129_length_477_cov_33.111111	360	440	8	2	80	0.0250000
NODE_47129_length_477_cov_33.111111	360	440	10	5	80	0.0625000
NODE_47129_length_477_cov_33.111111	360	440	12	11	80	0.1375000
NODE_47129_length_477_cov_33.111111	360	440	14	5	80	0.0625000
NODE_47129_length_477_cov_33.111111	360	440	16	9	80	0.1125000
NODE_47129_length_477_cov_33.111111	360	440	18	3	80	0.0375000
NODE_47129_length_477_cov_33.111111	360	440	20	14	80	0.1750000
NODE_47129_length_477_cov_33.111111	360	440	22	6	80	0.0750000
NODE_47133_length_477_cov_11.235450	119	199	0	80	80	1.0000000
NODE_47133_length_477_cov_11.235450	172	247	0	75	75	1.0000000
NODE_47135_length_477_cov_9.359788	221	301	0	68	80	0.8500000
NODE_47135_length_477_cov_9.359788	221	301	2	12	80	0.1500000
NODE_47135_length_477_cov_9.359788	274	354	0	80	80	1.0000000
NODE_47139_length_477_cov_7.436508	230	304	2	19	74	0.2567568
NODE_47139_length_477_cov_7.436508	230	304	8	13	74	0.1756757
NODE_47139_length_477_cov_7.436508	230	304	10	14	74	0.1891892
NODE_47139_length_477_cov_7.436508	230	304	12	7	74	0.0945946
NODE_47139_length_477_cov_7.436508	230	304	14	21	74	0.2837838
NODE_47140_length_477_cov_7.433862	43	123	0	80	80	1.0000000
NODE_47140_length_477_cov_7.433862	96	176	0	80	80	1.0000000
NODE_47143_length_477_cov_6.846561	163	243	0	49	80	0.6125000
NODE_47143_length_477_cov_6.846561	163	243	2	31	80	0.3875000
NODE_47143_length_477_cov_6.846561	216	296	2	80	80	1.0000000
NODE_47147_length_477_cov_5.677249	150	228	0	26	78	0.3333333
NODE_47147_length_477_cov_5.677249	150	228	2	52	78	0.6666667
NODE_47148_length_477_cov_5.084656	227	288	2	9	61	0.1475410
NODE_47148_length_477_cov_5.084656	227	288	4	52	61	0.8524590
NODE_47253_length_477_cov_1.629630	115	171	4	12	56	0.2142857
NODE_47253_length_477_cov_1.629630	115	171	6	44	56	0.7857143
NODE_47253_length_477_cov_1.629630	167	224	4	57	57	1.0000000
NODE_47375_length_477_cov_0.859788	445	477	0	32	32	1.0000000
NODE_47427_length_476_cov_7.533156	221	301	0	80	80	1.0000000
NODE_47427_length_476_cov_7.533156	274	354	0	80	80	1.0000000
NODE_47529_length_476_cov_1.618037	385	444	4	25	59	0.4237288
NODE_47529_length_476_cov_1.618037	385	444	6	34	59	0.5762712
NODE_47601_length_476_cov_1.129973	15	34	0	11	19	0.5789474
NODE_47601_length_476_cov_1.129973	15	34	2	8	19	0.4210526
NODE_47620_length_476_cov_1.037135	180	243	0	15	63	0.2380952
NODE_47620_length_476_cov_1.037135	180	243	2	48	63	0.7619048
NODE_47620_length_476_cov_1.037135	237	296	0	8	59	0.1355932
NODE_47620_length_476_cov_1.037135	237	296	2	51	59	0.8644068
NODE_47693_length_475_cov_34.460106	270	350	0	80	80	1.0000000
NODE_47693_length_475_cov_34.460106	323	403	0	80	80	1.0000000
NODE_47694_length_475_cov_30.087766	273	353	0	11	80	0.1375000
NODE_47694_length_475_cov_30.087766	273	353	2	40	80	0.5000000
NODE_47694_length_475_cov_30.087766	273	353	4	29	80	0.3625000
NODE_47694_length_475_cov_30.087766	326	406	2	11	80	0.1375000
NODE_47694_length_475_cov_30.087766	326	406	4	69	80	0.8625000
NODE_47695_length_475_cov_10.247340	42	122	2	36	80	0.4500000
NODE_47695_length_475_cov_10.247340	42	122	4	44	80	0.5500000
NODE_47701_length_475_cov_8.393617	9	89	0	15	80	0.1875000
NODE_47701_length_475_cov_8.393617	9	89	7	8	80	0.1000000
NODE_47701_length_475_cov_8.393617	9	89	8	57	80	0.7125000
NODE_47701_length_475_cov_8.393617	62	142	5	10	80	0.1250000
NODE_47701_length_475_cov_8.393617	62	142	6	38	80	0.4750000
NODE_47701_length_475_cov_8.393617	62	142	7	13	80	0.1625000
NODE_47701_length_475_cov_8.393617	62	142	8	19	80	0.2375000
NODE_47828_length_475_cov_1.531915	272	352	0	80	80	1.0000000
NODE_47839_length_475_cov_1.457447	50	93	0	43	43	1.0000000
NODE_47979_length_474_cov_49.453333	392	472	9	4	80	0.0500000
NODE_47979_length_474_cov_49.453333	392	472	12	1	80	0.0125000
NODE_47979_length_474_cov_49.453333	392	472	14	2	80	0.0250000
NODE_47979_length_474_cov_49.453333	392	472	16	1	80	0.0125000
NODE_47979_length_474_cov_49.453333	392	472	17	2	80	0.0250000
NODE_47979_length_474_cov_49.453333	392	472	18	3	80	0.0375000
NODE_47979_length_474_cov_49.453333	392	472	22	2	80	0.0250000
NODE_47979_length_474_cov_49.453333	392	472	24	1	80	0.0125000
NODE_47979_length_474_cov_49.453333	392	472	27	1	80	0.0125000
NODE_47979_length_474_cov_49.453333	392	472	33	2	80	0.0250000
NODE_47979_length_474_cov_49.453333	392	472	35	3	80	0.0375000
NODE_47979_length_474_cov_49.453333	392	472	37	2	80	0.0250000
NODE_47979_length_474_cov_49.453333	392	472	39	2	80	0.0250000
NODE_47979_length_474_cov_49.453333	392	472	41	1	80	0.0125000
NODE_47979_length_474_cov_49.453333	392	472	43	1	80	0.0125000
NODE_47979_length_474_cov_49.453333	392	472	44	1	80	0.0125000
NODE_47979_length_474_cov_49.453333	392	472	51	2	80	0.0250000
NODE_47979_length_474_cov_49.453333	392	472	59	3	80	0.0375000
NODE_47979_length_474_cov_49.453333	392	472	65	2	80	0.0250000
NODE_47979_length_474_cov_49.453333	392	472	67	2	80	0.0250000
NODE_47979_length_474_cov_49.453333	392	472	69	3	80	0.0375000
NODE_47979_length_474_cov_49.453333	392	472	73	1	80	0.0125000
NODE_47979_length_474_cov_49.453333	392	472	75	1	80	0.0125000
NODE_47979_length_474_cov_49.453333	392	472	81	4	80	0.0500000
NODE_47979_length_474_cov_49.453333	392	472	83	3	80	0.0375000
NODE_47979_length_474_cov_49.453333	392	472	89	1	80	0.0125000
NODE_47979_length_474_cov_49.453333	392	472	90	1	80	0.0125000
NODE_47979_length_474_cov_49.453333	392	472	95	1	80	0.0125000
NODE_47979_length_474_cov_49.453333	392	472	97	2	80	0.0250000
NODE_47979_length_474_cov_49.453333	392	472	99	1	80	0.0125000
NODE_47979_length_474_cov_49.453333	392	472	101	1	80	0.0125000
NODE_47979_length_474_cov_49.453333	392	472	109	1	80	0.0125000
NODE_47979_length_474_cov_49.453333	392	472	112	1	80	0.0125000
NODE_47979_length_474_cov_49.453333	392	472	118	1	80	0.0125000
NODE_47979_length_474_cov_49.453333	392	472	120	1	80	0.0125000
NODE_47979_length_474_cov_49.453333	392	472	124	1	80	0.0125000
NODE_47979_length_474_cov_49.453333	392	472	128	2	80	0.0250000
NODE_47979_length_474_cov_49.453333	392	472	130	1	80	0.0125000
NODE_47979_length_474_cov_49.453333	392	472	132	1	80	0.0125000
NODE_47979_length_474_cov_49.453333	392	472	133	3	80	0.0375000
NODE_47979_length_474_cov_49.453333	392	472	135	1	80	0.0125000
NODE_47979_length_474_cov_49.453333	392	472	137	5	80	0.0625000
NODE_47979_length_474_cov_49.453333	392	472	139	1	80	0.0125000
NODE_47979_length_474_cov_49.453333	392	472	140	2	80	0.0250000
NODE_47979_length_474_cov_49.453333	392	472	142	2	80	0.0250000
NODE_47979_length_474_cov_49.453333	445	474	3	1	29	0.0344828
NODE_47979_length_474_cov_49.453333	445	474	5	1	29	0.0344828
NODE_47979_length_474_cov_49.453333	445	474	9	4	29	0.1379310
NODE_47979_length_474_cov_49.453333	445	474	12	1	29	0.0344828
NODE_47979_length_474_cov_49.453333	445	474	14	2	29	0.0689655
NODE_47979_length_474_cov_49.453333	445	474	16	1	29	0.0344828
NODE_47979_length_474_cov_49.453333	445	474	17	2	29	0.0689655
NODE_47979_length_474_cov_49.453333	445	474	18	3	29	0.1034483
NODE_47979_length_474_cov_49.453333	445	474	22	2	29	0.0689655
NODE_47979_length_474_cov_49.453333	445	474	24	1	29	0.0344828
NODE_47979_length_474_cov_49.453333	445	474	27	1	29	0.0344828
NODE_47979_length_474_cov_49.453333	445	474	33	2	29	0.0689655
NODE_47979_length_474_cov_49.453333	445	474	35	3	29	0.1034483
NODE_47979_length_474_cov_49.453333	445	474	37	2	29	0.0689655
NODE_47979_length_474_cov_49.453333	445	474	39	2	29	0.0689655
NODE_47979_length_474_cov_49.453333	445	474	41	1	29	0.0344828
NODE_47981_length_474_cov_24.930667	287	367	0	7	80	0.0875000
NODE_47981_length_474_cov_24.930667	287	367	2	73	80	0.9125000
NODE_47981_length_474_cov_24.930667	340	420	0	8	80	0.1000000
NODE_47981_length_474_cov_24.930667	340	420	2	72	80	0.9000000
NODE_47982_length_474_cov_15.952000	258	338	0	80	80	1.0000000
NODE_47982_length_474_cov_15.952000	311	391	0	80	80	1.0000000
NODE_48003_length_474_cov_3.986667	172	252	2	1	80	0.0125000
NODE_48003_length_474_cov_3.986667	172	252	4	6	80	0.0750000
NODE_48003_length_474_cov_3.986667	172	252	5	1	80	0.0125000
NODE_48003_length_474_cov_3.986667	172	252	6	1	80	0.0125000
NODE_48003_length_474_cov_3.986667	172	252	10	15	80	0.1875000
NODE_48003_length_474_cov_3.986667	172	252	12	56	80	0.7000000
NODE_48015_length_474_cov_3.496000	163	243	2	70	80	0.8750000
NODE_48015_length_474_cov_3.496000	163	243	4	10	80	0.1250000
NODE_48038_length_474_cov_2.784000	259	300	0	41	41	1.0000000
NODE_48116_length_474_cov_1.538667	41	62	0	21	21	1.0000000
NODE_48181_length_474_cov_1.085333	0	50	0	50	50	1.0000000
NODE_48184_length_474_cov_1.056000	95	133	0	38	38	1.0000000
NODE_48266_length_473_cov_82.374332	123	203	0	8	80	0.1000000
NODE_48266_length_473_cov_82.374332	123	203	1	11	80	0.1375000
NODE_48266_length_473_cov_82.374332	123	203	2	3	80	0.0375000
NODE_48266_length_473_cov_82.374332	123	203	4	58	80	0.7250000
NODE_48266_length_473_cov_82.374332	176	256	0	61	80	0.7625000
NODE_48266_length_473_cov_82.374332	176	256	1	11	80	0.1375000
NODE_48266_length_473_cov_82.374332	176	256	2	3	80	0.0375000
NODE_48266_length_473_cov_82.374332	176	256	4	5	80	0.0625000
NODE_48267_length_473_cov_54.882353	199	279	0	80	80	1.0000000
NODE_48267_length_473_cov_54.882353	252	332	0	80	80	1.0000000
NODE_48268_length_473_cov_48.997326	119	194	8	10	75	0.1333333
NODE_48268_length_473_cov_48.997326	119	194	10	46	75	0.6133333
NODE_48268_length_473_cov_48.997326	119	194	11	1	75	0.0133333
NODE_48268_length_473_cov_48.997326	119	194	12	18	75	0.2400000
NODE_48268_length_473_cov_48.997326	119	194	8	10	75	0.1333333
NODE_48268_length_473_cov_48.997326	119	194	10	46	75	0.6133333
NODE_48268_length_473_cov_48.997326	119	194	11	1	75	0.0133333
NODE_48268_length_473_cov_48.997326	119	194	12	18	75	0.2400000
NODE_48268_length_473_cov_48.997326	167	247	1	7	80	0.0875000
NODE_48268_length_473_cov_48.997326	167	247	3	21	80	0.2625000
NODE_48268_length_473_cov_48.997326	167	247	5	10	80	0.1250000
NODE_48268_length_473_cov_48.997326	167	247	6	9	80	0.1125000
NODE_48268_length_473_cov_48.997326	167	247	8	12	80	0.1500000
NODE_48268_length_473_cov_48.997326	167	247	9	4	80	0.0500000
NODE_48268_length_473_cov_48.997326	167	247	10	17	80	0.2125000
NODE_48269_length_473_cov_30.679144	174	254	2	34	80	0.4250000
NODE_48269_length_473_cov_30.679144	174	254	4	5	80	0.0625000
NODE_48269_length_473_cov_30.679144	174	254	6	5	80	0.0625000
NODE_48269_length_473_cov_30.679144	174	254	8	2	80	0.0250000
NODE_48269_length_473_cov_30.679144	174	254	9	4	80	0.0500000
NODE_48269_length_473_cov_30.679144	174	254	10	17	80	0.2125000
NODE_48269_length_473_cov_30.679144	174	254	11	2	80	0.0250000
NODE_48269_length_473_cov_30.679144	174	254	14	4	80	0.0500000
NODE_48269_length_473_cov_30.679144	174	254	16	1	80	0.0125000
NODE_48269_length_473_cov_30.679144	174	254	18	4	80	0.0500000
NODE_48269_length_473_cov_30.679144	174	254	20	2	80	0.0250000
NODE_48269_length_473_cov_30.679144	226	307	0	4	81	0.0493827
NODE_48269_length_473_cov_30.679144	226	307	2	77	81	0.9506173
NODE_48269_length_473_cov_30.679144	227	307	0	4	80	0.0500000
NODE_48269_length_473_cov_30.679144	227	307	2	76	80	0.9500000
NODE_48270_length_473_cov_24.967914	295	370	0	75	75	1.0000000
NODE_48270_length_473_cov_24.967914	343	423	0	80	80	1.0000000
NODE_48271_length_473_cov_18.540107	168	248	0	1	80	0.0125000
NODE_48271_length_473_cov_18.540107	168	248	2	53	80	0.6625000
NODE_48271_length_473_cov_18.540107	168	248	6	7	80	0.0875000
NODE_48271_length_473_cov_18.540107	168	248	8	9	80	0.1125000
NODE_48271_length_473_cov_18.540107	168	248	10	10	80	0.1250000
NODE_48271_length_473_cov_18.540107	221	301	2	1	80	0.0125000
NODE_48271_length_473_cov_18.540107	221	301	6	7	80	0.0875000
NODE_48271_length_473_cov_18.540107	221	301	8	37	80	0.4625000
NODE_48271_length_473_cov_18.540107	221	301	10	35	80	0.4375000
NODE_48272_length_473_cov_15.871658	143	223	0	80	80	1.0000000
NODE_48272_length_473_cov_15.871658	196	276	0	80	80	1.0000000
NODE_48291_length_473_cov_4.363636	160	240	0	80	80	1.0000000
NODE_48291_length_473_cov_4.363636	213	293	0	80	80	1.0000000
NODE_48320_length_473_cov_2.959893	199	267	0	68	68	1.0000000
NODE_48325_length_473_cov_2.804813	207	269	0	62	62	1.0000000
NODE_48350_length_473_cov_2.251337	48	128	2	12	80	0.1500000
NODE_48350_length_473_cov_2.251337	48	128	4	68	80	0.8500000
NODE_48350_length_473_cov_2.251337	101	181	2	62	80	0.7750000
NODE_48350_length_473_cov_2.251337	101	181	4	18	80	0.2250000
NODE_48568_length_472_cov_50.077748	1	81	0	4	80	0.0500000
NODE_48568_length_472_cov_50.077748	1	81	2	17	80	0.2125000
NODE_48568_length_472_cov_50.077748	1	81	4	30	80	0.3750000
NODE_48568_length_472_cov_50.077748	1	81	9	1	80	0.0125000
NODE_48568_length_472_cov_50.077748	1	81	10	1	80	0.0125000
NODE_48568_length_472_cov_50.077748	1	81	11	1	80	0.0125000
NODE_48568_length_472_cov_50.077748	1	81	12	15	80	0.1875000
NODE_48568_length_472_cov_50.077748	1	81	14	11	80	0.1375000
NODE_48568_length_472_cov_50.077748	1	81	0	4	80	0.0500000
NODE_48568_length_472_cov_50.077748	1	81	2	17	80	0.2125000
NODE_48568_length_472_cov_50.077748	1	81	4	30	80	0.3750000
NODE_48568_length_472_cov_50.077748	1	81	9	1	80	0.0125000
NODE_48568_length_472_cov_50.077748	1	81	10	1	80	0.0125000
NODE_48568_length_472_cov_50.077748	1	81	11	1	80	0.0125000
NODE_48568_length_472_cov_50.077748	1	81	12	15	80	0.1875000
NODE_48568_length_472_cov_50.077748	1	81	14	11	80	0.1375000
NODE_48568_length_472_cov_50.077748	1	81	0	4	80	0.0500000
NODE_48568_length_472_cov_50.077748	1	81	2	17	80	0.2125000
NODE_48568_length_472_cov_50.077748	1	81	4	30	80	0.3750000
NODE_48568_length_472_cov_50.077748	1	81	9	1	80	0.0125000
NODE_48568_length_472_cov_50.077748	1	81	10	1	80	0.0125000
NODE_48568_length_472_cov_50.077748	1	81	11	1	80	0.0125000
NODE_48568_length_472_cov_50.077748	1	81	12	15	80	0.1875000
NODE_48568_length_472_cov_50.077748	1	81	14	11	80	0.1375000
NODE_48568_length_472_cov_50.077748	1	81	0	4	80	0.0500000
NODE_48568_length_472_cov_50.077748	1	81	2	17	80	0.2125000
NODE_48568_length_472_cov_50.077748	1	81	4	30	80	0.3750000
NODE_48568_length_472_cov_50.077748	1	81	9	1	80	0.0125000
NODE_48568_length_472_cov_50.077748	1	81	10	1	80	0.0125000
NODE_48568_length_472_cov_50.077748	1	81	11	1	80	0.0125000
NODE_48568_length_472_cov_50.077748	1	81	12	15	80	0.1875000
NODE_48568_length_472_cov_50.077748	1	81	14	11	80	0.1375000
NODE_48568_length_472_cov_50.077748	1	81	0	4	80	0.0500000
NODE_48568_length_472_cov_50.077748	1	81	2	17	80	0.2125000
NODE_48568_length_472_cov_50.077748	1	81	4	30	80	0.3750000
NODE_48568_length_472_cov_50.077748	1	81	9	1	80	0.0125000
NODE_48568_length_472_cov_50.077748	1	81	10	1	80	0.0125000
NODE_48568_length_472_cov_50.077748	1	81	11	1	80	0.0125000
NODE_48568_length_472_cov_50.077748	1	81	12	15	80	0.1875000
NODE_48568_length_472_cov_50.077748	1	81	14	11	80	0.1375000
NODE_48568_length_472_cov_50.077748	10	81	2	12	71	0.1690141
NODE_48568_length_472_cov_50.077748	10	81	4	30	71	0.4225352
NODE_48568_length_472_cov_50.077748	10	81	9	1	71	0.0140845
NODE_48568_length_472_cov_50.077748	10	81	10	1	71	0.0140845
NODE_48568_length_472_cov_50.077748	10	81	11	1	71	0.0140845
NODE_48568_length_472_cov_50.077748	10	81	12	15	71	0.2112676
NODE_48568_length_472_cov_50.077748	10	81	14	11	71	0.1549296
NODE_48568_length_472_cov_50.077748	54	131	4	13	77	0.1688312
NODE_48568_length_472_cov_50.077748	54	131	6	3	77	0.0389610
NODE_48568_length_472_cov_50.077748	54	131	11	1	77	0.0129870
NODE_48568_length_472_cov_50.077748	54	131	12	16	77	0.2077922
NODE_48568_length_472_cov_50.077748	54	131	14	44	77	0.5714286
NODE_48568_length_472_cov_50.077748	54	131	4	13	77	0.1688312
NODE_48568_length_472_cov_50.077748	54	131	6	3	77	0.0389610
NODE_48568_length_472_cov_50.077748	54	131	11	1	77	0.0129870
NODE_48568_length_472_cov_50.077748	54	131	12	16	77	0.2077922
NODE_48568_length_472_cov_50.077748	54	131	14	44	77	0.5714286
NODE_48568_length_472_cov_50.077748	54	131	4	13	77	0.1688312
NODE_48568_length_472_cov_50.077748	54	131	6	3	77	0.0389610
NODE_48568_length_472_cov_50.077748	54	131	11	1	77	0.0129870
NODE_48568_length_472_cov_50.077748	54	131	12	16	77	0.2077922
NODE_48568_length_472_cov_50.077748	54	131	14	44	77	0.5714286
NODE_48568_length_472_cov_50.077748	130	204	2	1	74	0.0135135
NODE_48568_length_472_cov_50.077748	130	204	4	37	74	0.5000000
NODE_48568_length_472_cov_50.077748	130	204	6	36	74	0.4864865
NODE_48569_length_472_cov_10.469169	294	374	0	80	80	1.0000000
NODE_48569_length_472_cov_10.469169	347	427	0	80	80	1.0000000
NODE_48570_length_472_cov_10.195710	143	223	0	80	80	1.0000000
NODE_48570_length_472_cov_10.195710	196	276	0	80	80	1.0000000
NODE_48593_length_472_cov_4.375335	165	245	0	14	80	0.1750000
NODE_48593_length_472_cov_4.375335	165	245	2	66	80	0.8250000
NODE_48593_length_472_cov_4.375335	218	251	2	33	33	1.0000000
NODE_48614_length_472_cov_3.495979	305	349	0	44	44	1.0000000
NODE_48620_length_472_cov_3.093834	220	295	0	75	75	1.0000000
NODE_48638_length_472_cov_2.592493	431	471	0	40	40	1.0000000
NODE_48745_length_472_cov_1.294906	43	98	0	55	55	1.0000000
NODE_48745_length_472_cov_1.294906	71	151	0	36	80	0.4500000
NODE_48745_length_472_cov_1.294906	71	151	2	44	80	0.5500000
NODE_48768_length_472_cov_1.211796	106	126	0	20	20	1.0000000
NODE_48873_length_471_cov_39.319892	119	193	2	71	74	0.9594595
NODE_48873_length_471_cov_39.319892	119	193	4	2	74	0.0270270
NODE_48873_length_471_cov_39.319892	119	193	20	1	74	0.0135135
NODE_48874_length_471_cov_24.279570	185	265	0	27	80	0.3375000
NODE_48874_length_471_cov_24.279570	185	265	2	47	80	0.5875000
NODE_48874_length_471_cov_24.279570	185	265	6	6	80	0.0750000
NODE_48874_length_471_cov_24.279570	238	318	0	80	80	1.0000000
NODE_48875_length_471_cov_19.669355	83	163	2	80	80	1.0000000
NODE_48875_length_471_cov_19.669355	136	216	0	38	80	0.4750000
NODE_48875_length_471_cov_19.669355	136	216	2	42	80	0.5250000
NODE_48876_length_471_cov_14.387097	198	278	0	80	80	1.0000000
NODE_48876_length_471_cov_14.387097	251	331	0	80	80	1.0000000
NODE_48881_length_471_cov_6.948925	186	213	0	27	27	1.0000000
NODE_48881_length_471_cov_6.948925	204	284	0	80	80	1.0000000
NODE_48881_length_471_cov_6.948925	244	275	0	31	31	1.0000000
NODE_48881_length_471_cov_6.948925	257	337	0	80	80	1.0000000
NODE_48881_length_471_cov_6.948925	268	337	0	69	69	1.0000000
NODE_48902_length_471_cov_3.803763	83	162	0	56	79	0.7088608
NODE_48902_length_471_cov_3.803763	83	162	4	23	79	0.2911392
NODE_48902_length_471_cov_3.803763	135	215	0	80	80	1.0000000
NODE_48924_length_471_cov_2.954301	284	315	6	15	31	0.4838710
NODE_48924_length_471_cov_2.954301	284	315	7	11	31	0.3548387
NODE_48924_length_471_cov_2.954301	284	315	8	5	31	0.1612903
NODE_48957_length_471_cov_2.287634	133	200	2	25	67	0.3731343
NODE_48957_length_471_cov_2.287634	133	200	4	4	67	0.0597015
NODE_48957_length_471_cov_2.287634	133	200	6	1	67	0.0149254
NODE_48957_length_471_cov_2.287634	133	200	8	3	67	0.0447761
NODE_48957_length_471_cov_2.287634	133	200	10	1	67	0.0149254
NODE_48957_length_471_cov_2.287634	133	200	12	6	67	0.0895522
NODE_48957_length_471_cov_2.287634	133	200	14	6	67	0.0895522
NODE_48957_length_471_cov_2.287634	133	200	15	21	67	0.3134328
NODE_49186_length_470_cov_57.078167	184	264	0	39	80	0.4875000
NODE_49186_length_470_cov_57.078167	184	264	2	41	80	0.5125000
NODE_49186_length_470_cov_57.078167	237	317	2	45	80	0.5625000
NODE_49186_length_470_cov_57.078167	237	317	6	7	80	0.0875000
NODE_49186_length_470_cov_57.078167	237	317	7	3	80	0.0375000
NODE_49186_length_470_cov_57.078167	237	317	8	14	80	0.1750000
NODE_49186_length_470_cov_57.078167	237	317	9	2	80	0.0250000
NODE_49186_length_470_cov_57.078167	237	317	10	9	80	0.1125000
NODE_49186_length_470_cov_57.078167	313	393	8	44	80	0.5500000
NODE_49186_length_470_cov_57.078167	313	393	10	2	80	0.0250000
NODE_49186_length_470_cov_57.078167	313	393	12	5	80	0.0625000
NODE_49186_length_470_cov_57.078167	313	393	14	29	80	0.3625000
NODE_49186_length_470_cov_57.078167	366	446	4	4	80	0.0500000
NODE_49186_length_470_cov_57.078167	366	446	5	3	80	0.0375000
NODE_49186_length_470_cov_57.078167	366	446	6	6	80	0.0750000
NODE_49186_length_470_cov_57.078167	366	446	8	3	80	0.0375000
NODE_49186_length_470_cov_57.078167	366	446	10	16	80	0.2000000
NODE_49186_length_470_cov_57.078167	366	446	14	48	80	0.6000000
NODE_49187_length_470_cov_34.035040	228	308	0	80	80	1.0000000
NODE_49187_length_470_cov_34.035040	281	361	0	80	80	1.0000000
NODE_49187_length_470_cov_34.035040	357	437	0	80	80	1.0000000
NODE_49187_length_470_cov_34.035040	410	470	0	60	60	1.0000000
NODE_49188_length_470_cov_15.539084	142	222	0	27	80	0.3375000
NODE_49188_length_470_cov_15.539084	142	222	2	53	80	0.6625000
NODE_49188_length_470_cov_15.539084	195	275	2	80	80	1.0000000
NODE_49193_length_470_cov_6.070081	272	330	18	5	58	0.0862069
NODE_49193_length_470_cov_6.070081	272	330	20	25	58	0.4310345
NODE_49193_length_470_cov_6.070081	272	330	22	18	58	0.3103448
NODE_49193_length_470_cov_6.070081	272	330	24	5	58	0.0862069
NODE_49193_length_470_cov_6.070081	272	330	26	2	58	0.0344828
NODE_49193_length_470_cov_6.070081	272	330	28	3	58	0.0517241
NODE_49193_length_470_cov_6.070081	325	383	0	2	58	0.0344828
NODE_49193_length_470_cov_6.070081	325	383	2	1	58	0.0172414
NODE_49193_length_470_cov_6.070081	325	383	3	2	58	0.0344828
NODE_49193_length_470_cov_6.070081	325	383	4	9	58	0.1551724
NODE_49193_length_470_cov_6.070081	325	383	5	5	58	0.0862069
NODE_49193_length_470_cov_6.070081	325	383	9	10	58	0.1724138
NODE_49193_length_470_cov_6.070081	325	383	11	2	58	0.0344828
NODE_49193_length_470_cov_6.070081	325	383	13	1	58	0.0172414
NODE_49193_length_470_cov_6.070081	325	383	15	9	58	0.1551724
NODE_49193_length_470_cov_6.070081	325	383	16	8	58	0.1379310
NODE_49193_length_470_cov_6.070081	325	383	17	1	58	0.0172414
NODE_49193_length_470_cov_6.070081	325	383	18	8	58	0.1379310
NODE_49215_length_470_cov_3.735849	194	251	0	57	57	1.0000000
NODE_49260_length_470_cov_2.363881	403	422	4	19	19	1.0000000
NODE_49260_length_470_cov_2.363881	403	422	4	19	19	1.0000000
NODE_49389_length_470_cov_1.142857	414	470	0	12	56	0.2142857
NODE_49389_length_470_cov_1.142857	414	470	1	5	56	0.0892857
NODE_49389_length_470_cov_1.142857	414	470	2	23	56	0.4107143
NODE_49389_length_470_cov_1.142857	414	470	4	16	56	0.2857143
NODE_49502_length_469_cov_221.024324	150	228	117	1	78	0.0128205
NODE_49502_length_469_cov_221.024324	150	228	118	2	78	0.0256410
NODE_49502_length_469_cov_221.024324	150	228	120	1	78	0.0128205
NODE_49502_length_469_cov_221.024324	150	228	128	1	78	0.0128205
NODE_49502_length_469_cov_221.024324	150	228	138	2	78	0.0256410
NODE_49502_length_469_cov_221.024324	150	228	142	1	78	0.0128205
NODE_49502_length_469_cov_221.024324	150	228	155	1	78	0.0128205
NODE_49502_length_469_cov_221.024324	150	228	156	1	78	0.0128205
NODE_49502_length_469_cov_221.024324	150	228	161	1	78	0.0128205
NODE_49502_length_469_cov_221.024324	150	228	162	1	78	0.0128205
NODE_49502_length_469_cov_221.024324	150	228	164	1	78	0.0128205
NODE_49502_length_469_cov_221.024324	150	228	166	2	78	0.0256410
NODE_49502_length_469_cov_221.024324	150	228	167	2	78	0.0256410
NODE_49502_length_469_cov_221.024324	150	228	169	3	78	0.0384615
NODE_49502_length_469_cov_221.024324	150	228	170	1	78	0.0128205
NODE_49502_length_469_cov_221.024324	150	228	173	4	78	0.0512821
NODE_49502_length_469_cov_221.024324	150	228	174	11	78	0.1410256
NODE_49502_length_469_cov_221.024324	150	228	175	2	78	0.0256410
NODE_49502_length_469_cov_221.024324	150	228	180	1	78	0.0128205
NODE_49502_length_469_cov_221.024324	150	228	181	1	78	0.0128205
NODE_49502_length_469_cov_221.024324	150	228	182	1	78	0.0128205
NODE_49502_length_469_cov_221.024324	150	228	183	1	78	0.0128205
NODE_49502_length_469_cov_221.024324	150	228	185	2	78	0.0256410
NODE_49502_length_469_cov_221.024324	150	228	186	1	78	0.0128205
NODE_49502_length_469_cov_221.024324	150	228	193	4	78	0.0512821
NODE_49502_length_469_cov_221.024324	150	228	194	1	78	0.0128205
NODE_49502_length_469_cov_221.024324	150	228	195	4	78	0.0512821
NODE_49502_length_469_cov_221.024324	150	228	198	11	78	0.1410256
NODE_49502_length_469_cov_221.024324	150	228	200	2	78	0.0256410
NODE_49502_length_469_cov_221.024324	150	228	201	2	78	0.0256410
NODE_49502_length_469_cov_221.024324	150	228	202	4	78	0.0512821
NODE_49502_length_469_cov_221.024324	150	228	203	2	78	0.0256410
NODE_49502_length_469_cov_221.024324	150	228	204	1	78	0.0128205
NODE_49502_length_469_cov_221.024324	150	228	205	2	78	0.0256410
NODE_49502_length_469_cov_221.024324	150	228	117	1	78	0.0128205
NODE_49502_length_469_cov_221.024324	150	228	118	2	78	0.0256410
NODE_49502_length_469_cov_221.024324	150	228	120	1	78	0.0128205
NODE_49502_length_469_cov_221.024324	150	228	128	1	78	0.0128205
NODE_49502_length_469_cov_221.024324	150	228	138	2	78	0.0256410
NODE_49502_length_469_cov_221.024324	150	228	142	1	78	0.0128205
NODE_49502_length_469_cov_221.024324	150	228	155	1	78	0.0128205
NODE_49502_length_469_cov_221.024324	150	228	156	1	78	0.0128205
NODE_49502_length_469_cov_221.024324	150	228	161	1	78	0.0128205
NODE_49502_length_469_cov_221.024324	150	228	162	1	78	0.0128205
NODE_49502_length_469_cov_221.024324	150	228	164	1	78	0.0128205
NODE_49502_length_469_cov_221.024324	150	228	166	2	78	0.0256410
NODE_49502_length_469_cov_221.024324	150	228	167	2	78	0.0256410
NODE_49502_length_469_cov_221.024324	150	228	169	3	78	0.0384615
NODE_49502_length_469_cov_221.024324	150	228	170	1	78	0.0128205
NODE_49502_length_469_cov_221.024324	150	228	173	4	78	0.0512821
NODE_49502_length_469_cov_221.024324	150	228	174	11	78	0.1410256
NODE_49502_length_469_cov_221.024324	150	228	175	2	78	0.0256410
NODE_49502_length_469_cov_221.024324	150	228	180	1	78	0.0128205
NODE_49502_length_469_cov_221.024324	150	228	181	1	78	0.0128205
NODE_49502_length_469_cov_221.024324	150	228	182	1	78	0.0128205
NODE_49502_length_469_cov_221.024324	150	228	183	1	78	0.0128205
NODE_49502_length_469_cov_221.024324	150	228	185	2	78	0.0256410
NODE_49502_length_469_cov_221.024324	150	228	186	1	78	0.0128205
NODE_49502_length_469_cov_221.024324	150	228	193	4	78	0.0512821
NODE_49502_length_469_cov_221.024324	150	228	194	1	78	0.0128205
NODE_49502_length_469_cov_221.024324	150	228	195	4	78	0.0512821
NODE_49502_length_469_cov_221.024324	150	228	198	11	78	0.1410256
NODE_49502_length_469_cov_221.024324	150	228	200	2	78	0.0256410
NODE_49502_length_469_cov_221.024324	150	228	201	2	78	0.0256410
NODE_49502_length_469_cov_221.024324	150	228	202	4	78	0.0512821
NODE_49502_length_469_cov_221.024324	150	228	203	2	78	0.0256410
NODE_49502_length_469_cov_221.024324	150	228	204	1	78	0.0128205
NODE_49502_length_469_cov_221.024324	150	228	205	2	78	0.0256410
NODE_49502_length_469_cov_221.024324	150	219	156	1	69	0.0144928
NODE_49502_length_469_cov_221.024324	150	219	161	1	69	0.0144928
NODE_49502_length_469_cov_221.024324	150	219	162	1	69	0.0144928
NODE_49502_length_469_cov_221.024324	150	219	164	1	69	0.0144928
NODE_49502_length_469_cov_221.024324	150	219	166	2	69	0.0289855
NODE_49502_length_469_cov_221.024324	150	219	167	2	69	0.0289855
NODE_49502_length_469_cov_221.024324	150	219	169	3	69	0.0434783
NODE_49502_length_469_cov_221.024324	150	219	170	1	69	0.0144928
NODE_49502_length_469_cov_221.024324	150	219	173	4	69	0.0579710
NODE_49502_length_469_cov_221.024324	150	219	174	11	69	0.1594203
NODE_49502_length_469_cov_221.024324	150	219	175	2	69	0.0289855
NODE_49502_length_469_cov_221.024324	150	219	180	1	69	0.0144928
NODE_49502_length_469_cov_221.024324	150	219	181	1	69	0.0144928
NODE_49502_length_469_cov_221.024324	150	219	182	1	69	0.0144928
NODE_49502_length_469_cov_221.024324	150	219	183	1	69	0.0144928
NODE_49502_length_469_cov_221.024324	150	219	185	2	69	0.0289855
NODE_49502_length_469_cov_221.024324	150	219	186	1	69	0.0144928
NODE_49502_length_469_cov_221.024324	150	219	193	4	69	0.0579710
NODE_49502_length_469_cov_221.024324	150	219	194	1	69	0.0144928
NODE_49502_length_469_cov_221.024324	150	219	195	4	69	0.0579710
NODE_49502_length_469_cov_221.024324	150	219	198	11	69	0.1594203
NODE_49502_length_469_cov_221.024324	150	219	200	2	69	0.0289855
NODE_49502_length_469_cov_221.024324	150	219	201	2	69	0.0289855
NODE_49502_length_469_cov_221.024324	150	219	202	4	69	0.0579710
NODE_49502_length_469_cov_221.024324	150	219	203	2	69	0.0289855
NODE_49502_length_469_cov_221.024324	150	219	204	1	69	0.0144928
NODE_49502_length_469_cov_221.024324	150	219	205	2	69	0.0289855
NODE_49557_length_469_cov_2.686486	263	343	2	80	80	1.0000000
NODE_49561_length_469_cov_2.521622	237	289	0	52	52	1.0000000
NODE_49579_length_469_cov_2.224324	279	331	0	33	52	0.6346154
NODE_49579_length_469_cov_2.224324	279	331	2	9	52	0.1730769
NODE_49579_length_469_cov_2.224324	279	331	6	10	52	0.1923077
NODE_49796_length_468_cov_8.043360	190	250	2	52	60	0.8666667
NODE_49796_length_468_cov_8.043360	190	250	3	5	60	0.0833333
NODE_49796_length_468_cov_8.043360	190	250	4	3	60	0.0500000
NODE_49796_length_468_cov_8.043360	223	303	2	21	80	0.2625000
NODE_49796_length_468_cov_8.043360	223	303	3	5	80	0.0625000
NODE_49796_length_468_cov_8.043360	223	303	4	54	80	0.6750000
NODE_49800_length_468_cov_6.046070	152	232	0	80	80	1.0000000
NODE_49800_length_468_cov_6.046070	205	285	0	80	80	1.0000000
NODE_49801_length_468_cov_5.997290	81	161	2	57	80	0.7125000
NODE_49801_length_468_cov_5.997290	81	161	4	23	80	0.2875000
NODE_49801_length_468_cov_5.997290	134	214	2	38	80	0.4750000
NODE_49801_length_468_cov_5.997290	134	214	4	32	80	0.4000000
NODE_49801_length_468_cov_5.997290	134	214	6	10	80	0.1250000
NODE_49801_length_468_cov_5.997290	210	270	4	54	60	0.9000000
NODE_49801_length_468_cov_5.997290	210	270	6	6	60	0.1000000
NODE_49803_length_468_cov_5.872629	133	201	2	5	68	0.0735294
NODE_49803_length_468_cov_5.872629	133	201	6	47	68	0.6911765
NODE_49803_length_468_cov_5.872629	133	201	8	16	68	0.2352941
NODE_49807_length_468_cov_5.384824	305	356	0	51	51	1.0000000
NODE_49894_length_468_cov_2.067751	45	96	2	51	51	1.0000000
NODE_49913_length_468_cov_1.891599	4	63	0	59	59	1.0000000
NODE_49928_length_468_cov_1.758808	140	218	0	78	78	1.0000000
NODE_49928_length_468_cov_1.758808	191	257	0	66	66	1.0000000
NODE_49974_length_468_cov_1.390244	291	310	0	19	19	1.0000000
NODE_49974_length_468_cov_1.390244	369	405	0	6	36	0.1666667
NODE_49974_length_468_cov_1.390244	369	405	2	30	36	0.8333333
NODE_50133_length_467_cov_14.100543	176	256	0	80	80	1.0000000
NODE_50134_length_467_cov_11.902174	193	236	0	43	43	1.0000000
NODE_50135_length_467_cov_10.875000	226	306	0	80	80	1.0000000
NODE_50135_length_467_cov_10.875000	279	359	0	80	80	1.0000000
NODE_50144_length_467_cov_6.625000	206	275	0	16	69	0.2318841
NODE_50144_length_467_cov_6.625000	206	275	2	21	69	0.3043478
NODE_50144_length_467_cov_6.625000	206	275	6	32	69	0.4637681
NODE_50144_length_467_cov_6.625000	257	328	4	25	71	0.3521127
NODE_50144_length_467_cov_6.625000	257	328	6	46	71	0.6478873
NODE_50197_length_467_cov_2.709239	247	327	0	80	80	1.0000000
NODE_50215_length_467_cov_2.296196	284	329	0	45	45	1.0000000
NODE_50238_length_467_cov_2.027174	218	269	0	51	51	1.0000000
NODE_50252_length_467_cov_1.836957	55	118	0	63	63	1.0000000
NODE_50267_length_467_cov_1.603261	92	141	0	8	49	0.1632653
NODE_50267_length_467_cov_1.603261	92	141	2	31	49	0.6326531
NODE_50267_length_467_cov_1.603261	92	141	4	10	49	0.2040816
NODE_50283_length_467_cov_1.426630	135	183	2	48	48	1.0000000
NODE_50447_length_466_cov_42.839237	0	47	0	47	47	1.0000000
NODE_50447_length_466_cov_42.839237	20	100	0	80	80	1.0000000
NODE_50447_length_466_cov_42.839237	96	176	0	17	80	0.2125000
NODE_50447_length_466_cov_42.839237	96	176	4	17	80	0.2125000
NODE_50447_length_466_cov_42.839237	96	176	6	46	80	0.5750000
NODE_50447_length_466_cov_42.839237	149	229	4	23	80	0.2875000
NODE_50447_length_466_cov_42.839237	149	229	6	57	80	0.7125000
NODE_50448_length_466_cov_36.901907	85	165	0	21	80	0.2625000
NODE_50448_length_466_cov_36.901907	85	165	2	59	80	0.7375000
NODE_50448_length_466_cov_36.901907	138	218	2	80	80	1.0000000
NODE_50448_length_466_cov_36.901907	214	294	0	73	80	0.9125000
NODE_50448_length_466_cov_36.901907	214	294	2	7	80	0.0875000
NODE_50448_length_466_cov_36.901907	267	347	0	38	80	0.4750000
NODE_50448_length_466_cov_36.901907	267	347	2	42	80	0.5250000
NODE_50457_length_466_cov_5.122616	275	316	0	41	41	1.0000000
NODE_50457_length_466_cov_5.122616	276	316	0	40	40	1.0000000
NODE_50457_length_466_cov_5.122616	289	338	0	49	49	1.0000000
NODE_50515_length_466_cov_2.602180	9	90	4	3	81	0.0370370
NODE_50515_length_466_cov_2.602180	9	90	8	16	81	0.1975309
NODE_50515_length_466_cov_2.602180	9	90	12	18	81	0.2222222
NODE_50515_length_466_cov_2.602180	9	90	14	44	81	0.5432099
NODE_50515_length_466_cov_2.602180	312	341	4	1	29	0.0344828
NODE_50515_length_466_cov_2.602180	312	341	6	28	29	0.9655172
NODE_50549_length_466_cov_2.108992	130	182	4	52	52	1.0000000
NODE_50562_length_466_cov_1.980926	183	265	0	60	82	0.7317073
NODE_50562_length_466_cov_1.980926	183	265	2	22	82	0.2682927
NODE_50787_length_465_cov_13.019126	170	250	0	80	80	1.0000000
NODE_50787_length_465_cov_13.019126	223	301	0	52	78	0.6666667
NODE_50787_length_465_cov_13.019126	223	301	4	12	78	0.1538462
NODE_50787_length_465_cov_13.019126	223	301	6	14	78	0.1794872
NODE_50799_length_465_cov_5.363388	316	393	0	77	77	1.0000000
NODE_50800_length_465_cov_4.898907	376	406	0	30	30	1.0000000
NODE_50869_length_465_cov_2.366120	147	227	0	80	80	1.0000000
NODE_50869_length_465_cov_2.366120	200	271	0	71	71	1.0000000
NODE_50911_length_465_cov_1.737705	338	383	0	45	45	1.0000000
NODE_51100_length_464_cov_8.473973	209	289	0	56	80	0.7000000
NODE_51100_length_464_cov_8.473973	209	289	2	24	80	0.3000000
NODE_51100_length_464_cov_8.473973	262	342	0	80	80	1.0000000
NODE_51148_length_464_cov_2.528767	136	199	0	63	63	1.0000000
NODE_51167_length_464_cov_2.134247	130	203	0	40	73	0.5479452
NODE_51167_length_464_cov_2.134247	130	203	2	33	73	0.4520548
NODE_51186_length_464_cov_1.901370	58	138	0	3	80	0.0375000
NODE_51186_length_464_cov_1.901370	58	138	6	77	80	0.9625000
NODE_51203_length_464_cov_1.706849	186	265	0	41	79	0.5189874
NODE_51203_length_464_cov_1.706849	186	265	2	38	79	0.4810127
NODE_51377_length_463_cov_64.420330	375	455	0	14	80	0.1750000
NODE_51377_length_463_cov_64.420330	375	455	2	19	80	0.2375000
NODE_51377_length_463_cov_64.420330	375	455	4	47	80	0.5875000
NODE_51377_length_463_cov_64.420330	375	455	0	14	80	0.1750000
NODE_51377_length_463_cov_64.420330	375	455	2	19	80	0.2375000
NODE_51377_length_463_cov_64.420330	375	455	4	47	80	0.5875000
NODE_51377_length_463_cov_64.420330	375	455	0	14	80	0.1750000
NODE_51377_length_463_cov_64.420330	375	455	2	19	80	0.2375000
NODE_51377_length_463_cov_64.420330	375	455	4	47	80	0.5875000
NODE_51377_length_463_cov_64.420330	375	455	0	14	80	0.1750000
NODE_51377_length_463_cov_64.420330	375	455	2	19	80	0.2375000
NODE_51377_length_463_cov_64.420330	375	455	4	47	80	0.5875000
NODE_51377_length_463_cov_64.420330	375	455	0	14	80	0.1750000
NODE_51377_length_463_cov_64.420330	375	455	2	19	80	0.2375000
NODE_51377_length_463_cov_64.420330	375	455	4	47	80	0.5875000
NODE_51378_length_463_cov_49.673077	0	71	1	20	71	0.2816902
NODE_51378_length_463_cov_49.673077	0	71	3	17	71	0.2394366
NODE_51378_length_463_cov_49.673077	0	71	6	2	71	0.0281690
NODE_51378_length_463_cov_49.673077	0	71	7	25	71	0.3521127
NODE_51378_length_463_cov_49.673077	0	71	8	7	71	0.0985916
NODE_51378_length_463_cov_49.673077	44	121	7	20	77	0.2597403
NODE_51378_length_463_cov_49.673077	44	121	8	57	77	0.7402598
NODE_51379_length_463_cov_41.005495	8	88	0	35	80	0.4375000
NODE_51379_length_463_cov_41.005495	8	88	2	45	80	0.5625000
NODE_51379_length_463_cov_41.005495	61	141	2	80	80	1.0000000
NODE_51380_length_463_cov_30.626374	318	398	0	80	80	1.0000000
NODE_51380_length_463_cov_30.626374	371	451	0	80	80	1.0000000
NODE_51381_length_463_cov_27.475275	211	291	0	39	80	0.4875000
NODE_51381_length_463_cov_27.475275	211	291	2	41	80	0.5125000
NODE_51381_length_463_cov_27.475275	264	344	0	9	80	0.1125000
NODE_51381_length_463_cov_27.475275	264	344	2	71	80	0.8875000
NODE_51383_length_463_cov_11.211538	304	377	0	4	73	0.0547945
NODE_51383_length_463_cov_11.211538	304	377	2	69	73	0.9452055
NODE_51383_length_463_cov_11.211538	350	430	0	57	80	0.7125000
NODE_51383_length_463_cov_11.211538	350	430	2	23	80	0.2875000
NODE_51391_length_463_cov_5.711538	181	261	4	40	80	0.5000000
NODE_51391_length_463_cov_5.711538	181	261	6	40	80	0.5000000
NODE_51391_length_463_cov_5.711538	234	314	0	4	80	0.0500000
NODE_51391_length_463_cov_5.711538	234	314	2	8	80	0.1000000
NODE_51391_length_463_cov_5.711538	234	314	4	26	80	0.3250000
NODE_51391_length_463_cov_5.711538	234	314	6	42	80	0.5250000
NODE_51399_length_463_cov_4.398352	119	169	0	50	50	1.0000000
NODE_51402_length_463_cov_4.186813	175	233	6	8	58	0.1379310
NODE_51402_length_463_cov_4.186813	175	233	8	50	58	0.8620690
NODE_51402_length_463_cov_4.186813	206	251	8	45	45	1.0000000
NODE_51408_length_463_cov_3.846154	235	268	4	33	33	1.0000000
NODE_51421_length_463_cov_3.063187	193	248	0	55	55	1.0000000
NODE_51421_length_463_cov_3.063187	222	301	0	77	79	0.9746835
NODE_51421_length_463_cov_3.063187	222	301	2	2	79	0.0253165
NODE_51680_length_462_cov_21.876033	93	173	0	80	80	1.0000000
NODE_51680_length_462_cov_21.876033	146	226	0	80	80	1.0000000
NODE_51687_length_462_cov_5.033058	93	154	2	61	61	1.0000000
NODE_51687_length_462_cov_5.033058	159	209	0	25	50	0.5000000
NODE_51687_length_462_cov_5.033058	159	209	2	25	50	0.5000000
NODE_51699_length_462_cov_4.101928	168	246	0	25	78	0.3205128
NODE_51699_length_462_cov_4.101928	168	246	2	53	78	0.6794872
NODE_51699_length_462_cov_4.101928	184	208	0	9	24	0.3750000
NODE_51699_length_462_cov_4.101928	184	208	2	15	24	0.6250000
NODE_51699_length_462_cov_4.101928	219	299	0	41	80	0.5125000
NODE_51699_length_462_cov_4.101928	219	299	2	39	80	0.4875000
NODE_51708_length_462_cov_3.630854	149	194	0	45	45	1.0000000
NODE_51720_length_462_cov_3.079890	103	147	0	35	44	0.7954546
NODE_51720_length_462_cov_3.079890	103	147	2	9	44	0.2045455
NODE_51735_length_462_cov_2.677686	78	118	0	15	40	0.3750000
NODE_51735_length_462_cov_2.677686	78	118	2	25	40	0.6250000
NODE_51763_length_462_cov_2.209366	18	58	0	40	40	1.0000000
NODE_51817_length_462_cov_1.570248	68	113	0	45	45	1.0000000
NODE_51995_length_461_cov_35.116022	0	79	0	79	79	1.0000000
NODE_51995_length_461_cov_35.116022	52	132	0	80	80	1.0000000
NODE_51996_length_461_cov_11.124309	77	157	0	80	80	1.0000000
NODE_51996_length_461_cov_11.124309	130	210	0	80	80	1.0000000
NODE_52010_length_461_cov_5.361878	246	322	0	76	76	1.0000000
NODE_52018_length_461_cov_4.472376	268	333	0	65	65	1.0000000
NODE_52021_length_461_cov_4.168508	159	234	0	46	75	0.6133333
NODE_52021_length_461_cov_4.168508	159	234	2	29	75	0.3866667
NODE_52047_length_461_cov_2.892265	233	312	2	79	79	1.0000000
NODE_52073_length_461_cov_2.392265	186	223	0	37	37	1.0000000
NODE_52154_length_461_cov_1.389503	283	349	0	3	66	0.0454545
NODE_52154_length_461_cov_1.389503	283	349	2	63	66	0.9545454
NODE_52292_length_460_cov_172.986150	0	68	4	3	68	0.0441176
NODE_52292_length_460_cov_172.986150	0	68	9	1	68	0.0147059
NODE_52292_length_460_cov_172.986150	0	68	15	1	68	0.0147059
NODE_52292_length_460_cov_172.986150	0	68	25	1	68	0.0147059
NODE_52292_length_460_cov_172.986150	0	68	28	2	68	0.0294118
NODE_52292_length_460_cov_172.986150	0	68	38	1	68	0.0147059
NODE_52292_length_460_cov_172.986150	0	68	46	1	68	0.0147059
NODE_52292_length_460_cov_172.986150	0	68	52	1	68	0.0147059
NODE_52292_length_460_cov_172.986150	0	68	55	1	68	0.0147059
NODE_52292_length_460_cov_172.986150	0	68	57	1	68	0.0147059
NODE_52292_length_460_cov_172.986150	0	68	59	1	68	0.0147059
NODE_52292_length_460_cov_172.986150	0	68	62	2	68	0.0294118
NODE_52292_length_460_cov_172.986150	0	68	72	1	68	0.0147059
NODE_52292_length_460_cov_172.986150	0	68	77	1	68	0.0147059
NODE_52292_length_460_cov_172.986150	0	68	81	1	68	0.0147059
NODE_52292_length_460_cov_172.986150	0	68	85	1	68	0.0147059
NODE_52292_length_460_cov_172.986150	0	68	90	1	68	0.0147059
NODE_52292_length_460_cov_172.986150	0	68	94	1	68	0.0147059
NODE_52292_length_460_cov_172.986150	0	68	99	1	68	0.0147059
NODE_52292_length_460_cov_172.986150	0	68	106	1	68	0.0147059
NODE_52292_length_460_cov_172.986150	0	68	110	1	68	0.0147059
NODE_52292_length_460_cov_172.986150	0	68	116	2	68	0.0294118
NODE_52292_length_460_cov_172.986150	0	68	124	2	68	0.0294118
NODE_52292_length_460_cov_172.986150	0	68	126	1	68	0.0147059
NODE_52292_length_460_cov_172.986150	0	68	130	3	68	0.0441176
NODE_52292_length_460_cov_172.986150	0	68	132	1	68	0.0147059
NODE_52292_length_460_cov_172.986150	0	68	134	1	68	0.0147059
NODE_52292_length_460_cov_172.986150	0	68	136	2	68	0.0294118
NODE_52292_length_460_cov_172.986150	0	68	144	5	68	0.0735294
NODE_52292_length_460_cov_172.986150	0	68	148	2	68	0.0294118
NODE_52292_length_460_cov_172.986150	0	68	154	1	68	0.0147059
NODE_52292_length_460_cov_172.986150	0	68	158	2	68	0.0294118
NODE_52292_length_460_cov_172.986150	0	68	162	1	68	0.0147059
NODE_52292_length_460_cov_172.986150	0	68	174	1	68	0.0147059
NODE_52292_length_460_cov_172.986150	0	68	177	1	68	0.0147059
NODE_52292_length_460_cov_172.986150	0	68	181	2	68	0.0294118
NODE_52292_length_460_cov_172.986150	0	68	185	2	68	0.0294118
NODE_52292_length_460_cov_172.986150	0	68	197	1	68	0.0147059
NODE_52292_length_460_cov_172.986150	0	68	199	3	68	0.0441176
NODE_52292_length_460_cov_172.986150	0	68	200	1	68	0.0147059
NODE_52292_length_460_cov_172.986150	0	68	204	2	68	0.0294118
NODE_52292_length_460_cov_172.986150	0	68	206	2	68	0.0294118
NODE_52292_length_460_cov_172.986150	0	68	207	3	68	0.0441176
NODE_52292_length_460_cov_172.986150	0	68	213	2	68	0.0294118
NODE_52292_length_460_cov_172.986150	41	121	144	1	80	0.0125000
NODE_52292_length_460_cov_172.986150	41	121	148	2	80	0.0250000
NODE_52292_length_460_cov_172.986150	41	121	154	1	80	0.0125000
NODE_52292_length_460_cov_172.986150	41	121	158	2	80	0.0250000
NODE_52292_length_460_cov_172.986150	41	121	162	1	80	0.0125000
NODE_52292_length_460_cov_172.986150	41	121	174	1	80	0.0125000
NODE_52292_length_460_cov_172.986150	41	121	177	1	80	0.0125000
NODE_52292_length_460_cov_172.986150	41	121	181	2	80	0.0250000
NODE_52292_length_460_cov_172.986150	41	121	185	2	80	0.0250000
NODE_52292_length_460_cov_172.986150	41	121	197	1	80	0.0125000
NODE_52292_length_460_cov_172.986150	41	121	199	3	80	0.0375000
NODE_52292_length_460_cov_172.986150	41	121	200	1	80	0.0125000
NODE_52292_length_460_cov_172.986150	41	121	204	2	80	0.0250000
NODE_52292_length_460_cov_172.986150	41	121	206	2	80	0.0250000
NODE_52292_length_460_cov_172.986150	41	121	207	3	80	0.0375000
NODE_52292_length_460_cov_172.986150	41	121	213	3	80	0.0375000
NODE_52292_length_460_cov_172.986150	41	121	215	1	80	0.0125000
NODE_52292_length_460_cov_172.986150	41	121	221	1	80	0.0125000
NODE_52292_length_460_cov_172.986150	41	121	223	2	80	0.0250000
NODE_52292_length_460_cov_172.986150	41	121	224	2	80	0.0250000
NODE_52292_length_460_cov_172.986150	41	121	225	4	80	0.0500000
NODE_52292_length_460_cov_172.986150	41	121	227	1	80	0.0125000
NODE_52292_length_460_cov_172.986150	41	121	229	2	80	0.0250000
NODE_52292_length_460_cov_172.986150	41	121	235	1	80	0.0125000
NODE_52292_length_460_cov_172.986150	41	121	237	2	80	0.0250000
NODE_52292_length_460_cov_172.986150	41	121	239	3	80	0.0375000
NODE_52292_length_460_cov_172.986150	41	121	241	2	80	0.0250000
NODE_52292_length_460_cov_172.986150	41	121	245	3	80	0.0375000
NODE_52292_length_460_cov_172.986150	41	121	253	1	80	0.0125000
NODE_52292_length_460_cov_172.986150	41	121	255	1	80	0.0125000
NODE_52292_length_460_cov_172.986150	41	121	260	1	80	0.0125000
NODE_52292_length_460_cov_172.986150	41	121	262	1	80	0.0125000
NODE_52292_length_460_cov_172.986150	41	121	263	1	80	0.0125000
NODE_52292_length_460_cov_172.986150	41	121	264	2	80	0.0250000
NODE_52292_length_460_cov_172.986150	41	121	266	5	80	0.0625000
NODE_52292_length_460_cov_172.986150	41	121	267	1	80	0.0125000
NODE_52292_length_460_cov_172.986150	41	121	268	2	80	0.0250000
NODE_52292_length_460_cov_172.986150	41	121	269	1	80	0.0125000
NODE_52292_length_460_cov_172.986150	41	121	270	1	80	0.0125000
NODE_52292_length_460_cov_172.986150	41	121	271	1	80	0.0125000
NODE_52292_length_460_cov_172.986150	41	121	272	1	80	0.0125000
NODE_52292_length_460_cov_172.986150	41	121	273	2	80	0.0250000
NODE_52292_length_460_cov_172.986150	41	121	274	1	80	0.0125000
NODE_52292_length_460_cov_172.986150	41	121	282	1	80	0.0125000
NODE_52292_length_460_cov_172.986150	41	121	284	1	80	0.0125000
NODE_52292_length_460_cov_172.986150	41	121	286	1	80	0.0125000
NODE_52292_length_460_cov_172.986150	41	121	288	3	80	0.0375000
NODE_52293_length_460_cov_62.512465	9	48	0	34	39	0.8717949
NODE_52293_length_460_cov_62.512465	9	48	2	5	39	0.1282051
NODE_52294_length_460_cov_33.146814	0	47	0	47	47	1.0000000
NODE_52294_length_460_cov_33.146814	43	115	0	72	72	1.0000000
NODE_52294_length_460_cov_33.146814	96	165	0	69	69	1.0000000
NODE_52295_length_460_cov_26.049861	0	63	2	21	63	0.3333333
NODE_52295_length_460_cov_26.049861	0	63	4	4	63	0.0634921
NODE_52295_length_460_cov_26.049861	0	63	8	8	63	0.1269841
NODE_52295_length_460_cov_26.049861	0	63	10	8	63	0.1269841
NODE_52295_length_460_cov_26.049861	0	63	11	1	63	0.0158730
NODE_52295_length_460_cov_26.049861	0	63	12	4	63	0.0634921
NODE_52295_length_460_cov_26.049861	0	63	14	2	63	0.0317460
NODE_52295_length_460_cov_26.049861	0	63	16	15	63	0.2380952
NODE_52296_length_460_cov_25.709141	246	326	2	80	80	1.0000000
NODE_52296_length_460_cov_25.709141	299	379	0	50	80	0.6250000
NODE_52296_length_460_cov_25.709141	299	379	2	30	80	0.3750000
NODE_52297_length_460_cov_11.063712	273	353	2	56	80	0.7000000
NODE_52297_length_460_cov_11.063712	273	353	4	24	80	0.3000000
NODE_52297_length_460_cov_11.063712	326	406	0	9	80	0.1125000
NODE_52297_length_460_cov_11.063712	326	406	2	64	80	0.8000000
NODE_52297_length_460_cov_11.063712	326	406	4	7	80	0.0875000
NODE_52303_length_460_cov_7.285319	172	250	0	1	78	0.0128205
NODE_52303_length_460_cov_7.285319	172	250	2	77	78	0.9871795
NODE_52312_length_460_cov_5.163435	120	200	2	20	80	0.2500000
NODE_52312_length_460_cov_5.163435	120	200	4	15	80	0.1875000
NODE_52312_length_460_cov_5.163435	120	200	6	45	80	0.5625000
NODE_52312_length_460_cov_5.163435	173	253	0	15	80	0.1875000
NODE_52312_length_460_cov_5.163435	173	253	2	8	80	0.1000000
NODE_52312_length_460_cov_5.163435	173	253	4	41	80	0.5125000
NODE_52312_length_460_cov_5.163435	173	253	6	16	80	0.2000000
NODE_52333_length_460_cov_3.457064	150	230	0	80	80	1.0000000
NODE_52333_length_460_cov_3.457064	203	246	0	43	43	1.0000000
NODE_52339_length_460_cov_3.027701	167	230	0	63	63	1.0000000
NODE_52347_length_460_cov_2.819945	195	266	0	71	71	1.0000000
NODE_52358_length_460_cov_2.626039	223	277	0	33	54	0.6111111
NODE_52358_length_460_cov_2.626039	223	277	2	21	54	0.3888889
NODE_52612_length_459_cov_34.927778	165	239	0	74	74	1.0000000
NODE_52612_length_459_cov_34.927778	212	292	0	80	80	1.0000000
NODE_52617_length_459_cov_7.261111	143	189	0	46	46	1.0000000
NODE_52617_length_459_cov_7.261111	162	242	0	80	80	1.0000000
NODE_52635_length_459_cov_4.127778	153	233	0	17	80	0.2125000
NODE_52635_length_459_cov_4.127778	153	233	4	63	80	0.7875000
NODE_52685_length_459_cov_2.158333	219	285	0	66	66	1.0000000
NODE_52685_length_459_cov_2.158333	283	342	0	59	59	1.0000000
NODE_52704_length_459_cov_1.722222	280	353	0	53	73	0.7260274
NODE_52704_length_459_cov_1.722222	280	353	2	20	73	0.2739726
NODE_52920_length_458_cov_71.047354	0	51	0	51	51	1.0000000
NODE_52920_length_458_cov_71.047354	24	104	0	80	80	1.0000000
NODE_52920_length_458_cov_71.047354	100	180	0	75	80	0.9375000
NODE_52920_length_458_cov_71.047354	100	180	2	5	80	0.0625000
NODE_52920_length_458_cov_71.047354	153	233	0	22	80	0.2750000
NODE_52920_length_458_cov_71.047354	153	233	2	58	80	0.7250000
NODE_52921_length_458_cov_47.966574	151	231	0	80	80	1.0000000
NODE_52921_length_458_cov_47.966574	204	284	0	80	80	1.0000000
NODE_52921_length_458_cov_47.966574	280	360	0	80	80	1.0000000
NODE_52921_length_458_cov_47.966574	333	413	0	80	80	1.0000000
NODE_52924_length_458_cov_9.935933	267	347	0	13	80	0.1625000
NODE_52924_length_458_cov_9.935933	267	347	2	67	80	0.8375000
NODE_52924_length_458_cov_9.935933	320	400	0	15	80	0.1875000
NODE_52924_length_458_cov_9.935933	320	400	2	65	80	0.8125000
NODE_52929_length_458_cov_7.598886	87	167	4	47	80	0.5875000
NODE_52929_length_458_cov_7.598886	87	167	6	13	80	0.1625000
NODE_52929_length_458_cov_7.598886	87	167	8	20	80	0.2500000
NODE_52967_length_458_cov_3.061281	62	91	0	29	29	1.0000000
NODE_52967_length_458_cov_3.061281	185	224	0	39	39	1.0000000
NODE_52992_length_458_cov_2.454039	210	251	2	17	41	0.4146341
NODE_52992_length_458_cov_2.454039	210	251	4	24	41	0.5853658
NODE_53107_length_458_cov_1.139276	242	289	0	23	47	0.4893617
NODE_53107_length_458_cov_1.139276	242	289	2	24	47	0.5106383
NODE_53107_length_458_cov_1.139276	262	328	0	3	66	0.0454545
NODE_53107_length_458_cov_1.139276	262	328	2	63	66	0.9545454
NODE_53205_length_457_cov_20.754190	123	203	0	11	80	0.1375000
NODE_53205_length_457_cov_20.754190	123	203	2	69	80	0.8625000
NODE_53205_length_457_cov_20.754190	176	256	2	80	80	1.0000000
NODE_53207_length_457_cov_13.918994	218	298	0	80	80	1.0000000
NODE_53207_length_457_cov_13.918994	218	298	0	80	80	1.0000000
NODE_53207_length_457_cov_13.918994	218	298	0	80	80	1.0000000
NODE_53207_length_457_cov_13.918994	218	298	0	80	80	1.0000000
NODE_53207_length_457_cov_13.918994	271	320	0	46	49	0.9387755
NODE_53207_length_457_cov_13.918994	271	320	2	2	49	0.0408163
NODE_53207_length_457_cov_13.918994	271	320	4	1	49	0.0204082
NODE_53207_length_457_cov_13.918994	271	320	0	46	49	0.9387755
NODE_53207_length_457_cov_13.918994	271	320	2	2	49	0.0408163
NODE_53207_length_457_cov_13.918994	271	320	4	1	49	0.0204082
NODE_53207_length_457_cov_13.918994	271	320	0	46	49	0.9387755
NODE_53207_length_457_cov_13.918994	271	320	2	2	49	0.0408163
NODE_53207_length_457_cov_13.918994	271	320	4	1	49	0.0204082
NODE_53216_length_457_cov_6.050279	264	326	0	7	62	0.1129032
NODE_53216_length_457_cov_6.050279	264	326	3	23	62	0.3709677
NODE_53216_length_457_cov_6.050279	264	326	4	1	62	0.0161290
NODE_53216_length_457_cov_6.050279	264	326	5	1	62	0.0161290
NODE_53216_length_457_cov_6.050279	264	326	6	30	62	0.4838710
NODE_53220_length_457_cov_5.078212	71	149	0	78	78	1.0000000
NODE_53220_length_457_cov_5.078212	122	202	0	80	80	1.0000000
NODE_53225_length_457_cov_4.530726	193	273	2	5	80	0.0625000
NODE_53225_length_457_cov_4.530726	193	273	4	75	80	0.9375000
NODE_53225_length_457_cov_4.530726	246	315	2	15	69	0.2173913
NODE_53225_length_457_cov_4.530726	246	315	4	54	69	0.7826087
NODE_53230_length_457_cov_3.986034	192	272	0	80	80	1.0000000
NODE_53267_length_457_cov_2.636872	117	197	2	68	80	0.8500000
NODE_53267_length_457_cov_2.636872	117	197	4	12	80	0.1500000
NODE_53462_length_457_cov_0.916201	108	188	0	80	80	1.0000000
NODE_53462_length_457_cov_0.916201	108	188	0	80	80	1.0000000
NODE_53462_length_457_cov_0.916201	161	241	0	80	80	1.0000000
NODE_53462_length_457_cov_0.916201	161	241	0	80	80	1.0000000
NODE_53512_length_456_cov_34.731092	0	63	0	63	63	1.0000000
NODE_53512_length_456_cov_34.731092	36	116	0	80	80	1.0000000
NODE_53512_length_456_cov_34.731092	112	194	0	82	82	1.0000000
NODE_53532_length_456_cov_4.582633	269	349	0	80	80	1.0000000
NODE_53533_length_456_cov_4.554622	124	206	0	82	82	1.0000000
NODE_53533_length_456_cov_4.554622	179	263	0	84	84	1.0000000
NODE_53546_length_456_cov_3.669468	123	186	0	63	63	1.0000000
NODE_53566_length_456_cov_2.921569	302	362	0	57	60	0.9500000
NODE_53566_length_456_cov_2.921569	302	362	2	3	60	0.0500000
NODE_53859_length_455_cov_113.589888	137	220	0	49	83	0.5903614
NODE_53859_length_455_cov_113.589888	137	220	2	34	83	0.4096386
NODE_53859_length_455_cov_113.589888	198	268	2	70	70	1.0000000
NODE_53859_length_455_cov_113.589888	269	348	0	14	79	0.1772152
NODE_53859_length_455_cov_113.589888	269	348	2	13	79	0.1645570
NODE_53859_length_455_cov_113.589888	269	348	4	27	79	0.3417721
NODE_53859_length_455_cov_113.589888	269	348	6	7	79	0.0886076
NODE_53859_length_455_cov_113.589888	269	348	8	18	79	0.2278481
NODE_53859_length_455_cov_113.589888	321	401	2	3	80	0.0375000
NODE_53859_length_455_cov_113.589888	321	401	4	11	80	0.1375000
NODE_53859_length_455_cov_113.589888	321	401	6	7	80	0.0875000
NODE_53859_length_455_cov_113.589888	321	401	8	59	80	0.7375000
NODE_53860_length_455_cov_52.941011	260	340	0	1	80	0.0125000
NODE_53860_length_455_cov_52.941011	260	340	2	79	80	0.9875000
NODE_53860_length_455_cov_52.941011	313	393	0	45	80	0.5625000
NODE_53860_length_455_cov_52.941011	313	393	2	35	80	0.4375000
NODE_53863_length_455_cov_8.584270	250	302	0	52	52	1.0000000
NODE_53863_length_455_cov_8.584270	275	355	0	80	80	1.0000000
NODE_53864_length_455_cov_8.084270	146	226	2	26	80	0.3250000
NODE_53864_length_455_cov_8.084270	146	226	3	1	80	0.0125000
NODE_53864_length_455_cov_8.084270	146	226	4	3	80	0.0375000
NODE_53864_length_455_cov_8.084270	146	226	6	29	80	0.3625000
NODE_53864_length_455_cov_8.084270	146	226	8	21	80	0.2625000
NODE_53864_length_455_cov_8.084270	199	279	0	26	80	0.3250000
NODE_53864_length_455_cov_8.084270	199	279	2	53	80	0.6625000
NODE_53864_length_455_cov_8.084270	199	279	3	1	80	0.0125000
NODE_53870_length_455_cov_6.022472	122	203	0	30	81	0.3703704
NODE_53870_length_455_cov_6.022472	122	203	2	51	81	0.6296296
NODE_53872_length_455_cov_5.140449	181	232	0	32	51	0.6274510
NODE_53872_length_455_cov_5.140449	181	232	2	19	51	0.3725490
NODE_54512_length_453_cov_29.528249	44	124	0	80	80	1.0000000
NODE_54512_length_453_cov_29.528249	97	177	0	80	80	1.0000000
NODE_54512_length_453_cov_29.528249	173	253	0	80	80	1.0000000
NODE_54512_length_453_cov_29.528249	226	301	0	75	75	1.0000000
NODE_54513_length_453_cov_11.146893	95	140	2	45	45	1.0000000
NODE_54513_length_453_cov_11.146893	146	220	0	68	74	0.9189189
NODE_54513_length_453_cov_11.146893	146	220	2	6	74	0.0810811
NODE_54517_length_453_cov_7.709040	194	252	2	3	58	0.0517241
NODE_54517_length_453_cov_7.709040	194	252	3	7	58	0.1206897
NODE_54517_length_453_cov_7.709040	194	252	4	48	58	0.8275862
NODE_54518_length_453_cov_7.440678	250	319	2	28	69	0.4057971
NODE_54518_length_453_cov_7.440678	250	319	4	22	69	0.3188406
NODE_54518_length_453_cov_7.440678	250	319	6	19	69	0.2753623
NODE_54533_length_453_cov_4.282486	190	270	0	80	80	1.0000000
NODE_54533_length_453_cov_4.282486	243	283	0	40	40	1.0000000
NODE_54566_length_453_cov_2.836158	186	266	0	80	80	1.0000000
NODE_54566_length_453_cov_2.836158	239	319	0	80	80	1.0000000
NODE_54592_length_453_cov_2.048023	139	174	2	18	35	0.5142857
NODE_54592_length_453_cov_2.048023	139	174	3	9	35	0.2571429
NODE_54592_length_453_cov_2.048023	139	174	4	8	35	0.2285714
NODE_54600_length_453_cov_2.002825	78	98	0	20	20	1.0000000
NODE_54767_length_453_cov_0.774011	174	195	0	21	21	1.0000000
NODE_54822_length_452_cov_36.028329	0	72	0	18	72	0.2500000
NODE_54822_length_452_cov_36.028329	0	72	2	54	72	0.7500000
NODE_54822_length_452_cov_36.028329	0	72	0	18	72	0.2500000
NODE_54822_length_452_cov_36.028329	0	72	2	54	72	0.7500000
NODE_54822_length_452_cov_36.028329	45	99	2	38	54	0.7037037
NODE_54822_length_452_cov_36.028329	45	99	4	16	54	0.2962963
NODE_54822_length_452_cov_36.028329	45	125	2	38	80	0.4750000
NODE_54822_length_452_cov_36.028329	45	125	4	42	80	0.5250000
NODE_54823_length_452_cov_17.424929	29	109	0	80	80	1.0000000
NODE_54823_length_452_cov_17.424929	82	162	0	80	80	1.0000000
NODE_54844_length_452_cov_4.317280	141	200	0	59	59	1.0000000
NODE_54886_length_452_cov_2.634561	262	338	0	76	76	1.0000000
NODE_55146_length_451_cov_37.090909	230	310	0	24	80	0.3000000
NODE_55146_length_451_cov_37.090909	230	310	2	56	80	0.7000000
NODE_55146_length_451_cov_37.090909	283	363	2	80	80	1.0000000
NODE_55147_length_451_cov_16.517045	205	286	0	38	81	0.4691358
NODE_55147_length_451_cov_16.517045	205	286	2	43	81	0.5308642
NODE_55147_length_451_cov_16.517045	259	339	0	10	80	0.1250000
NODE_55147_length_451_cov_16.517045	259	339	2	70	80	0.8750000
NODE_55148_length_451_cov_13.153409	182	262	0	20	80	0.2500000
NODE_55148_length_451_cov_13.153409	182	262	4	11	80	0.1375000
NODE_55148_length_451_cov_13.153409	182	262	6	41	80	0.5125000
NODE_55148_length_451_cov_13.153409	182	262	8	8	80	0.1000000
NODE_55148_length_451_cov_13.153409	235	315	6	19	80	0.2375000
NODE_55148_length_451_cov_13.153409	235	315	8	61	80	0.7625000
NODE_55149_length_451_cov_11.926136	141	221	0	35	80	0.4375000
NODE_55149_length_451_cov_11.926136	141	221	2	37	80	0.4625000
NODE_55149_length_451_cov_11.926136	141	221	4	8	80	0.1000000
NODE_55149_length_451_cov_11.926136	331	411	0	17	80	0.2125000
NODE_55149_length_451_cov_11.926136	331	411	2	63	80	0.7875000
NODE_55154_length_451_cov_7.102273	81	143	0	62	62	1.0000000
NODE_55161_length_451_cov_5.610795	1	31	0	30	30	1.0000000
NODE_55161_length_451_cov_5.610795	60	90	0	30	30	1.0000000
NODE_55166_length_451_cov_5.065341	219	285	4	6	66	0.0909091
NODE_55166_length_451_cov_5.065341	219	285	6	2	66	0.0303030
NODE_55166_length_451_cov_5.065341	219	285	8	28	66	0.4242424
NODE_55166_length_451_cov_5.065341	219	285	10	30	66	0.4545455
NODE_55166_length_451_cov_5.065341	272	322	6	8	50	0.1600000
NODE_55166_length_451_cov_5.065341	272	322	8	42	50	0.8400000
NODE_55184_length_451_cov_3.696023	253	332	0	46	79	0.5822785
NODE_55184_length_451_cov_3.696023	253	332	2	2	79	0.0253165
NODE_55184_length_451_cov_3.696023	253	332	4	31	79	0.3924051
NODE_55188_length_451_cov_3.406250	176	247	6	4	71	0.0563380
NODE_55188_length_451_cov_3.406250	176	247	8	4	71	0.0563380
NODE_55188_length_451_cov_3.406250	176	247	10	9	71	0.1267606
NODE_55188_length_451_cov_3.406250	176	247	12	2	71	0.0281690
NODE_55188_length_451_cov_3.406250	176	247	14	2	71	0.0281690
NODE_55188_length_451_cov_3.406250	176	247	16	50	71	0.7042254
NODE_55188_length_451_cov_3.406250	220	300	2	6	80	0.0750000
NODE_55188_length_451_cov_3.406250	220	300	4	6	80	0.0750000
NODE_55188_length_451_cov_3.406250	220	300	6	3	80	0.0375000
NODE_55188_length_451_cov_3.406250	220	300	8	7	80	0.0875000
NODE_55188_length_451_cov_3.406250	220	300	10	23	80	0.2875000
NODE_55188_length_451_cov_3.406250	220	300	14	8	80	0.1000000
NODE_55188_length_451_cov_3.406250	220	300	16	27	80	0.3375000
NODE_55198_length_451_cov_3.025568	72	148	0	61	76	0.8026316
NODE_55198_length_451_cov_3.025568	72	148	2	15	76	0.1973684
NODE_55213_length_451_cov_2.607955	84	143	0	59	59	1.0000000
NODE_55213_length_451_cov_2.607955	257	326	0	69	69	1.0000000
NODE_55234_length_451_cov_2.125000	156	224	0	68	68	1.0000000
NODE_55436_length_450_cov_105.723647	317	386	0	69	69	1.0000000
NODE_55438_length_450_cov_27.982906	98	120	0	22	22	1.0000000
NODE_55438_length_450_cov_27.982906	225	305	0	80	80	1.0000000
NODE_55438_length_450_cov_27.982906	278	358	0	80	80	1.0000000
NODE_55459_length_450_cov_3.991453	220	290	0	70	70	1.0000000
NODE_55459_length_450_cov_3.991453	223	290	0	67	67	1.0000000
NODE_55459_length_450_cov_3.991453	268	348	0	80	80	1.0000000
NODE_55459_length_450_cov_3.991453	268	348	0	80	80	1.0000000
NODE_55459_length_450_cov_3.991453	278	348	0	70	70	1.0000000
NODE_55459_length_450_cov_3.991453	344	363	0	19	19	1.0000000
NODE_55466_length_450_cov_3.717949	107	177	0	70	70	1.0000000
NODE_55483_length_450_cov_3.162393	99	157	0	51	58	0.8793104
NODE_55483_length_450_cov_3.162393	99	157	2	7	58	0.1206897
NODE_55550_length_450_cov_1.857550	114	172	0	19	58	0.3275862
NODE_55550_length_450_cov_1.857550	114	172	2	15	58	0.2586207
NODE_55550_length_450_cov_1.857550	114	172	6	24	58	0.4137931
NODE_55560_length_450_cov_1.749288	321	376	0	55	55	1.0000000
NODE_55565_length_450_cov_1.723647	101	161	4	8	60	0.1333333
NODE_55565_length_450_cov_1.723647	101	161	6	12	60	0.2000000
NODE_55565_length_450_cov_1.723647	101	161	8	3	60	0.0500000
NODE_55565_length_450_cov_1.723647	101	161	10	1	60	0.0166667
NODE_55565_length_450_cov_1.723647	101	161	12	1	60	0.0166667
NODE_55565_length_450_cov_1.723647	101	161	14	9	60	0.1500000
NODE_55565_length_450_cov_1.723647	101	161	16	26	60	0.4333333
NODE_55685_length_450_cov_1.017094	116	196	0	43	80	0.5375000
NODE_55685_length_450_cov_1.017094	116	196	2	25	80	0.3125000
NODE_55685_length_450_cov_1.017094	116	196	4	12	80	0.1500000
NODE_55761_length_449_cov_46.882857	237	317	5	26	80	0.3250000
NODE_55761_length_449_cov_46.882857	237	317	7	24	80	0.3000000
NODE_55761_length_449_cov_46.882857	237	317	8	30	80	0.3750000
NODE_55761_length_449_cov_46.882857	290	370	0	38	80	0.4750000
NODE_55761_length_449_cov_46.882857	290	370	5	41	80	0.5125000
NODE_55761_length_449_cov_46.882857	290	370	7	1	80	0.0125000
NODE_55762_length_449_cov_36.031429	238	318	0	22	80	0.2750000
NODE_55762_length_449_cov_36.031429	238	318	2	16	80	0.2000000
NODE_55762_length_449_cov_36.031429	238	318	4	10	80	0.1250000
NODE_55762_length_449_cov_36.031429	238	318	6	32	80	0.4000000
NODE_55762_length_449_cov_36.031429	291	371	4	10	80	0.1250000
NODE_55762_length_449_cov_36.031429	291	371	6	70	80	0.8750000
NODE_55783_length_449_cov_4.594286	137	184	0	47	47	1.0000000
NODE_55794_length_449_cov_3.797143	204	284	0	80	80	1.0000000
NODE_55844_length_449_cov_2.445714	346	376	0	30	30	1.0000000
NODE_56144_length_448_cov_44.664756	126	206	0	80	80	1.0000000
NODE_56144_length_448_cov_44.664756	179	259	0	80	80	1.0000000
NODE_56145_length_448_cov_36.148997	195	275	0	80	80	1.0000000
NODE_56145_length_448_cov_36.148997	248	328	0	80	80	1.0000000
NODE_56145_length_448_cov_36.148997	324	404	0	80	80	1.0000000
NODE_56145_length_448_cov_36.148997	377	448	0	71	71	1.0000000
NODE_56146_length_448_cov_31.816619	43	123	6	8	80	0.1000000
NODE_56146_length_448_cov_31.816619	43	123	8	1	80	0.0125000
NODE_56146_length_448_cov_31.816619	43	123	10	44	80	0.5500000
NODE_56146_length_448_cov_31.816619	43	123	12	27	80	0.3375000
NODE_56151_length_448_cov_6.779370	197	277	0	37	80	0.4625000
NODE_56151_length_448_cov_6.779370	197	277	2	43	80	0.5375000
NODE_56151_length_448_cov_6.779370	250	313	2	62	63	0.9841270
NODE_56151_length_448_cov_6.779370	250	313	4	1	63	0.0158730
NODE_56180_length_448_cov_3.664756	148	189	4	41	41	1.0000000
NODE_56189_length_448_cov_3.108883	242	324	4	82	82	1.0000000
NODE_56233_length_448_cov_2.263610	292	360	0	68	68	1.0000000
NODE_56518_length_447_cov_10.505747	205	234	2	29	29	1.0000000
NODE_56518_length_447_cov_10.505747	267	326	0	59	59	1.0000000
NODE_56518_length_447_cov_10.505747	299	379	0	80	80	1.0000000
NODE_56527_length_447_cov_5.767241	176	256	0	20	80	0.2500000
NODE_56527_length_447_cov_5.767241	176	256	2	60	80	0.7500000
NODE_56527_length_447_cov_5.767241	229	309	0	20	80	0.2500000
NODE_56527_length_447_cov_5.767241	229	309	2	58	80	0.7250000
NODE_56527_length_447_cov_5.767241	229	309	4	2	80	0.0250000
NODE_56539_length_447_cov_4.583333	265	289	0	20	24	0.8333333
NODE_56539_length_447_cov_4.583333	265	289	2	4	24	0.1666667
NODE_56545_length_447_cov_4.037356	58	138	0	80	80	1.0000000
NODE_56545_length_447_cov_4.037356	111	191	0	80	80	1.0000000
NODE_56890_length_446_cov_42.527378	239	310	11	10	71	0.1408451
NODE_56890_length_446_cov_42.527378	239	310	12	1	71	0.0140845
NODE_56890_length_446_cov_42.527378	239	310	13	7	71	0.0985916
NODE_56890_length_446_cov_42.527378	239	310	14	37	71	0.5211267
NODE_56890_length_446_cov_42.527378	239	310	15	16	71	0.2253521
NODE_56890_length_446_cov_42.527378	359	433	0	9	74	0.1216216
NODE_56890_length_446_cov_42.527378	359	433	1	7	74	0.0945946
NODE_56890_length_446_cov_42.527378	359	433	5	29	74	0.3918919
NODE_56890_length_446_cov_42.527378	359	433	6	24	74	0.3243243
NODE_56890_length_446_cov_42.527378	359	433	8	5	74	0.0675676
NODE_56891_length_446_cov_12.749280	92	172	2	16	80	0.2000000
NODE_56891_length_446_cov_12.749280	92	172	6	28	80	0.3500000
NODE_56891_length_446_cov_12.749280	92	172	8	36	80	0.4500000
NODE_56891_length_446_cov_12.749280	145	225	2	9	80	0.1125000
NODE_56891_length_446_cov_12.749280	145	225	6	69	80	0.8625000
NODE_56891_length_446_cov_12.749280	145	225	8	2	80	0.0250000
NODE_56896_length_446_cov_6.902017	175	217	0	42	42	1.0000000
NODE_56902_length_446_cov_5.930836	165	245	0	80	80	1.0000000
NODE_56902_length_446_cov_5.930836	165	245	0	80	80	1.0000000
NODE_56902_length_446_cov_5.930836	165	235	0	70	70	1.0000000
NODE_56902_length_446_cov_5.930836	218	298	0	80	80	1.0000000
NODE_56902_length_446_cov_5.930836	218	297	0	79	79	1.0000000
NODE_56919_length_446_cov_3.896254	215	274	2	31	59	0.5254237
NODE_56919_length_446_cov_3.896254	215	274	4	28	59	0.4745763
NODE_56934_length_446_cov_3.282421	130	168	0	8	38	0.2105263
NODE_56934_length_446_cov_3.282421	130	168	2	30	38	0.7894737
NODE_56952_length_446_cov_2.775216	337	417	0	44	80	0.5500000
NODE_56952_length_446_cov_2.775216	337	417	4	36	80	0.4500000
NODE_56995_length_446_cov_2.161383	17	97	0	80	80	1.0000000
NODE_57022_length_446_cov_1.907781	196	225	2	29	29	1.0000000
NODE_57277_length_445_cov_75.572254	108	188	0	43	80	0.5375000
NODE_57277_length_445_cov_75.572254	108	188	2	37	80	0.4625000
NODE_57277_length_445_cov_75.572254	161	241	0	19	80	0.2375000
NODE_57277_length_445_cov_75.572254	161	241	2	61	80	0.7625000
NODE_57277_length_445_cov_75.572254	237	317	0	80	80	1.0000000
NODE_57277_length_445_cov_75.572254	290	370	0	80	80	1.0000000
NODE_57278_length_445_cov_33.973988	83	163	0	31	80	0.3875000
NODE_57278_length_445_cov_33.973988	83	163	2	49	80	0.6125000
NODE_57278_length_445_cov_33.973988	136	216	2	52	80	0.6500000
NODE_57278_length_445_cov_33.973988	136	216	4	28	80	0.3500000
NODE_57280_length_445_cov_9.323699	78	148	0	70	70	1.0000000
NODE_57280_length_445_cov_9.323699	121	201	0	80	80	1.0000000
NODE_57284_length_445_cov_6.439306	210	282	0	72	72	1.0000000
NODE_57286_length_445_cov_5.479769	115	184	0	69	69	1.0000000
NODE_57286_length_445_cov_5.479769	157	237	0	80	80	1.0000000
NODE_57286_length_445_cov_5.479769	233	309	0	76	76	1.0000000
NODE_57286_length_445_cov_5.479769	286	309	0	23	23	1.0000000
NODE_57345_length_445_cov_2.843931	124	199	0	75	75	1.0000000
NODE_57352_length_445_cov_2.682081	202	248	0	46	46	1.0000000
NODE_57400_length_445_cov_1.884393	252	332	0	80	80	1.0000000
NODE_57409_length_445_cov_1.783237	132	203	1	71	71	1.0000000
NODE_57409_length_445_cov_1.783237	256	331	0	75	75	1.0000000
NODE_57409_length_445_cov_1.783237	256	278	0	22	22	1.0000000
NODE_57644_length_444_cov_34.075362	243	323	0	4	80	0.0500000
NODE_57644_length_444_cov_34.075362	243	323	2	13	80	0.1625000
NODE_57644_length_444_cov_34.075362	243	323	4	63	80	0.7875000
NODE_57644_length_444_cov_34.075362	296	376	0	19	80	0.2375000
NODE_57644_length_444_cov_34.075362	296	376	2	15	80	0.1875000
NODE_57644_length_444_cov_34.075362	296	376	4	46	80	0.5750000
NODE_57645_length_444_cov_22.524638	98	178	0	43	80	0.5375000
NODE_57645_length_444_cov_22.524638	98	178	2	37	80	0.4625000
NODE_57645_length_444_cov_22.524638	151	231	0	18	80	0.2250000
NODE_57645_length_444_cov_22.524638	151	231	2	23	80	0.2875000
NODE_57645_length_444_cov_22.524638	151	231	4	39	80	0.4875000
NODE_57646_length_444_cov_16.544928	263	343	0	80	80	1.0000000
NODE_57646_length_444_cov_16.544928	316	396	0	80	80	1.0000000
NODE_57647_length_444_cov_12.684058	293	373	0	53	80	0.6625000
NODE_57647_length_444_cov_12.684058	293	373	2	27	80	0.3375000
NODE_57647_length_444_cov_12.684058	346	426	0	8	80	0.1000000
NODE_57647_length_444_cov_12.684058	346	426	2	72	80	0.9000000
NODE_57649_length_444_cov_9.284058	176	256	0	80	80	1.0000000
NODE_57649_length_444_cov_9.284058	229	309	0	80	80	1.0000000
NODE_57666_length_444_cov_5.159420	170	241	0	71	71	1.0000000
NODE_57668_length_444_cov_5.060870	201	245	2	44	44	1.0000000
NODE_57668_length_444_cov_5.060870	218	298	0	10	80	0.1250000
NODE_57668_length_444_cov_5.060870	218	298	2	70	80	0.8750000
NODE_57717_length_444_cov_2.744928	73	136	0	35	63	0.5555556
NODE_57717_length_444_cov_2.744928	73	136	2	4	63	0.0634921
NODE_57717_length_444_cov_2.744928	73	136	4	12	63	0.1904762
NODE_57717_length_444_cov_2.744928	73	136	6	12	63	0.1904762
NODE_57770_length_444_cov_2.028986	46	113	22	1	67	0.0149254
NODE_57770_length_444_cov_2.028986	46	113	26	2	67	0.0298507
NODE_57770_length_444_cov_2.028986	46	113	28	2	67	0.0298507
NODE_57770_length_444_cov_2.028986	46	113	32	1	67	0.0149254
NODE_57770_length_444_cov_2.028986	46	113	36	1	67	0.0149254
NODE_57770_length_444_cov_2.028986	46	113	38	1	67	0.0149254
NODE_57770_length_444_cov_2.028986	46	113	40	2	67	0.0298507
NODE_57770_length_444_cov_2.028986	46	113	42	1	67	0.0149254
NODE_57770_length_444_cov_2.028986	46	113	44	1	67	0.0149254
NODE_57770_length_444_cov_2.028986	46	113	46	3	67	0.0447761
NODE_57770_length_444_cov_2.028986	46	113	56	2	67	0.0298507
NODE_57770_length_444_cov_2.028986	46	113	58	1	67	0.0149254
NODE_57770_length_444_cov_2.028986	46	113	60	2	67	0.0298507
NODE_57770_length_444_cov_2.028986	46	113	68	3	67	0.0447761
NODE_57770_length_444_cov_2.028986	46	113	70	1	67	0.0149254
NODE_57770_length_444_cov_2.028986	46	113	74	2	67	0.0298507
NODE_57770_length_444_cov_2.028986	46	113	84	1	67	0.0149254
NODE_57770_length_444_cov_2.028986	46	113	88	1	67	0.0149254
NODE_57770_length_444_cov_2.028986	46	113	96	1	67	0.0149254
NODE_57770_length_444_cov_2.028986	46	113	106	2	67	0.0298507
NODE_57770_length_444_cov_2.028986	46	113	108	1	67	0.0149254
NODE_57770_length_444_cov_2.028986	46	113	110	1	67	0.0149254
NODE_57770_length_444_cov_2.028986	46	113	112	1	67	0.0149254
NODE_57770_length_444_cov_2.028986	46	113	113	1	67	0.0149254
NODE_57770_length_444_cov_2.028986	46	113	115	1	67	0.0149254
NODE_57770_length_444_cov_2.028986	46	113	119	2	67	0.0298507
NODE_57770_length_444_cov_2.028986	46	113	121	2	67	0.0298507
NODE_57770_length_444_cov_2.028986	46	113	126	2	67	0.0298507
NODE_57770_length_444_cov_2.028986	46	113	128	1	67	0.0149254
NODE_57770_length_444_cov_2.028986	46	113	130	2	67	0.0298507
NODE_57770_length_444_cov_2.028986	46	113	136	1	67	0.0149254
NODE_57770_length_444_cov_2.028986	46	113	140	3	67	0.0447761
NODE_57770_length_444_cov_2.028986	46	113	149	2	67	0.0298507
NODE_57770_length_444_cov_2.028986	46	113	151	2	67	0.0298507
NODE_57770_length_444_cov_2.028986	46	113	153	2	67	0.0298507
NODE_57770_length_444_cov_2.028986	46	113	155	3	67	0.0447761
NODE_57770_length_444_cov_2.028986	46	113	157	3	67	0.0447761
NODE_57770_length_444_cov_2.028986	46	113	159	2	67	0.0298507
NODE_57770_length_444_cov_2.028986	46	113	166	3	67	0.0447761
NODE_57770_length_444_cov_2.028986	46	113	168	1	67	0.0149254
NODE_57770_length_444_cov_2.028986	86	166	112	1	80	0.0125000
NODE_57770_length_444_cov_2.028986	86	166	116	1	80	0.0125000
NODE_57770_length_444_cov_2.028986	86	166	122	1	80	0.0125000
NODE_57770_length_444_cov_2.028986	86	166	126	2	80	0.0250000
NODE_57770_length_444_cov_2.028986	86	166	128	2	80	0.0250000
NODE_57770_length_444_cov_2.028986	86	166	130	3	80	0.0375000
NODE_57770_length_444_cov_2.028986	86	166	132	3	80	0.0375000
NODE_57770_length_444_cov_2.028986	86	166	134	1	80	0.0125000
NODE_57770_length_444_cov_2.028986	86	166	136	2	80	0.0250000
NODE_57770_length_444_cov_2.028986	86	166	138	2	80	0.0250000
NODE_57770_length_444_cov_2.028986	86	166	140	3	80	0.0375000
NODE_57770_length_444_cov_2.028986	86	166	142	1	80	0.0125000
NODE_57770_length_444_cov_2.028986	86	166	144	1	80	0.0125000
NODE_57770_length_444_cov_2.028986	86	166	148	3	80	0.0375000
NODE_57770_length_444_cov_2.028986	86	166	149	2	80	0.0250000
NODE_57770_length_444_cov_2.028986	86	166	151	2	80	0.0250000
NODE_57770_length_444_cov_2.028986	86	166	153	2	80	0.0250000
NODE_57770_length_444_cov_2.028986	86	166	154	1	80	0.0125000
NODE_57770_length_444_cov_2.028986	86	166	155	3	80	0.0375000
NODE_57770_length_444_cov_2.028986	86	166	156	1	80	0.0125000
NODE_57770_length_444_cov_2.028986	86	166	157	3	80	0.0375000
NODE_57770_length_444_cov_2.028986	86	166	158	1	80	0.0125000
NODE_57770_length_444_cov_2.028986	86	166	159	2	80	0.0250000
NODE_57770_length_444_cov_2.028986	86	166	160	1	80	0.0125000
NODE_57770_length_444_cov_2.028986	86	166	162	1	80	0.0125000
NODE_57770_length_444_cov_2.028986	86	166	166	3	80	0.0375000
NODE_57770_length_444_cov_2.028986	86	166	167	1	80	0.0125000
NODE_57770_length_444_cov_2.028986	86	166	168	1	80	0.0125000
NODE_57770_length_444_cov_2.028986	86	166	169	2	80	0.0250000
NODE_57770_length_444_cov_2.028986	86	166	171	1	80	0.0125000
NODE_57770_length_444_cov_2.028986	86	166	173	2	80	0.0250000
NODE_57770_length_444_cov_2.028986	86	166	175	1	80	0.0125000
NODE_57770_length_444_cov_2.028986	86	166	176	3	80	0.0375000
NODE_57770_length_444_cov_2.028986	86	166	177	2	80	0.0250000
NODE_57770_length_444_cov_2.028986	86	166	178	1	80	0.0125000
NODE_57770_length_444_cov_2.028986	86	166	179	2	80	0.0250000
NODE_57770_length_444_cov_2.028986	86	166	180	2	80	0.0250000
NODE_57770_length_444_cov_2.028986	86	166	181	1	80	0.0125000
NODE_57770_length_444_cov_2.028986	86	166	183	3	80	0.0375000
NODE_57770_length_444_cov_2.028986	86	166	185	2	80	0.0250000
NODE_57770_length_444_cov_2.028986	86	166	186	6	80	0.0750000
NODE_57770_length_444_cov_2.028986	86	166	188	2	80	0.0250000
NODE_57873_length_444_cov_1.234783	335	407	0	12	72	0.1666667
NODE_57873_length_444_cov_1.234783	335	407	2	60	72	0.8333333
NODE_57892_length_444_cov_1.173913	7	87	0	80	80	1.0000000
NODE_58026_length_443_cov_71.284884	209	289	4	19	80	0.2375000
NODE_58026_length_443_cov_71.284884	209	289	6	24	80	0.3000000
NODE_58026_length_443_cov_71.284884	209	289	8	37	80	0.4625000
NODE_58026_length_443_cov_71.284884	262	342	0	40	80	0.5000000
NODE_58026_length_443_cov_71.284884	262	342	2	9	80	0.1125000
NODE_58026_length_443_cov_71.284884	262	342	4	14	80	0.1750000
NODE_58026_length_443_cov_71.284884	262	342	8	17	80	0.2125000
NODE_58026_length_443_cov_71.284884	338	418	0	80	80	1.0000000
NODE_58026_length_443_cov_71.284884	391	443	0	52	52	1.0000000
NODE_58027_length_443_cov_68.973837	314	394	0	80	80	1.0000000
NODE_58027_length_443_cov_68.973837	367	443	0	76	76	1.0000000
NODE_58028_length_443_cov_61.116279	34	114	0	8	80	0.1000000
NODE_58028_length_443_cov_61.116279	34	114	2	9	80	0.1125000
NODE_58028_length_443_cov_61.116279	34	114	3	1	80	0.0125000
NODE_58028_length_443_cov_61.116279	34	114	4	21	80	0.2625000
NODE_58028_length_443_cov_61.116279	34	114	6	3	80	0.0375000
NODE_58028_length_443_cov_61.116279	34	114	8	12	80	0.1500000
NODE_58028_length_443_cov_61.116279	34	114	10	26	80	0.3250000
NODE_58028_length_443_cov_61.116279	87	167	8	1	80	0.0125000
NODE_58028_length_443_cov_61.116279	87	167	10	79	80	0.9875000
NODE_58041_length_443_cov_4.895349	127	207	0	80	80	1.0000000
NODE_58086_length_443_cov_2.581395	121	195	0	56	74	0.7567568
NODE_58086_length_443_cov_2.581395	121	195	2	2	74	0.0270270
NODE_58086_length_443_cov_2.581395	121	195	4	4	74	0.0540541
NODE_58086_length_443_cov_2.581395	121	195	6	12	74	0.1621622
NODE_58088_length_443_cov_2.508721	297	347	0	50	50	1.0000000
NODE_58088_length_443_cov_2.508721	320	395	0	75	75	1.0000000
NODE_58091_length_443_cov_2.456395	114	192	0	13	78	0.1666667
NODE_58091_length_443_cov_2.456395	114	192	2	65	78	0.8333333
NODE_58091_length_443_cov_2.456395	118	141	2	23	23	1.0000000
NODE_58237_length_443_cov_1.151163	144	224	2	5	80	0.0625000
NODE_58237_length_443_cov_1.151163	144	224	4	5	80	0.0625000
NODE_58237_length_443_cov_1.151163	144	224	6	8	80	0.1000000
NODE_58237_length_443_cov_1.151163	144	224	8	62	80	0.7750000
NODE_58321_length_443_cov_0.715116	52	104	0	26	52	0.5000000
NODE_58321_length_443_cov_0.715116	52	104	2	26	52	0.5000000
NODE_58321_length_443_cov_0.715116	105	146	2	38	41	0.9268293
NODE_58321_length_443_cov_0.715116	105	146	4	3	41	0.0731707
NODE_58346_length_442_cov_42.956268	290	375	10	17	85	0.2000000
NODE_58346_length_442_cov_42.956268	290	375	12	2	85	0.0235294
NODE_58346_length_442_cov_42.956268	290	375	16	1	85	0.0117647
NODE_58346_length_442_cov_42.956268	290	375	18	3	85	0.0352941
NODE_58346_length_442_cov_42.956268	290	375	20	4	85	0.0470588
NODE_58346_length_442_cov_42.956268	290	375	22	1	85	0.0117647
NODE_58346_length_442_cov_42.956268	290	375	24	57	85	0.6705883
NODE_58346_length_442_cov_42.956268	290	375	10	17	85	0.2000000
NODE_58346_length_442_cov_42.956268	290	375	12	2	85	0.0235294
NODE_58346_length_442_cov_42.956268	290	375	16	1	85	0.0117647
NODE_58346_length_442_cov_42.956268	290	375	18	3	85	0.0352941
NODE_58346_length_442_cov_42.956268	290	375	20	4	85	0.0470588
NODE_58346_length_442_cov_42.956268	290	375	22	1	85	0.0117647
NODE_58346_length_442_cov_42.956268	290	375	24	57	85	0.6705883
NODE_58347_length_442_cov_24.093294	225	305	0	80	80	1.0000000
NODE_58347_length_442_cov_24.093294	278	358	0	80	80	1.0000000
NODE_58348_length_442_cov_8.956268	173	192	0	19	19	1.0000000
NODE_58361_length_442_cov_5.052478	213	293	0	80	80	1.0000000
NODE_58361_length_442_cov_5.052478	266	346	0	34	80	0.4250000
NODE_58361_length_442_cov_5.052478	266	346	2	46	80	0.5750000
NODE_58376_length_442_cov_3.871720	297	372	0	2	75	0.0266667
NODE_58376_length_442_cov_3.871720	297	372	2	2	75	0.0266667
NODE_58376_length_442_cov_3.871720	297	372	4	71	75	0.9466667
NODE_58376_length_442_cov_3.871720	360	413	0	28	53	0.5283019
NODE_58376_length_442_cov_3.871720	360	413	2	1	53	0.0188679
NODE_58376_length_442_cov_3.871720	360	413	4	24	53	0.4528302
NODE_58378_length_442_cov_3.804665	211	244	0	30	33	0.9090909
NODE_58378_length_442_cov_3.804665	211	244	4	2	33	0.0606061
NODE_58378_length_442_cov_3.804665	211	244	10	1	33	0.0303030
NODE_58405_length_442_cov_3.206997	149	217	2	68	68	1.0000000
NODE_58438_length_442_cov_2.434402	203	274	11	3	71	0.0422535
NODE_58438_length_442_cov_2.434402	203	274	13	4	71	0.0563380
NODE_58438_length_442_cov_2.434402	203	274	15	1	71	0.0140845
NODE_58438_length_442_cov_2.434402	203	274	16	3	71	0.0422535
NODE_58438_length_442_cov_2.434402	203	274	18	1	71	0.0140845
NODE_58438_length_442_cov_2.434402	203	274	23	55	71	0.7746479
NODE_58438_length_442_cov_2.434402	203	274	25	4	71	0.0563380
NODE_58438_length_442_cov_2.434402	247	327	23	23	80	0.2875000
NODE_58438_length_442_cov_2.434402	247	327	25	8	80	0.1000000
NODE_58438_length_442_cov_2.434402	247	327	27	21	80	0.2625000
NODE_58438_length_442_cov_2.434402	247	327	28	5	80	0.0625000
NODE_58438_length_442_cov_2.434402	247	327	29	17	80	0.2125000
NODE_58438_length_442_cov_2.434402	247	327	31	6	80	0.0750000
NODE_58503_length_442_cov_1.746356	95	161	2	48	66	0.7272727
NODE_58503_length_442_cov_1.746356	95	161	4	18	66	0.2727273
NODE_58503_length_442_cov_1.746356	95	122	2	27	27	1.0000000
NODE_58759_length_441_cov_21.877193	28	108	2	80	80	1.0000000
NODE_58759_length_441_cov_21.877193	81	161	0	45	80	0.5625000
NODE_58759_length_441_cov_21.877193	81	161	2	35	80	0.4375000
NODE_58760_length_441_cov_13.546784	152	232	0	11	80	0.1375000
NODE_58760_length_441_cov_13.546784	152	232	2	69	80	0.8625000
NODE_58760_length_441_cov_13.546784	205	285	0	60	80	0.7500000
NODE_58760_length_441_cov_13.546784	205	285	2	20	80	0.2500000
NODE_58771_length_441_cov_5.710526	200	280	0	80	80	1.0000000
NODE_58771_length_441_cov_5.710526	253	333	0	80	80	1.0000000
NODE_58817_length_441_cov_3.096491	240	324	0	84	84	1.0000000
NODE_58820_length_441_cov_3.023392	105	163	2	5	58	0.0862069
NODE_58820_length_441_cov_3.023392	105	163	4	23	58	0.3965517
NODE_58820_length_441_cov_3.023392	105	163	6	18	58	0.3103448
NODE_58820_length_441_cov_3.023392	105	163	8	12	58	0.2068966
NODE_58852_length_441_cov_2.438596	19	99	0	80	80	1.0000000
NODE_58852_length_441_cov_2.438596	72	126	0	54	54	1.0000000
NODE_58970_length_441_cov_1.435673	105	156	2	10	51	0.1960784
NODE_58970_length_441_cov_1.435673	105	156	3	1	51	0.0196078
NODE_58970_length_441_cov_1.435673	105	156	4	40	51	0.7843137
NODE_59142_length_440_cov_43.131965	122	202	0	1	80	0.0125000
NODE_59142_length_440_cov_43.131965	122	202	2	79	80	0.9875000
NODE_59142_length_440_cov_43.131965	175	255	2	75	80	0.9375000
NODE_59142_length_440_cov_43.131965	175	255	4	5	80	0.0625000
NODE_59142_length_440_cov_43.131965	251	331	2	18	80	0.2250000
NODE_59142_length_440_cov_43.131965	251	331	4	60	80	0.7500000
NODE_59142_length_440_cov_43.131965	251	331	6	2	80	0.0250000
NODE_59142_length_440_cov_43.131965	304	384	2	43	80	0.5375000
NODE_59142_length_440_cov_43.131965	304	384	4	35	80	0.4375000
NODE_59142_length_440_cov_43.131965	304	384	6	2	80	0.0250000
NODE_59143_length_440_cov_42.929619	116	196	0	80	80	1.0000000
NODE_59143_length_440_cov_42.929619	169	249	0	80	80	1.0000000
NODE_59147_length_440_cov_8.164223	45	125	0	53	80	0.6625000
NODE_59147_length_440_cov_8.164223	45	125	1	27	80	0.3375000
NODE_59147_length_440_cov_8.164223	98	178	1	80	80	1.0000000
NODE_59157_length_440_cov_5.193548	146	210	2	64	64	1.0000000
NODE_59157_length_440_cov_5.193548	146	210	2	64	64	1.0000000
NODE_59157_length_440_cov_5.193548	146	210	2	64	64	1.0000000
NODE_59164_length_440_cov_4.595308	153	233	0	80	80	1.0000000
NODE_59164_length_440_cov_4.595308	153	180	0	27	27	1.0000000
NODE_59188_length_440_cov_3.431085	84	150	6	12	66	0.1818182
NODE_59188_length_440_cov_3.431085	84	150	8	54	66	0.8181818
NODE_59191_length_440_cov_3.331378	139	195	0	15	56	0.2678571
NODE_59191_length_440_cov_3.331378	139	195	2	41	56	0.7321429
NODE_59517_length_439_cov_76.552941	0	68	0	6	68	0.0882353
NODE_59517_length_439_cov_76.552941	0	68	1	11	68	0.1617647
NODE_59517_length_439_cov_76.552941	0	68	3	5	68	0.0735294
NODE_59517_length_439_cov_76.552941	0	68	4	17	68	0.2500000
NODE_59517_length_439_cov_76.552941	0	68	6	28	68	0.4117647
NODE_59517_length_439_cov_76.552941	0	68	8	1	68	0.0147059
NODE_59517_length_439_cov_76.552941	0	68	0	6	68	0.0882353
NODE_59517_length_439_cov_76.552941	0	68	1	11	68	0.1617647
NODE_59517_length_439_cov_76.552941	0	68	3	5	68	0.0735294
NODE_59517_length_439_cov_76.552941	0	68	4	17	68	0.2500000
NODE_59517_length_439_cov_76.552941	0	68	6	28	68	0.4117647
NODE_59517_length_439_cov_76.552941	0	68	8	1	68	0.0147059
NODE_59517_length_439_cov_76.552941	0	68	0	6	68	0.0882353
NODE_59517_length_439_cov_76.552941	0	68	1	11	68	0.1617647
NODE_59517_length_439_cov_76.552941	0	68	3	5	68	0.0735294
NODE_59517_length_439_cov_76.552941	0	68	4	17	68	0.2500000
NODE_59517_length_439_cov_76.552941	0	68	6	28	68	0.4117647
NODE_59517_length_439_cov_76.552941	0	68	8	1	68	0.0147059
NODE_59517_length_439_cov_76.552941	1	68	0	5	67	0.0746269
NODE_59517_length_439_cov_76.552941	1	68	1	11	67	0.1641791
NODE_59517_length_439_cov_76.552941	1	68	3	5	67	0.0746269
NODE_59517_length_439_cov_76.552941	1	68	4	17	67	0.2537313
NODE_59517_length_439_cov_76.552941	1	68	6	28	67	0.4179105
NODE_59517_length_439_cov_76.552941	1	68	8	1	67	0.0149254
NODE_59517_length_439_cov_76.552941	64	144	6	3	80	0.0375000
NODE_59517_length_439_cov_76.552941	64	144	8	1	80	0.0125000
NODE_59517_length_439_cov_76.552941	64	144	10	31	80	0.3875000
NODE_59517_length_439_cov_76.552941	64	144	12	2	80	0.0250000
NODE_59517_length_439_cov_76.552941	64	144	14	32	80	0.4000000
NODE_59517_length_439_cov_76.552941	64	144	16	11	80	0.1375000
NODE_59517_length_439_cov_76.552941	64	144	6	3	80	0.0375000
NODE_59517_length_439_cov_76.552941	64	144	8	1	80	0.0125000
NODE_59517_length_439_cov_76.552941	64	144	10	31	80	0.3875000
NODE_59517_length_439_cov_76.552941	64	144	12	2	80	0.0250000
NODE_59517_length_439_cov_76.552941	64	144	14	32	80	0.4000000
NODE_59517_length_439_cov_76.552941	64	144	16	11	80	0.1375000
NODE_59517_length_439_cov_76.552941	117	197	4	15	80	0.1875000
NODE_59517_length_439_cov_76.552941	117	197	6	15	80	0.1875000
NODE_59517_length_439_cov_76.552941	117	197	7	11	80	0.1375000
NODE_59517_length_439_cov_76.552941	117	197	8	7	80	0.0875000
NODE_59517_length_439_cov_76.552941	117	197	10	1	80	0.0125000
NODE_59517_length_439_cov_76.552941	117	197	12	4	80	0.0500000
NODE_59517_length_439_cov_76.552941	117	197	14	21	80	0.2625000
NODE_59517_length_439_cov_76.552941	117	197	16	6	80	0.0750000
NODE_59517_length_439_cov_76.552941	117	195	4	13	78	0.1666667
NODE_59517_length_439_cov_76.552941	117	195	6	15	78	0.1923077
NODE_59517_length_439_cov_76.552941	117	195	7	11	78	0.1410256
NODE_59517_length_439_cov_76.552941	117	195	8	7	78	0.0897436
NODE_59517_length_439_cov_76.552941	117	195	10	1	78	0.0128205
NODE_59517_length_439_cov_76.552941	117	195	12	4	78	0.0512821
NODE_59517_length_439_cov_76.552941	117	195	14	21	78	0.2692308
NODE_59517_length_439_cov_76.552941	117	195	16	6	78	0.0769231
NODE_59533_length_439_cov_4.408824	174	238	0	35	64	0.5468750
NODE_59533_length_439_cov_4.408824	174	238	2	29	64	0.4531250
NODE_59536_length_439_cov_4.255882	258	318	0	10	60	0.1666667
NODE_59536_length_439_cov_4.255882	258	318	2	50	60	0.8333333
NODE_59560_length_439_cov_3.011765	57	128	8	3	71	0.0422535
NODE_59560_length_439_cov_3.011765	57	128	10	34	71	0.4788733
NODE_59560_length_439_cov_3.011765	57	128	12	1	71	0.0140845
NODE_59560_length_439_cov_3.011765	57	128	14	20	71	0.2816902
NODE_59560_length_439_cov_3.011765	57	128	16	13	71	0.1830986
NODE_59560_length_439_cov_3.011765	101	140	14	23	39	0.5897436
NODE_59560_length_439_cov_3.011765	101	140	16	16	39	0.4102564
NODE_59592_length_439_cov_2.252941	227	269	0	2	42	0.0476190
NODE_59592_length_439_cov_2.252941	227	269	2	40	42	0.9523810
NODE_59599_length_439_cov_2.135294	116	179	0	63	63	1.0000000
NODE_59617_length_439_cov_1.929412	388	439	0	51	51	1.0000000
NODE_59897_length_438_cov_29.952802	196	276	0	80	80	1.0000000
NODE_59897_length_438_cov_29.952802	249	329	0	80	80	1.0000000
NODE_59898_length_438_cov_16.330383	225	305	0	25	80	0.3125000
NODE_59898_length_438_cov_16.330383	225	305	4	55	80	0.6875000
NODE_59898_length_438_cov_16.330383	278	358	0	78	80	0.9750000
NODE_59898_length_438_cov_16.330383	278	358	4	2	80	0.0250000
NODE_59899_length_438_cov_15.436578	74	154	0	25	80	0.3125000
NODE_59899_length_438_cov_15.436578	74	154	2	55	80	0.6875000
NODE_59899_length_438_cov_15.436578	127	207	0	27	80	0.3375000
NODE_59899_length_438_cov_15.436578	127	207	2	53	80	0.6625000
NODE_59901_length_438_cov_9.306785	256	309	0	53	53	1.0000000
NODE_59901_length_438_cov_9.306785	282	327	0	45	45	1.0000000
NODE_59916_length_438_cov_4.808260	46	133	4	2	87	0.0229885
NODE_59916_length_438_cov_4.808260	46	133	8	2	87	0.0229885
NODE_59916_length_438_cov_4.808260	46	133	10	12	87	0.1379310
NODE_59916_length_438_cov_4.808260	46	133	12	23	87	0.2643678
NODE_59916_length_438_cov_4.808260	46	133	14	2	87	0.0229885
NODE_59916_length_438_cov_4.808260	46	133	16	2	87	0.0229885
NODE_59916_length_438_cov_4.808260	46	133	18	17	87	0.1954023
NODE_59916_length_438_cov_4.808260	46	133	20	26	87	0.2988506
NODE_59916_length_438_cov_4.808260	46	133	22	1	87	0.0114943
NODE_59916_length_438_cov_4.808260	106	186	8	4	80	0.0500000
NODE_59916_length_438_cov_4.808260	106	186	12	13	80	0.1625000
NODE_59916_length_438_cov_4.808260	106	186	13	1	80	0.0125000
NODE_59916_length_438_cov_4.808260	106	186	14	2	80	0.0250000
NODE_59916_length_438_cov_4.808260	106	186	16	22	80	0.2750000
NODE_59916_length_438_cov_4.808260	106	186	18	20	80	0.2500000
NODE_59916_length_438_cov_4.808260	106	186	20	17	80	0.2125000
NODE_59916_length_438_cov_4.808260	106	186	22	1	80	0.0125000
NODE_59920_length_438_cov_4.622419	135	184	0	23	49	0.4693878
NODE_59920_length_438_cov_4.622419	135	184	2	26	49	0.5306122
NODE_59936_length_438_cov_3.651917	86	166	2	25	80	0.3125000
NODE_59936_length_438_cov_3.651917	86	166	4	55	80	0.6875000
NODE_59936_length_438_cov_3.651917	139	219	0	30	80	0.3750000
NODE_59936_length_438_cov_3.651917	139	219	2	48	80	0.6000000
NODE_59936_length_438_cov_3.651917	139	219	4	2	80	0.0250000
NODE_59952_length_438_cov_3.109145	215	273	0	58	58	1.0000000
NODE_59957_length_438_cov_3.005900	175	258	0	83	83	1.0000000
NODE_60317_length_437_cov_57.260355	272	352	0	80	80	1.0000000
NODE_60317_length_437_cov_57.260355	325	405	0	80	80	1.0000000
NODE_60318_length_437_cov_40.964497	0	73	0	73	73	1.0000000
NODE_60318_length_437_cov_40.964497	46	126	0	80	80	1.0000000
NODE_60319_length_437_cov_30.843195	140	220	0	80	80	1.0000000
NODE_60319_length_437_cov_30.843195	193	273	0	80	80	1.0000000
NODE_60320_length_437_cov_14.736686	164	244	0	80	80	1.0000000
NODE_60320_length_437_cov_14.736686	217	297	0	80	80	1.0000000
NODE_60331_length_437_cov_6.032544	249	320	0	71	71	1.0000000
NODE_60332_length_437_cov_6.020710	272	352	2	78	80	0.9750000
NODE_60332_length_437_cov_6.020710	272	352	4	2	80	0.0250000
NODE_60332_length_437_cov_6.020710	325	405	0	48	80	0.6000000
NODE_60332_length_437_cov_6.020710	325	405	2	32	80	0.4000000
NODE_60336_length_437_cov_5.526627	129	209	0	80	80	1.0000000
NODE_60336_length_437_cov_5.526627	182	262	0	80	80	1.0000000
NODE_60348_length_437_cov_4.505917	247	327	0	14	80	0.1750000
NODE_60348_length_437_cov_4.505917	247	327	1	1	80	0.0125000
NODE_60348_length_437_cov_4.505917	247	327	2	34	80	0.4250000
NODE_60348_length_437_cov_4.505917	247	327	4	31	80	0.3875000
NODE_60361_length_437_cov_3.470414	204	259	2	55	55	1.0000000
NODE_60369_length_437_cov_3.301775	95	149	0	54	54	1.0000000
NODE_60381_length_437_cov_2.911243	91	171	2	14	80	0.1750000
NODE_60381_length_437_cov_2.911243	91	171	6	32	80	0.4000000
NODE_60381_length_437_cov_2.911243	91	171	8	7	80	0.0875000
NODE_60381_length_437_cov_2.911243	91	171	10	22	80	0.2750000
NODE_60381_length_437_cov_2.911243	91	171	12	5	80	0.0625000
NODE_60400_length_437_cov_2.650888	190	239	0	15	49	0.3061225
NODE_60400_length_437_cov_2.650888	190	239	2	34	49	0.6938776
NODE_60400_length_437_cov_2.650888	212	292	2	80	80	1.0000000
NODE_60411_length_437_cov_2.514793	292	333	0	41	41	1.0000000
NODE_60509_length_437_cov_1.473373	252	324	2	22	72	0.3055556
NODE_60509_length_437_cov_1.473373	252	324	4	50	72	0.6944444
NODE_60709_length_436_cov_125.940653	204	284	6	17	80	0.2125000
NODE_60709_length_436_cov_125.940653	204	284	8	40	80	0.5000000
NODE_60709_length_436_cov_125.940653	204	284	10	19	80	0.2375000
NODE_60709_length_436_cov_125.940653	204	284	12	1	80	0.0125000
NODE_60709_length_436_cov_125.940653	204	284	14	3	80	0.0375000
NODE_60709_length_436_cov_125.940653	255	301	4	16	46	0.3478261
NODE_60709_length_436_cov_125.940653	255	301	6	18	46	0.3913043
NODE_60709_length_436_cov_125.940653	255	301	8	12	46	0.2608696
NODE_60709_length_436_cov_125.940653	257	337	0	2	80	0.0250000
NODE_60709_length_436_cov_125.940653	257	337	2	23	80	0.2875000
NODE_60709_length_436_cov_125.940653	257	337	4	27	80	0.3375000
NODE_60709_length_436_cov_125.940653	257	337	6	18	80	0.2250000
NODE_60709_length_436_cov_125.940653	257	337	8	10	80	0.1250000
NODE_60709_length_436_cov_125.940653	333	413	0	78	80	0.9750000
NODE_60709_length_436_cov_125.940653	333	413	2	2	80	0.0250000
NODE_60709_length_436_cov_125.940653	386	436	0	50	50	1.0000000
NODE_60712_length_436_cov_45.459941	166	246	0	13	80	0.1625000
NODE_60712_length_436_cov_45.459941	166	246	2	67	80	0.8375000
NODE_60712_length_436_cov_45.459941	219	299	0	42	80	0.5250000
NODE_60712_length_436_cov_45.459941	219	299	2	38	80	0.4750000
NODE_60712_length_436_cov_45.459941	295	375	0	6	80	0.0750000
NODE_60712_length_436_cov_45.459941	295	375	2	74	80	0.9250000
NODE_60712_length_436_cov_45.459941	348	428	0	10	80	0.1250000
NODE_60712_length_436_cov_45.459941	348	428	2	70	80	0.8750000
NODE_60713_length_436_cov_10.560831	74	154	0	53	80	0.6625000
NODE_60713_length_436_cov_10.560831	74	154	4	27	80	0.3375000
NODE_60713_length_436_cov_10.560831	127	207	4	80	80	1.0000000
NODE_60716_length_436_cov_8.317507	51	127	0	76	76	1.0000000
NODE_60716_length_436_cov_8.317507	104	182	0	78	78	1.0000000
NODE_60760_length_436_cov_3.109792	153	205	0	52	52	1.0000000
NODE_60786_length_436_cov_2.551929	182	258	0	18	76	0.2368421
NODE_60786_length_436_cov_2.551929	182	258	2	58	76	0.7631579
NODE_60786_length_436_cov_2.551929	235	315	0	60	80	0.7500000
NODE_60786_length_436_cov_2.551929	235	315	2	20	80	0.2500000
NODE_60934_length_436_cov_1.207715	105	181	0	76	76	1.0000000
NODE_61088_length_435_cov_17.401786	55	135	0	14	80	0.1750000
NODE_61088_length_435_cov_17.401786	55	135	2	25	80	0.3125000
NODE_61088_length_435_cov_17.401786	55	135	6	8	80	0.1000000
NODE_61088_length_435_cov_17.401786	55	135	8	33	80	0.4125000
NODE_61088_length_435_cov_17.401786	108	188	2	10	80	0.1250000
NODE_61088_length_435_cov_17.401786	108	188	6	15	80	0.1875000
NODE_61088_length_435_cov_17.401786	108	188	8	55	80	0.6875000
NODE_61094_length_435_cov_6.910714	113	193	4	34	80	0.4250000
NODE_61094_length_435_cov_6.910714	113	193	6	46	80	0.5750000
NODE_61094_length_435_cov_6.910714	147	194	4	35	47	0.7446808
NODE_61094_length_435_cov_6.910714	147	194	6	12	47	0.2553191
NODE_61094_length_435_cov_6.910714	149	184	4	25	35	0.7142857
NODE_61094_length_435_cov_6.910714	149	184	6	10	35	0.2857143
NODE_61094_length_435_cov_6.910714	151	193	4	34	42	0.8095238
NODE_61094_length_435_cov_6.910714	151	193	6	8	42	0.1904762
NODE_61094_length_435_cov_6.910714	166	251	0	49	85	0.5764706
NODE_61094_length_435_cov_6.910714	166	251	2	6	85	0.0705882
NODE_61094_length_435_cov_6.910714	166	251	4	30	85	0.3529412
NODE_61094_length_435_cov_6.910714	167	251	0	49	84	0.5833333
NODE_61094_length_435_cov_6.910714	167	251	2	6	84	0.0714286
NODE_61094_length_435_cov_6.910714	167	251	4	29	84	0.3452381
NODE_61102_length_435_cov_5.630952	159	217	0	58	58	1.0000000
NODE_61102_length_435_cov_5.630952	190	270	0	80	80	1.0000000
NODE_61112_length_435_cov_4.601190	271	309	4	38	38	1.0000000
NODE_61112_length_435_cov_4.601190	282	344	2	25	62	0.4032258
NODE_61112_length_435_cov_4.601190	282	344	4	37	62	0.5967742
NODE_61122_length_435_cov_3.770833	209	240	0	31	31	1.0000000
NODE_61137_length_435_cov_2.836310	113	194	2	34	81	0.4197531
NODE_61137_length_435_cov_2.836310	113	194	4	17	81	0.2098765
NODE_61137_length_435_cov_2.836310	113	194	6	30	81	0.3703704
NODE_61357_length_435_cov_0.988095	286	322	0	36	36	1.0000000
NODE_61451_length_434_cov_136.483582	0	58	6	1	58	0.0172414
NODE_61451_length_434_cov_136.483582	0	58	7	1	58	0.0172414
NODE_61451_length_434_cov_136.483582	0	58	9	1	58	0.0172414
NODE_61451_length_434_cov_136.483582	0	58	13	2	58	0.0344828
NODE_61451_length_434_cov_136.483582	0	58	14	1	58	0.0172414
NODE_61451_length_434_cov_136.483582	0	58	16	2	58	0.0344828
NODE_61451_length_434_cov_136.483582	0	58	22	3	58	0.0517241
NODE_61451_length_434_cov_136.483582	0	58	26	1	58	0.0172414
NODE_61451_length_434_cov_136.483582	0	58	28	4	58	0.0689655
NODE_61451_length_434_cov_136.483582	0	58	34	1	58	0.0172414
NODE_61451_length_434_cov_136.483582	0	58	36	1	58	0.0172414
NODE_61451_length_434_cov_136.483582	0	58	38	1	58	0.0172414
NODE_61451_length_434_cov_136.483582	0	58	40	1	58	0.0172414
NODE_61451_length_434_cov_136.483582	0	58	42	1	58	0.0172414
NODE_61451_length_434_cov_136.483582	0	58	44	1	58	0.0172414
NODE_61451_length_434_cov_136.483582	0	58	48	1	58	0.0172414
NODE_61451_length_434_cov_136.483582	0	58	52	5	58	0.0862069
NODE_61451_length_434_cov_136.483582	0	58	62	1	58	0.0172414
NODE_61451_length_434_cov_136.483582	0	58	66	1	58	0.0172414
NODE_61451_length_434_cov_136.483582	0	58	68	3	58	0.0517241
NODE_61451_length_434_cov_136.483582	0	58	70	7	58	0.1206897
NODE_61451_length_434_cov_136.483582	0	58	72	10	58	0.1724138
NODE_61451_length_434_cov_136.483582	0	58	74	8	58	0.1379310
NODE_61451_length_434_cov_136.483582	31	111	68	2	80	0.0250000
NODE_61451_length_434_cov_136.483582	31	111	70	7	80	0.0875000
NODE_61451_length_434_cov_136.483582	31	111	72	10	80	0.1250000
NODE_61451_length_434_cov_136.483582	31	111	74	11	80	0.1375000
NODE_61451_length_434_cov_136.483582	31	111	76	1	80	0.0125000
NODE_61451_length_434_cov_136.483582	31	111	80	7	80	0.0875000
NODE_61451_length_434_cov_136.483582	31	111	82	11	80	0.1375000
NODE_61451_length_434_cov_136.483582	31	111	84	6	80	0.0750000
NODE_61451_length_434_cov_136.483582	31	111	86	9	80	0.1125000
NODE_61451_length_434_cov_136.483582	31	111	88	1	80	0.0125000
NODE_61451_length_434_cov_136.483582	31	111	90	3	80	0.0375000
NODE_61451_length_434_cov_136.483582	31	111	92	4	80	0.0500000
NODE_61451_length_434_cov_136.483582	31	111	94	8	80	0.1000000
NODE_61452_length_434_cov_43.214925	291	366	6	5	75	0.0666667
NODE_61452_length_434_cov_43.214925	291	366	12	5	75	0.0666667
NODE_61452_length_434_cov_43.214925	291	366	16	32	75	0.4266667
NODE_61452_length_434_cov_43.214925	291	366	18	33	75	0.4400000
NODE_61452_length_434_cov_43.214925	344	424	0	9	80	0.1125000
NODE_61452_length_434_cov_43.214925	344	424	2	7	80	0.0875000
NODE_61452_length_434_cov_43.214925	344	424	4	25	80	0.3125000
NODE_61452_length_434_cov_43.214925	344	424	6	22	80	0.2750000
NODE_61452_length_434_cov_43.214925	344	424	12	5	80	0.0625000
NODE_61452_length_434_cov_43.214925	344	424	18	12	80	0.1500000
NODE_61452_length_434_cov_43.214925	344	424	0	9	80	0.1125000
NODE_61452_length_434_cov_43.214925	344	424	2	7	80	0.0875000
NODE_61452_length_434_cov_43.214925	344	424	4	25	80	0.3125000
NODE_61452_length_434_cov_43.214925	344	424	6	22	80	0.2750000
NODE_61452_length_434_cov_43.214925	344	424	12	5	80	0.0625000
NODE_61452_length_434_cov_43.214925	344	424	18	12	80	0.1500000
NODE_61453_length_434_cov_22.373134	80	160	0	80	80	1.0000000
NODE_61453_length_434_cov_22.373134	133	213	0	80	80	1.0000000
NODE_61455_length_434_cov_11.549254	74	145	0	61	71	0.8591549
NODE_61455_length_434_cov_11.549254	74	145	2	10	71	0.1408451
NODE_61455_length_434_cov_11.549254	118	198	0	17	80	0.2125000
NODE_61455_length_434_cov_11.549254	118	198	2	63	80	0.7875000
NODE_61477_length_434_cov_4.125373	191	233	0	42	42	1.0000000
NODE_61477_length_434_cov_4.125373	200	235	0	35	35	1.0000000
NODE_61497_length_434_cov_3.104478	191	263	0	3	72	0.0416667
NODE_61497_length_434_cov_3.104478	191	263	2	24	72	0.3333333
NODE_61497_length_434_cov_3.104478	191	263	6	26	72	0.3611111
NODE_61497_length_434_cov_3.104478	191	263	8	19	72	0.2638889
NODE_61528_length_434_cov_2.197015	129	168	0	39	39	1.0000000
NODE_61563_length_434_cov_1.883582	88	133	0	45	45	1.0000000
NODE_61563_length_434_cov_1.883582	141	182	0	41	41	1.0000000
NODE_61603_length_434_cov_1.626866	163	243	2	16	80	0.2000000
NODE_61603_length_434_cov_1.626866	163	243	4	24	80	0.3000000
NODE_61603_length_434_cov_1.626866	163	243	6	40	80	0.5000000
NODE_61676_length_434_cov_1.220896	118	198	70	1	80	0.0125000
NODE_61676_length_434_cov_1.220896	118	198	72	3	80	0.0375000
NODE_61676_length_434_cov_1.220896	118	198	74	1	80	0.0125000
NODE_61676_length_434_cov_1.220896	118	198	78	2	80	0.0250000
NODE_61676_length_434_cov_1.220896	118	198	81	1	80	0.0125000
NODE_61676_length_434_cov_1.220896	118	198	89	1	80	0.0125000
NODE_61676_length_434_cov_1.220896	118	198	91	2	80	0.0250000
NODE_61676_length_434_cov_1.220896	118	198	92	1	80	0.0125000
NODE_61676_length_434_cov_1.220896	118	198	94	1	80	0.0125000
NODE_61676_length_434_cov_1.220896	118	198	96	1	80	0.0125000
NODE_61676_length_434_cov_1.220896	118	198	100	2	80	0.0250000
NODE_61676_length_434_cov_1.220896	118	198	104	1	80	0.0125000
NODE_61676_length_434_cov_1.220896	118	198	106	1	80	0.0125000
NODE_61676_length_434_cov_1.220896	118	198	108	4	80	0.0500000
NODE_61676_length_434_cov_1.220896	118	198	109	1	80	0.0125000
NODE_61676_length_434_cov_1.220896	118	198	110	2	80	0.0250000
NODE_61676_length_434_cov_1.220896	118	198	111	2	80	0.0250000
NODE_61676_length_434_cov_1.220896	118	198	112	1	80	0.0125000
NODE_61676_length_434_cov_1.220896	118	198	113	8	80	0.1000000
NODE_61676_length_434_cov_1.220896	118	198	114	5	80	0.0625000
NODE_61676_length_434_cov_1.220896	118	198	115	4	80	0.0500000
NODE_61676_length_434_cov_1.220896	118	198	116	7	80	0.0875000
NODE_61676_length_434_cov_1.220896	118	198	117	9	80	0.1125000
NODE_61676_length_434_cov_1.220896	118	198	118	10	80	0.1250000
NODE_61676_length_434_cov_1.220896	118	198	119	4	80	0.0500000
NODE_61676_length_434_cov_1.220896	118	198	120	4	80	0.0500000
NODE_61676_length_434_cov_1.220896	118	198	121	1	80	0.0125000
NODE_61727_length_434_cov_1.002985	245	286	2	11	41	0.2682927
NODE_61727_length_434_cov_1.002985	245	286	4	8	41	0.1951219
NODE_61727_length_434_cov_1.002985	245	286	6	22	41	0.5365854
NODE_61727_length_434_cov_1.002985	258	339	4	7	81	0.0864198
NODE_61727_length_434_cov_1.002985	258	339	6	74	81	0.9135802
NODE_61826_length_433_cov_51.392216	2	82	0	41	80	0.5125000
NODE_61826_length_433_cov_51.392216	2	82	2	39	80	0.4875000
NODE_61826_length_433_cov_51.392216	55	135	2	80	80	1.0000000
NODE_61826_length_433_cov_51.392216	131	213	0	57	82	0.6951219
NODE_61826_length_433_cov_51.392216	131	213	2	25	82	0.3048781
NODE_61826_length_433_cov_51.392216	189	266	0	77	77	1.0000000
NODE_61827_length_433_cov_46.344311	248	328	0	57	80	0.7125000
NODE_61827_length_433_cov_46.344311	248	328	3	1	80	0.0125000
NODE_61827_length_433_cov_46.344311	248	328	4	17	80	0.2125000
NODE_61827_length_433_cov_46.344311	248	328	6	5	80	0.0625000
NODE_61827_length_433_cov_46.344311	301	381	0	4	80	0.0500000
NODE_61827_length_433_cov_46.344311	301	381	3	1	80	0.0125000
NODE_61827_length_433_cov_46.344311	301	381	4	26	80	0.3250000
NODE_61827_length_433_cov_46.344311	301	381	6	49	80	0.6125000
NODE_61828_length_433_cov_41.808383	92	172	0	80	80	1.0000000
NODE_61828_length_433_cov_41.808383	145	225	0	80	80	1.0000000
NODE_61835_length_433_cov_6.227545	157	237	0	80	80	1.0000000
NODE_61836_length_433_cov_6.080838	164	244	0	6	80	0.0750000
NODE_61836_length_433_cov_6.080838	164	244	2	74	80	0.9250000
NODE_61838_length_433_cov_5.547904	10	80	0	16	70	0.2285714
NODE_61838_length_433_cov_5.547904	10	80	2	6	70	0.0857143
NODE_61838_length_433_cov_5.547904	10	80	4	4	70	0.0571429
NODE_61838_length_433_cov_5.547904	10	80	8	13	70	0.1857143
NODE_61838_length_433_cov_5.547904	10	80	10	31	70	0.4428571
NODE_61838_length_433_cov_5.547904	51	133	8	7	82	0.0853659
NODE_61838_length_433_cov_5.547904	51	133	10	75	82	0.9146342
NODE_61839_length_433_cov_5.476048	81	141	0	60	60	1.0000000
NODE_61855_length_433_cov_3.907186	77	107	0	1	30	0.0333333
NODE_61855_length_433_cov_3.907186	77	107	2	29	30	0.9666666
NODE_61862_length_433_cov_3.595808	231	316	0	7	85	0.0823529
NODE_61862_length_433_cov_3.595808	231	316	2	5	85	0.0588235
NODE_61862_length_433_cov_3.595808	231	316	4	21	85	0.2470588
NODE_61862_length_433_cov_3.595808	231	316	6	42	85	0.4941176
NODE_61862_length_433_cov_3.595808	231	316	7	10	85	0.1176471
NODE_61864_length_433_cov_3.526946	107	178	0	50	71	0.7042254
NODE_61864_length_433_cov_3.526946	107	178	2	21	71	0.2957746
NODE_61931_length_433_cov_2.137725	123	203	0	18	80	0.2250000
NODE_61931_length_433_cov_2.137725	123	203	2	62	80	0.7750000
NODE_62258_length_432_cov_17.540541	150	230	0	80	80	1.0000000
NODE_62258_length_432_cov_17.540541	203	288	0	85	85	1.0000000
NODE_62264_length_432_cov_6.555556	52	82	0	30	30	1.0000000
NODE_62268_length_432_cov_5.720721	77	157	0	80	80	1.0000000
NODE_62268_length_432_cov_5.720721	130	202	0	72	72	1.0000000
NODE_62269_length_432_cov_5.387387	65	95	0	30	30	1.0000000
NODE_62270_length_432_cov_5.345345	271	324	8	1	53	0.0188679
NODE_62270_length_432_cov_5.345345	271	324	12	1	53	0.0188679
NODE_62270_length_432_cov_5.345345	271	324	14	15	53	0.2830189
NODE_62270_length_432_cov_5.345345	271	324	15	2	53	0.0377358
NODE_62270_length_432_cov_5.345345	271	324	16	34	53	0.6415094
NODE_62293_length_432_cov_3.678679	78	121	2	43	43	1.0000000
NODE_62304_length_432_cov_3.246246	87	128	0	16	41	0.3902439
NODE_62304_length_432_cov_3.246246	87	128	2	10	41	0.2439024
NODE_62304_length_432_cov_3.246246	87	128	4	6	41	0.1463415
NODE_62304_length_432_cov_3.246246	87	128	6	6	41	0.1463415
NODE_62304_length_432_cov_3.246246	87	128	8	1	41	0.0243902
NODE_62304_length_432_cov_3.246246	87	128	12	2	41	0.0487805
NODE_62304_length_432_cov_3.246246	101	167	0	2	66	0.0303030
NODE_62304_length_432_cov_3.246246	101	167	2	10	66	0.1515152
NODE_62304_length_432_cov_3.246246	101	167	4	6	66	0.0909091
NODE_62304_length_432_cov_3.246246	101	167	6	6	66	0.0909091
NODE_62304_length_432_cov_3.246246	101	167	8	1	66	0.0151515
NODE_62304_length_432_cov_3.246246	101	167	12	3	66	0.0454545
NODE_62304_length_432_cov_3.246246	101	167	14	6	66	0.0909091
NODE_62304_length_432_cov_3.246246	101	167	16	1	66	0.0151515
NODE_62304_length_432_cov_3.246246	101	167	18	6	66	0.0909091
NODE_62304_length_432_cov_3.246246	101	167	20	4	66	0.0606061
NODE_62304_length_432_cov_3.246246	101	167	22	21	66	0.3181818
NODE_62396_length_432_cov_1.762763	4	71	0	29	67	0.4328358
NODE_62396_length_432_cov_1.762763	4	71	2	24	67	0.3582090
NODE_62396_length_432_cov_1.762763	4	71	4	14	67	0.2089552
NODE_62544_length_432_cov_1.027027	44	68	0	24	24	1.0000000
NODE_62650_length_431_cov_35.355422	202	284	0	82	82	1.0000000
NODE_62650_length_431_cov_35.355422	257	333	0	76	76	1.0000000
NODE_62652_length_431_cov_11.207831	185	265	0	80	80	1.0000000
NODE_62652_length_431_cov_11.207831	238	318	0	80	80	1.0000000
NODE_62657_length_431_cov_7.018072	110	190	0	80	80	1.0000000
NODE_62657_length_431_cov_7.018072	163	243	0	80	80	1.0000000
NODE_62661_length_431_cov_6.292169	123	203	0	80	80	1.0000000
NODE_62668_length_431_cov_5.608434	170	241	0	71	71	1.0000000
NODE_62681_length_431_cov_4.250000	146	216	0	42	70	0.6000000
NODE_62681_length_431_cov_4.250000	146	216	2	28	70	0.4000000
NODE_62684_length_431_cov_3.993976	210	290	4	1	80	0.0125000
NODE_62684_length_431_cov_3.993976	210	290	6	5	80	0.0625000
NODE_62684_length_431_cov_3.993976	210	290	8	25	80	0.3125000
NODE_62684_length_431_cov_3.993976	210	290	10	11	80	0.1375000
NODE_62684_length_431_cov_3.993976	210	290	12	38	80	0.4750000
NODE_62794_length_431_cov_1.695783	76	156	2	25	80	0.3125000
NODE_62794_length_431_cov_1.695783	76	156	4	20	80	0.2500000
NODE_62794_length_431_cov_1.695783	76	156	6	35	80	0.4375000
NODE_62794_length_431_cov_1.695783	129	199	4	9	70	0.1285714
NODE_62794_length_431_cov_1.695783	129	199	6	35	70	0.5000000
NODE_62794_length_431_cov_1.695783	129	199	8	26	70	0.3714286
NODE_63043_length_430_cov_49.791541	319	399	44	5	80	0.0625000
NODE_63043_length_430_cov_49.791541	319	399	46	3	80	0.0375000
NODE_63043_length_430_cov_49.791541	319	399	48	5	80	0.0625000
NODE_63043_length_430_cov_49.791541	319	399	50	7	80	0.0875000
NODE_63043_length_430_cov_49.791541	319	399	52	2	80	0.0250000
NODE_63043_length_430_cov_49.791541	319	399	57	4	80	0.0500000
NODE_63043_length_430_cov_49.791541	319	399	60	2	80	0.0250000
NODE_63043_length_430_cov_49.791541	319	399	64	1	80	0.0125000
NODE_63043_length_430_cov_49.791541	319	399	66	2	80	0.0250000
NODE_63043_length_430_cov_49.791541	319	399	72	1	80	0.0125000
NODE_63043_length_430_cov_49.791541	319	399	73	1	80	0.0125000
NODE_63043_length_430_cov_49.791541	319	399	75	1	80	0.0125000
NODE_63043_length_430_cov_49.791541	319	399	77	8	80	0.1000000
NODE_63043_length_430_cov_49.791541	319	399	81	5	80	0.0625000
NODE_63043_length_430_cov_49.791541	319	399	83	2	80	0.0250000
NODE_63043_length_430_cov_49.791541	319	399	85	7	80	0.0875000
NODE_63043_length_430_cov_49.791541	319	399	86	2	80	0.0250000
NODE_63043_length_430_cov_49.791541	319	399	87	3	80	0.0375000
NODE_63043_length_430_cov_49.791541	319	399	88	1	80	0.0125000
NODE_63043_length_430_cov_49.791541	319	399	90	2	80	0.0250000
NODE_63043_length_430_cov_49.791541	319	399	91	3	80	0.0375000
NODE_63043_length_430_cov_49.791541	319	399	92	1	80	0.0125000
NODE_63043_length_430_cov_49.791541	319	399	93	5	80	0.0625000
NODE_63043_length_430_cov_49.791541	319	399	94	4	80	0.0500000
NODE_63043_length_430_cov_49.791541	319	399	96	3	80	0.0375000
NODE_63043_length_430_cov_49.791541	372	430	0	2	58	0.0344828
NODE_63043_length_430_cov_49.791541	372	430	4	1	58	0.0172414
NODE_63043_length_430_cov_49.791541	372	430	6	3	58	0.0517241
NODE_63043_length_430_cov_49.791541	372	430	14	1	58	0.0172414
NODE_63043_length_430_cov_49.791541	372	430	16	1	58	0.0172414
NODE_63043_length_430_cov_49.791541	372	430	20	1	58	0.0172414
NODE_63043_length_430_cov_49.791541	372	430	22	2	58	0.0344828
NODE_63043_length_430_cov_49.791541	372	430	26	3	58	0.0517241
NODE_63043_length_430_cov_49.791541	372	430	28	8	58	0.1379310
NODE_63043_length_430_cov_49.791541	372	430	38	1	58	0.0172414
NODE_63043_length_430_cov_49.791541	372	430	40	6	58	0.1034483
NODE_63043_length_430_cov_49.791541	372	430	44	7	58	0.1206897
NODE_63043_length_430_cov_49.791541	372	430	46	3	58	0.0517241
NODE_63043_length_430_cov_49.791541	372	430	48	5	58	0.0862069
NODE_63043_length_430_cov_49.791541	372	430	50	7	58	0.1206897
NODE_63043_length_430_cov_49.791541	372	430	52	2	58	0.0344828
NODE_63043_length_430_cov_49.791541	372	430	57	4	58	0.0689655
NODE_63043_length_430_cov_49.791541	372	430	60	1	58	0.0172414
NODE_63044_length_430_cov_44.365559	109	189	0	80	80	1.0000000
NODE_63044_length_430_cov_44.365559	162	242	0	44	80	0.5500000
NODE_63044_length_430_cov_44.365559	162	242	2	36	80	0.4500000
NODE_63045_length_430_cov_16.746224	92	172	0	80	80	1.0000000
NODE_63045_length_430_cov_16.746224	145	225	0	80	80	1.0000000
NODE_63048_length_430_cov_7.737160	180	263	0	18	83	0.2168675
NODE_63048_length_430_cov_7.737160	180	263	2	1	83	0.0120482
NODE_63048_length_430_cov_7.737160	180	263	4	64	83	0.7710843
NODE_63050_length_430_cov_6.163142	135	197	0	62	62	1.0000000
NODE_63051_length_430_cov_5.873112	7	90	0	83	83	1.0000000
NODE_63051_length_430_cov_5.873112	60	126	0	66	66	1.0000000
NODE_63066_length_430_cov_4.323263	18	90	0	1	72	0.0138889
NODE_63066_length_430_cov_4.323263	18	90	2	1	72	0.0138889
NODE_63066_length_430_cov_4.323263	18	90	4	70	72	0.9722222
NODE_63161_length_430_cov_1.945619	153	233	0	4	80	0.0500000
NODE_63161_length_430_cov_1.945619	153	233	2	76	80	0.9500000
NODE_63401_length_430_cov_0.664653	391	430	0	39	39	1.0000000
NODE_63437_length_429_cov_10.424242	78	158	0	31	80	0.3875000
NODE_63437_length_429_cov_10.424242	78	158	2	49	80	0.6125000
NODE_63437_length_429_cov_10.424242	207	287	2	14	80	0.1750000
NODE_63437_length_429_cov_10.424242	207	287	4	66	80	0.8250000
NODE_63437_length_429_cov_10.424242	260	340	4	30	80	0.3750000
NODE_63437_length_429_cov_10.424242	260	340	6	29	80	0.3625000
NODE_63437_length_429_cov_10.424242	260	340	8	6	80	0.0750000
NODE_63437_length_429_cov_10.424242	260	340	10	6	80	0.0750000
NODE_63437_length_429_cov_10.424242	260	340	12	9	80	0.1125000
NODE_63439_length_429_cov_8.957576	213	293	0	80	80	1.0000000
NODE_63439_length_429_cov_8.957576	266	346	0	80	80	1.0000000
NODE_63441_length_429_cov_6.772727	337	366	0	29	29	1.0000000
NODE_63485_length_429_cov_3.003030	173	251	0	78	78	1.0000000
NODE_63516_length_429_cov_2.433333	220	300	0	6	80	0.0750000
NODE_63516_length_429_cov_2.433333	220	300	2	74	80	0.9250000
NODE_63519_length_429_cov_2.360606	24	85	0	61	61	1.0000000
NODE_63527_length_429_cov_2.224242	115	195	0	23	80	0.2875000
NODE_63527_length_429_cov_2.224242	115	195	2	57	80	0.7125000
NODE_63547_length_429_cov_2.051515	114	143	2	29	29	1.0000000
NODE_63547_length_429_cov_2.051515	286	348	0	56	62	0.9032258
NODE_63547_length_429_cov_2.051515	286	348	2	6	62	0.0967742
NODE_63864_length_428_cov_40.449848	217	297	0	80	80	1.0000000
NODE_63864_length_428_cov_40.449848	270	350	0	80	80	1.0000000
NODE_63864_length_428_cov_40.449848	346	426	0	80	80	1.0000000
NODE_63865_length_428_cov_31.066869	249	325	0	10	76	0.1315790
NODE_63865_length_428_cov_31.066869	249	325	2	13	76	0.1710526
NODE_63865_length_428_cov_31.066869	249	325	3	3	76	0.0394737
NODE_63865_length_428_cov_31.066869	249	325	4	47	76	0.6184211
NODE_63865_length_428_cov_31.066869	249	325	6	3	76	0.0394737
NODE_63865_length_428_cov_31.066869	297	378	2	3	81	0.0370370
NODE_63865_length_428_cov_31.066869	297	378	4	78	81	0.9629630
NODE_63866_length_428_cov_11.799392	62	142	0	80	80	1.0000000
NODE_63866_length_428_cov_11.799392	115	195	0	80	80	1.0000000
NODE_63867_length_428_cov_10.595745	227	307	0	80	80	1.0000000
NODE_63870_length_428_cov_6.784195	344	374	0	30	30	1.0000000
NODE_63871_length_428_cov_6.768997	131	194	2	6	63	0.0952381
NODE_63871_length_428_cov_6.768997	131	194	4	2	63	0.0317460
NODE_63871_length_428_cov_6.768997	131	194	6	14	63	0.2222222
NODE_63871_length_428_cov_6.768997	131	194	8	41	63	0.6507937
NODE_63895_length_428_cov_4.206687	224	304	0	5	80	0.0625000
NODE_63895_length_428_cov_4.206687	224	304	2	16	80	0.2000000
NODE_63895_length_428_cov_4.206687	224	304	4	6	80	0.0750000
NODE_63895_length_428_cov_4.206687	224	304	6	13	80	0.1625000
NODE_63895_length_428_cov_4.206687	224	304	8	37	80	0.4625000
NODE_63895_length_428_cov_4.206687	224	304	10	3	80	0.0375000
NODE_63905_length_428_cov_3.525836	168	236	0	68	68	1.0000000
NODE_63905_length_428_cov_3.525836	209	244	0	35	35	1.0000000
NODE_63959_length_428_cov_2.322188	1	42	0	41	41	1.0000000
NODE_63977_length_428_cov_2.124620	228	308	0	80	80	1.0000000
NODE_64011_length_428_cov_1.848024	178	260	4	21	82	0.2560976
NODE_64011_length_428_cov_1.848024	178	260	6	61	82	0.7439024
NODE_64027_length_428_cov_1.772036	187	255	0	68	68	1.0000000
NODE_64245_length_428_cov_0.790274	275	308	2	33	33	1.0000000
NODE_64245_length_428_cov_0.790274	276	302	2	26	26	1.0000000
NODE_64310_length_427_cov_29.628049	312	392	6	28	80	0.3500000
NODE_64310_length_427_cov_29.628049	312	392	8	30	80	0.3750000
NODE_64310_length_427_cov_29.628049	312	392	12	22	80	0.2750000
NODE_64310_length_427_cov_29.628049	365	427	0	1	62	0.0161290
NODE_64310_length_427_cov_29.628049	365	427	4	11	62	0.1774193
NODE_64310_length_427_cov_29.628049	365	427	6	50	62	0.8064516
NODE_64310_length_427_cov_29.628049	365	427	0	1	62	0.0161290
NODE_64310_length_427_cov_29.628049	365	427	4	11	62	0.1774193
NODE_64310_length_427_cov_29.628049	365	427	6	50	62	0.8064516
NODE_64312_length_427_cov_9.371951	184	239	0	6	55	0.1090909
NODE_64312_length_427_cov_9.371951	184	239	6	8	55	0.1454545
NODE_64312_length_427_cov_9.371951	184	239	8	41	55	0.7454545
NODE_64313_length_427_cov_9.359756	11	82	0	71	71	1.0000000
NODE_64313_length_427_cov_9.359756	70	149	0	79	79	1.0000000
NODE_64313_length_427_cov_9.359756	145	225	0	80	80	1.0000000
NODE_64313_length_427_cov_9.359756	198	278	0	80	80	1.0000000
NODE_64321_length_427_cov_5.929878	405	424	0	1	19	0.0526316
NODE_64321_length_427_cov_5.929878	405	424	1	14	19	0.7368421
NODE_64321_length_427_cov_5.929878	405	424	2	4	19	0.2105263
NODE_64324_length_427_cov_5.088415	257	332	0	75	75	1.0000000
NODE_64345_length_427_cov_3.884146	212	260	0	48	48	1.0000000
NODE_64383_length_427_cov_2.765244	312	363	0	51	51	1.0000000
NODE_64409_length_427_cov_2.362805	142	177	0	35	35	1.0000000
NODE_64537_length_427_cov_1.359756	56	139	0	83	83	1.0000000
NODE_64728_length_426_cov_21.837920	178	258	0	80	80	1.0000000
NODE_64729_length_426_cov_16.850153	76	156	0	80	80	1.0000000
NODE_64729_length_426_cov_16.850153	129	209	0	80	80	1.0000000
NODE_64731_length_426_cov_9.033639	152	232	0	80	80	1.0000000
NODE_64731_length_426_cov_9.033639	205	285	0	80	80	1.0000000
NODE_64734_length_426_cov_8.314985	133	213	0	26	80	0.3250000
NODE_64734_length_426_cov_8.314985	133	213	2	54	80	0.6750000
NODE_64734_length_426_cov_8.314985	186	266	0	30	80	0.3750000
NODE_64734_length_426_cov_8.314985	186	266	2	50	80	0.6250000
NODE_64735_length_426_cov_8.278287	132	212	0	37	80	0.4625000
NODE_64735_length_426_cov_8.278287	132	212	2	43	80	0.5375000
NODE_64735_length_426_cov_8.278287	185	265	0	4	80	0.0500000
NODE_64735_length_426_cov_8.278287	185	265	2	76	80	0.9500000
NODE_64752_length_426_cov_4.926606	116	196	0	80	80	1.0000000
NODE_64754_length_426_cov_4.743119	119	199	2	74	80	0.9250000
NODE_64754_length_426_cov_4.743119	119	199	4	6	80	0.0750000
NODE_64754_length_426_cov_4.743119	172	252	0	15	80	0.1875000
NODE_64754_length_426_cov_4.743119	172	252	2	65	80	0.8125000
NODE_64833_length_426_cov_2.278287	92	132	0	40	40	1.0000000
NODE_64833_length_426_cov_2.278287	139	205	0	66	66	1.0000000
NODE_64865_length_426_cov_1.896024	80	154	2	45	74	0.6081081
NODE_64865_length_426_cov_1.896024	80	154	4	29	74	0.3918919
NODE_64948_length_426_cov_1.397554	240	290	0	50	50	1.0000000
NODE_65135_length_426_cov_0.602446	127	158	0	31	31	1.0000000
NODE_65152_length_425_cov_63.938650	0	61	0	61	61	1.0000000
NODE_65152_length_425_cov_63.938650	34	114	0	80	80	1.0000000
NODE_65164_length_425_cov_4.877301	171	229	0	25	58	0.4310345
NODE_65164_length_425_cov_4.877301	171	229	2	9	58	0.1551724
NODE_65164_length_425_cov_4.877301	171	229	4	24	58	0.4137931
NODE_65165_length_425_cov_4.822086	295	377	0	8	82	0.0975610
NODE_65165_length_425_cov_4.822086	295	377	2	44	82	0.5365854
NODE_65165_length_425_cov_4.822086	295	377	6	21	82	0.2560976
NODE_65165_length_425_cov_4.822086	295	377	8	9	82	0.1097561
NODE_65218_length_425_cov_2.809816	38	118	0	8	80	0.1000000
NODE_65218_length_425_cov_2.809816	38	118	2	29	80	0.3625000
NODE_65218_length_425_cov_2.809816	38	118	4	13	80	0.1625000
NODE_65218_length_425_cov_2.809816	38	118	6	30	80	0.3750000
NODE_65278_length_425_cov_1.935583	93	138	2	14	45	0.3111111
NODE_65278_length_425_cov_1.935583	93	138	4	31	45	0.6888889
NODE_65278_length_425_cov_1.935583	170	225	0	46	55	0.8363636
NODE_65278_length_425_cov_1.935583	170	225	2	8	55	0.1454545
NODE_65278_length_425_cov_1.935583	170	225	4	1	55	0.0181818
NODE_65278_length_425_cov_1.935583	312	355	0	43	43	1.0000000
NODE_65565_length_425_cov_0.628834	104	131	0	27	27	1.0000000
NODE_65602_length_424_cov_5.295385	224	270	0	46	46	1.0000000
NODE_65634_length_424_cov_3.255385	266	329	0	63	63	1.0000000
NODE_65669_length_424_cov_2.578462	403	422	0	19	19	1.0000000
NODE_65670_length_424_cov_2.578462	122	144	0	22	22	1.0000000
NODE_66111_length_423_cov_2.728395	150	229	0	39	79	0.4936709
NODE_66111_length_423_cov_2.728395	150	229	2	40	79	0.5063291
NODE_66181_length_423_cov_1.879630	94	142	0	48	48	1.0000000
NODE_66222_length_423_cov_1.580247	128	208	0	80	80	1.0000000
NODE_66258_length_423_cov_1.410494	206	286	2	42	80	0.5250000
NODE_66258_length_423_cov_1.410494	206	286	4	38	80	0.4750000
NODE_66459_length_422_cov_12.021672	201	236	0	18	35	0.5142857
NODE_66459_length_422_cov_12.021672	201	236	2	17	35	0.4857143
NODE_66459_length_422_cov_12.021672	247	289	4	42	42	1.0000000
NODE_66460_length_422_cov_10.712074	62	140	0	78	78	1.0000000
NODE_66460_length_422_cov_10.712074	115	195	0	80	80	1.0000000
NODE_66468_length_422_cov_6.281734	37	117	0	80	80	1.0000000
NODE_66468_length_422_cov_6.281734	90	170	0	80	80	1.0000000
NODE_66474_length_422_cov_5.266254	176	256	0	80	80	1.0000000
NODE_66485_length_422_cov_4.148607	159	224	0	65	65	1.0000000
NODE_66485_length_422_cov_4.148607	197	277	0	80	80	1.0000000
NODE_66488_length_422_cov_4.003096	146	226	0	54	80	0.6750000
NODE_66488_length_422_cov_4.003096	146	226	2	26	80	0.3250000
NODE_66488_length_422_cov_4.003096	199	279	0	6	80	0.0750000
NODE_66488_length_422_cov_4.003096	199	279	2	65	80	0.8125000
NODE_66488_length_422_cov_4.003096	199	279	4	9	80	0.1125000
NODE_66512_length_422_cov_3.130031	93	173	4	12	80	0.1500000
NODE_66512_length_422_cov_3.130031	93	173	8	68	80	0.8500000
NODE_66512_length_422_cov_3.130031	146	226	0	43	80	0.5375000
NODE_66512_length_422_cov_3.130031	146	226	4	12	80	0.1500000
NODE_66512_length_422_cov_3.130031	146	226	8	25	80	0.3125000
NODE_66515_length_422_cov_3.077399	291	359	2	7	68	0.1029412
NODE_66515_length_422_cov_3.077399	291	359	4	4	68	0.0588235
NODE_66515_length_422_cov_3.077399	291	359	6	6	68	0.0882353
NODE_66515_length_422_cov_3.077399	291	359	8	3	68	0.0441176
NODE_66515_length_422_cov_3.077399	291	359	10	27	68	0.3970588
NODE_66515_length_422_cov_3.077399	291	359	12	21	68	0.3088235
NODE_66550_length_422_cov_2.191950	5	24	0	19	19	1.0000000
NODE_66560_length_422_cov_2.108359	97	177	0	67	80	0.8375000
NODE_66560_length_422_cov_2.108359	97	177	2	2	80	0.0250000
NODE_66560_length_422_cov_2.108359	97	177	4	8	80	0.1000000
NODE_66560_length_422_cov_2.108359	97	177	6	3	80	0.0375000
NODE_66560_length_422_cov_2.108359	150	189	0	39	39	1.0000000
NODE_66560_length_422_cov_2.108359	249	289	2	11	40	0.2750000
NODE_66560_length_422_cov_2.108359	249	289	4	12	40	0.3000000
NODE_66560_length_422_cov_2.108359	249	289	6	12	40	0.3000000
NODE_66560_length_422_cov_2.108359	249	289	8	5	40	0.1250000
NODE_66806_length_422_cov_0.845201	2	76	0	74	74	1.0000000
NODE_66869_length_421_cov_10.664596	178	256	0	78	78	1.0000000
NODE_66869_length_421_cov_10.664596	229	309	0	80	80	1.0000000
NODE_66874_length_421_cov_7.552795	325	407	0	80	82	0.9756098
NODE_66874_length_421_cov_7.552795	325	407	6	1	82	0.0121951
NODE_66874_length_421_cov_7.552795	325	407	8	1	82	0.0121951
NODE_66874_length_421_cov_7.552795	380	421	0	41	41	1.0000000
NODE_66875_length_421_cov_7.431677	96	118	0	22	22	1.0000000
NODE_66883_length_421_cov_5.279503	245	310	0	65	65	1.0000000
NODE_66884_length_421_cov_5.158385	68	145	0	77	77	1.0000000
NODE_66897_length_421_cov_4.114907	221	287	0	66	66	1.0000000
NODE_66898_length_421_cov_4.102484	202	277	0	75	75	1.0000000
NODE_66899_length_421_cov_4.040373	192	272	0	80	80	1.0000000
NODE_66899_length_421_cov_4.040373	245	314	0	69	69	1.0000000
NODE_66923_length_421_cov_3.319876	0	57	0	6	57	0.1052632
NODE_66923_length_421_cov_3.319876	0	57	2	51	57	0.8947368
NODE_66955_length_421_cov_2.708075	95	118	0	23	23	1.0000000
NODE_66955_length_421_cov_2.708075	109	189	0	80	80	1.0000000
NODE_66955_length_421_cov_2.708075	248	300	4	52	52	1.0000000
NODE_67073_length_421_cov_1.559006	240	309	0	46	69	0.6666667
NODE_67073_length_421_cov_1.559006	240	309	2	5	69	0.0724638
NODE_67073_length_421_cov_1.559006	240	309	4	18	69	0.2608696
NODE_67073_length_421_cov_1.559006	240	310	0	47	70	0.6714286
NODE_67073_length_421_cov_1.559006	240	310	2	5	70	0.0714286
NODE_67073_length_421_cov_1.559006	240	310	4	18	70	0.2571429
NODE_67077_length_421_cov_1.537267	305	383	0	23	78	0.2948718
NODE_67077_length_421_cov_1.537267	305	383	2	55	78	0.7051282
NODE_67098_length_421_cov_1.413043	254	303	0	49	49	1.0000000
NODE_67283_length_421_cov_0.633540	132	156	2	24	24	1.0000000
NODE_67317_length_420_cov_80.766355	90	170	0	80	80	1.0000000
NODE_67317_length_420_cov_80.766355	143	223	0	80	80	1.0000000
NODE_67319_length_420_cov_51.473520	171	250	0	79	79	1.0000000
NODE_67319_length_420_cov_51.473520	223	307	0	84	84	1.0000000
NODE_67319_length_420_cov_51.473520	303	383	0	80	80	1.0000000
NODE_67319_length_420_cov_51.473520	356	420	0	64	64	1.0000000
NODE_67330_length_420_cov_5.071651	230	310	0	80	80	1.0000000
NODE_67334_length_420_cov_4.775701	177	221	0	44	44	1.0000000
NODE_67345_length_420_cov_4.037383	161	240	0	4	79	0.0506329
NODE_67345_length_420_cov_4.037383	161	240	2	75	79	0.9493671
NODE_67358_length_420_cov_3.657321	291	373	0	50	82	0.6097561
NODE_67358_length_420_cov_3.657321	291	373	2	32	82	0.3902439
NODE_67398_length_420_cov_2.542056	96	176	0	80	80	1.0000000
NODE_67398_length_420_cov_2.542056	148	202	0	54	54	1.0000000
NODE_67398_length_420_cov_2.542056	149	195	0	46	46	1.0000000
NODE_67414_length_420_cov_2.323988	89	108	0	19	19	1.0000000
NODE_67506_length_420_cov_1.641745	277	312	0	35	35	1.0000000
NODE_67547_length_420_cov_1.429907	15	68	0	26	53	0.4905660
NODE_67547_length_420_cov_1.429907	15	68	2	8	53	0.1509434
NODE_67547_length_420_cov_1.429907	15	68	4	19	53	0.3584906
NODE_67547_length_420_cov_1.429907	69	111	4	42	42	1.0000000
NODE_67770_length_419_cov_491.015625	0	67	0	54	67	0.8059701
NODE_67770_length_419_cov_491.015625	0	67	2	13	67	0.1940299
NODE_67770_length_419_cov_491.015625	0	67	0	54	67	0.8059701
NODE_67770_length_419_cov_491.015625	0	67	2	13	67	0.1940299
NODE_67770_length_419_cov_491.015625	0	67	0	54	67	0.8059701
NODE_67770_length_419_cov_491.015625	0	67	2	13	67	0.1940299
NODE_67770_length_419_cov_491.015625	0	67	0	54	67	0.8059701
NODE_67770_length_419_cov_491.015625	0	67	2	13	67	0.1940299
NODE_67770_length_419_cov_491.015625	63	143	2	6	80	0.0750000
NODE_67770_length_419_cov_491.015625	63	143	3	10	80	0.1250000
NODE_67770_length_419_cov_491.015625	63	143	4	12	80	0.1500000
NODE_67770_length_419_cov_491.015625	63	143	6	18	80	0.2250000
NODE_67770_length_419_cov_491.015625	63	143	10	6	80	0.0750000
NODE_67770_length_419_cov_491.015625	63	143	12	15	80	0.1875000
NODE_67770_length_419_cov_491.015625	63	143	14	5	80	0.0625000
NODE_67770_length_419_cov_491.015625	63	143	16	8	80	0.1000000
NODE_67770_length_419_cov_491.015625	63	143	2	6	80	0.0750000
NODE_67770_length_419_cov_491.015625	63	143	3	10	80	0.1250000
NODE_67770_length_419_cov_491.015625	63	143	4	12	80	0.1500000
NODE_67770_length_419_cov_491.015625	63	143	6	18	80	0.2250000
NODE_67770_length_419_cov_491.015625	63	143	10	6	80	0.0750000
NODE_67770_length_419_cov_491.015625	63	143	12	15	80	0.1875000
NODE_67770_length_419_cov_491.015625	63	143	14	5	80	0.0625000
NODE_67770_length_419_cov_491.015625	63	143	16	8	80	0.1000000
NODE_67770_length_419_cov_491.015625	63	143	2	6	80	0.0750000
NODE_67770_length_419_cov_491.015625	63	143	3	10	80	0.1250000
NODE_67770_length_419_cov_491.015625	63	143	4	12	80	0.1500000
NODE_67770_length_419_cov_491.015625	63	143	6	18	80	0.2250000
NODE_67770_length_419_cov_491.015625	63	143	10	6	80	0.0750000
NODE_67770_length_419_cov_491.015625	63	143	12	15	80	0.1875000
NODE_67770_length_419_cov_491.015625	63	143	14	5	80	0.0625000
NODE_67770_length_419_cov_491.015625	63	143	16	8	80	0.1000000
NODE_67770_length_419_cov_491.015625	116	196	12	14	80	0.1750000
NODE_67770_length_419_cov_491.015625	116	196	14	11	80	0.1375000
NODE_67770_length_419_cov_491.015625	116	196	16	10	80	0.1250000
NODE_67770_length_419_cov_491.015625	116	196	18	21	80	0.2625000
NODE_67770_length_419_cov_491.015625	116	196	20	24	80	0.3000000
NODE_67770_length_419_cov_491.015625	116	196	12	14	80	0.1750000
NODE_67770_length_419_cov_491.015625	116	196	14	11	80	0.1375000
NODE_67770_length_419_cov_491.015625	116	196	16	10	80	0.1250000
NODE_67770_length_419_cov_491.015625	116	196	18	21	80	0.2625000
NODE_67770_length_419_cov_491.015625	116	196	20	24	80	0.3000000
NODE_67770_length_419_cov_491.015625	116	196	12	14	80	0.1750000
NODE_67770_length_419_cov_491.015625	116	196	14	11	80	0.1375000
NODE_67770_length_419_cov_491.015625	116	196	16	10	80	0.1250000
NODE_67770_length_419_cov_491.015625	116	196	18	21	80	0.2625000
NODE_67770_length_419_cov_491.015625	116	196	20	24	80	0.3000000
NODE_67770_length_419_cov_491.015625	116	196	12	14	80	0.1750000
NODE_67770_length_419_cov_491.015625	116	196	14	11	80	0.1375000
NODE_67770_length_419_cov_491.015625	116	196	16	10	80	0.1250000
NODE_67770_length_419_cov_491.015625	116	196	18	21	80	0.2625000
NODE_67770_length_419_cov_491.015625	116	196	20	24	80	0.3000000
NODE_67770_length_419_cov_491.015625	116	196	12	14	80	0.1750000
NODE_67770_length_419_cov_491.015625	116	196	14	11	80	0.1375000
NODE_67770_length_419_cov_491.015625	116	196	16	10	80	0.1250000
NODE_67770_length_419_cov_491.015625	116	196	18	21	80	0.2625000
NODE_67770_length_419_cov_491.015625	116	196	20	24	80	0.3000000
NODE_67772_length_419_cov_31.725000	12	92	0	80	80	1.0000000
NODE_67772_length_419_cov_31.725000	65	145	0	80	80	1.0000000
NODE_67789_length_419_cov_4.862500	47	103	0	20	56	0.3571429
NODE_67789_length_419_cov_4.862500	47	103	2	36	56	0.6428571
NODE_67789_length_419_cov_4.862500	258	327	0	14	69	0.2028985
NODE_67789_length_419_cov_4.862500	258	327	2	21	69	0.3043478
NODE_67789_length_419_cov_4.862500	258	327	4	22	69	0.3188406
NODE_67789_length_419_cov_4.862500	258	327	6	12	69	0.1739130
NODE_67789_length_419_cov_4.862500	284	328	0	15	44	0.3409091
NODE_67789_length_419_cov_4.862500	284	328	2	21	44	0.4772727
NODE_67789_length_419_cov_4.862500	284	328	4	8	44	0.1818182
NODE_67803_length_419_cov_4.193750	215	262	0	47	47	1.0000000
NODE_67803_length_419_cov_4.193750	235	275	0	40	40	1.0000000
NODE_67817_length_419_cov_3.696875	165	215	0	50	50	1.0000000
NODE_67854_length_419_cov_2.628125	234	314	0	66	80	0.8250000
NODE_67854_length_419_cov_2.628125	234	314	2	14	80	0.1750000
NODE_67856_length_419_cov_2.603125	154	196	0	42	42	1.0000000
NODE_67878_length_419_cov_2.350000	156	220	4	4	64	0.0625000
NODE_67878_length_419_cov_2.350000	156	220	6	11	64	0.1718750
NODE_67878_length_419_cov_2.350000	156	220	8	3	64	0.0468750
NODE_67878_length_419_cov_2.350000	156	220	12	2	64	0.0312500
NODE_67878_length_419_cov_2.350000	156	220	14	5	64	0.0781250
NODE_67878_length_419_cov_2.350000	156	220	16	14	64	0.2187500
NODE_67878_length_419_cov_2.350000	156	220	18	12	64	0.1875000
NODE_67878_length_419_cov_2.350000	156	220	20	1	64	0.0156250
NODE_67878_length_419_cov_2.350000	156	220	22	12	64	0.1875000
NODE_67961_length_419_cov_1.593750	339	358	0	19	19	1.0000000
NODE_68250_length_418_cov_63.059561	105	186	0	81	81	1.0000000
NODE_68250_length_418_cov_63.059561	159	239	0	80	80	1.0000000
NODE_68251_length_418_cov_49.796238	325	405	2	22	80	0.2750000
NODE_68251_length_418_cov_49.796238	325	405	3	1	80	0.0125000
NODE_68251_length_418_cov_49.796238	325	405	5	2	80	0.0250000
NODE_68251_length_418_cov_49.796238	325	405	7	10	80	0.1250000
NODE_68251_length_418_cov_49.796238	325	405	8	4	80	0.0500000
NODE_68251_length_418_cov_49.796238	325	405	10	4	80	0.0500000
NODE_68251_length_418_cov_49.796238	325	405	12	6	80	0.0750000
NODE_68251_length_418_cov_49.796238	325	405	14	1	80	0.0125000
NODE_68251_length_418_cov_49.796238	325	405	16	7	80	0.0875000
NODE_68251_length_418_cov_49.796238	325	405	18	2	80	0.0250000
NODE_68251_length_418_cov_49.796238	325	405	20	4	80	0.0500000
NODE_68251_length_418_cov_49.796238	325	405	22	4	80	0.0500000
NODE_68251_length_418_cov_49.796238	325	405	24	2	80	0.0250000
NODE_68251_length_418_cov_49.796238	325	405	26	2	80	0.0250000
NODE_68251_length_418_cov_49.796238	325	405	28	9	80	0.1125000
NODE_68251_length_418_cov_49.796238	378	415	0	9	37	0.2432432
NODE_68251_length_418_cov_49.796238	378	415	2	23	37	0.6216216
NODE_68251_length_418_cov_49.796238	378	415	3	1	37	0.0270270
NODE_68251_length_418_cov_49.796238	378	415	5	2	37	0.0540541
NODE_68251_length_418_cov_49.796238	378	415	7	2	37	0.0540541
NODE_68252_length_418_cov_42.764890	119	196	0	77	77	1.0000000
NODE_68252_length_418_cov_42.764890	172	250	0	24	78	0.3076923
NODE_68252_length_418_cov_42.764890	172	250	2	54	78	0.6923077
NODE_68253_length_418_cov_23.830721	73	153	0	80	80	1.0000000
NODE_68253_length_418_cov_23.830721	126	200	0	74	74	1.0000000
NODE_68255_length_418_cov_7.216301	211	291	2	72	80	0.9000000
NODE_68255_length_418_cov_7.216301	211	291	4	8	80	0.1000000
NODE_68265_length_418_cov_5.382445	134	215	0	32	81	0.3950617
NODE_68265_length_418_cov_5.382445	134	215	2	49	81	0.6049383
NODE_68265_length_418_cov_5.382445	187	268	0	19	81	0.2345679
NODE_68265_length_418_cov_5.382445	187	268	2	62	81	0.7654321
NODE_68275_length_418_cov_4.463950	191	272	0	81	81	1.0000000
NODE_68280_length_418_cov_4.216301	148	230	0	38	82	0.4634146
NODE_68280_length_418_cov_4.216301	148	230	2	44	82	0.5365854
NODE_68281_length_418_cov_4.065831	211	280	0	69	69	1.0000000
NODE_68284_length_418_cov_3.909091	95	175	6	31	80	0.3875000
NODE_68284_length_418_cov_3.909091	95	175	8	3	80	0.0375000
NODE_68284_length_418_cov_3.909091	95	175	10	16	80	0.2000000
NODE_68284_length_418_cov_3.909091	95	175	12	17	80	0.2125000
NODE_68284_length_418_cov_3.909091	95	175	14	12	80	0.1500000
NODE_68284_length_418_cov_3.909091	95	175	16	1	80	0.0125000
NODE_68284_length_418_cov_3.909091	148	224	6	25	76	0.3289474
NODE_68284_length_418_cov_3.909091	148	224	8	32	76	0.4210526
NODE_68284_length_418_cov_3.909091	148	224	10	16	76	0.2105263
NODE_68284_length_418_cov_3.909091	148	224	12	1	76	0.0131579
NODE_68284_length_418_cov_3.909091	148	224	14	1	76	0.0131579
NODE_68284_length_418_cov_3.909091	148	224	16	1	76	0.0131579
NODE_68288_length_418_cov_3.749216	181	247	0	66	66	1.0000000
NODE_68289_length_418_cov_3.711599	249	313	3	8	64	0.1250000
NODE_68289_length_418_cov_3.711599	249	313	7	12	64	0.1875000
NODE_68289_length_418_cov_3.711599	249	313	8	7	64	0.1093750
NODE_68289_length_418_cov_3.711599	249	313	9	7	64	0.1093750
NODE_68289_length_418_cov_3.711599	249	313	10	30	64	0.4687500
NODE_68307_length_418_cov_3.012539	101	181	0	36	80	0.4500000
NODE_68307_length_418_cov_3.012539	101	181	2	17	80	0.2125000
NODE_68307_length_418_cov_3.012539	101	181	4	12	80	0.1500000
NODE_68307_length_418_cov_3.012539	101	181	6	15	80	0.1875000
NODE_68354_length_418_cov_2.376176	95	115	0	20	20	1.0000000
NODE_68436_length_418_cov_1.623824	47	128	2	81	81	1.0000000
NODE_68436_length_418_cov_1.623824	239	268	4	9	29	0.3103448
NODE_68436_length_418_cov_1.623824	239	268	6	20	29	0.6896552
NODE_68682_length_418_cov_0.626959	255	299	0	44	44	1.0000000
NODE_68708_length_417_cov_45.267296	212	292	0	80	80	1.0000000
NODE_68708_length_417_cov_45.267296	265	345	0	80	80	1.0000000
NODE_68708_length_417_cov_45.267296	341	417	0	76	76	1.0000000
NODE_68709_length_417_cov_36.006289	159	239	2	2	80	0.0250000
NODE_68709_length_417_cov_36.006289	159	239	4	17	80	0.2125000
NODE_68709_length_417_cov_36.006289	159	239	8	10	80	0.1250000
NODE_68709_length_417_cov_36.006289	159	239	10	51	80	0.6375000
NODE_68711_length_417_cov_12.886792	193	273	0	80	80	1.0000000
NODE_68711_length_417_cov_12.886792	246	326	0	80	80	1.0000000
NODE_68717_length_417_cov_7.056604	210	271	0	61	61	1.0000000
NODE_68717_length_417_cov_7.056604	263	315	0	52	52	1.0000000
NODE_68718_length_417_cov_6.669811	194	264	0	65	70	0.9285714
NODE_68718_length_417_cov_6.669811	194	264	2	5	70	0.0714286
NODE_68779_length_417_cov_2.795597	20	91	0	71	71	1.0000000
NODE_69163_length_416_cov_115.782334	174	259	2	35	85	0.4117647
NODE_69163_length_416_cov_115.782334	174	259	4	12	85	0.1411765
NODE_69163_length_416_cov_115.782334	174	259	8	2	85	0.0235294
NODE_69163_length_416_cov_115.782334	174	259	9	9	85	0.1058824
NODE_69163_length_416_cov_115.782334	174	259	14	8	85	0.0941176
NODE_69163_length_416_cov_115.782334	174	259	16	19	85	0.2235294
NODE_69164_length_416_cov_70.678233	180	244	8	17	64	0.2656250
NODE_69164_length_416_cov_70.678233	180	244	10	2	64	0.0312500
NODE_69164_length_416_cov_70.678233	180	244	12	2	64	0.0312500
NODE_69164_length_416_cov_70.678233	180	244	14	3	64	0.0468750
NODE_69164_length_416_cov_70.678233	180	244	16	2	64	0.0312500
NODE_69164_length_416_cov_70.678233	180	244	18	3	64	0.0468750
NODE_69164_length_416_cov_70.678233	180	244	20	1	64	0.0156250
NODE_69164_length_416_cov_70.678233	180	244	22	6	64	0.0937500
NODE_69164_length_416_cov_70.678233	180	244	24	5	64	0.0781250
NODE_69164_length_416_cov_70.678233	180	244	26	1	64	0.0156250
NODE_69164_length_416_cov_70.678233	180	244	28	22	64	0.3437500
NODE_69166_length_416_cov_39.933754	288	368	0	15	80	0.1875000
NODE_69166_length_416_cov_39.933754	288	368	2	65	80	0.8125000
NODE_69166_length_416_cov_39.933754	341	416	0	16	75	0.2133333
NODE_69166_length_416_cov_39.933754	341	416	2	59	75	0.7866667
NODE_69167_length_416_cov_37.334385	158	238	0	80	80	1.0000000
NODE_69167_length_416_cov_37.334385	211	291	0	80	80	1.0000000
NODE_69167_length_416_cov_37.334385	287	367	0	80	80	1.0000000
NODE_69167_length_416_cov_37.334385	340	416	0	76	76	1.0000000
NODE_69179_length_416_cov_5.242902	89	169	0	80	80	1.0000000
NODE_69179_length_416_cov_5.242902	142	222	0	80	80	1.0000000
NODE_69184_length_416_cov_4.892744	79	145	0	66	66	1.0000000
NODE_69184_length_416_cov_4.892744	194	272	0	11	78	0.1410256
NODE_69184_length_416_cov_4.892744	194	272	2	67	78	0.8589743
NODE_69184_length_416_cov_4.892744	247	272	2	25	25	1.0000000
NODE_69204_length_416_cov_3.886435	79	136	2	24	57	0.4210526
NODE_69204_length_416_cov_3.886435	79	136	4	33	57	0.5789474
NODE_69279_length_416_cov_2.230284	10	90	0	80	80	1.0000000
NODE_69399_length_416_cov_1.520505	198	244	2	46	46	1.0000000
NODE_69399_length_416_cov_1.520505	261	328	2	1	67	0.0149254
NODE_69399_length_416_cov_1.520505	261	328	4	43	67	0.6417910
NODE_69399_length_416_cov_1.520505	261	328	6	3	67	0.0447761
NODE_69399_length_416_cov_1.520505	261	328	8	7	67	0.1044776
NODE_69399_length_416_cov_1.520505	261	328	10	13	67	0.1940299
NODE_69673_length_415_cov_35.924051	260	339	0	79	79	1.0000000
NODE_69673_length_415_cov_35.924051	316	392	0	76	76	1.0000000
NODE_69679_length_415_cov_6.376582	117	197	0	80	80	1.0000000
NODE_69679_length_415_cov_6.376582	254	334	0	13	80	0.1625000
NODE_69679_length_415_cov_6.376582	254	334	2	67	80	0.8375000
NODE_69774_length_415_cov_2.224684	144	224	2	80	80	1.0000000
NODE_69795_length_415_cov_2.069620	207	273	0	66	66	1.0000000
NODE_69817_length_415_cov_1.832278	225	283	1	27	58	0.4655173
NODE_69817_length_415_cov_1.832278	225	283	2	31	58	0.5344828
NODE_69845_length_415_cov_1.610759	90	170	12	15	80	0.1875000
NODE_69845_length_415_cov_1.610759	90	170	14	1	80	0.0125000
NODE_69845_length_415_cov_1.610759	90	170	16	5	80	0.0625000
NODE_69845_length_415_cov_1.610759	90	170	18	4	80	0.0500000
NODE_69845_length_415_cov_1.610759	90	170	20	2	80	0.0250000
NODE_69845_length_415_cov_1.610759	90	170	26	2	80	0.0250000
NODE_69845_length_415_cov_1.610759	90	170	28	8	80	0.1000000
NODE_69845_length_415_cov_1.610759	90	170	30	7	80	0.0875000
NODE_69845_length_415_cov_1.610759	90	170	32	2	80	0.0250000
NODE_69845_length_415_cov_1.610759	90	170	36	1	80	0.0125000
NODE_69845_length_415_cov_1.610759	90	170	38	5	80	0.0625000
NODE_69845_length_415_cov_1.610759	90	170	40	7	80	0.0875000
NODE_69845_length_415_cov_1.610759	90	170	42	7	80	0.0875000
NODE_69845_length_415_cov_1.610759	90	170	44	14	80	0.1750000
NODE_69845_length_415_cov_1.610759	335	376	0	41	41	1.0000000
NODE_70175_length_414_cov_46.263492	0	49	0	49	49	1.0000000
NODE_70175_length_414_cov_46.263492	22	102	0	80	80	1.0000000
NODE_70183_length_414_cov_7.460317	167	247	0	80	80	1.0000000
NODE_70183_length_414_cov_7.460317	220	300	0	80	80	1.0000000
NODE_70192_length_414_cov_5.676190	54	134	0	80	80	1.0000000
NODE_70192_length_414_cov_5.676190	107	187	0	80	80	1.0000000
NODE_70222_length_414_cov_4.130159	257	303	2	46	46	1.0000000
NODE_70222_length_414_cov_4.130159	276	356	0	7	80	0.0875000
NODE_70222_length_414_cov_4.130159	276	356	2	73	80	0.9125000
NODE_70254_length_414_cov_2.996825	75	135	10	4	60	0.0666667
NODE_70254_length_414_cov_2.996825	75	135	12	4	60	0.0666667
NODE_70254_length_414_cov_2.996825	75	135	14	1	60	0.0166667
NODE_70254_length_414_cov_2.996825	75	135	16	8	60	0.1333333
NODE_70254_length_414_cov_2.996825	75	135	18	4	60	0.0666667
NODE_70254_length_414_cov_2.996825	75	135	20	5	60	0.0833333
NODE_70254_length_414_cov_2.996825	75	135	22	3	60	0.0500000
NODE_70254_length_414_cov_2.996825	75	135	24	31	60	0.5166667
NODE_70271_length_414_cov_2.631746	68	145	0	77	77	1.0000000
NODE_70284_length_414_cov_2.473016	164	197	0	33	33	1.0000000
NODE_70284_length_414_cov_2.473016	170	255	0	85	85	1.0000000
NODE_70305_length_414_cov_2.222222	185	260	0	15	75	0.2000000
NODE_70305_length_414_cov_2.222222	185	260	2	6	75	0.0800000
NODE_70305_length_414_cov_2.222222	185	260	4	46	75	0.6133333
NODE_70305_length_414_cov_2.222222	185	260	6	8	75	0.1066667
NODE_70305_length_414_cov_2.222222	233	304	2	9	71	0.1267606
NODE_70305_length_414_cov_2.222222	233	304	4	25	71	0.3521127
NODE_70305_length_414_cov_2.222222	233	304	6	37	71	0.5211267
NODE_70307_length_414_cov_2.206349	88	163	0	75	75	1.0000000
NODE_70326_length_414_cov_2.047619	298	349	0	51	51	1.0000000
NODE_70486_length_414_cov_1.177778	106	190	4	61	84	0.7261904
NODE_70486_length_414_cov_1.177778	106	190	6	23	84	0.2738095
NODE_70494_length_414_cov_1.155556	0	23	0	23	23	1.0000000
NODE_70690_length_413_cov_41.471338	35	115	0	80	80	1.0000000
NODE_70690_length_413_cov_41.471338	35	115	0	80	80	1.0000000
NODE_70690_length_413_cov_41.471338	88	168	0	80	80	1.0000000
NODE_70690_length_413_cov_41.471338	88	168	0	80	80	1.0000000
NODE_70691_length_413_cov_16.687898	222	302	0	75	80	0.9375000
NODE_70691_length_413_cov_16.687898	222	302	2	5	80	0.0625000
NODE_70691_length_413_cov_16.687898	275	355	0	80	80	1.0000000
NODE_70699_length_413_cov_7.057325	170	250	2	31	80	0.3875000
NODE_70699_length_413_cov_7.057325	170	250	4	25	80	0.3125000
NODE_70699_length_413_cov_7.057325	170	250	6	24	80	0.3000000
NODE_70699_length_413_cov_7.057325	223	300	4	3	77	0.0389610
NODE_70699_length_413_cov_7.057325	223	300	6	36	77	0.4675325
NODE_70699_length_413_cov_7.057325	223	300	8	1	77	0.0129870
NODE_70699_length_413_cov_7.057325	223	300	10	37	77	0.4805195
NODE_70703_length_413_cov_5.665605	125	182	0	57	57	1.0000000
NODE_70712_length_413_cov_4.754777	140	184	0	4	44	0.0909091
NODE_70712_length_413_cov_4.754777	140	184	2	40	44	0.9090909
NODE_70743_length_413_cov_3.506369	113	193	4	80	80	1.0000000
NODE_70749_length_413_cov_3.235669	251	331	0	80	80	1.0000000
NODE_70749_length_413_cov_3.235669	304	356	0	52	52	1.0000000
NODE_70792_length_413_cov_2.484076	209	257	2	48	48	1.0000000
NODE_70835_length_413_cov_1.949045	224	296	0	72	72	1.0000000
NODE_71196_length_412_cov_9.996805	172	244	0	72	72	1.0000000
NODE_71218_length_412_cov_4.686901	112	167	0	55	55	1.0000000
NODE_71253_length_412_cov_3.204473	44	124	0	80	80	1.0000000
NODE_71276_length_412_cov_2.824281	225	305	0	37	80	0.4625000
NODE_71276_length_412_cov_2.824281	225	305	4	43	80	0.5375000
NODE_71371_length_412_cov_1.782748	262	342	0	80	80	1.0000000
NODE_71398_length_412_cov_1.603834	143	182	0	9	39	0.2307692
NODE_71398_length_412_cov_1.603834	143	182	2	11	39	0.2820513
NODE_71398_length_412_cov_1.603834	143	182	4	4	39	0.1025641
NODE_71398_length_412_cov_1.603834	143	182	6	8	39	0.2051282
NODE_71398_length_412_cov_1.603834	143	182	8	3	39	0.0769231
NODE_71398_length_412_cov_1.603834	143	182	10	4	39	0.1025641
NODE_71665_length_411_cov_44.701923	4	72	0	68	68	1.0000000
NODE_71665_length_411_cov_44.701923	35	116	0	81	81	1.0000000
NODE_71665_length_411_cov_44.701923	161	242	0	81	81	1.0000000
NODE_71665_length_411_cov_44.701923	293	374	0	81	81	1.0000000
NODE_71665_length_411_cov_44.701923	337	411	0	74	74	1.0000000
NODE_71666_length_411_cov_43.144231	102	183	0	43	81	0.5308642
NODE_71666_length_411_cov_43.144231	102	183	4	28	81	0.3456790
NODE_71666_length_411_cov_43.144231	102	183	8	10	81	0.1234568
NODE_71666_length_411_cov_43.144231	156	236	0	5	80	0.0625000
NODE_71666_length_411_cov_43.144231	156	236	4	28	80	0.3500000
NODE_71666_length_411_cov_43.144231	156	236	8	47	80	0.5875000
NODE_71666_length_411_cov_43.144231	232	312	0	80	80	1.0000000
NODE_71666_length_411_cov_43.144231	285	365	0	80	80	1.0000000
NODE_71672_length_411_cov_8.471154	133	213	0	80	80	1.0000000
NODE_71672_length_411_cov_8.471154	186	266	0	80	80	1.0000000
NODE_71673_length_411_cov_8.407051	133	220	2	36	87	0.4137931
NODE_71673_length_411_cov_8.407051	133	220	4	51	87	0.5862069
NODE_71675_length_411_cov_6.455128	249	316	0	67	67	1.0000000
NODE_71675_length_411_cov_6.455128	292	344	0	52	52	1.0000000
NODE_71687_length_411_cov_4.782051	98	178	0	62	80	0.7750000
NODE_71687_length_411_cov_4.782051	98	178	2	18	80	0.2250000
NODE_71687_length_411_cov_4.782051	151	228	0	60	77	0.7792208
NODE_71687_length_411_cov_4.782051	151	228	2	17	77	0.2207792
NODE_71705_length_411_cov_3.698718	282	347	0	65	65	1.0000000
NODE_71713_length_411_cov_3.378205	88	148	6	1	60	0.0166667
NODE_71713_length_411_cov_3.378205	88	148	8	6	60	0.1000000
NODE_71713_length_411_cov_3.378205	88	148	10	6	60	0.1000000
NODE_71713_length_411_cov_3.378205	88	148	12	47	60	0.7833334
NODE_71714_length_411_cov_3.371795	145	225	0	23	80	0.2875000
NODE_71714_length_411_cov_3.371795	145	225	2	57	80	0.7125000
NODE_71714_length_411_cov_3.371795	198	274	2	67	76	0.8815789
NODE_71714_length_411_cov_3.371795	198	274	4	9	76	0.1184211
NODE_72163_length_410_cov_49.331190	320	400	0	80	80	1.0000000
NODE_72163_length_410_cov_49.331190	320	400	0	80	80	1.0000000
NODE_72163_length_410_cov_49.331190	320	400	0	80	80	1.0000000
NODE_72163_length_410_cov_49.331190	320	400	0	80	80	1.0000000
NODE_72163_length_410_cov_49.331190	320	400	0	80	80	1.0000000
NODE_72163_length_410_cov_49.331190	329	400	0	71	71	1.0000000
NODE_72169_length_410_cov_6.797428	179	259	6	6	80	0.0750000
NODE_72169_length_410_cov_6.797428	179	259	9	45	80	0.5625000
NODE_72169_length_410_cov_6.797428	179	259	10	14	80	0.1750000
NODE_72169_length_410_cov_6.797428	179	259	11	15	80	0.1875000
NODE_72169_length_410_cov_6.797428	232	312	0	33	80	0.4125000
NODE_72169_length_410_cov_6.797428	232	312	4	14	80	0.1750000
NODE_72169_length_410_cov_6.797428	232	312	6	12	80	0.1500000
NODE_72169_length_410_cov_6.797428	232	312	9	21	80	0.2625000
NODE_72184_length_410_cov_5.102894	153	222	0	1	69	0.0144928
NODE_72184_length_410_cov_5.102894	153	222	2	27	69	0.3913043
NODE_72184_length_410_cov_5.102894	153	222	4	41	69	0.5942029
NODE_72186_length_410_cov_4.884244	101	179	2	78	78	1.0000000
NODE_72187_length_410_cov_4.787781	287	344	2	57	57	1.0000000
NODE_72187_length_410_cov_4.787781	340	397	0	43	57	0.7543859
NODE_72187_length_410_cov_4.787781	340	397	2	14	57	0.2456140
NODE_72194_length_410_cov_4.591640	245	303	25	4	58	0.0689655
NODE_72194_length_410_cov_4.591640	245	303	27	2	58	0.0344828
NODE_72194_length_410_cov_4.591640	245	303	29	2	58	0.0344828
NODE_72194_length_410_cov_4.591640	245	303	33	1	58	0.0172414
NODE_72194_length_410_cov_4.591640	245	303	34	5	58	0.0862069
NODE_72194_length_410_cov_4.591640	245	303	35	1	58	0.0172414
NODE_72194_length_410_cov_4.591640	245	303	37	1	58	0.0172414
NODE_72194_length_410_cov_4.591640	245	303	42	2	58	0.0344828
NODE_72194_length_410_cov_4.591640	245	303	44	4	58	0.0689655
NODE_72194_length_410_cov_4.591640	245	303	45	6	58	0.1034483
NODE_72194_length_410_cov_4.591640	245	303	46	3	58	0.0517241
NODE_72194_length_410_cov_4.591640	245	303	48	2	58	0.0344828
NODE_72194_length_410_cov_4.591640	245	303	50	4	58	0.0689655
NODE_72194_length_410_cov_4.591640	245	303	52	8	58	0.1379310
NODE_72194_length_410_cov_4.591640	245	303	54	12	58	0.2068966
NODE_72194_length_410_cov_4.591640	245	303	56	1	58	0.0172414
NODE_72194_length_410_cov_4.591640	298	356	36	3	58	0.0517241
NODE_72194_length_410_cov_4.591640	298	356	38	2	58	0.0344828
NODE_72194_length_410_cov_4.591640	298	356	44	8	58	0.1379310
NODE_72194_length_410_cov_4.591640	298	356	46	6	58	0.1034483
NODE_72194_length_410_cov_4.591640	298	356	48	1	58	0.0172414
NODE_72194_length_410_cov_4.591640	298	356	52	11	58	0.1896552
NODE_72194_length_410_cov_4.591640	298	356	54	26	58	0.4482759
NODE_72194_length_410_cov_4.591640	298	356	56	1	58	0.0172414
NODE_72230_length_410_cov_3.215434	32	112	0	80	80	1.0000000
NODE_72230_length_410_cov_3.215434	85	165	0	80	80	1.0000000
NODE_72327_length_410_cov_1.913183	227	285	0	6	58	0.1034483
NODE_72327_length_410_cov_1.913183	227	285	2	52	58	0.8965517
NODE_72526_length_410_cov_1.038585	272	316	0	44	44	1.0000000
NODE_72688_length_409_cov_11.506452	56	136	0	21	80	0.2625000
NODE_72688_length_409_cov_11.506452	56	136	4	59	80	0.7375000
NODE_72688_length_409_cov_11.506452	109	189	0	23	80	0.2875000
NODE_72688_length_409_cov_11.506452	109	189	4	57	80	0.7125000
NODE_72689_length_409_cov_10.329032	131	186	0	55	55	1.0000000
NODE_72690_length_409_cov_9.625806	62	142	0	66	80	0.8250000
NODE_72690_length_409_cov_9.625806	62	142	2	14	80	0.1750000
NODE_72690_length_409_cov_9.625806	115	195	0	13	80	0.1625000
NODE_72690_length_409_cov_9.625806	115	195	2	67	80	0.8375000
NODE_72697_length_409_cov_6.867742	41	71	0	30	30	1.0000000
NODE_72730_length_409_cov_3.822581	103	158	0	5	55	0.0909091
NODE_72730_length_409_cov_3.822581	103	158	4	50	55	0.9090909
NODE_72730_length_409_cov_3.822581	151	232	0	15	81	0.1851852
NODE_72730_length_409_cov_3.822581	151	232	2	10	81	0.1234568
NODE_72730_length_409_cov_3.822581	151	232	4	56	81	0.6913580
NODE_72754_length_409_cov_2.987097	240	287	0	47	47	1.0000000
NODE_72951_length_409_cov_1.319355	49	131	0	4	82	0.0487805
NODE_72951_length_409_cov_1.319355	49	131	2	16	82	0.1951219
NODE_72951_length_409_cov_1.319355	49	131	4	62	82	0.7560976
NODE_72951_length_409_cov_1.319355	104	161	0	34	57	0.5964912
NODE_72951_length_409_cov_1.319355	104	161	2	6	57	0.1052632
NODE_72951_length_409_cov_1.319355	104	161	4	17	57	0.2982456
NODE_73196_length_408_cov_8.585761	57	137	2	25	80	0.3125000
NODE_73196_length_408_cov_8.585761	57	137	4	55	80	0.6875000
NODE_73196_length_408_cov_8.585761	110	190	4	28	80	0.3500000
NODE_73196_length_408_cov_8.585761	110	190	6	4	80	0.0500000
NODE_73196_length_408_cov_8.585761	110	190	8	48	80	0.6000000
NODE_73198_length_408_cov_6.948220	71	151	0	80	80	1.0000000
NODE_73198_length_408_cov_6.948220	124	204	0	80	80	1.0000000
NODE_73219_length_408_cov_3.957929	83	132	4	11	49	0.2244898
NODE_73219_length_408_cov_3.957929	83	132	6	38	49	0.7755102
NODE_73226_length_408_cov_3.511327	40	97	0	57	57	1.0000000
NODE_73226_length_408_cov_3.511327	357	398	0	41	41	1.0000000
NODE_73262_length_408_cov_2.724919	128	180	4	52	52	1.0000000
NODE_73269_length_408_cov_2.563107	164	241	0	71	77	0.9220779
NODE_73269_length_408_cov_2.563107	164	241	6	1	77	0.0129870
NODE_73269_length_408_cov_2.563107	164	241	10	1	77	0.0129870
NODE_73269_length_408_cov_2.563107	164	241	14	4	77	0.0519481
NODE_73271_length_408_cov_2.456311	314	379	0	64	65	0.9846154
NODE_73271_length_408_cov_2.456311	314	379	2	1	65	0.0153846
NODE_73271_length_408_cov_2.456311	352	408	0	56	56	1.0000000
NODE_73690_length_407_cov_6.191558	144	208	2	64	64	1.0000000
NODE_73698_length_407_cov_4.961039	212	291	0	30	79	0.3797468
NODE_73698_length_407_cov_4.961039	212	291	2	49	79	0.6202531
NODE_73719_length_407_cov_3.681818	314	375	0	61	61	1.0000000
NODE_73732_length_407_cov_3.344156	199	247	0	39	48	0.8125000
NODE_73732_length_407_cov_3.344156	199	247	3	1	48	0.0208333
NODE_73732_length_407_cov_3.344156	199	247	4	8	48	0.1666667
NODE_73736_length_407_cov_3.250000	142	223	0	3	81	0.0370370
NODE_73736_length_407_cov_3.250000	142	223	4	74	81	0.9135802
NODE_73736_length_407_cov_3.250000	142	223	6	4	81	0.0493827
NODE_73762_length_407_cov_2.594156	194	257	0	31	63	0.4920635
NODE_73762_length_407_cov_2.594156	194	257	2	8	63	0.1269841
NODE_73762_length_407_cov_2.594156	194	257	4	24	63	0.3809524
NODE_73769_length_407_cov_2.538961	34	114	0	80	80	1.0000000
NODE_73853_length_407_cov_1.737013	208	264	0	44	56	0.7857143
NODE_73853_length_407_cov_1.737013	208	264	2	12	56	0.2142857
NODE_74200_length_406_cov_176.856678	200	271	111	2	71	0.0281690
NODE_74200_length_406_cov_176.856678	200	271	112	3	71	0.0422535
NODE_74200_length_406_cov_176.856678	200	271	113	7	71	0.0985916
NODE_74200_length_406_cov_176.856678	200	271	115	1	71	0.0140845
NODE_74200_length_406_cov_176.856678	200	271	116	1	71	0.0140845
NODE_74200_length_406_cov_176.856678	200	271	117	5	71	0.0704225
NODE_74200_length_406_cov_176.856678	200	271	118	4	71	0.0563380
NODE_74200_length_406_cov_176.856678	200	271	119	2	71	0.0281690
NODE_74200_length_406_cov_176.856678	200	271	120	6	71	0.0845070
NODE_74200_length_406_cov_176.856678	200	271	121	7	71	0.0985916
NODE_74200_length_406_cov_176.856678	200	271	122	1	71	0.0140845
NODE_74200_length_406_cov_176.856678	200	271	123	3	71	0.0422535
NODE_74200_length_406_cov_176.856678	200	271	124	5	71	0.0704225
NODE_74200_length_406_cov_176.856678	200	271	125	1	71	0.0140845
NODE_74200_length_406_cov_176.856678	200	271	126	7	71	0.0985916
NODE_74200_length_406_cov_176.856678	200	271	127	1	71	0.0140845
NODE_74200_length_406_cov_176.856678	200	271	128	8	71	0.1126761
NODE_74200_length_406_cov_176.856678	200	271	130	5	71	0.0704225
NODE_74200_length_406_cov_176.856678	200	271	132	1	71	0.0140845
NODE_74200_length_406_cov_176.856678	200	271	133	1	71	0.0140845
NODE_74200_length_406_cov_176.856678	244	321	103	2	77	0.0259740
NODE_74200_length_406_cov_176.856678	244	321	104	1	77	0.0129870
NODE_74200_length_406_cov_176.856678	244	321	105	2	77	0.0259740
NODE_74200_length_406_cov_176.856678	244	321	107	2	77	0.0259740
NODE_74200_length_406_cov_176.856678	244	321	108	5	77	0.0649351
NODE_74200_length_406_cov_176.856678	244	321	110	1	77	0.0129870
NODE_74200_length_406_cov_176.856678	244	321	112	3	77	0.0389610
NODE_74200_length_406_cov_176.856678	244	321	113	1	77	0.0129870
NODE_74200_length_406_cov_176.856678	244	321	117	2	77	0.0259740
NODE_74200_length_406_cov_176.856678	244	321	118	4	77	0.0519481
NODE_74200_length_406_cov_176.856678	244	321	119	8	77	0.1038961
NODE_74200_length_406_cov_176.856678	244	321	120	2	77	0.0259740
NODE_74200_length_406_cov_176.856678	244	321	121	16	77	0.2077922
NODE_74200_length_406_cov_176.856678	244	321	122	8	77	0.1038961
NODE_74200_length_406_cov_176.856678	244	321	123	2	77	0.0259740
NODE_74200_length_406_cov_176.856678	244	321	124	7	77	0.0909091
NODE_74200_length_406_cov_176.856678	244	321	126	1	77	0.0129870
NODE_74200_length_406_cov_176.856678	244	321	128	6	77	0.0779221
NODE_74200_length_406_cov_176.856678	244	321	130	2	77	0.0259740
NODE_74200_length_406_cov_176.856678	244	321	132	1	77	0.0129870
NODE_74200_length_406_cov_176.856678	244	321	133	1	77	0.0129870
NODE_74203_length_406_cov_37.723127	15	95	0	22	80	0.2750000
NODE_74203_length_406_cov_37.723127	15	95	4	53	80	0.6625000
NODE_74203_length_406_cov_37.723127	15	95	6	2	80	0.0250000
NODE_74203_length_406_cov_37.723127	15	95	8	2	80	0.0250000
NODE_74203_length_406_cov_37.723127	15	95	18	1	80	0.0125000
NODE_74219_length_406_cov_4.960912	268	327	2	59	59	1.0000000
NODE_74253_length_406_cov_3.087948	261	302	2	41	41	1.0000000
NODE_74284_length_406_cov_2.475570	220	270	0	50	50	1.0000000
NODE_74332_length_406_cov_1.986971	238	276	2	4	38	0.1052632
NODE_74332_length_406_cov_1.986971	238	276	4	34	38	0.8947368
NODE_74368_length_406_cov_1.778502	159	195	4	6	36	0.1666667
NODE_74368_length_406_cov_1.778502	159	195	6	30	36	0.8333333
NODE_74368_length_406_cov_1.778502	234	294	6	48	60	0.8000000
NODE_74368_length_406_cov_1.778502	234	294	8	3	60	0.0500000
NODE_74368_length_406_cov_1.778502	234	294	10	9	60	0.1500000
NODE_74368_length_406_cov_1.778502	267	347	2	29	80	0.3625000
NODE_74368_length_406_cov_1.778502	267	347	4	11	80	0.1375000
NODE_74368_length_406_cov_1.778502	267	347	6	40	80	0.5000000
NODE_74427_length_406_cov_1.495114	173	212	0	39	39	1.0000000
NODE_74476_length_406_cov_1.325733	367	398	0	31	31	1.0000000
NODE_74588_length_406_cov_0.934853	1	32	0	5	31	0.1612903
NODE_74588_length_406_cov_0.934853	1	32	2	19	31	0.6129032
NODE_74588_length_406_cov_0.934853	1	32	4	7	31	0.2258064
NODE_74588_length_406_cov_0.934853	5	85	0	1	80	0.0125000
NODE_74588_length_406_cov_0.934853	5	85	2	19	80	0.2375000
NODE_74588_length_406_cov_0.934853	5	85	4	60	80	0.7500000
NODE_74696_length_405_cov_5.107843	332	380	0	48	48	1.0000000
NODE_74697_length_405_cov_4.915033	15	46	2	31	31	1.0000000
NODE_74727_length_405_cov_3.346405	195	240	2	7	45	0.1555556
NODE_74727_length_405_cov_3.346405	195	240	4	6	45	0.1333333
NODE_74727_length_405_cov_3.346405	195	240	6	2	45	0.0444444
NODE_74727_length_405_cov_3.346405	195	240	8	30	45	0.6666667
NODE_74727_length_405_cov_3.346405	274	329	0	28	55	0.5090909
NODE_74727_length_405_cov_3.346405	274	329	2	27	55	0.4909091
NODE_74737_length_405_cov_3.124183	210	260	0	50	50	1.0000000
NODE_74737_length_405_cov_3.124183	240	286	0	46	46	1.0000000
NODE_74737_length_405_cov_3.124183	260	339	0	79	79	1.0000000
NODE_74737_length_405_cov_3.124183	272	339	0	67	67	1.0000000
NODE_74780_length_405_cov_2.503268	352	399	0	33	47	0.7021276
NODE_74780_length_405_cov_2.503268	352	399	2	14	47	0.2978723
NODE_74787_length_405_cov_2.460784	0	73	0	73	73	1.0000000
NODE_75145_length_405_cov_0.666667	207	268	0	61	61	1.0000000
NODE_75196_length_404_cov_40.937705	40	120	0	80	80	1.0000000
NODE_75196_length_404_cov_40.937705	93	173	0	80	80	1.0000000
NODE_75197_length_404_cov_32.940984	46	126	0	50	80	0.6250000
NODE_75197_length_404_cov_32.940984	46	126	3	20	80	0.2500000
NODE_75197_length_404_cov_32.940984	46	126	6	10	80	0.1250000
NODE_75197_length_404_cov_32.940984	99	179	3	17	80	0.2125000
NODE_75197_length_404_cov_32.940984	99	179	6	63	80	0.7875000
NODE_75197_length_404_cov_32.940984	175	255	5	9	80	0.1125000
NODE_75197_length_404_cov_32.940984	175	255	6	36	80	0.4500000
NODE_75197_length_404_cov_32.940984	175	255	7	1	80	0.0125000
NODE_75197_length_404_cov_32.940984	175	255	8	34	80	0.4250000
NODE_75197_length_404_cov_32.940984	228	308	2	42	80	0.5250000
NODE_75197_length_404_cov_32.940984	228	308	5	20	80	0.2500000
NODE_75197_length_404_cov_32.940984	228	308	7	1	80	0.0125000
NODE_75197_length_404_cov_32.940984	228	308	8	17	80	0.2125000
NODE_75198_length_404_cov_11.731148	130	210	0	9	80	0.1125000
NODE_75198_length_404_cov_11.731148	130	210	2	71	80	0.8875000
NODE_75198_length_404_cov_11.731148	183	263	0	4	80	0.0500000
NODE_75198_length_404_cov_11.731148	183	263	2	76	80	0.9500000
NODE_75200_length_404_cov_9.170492	201	257	0	56	56	1.0000000
NODE_75236_length_404_cov_3.613115	323	385	0	62	62	1.0000000
NODE_75259_length_404_cov_2.914754	181	261	0	80	80	1.0000000
NODE_75345_length_404_cov_2.085246	245	325	0	80	80	1.0000000
NODE_75357_length_404_cov_1.993443	95	148	0	53	53	1.0000000
NODE_75399_length_404_cov_1.672131	32	106	0	74	74	1.0000000
NODE_75440_length_404_cov_1.498361	94	174	2	43	80	0.5375000
NODE_75440_length_404_cov_1.498361	94	174	4	27	80	0.3375000
NODE_75440_length_404_cov_1.498361	94	174	6	10	80	0.1250000
NODE_75446_length_404_cov_1.485246	234	282	10	48	48	1.0000000
NODE_75545_length_404_cov_1.121311	114	194	0	9	80	0.1125000
NODE_75545_length_404_cov_1.121311	114	194	2	6	80	0.0750000
NODE_75545_length_404_cov_1.121311	114	194	4	5	80	0.0625000
NODE_75545_length_404_cov_1.121311	114	194	6	2	80	0.0250000
NODE_75545_length_404_cov_1.121311	114	194	8	58	80	0.7250000
NODE_75750_length_403_cov_7.325658	80	146	0	66	66	1.0000000
NODE_75750_length_403_cov_7.325658	165	234	0	69	69	1.0000000
NODE_75750_length_403_cov_7.325658	215	255	0	40	40	1.0000000
NODE_75751_length_403_cov_7.217105	207	284	0	77	77	1.0000000
NODE_75751_length_403_cov_7.217105	257	334	0	77	77	1.0000000
NODE_75752_length_403_cov_6.776316	192	250	0	58	58	1.0000000
NODE_75788_length_403_cov_3.710526	327	373	0	46	46	1.0000000
NODE_75788_length_403_cov_3.710526	346	403	0	57	57	1.0000000
NODE_75793_length_403_cov_3.611842	283	363	8	11	80	0.1375000
NODE_75793_length_403_cov_3.611842	283	363	9	2	80	0.0250000
NODE_75793_length_403_cov_3.611842	283	363	10	1	80	0.0125000
NODE_75793_length_403_cov_3.611842	283	363	13	2	80	0.0250000
NODE_75793_length_403_cov_3.611842	283	363	15	17	80	0.2125000
NODE_75793_length_403_cov_3.611842	283	363	17	23	80	0.2875000
NODE_75793_length_403_cov_3.611842	283	363	19	24	80	0.3000000
NODE_75824_length_403_cov_2.822368	201	282	4	3	81	0.0370370
NODE_75824_length_403_cov_2.822368	201	282	6	2	81	0.0246914
NODE_75824_length_403_cov_2.822368	201	282	8	28	81	0.3456790
NODE_75824_length_403_cov_2.822368	201	282	10	39	81	0.4814815
NODE_75824_length_403_cov_2.822368	201	282	12	9	81	0.1111111
NODE_75871_length_403_cov_2.082237	102	145	0	43	43	1.0000000
NODE_75908_length_403_cov_1.871711	130	166	0	36	36	1.0000000
NODE_75993_length_403_cov_1.398026	79	116	0	37	37	1.0000000
NODE_76029_length_403_cov_1.269737	82	111	0	29	29	1.0000000
NODE_76239_length_402_cov_6.293729	217	297	2	26	80	0.3250000
NODE_76239_length_402_cov_6.293729	217	297	4	54	80	0.6750000
NODE_76239_length_402_cov_6.293729	270	350	2	44	80	0.5500000
NODE_76239_length_402_cov_6.293729	270	350	4	36	80	0.4500000
NODE_76246_length_402_cov_5.227723	176	236	6	7	60	0.1166667
NODE_76246_length_402_cov_5.227723	176	236	10	53	60	0.8833333
NODE_76261_length_402_cov_4.356436	44	123	0	79	79	1.0000000
NODE_76261_length_402_cov_4.356436	119	199	0	27	80	0.3375000
NODE_76261_length_402_cov_4.356436	119	199	2	53	80	0.6625000
NODE_76261_length_402_cov_4.356436	172	252	2	80	80	1.0000000
NODE_76276_length_402_cov_3.564356	197	257	0	23	60	0.3833333
NODE_76276_length_402_cov_3.564356	197	257	2	37	60	0.6166667
NODE_76276_length_402_cov_3.564356	230	310	2	55	80	0.6875000
NODE_76276_length_402_cov_3.564356	230	310	4	25	80	0.3125000
NODE_76328_length_402_cov_2.633663	335	402	0	67	67	1.0000000
NODE_76336_length_402_cov_2.514851	82	162	6	18	80	0.2250000
NODE_76336_length_402_cov_2.514851	82	162	8	8	80	0.1000000
NODE_76336_length_402_cov_2.514851	82	162	10	3	80	0.0375000
NODE_76336_length_402_cov_2.514851	82	162	14	1	80	0.0125000
NODE_76336_length_402_cov_2.514851	82	162	16	6	80	0.0750000
NODE_76336_length_402_cov_2.514851	82	162	18	3	80	0.0375000
NODE_76336_length_402_cov_2.514851	82	162	20	8	80	0.1000000
NODE_76336_length_402_cov_2.514851	82	162	22	17	80	0.2125000
NODE_76336_length_402_cov_2.514851	82	162	24	9	80	0.1125000
NODE_76336_length_402_cov_2.514851	82	162	26	7	80	0.0875000
NODE_76336_length_402_cov_2.514851	135	200	2	32	65	0.4923077
NODE_76336_length_402_cov_2.514851	135	200	4	5	65	0.0769231
NODE_76336_length_402_cov_2.514851	135	200	6	19	65	0.2923077
NODE_76336_length_402_cov_2.514851	135	200	8	8	65	0.1230769
NODE_76336_length_402_cov_2.514851	135	200	10	1	65	0.0153846
NODE_76380_length_402_cov_2.102310	114	165	0	48	51	0.9411765
NODE_76380_length_402_cov_2.102310	114	165	2	3	51	0.0588235
NODE_76380_length_402_cov_2.102310	138	195	0	57	57	1.0000000
NODE_76560_length_402_cov_1.214521	0	33	0	33	33	1.0000000
NODE_76646_length_402_cov_1.000000	119	188	0	58	69	0.8405797
NODE_76646_length_402_cov_1.000000	119	188	2	11	69	0.1594203
NODE_76752_length_402_cov_0.663366	0	46	0	46	46	1.0000000
NODE_76780_length_401_cov_43.675497	285	343	0	58	58	1.0000000
NODE_76801_length_401_cov_4.377483	309	389	0	80	80	1.0000000
NODE_76804_length_401_cov_4.241722	125	180	0	7	55	0.1272727
NODE_76804_length_401_cov_4.241722	125	180	4	48	55	0.8727273
NODE_76808_length_401_cov_4.132450	195	275	0	80	80	1.0000000
NODE_76811_length_401_cov_3.973510	138	181	0	43	43	1.0000000
NODE_76828_length_401_cov_3.370861	141	221	0	80	80	1.0000000
NODE_76828_length_401_cov_3.370861	194	273	0	79	79	1.0000000
NODE_76830_length_401_cov_3.317881	67	147	0	80	80	1.0000000
NODE_76918_length_401_cov_1.937086	160	239	0	17	79	0.2151899
NODE_76918_length_401_cov_1.937086	160	239	2	55	79	0.6962025
NODE_76918_length_401_cov_1.937086	160	239	4	7	79	0.0886076
NODE_76978_length_401_cov_1.615894	205	269	2	6	64	0.0937500
NODE_76978_length_401_cov_1.615894	205	269	4	6	64	0.0937500
NODE_76978_length_401_cov_1.615894	205	269	5	2	64	0.0312500
NODE_76978_length_401_cov_1.615894	205	269	7	1	64	0.0156250
NODE_76978_length_401_cov_1.615894	205	269	9	4	64	0.0625000
NODE_76978_length_401_cov_1.615894	205	269	11	1	64	0.0156250
NODE_76978_length_401_cov_1.615894	205	269	16	1	64	0.0156250
NODE_76978_length_401_cov_1.615894	205	269	22	1	64	0.0156250
NODE_76978_length_401_cov_1.615894	205	269	26	2	64	0.0312500
NODE_76978_length_401_cov_1.615894	205	269	27	1	64	0.0156250
NODE_76978_length_401_cov_1.615894	205	269	29	3	64	0.0468750
NODE_76978_length_401_cov_1.615894	205	269	31	1	64	0.0156250
NODE_76978_length_401_cov_1.615894	205	269	33	1	64	0.0156250
NODE_76978_length_401_cov_1.615894	205	269	35	1	64	0.0156250
NODE_76978_length_401_cov_1.615894	205	269	39	1	64	0.0156250
NODE_76978_length_401_cov_1.615894	205	269	45	2	64	0.0312500
NODE_76978_length_401_cov_1.615894	205	269	47	1	64	0.0156250
NODE_76978_length_401_cov_1.615894	205	269	50	1	64	0.0156250
NODE_76978_length_401_cov_1.615894	205	269	52	4	64	0.0625000
NODE_76978_length_401_cov_1.615894	205	269	54	1	64	0.0156250
NODE_76978_length_401_cov_1.615894	205	269	58	5	64	0.0781250
NODE_76978_length_401_cov_1.615894	205	269	62	4	64	0.0625000
NODE_76978_length_401_cov_1.615894	205	269	64	2	64	0.0312500
NODE_76978_length_401_cov_1.615894	205	269	66	1	64	0.0156250
NODE_76978_length_401_cov_1.615894	205	269	68	1	64	0.0156250
NODE_76978_length_401_cov_1.615894	205	269	72	2	64	0.0312500
NODE_76978_length_401_cov_1.615894	205	269	78	3	64	0.0468750
NODE_76978_length_401_cov_1.615894	205	269	80	1	64	0.0156250
NODE_76978_length_401_cov_1.615894	205	269	82	1	64	0.0156250
NODE_76978_length_401_cov_1.615894	205	269	84	2	64	0.0312500
NODE_76978_length_401_cov_1.615894	205	269	86	1	64	0.0156250
NODE_77017_length_401_cov_1.407285	23	92	0	69	69	1.0000000
NODE_77017_length_401_cov_1.407285	76	122	0	46	46	1.0000000
NODE_77236_length_401_cov_0.675497	292	372	0	24	80	0.3000000
NODE_77236_length_401_cov_0.675497	292	372	2	56	80	0.7000000
NODE_77236_length_401_cov_0.675497	345	401	0	53	56	0.9464286
NODE_77236_length_401_cov_0.675497	345	401	2	3	56	0.0535714
NODE_77284_length_400_cov_40.584718	205	281	0	7	76	0.0921053
NODE_77284_length_400_cov_40.584718	205	281	2	69	76	0.9078947
NODE_77284_length_400_cov_40.584718	254	334	0	60	80	0.7500000
NODE_77284_length_400_cov_40.584718	254	334	2	20	80	0.2500000
NODE_77289_length_400_cov_8.631229	307	372	0	65	65	1.0000000
NODE_77292_length_400_cov_6.850498	281	329	0	3	48	0.0625000
NODE_77292_length_400_cov_6.850498	281	329	2	45	48	0.9375000
NODE_77322_length_400_cov_4.000000	82	140	2	20	58	0.3448276
NODE_77322_length_400_cov_4.000000	82	140	3	10	58	0.1724138
NODE_77322_length_400_cov_4.000000	82	140	4	23	58	0.3965517
NODE_77322_length_400_cov_4.000000	82	140	5	5	58	0.0862069
NODE_77358_length_400_cov_3.029900	204	284	0	80	80	1.0000000
NODE_77358_length_400_cov_3.029900	205	231	0	26	26	1.0000000
NODE_77362_length_400_cov_3.009967	146	220	6	4	74	0.0540541
NODE_77362_length_400_cov_3.009967	146	220	8	1	74	0.0135135
NODE_77362_length_400_cov_3.009967	146	220	10	12	74	0.1621622
NODE_77362_length_400_cov_3.009967	146	220	12	37	74	0.5000000
NODE_77362_length_400_cov_3.009967	146	220	14	20	74	0.2702703
NODE_77362_length_400_cov_3.009967	195	261	4	2	66	0.0303030
NODE_77362_length_400_cov_3.009967	195	261	6	2	66	0.0303030
NODE_77362_length_400_cov_3.009967	195	261	8	5	66	0.0757576
NODE_77362_length_400_cov_3.009967	195	261	10	23	66	0.3484848
NODE_77362_length_400_cov_3.009967	195	261	12	21	66	0.3181818
NODE_77362_length_400_cov_3.009967	195	261	14	13	66	0.1969697
NODE_77363_length_400_cov_2.990033	253	332	26	8	79	0.1012658
NODE_77363_length_400_cov_2.990033	253	332	27	1	79	0.0126582
NODE_77363_length_400_cov_2.990033	253	332	28	8	79	0.1012658
NODE_77363_length_400_cov_2.990033	253	332	29	1	79	0.0126582
NODE_77363_length_400_cov_2.990033	253	332	30	13	79	0.1645570
NODE_77363_length_400_cov_2.990033	253	332	31	1	79	0.0126582
NODE_77363_length_400_cov_2.990033	253	332	32	9	79	0.1139240
NODE_77363_length_400_cov_2.990033	253	332	34	7	79	0.0886076
NODE_77363_length_400_cov_2.990033	253	332	36	8	79	0.1012658
NODE_77363_length_400_cov_2.990033	253	332	38	13	79	0.1645570
NODE_77363_length_400_cov_2.990033	253	332	42	10	79	0.1265823
NODE_77363_length_400_cov_2.990033	306	385	14	43	79	0.5443038
NODE_77363_length_400_cov_2.990033	306	385	16	8	79	0.1012658
NODE_77363_length_400_cov_2.990033	306	385	22	2	79	0.0253165
NODE_77363_length_400_cov_2.990033	306	385	26	8	79	0.1012658
NODE_77363_length_400_cov_2.990033	306	385	27	1	79	0.0126582
NODE_77363_length_400_cov_2.990033	306	385	28	8	79	0.1012658
NODE_77363_length_400_cov_2.990033	306	385	29	1	79	0.0126582
NODE_77363_length_400_cov_2.990033	306	385	30	5	79	0.0632911
NODE_77363_length_400_cov_2.990033	306	385	31	1	79	0.0126582
NODE_77363_length_400_cov_2.990033	306	385	32	2	79	0.0253165
NODE_77368_length_400_cov_2.860465	365	400	0	35	35	1.0000000
NODE_77371_length_400_cov_2.797342	324	372	0	48	48	1.0000000
NODE_77380_length_400_cov_2.581395	192	254	0	62	62	1.0000000
NODE_77460_length_400_cov_1.940199	225	268	0	43	43	1.0000000
NODE_77460_length_400_cov_1.940199	293	374	0	2	81	0.0246914
NODE_77460_length_400_cov_1.940199	293	374	2	79	81	0.9753087
NODE_77821_length_399_cov_71.493333	215	295	0	80	80	1.0000000
NODE_77821_length_399_cov_71.493333	268	348	0	80	80	1.0000000
NODE_77823_length_399_cov_7.510000	229	309	0	80	80	1.0000000
NODE_77823_length_399_cov_7.510000	282	362	0	80	80	1.0000000
NODE_77825_length_399_cov_7.310000	125	187	4	62	62	1.0000000
NODE_77854_length_399_cov_4.293333	86	164	2	8	78	0.1025641
NODE_77854_length_399_cov_4.293333	86	164	3	3	78	0.0384615
NODE_77854_length_399_cov_4.293333	86	164	5	1	78	0.0128205
NODE_77854_length_399_cov_4.293333	86	164	10	3	78	0.0384615
NODE_77854_length_399_cov_4.293333	86	164	12	3	78	0.0384615
NODE_77854_length_399_cov_4.293333	86	164	14	7	78	0.0897436
NODE_77854_length_399_cov_4.293333	86	164	16	1	78	0.0128205
NODE_77854_length_399_cov_4.293333	86	164	18	11	78	0.1410256
NODE_77854_length_399_cov_4.293333	86	164	20	6	78	0.0769231
NODE_77854_length_399_cov_4.293333	86	164	22	35	78	0.4487180
NODE_77877_length_399_cov_3.406667	51	124	0	28	73	0.3835616
NODE_77877_length_399_cov_3.406667	51	124	2	45	73	0.6164383
NODE_77933_length_399_cov_2.286667	310	390	6	17	80	0.2125000
NODE_77933_length_399_cov_2.286667	310	390	8	63	80	0.7875000
NODE_77966_length_399_cov_1.916667	76	136	0	60	60	1.0000000
NODE_77966_length_399_cov_1.916667	123	189	0	66	66	1.0000000
NODE_78276_length_399_cov_0.710000	313	392	0	79	79	1.0000000
NODE_78354_length_398_cov_9.688963	1	81	0	80	80	1.0000000
NODE_78354_length_398_cov_9.688963	247	327	0	80	80	1.0000000
NODE_78354_length_398_cov_9.688963	300	380	0	80	80	1.0000000
NODE_78360_length_398_cov_6.488294	130	210	0	29	80	0.3625000
NODE_78360_length_398_cov_6.488294	130	210	6	51	80	0.6375000
NODE_78364_length_398_cov_5.765886	253	333	0	11	80	0.1375000
NODE_78364_length_398_cov_5.765886	253	333	2	69	80	0.8625000
NODE_78372_length_398_cov_5.244147	248	312	0	22	64	0.3437500
NODE_78372_length_398_cov_5.244147	248	312	2	42	64	0.6562500
NODE_78376_length_398_cov_5.006689	116	196	0	80	80	1.0000000
NODE_78376_length_398_cov_5.006689	169	251	0	82	82	1.0000000
NODE_78383_length_398_cov_4.284281	63	117	0	54	54	1.0000000
NODE_78383_length_398_cov_4.284281	135	160	0	25	25	1.0000000
NODE_78420_length_398_cov_2.993311	229	309	0	18	80	0.2250000
NODE_78420_length_398_cov_2.993311	229	309	2	62	80	0.7750000
NODE_78429_length_398_cov_2.822742	236	271	0	35	35	1.0000000
NODE_78891_length_397_cov_52.855705	124	204	0	41	80	0.5125000
NODE_78891_length_397_cov_52.855705	124	204	2	39	80	0.4875000
NODE_78891_length_397_cov_52.855705	177	257	2	75	80	0.9375000
NODE_78891_length_397_cov_52.855705	177	257	4	5	80	0.0625000
NODE_78894_length_397_cov_35.036913	173	253	0	12	80	0.1500000
NODE_78894_length_397_cov_35.036913	173	253	2	4	80	0.0500000
NODE_78894_length_397_cov_35.036913	173	253	4	9	80	0.1125000
NODE_78894_length_397_cov_35.036913	173	253	6	16	80	0.2000000
NODE_78894_length_397_cov_35.036913	173	253	8	39	80	0.4875000
NODE_78895_length_397_cov_13.667785	94	174	0	80	80	1.0000000
NODE_78895_length_397_cov_13.667785	147	227	0	80	80	1.0000000
NODE_78897_length_397_cov_7.496644	192	272	0	80	80	1.0000000
NODE_78897_length_397_cov_7.496644	245	325	0	80	80	1.0000000
NODE_78898_length_397_cov_6.828859	127	173	0	46	46	1.0000000
NODE_78913_length_397_cov_4.902685	293	364	0	71	71	1.0000000
NODE_78933_length_397_cov_3.765101	164	244	0	80	80	1.0000000
NODE_78951_length_397_cov_3.325503	107	187	0	80	80	1.0000000
NODE_78951_length_397_cov_3.325503	163	236	0	27	73	0.3698630
NODE_78951_length_397_cov_3.325503	163	236	2	40	73	0.5479452
NODE_78951_length_397_cov_3.325503	163	236	4	6	73	0.0821918
NODE_78999_length_397_cov_2.530201	269	312	0	43	43	1.0000000
NODE_79047_length_397_cov_1.959732	154	193	2	39	39	1.0000000
NODE_79072_length_397_cov_1.791946	218	283	0	7	65	0.1076923
NODE_79072_length_397_cov_1.791946	218	283	2	21	65	0.3230769
NODE_79072_length_397_cov_1.791946	218	283	4	3	65	0.0461538
NODE_79072_length_397_cov_1.791946	218	283	6	34	65	0.5230770
NODE_79127_length_397_cov_1.560403	183	240	0	57	57	1.0000000
NODE_79456_length_396_cov_11.632997	162	242	0	80	80	1.0000000
NODE_79456_length_396_cov_11.632997	215	295	0	80	80	1.0000000
NODE_79460_length_396_cov_7.053872	71	101	0	30	30	1.0000000
NODE_79464_length_396_cov_6.097643	229	309	0	38	80	0.4750000
NODE_79464_length_396_cov_6.097643	229	309	2	42	80	0.5250000
NODE_79464_length_396_cov_6.097643	282	362	0	80	80	1.0000000
NODE_79471_length_396_cov_5.484848	125	205	0	20	80	0.2500000
NODE_79471_length_396_cov_5.484848	125	205	2	29	80	0.3625000
NODE_79471_length_396_cov_5.484848	125	205	4	31	80	0.3875000
NODE_79471_length_396_cov_5.484848	178	259	0	3	81	0.0370370
NODE_79471_length_396_cov_5.484848	178	259	2	11	81	0.1358025
NODE_79471_length_396_cov_5.484848	178	259	4	67	81	0.8271605
NODE_79473_length_396_cov_5.434343	224	275	0	51	51	1.0000000
NODE_79473_length_396_cov_5.434343	272	331	0	59	59	1.0000000
NODE_79483_length_396_cov_4.414141	189	264	0	22	75	0.2933333
NODE_79483_length_396_cov_4.414141	189	264	2	53	75	0.7066666
NODE_79483_length_396_cov_4.414141	241	317	0	1	76	0.0131579
NODE_79483_length_396_cov_4.414141	241	317	2	75	76	0.9868421
NODE_79493_length_396_cov_4.010101	163	205	2	42	42	1.0000000
NODE_79522_length_396_cov_3.080808	95	161	0	66	66	1.0000000
NODE_79524_length_396_cov_3.067340	252	316	0	64	64	1.0000000
NODE_79535_length_396_cov_2.892256	136	217	0	5	81	0.0617284
NODE_79535_length_396_cov_2.892256	136	217	2	76	81	0.9382716
NODE_79557_length_396_cov_2.710438	88	168	12	16	80	0.2000000
NODE_79557_length_396_cov_2.710438	88	168	14	2	80	0.0250000
NODE_79557_length_396_cov_2.710438	88	168	16	12	80	0.1500000
NODE_79557_length_396_cov_2.710438	88	168	18	2	80	0.0250000
NODE_79557_length_396_cov_2.710438	88	168	20	4	80	0.0500000
NODE_79557_length_396_cov_2.710438	88	168	22	15	80	0.1875000
NODE_79557_length_396_cov_2.710438	88	168	24	1	80	0.0125000
NODE_79557_length_396_cov_2.710438	88	168	26	28	80	0.3500000
NODE_79561_length_396_cov_2.680135	297	335	0	38	38	1.0000000
NODE_79562_length_396_cov_2.659933	68	148	0	80	80	1.0000000
NODE_79562_length_396_cov_2.659933	121	168	0	47	47	1.0000000
NODE_79616_length_396_cov_2.060606	308	388	0	39	80	0.4875000
NODE_79616_length_396_cov_2.060606	308	388	2	40	80	0.5000000
NODE_79616_length_396_cov_2.060606	308	388	4	1	80	0.0125000
NODE_79643_length_396_cov_1.939394	63	142	0	14	79	0.1772152
NODE_79643_length_396_cov_1.939394	63	142	4	14	79	0.1772152
NODE_79643_length_396_cov_1.939394	63	142	6	32	79	0.4050633
NODE_79643_length_396_cov_1.939394	63	142	8	19	79	0.2405063
NODE_79643_length_396_cov_1.939394	115	164	6	8	49	0.1632653
NODE_79643_length_396_cov_1.939394	115	164	8	41	49	0.8367347
NODE_79683_length_396_cov_1.811448	82	162	0	6	80	0.0750000
NODE_79683_length_396_cov_1.811448	82	162	2	66	80	0.8250000
NODE_79683_length_396_cov_1.811448	82	162	4	8	80	0.1000000
NODE_79692_length_396_cov_1.734007	88	119	0	31	31	1.0000000
NODE_79930_length_396_cov_0.905724	101	151	2	45	50	0.9000000
NODE_79930_length_396_cov_0.905724	101	151	4	5	50	0.1000000
NODE_80057_length_395_cov_449.327703	0	79	18	1	79	0.0126582
NODE_80057_length_395_cov_449.327703	0	79	20	4	79	0.0506329
NODE_80057_length_395_cov_449.327703	0	79	22	4	79	0.0506329
NODE_80057_length_395_cov_449.327703	0	79	24	1	79	0.0126582
NODE_80057_length_395_cov_449.327703	0	79	26	2	79	0.0253165
NODE_80057_length_395_cov_449.327703	0	79	28	1	79	0.0126582
NODE_80057_length_395_cov_449.327703	0	79	32	5	79	0.0632911
NODE_80057_length_395_cov_449.327703	0	79	34	1	79	0.0126582
NODE_80057_length_395_cov_449.327703	0	79	36	2	79	0.0253165
NODE_80057_length_395_cov_449.327703	0	79	44	2	79	0.0253165
NODE_80057_length_395_cov_449.327703	0	79	46	1	79	0.0126582
NODE_80057_length_395_cov_449.327703	0	79	50	1	79	0.0126582
NODE_80057_length_395_cov_449.327703	0	79	55	2	79	0.0253165
NODE_80057_length_395_cov_449.327703	0	79	63	1	79	0.0126582
NODE_80057_length_395_cov_449.327703	0	79	69	1	79	0.0126582
NODE_80057_length_395_cov_449.327703	0	79	73	1	79	0.0126582
NODE_80057_length_395_cov_449.327703	0	79	77	1	79	0.0126582
NODE_80057_length_395_cov_449.327703	0	79	81	1	79	0.0126582
NODE_80057_length_395_cov_449.327703	0	79	87	1	79	0.0126582
NODE_80057_length_395_cov_449.327703	0	79	96	1	79	0.0126582
NODE_80057_length_395_cov_449.327703	0	79	98	3	79	0.0379747
NODE_80057_length_395_cov_449.327703	0	79	99	1	79	0.0126582
NODE_80057_length_395_cov_449.327703	0	79	101	1	79	0.0126582
NODE_80057_length_395_cov_449.327703	0	79	103	1	79	0.0126582
NODE_80057_length_395_cov_449.327703	0	79	109	1	79	0.0126582
NODE_80057_length_395_cov_449.327703	0	79	116	1	79	0.0126582
NODE_80057_length_395_cov_449.327703	0	79	118	1	79	0.0126582
NODE_80057_length_395_cov_449.327703	0	79	124	1	79	0.0126582
NODE_80057_length_395_cov_449.327703	0	79	125	2	79	0.0253165
NODE_80057_length_395_cov_449.327703	0	79	129	1	79	0.0126582
NODE_80057_length_395_cov_449.327703	0	79	133	3	79	0.0379747
NODE_80057_length_395_cov_449.327703	0	79	135	1	79	0.0126582
NODE_80057_length_395_cov_449.327703	0	79	138	1	79	0.0126582
NODE_80057_length_395_cov_449.327703	0	79	140	1	79	0.0126582
NODE_80057_length_395_cov_449.327703	0	79	142	2	79	0.0253165
NODE_80057_length_395_cov_449.327703	0	79	144	3	79	0.0379747
NODE_80057_length_395_cov_449.327703	0	79	146	2	79	0.0253165
NODE_80057_length_395_cov_449.327703	0	79	148	1	79	0.0126582
NODE_80057_length_395_cov_449.327703	0	79	153	1	79	0.0126582
NODE_80057_length_395_cov_449.327703	0	79	155	1	79	0.0126582
NODE_80057_length_395_cov_449.327703	0	79	159	2	79	0.0253165
NODE_80057_length_395_cov_449.327703	0	79	161	2	79	0.0253165
NODE_80057_length_395_cov_449.327703	0	79	165	2	79	0.0253165
NODE_80057_length_395_cov_449.327703	0	79	167	3	79	0.0379747
NODE_80057_length_395_cov_449.327703	0	79	169	3	79	0.0379747
NODE_80057_length_395_cov_449.327703	0	79	173	1	79	0.0126582
NODE_80057_length_395_cov_449.327703	0	79	175	1	79	0.0126582
NODE_80057_length_395_cov_449.327703	0	79	181	1	79	0.0126582
NODE_80057_length_395_cov_449.327703	0	79	184	1	79	0.0126582
NODE_80058_length_395_cov_13.695946	113	193	0	80	80	1.0000000
NODE_80058_length_395_cov_13.695946	166	246	0	80	80	1.0000000
NODE_80086_length_395_cov_4.179054	152	232	0	76	80	0.9500000
NODE_80086_length_395_cov_4.179054	152	232	2	4	80	0.0500000
NODE_80116_length_395_cov_2.962838	118	198	0	9	80	0.1125000
NODE_80116_length_395_cov_2.962838	118	198	2	71	80	0.8875000
NODE_80116_length_395_cov_2.962838	171	237	0	11	66	0.1666667
NODE_80116_length_395_cov_2.962838	171	237	2	55	66	0.8333333
NODE_80121_length_395_cov_2.878378	261	301	2	1	40	0.0250000
NODE_80121_length_395_cov_2.878378	261	301	4	39	40	0.9750000
NODE_80139_length_395_cov_2.587838	111	188	2	56	77	0.7272727
NODE_80139_length_395_cov_2.587838	111	188	4	1	77	0.0129870
NODE_80139_length_395_cov_2.587838	111	188	6	20	77	0.2597403
NODE_80139_length_395_cov_2.587838	232	301	0	56	69	0.8115942
NODE_80139_length_395_cov_2.587838	232	301	2	13	69	0.1884058
NODE_80139_length_395_cov_2.587838	258	302	0	44	44	1.0000000
NODE_80141_length_395_cov_2.560811	123	187	0	64	64	1.0000000
NODE_80146_length_395_cov_2.527027	194	274	0	80	80	1.0000000
NODE_80146_length_395_cov_2.527027	247	327	0	80	80	1.0000000
NODE_80439_length_395_cov_1.033784	103	151	0	11	48	0.2291667
NODE_80439_length_395_cov_1.033784	103	151	2	37	48	0.7708333
NODE_80448_length_395_cov_1.010135	85	105	0	20	20	1.0000000
NODE_80639_length_394_cov_9.464407	211	291	0	8	80	0.1000000
NODE_80639_length_394_cov_9.464407	211	291	1	3	80	0.0375000
NODE_80639_length_394_cov_9.464407	211	291	2	69	80	0.8625000
NODE_80639_length_394_cov_9.464407	264	344	2	80	80	1.0000000
NODE_80643_length_394_cov_7.437288	221	301	2	45	80	0.5625000
NODE_80643_length_394_cov_7.437288	221	301	4	8	80	0.1000000
NODE_80643_length_394_cov_7.437288	221	301	6	27	80	0.3375000
NODE_80643_length_394_cov_7.437288	274	331	6	57	57	1.0000000
NODE_80647_length_394_cov_6.444068	187	267	0	80	80	1.0000000
NODE_80647_length_394_cov_6.444068	240	320	0	80	80	1.0000000
NODE_80709_length_394_cov_2.932203	119	140	0	21	21	1.0000000
NODE_80710_length_394_cov_2.894915	79	135	4	52	56	0.9285714
NODE_80710_length_394_cov_2.894915	79	135	6	4	56	0.0714286
NODE_80710_length_394_cov_2.894915	166	202	6	36	36	1.0000000
NODE_81216_length_393_cov_4.261905	201	267	0	66	66	1.0000000
NODE_81216_length_393_cov_4.261905	240	282	0	42	42	1.0000000
NODE_81240_length_393_cov_3.503401	121	201	0	80	80	1.0000000
NODE_81240_length_393_cov_3.503401	174	246	0	72	72	1.0000000
NODE_81277_length_393_cov_2.704082	198	271	0	16	73	0.2191781
NODE_81277_length_393_cov_2.704082	198	271	4	34	73	0.4657534
NODE_81277_length_393_cov_2.704082	198	271	7	1	73	0.0136986
NODE_81277_length_393_cov_2.704082	198	271	8	22	73	0.3013699
NODE_81289_length_393_cov_2.493197	136	216	0	73	80	0.9125000
NODE_81289_length_393_cov_2.493197	136	216	2	7	80	0.0875000
NODE_81289_length_393_cov_2.493197	189	269	0	20	80	0.2500000
NODE_81289_length_393_cov_2.493197	189	269	2	60	80	0.7500000
NODE_81296_length_393_cov_2.360544	195	252	0	57	57	1.0000000
NODE_81416_length_393_cov_1.608844	207	270	0	63	63	1.0000000
NODE_81778_length_392_cov_7.873720	161	241	0	80	80	1.0000000
NODE_81778_length_392_cov_7.873720	214	294	0	80	80	1.0000000
NODE_81790_length_392_cov_5.262799	218	248	0	30	30	1.0000000
NODE_81805_length_392_cov_3.655290	109	157	0	48	48	1.0000000
NODE_81805_length_392_cov_3.655290	306	386	0	42	80	0.5250000
NODE_81805_length_392_cov_3.655290	306	386	2	38	80	0.4750000
NODE_81823_length_392_cov_3.197952	102	171	0	69	69	1.0000000
NODE_81823_length_392_cov_3.197952	233	314	0	20	81	0.2469136
NODE_81823_length_392_cov_3.197952	233	314	2	13	81	0.1604938
NODE_81823_length_392_cov_3.197952	233	314	4	48	81	0.5925926
NODE_81857_length_392_cov_2.511945	67	133	16	1	66	0.0151515
NODE_81857_length_392_cov_2.511945	67	133	17	3	66	0.0454545
NODE_81857_length_392_cov_2.511945	67	133	19	2	66	0.0303030
NODE_81857_length_392_cov_2.511945	67	133	21	6	66	0.0909091
NODE_81857_length_392_cov_2.511945	67	133	23	1	66	0.0151515
NODE_81857_length_392_cov_2.511945	67	133	25	3	66	0.0454545
NODE_81857_length_392_cov_2.511945	67	133	26	8	66	0.1212121
NODE_81857_length_392_cov_2.511945	67	133	30	1	66	0.0151515
NODE_81857_length_392_cov_2.511945	67	133	32	6	66	0.0909091
NODE_81857_length_392_cov_2.511945	67	133	34	5	66	0.0757576
NODE_81857_length_392_cov_2.511945	67	133	36	3	66	0.0454545
NODE_81857_length_392_cov_2.511945	67	133	38	5	66	0.0757576
NODE_81857_length_392_cov_2.511945	67	133	40	5	66	0.0757576
NODE_81857_length_392_cov_2.511945	67	133	42	3	66	0.0454545
NODE_81857_length_392_cov_2.511945	67	133	44	4	66	0.0606061
NODE_81857_length_392_cov_2.511945	67	133	46	2	66	0.0303030
NODE_81857_length_392_cov_2.511945	67	133	48	6	66	0.0909091
NODE_81857_length_392_cov_2.511945	67	133	49	1	66	0.0151515
NODE_81857_length_392_cov_2.511945	67	133	55	1	66	0.0151515
NODE_81857_length_392_cov_2.511945	120	206	42	3	86	0.0348837
NODE_81857_length_392_cov_2.511945	120	206	44	1	86	0.0116279
NODE_81857_length_392_cov_2.511945	120	206	46	1	86	0.0116279
NODE_81857_length_392_cov_2.511945	120	206	48	6	86	0.0697674
NODE_81857_length_392_cov_2.511945	120	206	49	1	86	0.0116279
NODE_81857_length_392_cov_2.511945	120	206	55	2	86	0.0232558
NODE_81857_length_392_cov_2.511945	120	206	57	2	86	0.0232558
NODE_81857_length_392_cov_2.511945	120	206	61	1	86	0.0116279
NODE_81857_length_392_cov_2.511945	120	206	63	3	86	0.0348837
NODE_81857_length_392_cov_2.511945	120	206	65	3	86	0.0348837
NODE_81857_length_392_cov_2.511945	120	206	66	4	86	0.0465116
NODE_81857_length_392_cov_2.511945	120	206	67	1	86	0.0116279
NODE_81857_length_392_cov_2.511945	120	206	68	3	86	0.0348837
NODE_81857_length_392_cov_2.511945	120	206	69	13	86	0.1511628
NODE_81857_length_392_cov_2.511945	120	206	73	9	86	0.1046512
NODE_81857_length_392_cov_2.511945	120	206	75	5	86	0.0581395
NODE_81857_length_392_cov_2.511945	120	206	77	10	86	0.1162791
NODE_81857_length_392_cov_2.511945	120	206	79	5	86	0.0581395
NODE_81857_length_392_cov_2.511945	120	206	81	8	86	0.0930233
NODE_81857_length_392_cov_2.511945	120	206	83	1	86	0.0116279
NODE_81857_length_392_cov_2.511945	120	206	85	4	86	0.0465116
NODE_81914_length_392_cov_2.075085	268	349	2	50	81	0.6172839
NODE_81914_length_392_cov_2.075085	268	349	4	31	81	0.3827161
NODE_81914_length_392_cov_2.075085	322	387	0	37	65	0.5692308
NODE_81914_length_392_cov_2.075085	322	387	2	28	65	0.4307692
NODE_81928_length_392_cov_1.955631	11	56	0	45	45	1.0000000
NODE_81929_length_392_cov_1.952218	40	59	0	19	19	1.0000000
NODE_81940_length_392_cov_1.911263	238	315	0	27	77	0.3506494
NODE_81940_length_392_cov_1.911263	238	315	2	42	77	0.5454546
NODE_81940_length_392_cov_1.911263	238	315	4	8	77	0.1038961
NODE_81994_length_392_cov_1.631399	114	139	8	4	25	0.1600000
NODE_81994_length_392_cov_1.631399	114	139	10	5	25	0.2000000
NODE_81994_length_392_cov_1.631399	114	139	14	2	25	0.0800000
NODE_81994_length_392_cov_1.631399	114	139	20	1	25	0.0400000
NODE_81994_length_392_cov_1.631399	114	139	22	1	25	0.0400000
NODE_81994_length_392_cov_1.631399	114	139	26	1	25	0.0400000
NODE_81994_length_392_cov_1.631399	114	139	28	2	25	0.0800000
NODE_81994_length_392_cov_1.631399	114	139	30	1	25	0.0400000
NODE_81994_length_392_cov_1.631399	114	139	34	8	25	0.3200000
NODE_82008_length_392_cov_1.559727	83	163	2	41	80	0.5125000
NODE_82008_length_392_cov_1.559727	83	163	4	39	80	0.4875000
NODE_82015_length_392_cov_1.552901	32	52	0	20	20	1.0000000
NODE_82390_length_391_cov_69.510274	9	89	22	1	80	0.0125000
NODE_82390_length_391_cov_69.510274	9	89	24	1	80	0.0125000
NODE_82390_length_391_cov_69.510274	9	89	26	2	80	0.0250000
NODE_82390_length_391_cov_69.510274	9	89	32	1	80	0.0125000
NODE_82390_length_391_cov_69.510274	9	89	34	1	80	0.0125000
NODE_82390_length_391_cov_69.510274	9	89	38	5	80	0.0625000
NODE_82390_length_391_cov_69.510274	9	89	46	2	80	0.0250000
NODE_82390_length_391_cov_69.510274	9	89	52	4	80	0.0500000
NODE_82390_length_391_cov_69.510274	9	89	54	3	80	0.0375000
NODE_82390_length_391_cov_69.510274	9	89	58	1	80	0.0125000
NODE_82390_length_391_cov_69.510274	9	89	60	2	80	0.0250000
NODE_82390_length_391_cov_69.510274	9	89	62	1	80	0.0125000
NODE_82390_length_391_cov_69.510274	9	89	64	2	80	0.0250000
NODE_82390_length_391_cov_69.510274	9	89	66	2	80	0.0250000
NODE_82390_length_391_cov_69.510274	9	89	70	1	80	0.0125000
NODE_82390_length_391_cov_69.510274	9	89	72	1	80	0.0125000
NODE_82390_length_391_cov_69.510274	9	89	74	2	80	0.0250000
NODE_82390_length_391_cov_69.510274	9	89	80	1	80	0.0125000
NODE_82390_length_391_cov_69.510274	9	89	84	1	80	0.0125000
NODE_82390_length_391_cov_69.510274	9	89	94	1	80	0.0125000
NODE_82390_length_391_cov_69.510274	9	89	96	1	80	0.0125000
NODE_82390_length_391_cov_69.510274	9	89	98	2	80	0.0250000
NODE_82390_length_391_cov_69.510274	9	89	102	1	80	0.0125000
NODE_82390_length_391_cov_69.510274	9	89	104	1	80	0.0125000
NODE_82390_length_391_cov_69.510274	9	89	106	2	80	0.0250000
NODE_82390_length_391_cov_69.510274	9	89	110	1	80	0.0125000
NODE_82390_length_391_cov_69.510274	9	89	112	1	80	0.0125000
NODE_82390_length_391_cov_69.510274	9	89	118	3	80	0.0375000
NODE_82390_length_391_cov_69.510274	9	89	119	1	80	0.0125000
NODE_82390_length_391_cov_69.510274	9	89	121	2	80	0.0250000
NODE_82390_length_391_cov_69.510274	9	89	125	2	80	0.0250000
NODE_82390_length_391_cov_69.510274	9	89	127	1	80	0.0125000
NODE_82390_length_391_cov_69.510274	9	89	129	3	80	0.0375000
NODE_82390_length_391_cov_69.510274	9	89	131	2	80	0.0250000
NODE_82390_length_391_cov_69.510274	9	89	133	1	80	0.0125000
NODE_82390_length_391_cov_69.510274	9	89	135	2	80	0.0250000
NODE_82390_length_391_cov_69.510274	9	89	139	2	80	0.0250000
NODE_82390_length_391_cov_69.510274	9	89	141	1	80	0.0125000
NODE_82390_length_391_cov_69.510274	9	89	143	1	80	0.0125000
NODE_82390_length_391_cov_69.510274	9	89	145	3	80	0.0375000
NODE_82390_length_391_cov_69.510274	9	89	149	8	80	0.1000000
NODE_82390_length_391_cov_69.510274	9	89	155	4	80	0.0500000
NODE_82391_length_391_cov_39.414384	0	66	2	1	66	0.0151515
NODE_82391_length_391_cov_39.414384	0	66	4	8	66	0.1212121
NODE_82391_length_391_cov_39.414384	0	66	6	1	66	0.0151515
NODE_82391_length_391_cov_39.414384	0	66	10	12	66	0.1818182
NODE_82391_length_391_cov_39.414384	0	66	12	6	66	0.0909091
NODE_82391_length_391_cov_39.414384	0	66	16	7	66	0.1060606
NODE_82391_length_391_cov_39.414384	0	66	18	4	66	0.0606061
NODE_82391_length_391_cov_39.414384	0	66	27	1	66	0.0151515
NODE_82391_length_391_cov_39.414384	0	66	28	12	66	0.1818182
NODE_82391_length_391_cov_39.414384	0	66	34	8	66	0.1212121
NODE_82391_length_391_cov_39.414384	0	66	36	4	66	0.0606061
NODE_82391_length_391_cov_39.414384	0	66	40	2	66	0.0303030
NODE_82391_length_391_cov_39.414384	0	71	2	1	71	0.0140845
NODE_82391_length_391_cov_39.414384	0	71	4	8	71	0.1126761
NODE_82391_length_391_cov_39.414384	0	71	6	1	71	0.0140845
NODE_82391_length_391_cov_39.414384	0	71	10	12	71	0.1690141
NODE_82391_length_391_cov_39.414384	0	71	12	6	71	0.0845070
NODE_82391_length_391_cov_39.414384	0	71	16	7	71	0.0985916
NODE_82391_length_391_cov_39.414384	0	71	18	4	71	0.0563380
NODE_82391_length_391_cov_39.414384	0	71	27	1	71	0.0140845
NODE_82391_length_391_cov_39.414384	0	71	28	12	71	0.1690141
NODE_82391_length_391_cov_39.414384	0	71	34	8	71	0.1126761
NODE_82391_length_391_cov_39.414384	0	71	36	4	71	0.0563380
NODE_82391_length_391_cov_39.414384	0	71	40	7	71	0.0985916
NODE_82391_length_391_cov_39.414384	44	124	28	10	80	0.1250000
NODE_82391_length_391_cov_39.414384	44	124	30	2	80	0.0250000
NODE_82391_length_391_cov_39.414384	44	124	34	14	80	0.1750000
NODE_82391_length_391_cov_39.414384	44	124	36	4	80	0.0500000
NODE_82391_length_391_cov_39.414384	44	124	38	1	80	0.0125000
NODE_82391_length_391_cov_39.414384	44	124	40	34	80	0.4250000
NODE_82391_length_391_cov_39.414384	44	124	42	2	80	0.0250000
NODE_82391_length_391_cov_39.414384	44	124	44	13	80	0.1625000
NODE_82394_length_391_cov_10.352740	156	235	0	79	79	1.0000000
NODE_82415_length_391_cov_5.030822	85	166	4	3	81	0.0370370
NODE_82415_length_391_cov_5.030822	85	166	6	8	81	0.0987654
NODE_82415_length_391_cov_5.030822	85	166	8	9	81	0.1111111
NODE_82415_length_391_cov_5.030822	85	166	10	43	81	0.5308642
NODE_82415_length_391_cov_5.030822	85	166	11	15	81	0.1851852
NODE_82415_length_391_cov_5.030822	85	166	12	3	81	0.0370370
NODE_82498_length_391_cov_2.660959	267	343	0	22	76	0.2894737
NODE_82498_length_391_cov_2.660959	267	343	2	25	76	0.3289474
NODE_82498_length_391_cov_2.660959	267	343	4	29	76	0.3815790
NODE_82552_length_391_cov_2.089041	176	256	4	13	80	0.1625000
NODE_82552_length_391_cov_2.089041	176	256	6	67	80	0.8375000
NODE_82552_length_391_cov_2.089041	229	280	0	1	51	0.0196078
NODE_82552_length_391_cov_2.089041	229	280	2	20	51	0.3921569
NODE_82552_length_391_cov_2.089041	229	280	4	16	51	0.3137255
NODE_82552_length_391_cov_2.089041	229	280	6	14	51	0.2745098
NODE_82574_length_391_cov_1.907534	200	257	0	57	57	1.0000000
NODE_82597_length_391_cov_1.773973	160	190	2	30	30	1.0000000
NODE_82632_length_391_cov_1.647260	298	378	0	22	80	0.2750000
NODE_82632_length_391_cov_1.647260	298	378	2	58	80	0.7250000
NODE_82662_length_391_cov_1.561644	241	261	0	20	20	1.0000000
NODE_83015_length_390_cov_29.030928	86	166	2	80	80	1.0000000
NODE_83015_length_390_cov_29.030928	139	219	0	35	80	0.4375000
NODE_83015_length_390_cov_29.030928	139	219	2	45	80	0.5625000
NODE_83016_length_390_cov_22.319588	118	198	0	80	80	1.0000000
NODE_83016_length_390_cov_22.319588	171	251	0	80	80	1.0000000
NODE_83044_length_390_cov_4.481100	208	277	0	69	69	1.0000000
NODE_83044_length_390_cov_4.481100	286	327	6	41	41	1.0000000
NODE_83045_length_390_cov_4.481100	93	171	0	50	78	0.6410257
NODE_83045_length_390_cov_4.481100	93	171	2	28	78	0.3589744
NODE_83045_length_390_cov_4.481100	144	210	2	66	66	1.0000000
NODE_83060_length_390_cov_3.814433	66	99	0	33	33	1.0000000
NODE_83061_length_390_cov_3.783505	188	268	0	75	80	0.9375000
NODE_83061_length_390_cov_3.783505	188	268	2	5	80	0.0625000
NODE_83061_length_390_cov_3.783505	241	321	0	80	80	1.0000000
NODE_83066_length_390_cov_3.560137	304	367	2	31	63	0.4920635
NODE_83066_length_390_cov_3.560137	304	367	4	32	63	0.5079365
NODE_83066_length_390_cov_3.560137	340	381	2	41	41	1.0000000
NODE_83169_length_390_cov_2.127148	242	322	2	13	80	0.1625000
NODE_83169_length_390_cov_2.127148	242	322	4	4	80	0.0500000
NODE_83169_length_390_cov_2.127148	242	322	8	2	80	0.0250000
NODE_83169_length_390_cov_2.127148	242	322	10	1	80	0.0125000
NODE_83169_length_390_cov_2.127148	242	322	12	3	80	0.0375000
NODE_83169_length_390_cov_2.127148	242	322	14	57	80	0.7125000
NODE_83171_length_390_cov_2.123711	133	177	2	7	44	0.1590909
NODE_83171_length_390_cov_2.123711	133	177	6	16	44	0.3636364
NODE_83171_length_390_cov_2.123711	133	177	8	3	44	0.0681818
NODE_83171_length_390_cov_2.123711	133	177	10	13	44	0.2954545
NODE_83171_length_390_cov_2.123711	133	177	12	5	44	0.1136364
NODE_83171_length_390_cov_2.123711	157	237	6	1	80	0.0125000
NODE_83171_length_390_cov_2.123711	157	237	8	1	80	0.0125000
NODE_83171_length_390_cov_2.123711	157	237	10	13	80	0.1625000
NODE_83171_length_390_cov_2.123711	157	237	12	6	80	0.0750000
NODE_83171_length_390_cov_2.123711	157	237	14	8	80	0.1000000
NODE_83171_length_390_cov_2.123711	157	237	16	51	80	0.6375000
NODE_83288_length_390_cov_1.536082	223	276	0	53	53	1.0000000
NODE_83338_length_390_cov_1.398625	49	110	28	1	61	0.0163934
NODE_83338_length_390_cov_1.398625	49	110	36	5	61	0.0819672
NODE_83338_length_390_cov_1.398625	49	110	42	1	61	0.0163934
NODE_83338_length_390_cov_1.398625	49	110	48	2	61	0.0327869
NODE_83338_length_390_cov_1.398625	49	110	52	4	61	0.0655738
NODE_83338_length_390_cov_1.398625	49	110	55	1	61	0.0163934
NODE_83338_length_390_cov_1.398625	49	110	56	1	61	0.0163934
NODE_83338_length_390_cov_1.398625	49	110	58	1	61	0.0163934
NODE_83338_length_390_cov_1.398625	49	110	62	1	61	0.0163934
NODE_83338_length_390_cov_1.398625	49	110	66	6	61	0.0983607
NODE_83338_length_390_cov_1.398625	49	110	70	1	61	0.0163934
NODE_83338_length_390_cov_1.398625	49	110	72	2	61	0.0327869
NODE_83338_length_390_cov_1.398625	49	110	76	1	61	0.0163934
NODE_83338_length_390_cov_1.398625	49	110	80	3	61	0.0491803
NODE_83338_length_390_cov_1.398625	49	110	82	7	61	0.1147541
NODE_83338_length_390_cov_1.398625	49	110	84	3	61	0.0491803
NODE_83338_length_390_cov_1.398625	49	110	86	5	61	0.0819672
NODE_83338_length_390_cov_1.398625	49	110	88	13	61	0.2131148
NODE_83338_length_390_cov_1.398625	49	110	90	3	61	0.0491803
NODE_83463_length_390_cov_1.034364	78	158	0	80	80	1.0000000
NODE_83633_length_389_cov_63.710345	32	112	0	80	80	1.0000000
NODE_83633_length_389_cov_63.710345	85	165	0	80	80	1.0000000
NODE_83633_length_389_cov_63.710345	161	241	0	80	80	1.0000000
NODE_83633_length_389_cov_63.710345	214	294	0	80	80	1.0000000
NODE_83650_length_389_cov_5.382759	154	234	0	80	80	1.0000000
NODE_83662_length_389_cov_4.468966	199	269	0	30	70	0.4285714
NODE_83662_length_389_cov_4.468966	199	269	2	29	70	0.4142857
NODE_83662_length_389_cov_4.468966	199	269	4	11	70	0.1571429
NODE_83663_length_389_cov_4.424138	68	148	34	4	80	0.0500000
NODE_83663_length_389_cov_4.424138	68	148	38	1	80	0.0125000
NODE_83663_length_389_cov_4.424138	68	148	39	11	80	0.1375000
NODE_83663_length_389_cov_4.424138	68	148	41	1	80	0.0125000
NODE_83663_length_389_cov_4.424138	68	148	42	9	80	0.1125000
NODE_83663_length_389_cov_4.424138	68	148	44	5	80	0.0625000
NODE_83663_length_389_cov_4.424138	68	148	46	6	80	0.0750000
NODE_83663_length_389_cov_4.424138	68	148	48	43	80	0.5375000
NODE_83685_length_389_cov_3.782759	194	225	0	31	31	1.0000000
NODE_83689_length_389_cov_3.555172	107	153	0	36	46	0.7826087
NODE_83689_length_389_cov_3.555172	107	153	2	10	46	0.2173913
NODE_83695_length_389_cov_3.251724	120	163	0	43	43	1.0000000
NODE_83695_length_389_cov_3.251724	136	206	0	70	70	1.0000000
NODE_83816_length_389_cov_1.951724	68	148	0	2	80	0.0250000
NODE_83816_length_389_cov_1.951724	68	148	2	4	80	0.0500000
NODE_83816_length_389_cov_1.951724	68	148	6	74	80	0.9250000
NODE_83819_length_389_cov_1.937931	53	82	6	15	29	0.5172414
NODE_83819_length_389_cov_1.937931	53	82	8	14	29	0.4827586
NODE_83819_length_389_cov_1.937931	153	233	8	6	80	0.0750000
NODE_83819_length_389_cov_1.937931	153	233	10	20	80	0.2500000
NODE_83819_length_389_cov_1.937931	153	233	12	2	80	0.0250000
NODE_83819_length_389_cov_1.937931	153	233	14	31	80	0.3875000
NODE_83819_length_389_cov_1.937931	153	233	16	21	80	0.2625000
NODE_83829_length_389_cov_1.920690	296	365	8	69	69	1.0000000
NODE_84182_length_389_cov_0.720690	294	374	0	26	80	0.3250000
NODE_84182_length_389_cov_0.720690	294	374	2	54	80	0.6750000
NODE_84267_length_388_cov_9.179931	47	127	0	80	80	1.0000000
NODE_84267_length_388_cov_9.179931	100	180	0	80	80	1.0000000
NODE_84270_length_388_cov_7.249135	171	251	0	80	80	1.0000000
NODE_84270_length_388_cov_7.249135	224	304	0	80	80	1.0000000
NODE_84305_length_388_cov_3.913495	151	231	0	7	80	0.0875000
NODE_84305_length_388_cov_3.913495	151	231	2	39	80	0.4875000
NODE_84305_length_388_cov_3.913495	151	231	4	34	80	0.4250000
NODE_84308_length_388_cov_3.809689	233	277	0	44	44	1.0000000
NODE_84332_length_388_cov_3.103806	101	166	0	46	65	0.7076923
NODE_84332_length_388_cov_3.103806	101	166	2	19	65	0.2923077
NODE_84332_length_388_cov_3.103806	147	227	2	80	80	1.0000000
NODE_84334_length_388_cov_3.041522	48	128	0	15	80	0.1875000
NODE_84334_length_388_cov_3.041522	48	128	2	27	80	0.3375000
NODE_84334_length_388_cov_3.041522	48	128	4	38	80	0.4750000
NODE_84410_length_388_cov_2.114187	82	141	0	39	59	0.6610169
NODE_84410_length_388_cov_2.114187	82	141	2	20	59	0.3389831
NODE_84410_length_388_cov_2.114187	135	194	0	59	59	1.0000000
NODE_84423_length_388_cov_2.017301	99	151	0	2	52	0.0384615
NODE_84423_length_388_cov_2.017301	99	151	2	10	52	0.1923077
NODE_84423_length_388_cov_2.017301	99	151	4	40	52	0.7692308
NODE_84427_length_388_cov_1.989619	0	76	0	76	76	1.0000000
NODE_84427_length_388_cov_1.989619	49	114	0	65	65	1.0000000
NODE_84587_length_388_cov_1.352941	172	247	0	75	75	1.0000000
NODE_84631_length_388_cov_1.228374	308	339	0	31	31	1.0000000
NODE_84885_length_387_cov_33.052083	194	274	0	80	80	1.0000000
NODE_84885_length_387_cov_33.052083	247	327	0	80	80	1.0000000
NODE_84890_length_387_cov_6.871528	26	106	0	80	80	1.0000000
NODE_84890_length_387_cov_6.871528	79	159	0	80	80	1.0000000
NODE_84902_length_387_cov_5.420139	286	341	0	55	55	1.0000000
NODE_84946_length_387_cov_3.364583	287	367	0	80	80	1.0000000
NODE_85007_length_387_cov_2.260417	140	210	4	70	70	1.0000000
NODE_85019_length_387_cov_2.128472	220	286	0	66	66	1.0000000
NODE_85019_length_387_cov_2.128472	273	329	0	56	56	1.0000000
NODE_85032_length_387_cov_2.090278	318	352	0	34	34	1.0000000
NODE_85037_length_387_cov_2.055556	23	45	0	22	22	1.0000000
NODE_85047_length_387_cov_1.979167	259	316	0	57	57	1.0000000
NODE_85047_length_387_cov_1.979167	312	369	0	57	57	1.0000000
NODE_85091_length_387_cov_1.770833	315	361	0	36	46	0.7826087
NODE_85091_length_387_cov_1.770833	315	361	4	10	46	0.2173913
NODE_85528_length_386_cov_9.979094	38	118	0	33	80	0.4125000
NODE_85528_length_386_cov_9.979094	38	118	2	47	80	0.5875000
NODE_85528_length_386_cov_9.979094	91	174	0	36	83	0.4337350
NODE_85528_length_386_cov_9.979094	91	174	2	47	83	0.5662650
NODE_85546_length_386_cov_4.428571	197	249	0	52	52	1.0000000
NODE_85570_length_386_cov_3.355401	151	231	0	54	80	0.6750000
NODE_85570_length_386_cov_3.355401	151	231	2	26	80	0.3250000
NODE_85570_length_386_cov_3.355401	204	265	0	61	61	1.0000000
NODE_85602_length_386_cov_2.686411	293	325	0	32	32	1.0000000
NODE_85602_length_386_cov_2.686411	349	379	0	3	30	0.1000000
NODE_85602_length_386_cov_2.686411	349	379	2	27	30	0.9000000
NODE_85629_length_386_cov_2.442509	55	135	0	80	80	1.0000000
NODE_85629_length_386_cov_2.442509	108	164	0	56	56	1.0000000
NODE_85793_length_386_cov_1.494774	79	121	2	42	42	1.0000000
NODE_85793_length_386_cov_1.494774	93	156	2	37	63	0.5873016
NODE_85793_length_386_cov_1.494774	93	156	4	26	63	0.4126984
NODE_85816_length_386_cov_1.421603	160	236	0	53	76	0.6973684
NODE_85816_length_386_cov_1.421603	160	236	2	23	76	0.3026316
NODE_85845_length_386_cov_1.372822	62	142	0	80	80	1.0000000
NODE_85845_length_386_cov_1.372822	115	195	0	29	80	0.3625000
NODE_85845_length_386_cov_1.372822	115	195	4	51	80	0.6375000
NODE_85858_length_386_cov_1.317073	124	161	6	6	37	0.1621622
NODE_85858_length_386_cov_1.317073	124	161	8	5	37	0.1351351
NODE_85858_length_386_cov_1.317073	124	161	10	26	37	0.7027027
NODE_85902_length_386_cov_1.170732	260	308	4	4	48	0.0833333
NODE_85902_length_386_cov_1.170732	260	308	6	8	48	0.1666667
NODE_85902_length_386_cov_1.170732	260	308	8	4	48	0.0833333
NODE_85902_length_386_cov_1.170732	260	308	10	3	48	0.0625000
NODE_85902_length_386_cov_1.170732	260	308	12	13	48	0.2708333
NODE_85902_length_386_cov_1.170732	260	308	14	5	48	0.1041667
NODE_85902_length_386_cov_1.170732	260	308	16	11	48	0.2291667
NODE_86143_length_385_cov_167.877622	103	164	124	3	61	0.0491803
NODE_86143_length_385_cov_167.877622	103	164	126	5	61	0.0819672
NODE_86143_length_385_cov_167.877622	103	164	127	2	61	0.0327869
NODE_86143_length_385_cov_167.877622	103	164	128	7	61	0.1147541
NODE_86143_length_385_cov_167.877622	103	164	129	2	61	0.0327869
NODE_86143_length_385_cov_167.877622	103	164	131	1	61	0.0163934
NODE_86143_length_385_cov_167.877622	103	164	132	1	61	0.0163934
NODE_86143_length_385_cov_167.877622	103	164	134	1	61	0.0163934
NODE_86143_length_385_cov_167.877622	103	164	138	1	61	0.0163934
NODE_86143_length_385_cov_167.877622	103	164	142	1	61	0.0163934
NODE_86143_length_385_cov_167.877622	103	164	144	1	61	0.0163934
NODE_86143_length_385_cov_167.877622	103	164	146	2	61	0.0327869
NODE_86143_length_385_cov_167.877622	103	164	147	1	61	0.0163934
NODE_86143_length_385_cov_167.877622	103	164	148	2	61	0.0327869
NODE_86143_length_385_cov_167.877622	103	164	149	4	61	0.0655738
NODE_86143_length_385_cov_167.877622	103	164	150	3	61	0.0491803
NODE_86143_length_385_cov_167.877622	103	164	151	1	61	0.0163934
NODE_86143_length_385_cov_167.877622	103	164	152	1	61	0.0163934
NODE_86143_length_385_cov_167.877622	103	164	153	2	61	0.0327869
NODE_86143_length_385_cov_167.877622	103	164	154	2	61	0.0327869
NODE_86143_length_385_cov_167.877622	103	164	155	2	61	0.0327869
NODE_86143_length_385_cov_167.877622	103	164	156	1	61	0.0163934
NODE_86143_length_385_cov_167.877622	103	164	157	5	61	0.0819672
NODE_86143_length_385_cov_167.877622	103	164	159	2	61	0.0327869
NODE_86143_length_385_cov_167.877622	103	164	161	4	61	0.0655738
NODE_86143_length_385_cov_167.877622	103	164	165	1	61	0.0163934
NODE_86143_length_385_cov_167.877622	103	164	167	3	61	0.0491803
NODE_86144_length_385_cov_38.695804	164	244	0	15	80	0.1875000
NODE_86144_length_385_cov_38.695804	164	244	4	65	80	0.8125000
NODE_86144_length_385_cov_38.695804	217	297	0	28	80	0.3500000
NODE_86144_length_385_cov_38.695804	217	297	4	52	80	0.6500000
NODE_86169_length_385_cov_4.335664	173	250	0	77	77	1.0000000
NODE_86185_length_385_cov_3.793706	215	297	0	52	82	0.6341463
NODE_86185_length_385_cov_3.793706	215	297	2	30	82	0.3658537
NODE_86230_length_385_cov_2.786713	99	179	6	12	80	0.1500000
NODE_86230_length_385_cov_2.786713	99	179	8	43	80	0.5375000
NODE_86230_length_385_cov_2.786713	99	179	10	25	80	0.3125000
NODE_86230_length_385_cov_2.786713	152	232	0	2	80	0.0250000
NODE_86230_length_385_cov_2.786713	152	232	2	17	80	0.2125000
NODE_86230_length_385_cov_2.786713	152	232	4	3	80	0.0375000
NODE_86230_length_385_cov_2.786713	152	232	6	16	80	0.2000000
NODE_86230_length_385_cov_2.786713	152	232	8	42	80	0.5250000
NODE_86230_length_385_cov_2.786713	281	362	0	81	81	1.0000000
NODE_86448_length_385_cov_1.381119	71	145	0	50	74	0.6756757
NODE_86448_length_385_cov_1.381119	71	145	2	3	74	0.0405405
NODE_86448_length_385_cov_1.381119	71	145	6	7	74	0.0945946
NODE_86448_length_385_cov_1.381119	71	145	10	14	74	0.1891892
NODE_86448_length_385_cov_1.381119	118	198	0	3	80	0.0375000
NODE_86448_length_385_cov_1.381119	118	198	2	3	80	0.0375000
NODE_86448_length_385_cov_1.381119	118	198	6	7	80	0.0875000
NODE_86448_length_385_cov_1.381119	118	198	10	30	80	0.3750000
NODE_86448_length_385_cov_1.381119	118	198	12	1	80	0.0125000
NODE_86448_length_385_cov_1.381119	118	198	13	32	80	0.4000000
NODE_86448_length_385_cov_1.381119	118	198	14	4	80	0.0500000
NODE_86798_length_384_cov_3.996491	135	217	2	1	82	0.0121951
NODE_86798_length_384_cov_3.996491	135	217	4	17	82	0.2073171
NODE_86798_length_384_cov_3.996491	135	217	6	22	82	0.2682927
NODE_86798_length_384_cov_3.996491	135	217	7	1	82	0.0121951
NODE_86798_length_384_cov_3.996491	135	217	8	41	82	0.5000000
NODE_86809_length_384_cov_3.729825	181	228	2	47	47	1.0000000
NODE_86812_length_384_cov_3.715789	145	221	0	46	76	0.6052632
NODE_86812_length_384_cov_3.715789	145	221	2	30	76	0.3947369
NODE_86841_length_384_cov_2.996491	147	227	6	47	80	0.5875000
NODE_86841_length_384_cov_2.996491	147	227	8	6	80	0.0750000
NODE_86841_length_384_cov_2.996491	147	227	12	24	80	0.3000000
NODE_86841_length_384_cov_2.996491	147	227	14	3	80	0.0375000
NODE_86847_length_384_cov_2.835088	65	145	6	13	80	0.1625000
NODE_86847_length_384_cov_2.835088	65	145	8	26	80	0.3250000
NODE_86847_length_384_cov_2.835088	65	145	10	18	80	0.2250000
NODE_86847_length_384_cov_2.835088	65	145	12	23	80	0.2875000
NODE_86866_length_384_cov_2.575439	151	224	10	1	73	0.0136986
NODE_86866_length_384_cov_2.575439	151	224	12	6	73	0.0821918
NODE_86866_length_384_cov_2.575439	151	224	14	2	73	0.0273973
NODE_86866_length_384_cov_2.575439	151	224	16	3	73	0.0410959
NODE_86866_length_384_cov_2.575439	151	224	18	12	73	0.1643836
NODE_86866_length_384_cov_2.575439	151	224	20	4	73	0.0547945
NODE_86866_length_384_cov_2.575439	151	224	24	4	73	0.0547945
NODE_86866_length_384_cov_2.575439	151	224	26	41	73	0.5616438
NODE_86866_length_384_cov_2.575439	197	281	6	18	84	0.2142857
NODE_86866_length_384_cov_2.575439	197	281	8	8	84	0.0952381
NODE_86866_length_384_cov_2.575439	197	281	10	12	84	0.1428571
NODE_86866_length_384_cov_2.575439	197	281	12	14	84	0.1666667
NODE_86866_length_384_cov_2.575439	197	281	14	7	84	0.0833333
NODE_86866_length_384_cov_2.575439	197	281	15	1	84	0.0119048
NODE_86866_length_384_cov_2.575439	197	281	16	9	84	0.1071429
NODE_86866_length_384_cov_2.575439	197	281	18	12	84	0.1428571
NODE_86866_length_384_cov_2.575439	197	281	20	3	84	0.0357143
NODE_86907_length_384_cov_2.231579	78	153	0	75	75	1.0000000
NODE_86942_length_384_cov_1.940351	73	153	0	10	80	0.1250000
NODE_86942_length_384_cov_1.940351	73	153	2	70	80	0.8750000
NODE_87431_length_383_cov_4.869718	117	197	0	80	80	1.0000000
NODE_87431_length_383_cov_4.869718	170	250	0	80	80	1.0000000
NODE_87432_length_383_cov_4.841549	121	180	0	59	59	1.0000000
NODE_87438_length_383_cov_4.559859	33	109	0	76	76	1.0000000
NODE_87487_length_383_cov_2.940141	185	265	0	74	80	0.9250000
NODE_87487_length_383_cov_2.940141	185	265	2	6	80	0.0750000
NODE_87495_length_383_cov_2.760563	123	203	169	1	80	0.0125000
NODE_87495_length_383_cov_2.760563	123	203	181	2	80	0.0250000
NODE_87495_length_383_cov_2.760563	123	203	183	2	80	0.0250000
NODE_87495_length_383_cov_2.760563	123	203	187	1	80	0.0125000
NODE_87495_length_383_cov_2.760563	123	203	195	1	80	0.0125000
NODE_87495_length_383_cov_2.760563	123	203	205	1	80	0.0125000
NODE_87495_length_383_cov_2.760563	123	203	207	1	80	0.0125000
NODE_87495_length_383_cov_2.760563	123	203	209	1	80	0.0125000
NODE_87495_length_383_cov_2.760563	123	203	211	5	80	0.0625000
NODE_87495_length_383_cov_2.760563	123	203	213	3	80	0.0375000
NODE_87495_length_383_cov_2.760563	123	203	215	1	80	0.0125000
NODE_87495_length_383_cov_2.760563	123	203	217	1	80	0.0125000
NODE_87495_length_383_cov_2.760563	123	203	219	4	80	0.0500000
NODE_87495_length_383_cov_2.760563	123	203	221	1	80	0.0125000
NODE_87495_length_383_cov_2.760563	123	203	223	3	80	0.0375000
NODE_87495_length_383_cov_2.760563	123	203	224	1	80	0.0125000
NODE_87495_length_383_cov_2.760563	123	203	226	2	80	0.0250000
NODE_87495_length_383_cov_2.760563	123	203	227	1	80	0.0125000
NODE_87495_length_383_cov_2.760563	123	203	232	1	80	0.0125000
NODE_87495_length_383_cov_2.760563	123	203	234	1	80	0.0125000
NODE_87495_length_383_cov_2.760563	123	203	235	2	80	0.0250000
NODE_87495_length_383_cov_2.760563	123	203	236	1	80	0.0125000
NODE_87495_length_383_cov_2.760563	123	203	237	3	80	0.0375000
NODE_87495_length_383_cov_2.760563	123	203	238	2	80	0.0250000
NODE_87495_length_383_cov_2.760563	123	203	239	4	80	0.0500000
NODE_87495_length_383_cov_2.760563	123	203	241	1	80	0.0125000
NODE_87495_length_383_cov_2.760563	123	203	242	2	80	0.0250000
NODE_87495_length_383_cov_2.760563	123	203	244	2	80	0.0250000
NODE_87495_length_383_cov_2.760563	123	203	246	1	80	0.0125000
NODE_87495_length_383_cov_2.760563	123	203	248	2	80	0.0250000
NODE_87495_length_383_cov_2.760563	123	203	250	1	80	0.0125000
NODE_87495_length_383_cov_2.760563	123	203	252	3	80	0.0375000
NODE_87495_length_383_cov_2.760563	123	203	254	1	80	0.0125000
NODE_87495_length_383_cov_2.760563	123	203	256	1	80	0.0125000
NODE_87495_length_383_cov_2.760563	123	203	258	1	80	0.0125000
NODE_87495_length_383_cov_2.760563	123	203	260	1	80	0.0125000
NODE_87495_length_383_cov_2.760563	123	203	264	1	80	0.0125000
NODE_87495_length_383_cov_2.760563	123	203	265	3	80	0.0375000
NODE_87495_length_383_cov_2.760563	123	203	266	1	80	0.0125000
NODE_87495_length_383_cov_2.760563	123	203	267	4	80	0.0500000
NODE_87495_length_383_cov_2.760563	123	203	268	1	80	0.0125000
NODE_87495_length_383_cov_2.760563	123	203	269	3	80	0.0375000
NODE_87495_length_383_cov_2.760563	123	203	271	4	80	0.0500000
NODE_87495_length_383_cov_2.760563	123	203	272	1	80	0.0125000
NODE_87495_length_383_cov_2.760563	169	249	62	2	80	0.0250000
NODE_87495_length_383_cov_2.760563	169	249	68	1	80	0.0125000
NODE_87495_length_383_cov_2.760563	169	249	76	3	80	0.0375000
NODE_87495_length_383_cov_2.760563	169	249	78	2	80	0.0250000
NODE_87495_length_383_cov_2.760563	169	249	80	2	80	0.0250000
NODE_87495_length_383_cov_2.760563	169	249	88	4	80	0.0500000
NODE_87495_length_383_cov_2.760563	169	249	92	5	80	0.0625000
NODE_87495_length_383_cov_2.760563	169	249	98	1	80	0.0125000
NODE_87495_length_383_cov_2.760563	169	249	106	1	80	0.0125000
NODE_87495_length_383_cov_2.760563	169	249	110	1	80	0.0125000
NODE_87495_length_383_cov_2.760563	169	249	112	2	80	0.0250000
NODE_87495_length_383_cov_2.760563	169	249	114	1	80	0.0125000
NODE_87495_length_383_cov_2.760563	169	249	116	1	80	0.0125000
NODE_87495_length_383_cov_2.760563	169	249	118	3	80	0.0375000
NODE_87495_length_383_cov_2.760563	169	249	120	1	80	0.0125000
NODE_87495_length_383_cov_2.760563	169	249	122	2	80	0.0250000
NODE_87495_length_383_cov_2.760563	169	249	128	1	80	0.0125000
NODE_87495_length_383_cov_2.760563	169	249	134	2	80	0.0250000
NODE_87495_length_383_cov_2.760563	169	249	136	1	80	0.0125000
NODE_87495_length_383_cov_2.760563	169	249	137	1	80	0.0125000
NODE_87495_length_383_cov_2.760563	169	249	143	1	80	0.0125000
NODE_87495_length_383_cov_2.760563	169	249	149	1	80	0.0125000
NODE_87495_length_383_cov_2.760563	169	249	151	1	80	0.0125000
NODE_87495_length_383_cov_2.760563	169	249	153	1	80	0.0125000
NODE_87495_length_383_cov_2.760563	169	249	155	1	80	0.0125000
NODE_87495_length_383_cov_2.760563	169	249	163	1	80	0.0125000
NODE_87495_length_383_cov_2.760563	169	249	164	1	80	0.0125000
NODE_87495_length_383_cov_2.760563	169	249	165	1	80	0.0125000
NODE_87495_length_383_cov_2.760563	169	249	167	1	80	0.0125000
NODE_87495_length_383_cov_2.760563	169	249	169	1	80	0.0125000
NODE_87495_length_383_cov_2.760563	169	249	181	2	80	0.0250000
NODE_87495_length_383_cov_2.760563	169	249	183	2	80	0.0250000
NODE_87495_length_383_cov_2.760563	169	249	187	1	80	0.0125000
NODE_87495_length_383_cov_2.760563	169	249	195	1	80	0.0125000
NODE_87495_length_383_cov_2.760563	169	249	205	1	80	0.0125000
NODE_87495_length_383_cov_2.760563	169	249	207	1	80	0.0125000
NODE_87495_length_383_cov_2.760563	169	249	209	1	80	0.0125000
NODE_87495_length_383_cov_2.760563	169	249	211	5	80	0.0625000
NODE_87495_length_383_cov_2.760563	169	249	215	1	80	0.0125000
NODE_87495_length_383_cov_2.760563	169	249	223	1	80	0.0125000
NODE_87495_length_383_cov_2.760563	169	249	237	1	80	0.0125000
NODE_87495_length_383_cov_2.760563	169	249	239	1	80	0.0125000
NODE_87495_length_383_cov_2.760563	169	249	241	1	80	0.0125000
NODE_87495_length_383_cov_2.760563	169	249	242	1	80	0.0125000
NODE_87495_length_383_cov_2.760563	169	249	244	1	80	0.0125000
NODE_87495_length_383_cov_2.760563	169	249	246	1	80	0.0125000
NODE_87495_length_383_cov_2.760563	169	249	248	1	80	0.0125000
NODE_87495_length_383_cov_2.760563	169	249	250	1	80	0.0125000
NODE_87495_length_383_cov_2.760563	169	249	252	1	80	0.0125000
NODE_87495_length_383_cov_2.760563	169	249	258	1	80	0.0125000
NODE_87495_length_383_cov_2.760563	169	249	265	3	80	0.0375000
NODE_87495_length_383_cov_2.760563	169	249	267	2	80	0.0250000
NODE_87495_length_383_cov_2.760563	169	249	269	2	80	0.0250000
NODE_87495_length_383_cov_2.760563	222	302	2	17	80	0.2125000
NODE_87495_length_383_cov_2.760563	222	302	4	9	80	0.1125000
NODE_87495_length_383_cov_2.760563	222	302	12	4	80	0.0500000
NODE_87495_length_383_cov_2.760563	222	302	14	1	80	0.0125000
NODE_87495_length_383_cov_2.760563	222	302	18	1	80	0.0125000
NODE_87495_length_383_cov_2.760563	222	302	22	1	80	0.0125000
NODE_87495_length_383_cov_2.760563	222	302	28	1	80	0.0125000
NODE_87495_length_383_cov_2.760563	222	302	30	4	80	0.0500000
NODE_87495_length_383_cov_2.760563	222	302	34	1	80	0.0125000
NODE_87495_length_383_cov_2.760563	222	302	42	1	80	0.0125000
NODE_87495_length_383_cov_2.760563	222	302	46	2	80	0.0250000
NODE_87495_length_383_cov_2.760563	222	302	48	1	80	0.0125000
NODE_87495_length_383_cov_2.760563	222	302	50	7	80	0.0875000
NODE_87495_length_383_cov_2.760563	222	302	52	2	80	0.0250000
NODE_87495_length_383_cov_2.760563	222	302	54	1	80	0.0125000
NODE_87495_length_383_cov_2.760563	222	302	62	2	80	0.0250000
NODE_87495_length_383_cov_2.760563	222	302	68	1	80	0.0125000
NODE_87495_length_383_cov_2.760563	222	302	76	3	80	0.0375000
NODE_87495_length_383_cov_2.760563	222	302	78	2	80	0.0250000
NODE_87495_length_383_cov_2.760563	222	302	80	2	80	0.0250000
NODE_87495_length_383_cov_2.760563	222	302	88	4	80	0.0500000
NODE_87495_length_383_cov_2.760563	222	302	92	5	80	0.0625000
NODE_87495_length_383_cov_2.760563	222	302	98	1	80	0.0125000
NODE_87495_length_383_cov_2.760563	222	302	106	1	80	0.0125000
NODE_87495_length_383_cov_2.760563	222	302	110	1	80	0.0125000
NODE_87495_length_383_cov_2.760563	222	302	112	2	80	0.0250000
NODE_87495_length_383_cov_2.760563	222	302	114	1	80	0.0125000
NODE_87495_length_383_cov_2.760563	222	302	116	1	80	0.0125000
NODE_87495_length_383_cov_2.760563	222	302	118	1	80	0.0125000
NODE_87566_length_383_cov_2.123239	29	94	0	65	65	1.0000000
NODE_87566_length_383_cov_2.123239	93	173	0	80	80	1.0000000
NODE_87566_length_383_cov_2.123239	146	193	0	47	47	1.0000000
NODE_87634_length_383_cov_1.728873	196	257	4	6	61	0.0983607
NODE_87634_length_383_cov_1.728873	196	257	10	3	61	0.0491803
NODE_87634_length_383_cov_1.728873	196	257	12	3	61	0.0491803
NODE_87634_length_383_cov_1.728873	196	257	13	20	61	0.3278688
NODE_87634_length_383_cov_1.728873	196	257	14	1	61	0.0163934
NODE_87634_length_383_cov_1.728873	196	257	15	4	61	0.0655738
NODE_87634_length_383_cov_1.728873	196	257	18	7	61	0.1147541
NODE_87634_length_383_cov_1.728873	196	257	19	16	61	0.2622951
NODE_87634_length_383_cov_1.728873	196	257	20	1	61	0.0163934
NODE_87634_length_383_cov_1.728873	239	310	8	27	71	0.3802817
NODE_87634_length_383_cov_1.728873	239	310	10	10	71	0.1408451
NODE_87634_length_383_cov_1.728873	239	310	12	3	71	0.0422535
NODE_87634_length_383_cov_1.728873	239	310	14	5	71	0.0704225
NODE_87634_length_383_cov_1.728873	239	310	18	15	71	0.2112676
NODE_87634_length_383_cov_1.728873	239	310	19	11	71	0.1549296
NODE_88039_length_382_cov_43.724382	245	325	0	80	80	1.0000000
NODE_88039_length_382_cov_43.724382	298	378	0	80	80	1.0000000
NODE_88040_length_382_cov_35.908127	163	243	0	68	80	0.8500000
NODE_88040_length_382_cov_35.908127	163	243	2	12	80	0.1500000
NODE_88040_length_382_cov_35.908127	216	296	0	80	80	1.0000000
NODE_88040_length_382_cov_35.908127	292	372	0	80	80	1.0000000
NODE_88041_length_382_cov_26.240283	57	137	0	75	80	0.9375000
NODE_88041_length_382_cov_26.240283	57	137	2	5	80	0.0625000
NODE_88041_length_382_cov_26.240283	110	190	0	22	80	0.2750000
NODE_88041_length_382_cov_26.240283	110	190	2	44	80	0.5500000
NODE_88041_length_382_cov_26.240283	110	190	4	14	80	0.1750000
NODE_88054_length_382_cov_5.583039	63	143	0	15	80	0.1875000
NODE_88054_length_382_cov_5.583039	63	143	3	22	80	0.2750000
NODE_88054_length_382_cov_5.583039	63	143	4	43	80	0.5375000
NODE_88054_length_382_cov_5.583039	116	196	0	40	80	0.5000000
NODE_88054_length_382_cov_5.583039	116	196	4	40	80	0.5000000
NODE_88063_length_382_cov_4.837456	19	78	0	59	59	1.0000000
NODE_88067_length_382_cov_4.618375	0	55	0	55	55	1.0000000
NODE_88067_length_382_cov_4.618375	104	184	6	2	80	0.0250000
NODE_88067_length_382_cov_4.618375	104	184	8	3	80	0.0375000
NODE_88067_length_382_cov_4.618375	104	184	9	1	80	0.0125000
NODE_88067_length_382_cov_4.618375	104	184	11	5	80	0.0625000
NODE_88067_length_382_cov_4.618375	104	184	12	64	80	0.8000000
NODE_88067_length_382_cov_4.618375	104	184	14	4	80	0.0500000
NODE_88067_length_382_cov_4.618375	104	184	16	1	80	0.0125000
NODE_88067_length_382_cov_4.618375	157	237	6	23	80	0.2875000
NODE_88067_length_382_cov_4.618375	157	237	8	6	80	0.0750000
NODE_88067_length_382_cov_4.618375	157	237	10	7	80	0.0875000
NODE_88067_length_382_cov_4.618375	157	237	12	39	80	0.4875000
NODE_88067_length_382_cov_4.618375	157	237	14	4	80	0.0500000
NODE_88067_length_382_cov_4.618375	157	237	16	1	80	0.0125000
NODE_88075_length_382_cov_4.268551	71	152	0	81	81	1.0000000
NODE_88075_length_382_cov_4.268551	124	205	0	81	81	1.0000000
NODE_88080_length_382_cov_4.091873	30	92	0	62	62	1.0000000
NODE_88121_length_382_cov_3.031802	173	253	0	80	80	1.0000000
NODE_88121_length_382_cov_3.031802	226	295	0	69	69	1.0000000
NODE_88135_length_382_cov_2.798587	231	293	0	62	62	1.0000000
NODE_88136_length_382_cov_2.791519	195	244	0	6	49	0.1224490
NODE_88136_length_382_cov_2.791519	195	244	2	43	49	0.8775510
NODE_88136_length_382_cov_2.791519	217	297	0	9	80	0.1125000
NODE_88136_length_382_cov_2.791519	217	297	2	71	80	0.8875000
NODE_88164_length_382_cov_2.611307	301	368	0	67	67	1.0000000
NODE_88276_length_382_cov_1.802120	0	60	0	60	60	1.0000000
NODE_88660_length_382_cov_0.738516	48	95	4	47	47	1.0000000
NODE_88660_length_382_cov_0.738516	68	148	4	80	80	1.0000000
NODE_88758_length_381_cov_12.010638	195	274	0	15	79	0.1898734
NODE_88758_length_381_cov_12.010638	195	274	2	64	79	0.8101266
NODE_88865_length_381_cov_2.606383	68	98	0	30	30	1.0000000
NODE_88867_length_381_cov_2.570922	115	175	0	60	60	1.0000000
NODE_88872_length_381_cov_2.514184	225	307	0	61	82	0.7439024
NODE_88872_length_381_cov_2.514184	225	307	2	5	82	0.0609756
NODE_88872_length_381_cov_2.514184	225	307	4	16	82	0.1951219
NODE_88900_length_381_cov_2.198582	193	276	0	26	83	0.3132530
NODE_88900_length_381_cov_2.198582	193	276	2	37	83	0.4457831
NODE_88900_length_381_cov_2.198582	193	276	3	6	83	0.0722892
NODE_88900_length_381_cov_2.198582	193	276	4	14	83	0.1686747
NODE_88935_length_381_cov_1.989362	279	325	0	5	46	0.1086956
NODE_88935_length_381_cov_1.989362	279	325	2	41	46	0.8913044
NODE_89009_length_381_cov_1.663121	51	128	2	9	77	0.1168831
NODE_89009_length_381_cov_1.663121	51	128	4	11	77	0.1428571
NODE_89009_length_381_cov_1.663121	51	128	6	6	77	0.0779221
NODE_89009_length_381_cov_1.663121	51	128	8	45	77	0.5844156
NODE_89009_length_381_cov_1.663121	51	128	10	4	77	0.0519481
NODE_89009_length_381_cov_1.663121	51	128	12	2	77	0.0259740
NODE_89009_length_381_cov_1.663121	101	181	8	21	80	0.2625000
NODE_89009_length_381_cov_1.663121	101	181	10	5	80	0.0625000
NODE_89009_length_381_cov_1.663121	101	181	12	19	80	0.2375000
NODE_89009_length_381_cov_1.663121	101	181	14	35	80	0.4375000
NODE_89090_length_381_cov_1.400709	254	334	0	80	80	1.0000000
NODE_89090_length_381_cov_1.400709	254	334	0	80	80	1.0000000
NODE_89090_length_381_cov_1.400709	309	373	0	64	64	1.0000000
NODE_89482_length_380_cov_57.604982	196	276	0	28	80	0.3500000
NODE_89482_length_380_cov_57.604982	196	276	2	52	80	0.6500000
NODE_89482_length_380_cov_57.604982	249	329	0	80	80	1.0000000
NODE_89482_length_380_cov_57.604982	325	359	0	34	34	1.0000000
NODE_89483_length_380_cov_11.185053	79	161	0	82	82	1.0000000
NODE_89483_length_380_cov_11.185053	134	214	0	80	80	1.0000000
NODE_89491_length_380_cov_5.811388	100	156	0	56	56	1.0000000
NODE_89491_length_380_cov_5.811388	177	213	0	36	36	1.0000000
NODE_89495_length_380_cov_5.377224	242	271	24	5	29	0.1724138
NODE_89495_length_380_cov_5.377224	242	271	26	6	29	0.2068966
NODE_89495_length_380_cov_5.377224	242	271	30	1	29	0.0344828
NODE_89495_length_380_cov_5.377224	242	271	32	5	29	0.1724138
NODE_89495_length_380_cov_5.377224	242	271	34	6	29	0.2068966
NODE_89495_length_380_cov_5.377224	242	271	36	1	29	0.0344828
NODE_89495_length_380_cov_5.377224	242	271	38	1	29	0.0344828
NODE_89495_length_380_cov_5.377224	242	271	40	4	29	0.1379310
NODE_89508_length_380_cov_4.185053	158	230	0	72	72	1.0000000
NODE_89508_length_380_cov_4.185053	159	229	0	70	70	1.0000000
NODE_89508_length_380_cov_4.185053	203	283	0	80	80	1.0000000
NODE_89508_length_380_cov_4.185053	203	283	0	80	80	1.0000000
NODE_89527_length_380_cov_3.423488	164	233	0	4	69	0.0579710
NODE_89527_length_380_cov_3.423488	164	233	2	43	69	0.6231884
NODE_89527_length_380_cov_3.423488	164	233	4	22	69	0.3188406
NODE_89540_length_380_cov_3.153025	188	260	0	2	72	0.0277778
NODE_89540_length_380_cov_3.153025	188	260	2	70	72	0.9722222
NODE_89568_length_380_cov_2.718861	51	131	0	80	80	1.0000000
NODE_89568_length_380_cov_2.718861	104	184	0	80	80	1.0000000
NODE_89658_length_380_cov_1.943060	22	56	4	9	34	0.2647059
NODE_89658_length_380_cov_1.943060	22	56	6	3	34	0.0882353
NODE_89658_length_380_cov_1.943060	22	56	8	22	34	0.6470588
NODE_89750_length_380_cov_1.601423	292	332	29	7	40	0.1750000
NODE_89750_length_380_cov_1.601423	292	332	31	1	40	0.0250000
NODE_89750_length_380_cov_1.601423	292	332	32	1	40	0.0250000
NODE_89750_length_380_cov_1.601423	292	332	33	3	40	0.0750000
NODE_89750_length_380_cov_1.601423	292	332	34	1	40	0.0250000
NODE_89750_length_380_cov_1.601423	292	332	36	1	40	0.0250000
NODE_89750_length_380_cov_1.601423	292	332	37	3	40	0.0750000
NODE_89750_length_380_cov_1.601423	292	332	39	6	40	0.1500000
NODE_89750_length_380_cov_1.601423	292	332	41	8	40	0.2000000
NODE_89750_length_380_cov_1.601423	292	332	43	3	40	0.0750000
NODE_89750_length_380_cov_1.601423	292	332	45	6	40	0.1500000
NODE_89911_length_380_cov_1.088968	312	353	0	41	41	1.0000000
NODE_89911_length_380_cov_1.088968	326	380	0	54	54	1.0000000
NODE_90152_length_379_cov_42.339286	10	90	0	80	80	1.0000000
NODE_90152_length_379_cov_42.339286	86	166	0	80	80	1.0000000
NODE_90152_length_379_cov_42.339286	139	219	0	80	80	1.0000000
NODE_90153_length_379_cov_32.075000	0	62	0	62	62	1.0000000
NODE_90165_length_379_cov_5.607143	279	338	0	59	59	1.0000000
NODE_90180_length_379_cov_4.432143	219	243	2	14	24	0.5833333
NODE_90180_length_379_cov_4.432143	219	243	4	10	24	0.4166667
NODE_90193_length_379_cov_3.778571	271	300	0	17	29	0.5862069
NODE_90193_length_379_cov_3.778571	271	300	2	3	29	0.1034483
NODE_90193_length_379_cov_3.778571	271	300	4	9	29	0.3103448
NODE_90198_length_379_cov_3.585714	128	152	0	24	24	1.0000000
NODE_90198_length_379_cov_3.585714	169	249	0	80	80	1.0000000
NODE_90203_length_379_cov_3.375000	19	43	0	24	24	1.0000000
NODE_90247_length_379_cov_2.692857	121	201	0	80	80	1.0000000
NODE_90247_length_379_cov_2.692857	174	221	0	47	47	1.0000000
NODE_90789_length_378_cov_53.039427	147	227	0	80	80	1.0000000
NODE_90789_length_378_cov_53.039427	200	280	0	80	80	1.0000000
NODE_90789_length_378_cov_53.039427	276	356	0	80	80	1.0000000
NODE_90789_length_378_cov_53.039427	329	378	0	49	49	1.0000000
NODE_90794_length_378_cov_6.569892	223	304	4	37	81	0.4567901
NODE_90794_length_378_cov_6.569892	223	304	6	44	81	0.5432099
NODE_90795_length_378_cov_6.444444	217	297	0	80	80	1.0000000
NODE_90795_length_378_cov_6.444444	270	350	0	80	80	1.0000000
NODE_90808_length_378_cov_4.899642	135	191	4	26	56	0.4642857
NODE_90808_length_378_cov_4.899642	135	191	5	1	56	0.0178571
NODE_90808_length_378_cov_4.899642	135	191	6	29	56	0.5178571
NODE_90855_length_378_cov_3.236559	143	212	4	69	69	1.0000000
NODE_90859_length_378_cov_3.132616	238	280	0	42	42	1.0000000
NODE_90898_length_378_cov_2.534050	203	243	0	40	40	1.0000000
NODE_90898_length_378_cov_2.534050	271	347	0	76	76	1.0000000
NODE_90898_length_378_cov_2.534050	331	360	0	29	29	1.0000000
NODE_90948_length_378_cov_2.093190	179	250	0	71	71	1.0000000
NODE_90948_length_378_cov_2.093190	183	219	0	36	36	1.0000000
NODE_91002_length_378_cov_1.813620	36	89	0	53	53	1.0000000
NODE_91475_length_377_cov_71.723022	19	99	0	1	80	0.0125000
NODE_91475_length_377_cov_71.723022	19	99	2	25	80	0.3125000
NODE_91475_length_377_cov_71.723022	19	99	4	15	80	0.1875000
NODE_91475_length_377_cov_71.723022	19	99	6	39	80	0.4875000
NODE_91475_length_377_cov_71.723022	72	152	2	14	80	0.1750000
NODE_91475_length_377_cov_71.723022	72	152	4	13	80	0.1625000
NODE_91475_length_377_cov_71.723022	72	152	6	53	80	0.6625000
NODE_91475_length_377_cov_71.723022	148	228	0	45	80	0.5625000
NODE_91475_length_377_cov_71.723022	148	228	2	35	80	0.4375000
NODE_91475_length_377_cov_71.723022	201	281	0	28	80	0.3500000
NODE_91475_length_377_cov_71.723022	201	281	2	20	80	0.2500000
NODE_91475_length_377_cov_71.723022	201	281	4	32	80	0.4000000
NODE_91477_length_377_cov_41.787770	210	290	2	80	80	1.0000000
NODE_91477_length_377_cov_41.787770	263	343	0	50	80	0.6250000
NODE_91477_length_377_cov_41.787770	263	343	2	30	80	0.3750000
NODE_91478_length_377_cov_9.982014	32	83	8	51	51	1.0000000
NODE_91486_length_377_cov_6.244604	101	177	0	41	76	0.5394737
NODE_91486_length_377_cov_6.244604	101	177	2	35	76	0.4605263
NODE_91494_length_377_cov_5.183453	169	224	0	55	55	1.0000000
NODE_91499_length_377_cov_4.586331	186	266	0	80	80	1.0000000
NODE_91499_length_377_cov_4.586331	239	319	0	80	80	1.0000000
NODE_91500_length_377_cov_4.431655	139	216	0	77	77	1.0000000
NODE_91502_length_377_cov_4.330935	134	214	0	59	80	0.7375000
NODE_91502_length_377_cov_4.330935	134	214	2	21	80	0.2625000
NODE_91502_length_377_cov_4.330935	187	267	0	80	80	1.0000000
NODE_91506_length_377_cov_4.032374	124	181	4	57	57	1.0000000
NODE_91506_length_377_cov_4.032374	154	201	2	2	47	0.0425532
NODE_91506_length_377_cov_4.032374	154	201	4	45	47	0.9574468
NODE_91526_length_377_cov_3.615108	82	140	0	58	58	1.0000000
NODE_91526_length_377_cov_3.615108	82	140	0	58	58	1.0000000
NODE_91526_length_377_cov_3.615108	113	193	0	80	80	1.0000000
NODE_91526_length_377_cov_3.615108	113	193	0	80	80	1.0000000
NODE_91526_length_377_cov_3.615108	189	258	0	69	69	1.0000000
NODE_91526_length_377_cov_3.615108	243	313	0	70	70	1.0000000
NODE_91553_length_377_cov_2.913669	38	61	2	23	23	1.0000000
NODE_91553_length_377_cov_2.913669	167	228	0	61	61	1.0000000
NODE_91619_length_377_cov_2.104317	137	188	0	17	51	0.3333333
NODE_91619_length_377_cov_2.104317	137	188	2	34	51	0.6666667
NODE_91619_length_377_cov_2.104317	168	211	2	43	43	1.0000000
NODE_91619_length_377_cov_2.104317	190	241	2	51	51	1.0000000
NODE_91727_length_377_cov_1.622302	123	181	2	5	58	0.0862069
NODE_91727_length_377_cov_1.622302	123	181	4	2	58	0.0344828
NODE_91727_length_377_cov_1.622302	123	181	6	51	58	0.8793104
NODE_91727_length_377_cov_1.622302	176	234	0	40	58	0.6896552
NODE_91727_length_377_cov_1.622302	176	234	2	11	58	0.1896552
NODE_91727_length_377_cov_1.622302	176	234	4	1	58	0.0172414
NODE_91727_length_377_cov_1.622302	176	234	6	6	58	0.1034483
NODE_91749_length_377_cov_1.539568	230	310	1	31	80	0.3875000
NODE_91749_length_377_cov_1.539568	230	310	2	47	80	0.5875000
NODE_91749_length_377_cov_1.539568	230	310	4	2	80	0.0250000
NODE_91749_length_377_cov_1.539568	230	310	1	31	80	0.3875000
NODE_91749_length_377_cov_1.539568	230	310	2	47	80	0.5875000
NODE_91749_length_377_cov_1.539568	230	310	4	2	80	0.0250000
NODE_91749_length_377_cov_1.539568	306	377	0	21	71	0.2957746
NODE_91749_length_377_cov_1.539568	306	377	1	11	71	0.1549296
NODE_91749_length_377_cov_1.539568	306	377	2	28	71	0.3943662
NODE_91749_length_377_cov_1.539568	306	377	3	11	71	0.1549296
NODE_91749_length_377_cov_1.539568	327	351	2	23	24	0.9583333
NODE_91749_length_377_cov_1.539568	327	351	3	1	24	0.0416667
NODE_91765_length_377_cov_1.471223	118	198	2	24	80	0.3000000
NODE_91765_length_377_cov_1.471223	118	198	3	2	80	0.0250000
NODE_91765_length_377_cov_1.471223	118	198	4	15	80	0.1875000
NODE_91765_length_377_cov_1.471223	118	198	6	32	80	0.4000000
NODE_91765_length_377_cov_1.471223	118	198	8	7	80	0.0875000
NODE_91790_length_377_cov_1.456835	177	257	0	80	80	1.0000000
NODE_91790_length_377_cov_1.456835	230	310	0	80	80	1.0000000
NODE_91817_length_377_cov_1.330935	0	44	0	44	44	1.0000000
NODE_91817_length_377_cov_1.330935	45	117	0	72	72	1.0000000
NODE_92046_length_377_cov_0.762590	299	330	0	31	31	1.0000000
NODE_92166_length_376_cov_6.938628	0	63	0	7	63	0.1111111
NODE_92166_length_376_cov_6.938628	0	63	2	27	63	0.4285714
NODE_92166_length_376_cov_6.938628	0	63	4	6	63	0.0952381
NODE_92166_length_376_cov_6.938628	0	63	6	7	63	0.1111111
NODE_92166_length_376_cov_6.938628	0	63	8	8	63	0.1269841
NODE_92166_length_376_cov_6.938628	0	63	10	1	63	0.0158730
NODE_92166_length_376_cov_6.938628	0	63	12	1	63	0.0158730
NODE_92166_length_376_cov_6.938628	0	63	14	2	63	0.0317460
NODE_92166_length_376_cov_6.938628	0	63	16	1	63	0.0158730
NODE_92166_length_376_cov_6.938628	0	63	18	3	63	0.0476190
NODE_92166_length_376_cov_6.938628	269	340	14	19	71	0.2676056
NODE_92166_length_376_cov_6.938628	269	340	16	4	71	0.0563380
NODE_92166_length_376_cov_6.938628	269	340	18	4	71	0.0563380
NODE_92166_length_376_cov_6.938628	269	340	20	11	71	0.1549296
NODE_92166_length_376_cov_6.938628	269	340	22	33	71	0.4647887
NODE_92168_length_376_cov_6.415162	177	257	0	80	80	1.0000000
NODE_92168_length_376_cov_6.415162	230	310	0	80	80	1.0000000
NODE_92173_length_376_cov_5.722022	100	171	0	7	71	0.0985916
NODE_92173_length_376_cov_5.722022	100	171	2	2	71	0.0281690
NODE_92173_length_376_cov_5.722022	100	171	4	14	71	0.1971831
NODE_92173_length_376_cov_5.722022	100	171	6	48	71	0.6760563
NODE_92173_length_376_cov_5.722022	155	192	2	2	37	0.0540541
NODE_92173_length_376_cov_5.722022	155	192	4	6	37	0.1621622
NODE_92173_length_376_cov_5.722022	155	192	6	29	37	0.7837838
NODE_92191_length_376_cov_4.148014	300	330	0	30	30	1.0000000
NODE_92196_length_376_cov_3.859206	168	236	2	68	68	1.0000000
NODE_92219_length_376_cov_3.140794	122	188	0	66	66	1.0000000
NODE_92442_length_376_cov_1.516245	57	106	8	9	49	0.1836735
NODE_92442_length_376_cov_1.516245	57	106	10	5	49	0.1020408
NODE_92442_length_376_cov_1.516245	57	106	12	35	49	0.7142857
NODE_92879_length_375_cov_4.217391	321	350	2	29	29	1.0000000
NODE_92897_length_375_cov_3.699275	287	367	0	80	80	1.0000000
NODE_92911_length_375_cov_3.376812	70	136	2	35	66	0.5303030
NODE_92911_length_375_cov_3.376812	70	136	4	31	66	0.4696970
NODE_93031_length_375_cov_2.032609	162	224	2	29	62	0.4677419
NODE_93031_length_375_cov_2.032609	162	224	4	21	62	0.3387097
NODE_93031_length_375_cov_2.032609	162	224	6	12	62	0.1935484
NODE_93031_length_375_cov_2.032609	215	272	2	14	57	0.2456140
NODE_93031_length_375_cov_2.032609	215	272	4	9	57	0.1578947
NODE_93031_length_375_cov_2.032609	215	272	6	18	57	0.3157895
NODE_93031_length_375_cov_2.032609	215	272	8	16	57	0.2807018
NODE_93050_length_375_cov_1.967391	131	190	2	1	59	0.0169492
NODE_93050_length_375_cov_1.967391	131	190	4	58	59	0.9830508
NODE_93050_length_375_cov_1.967391	184	235	0	6	51	0.1176471
NODE_93050_length_375_cov_1.967391	184	235	2	31	51	0.6078432
NODE_93050_length_375_cov_1.967391	184	235	4	14	51	0.2745098
NODE_93081_length_375_cov_1.840580	195	276	0	81	81	1.0000000
NODE_93386_length_375_cov_1.000000	320	375	0	55	55	1.0000000
NODE_93609_length_374_cov_4.563636	93	160	0	62	67	0.9253731
NODE_93609_length_374_cov_4.563636	93	160	4	4	67	0.0597015
NODE_93609_length_374_cov_4.563636	93	160	6	1	67	0.0149254
NODE_93609_length_374_cov_4.563636	146	213	0	67	67	1.0000000
NODE_93612_length_374_cov_4.523636	23	101	0	3	78	0.0384615
NODE_93612_length_374_cov_4.523636	23	101	2	75	78	0.9615384
NODE_93612_length_374_cov_4.523636	81	154	0	26	73	0.3561644
NODE_93612_length_374_cov_4.523636	81	154	2	47	73	0.6438356
NODE_93628_length_374_cov_3.810909	130	189	0	8	59	0.1355932
NODE_93628_length_374_cov_3.810909	130	189	2	5	59	0.0847458
NODE_93628_length_374_cov_3.810909	130	189	4	3	59	0.0508475
NODE_93628_length_374_cov_3.810909	130	189	6	16	59	0.2711864
NODE_93628_length_374_cov_3.810909	130	189	8	27	59	0.4576271
NODE_93628_length_374_cov_3.810909	162	242	8	32	80	0.4000000
NODE_93628_length_374_cov_3.810909	162	242	10	6	80	0.0750000
NODE_93628_length_374_cov_3.810909	162	242	12	16	80	0.2000000
NODE_93628_length_374_cov_3.810909	162	242	14	8	80	0.1000000
NODE_93628_length_374_cov_3.810909	162	242	15	1	80	0.0125000
NODE_93628_length_374_cov_3.810909	162	242	16	17	80	0.2125000
NODE_93630_length_374_cov_3.789091	236	271	5	34	35	0.9714286
NODE_93630_length_374_cov_3.789091	236	271	6	1	35	0.0285714
NODE_93630_length_374_cov_3.789091	238	280	2	3	42	0.0714286
NODE_93630_length_374_cov_3.789091	238	280	5	39	42	0.9285714
NODE_93637_length_374_cov_3.458182	190	248	0	54	58	0.9310345
NODE_93637_length_374_cov_3.458182	190	248	2	4	58	0.0689655
NODE_93688_length_374_cov_2.600000	142	217	0	23	75	0.3066667
NODE_93688_length_374_cov_2.600000	142	217	2	25	75	0.3333333
NODE_93688_length_374_cov_2.600000	142	217	4	27	75	0.3600000
NODE_93688_length_374_cov_2.600000	190	270	4	46	80	0.5750000
NODE_93688_length_374_cov_2.600000	190	270	6	6	80	0.0750000
NODE_93688_length_374_cov_2.600000	190	270	11	1	80	0.0125000
NODE_93688_length_374_cov_2.600000	190	270	12	27	80	0.3375000
NODE_93718_length_374_cov_2.330909	40	120	0	80	80	1.0000000
NODE_93769_length_374_cov_2.010909	40	105	0	65	65	1.0000000
NODE_93821_length_374_cov_1.796364	254	288	0	34	34	1.0000000
NODE_93852_length_374_cov_1.661818	95	157	0	2	62	0.0322581
NODE_93852_length_374_cov_1.661818	95	157	2	60	62	0.9677419
NODE_93859_length_374_cov_1.621818	202	254	0	52	52	1.0000000
NODE_93936_length_374_cov_1.360000	211	291	0	55	80	0.6875000
NODE_93936_length_374_cov_1.360000	211	291	2	25	80	0.3125000
NODE_93981_length_374_cov_1.236364	263	336	0	73	73	1.0000000
NODE_94321_length_373_cov_31.302920	0	53	4	1	53	0.0188679
NODE_94321_length_373_cov_31.302920	0	53	6	1	53	0.0188679
NODE_94321_length_373_cov_31.302920	0	53	7	7	53	0.1320755
NODE_94321_length_373_cov_31.302920	0	53	9	1	53	0.0188679
NODE_94321_length_373_cov_31.302920	0	53	11	14	53	0.2641509
NODE_94321_length_373_cov_31.302920	0	53	12	3	53	0.0566038
NODE_94321_length_373_cov_31.302920	0	53	18	9	53	0.1698113
NODE_94321_length_373_cov_31.302920	0	53	20	5	53	0.0943396
NODE_94321_length_373_cov_31.302920	0	53	24	7	53	0.1320755
NODE_94321_length_373_cov_31.302920	0	53	26	5	53	0.0943396
NODE_94321_length_373_cov_31.302920	0	53	4	1	53	0.0188679
NODE_94321_length_373_cov_31.302920	0	53	6	1	53	0.0188679
NODE_94321_length_373_cov_31.302920	0	53	7	7	53	0.1320755
NODE_94321_length_373_cov_31.302920	0	53	9	1	53	0.0188679
NODE_94321_length_373_cov_31.302920	0	53	11	14	53	0.2641509
NODE_94321_length_373_cov_31.302920	0	53	12	3	53	0.0566038
NODE_94321_length_373_cov_31.302920	0	53	18	9	53	0.1698113
NODE_94321_length_373_cov_31.302920	0	53	20	5	53	0.0943396
NODE_94321_length_373_cov_31.302920	0	53	24	7	53	0.1320755
NODE_94321_length_373_cov_31.302920	0	53	26	5	53	0.0943396
NODE_94321_length_373_cov_31.302920	0	53	4	1	53	0.0188679
NODE_94321_length_373_cov_31.302920	0	53	6	1	53	0.0188679
NODE_94321_length_373_cov_31.302920	0	53	7	7	53	0.1320755
NODE_94321_length_373_cov_31.302920	0	53	9	1	53	0.0188679
NODE_94321_length_373_cov_31.302920	0	53	11	14	53	0.2641509
NODE_94321_length_373_cov_31.302920	0	53	12	3	53	0.0566038
NODE_94321_length_373_cov_31.302920	0	53	18	9	53	0.1698113
NODE_94321_length_373_cov_31.302920	0	53	20	5	53	0.0943396
NODE_94321_length_373_cov_31.302920	0	53	24	7	53	0.1320755
NODE_94321_length_373_cov_31.302920	0	53	26	5	53	0.0943396
NODE_94321_length_373_cov_31.302920	26	106	12	1	80	0.0125000
NODE_94321_length_373_cov_31.302920	26	106	18	9	80	0.1125000
NODE_94321_length_373_cov_31.302920	26	106	20	5	80	0.0625000
NODE_94321_length_373_cov_31.302920	26	106	24	7	80	0.0875000
NODE_94321_length_373_cov_31.302920	26	106	26	10	80	0.1250000
NODE_94321_length_373_cov_31.302920	26	106	27	1	80	0.0125000
NODE_94321_length_373_cov_31.302920	26	106	28	17	80	0.2125000
NODE_94321_length_373_cov_31.302920	26	106	30	30	80	0.3750000
NODE_94340_length_373_cov_4.671533	76	142	2	66	66	1.0000000
NODE_94340_length_373_cov_4.671533	115	195	0	17	80	0.2125000
NODE_94340_length_373_cov_4.671533	115	195	2	63	80	0.7875000
NODE_94340_length_373_cov_4.671533	115	195	0	17	80	0.2125000
NODE_94340_length_373_cov_4.671533	115	195	2	63	80	0.7875000
NODE_94340_length_373_cov_4.671533	288	368	0	80	80	1.0000000
NODE_94352_length_373_cov_4.080292	109	189	4	80	80	1.0000000
NODE_94352_length_373_cov_4.080292	162	220	2	9	58	0.1551724
NODE_94352_length_373_cov_4.080292	162	220	4	27	58	0.4655173
NODE_94352_length_373_cov_4.080292	162	220	6	22	58	0.3793103
NODE_94380_length_373_cov_3.167883	131	210	0	79	79	1.0000000
NODE_94414_length_373_cov_2.751825	80	151	0	30	71	0.4225352
NODE_94414_length_373_cov_2.751825	80	151	1	1	71	0.0140845
NODE_94414_length_373_cov_2.751825	80	151	2	40	71	0.5633803
NODE_94414_length_373_cov_2.751825	124	162	0	29	38	0.7631579
NODE_94414_length_373_cov_2.751825	124	162	2	8	38	0.2105263
NODE_94414_length_373_cov_2.751825	124	162	4	1	38	0.0263158
NODE_94493_length_373_cov_2.036496	248	326	0	69	78	0.8846154
NODE_94493_length_373_cov_2.036496	248	326	2	9	78	0.1153846
NODE_94493_length_373_cov_2.036496	299	359	0	60	60	1.0000000
NODE_94500_length_373_cov_2.003650	150	194	0	44	44	1.0000000
NODE_94937_length_373_cov_0.759124	62	114	4	46	52	0.8846154
NODE_94937_length_373_cov_0.759124	62	114	5	6	52	0.1153846
NODE_95051_length_372_cov_30.135531	111	191	0	80	80	1.0000000
NODE_95051_length_372_cov_30.135531	159	222	0	63	63	1.0000000
NODE_95051_length_372_cov_30.135531	164	239	0	75	75	1.0000000
NODE_95051_length_372_cov_30.135531	182	253	0	71	71	1.0000000
NODE_95051_length_372_cov_30.135531	195	275	0	80	80	1.0000000
NODE_95051_length_372_cov_30.135531	213	276	0	63	63	1.0000000
NODE_95053_length_372_cov_9.091575	150	230	0	80	80	1.0000000
NODE_95053_length_372_cov_9.091575	203	283	0	80	80	1.0000000
NODE_95063_length_372_cov_5.706960	168	208	0	40	40	1.0000000
NODE_95067_length_372_cov_5.124542	146	211	1	12	65	0.1846154
NODE_95067_length_372_cov_5.124542	146	211	2	53	65	0.8153846
NODE_95067_length_372_cov_5.124542	189	264	2	75	75	1.0000000
NODE_95090_length_372_cov_3.761905	177	221	0	44	44	1.0000000
NODE_95109_length_372_cov_3.186813	137	218	0	81	81	1.0000000
NODE_95159_length_372_cov_2.582418	167	239	8	5	72	0.0694444
NODE_95159_length_372_cov_2.582418	167	239	10	3	72	0.0416667
NODE_95159_length_372_cov_2.582418	167	239	14	8	72	0.1111111
NODE_95159_length_372_cov_2.582418	167	239	16	1	72	0.0138889
NODE_95159_length_372_cov_2.582418	167	239	18	3	72	0.0416667
NODE_95159_length_372_cov_2.582418	167	239	20	6	72	0.0833333
NODE_95159_length_372_cov_2.582418	167	239	22	17	72	0.2361111
NODE_95159_length_372_cov_2.582418	167	239	24	28	72	0.3888889
NODE_95159_length_372_cov_2.582418	167	239	26	1	72	0.0138889
NODE_95159_length_372_cov_2.582418	212	292	2	1	80	0.0125000
NODE_95159_length_372_cov_2.582418	212	292	4	10	80	0.1250000
NODE_95159_length_372_cov_2.582418	212	292	6	5	80	0.0625000
NODE_95159_length_372_cov_2.582418	212	292	7	1	80	0.0125000
NODE_95159_length_372_cov_2.582418	212	292	12	1	80	0.0125000
NODE_95159_length_372_cov_2.582418	212	292	14	3	80	0.0375000
NODE_95159_length_372_cov_2.582418	212	292	15	15	80	0.1875000
NODE_95159_length_372_cov_2.582418	212	292	19	2	80	0.0250000
NODE_95159_length_372_cov_2.582418	212	292	20	2	80	0.0250000
NODE_95159_length_372_cov_2.582418	212	292	22	2	80	0.0250000
NODE_95159_length_372_cov_2.582418	212	292	24	27	80	0.3375000
NODE_95159_length_372_cov_2.582418	212	292	26	11	80	0.1375000
NODE_95183_length_372_cov_2.347985	97	141	2	44	44	1.0000000
NODE_95183_length_372_cov_2.347985	98	133	2	35	35	1.0000000
NODE_95183_length_372_cov_2.347985	178	243	2	14	65	0.2153846
NODE_95183_length_372_cov_2.347985	178	243	4	51	65	0.7846154
NODE_95303_length_372_cov_1.699634	195	276	0	2	81	0.0246914
NODE_95303_length_372_cov_1.699634	195	276	2	29	81	0.3580247
NODE_95303_length_372_cov_1.699634	195	276	4	10	81	0.1234568
NODE_95303_length_372_cov_1.699634	195	276	5	1	81	0.0123457
NODE_95303_length_372_cov_1.699634	195	276	6	39	81	0.4814815
NODE_95453_length_372_cov_1.223443	264	334	0	31	70	0.4428571
NODE_95453_length_372_cov_1.223443	264	334	2	39	70	0.5571429
NODE_95784_length_371_cov_52.040441	104	184	0	74	80	0.9250000
NODE_95784_length_371_cov_52.040441	104	184	2	2	80	0.0250000
NODE_95784_length_371_cov_52.040441	104	184	4	1	80	0.0125000
NODE_95784_length_371_cov_52.040441	104	184	6	3	80	0.0375000
NODE_95784_length_371_cov_52.040441	157	237	0	21	80	0.2625000
NODE_95784_length_371_cov_52.040441	157	237	2	2	80	0.0250000
NODE_95784_length_371_cov_52.040441	157	237	4	1	80	0.0125000
NODE_95784_length_371_cov_52.040441	157	237	6	16	80	0.2000000
NODE_95784_length_371_cov_52.040441	157	237	7	3	80	0.0375000
NODE_95784_length_371_cov_52.040441	157	237	8	12	80	0.1500000
NODE_95784_length_371_cov_52.040441	157	237	10	8	80	0.1000000
NODE_95784_length_371_cov_52.040441	157	237	12	3	80	0.0375000
NODE_95784_length_371_cov_52.040441	157	237	14	10	80	0.1250000
NODE_95784_length_371_cov_52.040441	157	237	16	4	80	0.0500000
NODE_95784_length_371_cov_52.040441	180	232	4	1	52	0.0192308
NODE_95784_length_371_cov_52.040441	180	232	6	16	52	0.3076923
NODE_95784_length_371_cov_52.040441	180	232	7	3	52	0.0576923
NODE_95784_length_371_cov_52.040441	180	232	8	12	52	0.2307692
NODE_95784_length_371_cov_52.040441	180	232	10	8	52	0.1538462
NODE_95784_length_371_cov_52.040441	180	232	12	3	52	0.0576923
NODE_95784_length_371_cov_52.040441	180	232	14	9	52	0.1730769
NODE_95785_length_371_cov_24.878676	91	171	0	78	80	0.9750000
NODE_95785_length_371_cov_24.878676	91	171	2	2	80	0.0250000
NODE_95785_length_371_cov_24.878676	144	224	0	25	80	0.3125000
NODE_95785_length_371_cov_24.878676	144	224	2	4	80	0.0500000
NODE_95785_length_371_cov_24.878676	144	224	4	51	80	0.6375000
NODE_95797_length_371_cov_5.738971	170	245	0	17	75	0.2266667
NODE_95797_length_371_cov_5.738971	170	245	1	2	75	0.0266667
NODE_95797_length_371_cov_5.738971	170	245	3	2	75	0.0266667
NODE_95797_length_371_cov_5.738971	170	245	4	28	75	0.3733333
NODE_95797_length_371_cov_5.738971	170	245	6	8	75	0.1066667
NODE_95797_length_371_cov_5.738971	170	245	10	6	75	0.0800000
NODE_95797_length_371_cov_5.738971	170	245	12	8	75	0.1066667
NODE_95797_length_371_cov_5.738971	170	245	14	4	75	0.0533333
NODE_95797_length_371_cov_5.738971	218	298	4	1	80	0.0125000
NODE_95797_length_371_cov_5.738971	218	298	6	8	80	0.1000000
NODE_95797_length_371_cov_5.738971	218	298	10	6	80	0.0750000
NODE_95797_length_371_cov_5.738971	218	298	12	8	80	0.1000000
NODE_95797_length_371_cov_5.738971	218	298	14	8	80	0.1000000
NODE_95797_length_371_cov_5.738971	218	298	16	27	80	0.3375000
NODE_95797_length_371_cov_5.738971	218	298	18	22	80	0.2750000
NODE_95807_length_371_cov_4.452206	65	145	0	16	80	0.2000000
NODE_95807_length_371_cov_4.452206	65	145	8	64	80	0.8000000
NODE_95807_length_371_cov_4.452206	118	198	8	58	80	0.7250000
NODE_95807_length_371_cov_4.452206	118	198	10	22	80	0.2750000
NODE_95863_length_371_cov_2.841912	288	350	0	60	62	0.9677419
NODE_95863_length_371_cov_2.841912	288	350	14	2	62	0.0322581
NODE_96013_length_371_cov_1.790441	188	235	0	47	47	1.0000000
NODE_96105_length_371_cov_1.422794	199	287	0	88	88	1.0000000
NODE_96500_length_370_cov_50.380074	144	224	0	80	80	1.0000000
NODE_96500_length_370_cov_50.380074	197	277	0	80	80	1.0000000
NODE_96504_length_370_cov_7.553506	105	162	2	57	57	1.0000000
NODE_96510_length_370_cov_5.811808	153	221	0	68	68	1.0000000
NODE_96510_length_370_cov_5.811808	206	286	0	80	80	1.0000000
NODE_96522_length_370_cov_4.915129	157	207	0	20	50	0.4000000
NODE_96522_length_370_cov_4.915129	157	207	2	30	50	0.6000000
NODE_96528_length_370_cov_4.535055	141	221	0	80	80	1.0000000
NODE_96528_length_370_cov_4.535055	194	274	0	80	80	1.0000000
NODE_96532_length_370_cov_4.199262	230	275	0	45	45	1.0000000
NODE_96533_length_370_cov_4.151292	142	209	0	67	67	1.0000000
NODE_96542_length_370_cov_3.719557	214	251	12	1	37	0.0270270
NODE_96542_length_370_cov_3.719557	214	251	18	18	37	0.4864865
NODE_96542_length_370_cov_3.719557	214	251	20	18	37	0.4864865
NODE_96581_length_370_cov_2.822878	126	173	2	39	47	0.8297873
NODE_96581_length_370_cov_2.822878	126	173	4	8	47	0.1702128
NODE_96668_length_370_cov_2.081181	0	52	0	3	52	0.0576923
NODE_96668_length_370_cov_2.081181	0	52	2	15	52	0.2884615
NODE_96668_length_370_cov_2.081181	0	52	4	7	52	0.1346154
NODE_96668_length_370_cov_2.081181	0	52	6	7	52	0.1346154
NODE_96668_length_370_cov_2.081181	0	52	8	20	52	0.3846154
NODE_97207_length_369_cov_36.811111	273	358	0	24	85	0.2823530
NODE_97207_length_369_cov_36.811111	273	358	8	3	85	0.0352941
NODE_97207_length_369_cov_36.811111	273	358	10	10	85	0.1176471
NODE_97207_length_369_cov_36.811111	273	358	12	3	85	0.0352941
NODE_97207_length_369_cov_36.811111	273	358	14	12	85	0.1411765
NODE_97207_length_369_cov_36.811111	273	358	16	33	85	0.3882353
NODE_97207_length_369_cov_36.811111	273	358	0	24	85	0.2823530
NODE_97207_length_369_cov_36.811111	273	358	8	3	85	0.0352941
NODE_97207_length_369_cov_36.811111	273	358	10	10	85	0.1176471
NODE_97207_length_369_cov_36.811111	273	358	12	3	85	0.0352941
NODE_97207_length_369_cov_36.811111	273	358	14	12	85	0.1411765
NODE_97207_length_369_cov_36.811111	273	358	16	33	85	0.3882353
NODE_97207_length_369_cov_36.811111	273	358	0	24	85	0.2823530
NODE_97207_length_369_cov_36.811111	273	358	8	3	85	0.0352941
NODE_97207_length_369_cov_36.811111	273	358	10	10	85	0.1176471
NODE_97207_length_369_cov_36.811111	273	358	12	3	85	0.0352941
NODE_97207_length_369_cov_36.811111	273	358	14	12	85	0.1411765
NODE_97207_length_369_cov_36.811111	273	358	16	33	85	0.3882353
NODE_97211_length_369_cov_8.751852	107	187	0	80	80	1.0000000
NODE_97226_length_369_cov_6.677778	189	269	0	5	80	0.0625000
NODE_97226_length_369_cov_6.677778	189	269	4	18	80	0.2250000
NODE_97226_length_369_cov_6.677778	189	269	6	57	80	0.7125000
NODE_97226_length_369_cov_6.677778	242	323	0	59	81	0.7283950
NODE_97226_length_369_cov_6.677778	242	323	4	18	81	0.2222222
NODE_97226_length_369_cov_6.677778	242	323	6	4	81	0.0493827
NODE_97236_length_369_cov_5.337037	199	264	0	3	65	0.0461538
NODE_97236_length_369_cov_5.337037	199	264	4	62	65	0.9538462
NODE_97249_length_369_cov_4.459259	89	157	0	68	68	1.0000000
NODE_97249_length_369_cov_4.459259	130	210	0	80	80	1.0000000
NODE_97255_length_369_cov_4.111111	216	279	0	11	63	0.1746032
NODE_97255_length_369_cov_4.111111	216	279	2	52	63	0.8253968
NODE_97265_length_369_cov_3.837037	205	238	0	33	33	1.0000000
NODE_97265_length_369_cov_3.837037	211	291	0	80	80	1.0000000
NODE_97265_length_369_cov_3.837037	287	316	0	29	29	1.0000000
NODE_97346_length_369_cov_2.355556	62	142	0	51	80	0.6375000
NODE_97346_length_369_cov_2.355556	62	142	2	29	80	0.3625000
NODE_97346_length_369_cov_2.355556	114	195	2	70	81	0.8641976
NODE_97346_length_369_cov_2.355556	114	195	4	11	81	0.1358025
NODE_97440_length_369_cov_1.803704	170	235	0	65	65	1.0000000
NODE_97936_length_368_cov_42.208178	231	311	0	80	80	1.0000000
NODE_97936_length_368_cov_42.208178	284	364	0	80	80	1.0000000
NODE_97939_length_368_cov_11.988848	47	127	0	80	80	1.0000000
NODE_97939_length_368_cov_11.988848	100	180	0	80	80	1.0000000
NODE_97945_length_368_cov_6.267658	133	213	0	80	80	1.0000000
NODE_97945_length_368_cov_6.267658	186	266	0	80	80	1.0000000
NODE_97997_length_368_cov_3.486989	127	207	0	80	80	1.0000000
NODE_98008_length_368_cov_3.282528	182	255	4	37	73	0.5068493
NODE_98008_length_368_cov_3.282528	182	255	5	8	73	0.1095890
NODE_98008_length_368_cov_3.282528	182	255	6	28	73	0.3835616
NODE_98058_length_368_cov_2.605948	192	246	0	54	54	1.0000000
NODE_98123_length_368_cov_2.182156	85	145	0	60	60	1.0000000
NODE_98129_length_368_cov_2.137546	66	107	0	2	41	0.0487805
NODE_98129_length_368_cov_2.137546	66	107	2	7	41	0.1707317
NODE_98129_length_368_cov_2.137546	66	107	4	6	41	0.1463415
NODE_98129_length_368_cov_2.137546	66	107	6	17	41	0.4146341
NODE_98129_length_368_cov_2.137546	66	107	8	9	41	0.2195122
NODE_98157_length_368_cov_1.944238	192	272	0	33	80	0.4125000
NODE_98157_length_368_cov_1.944238	192	272	2	21	80	0.2625000
NODE_98157_length_368_cov_1.944238	192	272	4	26	80	0.3250000
NODE_98723_length_367_cov_7.156716	174	254	0	80	80	1.0000000
NODE_98723_length_367_cov_7.156716	227	307	0	80	80	1.0000000
NODE_98734_length_367_cov_5.313433	148	206	0	4	58	0.0689655
NODE_98734_length_367_cov_5.313433	148	206	4	7	58	0.1206897
NODE_98734_length_367_cov_5.313433	148	206	6	7	58	0.1206897
NODE_98734_length_367_cov_5.313433	148	206	8	35	58	0.6034483
NODE_98734_length_367_cov_5.313433	148	206	10	1	58	0.0172414
NODE_98734_length_367_cov_5.313433	148	206	12	4	58	0.0689655
NODE_98737_length_367_cov_5.138060	58	138	0	80	80	1.0000000
NODE_98737_length_367_cov_5.138060	111	191	0	80	80	1.0000000
NODE_98796_length_367_cov_3.059701	110	154	2	10	44	0.2272727
NODE_98796_length_367_cov_3.059701	110	154	4	34	44	0.7727273
NODE_98796_length_367_cov_3.059701	111	146	2	2	35	0.0571429
NODE_98796_length_367_cov_3.059701	111	146	4	33	35	0.9428571
NODE_98843_length_367_cov_2.384328	246	326	0	34	80	0.4250000
NODE_98843_length_367_cov_2.384328	246	326	2	5	80	0.0625000
NODE_98843_length_367_cov_2.384328	246	326	4	41	80	0.5125000
NODE_98843_length_367_cov_2.384328	299	367	0	68	68	1.0000000
NODE_98849_length_367_cov_2.332090	127	207	0	12	80	0.1500000
NODE_98849_length_367_cov_2.332090	127	207	2	68	80	0.8500000
NODE_98909_length_367_cov_1.944030	91	156	2	65	65	1.0000000
NODE_98980_length_367_cov_1.679104	173	252	0	4	79	0.0506329
NODE_98980_length_367_cov_1.679104	173	252	2	36	79	0.4556962
NODE_98980_length_367_cov_1.679104	173	252	4	5	79	0.0632911
NODE_98980_length_367_cov_1.679104	173	252	6	8	79	0.1012658
NODE_98980_length_367_cov_1.679104	173	252	8	4	79	0.0506329
NODE_98980_length_367_cov_1.679104	173	252	10	22	79	0.2784810
NODE_99005_length_367_cov_1.552239	148	200	2	52	52	1.0000000
NODE_99138_length_367_cov_1.201493	79	159	0	57	80	0.7125000
NODE_99138_length_367_cov_1.201493	79	159	2	23	80	0.2875000
NODE_99138_length_367_cov_1.201493	136	179	2	43	43	1.0000000
NODE_99318_length_367_cov_0.761194	288	357	0	69	69	1.0000000
NODE_99451_length_366_cov_5.239700	193	253	0	42	60	0.7000000
NODE_99451_length_366_cov_5.239700	193	253	2	18	60	0.3000000
NODE_99472_length_366_cov_4.168539	302	355	0	53	53	1.0000000
NODE_99478_length_366_cov_3.913858	183	229	0	46	46	1.0000000
NODE_99478_length_366_cov_3.913858	203	282	0	79	79	1.0000000
NODE_99496_length_366_cov_3.168539	88	160	0	72	72	1.0000000
NODE_99496_length_366_cov_3.168539	133	193	0	60	60	1.0000000
NODE_100137_length_365_cov_140.101504	40	107	62	2	67	0.0298507
NODE_100137_length_365_cov_140.101504	40	107	65	1	67	0.0149254
NODE_100137_length_365_cov_140.101504	40	107	66	1	67	0.0149254
NODE_100137_length_365_cov_140.101504	40	107	68	6	67	0.0895522
NODE_100137_length_365_cov_140.101504	40	107	70	2	67	0.0298507
NODE_100137_length_365_cov_140.101504	40	107	72	1	67	0.0149254
NODE_100137_length_365_cov_140.101504	40	107	74	1	67	0.0149254
NODE_100137_length_365_cov_140.101504	40	107	76	1	67	0.0149254
NODE_100137_length_365_cov_140.101504	40	107	78	1	67	0.0149254
NODE_100137_length_365_cov_140.101504	40	107	80	2	67	0.0298507
NODE_100137_length_365_cov_140.101504	40	107	82	2	67	0.0298507
NODE_100137_length_365_cov_140.101504	40	107	90	1	67	0.0149254
NODE_100137_length_365_cov_140.101504	40	107	94	4	67	0.0597015
NODE_100137_length_365_cov_140.101504	40	107	102	1	67	0.0149254
NODE_100137_length_365_cov_140.101504	40	107	104	2	67	0.0298507
NODE_100137_length_365_cov_140.101504	40	107	106	1	67	0.0149254
NODE_100137_length_365_cov_140.101504	40	107	109	1	67	0.0149254
NODE_100137_length_365_cov_140.101504	40	107	111	2	67	0.0298507
NODE_100137_length_365_cov_140.101504	40	107	117	3	67	0.0447761
NODE_100137_length_365_cov_140.101504	40	107	119	1	67	0.0149254
NODE_100137_length_365_cov_140.101504	40	107	121	1	67	0.0149254
NODE_100137_length_365_cov_140.101504	40	107	123	3	67	0.0447761
NODE_100137_length_365_cov_140.101504	40	107	125	1	67	0.0149254
NODE_100137_length_365_cov_140.101504	40	107	127	3	67	0.0447761
NODE_100137_length_365_cov_140.101504	40	107	129	2	67	0.0298507
NODE_100137_length_365_cov_140.101504	40	107	131	1	67	0.0149254
NODE_100137_length_365_cov_140.101504	40	107	132	1	67	0.0149254
NODE_100137_length_365_cov_140.101504	40	107	134	1	67	0.0149254
NODE_100137_length_365_cov_140.101504	40	107	135	3	67	0.0447761
NODE_100137_length_365_cov_140.101504	40	107	137	2	67	0.0298507
NODE_100137_length_365_cov_140.101504	40	107	139	2	67	0.0298507
NODE_100137_length_365_cov_140.101504	40	107	141	10	67	0.1492537
NODE_100137_length_365_cov_140.101504	40	107	143	1	67	0.0149254
NODE_100138_length_365_cov_45.815789	0	38	0	38	38	1.0000000
NODE_100138_length_365_cov_45.815789	11	91	0	80	80	1.0000000
NODE_100140_length_365_cov_8.169173	191	244	0	53	53	1.0000000
NODE_100140_length_365_cov_8.169173	217	297	0	80	80	1.0000000
NODE_100145_length_365_cov_5.954887	136	216	0	51	80	0.6375000
NODE_100145_length_365_cov_5.954887	136	216	2	29	80	0.3625000
NODE_100145_length_365_cov_5.954887	189	269	0	80	80	1.0000000
NODE_100147_length_365_cov_5.721805	37	78	0	41	41	1.0000000
NODE_100168_length_365_cov_4.195489	269	329	2	3	60	0.0500000
NODE_100168_length_365_cov_4.195489	269	329	6	12	60	0.2000000
NODE_100168_length_365_cov_4.195489	269	329	8	7	60	0.1166667
NODE_100168_length_365_cov_4.195489	269	329	10	38	60	0.6333333
NODE_100172_length_365_cov_4.071429	106	186	0	80	80	1.0000000
NODE_100172_length_365_cov_4.071429	159	239	0	80	80	1.0000000
NODE_100180_length_365_cov_3.879699	131	187	2	28	56	0.5000000
NODE_100180_length_365_cov_3.879699	131	187	4	17	56	0.3035714
NODE_100180_length_365_cov_3.879699	131	187	6	2	56	0.0357143
NODE_100180_length_365_cov_3.879699	131	187	8	9	56	0.1607143
NODE_100206_length_365_cov_3.270677	211	280	0	69	69	1.0000000
NODE_100253_length_365_cov_2.601504	189	265	2	40	76	0.5263158
NODE_100253_length_365_cov_2.601504	189	265	4	14	76	0.1842105
NODE_100253_length_365_cov_2.601504	189	265	6	22	76	0.2894737
NODE_100293_length_365_cov_2.289474	169	249	0	19	80	0.2375000
NODE_100293_length_365_cov_2.289474	169	249	2	61	80	0.7625000
NODE_100407_length_365_cov_1.635338	156	235	4	12	79	0.1518987
NODE_100407_length_365_cov_1.635338	156	235	5	1	79	0.0126582
NODE_100407_length_365_cov_1.635338	156	235	9	12	79	0.1518987
NODE_100407_length_365_cov_1.635338	156	235	11	7	79	0.0886076
NODE_100407_length_365_cov_1.635338	156	235	13	1	79	0.0126582
NODE_100407_length_365_cov_1.635338	156	235	17	6	79	0.0759494
NODE_100407_length_365_cov_1.635338	156	235	19	23	79	0.2911392
NODE_100407_length_365_cov_1.635338	156	235	21	17	79	0.2151899
NODE_100485_length_365_cov_1.421053	228	309	0	36	81	0.4444444
NODE_100485_length_365_cov_1.421053	228	309	2	45	81	0.5555556
NODE_100570_length_365_cov_1.169173	57	137	2	44	80	0.5500000
NODE_100570_length_365_cov_1.169173	57	137	4	30	80	0.3750000
NODE_100570_length_365_cov_1.169173	57	137	5	4	80	0.0500000
NODE_100570_length_365_cov_1.169173	57	137	6	2	80	0.0250000
NODE_100570_length_365_cov_1.169173	65	145	2	36	80	0.4500000
NODE_100570_length_365_cov_1.169173	65	145	4	30	80	0.3750000
NODE_100570_length_365_cov_1.169173	65	145	5	4	80	0.0500000
NODE_100570_length_365_cov_1.169173	65	145	6	10	80	0.1250000
NODE_100570_length_365_cov_1.169173	194	274	4	4	80	0.0500000
NODE_100570_length_365_cov_1.169173	194	274	6	58	80	0.7250000
NODE_100570_length_365_cov_1.169173	194	274	8	6	80	0.0750000
NODE_100570_length_365_cov_1.169173	194	274	10	2	80	0.0250000
NODE_100570_length_365_cov_1.169173	194	274	12	10	80	0.1250000
NODE_100893_length_364_cov_24.600000	101	181	0	80	80	1.0000000
NODE_100893_length_364_cov_24.600000	154	234	0	80	80	1.0000000
NODE_100896_length_364_cov_7.377358	0	50	0	50	50	1.0000000
NODE_100933_length_364_cov_3.988679	122	168	0	46	46	1.0000000
NODE_100935_length_364_cov_3.913208	151	208	0	36	57	0.6315789
NODE_100935_length_364_cov_3.913208	151	208	3	1	57	0.0175439
NODE_100935_length_364_cov_3.913208	151	208	4	14	57	0.2456140
NODE_100935_length_364_cov_3.913208	151	208	6	6	57	0.1052632
NODE_100959_length_364_cov_3.305660	296	358	3	7	62	0.1129032
NODE_100959_length_364_cov_3.305660	296	358	4	3	62	0.0483871
NODE_100959_length_364_cov_3.305660	296	358	5	6	62	0.0967742
NODE_100959_length_364_cov_3.305660	296	358	6	46	62	0.7419355
NODE_100966_length_364_cov_3.181132	78	138	0	55	60	0.9166667
NODE_100966_length_364_cov_3.181132	78	138	2	5	60	0.0833333
NODE_100975_length_364_cov_3.041509	264	321	0	57	57	1.0000000
NODE_100975_length_364_cov_3.041509	294	359	0	65	65	1.0000000
NODE_100978_length_364_cov_3.015094	238	274	0	36	36	1.0000000
NODE_101087_length_364_cov_1.977358	126	201	4	35	75	0.4666667
NODE_101087_length_364_cov_1.977358	126	201	6	40	75	0.5333334
NODE_101141_length_364_cov_1.811321	209	256	0	47	47	1.0000000
NODE_101148_length_364_cov_1.781132	130	203	0	2	73	0.0273973
NODE_101148_length_364_cov_1.781132	130	203	2	71	73	0.9726027
NODE_101148_length_364_cov_1.781132	183	203	0	2	20	0.1000000
NODE_101148_length_364_cov_1.781132	183	203	2	18	20	0.9000000
NODE_101720_length_363_cov_7.791667	121	200	0	79	79	1.0000000
NODE_101725_length_363_cov_6.484848	33	90	4	8	57	0.1403509
NODE_101725_length_363_cov_6.484848	33	90	7	2	57	0.0350877
NODE_101725_length_363_cov_6.484848	33	90	8	19	57	0.3333333
NODE_101725_length_363_cov_6.484848	33	90	10	28	57	0.4912281
NODE_101725_length_363_cov_6.484848	93	146	0	2	53	0.0377358
NODE_101725_length_363_cov_6.484848	93	146	2	7	53	0.1320755
NODE_101725_length_363_cov_6.484848	93	146	6	5	53	0.0943396
NODE_101725_length_363_cov_6.484848	93	146	8	22	53	0.4150943
NODE_101725_length_363_cov_6.484848	93	146	10	17	53	0.3207547
NODE_101734_length_363_cov_4.825758	154	215	0	4	61	0.0655738
NODE_101734_length_363_cov_4.825758	154	215	4	57	61	0.9344262
NODE_101760_length_363_cov_3.950758	112	183	0	71	71	1.0000000
NODE_101760_length_363_cov_3.950758	156	236	0	80	80	1.0000000
NODE_101769_length_363_cov_3.617424	16	79	2	63	63	1.0000000
NODE_101774_length_363_cov_3.409091	241	267	0	26	26	1.0000000
NODE_101791_length_363_cov_3.087121	228	308	0	21	80	0.2625000
NODE_101791_length_363_cov_3.087121	228	308	2	11	80	0.1375000
NODE_101791_length_363_cov_3.087121	228	308	4	11	80	0.1375000
NODE_101791_length_363_cov_3.087121	228	308	6	37	80	0.4625000
NODE_101809_length_363_cov_2.795455	240	320	16	1	80	0.0125000
NODE_101809_length_363_cov_2.795455	240	320	22	5	80	0.0625000
NODE_101809_length_363_cov_2.795455	240	320	24	1	80	0.0125000
NODE_101809_length_363_cov_2.795455	240	320	26	9	80	0.1125000
NODE_101809_length_363_cov_2.795455	240	320	28	4	80	0.0500000
NODE_101809_length_363_cov_2.795455	240	320	30	5	80	0.0625000
NODE_101809_length_363_cov_2.795455	240	320	32	3	80	0.0375000
NODE_101809_length_363_cov_2.795455	240	320	34	7	80	0.0875000
NODE_101809_length_363_cov_2.795455	240	320	36	4	80	0.0500000
NODE_101809_length_363_cov_2.795455	240	320	38	1	80	0.0125000
NODE_101809_length_363_cov_2.795455	240	320	42	2	80	0.0250000
NODE_101809_length_363_cov_2.795455	240	320	44	4	80	0.0500000
NODE_101809_length_363_cov_2.795455	240	320	46	1	80	0.0125000
NODE_101809_length_363_cov_2.795455	240	320	47	9	80	0.1125000
NODE_101809_length_363_cov_2.795455	240	320	48	2	80	0.0250000
NODE_101809_length_363_cov_2.795455	240	320	49	4	80	0.0500000
NODE_101809_length_363_cov_2.795455	240	320	51	2	80	0.0250000
NODE_101809_length_363_cov_2.795455	240	320	53	8	80	0.1000000
NODE_101809_length_363_cov_2.795455	240	320	55	7	80	0.0875000
NODE_101809_length_363_cov_2.795455	240	320	57	1	80	0.0125000
NODE_101822_length_363_cov_2.481061	86	166	0	80	80	1.0000000
NODE_101822_length_363_cov_2.481061	139	219	0	80	80	1.0000000
NODE_101879_length_363_cov_2.034091	46	126	0	80	80	1.0000000
NODE_101879_length_363_cov_2.034091	99	153	0	54	54	1.0000000
NODE_101992_length_363_cov_1.541667	235	315	0	76	80	0.9500000
NODE_101992_length_363_cov_1.541667	235	315	2	4	80	0.0500000
NODE_102022_length_363_cov_1.477273	141	202	2	9	61	0.1475410
NODE_102022_length_363_cov_1.477273	141	202	4	27	61	0.4426230
NODE_102022_length_363_cov_1.477273	141	202	6	24	61	0.3934426
NODE_102022_length_363_cov_1.477273	141	202	8	1	61	0.0163934
NODE_102022_length_363_cov_1.477273	153	210	4	24	57	0.4210526
NODE_102022_length_363_cov_1.477273	153	210	6	32	57	0.5614035
NODE_102022_length_363_cov_1.477273	153	210	8	1	57	0.0175439
NODE_102187_length_363_cov_1.113636	245	316	0	71	71	1.0000000
NODE_102464_length_362_cov_54.927757	52	116	0	64	64	1.0000000
NODE_102465_length_362_cov_29.273764	86	166	0	34	80	0.4250000
NODE_102465_length_362_cov_29.273764	86	166	2	46	80	0.5750000
NODE_102465_length_362_cov_29.273764	139	219	0	80	80	1.0000000
NODE_102467_length_362_cov_14.847909	130	210	0	80	80	1.0000000
NODE_102467_length_362_cov_14.847909	183	263	0	80	80	1.0000000
NODE_102633_length_362_cov_2.159696	133	216	0	83	83	1.0000000
NODE_103259_length_361_cov_4.641221	249	312	0	22	63	0.3492064
NODE_103259_length_361_cov_4.641221	249	312	2	23	63	0.3650794
NODE_103259_length_361_cov_4.641221	249	312	4	18	63	0.2857143
NODE_103280_length_361_cov_3.717557	185	265	0	67	80	0.8375000
NODE_103280_length_361_cov_3.717557	185	265	4	13	80	0.1625000
NODE_103280_length_361_cov_3.717557	238	265	0	27	27	1.0000000
NODE_103314_length_361_cov_2.988550	121	201	2	9	80	0.1125000
NODE_103314_length_361_cov_2.988550	121	201	4	3	80	0.0375000
NODE_103314_length_361_cov_2.988550	121	201	6	26	80	0.3250000
NODE_103314_length_361_cov_2.988550	121	201	8	42	80	0.5250000
NODE_103314_length_361_cov_2.988550	174	216	4	4	42	0.0952381
NODE_103314_length_361_cov_2.988550	174	216	6	8	42	0.1904762
NODE_103314_length_361_cov_2.988550	174	216	8	30	42	0.7142857
NODE_103338_length_361_cov_2.641221	4	33	4	29	29	1.0000000
NODE_103338_length_361_cov_2.641221	101	182	0	54	81	0.6666667
NODE_103338_length_361_cov_2.641221	101	182	2	27	81	0.3333333
NODE_103391_length_361_cov_2.137405	138	194	0	56	56	1.0000000
NODE_103396_length_361_cov_2.106870	192	256	0	64	64	1.0000000
NODE_103418_length_361_cov_1.969466	137	198	0	44	61	0.7213115
NODE_103418_length_361_cov_1.969466	137	198	2	17	61	0.2786885
NODE_103632_length_361_cov_1.343511	171	250	0	79	79	1.0000000
NODE_103802_length_361_cov_1.000000	60	123	0	20	63	0.3174603
NODE_103802_length_361_cov_1.000000	60	123	2	43	63	0.6825397
NODE_104057_length_360_cov_8.191571	171	242	0	25	71	0.3521127
NODE_104057_length_360_cov_8.191571	171	242	2	23	71	0.3239437
NODE_104057_length_360_cov_8.191571	171	242	4	23	71	0.3239437
NODE_104057_length_360_cov_8.191571	176	242	0	20	66	0.3030303
NODE_104057_length_360_cov_8.191571	176	242	2	23	66	0.3484848
NODE_104057_length_360_cov_8.191571	176	242	4	23	66	0.3484848
NODE_104057_length_360_cov_8.191571	215	279	2	4	64	0.0625000
NODE_104057_length_360_cov_8.191571	215	279	4	60	64	0.9375000
NODE_104057_length_360_cov_8.191571	215	279	2	4	64	0.0625000
NODE_104057_length_360_cov_8.191571	215	279	4	60	64	0.9375000
NODE_104079_length_360_cov_5.003831	86	166	0	29	80	0.3625000
NODE_104079_length_360_cov_5.003831	86	166	2	51	80	0.6375000
NODE_104091_length_360_cov_4.111111	158	238	24	5	80	0.0625000
NODE_104091_length_360_cov_4.111111	158	238	26	2	80	0.0250000
NODE_104091_length_360_cov_4.111111	158	238	28	12	80	0.1500000
NODE_104091_length_360_cov_4.111111	158	238	30	27	80	0.3375000
NODE_104091_length_360_cov_4.111111	158	238	32	14	80	0.1750000
NODE_104091_length_360_cov_4.111111	158	238	34	20	80	0.2500000
NODE_104102_length_360_cov_3.613027	123	203	0	61	80	0.7625000
NODE_104102_length_360_cov_3.613027	123	203	2	19	80	0.2375000
NODE_104102_length_360_cov_3.613027	176	256	0	80	80	1.0000000
NODE_104129_length_360_cov_3.080460	48	70	0	22	22	1.0000000
NODE_104162_length_360_cov_2.689655	118	198	6	80	80	1.0000000
NODE_104261_length_360_cov_1.977011	235	286	0	34	51	0.6666667
NODE_104261_length_360_cov_1.977011	235	286	2	17	51	0.3333333
NODE_104572_length_360_cov_1.149425	273	353	0	59	80	0.7375000
NODE_104572_length_360_cov_1.149425	273	353	2	21	80	0.2625000
NODE_104669_length_360_cov_0.965517	119	175	0	56	56	1.0000000
NODE_104671_length_360_cov_0.957854	140	186	0	46	46	1.0000000
NODE_104858_length_359_cov_45.519231	140	220	0	80	80	1.0000000
NODE_104858_length_359_cov_45.519231	193	273	0	80	80	1.0000000
NODE_104932_length_359_cov_3.296154	67	147	2	10	80	0.1250000
NODE_104932_length_359_cov_3.296154	67	147	3	2	80	0.0250000
NODE_104932_length_359_cov_3.296154	67	147	4	45	80	0.5625000
NODE_104932_length_359_cov_3.296154	67	147	6	23	80	0.2875000
NODE_104932_length_359_cov_3.296154	120	177	3	15	57	0.2631579
NODE_104932_length_359_cov_3.296154	120	177	4	17	57	0.2982456
NODE_104932_length_359_cov_3.296154	120	177	5	17	57	0.2982456
NODE_104932_length_359_cov_3.296154	120	177	6	8	57	0.1403509
NODE_104932_length_359_cov_3.296154	201	256	2	12	55	0.2181818
NODE_104932_length_359_cov_3.296154	201	256	4	41	55	0.7454545
NODE_104932_length_359_cov_3.296154	201	256	5	2	55	0.0363636
NODE_104936_length_359_cov_3.276923	5	95	0	90	90	1.0000000
NODE_104954_length_359_cov_3.007692	156	212	2	2	56	0.0357143
NODE_104954_length_359_cov_3.007692	156	212	8	54	56	0.9642857
NODE_104998_length_359_cov_2.523077	148	228	0	80	80	1.0000000
NODE_104998_length_359_cov_2.523077	201	278	0	43	77	0.5584416
NODE_104998_length_359_cov_2.523077	201	278	2	34	77	0.4415585
NODE_105002_length_359_cov_2.419231	106	186	0	80	80	1.0000000
NODE_105002_length_359_cov_2.419231	159	211	0	50	52	0.9615384
NODE_105002_length_359_cov_2.419231	159	211	6	1	52	0.0192308
NODE_105002_length_359_cov_2.419231	159	211	14	1	52	0.0192308
NODE_105006_length_359_cov_2.353846	172	243	0	1	71	0.0140845
NODE_105006_length_359_cov_2.353846	172	243	2	43	71	0.6056338
NODE_105006_length_359_cov_2.353846	172	243	4	27	71	0.3802817
NODE_105006_length_359_cov_2.353846	216	296	2	34	80	0.4250000
NODE_105006_length_359_cov_2.353846	216	296	4	46	80	0.5750000
NODE_105026_length_359_cov_2.257692	211	270	0	59	59	1.0000000
NODE_105063_length_359_cov_2.003846	8	88	0	80	80	1.0000000
NODE_105063_length_359_cov_2.003846	61	139	0	78	78	1.0000000
NODE_105106_length_359_cov_1.815385	126	207	0	81	81	1.0000000
NODE_105106_length_359_cov_1.815385	180	227	0	47	47	1.0000000
NODE_105142_length_359_cov_1.692308	88	116	0	28	28	1.0000000
NODE_105373_length_359_cov_1.096154	64	89	0	25	25	1.0000000
NODE_105599_length_359_cov_0.711538	222	248	0	26	26	1.0000000
NODE_105600_length_359_cov_0.707692	10	90	0	63	80	0.7875000
NODE_105600_length_359_cov_0.707692	10	90	2	17	80	0.2125000
NODE_105600_length_359_cov_0.707692	10	90	0	63	80	0.7875000
NODE_105600_length_359_cov_0.707692	10	90	2	17	80	0.2125000
NODE_105600_length_359_cov_0.707692	63	143	0	10	80	0.1250000
NODE_105600_length_359_cov_0.707692	63	143	2	25	80	0.3125000
NODE_105600_length_359_cov_0.707692	63	143	4	45	80	0.5625000
NODE_105678_length_358_cov_19.760618	213	293	0	80	80	1.0000000
NODE_105678_length_358_cov_19.760618	266	346	0	80	80	1.0000000
NODE_105679_length_358_cov_18.455598	303	358	0	12	55	0.2181818
NODE_105679_length_358_cov_18.455598	303	358	2	43	55	0.7818182
NODE_105680_length_358_cov_17.023166	0	63	11	1	63	0.0158730
NODE_105680_length_358_cov_17.023166	0	63	12	10	63	0.1587302
NODE_105680_length_358_cov_17.023166	0	63	14	52	63	0.8253968
NODE_105680_length_358_cov_17.023166	0	63	11	1	63	0.0158730
NODE_105680_length_358_cov_17.023166	0	63	12	10	63	0.1587302
NODE_105680_length_358_cov_17.023166	0	63	14	52	63	0.8253968
NODE_105680_length_358_cov_17.023166	0	63	11	1	63	0.0158730
NODE_105680_length_358_cov_17.023166	0	63	12	10	63	0.1587302
NODE_105680_length_358_cov_17.023166	0	63	14	52	63	0.8253968
NODE_105680_length_358_cov_17.023166	36	116	6	2	80	0.0250000
NODE_105680_length_358_cov_17.023166	36	116	14	45	80	0.5625000
NODE_105680_length_358_cov_17.023166	36	116	16	33	80	0.4125000
NODE_105680_length_358_cov_17.023166	53	115	6	1	62	0.0161290
NODE_105680_length_358_cov_17.023166	53	115	14	28	62	0.4516129
NODE_105680_length_358_cov_17.023166	53	115	16	33	62	0.5322581
NODE_105686_length_358_cov_6.509653	109	155	2	9	46	0.1956522
NODE_105686_length_358_cov_6.509653	109	155	4	37	46	0.8043478
NODE_105710_length_358_cov_4.239382	114	143	10	15	29	0.5172414
NODE_105710_length_358_cov_4.239382	114	143	12	14	29	0.4827586
NODE_105710_length_358_cov_4.239382	180	245	14	7	65	0.1076923
NODE_105710_length_358_cov_4.239382	180	245	16	6	65	0.0923077
NODE_105710_length_358_cov_4.239382	180	245	18	15	65	0.2307692
NODE_105710_length_358_cov_4.239382	180	245	19	5	65	0.0769231
NODE_105710_length_358_cov_4.239382	180	245	20	29	65	0.4461538
NODE_105710_length_358_cov_4.239382	180	245	22	3	65	0.0461538
NODE_105710_length_358_cov_4.239382	218	298	8	19	80	0.2375000
NODE_105710_length_358_cov_4.239382	218	298	10	7	80	0.0875000
NODE_105710_length_358_cov_4.239382	218	298	12	10	80	0.1250000
NODE_105710_length_358_cov_4.239382	218	298	14	8	80	0.1000000
NODE_105710_length_358_cov_4.239382	218	298	16	4	80	0.0500000
NODE_105710_length_358_cov_4.239382	218	298	18	11	80	0.1375000
NODE_105710_length_358_cov_4.239382	218	298	19	5	80	0.0625000
NODE_105710_length_358_cov_4.239382	218	298	20	16	80	0.2000000
NODE_105846_length_358_cov_2.162162	229	305	0	57	76	0.7500000
NODE_105846_length_358_cov_2.162162	229	305	2	19	76	0.2500000
NODE_105902_length_358_cov_1.926641	290	358	0	2	68	0.0294118
NODE_105902_length_358_cov_1.926641	290	358	4	21	68	0.3088235
NODE_105902_length_358_cov_1.926641	290	358	6	45	68	0.6617647
NODE_105910_length_358_cov_1.884170	250	317	0	8	67	0.1194030
NODE_105910_length_358_cov_1.884170	250	317	2	59	67	0.8805970
NODE_105923_length_358_cov_1.841699	189	269	11	1	80	0.0125000
NODE_105923_length_358_cov_1.841699	189	269	13	3	80	0.0375000
NODE_105923_length_358_cov_1.841699	189	269	14	2	80	0.0250000
NODE_105923_length_358_cov_1.841699	189	269	16	4	80	0.0500000
NODE_105923_length_358_cov_1.841699	189	269	20	5	80	0.0625000
NODE_105923_length_358_cov_1.841699	189	269	22	2	80	0.0250000
NODE_105923_length_358_cov_1.841699	189	269	24	6	80	0.0750000
NODE_105923_length_358_cov_1.841699	189	269	26	3	80	0.0375000
NODE_105923_length_358_cov_1.841699	189	269	30	9	80	0.1125000
NODE_105923_length_358_cov_1.841699	189	269	32	2	80	0.0250000
NODE_105923_length_358_cov_1.841699	189	269	34	24	80	0.3000000
NODE_105923_length_358_cov_1.841699	189	269	36	8	80	0.1000000
NODE_105923_length_358_cov_1.841699	189	269	38	11	80	0.1375000
NODE_106096_length_358_cov_1.235521	99	179	4	5	80	0.0625000
NODE_106096_length_358_cov_1.235521	99	179	6	21	80	0.2625000
NODE_106096_length_358_cov_1.235521	99	179	13	32	80	0.4000000
NODE_106096_length_358_cov_1.235521	99	179	14	6	80	0.0750000
NODE_106096_length_358_cov_1.235521	99	179	15	1	80	0.0125000
NODE_106096_length_358_cov_1.235521	99	179	17	15	80	0.1875000
NODE_106096_length_358_cov_1.235521	152	222	13	60	70	0.8571429
NODE_106096_length_358_cov_1.235521	152	222	15	10	70	0.1428571
NODE_106189_length_358_cov_1.096525	148	228	0	80	80	1.0000000
NODE_106233_length_358_cov_0.984556	193	265	0	68	72	0.9444444
NODE_106233_length_358_cov_0.984556	193	265	4	4	72	0.0555556
NODE_106489_length_357_cov_381.833333	244	324	85	4	80	0.0500000
NODE_106489_length_357_cov_381.833333	244	324	87	3	80	0.0375000
NODE_106489_length_357_cov_381.833333	244	324	89	3	80	0.0375000
NODE_106489_length_357_cov_381.833333	244	324	93	1	80	0.0125000
NODE_106489_length_357_cov_381.833333	244	324	97	1	80	0.0125000
NODE_106489_length_357_cov_381.833333	244	324	107	2	80	0.0250000
NODE_106489_length_357_cov_381.833333	244	324	108	1	80	0.0125000
NODE_106489_length_357_cov_381.833333	244	324	109	3	80	0.0375000
NODE_106489_length_357_cov_381.833333	244	324	111	2	80	0.0250000
NODE_106489_length_357_cov_381.833333	244	324	112	1	80	0.0125000
NODE_106489_length_357_cov_381.833333	244	324	113	2	80	0.0250000
NODE_106489_length_357_cov_381.833333	244	324	116	5	80	0.0625000
NODE_106489_length_357_cov_381.833333	244	324	117	2	80	0.0250000
NODE_106489_length_357_cov_381.833333	244	324	118	34	80	0.4250000
NODE_106489_length_357_cov_381.833333	244	324	119	16	80	0.2000000
NODE_106493_length_357_cov_7.643411	45	125	0	80	80	1.0000000
NODE_106493_length_357_cov_7.643411	98	178	0	80	80	1.0000000
NODE_106495_length_357_cov_7.027132	157	237	0	80	80	1.0000000
NODE_106495_length_357_cov_7.027132	210	252	0	42	42	1.0000000
NODE_106496_length_357_cov_6.732558	183	263	4	49	80	0.6125000
NODE_106496_length_357_cov_6.732558	183	263	6	31	80	0.3875000
NODE_106529_length_357_cov_4.081395	145	225	0	80	80	1.0000000
NODE_106529_length_357_cov_4.081395	198	271	0	73	73	1.0000000
NODE_106542_length_357_cov_3.724806	192	265	0	51	73	0.6986302
NODE_106542_length_357_cov_3.724806	192	265	2	22	73	0.3013699
NODE_106558_length_357_cov_3.341085	205	285	0	80	80	1.0000000
NODE_106558_length_357_cov_3.341085	258	338	0	80	80	1.0000000
NODE_106625_length_357_cov_2.414729	245	302	0	57	57	1.0000000
NODE_106625_length_357_cov_2.414729	275	355	0	80	80	1.0000000
NODE_106661_length_357_cov_2.174419	250	330	0	80	80	1.0000000
NODE_106666_length_357_cov_2.166667	103	133	0	30	30	1.0000000
NODE_106666_length_357_cov_2.166667	112	133	0	21	21	1.0000000
NODE_106702_length_357_cov_1.961240	150	169	0	14	19	0.7368421
NODE_106702_length_357_cov_1.961240	150	169	4	5	19	0.2631579
NODE_106708_length_357_cov_1.918605	173	253	6	4	80	0.0500000
NODE_106708_length_357_cov_1.918605	173	253	8	1	80	0.0125000
NODE_106708_length_357_cov_1.918605	173	253	10	9	80	0.1125000
NODE_106708_length_357_cov_1.918605	173	253	12	2	80	0.0250000
NODE_106708_length_357_cov_1.918605	173	253	14	9	80	0.1125000
NODE_106708_length_357_cov_1.918605	173	253	16	36	80	0.4500000
NODE_106708_length_357_cov_1.918605	173	253	18	4	80	0.0500000
NODE_106708_length_357_cov_1.918605	173	253	20	14	80	0.1750000
NODE_106708_length_357_cov_1.918605	173	253	21	1	80	0.0125000
NODE_106737_length_357_cov_1.782946	73	142	0	36	69	0.5217391
NODE_106737_length_357_cov_1.782946	73	142	2	12	69	0.1739130
NODE_106737_length_357_cov_1.782946	73	142	4	21	69	0.3043478
NODE_106737_length_357_cov_1.782946	115	195	2	6	80	0.0750000
NODE_106737_length_357_cov_1.782946	115	195	4	74	80	0.9250000
NODE_107002_length_357_cov_1.127907	98	129	2	31	31	1.0000000
NODE_107306_length_356_cov_5.299611	140	200	6	1	60	0.0166667
NODE_107306_length_356_cov_5.299611	140	200	10	1	60	0.0166667
NODE_107306_length_356_cov_5.299611	140	200	12	16	60	0.2666667
NODE_107306_length_356_cov_5.299611	140	200	14	3	60	0.0500000
NODE_107306_length_356_cov_5.299611	140	200	16	39	60	0.6500000
NODE_107347_length_356_cov_3.400778	255	317	8	3	62	0.0483871
NODE_107347_length_356_cov_3.400778	255	317	9	1	62	0.0161290
NODE_107347_length_356_cov_3.400778	255	317	10	58	62	0.9354839
NODE_107347_length_356_cov_3.400778	308	353	2	12	45	0.2666667
NODE_107347_length_356_cov_3.400778	308	353	6	8	45	0.1777778
NODE_107347_length_356_cov_3.400778	308	353	7	1	45	0.0222222
NODE_107347_length_356_cov_3.400778	308	353	8	11	45	0.2444444
NODE_107347_length_356_cov_3.400778	308	353	10	13	45	0.2888889
NODE_107402_length_356_cov_2.657588	256	298	16	4	42	0.0952381
NODE_107402_length_356_cov_2.657588	256	298	18	37	42	0.8809524
NODE_107402_length_356_cov_2.657588	256	298	20	1	42	0.0238095
NODE_107402_length_356_cov_2.657588	265	338	6	7	73	0.0958904
NODE_107402_length_356_cov_2.657588	265	338	8	6	73	0.0821918
NODE_107402_length_356_cov_2.657588	265	338	10	1	73	0.0136986
NODE_107402_length_356_cov_2.657588	265	338	11	4	73	0.0547945
NODE_107402_length_356_cov_2.657588	265	338	14	22	73	0.3013699
NODE_107402_length_356_cov_2.657588	265	338	16	4	73	0.0547945
NODE_107402_length_356_cov_2.657588	265	338	18	29	73	0.3972603
NODE_107402_length_356_cov_2.657588	299	351	0	2	52	0.0384615
NODE_107402_length_356_cov_2.657588	299	351	2	5	52	0.0961538
NODE_107402_length_356_cov_2.657588	299	351	4	6	52	0.1153846
NODE_107402_length_356_cov_2.657588	299	351	6	7	52	0.1346154
NODE_107402_length_356_cov_2.657588	299	351	8	6	52	0.1153846
NODE_107402_length_356_cov_2.657588	299	351	10	1	52	0.0192308
NODE_107402_length_356_cov_2.657588	299	351	11	4	52	0.0769231
NODE_107402_length_356_cov_2.657588	299	351	14	21	52	0.4038461
NODE_107452_length_356_cov_2.237354	90	135	0	7	45	0.1555556
NODE_107452_length_356_cov_2.237354	90	135	2	24	45	0.5333334
NODE_107452_length_356_cov_2.237354	90	135	4	14	45	0.3111111
NODE_107475_length_356_cov_1.996109	127	194	0	67	67	1.0000000
NODE_107521_length_356_cov_1.813230	296	341	0	45	45	1.0000000
NODE_107606_length_356_cov_1.560311	192	272	0	80	80	1.0000000
NODE_107606_length_356_cov_1.560311	245	319	0	74	74	1.0000000
NODE_108122_length_355_cov_6.796875	127	173	0	46	46	1.0000000
NODE_108210_length_355_cov_2.734375	111	162	0	51	51	1.0000000
NODE_108210_length_355_cov_2.734375	142	222	0	80	80	1.0000000
NODE_108215_length_355_cov_2.707031	277	314	0	37	37	1.0000000
NODE_108215_length_355_cov_2.707031	287	353	0	66	66	1.0000000
NODE_108239_length_355_cov_2.500000	38	82	0	44	44	1.0000000
NODE_108278_length_355_cov_2.207031	258	308	0	50	50	1.0000000
NODE_108284_length_355_cov_2.179688	153	233	0	47	80	0.5875000
NODE_108284_length_355_cov_2.179688	153	233	2	33	80	0.4125000
NODE_108284_length_355_cov_2.179688	206	286	0	36	80	0.4500000
NODE_108284_length_355_cov_2.179688	206	286	2	44	80	0.5500000
NODE_108291_length_355_cov_2.132812	261	334	0	73	73	1.0000000
NODE_108291_length_355_cov_2.132812	301	342	0	41	41	1.0000000
NODE_108315_length_355_cov_2.007812	281	347	0	66	66	1.0000000
NODE_108395_length_355_cov_1.765625	186	247	2	3	61	0.0491803
NODE_108395_length_355_cov_1.765625	186	247	4	15	61	0.2459016
NODE_108395_length_355_cov_1.765625	186	247	6	9	61	0.1475410
NODE_108395_length_355_cov_1.765625	186	247	8	34	61	0.5573770
NODE_108395_length_355_cov_1.765625	220	300	5	17	80	0.2125000
NODE_108395_length_355_cov_1.765625	220	300	6	18	80	0.2250000
NODE_108395_length_355_cov_1.765625	220	300	8	45	80	0.5625000
NODE_109015_length_354_cov_6.843137	53	132	0	79	79	1.0000000
NODE_109015_length_354_cov_6.843137	53	132	0	79	79	1.0000000
NODE_109015_length_354_cov_6.843137	105	185	0	80	80	1.0000000
NODE_109015_length_354_cov_6.843137	105	185	0	80	80	1.0000000
NODE_109033_length_354_cov_4.823529	208	255	0	47	47	1.0000000
NODE_109054_length_354_cov_3.956863	145	208	0	63	63	1.0000000
NODE_109054_length_354_cov_3.956863	181	261	0	80	80	1.0000000
NODE_109057_length_354_cov_3.878431	198	244	0	22	46	0.4782609
NODE_109057_length_354_cov_3.878431	198	244	2	24	46	0.5217391
NODE_109089_length_354_cov_3.207843	130	199	2	69	69	1.0000000
NODE_109126_length_354_cov_2.725490	179	259	0	55	80	0.6875000
NODE_109126_length_354_cov_2.725490	179	259	4	10	80	0.1250000
NODE_109126_length_354_cov_2.725490	179	259	6	15	80	0.1875000
NODE_109126_length_354_cov_2.725490	235	312	4	9	77	0.1168831
NODE_109126_length_354_cov_2.725490	235	312	6	16	77	0.2077922
NODE_109126_length_354_cov_2.725490	235	312	8	52	77	0.6753247
NODE_109128_length_354_cov_2.713725	16	76	0	60	60	1.0000000
NODE_109128_length_354_cov_2.713725	90	149	0	59	59	1.0000000
NODE_109140_length_354_cov_2.580392	176	234	0	2	58	0.0344828
NODE_109140_length_354_cov_2.580392	176	234	2	56	58	0.9655172
NODE_109140_length_354_cov_2.580392	207	251	2	44	44	1.0000000
NODE_109237_length_354_cov_1.996078	79	145	0	66	66	1.0000000
NODE_109237_length_354_cov_1.996078	118	200	0	82	82	1.0000000
NODE_109244_length_354_cov_1.988235	7	77	0	34	70	0.4857143
NODE_109244_length_354_cov_1.988235	7	77	2	36	70	0.5142857
NODE_109244_length_354_cov_1.988235	64	130	2	13	66	0.1969697
NODE_109244_length_354_cov_1.988235	64	130	4	14	66	0.2121212
NODE_109244_length_354_cov_1.988235	64	130	6	39	66	0.5909091
NODE_109321_length_354_cov_1.682353	99	171	0	5	72	0.0694444
NODE_109321_length_354_cov_1.682353	99	171	2	67	72	0.9305556
NODE_109321_length_354_cov_1.682353	144	224	2	80	80	1.0000000
NODE_109852_length_353_cov_11.169291	14	90	0	76	76	1.0000000
NODE_109852_length_353_cov_11.169291	67	143	0	76	76	1.0000000
NODE_109911_length_353_cov_3.874016	220	256	0	36	36	1.0000000
NODE_109911_length_353_cov_3.874016	265	334	0	69	69	1.0000000
NODE_109928_length_353_cov_3.488189	200	282	6	3	82	0.0365854
NODE_109928_length_353_cov_3.488189	200	282	8	4	82	0.0487805
NODE_109928_length_353_cov_3.488189	200	282	10	18	82	0.2195122
NODE_109928_length_353_cov_3.488189	200	282	12	32	82	0.3902439
NODE_109928_length_353_cov_3.488189	200	282	14	12	82	0.1463415
NODE_109928_length_353_cov_3.488189	200	282	16	13	82	0.1585366
NODE_109976_length_353_cov_2.826772	8	88	0	24	80	0.3000000
NODE_109976_length_353_cov_2.826772	8	88	2	56	80	0.7000000
NODE_109976_length_353_cov_2.826772	61	120	2	59	59	1.0000000
NODE_110022_length_353_cov_2.417323	260	336	0	76	76	1.0000000
NODE_110610_length_353_cov_0.744094	299	318	0	19	19	1.0000000
NODE_110708_length_352_cov_34.691700	110	203	0	16	93	0.1720430
NODE_110708_length_352_cov_34.691700	110	203	2	75	93	0.8064516
NODE_110708_length_352_cov_34.691700	110	203	12	1	93	0.0107527
NODE_110708_length_352_cov_34.691700	110	203	18	1	93	0.0107527
NODE_110710_length_352_cov_17.944664	20	100	0	80	80	1.0000000
NODE_110710_length_352_cov_17.944664	73	153	0	80	80	1.0000000
NODE_110710_length_352_cov_17.944664	273	352	0	79	79	1.0000000
NODE_110735_length_352_cov_4.707510	157	237	2	11	80	0.1375000
NODE_110735_length_352_cov_4.707510	157	237	4	10	80	0.1250000
NODE_110735_length_352_cov_4.707510	157	237	6	17	80	0.2125000
NODE_110735_length_352_cov_4.707510	157	237	7	11	80	0.1375000
NODE_110735_length_352_cov_4.707510	157	237	9	4	80	0.0500000
NODE_110735_length_352_cov_4.707510	157	237	10	27	80	0.3375000
NODE_110749_length_352_cov_4.221344	144	205	0	61	61	1.0000000
NODE_110749_length_352_cov_4.221344	178	259	0	81	81	1.0000000
NODE_110754_length_352_cov_4.011858	98	143	0	45	45	1.0000000
NODE_110754_length_352_cov_4.011858	151	228	0	69	77	0.8961039
NODE_110754_length_352_cov_4.011858	151	228	2	8	77	0.1038961
NODE_110798_length_352_cov_2.849802	74	154	0	13	80	0.1625000
NODE_110798_length_352_cov_2.849802	74	154	2	67	80	0.8375000
NODE_110798_length_352_cov_2.849802	127	198	0	38	71	0.5352113
NODE_110798_length_352_cov_2.849802	127	198	2	33	71	0.4647887
NODE_110820_length_352_cov_2.683794	0	77	0	52	77	0.6753247
NODE_110820_length_352_cov_2.683794	0	77	2	25	77	0.3246753
NODE_110820_length_352_cov_2.683794	50	130	0	2	80	0.0250000
NODE_110820_length_352_cov_2.683794	50	130	2	78	80	0.9750000
NODE_110832_length_352_cov_2.608696	90	136	0	46	46	1.0000000
NODE_110832_length_352_cov_2.608696	144	189	0	45	45	1.0000000
NODE_110838_length_352_cov_2.577075	111	191	2	12	80	0.1500000
NODE_110838_length_352_cov_2.577075	111	191	3	2	80	0.0250000
NODE_110838_length_352_cov_2.577075	111	191	4	66	80	0.8250000
NODE_110876_length_352_cov_2.264822	171	251	0	80	80	1.0000000
NODE_110938_length_352_cov_2.007905	277	326	0	49	49	1.0000000
NODE_111439_length_352_cov_0.806324	165	238	22	2	73	0.0273973
NODE_111439_length_352_cov_0.806324	165	238	25	1	73	0.0136986
NODE_111439_length_352_cov_0.806324	165	238	32	1	73	0.0136986
NODE_111439_length_352_cov_0.806324	165	238	35	1	73	0.0136986
NODE_111439_length_352_cov_0.806324	165	238	44	2	73	0.0273973
NODE_111439_length_352_cov_0.806324	165	238	46	1	73	0.0136986
NODE_111439_length_352_cov_0.806324	165	238	50	2	73	0.0273973
NODE_111439_length_352_cov_0.806324	165	238	52	2	73	0.0273973
NODE_111439_length_352_cov_0.806324	165	238	54	2	73	0.0273973
NODE_111439_length_352_cov_0.806324	165	238	56	1	73	0.0136986
NODE_111439_length_352_cov_0.806324	165	238	58	3	73	0.0410959
NODE_111439_length_352_cov_0.806324	165	238	60	9	73	0.1232877
NODE_111439_length_352_cov_0.806324	165	238	62	1	73	0.0136986
NODE_111439_length_352_cov_0.806324	165	238	66	2	73	0.0273973
NODE_111439_length_352_cov_0.806324	165	238	68	3	73	0.0410959
NODE_111439_length_352_cov_0.806324	165	238	70	6	73	0.0821918
NODE_111439_length_352_cov_0.806324	165	238	72	2	73	0.0273973
NODE_111439_length_352_cov_0.806324	165	238	74	14	73	0.1917808
NODE_111439_length_352_cov_0.806324	165	238	78	1	73	0.0136986
NODE_111439_length_352_cov_0.806324	165	238	80	6	73	0.0821918
NODE_111439_length_352_cov_0.806324	165	238	82	2	73	0.0273973
NODE_111439_length_352_cov_0.806324	165	238	84	9	73	0.1232877
NODE_111593_length_351_cov_5.003968	115	195	0	80	80	1.0000000
NODE_111662_length_351_cov_2.900794	289	320	0	31	31	1.0000000
NODE_111738_length_351_cov_2.376984	79	159	0	14	80	0.1750000
NODE_111738_length_351_cov_2.376984	79	159	2	20	80	0.2500000
NODE_111738_length_351_cov_2.376984	79	159	4	2	80	0.0250000
NODE_111738_length_351_cov_2.376984	79	159	6	15	80	0.1875000
NODE_111738_length_351_cov_2.376984	79	159	8	7	80	0.0875000
NODE_111738_length_351_cov_2.376984	79	159	10	20	80	0.2500000
NODE_111738_length_351_cov_2.376984	79	159	12	2	80	0.0250000
NODE_111759_length_351_cov_2.226190	116	170	22	4	54	0.0740741
NODE_111759_length_351_cov_2.226190	116	170	26	4	54	0.0740741
NODE_111759_length_351_cov_2.226190	116	170	28	5	54	0.0925926
NODE_111759_length_351_cov_2.226190	116	170	30	1	54	0.0185185
NODE_111759_length_351_cov_2.226190	116	170	32	40	54	0.7407407
NODE_111769_length_351_cov_2.186508	198	277	0	79	79	1.0000000
NODE_111861_length_351_cov_1.809524	276	309	0	33	33	1.0000000
NODE_111969_length_351_cov_1.515873	228	299	0	71	71	1.0000000
NODE_112493_length_350_cov_232.529880	25	92	32	2	67	0.0298507
NODE_112493_length_350_cov_232.529880	25	92	34	2	67	0.0298507
NODE_112493_length_350_cov_232.529880	25	92	40	1	67	0.0149254
NODE_112493_length_350_cov_232.529880	25	92	42	2	67	0.0298507
NODE_112493_length_350_cov_232.529880	25	92	44	2	67	0.0298507
NODE_112493_length_350_cov_232.529880	25	92	46	1	67	0.0149254
NODE_112493_length_350_cov_232.529880	25	92	50	4	67	0.0597015
NODE_112493_length_350_cov_232.529880	25	92	52	1	67	0.0149254
NODE_112493_length_350_cov_232.529880	25	92	54	1	67	0.0149254
NODE_112493_length_350_cov_232.529880	25	92	58	1	67	0.0149254
NODE_112493_length_350_cov_232.529880	25	92	60	2	67	0.0298507
NODE_112493_length_350_cov_232.529880	25	92	62	1	67	0.0149254
NODE_112493_length_350_cov_232.529880	25	92	64	1	67	0.0149254
NODE_112493_length_350_cov_232.529880	25	92	66	7	67	0.1044776
NODE_112493_length_350_cov_232.529880	25	92	68	1	67	0.0149254
NODE_112493_length_350_cov_232.529880	25	92	70	1	67	0.0149254
NODE_112493_length_350_cov_232.529880	25	92	72	2	67	0.0298507
NODE_112493_length_350_cov_232.529880	25	92	76	2	67	0.0298507
NODE_112493_length_350_cov_232.529880	25	92	78	1	67	0.0149254
NODE_112493_length_350_cov_232.529880	25	92	80	6	67	0.0895522
NODE_112493_length_350_cov_232.529880	25	92	82	11	67	0.1641791
NODE_112493_length_350_cov_232.529880	25	92	86	9	67	0.1343284
NODE_112493_length_350_cov_232.529880	25	92	88	6	67	0.0895522
NODE_112494_length_350_cov_40.677291	181	246	93	7	65	0.1076923
NODE_112494_length_350_cov_40.677291	181	246	95	1	65	0.0153846
NODE_112494_length_350_cov_40.677291	181	246	108	1	65	0.0153846
NODE_112494_length_350_cov_40.677291	181	246	113	2	65	0.0307692
NODE_112494_length_350_cov_40.677291	181	246	119	3	65	0.0461538
NODE_112494_length_350_cov_40.677291	181	246	121	3	65	0.0461538
NODE_112494_length_350_cov_40.677291	181	246	123	1	65	0.0153846
NODE_112494_length_350_cov_40.677291	181	246	127	1	65	0.0153846
NODE_112494_length_350_cov_40.677291	181	246	131	2	65	0.0307692
NODE_112494_length_350_cov_40.677291	181	246	133	2	65	0.0307692
NODE_112494_length_350_cov_40.677291	181	246	134	1	65	0.0153846
NODE_112494_length_350_cov_40.677291	181	246	135	2	65	0.0307692
NODE_112494_length_350_cov_40.677291	181	246	137	8	65	0.1230769
NODE_112494_length_350_cov_40.677291	181	246	139	7	65	0.1076923
NODE_112494_length_350_cov_40.677291	181	246	140	1	65	0.0153846
NODE_112494_length_350_cov_40.677291	181	246	141	4	65	0.0615385
NODE_112494_length_350_cov_40.677291	181	246	143	3	65	0.0461538
NODE_112494_length_350_cov_40.677291	181	246	145	3	65	0.0461538
NODE_112494_length_350_cov_40.677291	181	246	147	3	65	0.0461538
NODE_112494_length_350_cov_40.677291	181	246	149	1	65	0.0153846
NODE_112494_length_350_cov_40.677291	181	246	151	3	65	0.0461538
NODE_112494_length_350_cov_40.677291	181	246	153	2	65	0.0307692
NODE_112494_length_350_cov_40.677291	181	246	155	1	65	0.0153846
NODE_112494_length_350_cov_40.677291	181	246	157	3	65	0.0461538
NODE_112535_length_350_cov_4.179283	114	194	2	36	80	0.4500000
NODE_112535_length_350_cov_4.179283	114	194	4	11	80	0.1375000
NODE_112535_length_350_cov_4.179283	114	194	6	2	80	0.0250000
NODE_112535_length_350_cov_4.179283	114	194	7	4	80	0.0500000
NODE_112535_length_350_cov_4.179283	114	194	8	27	80	0.3375000
NODE_112535_length_350_cov_4.179283	167	244	8	28	77	0.3636364
NODE_112535_length_350_cov_4.179283	167	244	9	2	77	0.0259740
NODE_112535_length_350_cov_4.179283	167	244	10	37	77	0.4805195
NODE_112535_length_350_cov_4.179283	167	244	11	10	77	0.1298701
NODE_112554_length_350_cov_3.573705	128	202	0	7	74	0.0945946
NODE_112554_length_350_cov_3.573705	128	202	2	26	74	0.3513514
NODE_112554_length_350_cov_3.573705	128	202	10	1	74	0.0135135
NODE_112554_length_350_cov_3.573705	128	202	14	1	74	0.0135135
NODE_112554_length_350_cov_3.573705	128	202	16	3	74	0.0405405
NODE_112554_length_350_cov_3.573705	128	202	20	2	74	0.0270270
NODE_112554_length_350_cov_3.573705	128	202	22	1	74	0.0135135
NODE_112554_length_350_cov_3.573705	128	202	24	1	74	0.0135135
NODE_112554_length_350_cov_3.573705	128	202	25	1	74	0.0135135
NODE_112554_length_350_cov_3.573705	128	202	27	3	74	0.0405405
NODE_112554_length_350_cov_3.573705	128	202	29	10	74	0.1351351
NODE_112554_length_350_cov_3.573705	128	202	31	14	74	0.1891892
NODE_112554_length_350_cov_3.573705	128	202	33	4	74	0.0540541
NODE_112554_length_350_cov_3.573705	178	241	0	46	63	0.7301587
NODE_112554_length_350_cov_3.573705	178	241	2	17	63	0.2698413
NODE_112627_length_350_cov_2.478088	266	297	0	31	31	1.0000000
NODE_112647_length_350_cov_2.346614	97	148	22	3	51	0.0588235
NODE_112647_length_350_cov_2.346614	97	148	23	2	51	0.0392157
NODE_112647_length_350_cov_2.346614	97	148	24	1	51	0.0196078
NODE_112647_length_350_cov_2.346614	97	148	25	3	51	0.0588235
NODE_112647_length_350_cov_2.346614	97	148	26	4	51	0.0784314
NODE_112647_length_350_cov_2.346614	97	148	29	1	51	0.0196078
NODE_112647_length_350_cov_2.346614	97	148	30	4	51	0.0784314
NODE_112647_length_350_cov_2.346614	97	148	32	5	51	0.0980392
NODE_112647_length_350_cov_2.346614	97	148	34	3	51	0.0588235
NODE_112647_length_350_cov_2.346614	97	148	38	2	51	0.0392157
NODE_112647_length_350_cov_2.346614	97	148	40	22	51	0.4313726
NODE_112647_length_350_cov_2.346614	97	148	42	1	51	0.0196078
NODE_112714_length_350_cov_2.031873	181	238	16	8	57	0.1403509
NODE_112714_length_350_cov_2.031873	181	238	20	17	57	0.2982456
NODE_112714_length_350_cov_2.031873	181	238	22	29	57	0.5087720
NODE_112714_length_350_cov_2.031873	181	238	24	3	57	0.0526316
NODE_112997_length_350_cov_1.223108	202	275	0	20	73	0.2739726
NODE_112997_length_350_cov_1.223108	202	275	2	17	73	0.2328767
NODE_112997_length_350_cov_1.223108	202	275	8	1	73	0.0136986
NODE_112997_length_350_cov_1.223108	202	275	12	4	73	0.0547945
NODE_112997_length_350_cov_1.223108	202	275	14	9	73	0.1232877
NODE_112997_length_350_cov_1.223108	202	275	18	4	73	0.0547945
NODE_112997_length_350_cov_1.223108	202	275	20	3	73	0.0410959
NODE_112997_length_350_cov_1.223108	202	275	26	4	73	0.0547945
NODE_112997_length_350_cov_1.223108	202	275	32	3	73	0.0410959
NODE_112997_length_350_cov_1.223108	202	275	34	1	73	0.0136986
NODE_112997_length_350_cov_1.223108	202	275	36	6	73	0.0821918
NODE_112997_length_350_cov_1.223108	202	275	38	1	73	0.0136986
NODE_113450_length_349_cov_4.268000	83	163	0	80	80	1.0000000
NODE_113450_length_349_cov_4.268000	83	163	0	80	80	1.0000000
NODE_113450_length_349_cov_4.268000	136	216	0	80	80	1.0000000
NODE_113450_length_349_cov_4.268000	145	180	0	35	35	1.0000000
NODE_113473_length_349_cov_3.648000	219	300	3	3	81	0.0370370
NODE_113473_length_349_cov_3.648000	219	300	5	6	81	0.0740741
NODE_113473_length_349_cov_3.648000	219	300	7	6	81	0.0740741
NODE_113473_length_349_cov_3.648000	219	300	9	1	81	0.0123457
NODE_113473_length_349_cov_3.648000	219	300	10	7	81	0.0864198
NODE_113473_length_349_cov_3.648000	219	300	12	5	81	0.0617284
NODE_113473_length_349_cov_3.648000	219	300	14	8	81	0.0987654
NODE_113473_length_349_cov_3.648000	219	300	16	10	81	0.1234568
NODE_113473_length_349_cov_3.648000	219	300	18	32	81	0.3950617
NODE_113473_length_349_cov_3.648000	219	300	20	3	81	0.0370370
NODE_113480_length_349_cov_3.484000	196	276	4	10	80	0.1250000
NODE_113480_length_349_cov_3.484000	196	276	6	3	80	0.0375000
NODE_113480_length_349_cov_3.484000	196	276	8	67	80	0.8375000
NODE_113486_length_349_cov_3.364000	219	284	2	26	65	0.4000000
NODE_113486_length_349_cov_3.364000	219	284	4	31	65	0.4769231
NODE_113486_length_349_cov_3.364000	219	284	6	8	65	0.1230769
NODE_113511_length_349_cov_2.916000	94	189	8	10	95	0.1052632
NODE_113511_length_349_cov_2.916000	94	189	12	1	95	0.0105263
NODE_113511_length_349_cov_2.916000	94	189	14	6	95	0.0631579
NODE_113511_length_349_cov_2.916000	94	189	16	19	95	0.2000000
NODE_113511_length_349_cov_2.916000	94	189	18	59	95	0.6210526
NODE_113571_length_349_cov_2.420000	35	54	0	19	19	1.0000000
NODE_113647_length_349_cov_1.964000	32	63	0	31	31	1.0000000
NODE_113654_length_349_cov_1.928000	9	77	0	68	68	1.0000000
NODE_113654_length_349_cov_1.928000	62	115	0	53	53	1.0000000
NODE_113710_length_349_cov_1.684000	225	265	5	5	40	0.1250000
NODE_113710_length_349_cov_1.684000	225	265	6	14	40	0.3500000
NODE_113710_length_349_cov_1.684000	225	265	7	1	40	0.0250000
NODE_113710_length_349_cov_1.684000	225	265	8	3	40	0.0750000
NODE_113710_length_349_cov_1.684000	225	265	9	3	40	0.0750000
NODE_113710_length_349_cov_1.684000	225	265	10	1	40	0.0250000
NODE_113710_length_349_cov_1.684000	225	265	11	13	40	0.3250000
NODE_113825_length_349_cov_1.392000	32	95	0	12	63	0.1904762
NODE_113825_length_349_cov_1.392000	32	95	2	51	63	0.8095238
NODE_113961_length_349_cov_1.056000	316	339	0	23	23	1.0000000
NODE_114002_length_349_cov_1.020000	177	257	0	50	80	0.6250000
NODE_114002_length_349_cov_1.020000	177	257	2	30	80	0.3750000
NODE_114263_length_348_cov_34.867470	156	236	0	80	80	1.0000000
NODE_114263_length_348_cov_34.867470	209	289	0	80	80	1.0000000
NODE_114296_length_348_cov_4.180723	106	186	0	80	80	1.0000000
NODE_114296_length_348_cov_4.180723	159	239	0	80	80	1.0000000
NODE_114330_length_348_cov_3.277108	83	137	0	54	54	1.0000000
NODE_114330_length_348_cov_3.277108	145	197	0	52	52	1.0000000
NODE_114424_length_348_cov_2.305221	204	273	0	69	69	1.0000000
NODE_114448_length_348_cov_2.216867	103	152	0	49	49	1.0000000
NODE_114505_length_348_cov_1.995984	170	239	0	41	69	0.5942029
NODE_114505_length_348_cov_1.995984	170	239	2	28	69	0.4057971
NODE_114591_length_348_cov_1.638554	309	346	0	37	37	1.0000000
NODE_114643_length_348_cov_1.485944	9	60	0	51	51	1.0000000
NODE_115147_length_347_cov_15.100806	57	137	0	80	80	1.0000000
NODE_115147_length_347_cov_15.100806	110	152	0	42	42	1.0000000
NODE_115147_length_347_cov_15.100806	182	209	0	27	27	1.0000000
NODE_115147_length_347_cov_15.100806	290	317	0	27	27	1.0000000
NODE_115161_length_347_cov_5.967742	110	173	2	63	63	1.0000000
NODE_115195_length_347_cov_4.028226	260	329	0	69	69	1.0000000
NODE_115321_length_347_cov_2.463710	99	141	0	40	42	0.9523810
NODE_115321_length_347_cov_2.463710	99	141	2	2	42	0.0476190
NODE_115321_length_347_cov_2.463710	108	143	0	31	35	0.8857143
NODE_115321_length_347_cov_2.463710	108	143	2	4	35	0.1142857
NODE_115331_length_347_cov_2.391129	35	70	0	35	35	1.0000000
NODE_115331_length_347_cov_2.391129	37	79	0	42	42	1.0000000
NODE_115331_length_347_cov_2.391129	77	105	0	28	28	1.0000000
NODE_115397_length_347_cov_2.048387	15	34	0	19	19	1.0000000
NODE_115417_length_347_cov_1.967742	205	268	0	30	63	0.4761905
NODE_115417_length_347_cov_1.967742	205	268	2	33	63	0.5238096
NODE_115450_length_347_cov_1.818548	109	156	0	47	47	1.0000000
NODE_115771_length_347_cov_1.028226	230	255	0	25	25	1.0000000
NODE_116114_length_346_cov_74.433198	10	90	0	39	80	0.4875000
NODE_116114_length_346_cov_74.433198	10	90	5	1	80	0.0125000
NODE_116114_length_346_cov_74.433198	10	90	9	2	80	0.0250000
NODE_116114_length_346_cov_74.433198	10	90	11	6	80	0.0750000
NODE_116114_length_346_cov_74.433198	10	90	12	32	80	0.4000000
NODE_116114_length_346_cov_74.433198	19	90	0	30	71	0.4225352
NODE_116114_length_346_cov_74.433198	19	90	5	1	71	0.0140845
NODE_116114_length_346_cov_74.433198	19	90	9	2	71	0.0281690
NODE_116114_length_346_cov_74.433198	19	90	11	6	71	0.0845070
NODE_116114_length_346_cov_74.433198	19	90	12	32	71	0.4507042
NODE_116114_length_346_cov_74.433198	192	272	4	15	80	0.1875000
NODE_116114_length_346_cov_74.433198	192	272	6	65	80	0.8125000
NODE_116115_length_346_cov_67.834008	133	213	0	80	80	1.0000000
NODE_116115_length_346_cov_67.834008	186	266	0	80	80	1.0000000
NODE_116117_length_346_cov_10.299595	190	270	0	80	80	1.0000000
NODE_116117_length_346_cov_10.299595	243	323	0	80	80	1.0000000
NODE_116119_length_346_cov_9.566802	159	239	0	80	80	1.0000000
NODE_116119_length_346_cov_9.566802	212	292	0	27	80	0.3375000
NODE_116119_length_346_cov_9.566802	212	292	2	14	80	0.1750000
NODE_116119_length_346_cov_9.566802	212	292	4	39	80	0.4875000
NODE_116134_length_346_cov_5.506073	157	238	4	32	81	0.3950617
NODE_116134_length_346_cov_5.506073	157	238	6	49	81	0.6049383
NODE_116155_length_346_cov_4.368421	205	264	0	59	59	1.0000000
NODE_116159_length_346_cov_4.032389	121	141	0	20	20	1.0000000
NODE_116184_length_346_cov_3.400810	194	253	0	59	59	1.0000000
NODE_116212_length_346_cov_3.008097	183	263	0	80	80	1.0000000
NODE_116257_length_346_cov_2.538462	47	102	0	55	55	1.0000000
NODE_116257_length_346_cov_2.538462	118	173	0	55	55	1.0000000
NODE_116439_length_346_cov_1.700405	71	107	0	36	36	1.0000000
NODE_117035_length_345_cov_47.699187	0	66	0	66	66	1.0000000
NODE_117035_length_345_cov_47.699187	39	119	0	80	80	1.0000000
NODE_117035_length_345_cov_47.699187	115	182	0	67	67	1.0000000
NODE_117035_length_345_cov_47.699187	246	311	0	3	65	0.0461538
NODE_117035_length_345_cov_47.699187	246	311	2	62	65	0.9538462
NODE_117036_length_345_cov_13.439024	28	108	0	80	80	1.0000000
NODE_117036_length_345_cov_13.439024	81	161	0	80	80	1.0000000
NODE_117037_length_345_cov_9.906504	224	283	2	59	59	1.0000000
NODE_117051_length_345_cov_5.475610	52	132	2	17	80	0.2125000
NODE_117051_length_345_cov_5.475610	52	132	4	2	80	0.0250000
NODE_117051_length_345_cov_5.475610	52	132	6	2	80	0.0250000
NODE_117051_length_345_cov_5.475610	52	132	8	11	80	0.1375000
NODE_117051_length_345_cov_5.475610	52	132	10	23	80	0.2875000
NODE_117051_length_345_cov_5.475610	52	132	12	25	80	0.3125000
NODE_117051_length_345_cov_5.475610	105	185	0	41	80	0.5125000
NODE_117051_length_345_cov_5.475610	105	185	2	29	80	0.3625000
NODE_117051_length_345_cov_5.475610	105	185	4	2	80	0.0250000
NODE_117051_length_345_cov_5.475610	105	185	6	2	80	0.0250000
NODE_117051_length_345_cov_5.475610	105	185	8	6	80	0.0750000
NODE_117055_length_345_cov_5.321138	104	152	0	48	48	1.0000000
NODE_117065_length_345_cov_4.524390	205	269	0	64	64	1.0000000
NODE_117075_length_345_cov_4.109756	95	157	0	19	62	0.3064516
NODE_117075_length_345_cov_4.109756	95	157	4	10	62	0.1612903
NODE_117075_length_345_cov_4.109756	95	157	6	33	62	0.5322581
NODE_117075_length_345_cov_4.109756	162	204	2	2	42	0.0476190
NODE_117075_length_345_cov_4.109756	162	204	6	40	42	0.9523810
NODE_117076_length_345_cov_4.073171	251	326	0	75	75	1.0000000
NODE_117084_length_345_cov_3.776423	199	273	0	74	74	1.0000000
NODE_117084_length_345_cov_3.776423	246	326	0	80	80	1.0000000
NODE_117148_length_345_cov_2.821138	61	141	0	54	80	0.6750000
NODE_117148_length_345_cov_2.821138	61	141	2	26	80	0.3250000
NODE_117205_length_345_cov_2.333333	47	90	2	9	43	0.2093023
NODE_117205_length_345_cov_2.333333	47	90	6	8	43	0.1860465
NODE_117205_length_345_cov_2.333333	47	90	12	4	43	0.0930233
NODE_117205_length_345_cov_2.333333	47	90	14	1	43	0.0232558
NODE_117205_length_345_cov_2.333333	47	90	18	6	43	0.1395349
NODE_117205_length_345_cov_2.333333	47	90	20	8	43	0.1860465
NODE_117205_length_345_cov_2.333333	47	90	22	7	43	0.1627907
NODE_117205_length_345_cov_2.333333	63	147	6	1	84	0.0119048
NODE_117205_length_345_cov_2.333333	63	147	12	4	84	0.0476190
NODE_117205_length_345_cov_2.333333	63	147	14	1	84	0.0119048
NODE_117205_length_345_cov_2.333333	63	147	18	6	84	0.0714286
NODE_117205_length_345_cov_2.333333	63	147	20	8	84	0.0952381
NODE_117205_length_345_cov_2.333333	63	147	22	14	84	0.1666667
NODE_117205_length_345_cov_2.333333	63	147	24	20	84	0.2380952
NODE_117205_length_345_cov_2.333333	63	147	26	7	84	0.0833333
NODE_117205_length_345_cov_2.333333	63	147	27	6	84	0.0714286
NODE_117205_length_345_cov_2.333333	63	147	28	17	84	0.2023810
NODE_117219_length_345_cov_2.239837	0	81	2	2	81	0.0246914
NODE_117219_length_345_cov_2.239837	0	81	3	1	81	0.0123457
NODE_117219_length_345_cov_2.239837	0	81	4	2	81	0.0246914
NODE_117219_length_345_cov_2.239837	0	81	6	2	81	0.0246914
NODE_117219_length_345_cov_2.239837	0	81	8	11	81	0.1358025
NODE_117219_length_345_cov_2.239837	0	81	9	8	81	0.0987654
NODE_117219_length_345_cov_2.239837	0	81	11	1	81	0.0123457
NODE_117219_length_345_cov_2.239837	0	81	13	6	81	0.0740741
NODE_117219_length_345_cov_2.239837	0	81	17	11	81	0.1358025
NODE_117219_length_345_cov_2.239837	0	81	19	1	81	0.0123457
NODE_117219_length_345_cov_2.239837	0	81	20	3	81	0.0370370
NODE_117219_length_345_cov_2.239837	0	81	22	5	81	0.0617284
NODE_117219_length_345_cov_2.239837	0	81	24	1	81	0.0123457
NODE_117219_length_345_cov_2.239837	0	81	26	6	81	0.0740741
NODE_117219_length_345_cov_2.239837	0	81	28	21	81	0.2592593
NODE_117669_length_345_cov_1.040650	6	73	0	45	67	0.6716418
NODE_117669_length_345_cov_1.040650	6	73	2	1	67	0.0149254
NODE_117669_length_345_cov_1.040650	6	73	4	2	67	0.0298507
NODE_117669_length_345_cov_1.040650	6	73	6	19	67	0.2835821
NODE_117989_length_344_cov_54.020408	6	55	0	28	49	0.5714286
NODE_117989_length_344_cov_54.020408	6	55	2	14	49	0.2857143
NODE_117989_length_344_cov_54.020408	6	55	4	1	49	0.0204082
NODE_117989_length_344_cov_54.020408	6	55	6	6	49	0.1224490
NODE_117989_length_344_cov_54.020408	28	105	0	6	77	0.0779221
NODE_117989_length_344_cov_54.020408	28	105	2	14	77	0.1818182
NODE_117989_length_344_cov_54.020408	28	105	4	1	77	0.0129870
NODE_117989_length_344_cov_54.020408	28	105	6	45	77	0.5844156
NODE_117989_length_344_cov_54.020408	28	105	8	11	77	0.1428571
NODE_117989_length_344_cov_54.020408	28	105	0	6	77	0.0779221
NODE_117989_length_344_cov_54.020408	28	105	2	14	77	0.1818182
NODE_117989_length_344_cov_54.020408	28	105	4	1	77	0.0129870
NODE_117989_length_344_cov_54.020408	28	105	6	45	77	0.5844156
NODE_117989_length_344_cov_54.020408	28	105	8	11	77	0.1428571
NODE_117989_length_344_cov_54.020408	112	178	4	3	66	0.0454545
NODE_117989_length_344_cov_54.020408	112	178	6	12	66	0.1818182
NODE_117989_length_344_cov_54.020408	112	178	8	6	66	0.0909091
NODE_117989_length_344_cov_54.020408	112	178	10	7	66	0.1060606
NODE_117989_length_344_cov_54.020408	112	178	12	38	66	0.5757576
NODE_118009_length_344_cov_5.016327	72	125	6	3	53	0.0566038
NODE_118009_length_344_cov_5.016327	72	125	8	7	53	0.1320755
NODE_118009_length_344_cov_5.016327	72	125	10	2	53	0.0377358
NODE_118009_length_344_cov_5.016327	72	125	12	2	53	0.0377358
NODE_118009_length_344_cov_5.016327	72	125	14	2	53	0.0377358
NODE_118009_length_344_cov_5.016327	72	125	16	4	53	0.0754717
NODE_118009_length_344_cov_5.016327	72	125	20	5	53	0.0943396
NODE_118009_length_344_cov_5.016327	72	125	22	2	53	0.0377358
NODE_118009_length_344_cov_5.016327	72	125	26	26	53	0.4905660
NODE_118009_length_344_cov_5.016327	136	203	10	10	67	0.1492537
NODE_118009_length_344_cov_5.016327	136	203	14	3	67	0.0447761
NODE_118009_length_344_cov_5.016327	136	203	16	9	67	0.1343284
NODE_118009_length_344_cov_5.016327	136	203	18	21	67	0.3134328
NODE_118009_length_344_cov_5.016327	136	203	20	23	67	0.3432836
NODE_118009_length_344_cov_5.016327	136	203	22	1	67	0.0149254
NODE_118017_length_344_cov_4.579592	172	254	0	65	82	0.7926829
NODE_118017_length_344_cov_4.579592	172	254	2	17	82	0.2073171
NODE_118045_length_344_cov_3.840816	197	240	2	11	43	0.2558140
NODE_118045_length_344_cov_3.840816	197	240	4	32	43	0.7441860
NODE_118074_length_344_cov_3.293878	149	189	4	40	40	1.0000000
NODE_118074_length_344_cov_3.293878	162	229	4	67	67	1.0000000
NODE_118111_length_344_cov_2.751020	24	87	0	9	63	0.1428571
NODE_118111_length_344_cov_2.751020	24	87	2	23	63	0.3650794
NODE_118111_length_344_cov_2.751020	24	87	4	21	63	0.3333333
NODE_118111_length_344_cov_2.751020	24	87	6	10	63	0.1587302
NODE_118179_length_344_cov_2.126531	274	305	2	28	31	0.9032258
NODE_118179_length_344_cov_2.126531	274	305	4	3	31	0.0967742
NODE_118243_length_344_cov_1.914286	114	194	0	80	80	1.0000000
NODE_118243_length_344_cov_1.914286	167	247	0	43	80	0.5375000
NODE_118243_length_344_cov_1.914286	167	247	2	5	80	0.0625000
NODE_118243_length_344_cov_1.914286	167	247	4	32	80	0.4000000
NODE_118297_length_344_cov_1.685714	180	220	0	40	40	1.0000000
NODE_118393_length_344_cov_1.457143	160	240	12	9	80	0.1125000
NODE_118393_length_344_cov_1.457143	160	240	14	11	80	0.1375000
NODE_118393_length_344_cov_1.457143	160	240	16	6	80	0.0750000
NODE_118393_length_344_cov_1.457143	160	240	18	4	80	0.0500000
NODE_118393_length_344_cov_1.457143	160	240	20	50	80	0.6250000
NODE_118393_length_344_cov_1.457143	213	273	0	15	60	0.2500000
NODE_118393_length_344_cov_1.457143	213	273	2	1	60	0.0166667
NODE_118393_length_344_cov_1.457143	213	273	6	2	60	0.0333333
NODE_118393_length_344_cov_1.457143	213	273	8	4	60	0.0666667
NODE_118393_length_344_cov_1.457143	213	273	10	11	60	0.1833333
NODE_118393_length_344_cov_1.457143	213	273	12	9	60	0.1500000
NODE_118393_length_344_cov_1.457143	213	273	14	11	60	0.1833333
NODE_118393_length_344_cov_1.457143	213	273	16	5	60	0.0833333
NODE_118393_length_344_cov_1.457143	213	273	18	1	60	0.0166667
NODE_118393_length_344_cov_1.457143	213	273	20	1	60	0.0166667
NODE_118743_length_344_cov_0.800000	123	163	0	16	40	0.4000000
NODE_118743_length_344_cov_0.800000	123	163	2	24	40	0.6000000
NODE_118899_length_343_cov_3.770492	2	60	0	36	58	0.6206896
NODE_118899_length_343_cov_3.770492	2	60	2	22	58	0.3793103
NODE_118905_length_343_cov_3.598361	97	170	4	3	73	0.0410959
NODE_118905_length_343_cov_3.598361	97	170	8	70	73	0.9589041
NODE_118905_length_343_cov_3.598361	150	223	0	15	73	0.2054795
NODE_118905_length_343_cov_3.598361	150	223	4	15	73	0.2054795
NODE_118905_length_343_cov_3.598361	150	223	6	9	73	0.1232877
NODE_118905_length_343_cov_3.598361	150	223	8	34	73	0.4657534
NODE_118911_length_343_cov_3.401639	48	128	8	9	80	0.1125000
NODE_118911_length_343_cov_3.401639	48	128	10	5	80	0.0625000
NODE_118911_length_343_cov_3.401639	48	128	16	1	80	0.0125000
NODE_118911_length_343_cov_3.401639	48	128	18	1	80	0.0125000
NODE_118911_length_343_cov_3.401639	48	128	20	4	80	0.0500000
NODE_118911_length_343_cov_3.401639	48	128	24	9	80	0.1125000
NODE_118911_length_343_cov_3.401639	48	128	26	1	80	0.0125000
NODE_118911_length_343_cov_3.401639	48	128	28	1	80	0.0125000
NODE_118911_length_343_cov_3.401639	48	128	30	1	80	0.0125000
NODE_118911_length_343_cov_3.401639	48	128	32	5	80	0.0625000
NODE_118911_length_343_cov_3.401639	48	128	34	9	80	0.1125000
NODE_118911_length_343_cov_3.401639	48	128	36	11	80	0.1375000
NODE_118911_length_343_cov_3.401639	48	128	38	23	80	0.2875000
NODE_118941_length_343_cov_3.049180	12	62	0	50	50	1.0000000
NODE_118941_length_343_cov_3.049180	82	111	0	29	29	1.0000000
NODE_118941_length_343_cov_3.049180	133	205	0	15	72	0.2083333
NODE_118941_length_343_cov_3.049180	133	205	2	57	72	0.7916667
NODE_118957_length_343_cov_2.770492	236	316	6	30	80	0.3750000
NODE_118957_length_343_cov_2.770492	236	316	8	5	80	0.0625000
NODE_118957_length_343_cov_2.770492	236	316	10	8	80	0.1000000
NODE_118957_length_343_cov_2.770492	236	316	11	2	80	0.0250000
NODE_118957_length_343_cov_2.770492	236	316	15	1	80	0.0125000
NODE_118957_length_343_cov_2.770492	236	316	17	4	80	0.0500000
NODE_118957_length_343_cov_2.770492	236	316	19	1	80	0.0125000
NODE_118957_length_343_cov_2.770492	236	316	21	6	80	0.0750000
NODE_118957_length_343_cov_2.770492	236	316	23	9	80	0.1125000
NODE_118957_length_343_cov_2.770492	236	316	27	3	80	0.0375000
NODE_118957_length_343_cov_2.770492	236	316	28	2	80	0.0250000
NODE_118957_length_343_cov_2.770492	236	316	30	1	80	0.0125000
NODE_118957_length_343_cov_2.770492	236	316	32	8	80	0.1000000
NODE_118978_length_343_cov_2.590164	167	225	0	13	58	0.2241379
NODE_118978_length_343_cov_2.590164	167	225	1	18	58	0.3103448
NODE_118978_length_343_cov_2.590164	167	225	3	8	58	0.1379310
NODE_118978_length_343_cov_2.590164	167	225	5	13	58	0.2241379
NODE_118978_length_343_cov_2.590164	167	225	7	6	58	0.1034483
NODE_118998_length_343_cov_2.430328	208	274	2	62	66	0.9393939
NODE_118998_length_343_cov_2.430328	208	274	4	4	66	0.0606061
NODE_119040_length_343_cov_2.209016	32	111	0	79	79	1.0000000
NODE_119067_length_343_cov_2.081967	95	177	4	82	82	1.0000000
NODE_119067_length_343_cov_2.081967	150	199	4	49	49	1.0000000
NODE_119202_length_343_cov_1.635246	0	52	0	52	52	1.0000000
NODE_119439_length_343_cov_1.143443	60	120	0	60	60	1.0000000
NODE_119834_length_342_cov_3.872428	136	216	0	80	80	1.0000000
NODE_119834_length_342_cov_3.872428	189	259	0	70	70	1.0000000
NODE_119840_length_342_cov_3.769547	146	212	0	66	66	1.0000000
NODE_119841_length_342_cov_3.740741	113	146	0	33	33	1.0000000
NODE_119846_length_342_cov_3.674897	20	100	0	80	80	1.0000000
NODE_119846_length_342_cov_3.674897	73	153	0	80	80	1.0000000
NODE_119847_length_342_cov_3.588477	117	197	2	52	80	0.6500000
NODE_119847_length_342_cov_3.588477	117	197	4	28	80	0.3500000
NODE_119849_length_342_cov_3.530864	72	151	0	70	79	0.8860760
NODE_119849_length_342_cov_3.530864	72	151	2	9	79	0.1139240
NODE_119852_length_342_cov_3.423868	172	252	6	80	80	1.0000000
NODE_119852_length_342_cov_3.423868	225	283	0	3	58	0.0517241
NODE_119852_length_342_cov_3.423868	225	283	5	1	58	0.0172414
NODE_119852_length_342_cov_3.423868	225	283	6	54	58	0.9310345
NODE_119922_length_342_cov_2.432099	16	81	0	65	65	1.0000000
NODE_119993_length_342_cov_2.049383	249	317	0	68	68	1.0000000
NODE_120047_length_342_cov_1.864198	138	190	4	10	52	0.1923077
NODE_120047_length_342_cov_1.864198	138	190	6	15	52	0.2884615
NODE_120047_length_342_cov_1.864198	138	190	8	19	52	0.3653846
NODE_120047_length_342_cov_1.864198	138	190	10	8	52	0.1538462
NODE_120047_length_342_cov_1.864198	183	243	4	11	60	0.1833333
NODE_120047_length_342_cov_1.864198	183	243	6	10	60	0.1666667
NODE_120047_length_342_cov_1.864198	183	243	7	1	60	0.0166667
NODE_120047_length_342_cov_1.864198	183	243	8	37	60	0.6166667
NODE_120047_length_342_cov_1.864198	183	243	10	1	60	0.0166667
NODE_120073_length_342_cov_1.720165	91	147	14	27	56	0.4821429
NODE_120073_length_342_cov_1.720165	91	147	16	13	56	0.2321429
NODE_120073_length_342_cov_1.720165	91	147	18	16	56	0.2857143
NODE_120284_length_342_cov_1.271605	201	240	0	39	39	1.0000000
NODE_120755_length_341_cov_15.896694	50	130	2	13	80	0.1625000
NODE_120755_length_341_cov_15.896694	50	130	3	11	80	0.1375000
NODE_120755_length_341_cov_15.896694	50	130	4	56	80	0.7000000
NODE_120755_length_341_cov_15.896694	103	183	2	45	80	0.5625000
NODE_120755_length_341_cov_15.896694	103	183	4	35	80	0.4375000
NODE_120757_length_341_cov_9.756198	117	196	0	34	79	0.4303797
NODE_120757_length_341_cov_9.756198	117	196	1	1	79	0.0126582
NODE_120757_length_341_cov_9.756198	117	196	2	44	79	0.5569620
NODE_120770_length_341_cov_5.404959	141	220	2	44	79	0.5569620
NODE_120770_length_341_cov_5.404959	141	220	4	35	79	0.4430380
NODE_120780_length_341_cov_4.669421	301	320	0	19	19	1.0000000
NODE_120783_length_341_cov_4.438017	57	132	0	20	75	0.2666667
NODE_120783_length_341_cov_4.438017	57	132	2	55	75	0.7333333
NODE_120783_length_341_cov_4.438017	110	185	0	30	75	0.4000000
NODE_120783_length_341_cov_4.438017	110	185	2	45	75	0.6000000
NODE_120785_length_341_cov_4.400826	164	244	0	72	80	0.9000000
NODE_120785_length_341_cov_4.400826	164	244	2	8	80	0.1000000
NODE_120785_length_341_cov_4.400826	224	297	0	31	73	0.4246575
NODE_120785_length_341_cov_4.400826	224	297	2	42	73	0.5753425
NODE_120797_length_341_cov_3.896694	58	122	0	13	64	0.2031250
NODE_120797_length_341_cov_3.896694	58	122	2	4	64	0.0625000
NODE_120797_length_341_cov_3.896694	58	122	4	8	64	0.1250000
NODE_120797_length_341_cov_3.896694	58	122	8	7	64	0.1093750
NODE_120797_length_341_cov_3.896694	58	122	10	1	64	0.0156250
NODE_120797_length_341_cov_3.896694	58	122	12	16	64	0.2500000
NODE_120797_length_341_cov_3.896694	58	122	14	1	64	0.0156250
NODE_120797_length_341_cov_3.896694	58	122	15	9	64	0.1406250
NODE_120797_length_341_cov_3.896694	58	122	16	5	64	0.0781250
NODE_120805_length_341_cov_3.727273	191	273	0	38	82	0.4634146
NODE_120805_length_341_cov_3.727273	191	273	4	44	82	0.5365854
NODE_120805_length_341_cov_3.727273	253	326	0	73	73	1.0000000
NODE_120839_length_341_cov_3.000000	91	161	2	70	70	1.0000000
NODE_120839_length_341_cov_3.000000	146	215	0	31	69	0.4492754
NODE_120839_length_341_cov_3.000000	146	215	2	38	69	0.5507246
NODE_120840_length_341_cov_3.000000	127	207	0	40	80	0.5000000
NODE_120840_length_341_cov_3.000000	127	207	4	40	80	0.5000000
NODE_120892_length_341_cov_2.533058	92	172	0	26	80	0.3250000
NODE_120892_length_341_cov_2.533058	92	172	2	54	80	0.6750000
NODE_120901_length_341_cov_2.495868	8	89	0	81	81	1.0000000
NODE_120946_length_341_cov_2.235537	10	90	0	80	80	1.0000000
NODE_120972_length_341_cov_2.103306	46	125	0	35	79	0.4430380
NODE_120972_length_341_cov_2.103306	46	125	2	44	79	0.5569620
NODE_120994_length_341_cov_2.066116	147	184	5	1	37	0.0270270
NODE_120994_length_341_cov_2.066116	147	184	7	3	37	0.0810811
NODE_120994_length_341_cov_2.066116	147	184	9	3	37	0.0810811
NODE_120994_length_341_cov_2.066116	147	184	11	30	37	0.8108108
NODE_121052_length_341_cov_1.772727	179	250	0	71	71	1.0000000
NODE_121064_length_341_cov_1.727273	105	185	0	43	80	0.5375000
NODE_121064_length_341_cov_1.727273	105	185	2	37	80	0.4625000
NODE_121160_length_341_cov_1.475207	120	185	8	20	65	0.3076923
NODE_121160_length_341_cov_1.475207	120	185	10	45	65	0.6923077
NODE_121160_length_341_cov_1.475207	158	238	0	34	80	0.4250000
NODE_121160_length_341_cov_1.475207	158	238	2	2	80	0.0250000
NODE_121160_length_341_cov_1.475207	158	238	6	8	80	0.1000000
NODE_121160_length_341_cov_1.475207	158	238	8	29	80	0.3625000
NODE_121160_length_341_cov_1.475207	158	238	10	7	80	0.0875000
NODE_121173_length_341_cov_1.471074	186	266	2	5	80	0.0625000
NODE_121173_length_341_cov_1.471074	186	266	6	46	80	0.5750000
NODE_121173_length_341_cov_1.471074	186	266	7	1	80	0.0125000
NODE_121173_length_341_cov_1.471074	186	266	8	28	80	0.3500000
NODE_121173_length_341_cov_1.471074	239	319	0	2	80	0.0250000
NODE_121173_length_341_cov_1.471074	239	319	2	29	80	0.3625000
NODE_121173_length_341_cov_1.471074	239	319	6	34	80	0.4250000
NODE_121173_length_341_cov_1.471074	239	319	8	15	80	0.1875000
NODE_121211_length_341_cov_1.342975	284	322	0	38	38	1.0000000
NODE_121431_length_341_cov_0.991736	36	89	0	53	53	1.0000000
NODE_121693_length_340_cov_541.348548	86	144	144	1	58	0.0172414
NODE_121693_length_340_cov_541.348548	86	144	146	1	58	0.0172414
NODE_121693_length_340_cov_541.348548	86	144	148	2	58	0.0344828
NODE_121693_length_340_cov_541.348548	86	144	162	1	58	0.0172414
NODE_121693_length_340_cov_541.348548	86	144	164	1	58	0.0172414
NODE_121693_length_340_cov_541.348548	86	144	174	1	58	0.0172414
NODE_121693_length_340_cov_541.348548	86	144	179	1	58	0.0172414
NODE_121693_length_340_cov_541.348548	86	144	180	1	58	0.0172414
NODE_121693_length_340_cov_541.348548	86	144	191	1	58	0.0172414
NODE_121693_length_340_cov_541.348548	86	144	202	1	58	0.0172414
NODE_121693_length_340_cov_541.348548	86	144	205	1	58	0.0172414
NODE_121693_length_340_cov_541.348548	86	144	209	1	58	0.0172414
NODE_121693_length_340_cov_541.348548	86	144	219	1	58	0.0172414
NODE_121693_length_340_cov_541.348548	86	144	226	1	58	0.0172414
NODE_121693_length_340_cov_541.348548	86	144	240	1	58	0.0172414
NODE_121693_length_340_cov_541.348548	86	144	250	1	58	0.0172414
NODE_121693_length_340_cov_541.348548	86	144	252	1	58	0.0172414
NODE_121693_length_340_cov_541.348548	86	144	254	1	58	0.0172414
NODE_121693_length_340_cov_541.348548	86	144	255	1	58	0.0172414
NODE_121693_length_340_cov_541.348548	86	144	266	1	58	0.0172414
NODE_121693_length_340_cov_541.348548	86	144	277	1	58	0.0172414
NODE_121693_length_340_cov_541.348548	86	144	279	1	58	0.0172414
NODE_121693_length_340_cov_541.348548	86	144	282	1	58	0.0172414
NODE_121693_length_340_cov_541.348548	86	144	284	1	58	0.0172414
NODE_121693_length_340_cov_541.348548	86	144	287	1	58	0.0172414
NODE_121693_length_340_cov_541.348548	86	144	289	1	58	0.0172414
NODE_121693_length_340_cov_541.348548	86	144	291	1	58	0.0172414
NODE_121693_length_340_cov_541.348548	86	144	292	1	58	0.0172414
NODE_121693_length_340_cov_541.348548	86	144	299	1	58	0.0172414
NODE_121693_length_340_cov_541.348548	86	144	302	1	58	0.0172414
NODE_121693_length_340_cov_541.348548	86	144	311	1	58	0.0172414
NODE_121693_length_340_cov_541.348548	86	144	319	1	58	0.0172414
NODE_121693_length_340_cov_541.348548	86	144	323	1	58	0.0172414
NODE_121693_length_340_cov_541.348548	86	144	329	1	58	0.0172414
NODE_121693_length_340_cov_541.348548	86	144	334	1	58	0.0172414
NODE_121693_length_340_cov_541.348548	86	144	340	1	58	0.0172414
NODE_121693_length_340_cov_541.348548	86	144	346	1	58	0.0172414
NODE_121693_length_340_cov_541.348548	86	144	350	1	58	0.0172414
NODE_121693_length_340_cov_541.348548	86	144	368	1	58	0.0172414
NODE_121693_length_340_cov_541.348548	86	144	386	1	58	0.0172414
NODE_121693_length_340_cov_541.348548	86	144	398	1	58	0.0172414
NODE_121693_length_340_cov_541.348548	86	144	401	1	58	0.0172414
NODE_121693_length_340_cov_541.348548	86	144	411	1	58	0.0172414
NODE_121693_length_340_cov_541.348548	86	144	415	1	58	0.0172414
NODE_121693_length_340_cov_541.348548	86	144	440	1	58	0.0172414
NODE_121693_length_340_cov_541.348548	86	144	450	1	58	0.0172414
NODE_121693_length_340_cov_541.348548	86	144	456	1	58	0.0172414
NODE_121693_length_340_cov_541.348548	86	144	460	1	58	0.0172414
NODE_121693_length_340_cov_541.348548	86	144	470	1	58	0.0172414
NODE_121693_length_340_cov_541.348548	86	144	495	1	58	0.0172414
NODE_121693_length_340_cov_541.348548	86	144	506	1	58	0.0172414
NODE_121693_length_340_cov_541.348548	86	144	512	1	58	0.0172414
NODE_121693_length_340_cov_541.348548	86	144	524	1	58	0.0172414
NODE_121693_length_340_cov_541.348548	86	144	541	1	58	0.0172414
NODE_121693_length_340_cov_541.348548	86	144	551	1	58	0.0172414
NODE_121693_length_340_cov_541.348548	86	144	558	1	58	0.0172414
NODE_121693_length_340_cov_541.348548	86	144	570	1	58	0.0172414
NODE_121693_length_340_cov_541.348548	86	154	144	1	68	0.0147059
NODE_121693_length_340_cov_541.348548	86	154	146	1	68	0.0147059
NODE_121693_length_340_cov_541.348548	86	154	148	2	68	0.0294118
NODE_121693_length_340_cov_541.348548	86	154	162	1	68	0.0147059
NODE_121693_length_340_cov_541.348548	86	154	164	1	68	0.0147059
NODE_121693_length_340_cov_541.348548	86	154	174	1	68	0.0147059
NODE_121693_length_340_cov_541.348548	86	154	179	1	68	0.0147059
NODE_121693_length_340_cov_541.348548	86	154	180	1	68	0.0147059
NODE_121693_length_340_cov_541.348548	86	154	191	1	68	0.0147059
NODE_121693_length_340_cov_541.348548	86	154	202	1	68	0.0147059
NODE_121693_length_340_cov_541.348548	86	154	205	1	68	0.0147059
NODE_121693_length_340_cov_541.348548	86	154	209	1	68	0.0147059
NODE_121693_length_340_cov_541.348548	86	154	219	1	68	0.0147059
NODE_121693_length_340_cov_541.348548	86	154	226	1	68	0.0147059
NODE_121693_length_340_cov_541.348548	86	154	240	1	68	0.0147059
NODE_121693_length_340_cov_541.348548	86	154	250	1	68	0.0147059
NODE_121693_length_340_cov_541.348548	86	154	252	1	68	0.0147059
NODE_121693_length_340_cov_541.348548	86	154	254	1	68	0.0147059
NODE_121693_length_340_cov_541.348548	86	154	255	1	68	0.0147059
NODE_121693_length_340_cov_541.348548	86	154	266	1	68	0.0147059
NODE_121693_length_340_cov_541.348548	86	154	277	1	68	0.0147059
NODE_121693_length_340_cov_541.348548	86	154	279	1	68	0.0147059
NODE_121693_length_340_cov_541.348548	86	154	282	1	68	0.0147059
NODE_121693_length_340_cov_541.348548	86	154	284	1	68	0.0147059
NODE_121693_length_340_cov_541.348548	86	154	287	1	68	0.0147059
NODE_121693_length_340_cov_541.348548	86	154	289	1	68	0.0147059
NODE_121693_length_340_cov_541.348548	86	154	291	1	68	0.0147059
NODE_121693_length_340_cov_541.348548	86	154	292	1	68	0.0147059
NODE_121693_length_340_cov_541.348548	86	154	299	1	68	0.0147059
NODE_121693_length_340_cov_541.348548	86	154	302	1	68	0.0147059
NODE_121693_length_340_cov_541.348548	86	154	311	1	68	0.0147059
NODE_121693_length_340_cov_541.348548	86	154	319	1	68	0.0147059
NODE_121693_length_340_cov_541.348548	86	154	323	1	68	0.0147059
NODE_121693_length_340_cov_541.348548	86	154	329	1	68	0.0147059
NODE_121693_length_340_cov_541.348548	86	154	334	1	68	0.0147059
NODE_121693_length_340_cov_541.348548	86	154	340	1	68	0.0147059
NODE_121693_length_340_cov_541.348548	86	154	346	1	68	0.0147059
NODE_121693_length_340_cov_541.348548	86	154	350	1	68	0.0147059
NODE_121693_length_340_cov_541.348548	86	154	368	1	68	0.0147059
NODE_121693_length_340_cov_541.348548	86	154	386	1	68	0.0147059
NODE_121693_length_340_cov_541.348548	86	154	398	1	68	0.0147059
NODE_121693_length_340_cov_541.348548	86	154	401	1	68	0.0147059
NODE_121693_length_340_cov_541.348548	86	154	411	1	68	0.0147059
NODE_121693_length_340_cov_541.348548	86	154	415	1	68	0.0147059
NODE_121693_length_340_cov_541.348548	86	154	440	1	68	0.0147059
NODE_121693_length_340_cov_541.348548	86	154	450	1	68	0.0147059
NODE_121693_length_340_cov_541.348548	86	154	456	1	68	0.0147059
NODE_121693_length_340_cov_541.348548	86	154	460	1	68	0.0147059
NODE_121693_length_340_cov_541.348548	86	154	470	1	68	0.0147059
NODE_121693_length_340_cov_541.348548	86	154	495	1	68	0.0147059
NODE_121693_length_340_cov_541.348548	86	154	506	1	68	0.0147059
NODE_121693_length_340_cov_541.348548	86	154	512	1	68	0.0147059
NODE_121693_length_340_cov_541.348548	86	154	524	1	68	0.0147059
NODE_121693_length_340_cov_541.348548	86	154	541	1	68	0.0147059
NODE_121693_length_340_cov_541.348548	86	154	551	1	68	0.0147059
NODE_121693_length_340_cov_541.348548	86	154	558	1	68	0.0147059
NODE_121693_length_340_cov_541.348548	86	154	570	1	68	0.0147059
NODE_121693_length_340_cov_541.348548	86	154	574	1	68	0.0147059
NODE_121693_length_340_cov_541.348548	86	154	582	1	68	0.0147059
NODE_121693_length_340_cov_541.348548	86	154	587	1	68	0.0147059
NODE_121693_length_340_cov_541.348548	86	154	590	1	68	0.0147059
NODE_121693_length_340_cov_541.348548	86	154	593	1	68	0.0147059
NODE_121693_length_340_cov_541.348548	86	154	594	1	68	0.0147059
NODE_121693_length_340_cov_541.348548	86	154	599	1	68	0.0147059
NODE_121693_length_340_cov_541.348548	86	154	623	1	68	0.0147059
NODE_121693_length_340_cov_541.348548	86	154	628	1	68	0.0147059
NODE_121693_length_340_cov_541.348548	86	154	638	1	68	0.0147059
NODE_121693_length_340_cov_541.348548	86	107	144	1	21	0.0476190
NODE_121693_length_340_cov_541.348548	86	107	146	1	21	0.0476190
NODE_121693_length_340_cov_541.348548	86	107	148	2	21	0.0952381
NODE_121693_length_340_cov_541.348548	86	107	162	1	21	0.0476190
NODE_121693_length_340_cov_541.348548	86	107	164	1	21	0.0476190
NODE_121693_length_340_cov_541.348548	86	107	174	1	21	0.0476190
NODE_121693_length_340_cov_541.348548	86	107	179	1	21	0.0476190
NODE_121693_length_340_cov_541.348548	86	107	180	1	21	0.0476190
NODE_121693_length_340_cov_541.348548	86	107	191	1	21	0.0476190
NODE_121693_length_340_cov_541.348548	86	107	202	1	21	0.0476190
NODE_121693_length_340_cov_541.348548	86	107	205	1	21	0.0476190
NODE_121693_length_340_cov_541.348548	86	107	209	1	21	0.0476190
NODE_121693_length_340_cov_541.348548	86	107	219	1	21	0.0476190
NODE_121693_length_340_cov_541.348548	86	107	226	1	21	0.0476190
NODE_121693_length_340_cov_541.348548	86	107	240	1	21	0.0476190
NODE_121693_length_340_cov_541.348548	86	107	250	1	21	0.0476190
NODE_121693_length_340_cov_541.348548	86	107	252	1	21	0.0476190
NODE_121693_length_340_cov_541.348548	86	107	254	1	21	0.0476190
NODE_121693_length_340_cov_541.348548	86	107	255	1	21	0.0476190
NODE_121693_length_340_cov_541.348548	86	107	266	1	21	0.0476190
NODE_121694_length_340_cov_50.755187	196	266	14	28	70	0.4000000
NODE_121694_length_340_cov_50.755187	196	266	16	30	70	0.4285714
NODE_121694_length_340_cov_50.755187	196	266	17	1	70	0.0142857
NODE_121694_length_340_cov_50.755187	196	266	18	11	70	0.1571429
NODE_121696_length_340_cov_8.917012	240	270	0	22	30	0.7333333
NODE_121696_length_340_cov_8.917012	240	270	2	8	30	0.2666667
NODE_121696_length_340_cov_8.917012	243	315	0	67	72	0.9305556
NODE_121696_length_340_cov_8.917012	243	315	2	5	72	0.0694444
NODE_121702_length_340_cov_6.439834	175	255	0	80	80	1.0000000
NODE_121702_length_340_cov_6.439834	228	310	0	82	82	1.0000000
NODE_121708_length_340_cov_5.883817	72	121	0	4	49	0.0816327
NODE_121708_length_340_cov_5.883817	72	121	4	2	49	0.0408163
NODE_121708_length_340_cov_5.883817	72	121	6	7	49	0.1428571
NODE_121708_length_340_cov_5.883817	72	121	8	36	49	0.7346939
NODE_121708_length_340_cov_5.883817	82	113	6	3	31	0.0967742
NODE_121708_length_340_cov_5.883817	82	113	8	28	31	0.9032258
NODE_121714_length_340_cov_5.228216	116	186	0	15	70	0.2142857
NODE_121714_length_340_cov_5.228216	116	186	2	55	70	0.7857143
NODE_121714_length_340_cov_5.228216	159	201	0	30	42	0.7142857
NODE_121714_length_340_cov_5.228216	159	201	2	12	42	0.2857143
NODE_121730_length_340_cov_4.497925	136	184	0	31	48	0.6458333
NODE_121730_length_340_cov_4.497925	136	184	4	17	48	0.3541667
NODE_121752_length_340_cov_3.759336	88	169	0	50	81	0.6172839
NODE_121752_length_340_cov_3.759336	88	169	2	31	81	0.3827161
NODE_121849_length_340_cov_2.506224	68	114	0	46	46	1.0000000
NODE_121951_length_340_cov_1.995851	29	101	2	3	72	0.0416667
NODE_121951_length_340_cov_1.995851	29	101	4	69	72	0.9583333
NODE_121951_length_340_cov_1.995851	96	143	4	38	47	0.8085107
NODE_121951_length_340_cov_1.995851	96	143	6	9	47	0.1914894
NODE_122154_length_340_cov_1.427386	244	274	4	17	30	0.5666667
NODE_122154_length_340_cov_1.427386	244	274	6	13	30	0.4333333
NODE_122218_length_340_cov_1.282158	71	135	0	26	64	0.4062500
NODE_122218_length_340_cov_1.282158	71	135	2	12	64	0.1875000
NODE_122218_length_340_cov_1.282158	71	135	4	26	64	0.4062500
NODE_122218_length_340_cov_1.282158	128	188	4	60	60	1.0000000
NODE_122218_length_340_cov_1.282158	142	189	4	47	47	1.0000000
NODE_122220_length_340_cov_1.278008	51	102	2	10	51	0.1960784
NODE_122220_length_340_cov_1.278008	51	102	4	6	51	0.1176471
NODE_122220_length_340_cov_1.278008	51	102	6	23	51	0.4509804
NODE_122220_length_340_cov_1.278008	51	102	8	12	51	0.2352941
NODE_122321_length_340_cov_1.199170	98	160	0	62	62	1.0000000
NODE_122381_length_340_cov_1.070539	32	65	0	33	33	1.0000000
NODE_122429_length_340_cov_1.020747	209	228	0	13	19	0.6842105
NODE_122429_length_340_cov_1.020747	209	228	2	6	19	0.3157895
NODE_122686_length_339_cov_87.841667	149	227	56	4	78	0.0512821
NODE_122686_length_339_cov_87.841667	149	227	58	1	78	0.0128205
NODE_122686_length_339_cov_87.841667	149	227	60	2	78	0.0256410
NODE_122686_length_339_cov_87.841667	149	227	64	8	78	0.1025641
NODE_122686_length_339_cov_87.841667	149	227	72	1	78	0.0128205
NODE_122686_length_339_cov_87.841667	149	227	73	1	78	0.0128205
NODE_122686_length_339_cov_87.841667	149	227	74	3	78	0.0384615
NODE_122686_length_339_cov_87.841667	149	227	76	2	78	0.0256410
NODE_122686_length_339_cov_87.841667	149	227	78	2	78	0.0256410
NODE_122686_length_339_cov_87.841667	149	227	82	3	78	0.0384615
NODE_122686_length_339_cov_87.841667	149	227	83	4	78	0.0512821
NODE_122686_length_339_cov_87.841667	149	227	84	1	78	0.0128205
NODE_122686_length_339_cov_87.841667	149	227	85	1	78	0.0128205
NODE_122686_length_339_cov_87.841667	149	227	87	1	78	0.0128205
NODE_122686_length_339_cov_87.841667	149	227	91	3	78	0.0384615
NODE_122686_length_339_cov_87.841667	149	227	95	3	78	0.0384615
NODE_122686_length_339_cov_87.841667	149	227	99	1	78	0.0128205
NODE_122686_length_339_cov_87.841667	149	227	100	1	78	0.0128205
NODE_122686_length_339_cov_87.841667	149	227	101	1	78	0.0128205
NODE_122686_length_339_cov_87.841667	149	227	103	1	78	0.0128205
NODE_122686_length_339_cov_87.841667	149	227	105	1	78	0.0128205
NODE_122686_length_339_cov_87.841667	149	227	107	3	78	0.0384615
NODE_122686_length_339_cov_87.841667	149	227	109	3	78	0.0384615
NODE_122686_length_339_cov_87.841667	149	227	111	2	78	0.0256410
NODE_122686_length_339_cov_87.841667	149	227	113	3	78	0.0384615
NODE_122686_length_339_cov_87.841667	149	227	116	1	78	0.0128205
NODE_122686_length_339_cov_87.841667	149	227	118	1	78	0.0128205
NODE_122686_length_339_cov_87.841667	149	227	122	2	78	0.0256410
NODE_122686_length_339_cov_87.841667	149	227	134	1	78	0.0128205
NODE_122686_length_339_cov_87.841667	149	227	136	1	78	0.0128205
NODE_122686_length_339_cov_87.841667	149	227	138	2	78	0.0256410
NODE_122686_length_339_cov_87.841667	149	227	139	8	78	0.1025641
NODE_122686_length_339_cov_87.841667	149	227	140	2	78	0.0256410
NODE_122686_length_339_cov_87.841667	149	227	142	4	78	0.0512821
NODE_122687_length_339_cov_14.304167	69	138	8	6	69	0.0869565
NODE_122687_length_339_cov_14.304167	69	138	10	2	69	0.0289855
NODE_122687_length_339_cov_14.304167	69	138	12	11	69	0.1594203
NODE_122687_length_339_cov_14.304167	69	138	14	33	69	0.4782609
NODE_122687_length_339_cov_14.304167	69	138	16	17	69	0.2463768
NODE_122687_length_339_cov_14.304167	69	138	8	6	69	0.0869565
NODE_122687_length_339_cov_14.304167	69	138	10	2	69	0.0289855
NODE_122687_length_339_cov_14.304167	69	138	12	11	69	0.1594203
NODE_122687_length_339_cov_14.304167	69	138	14	33	69	0.4782609
NODE_122687_length_339_cov_14.304167	69	138	16	17	69	0.2463768
NODE_122687_length_339_cov_14.304167	69	138	8	6	69	0.0869565
NODE_122687_length_339_cov_14.304167	69	138	10	2	69	0.0289855
NODE_122687_length_339_cov_14.304167	69	138	12	11	69	0.1594203
NODE_122687_length_339_cov_14.304167	69	138	14	33	69	0.4782609
NODE_122687_length_339_cov_14.304167	69	138	16	17	69	0.2463768
NODE_122687_length_339_cov_14.304167	88	138	8	6	50	0.1200000
NODE_122687_length_339_cov_14.304167	88	138	10	2	50	0.0400000
NODE_122687_length_339_cov_14.304167	88	138	12	5	50	0.1000000
NODE_122687_length_339_cov_14.304167	88	138	14	20	50	0.4000000
NODE_122687_length_339_cov_14.304167	88	138	16	17	50	0.3400000
NODE_122687_length_339_cov_14.304167	111	160	4	8	49	0.1632653
NODE_122687_length_339_cov_14.304167	111	160	6	10	49	0.2040816
NODE_122687_length_339_cov_14.304167	111	160	8	10	49	0.2040816
NODE_122687_length_339_cov_14.304167	111	160	10	2	49	0.0408163
NODE_122687_length_339_cov_14.304167	111	160	12	5	49	0.1020408
NODE_122687_length_339_cov_14.304167	111	160	14	8	49	0.1632653
NODE_122687_length_339_cov_14.304167	111	160	16	6	49	0.1224490
NODE_122727_length_339_cov_4.320833	187	267	0	80	80	1.0000000
NODE_122804_length_339_cov_2.754167	45	125	0	6	80	0.0750000
NODE_122804_length_339_cov_2.754167	45	125	2	2	80	0.0250000
NODE_122804_length_339_cov_2.754167	45	125	4	10	80	0.1250000
NODE_122804_length_339_cov_2.754167	45	125	5	16	80	0.2000000
NODE_122804_length_339_cov_2.754167	45	125	6	46	80	0.5750000
NODE_122971_length_339_cov_1.841667	265	312	0	47	47	1.0000000
NODE_123041_length_339_cov_1.662500	10	57	2	4	47	0.0851064
NODE_123041_length_339_cov_1.662500	10	57	4	43	47	0.9148936
NODE_123182_length_339_cov_1.275000	247	312	0	65	65	1.0000000
NODE_123285_length_339_cov_1.070833	147	169	0	22	22	1.0000000
NODE_123633_length_338_cov_57.163180	59	120	0	61	61	1.0000000
NODE_123633_length_338_cov_57.163180	102	176	0	74	74	1.0000000
NODE_123674_length_338_cov_4.263598	113	165	0	52	52	1.0000000
NODE_123679_length_338_cov_4.079498	96	151	0	55	55	1.0000000
NODE_123689_length_338_cov_3.841004	122	149	0	27	27	1.0000000
NODE_123793_length_338_cov_2.393305	216	288	2	72	72	1.0000000
NODE_123795_length_338_cov_2.380753	29	93	0	64	64	1.0000000
NODE_123919_length_338_cov_1.878661	146	232	17	3	86	0.0348837
NODE_123919_length_338_cov_1.878661	146	232	18	5	86	0.0581395
NODE_123919_length_338_cov_1.878661	146	232	19	6	86	0.0697674
NODE_123919_length_338_cov_1.878661	146	232	20	2	86	0.0232558
NODE_123919_length_338_cov_1.878661	146	232	21	4	86	0.0465116
NODE_123919_length_338_cov_1.878661	146	232	22	11	86	0.1279070
NODE_123919_length_338_cov_1.878661	146	232	23	1	86	0.0116279
NODE_123919_length_338_cov_1.878661	146	232	25	7	86	0.0813954
NODE_123919_length_338_cov_1.878661	146	232	26	2	86	0.0232558
NODE_123919_length_338_cov_1.878661	146	232	28	20	86	0.2325581
NODE_123919_length_338_cov_1.878661	146	232	30	1	86	0.0116279
NODE_123919_length_338_cov_1.878661	146	232	32	4	86	0.0465116
NODE_123919_length_338_cov_1.878661	146	232	34	2	86	0.0232558
NODE_123919_length_338_cov_1.878661	146	232	36	3	86	0.0348837
NODE_123919_length_338_cov_1.878661	146	232	38	3	86	0.0348837
NODE_123919_length_338_cov_1.878661	146	232	40	1	86	0.0116279
NODE_123919_length_338_cov_1.878661	146	232	42	5	86	0.0581395
NODE_123919_length_338_cov_1.878661	146	232	44	4	86	0.0465116
NODE_123919_length_338_cov_1.878661	146	232	46	2	86	0.0232558
NODE_123944_length_338_cov_1.740586	79	159	0	32	80	0.4000000
NODE_123944_length_338_cov_1.740586	79	159	2	48	80	0.6000000
NODE_123946_length_338_cov_1.732218	216	257	0	41	41	1.0000000
NODE_124046_length_338_cov_1.493724	14	90	0	76	76	1.0000000
NODE_124247_length_338_cov_1.100418	265	333	0	68	68	1.0000000
NODE_124456_length_338_cov_0.849372	281	338	0	17	57	0.2982456
NODE_124456_length_338_cov_0.849372	281	338	2	40	57	0.7017544
NODE_124533_length_338_cov_0.711297	188	263	2	14	75	0.1866667
NODE_124533_length_338_cov_0.711297	188	263	4	61	75	0.8133333
NODE_124625_length_337_cov_468.180672	107	187	22	3	80	0.0375000
NODE_124625_length_337_cov_468.180672	107	187	26	7	80	0.0875000
NODE_124625_length_337_cov_468.180672	107	187	28	1	80	0.0125000
NODE_124625_length_337_cov_468.180672	107	187	32	7	80	0.0875000
NODE_124625_length_337_cov_468.180672	107	187	34	2	80	0.0250000
NODE_124625_length_337_cov_468.180672	107	187	36	1	80	0.0125000
NODE_124625_length_337_cov_468.180672	107	187	38	2	80	0.0250000
NODE_124625_length_337_cov_468.180672	107	187	40	4	80	0.0500000
NODE_124625_length_337_cov_468.180672	107	187	42	5	80	0.0625000
NODE_124625_length_337_cov_468.180672	107	187	44	5	80	0.0625000
NODE_124625_length_337_cov_468.180672	107	187	46	14	80	0.1750000
NODE_124625_length_337_cov_468.180672	107	187	47	7	80	0.0875000
NODE_124625_length_337_cov_468.180672	107	187	48	12	80	0.1500000
NODE_124625_length_337_cov_468.180672	107	187	49	1	80	0.0125000
NODE_124625_length_337_cov_468.180672	107	187	51	3	80	0.0375000
NODE_124625_length_337_cov_468.180672	107	187	53	1	80	0.0125000
NODE_124625_length_337_cov_468.180672	107	187	55	1	80	0.0125000
NODE_124625_length_337_cov_468.180672	107	187	57	3	80	0.0375000
NODE_124625_length_337_cov_468.180672	107	187	59	1	80	0.0125000
NODE_124625_length_337_cov_468.180672	160	230	0	8	70	0.1142857
NODE_124625_length_337_cov_468.180672	160	230	2	4	70	0.0571429
NODE_124625_length_337_cov_468.180672	160	230	4	2	70	0.0285714
NODE_124625_length_337_cov_468.180672	160	230	6	3	70	0.0428571
NODE_124625_length_337_cov_468.180672	160	230	10	3	70	0.0428571
NODE_124625_length_337_cov_468.180672	160	230	14	2	70	0.0285714
NODE_124625_length_337_cov_468.180672	160	230	16	8	70	0.1142857
NODE_124625_length_337_cov_468.180672	160	230	18	2	70	0.0285714
NODE_124625_length_337_cov_468.180672	160	230	19	1	70	0.0142857
NODE_124625_length_337_cov_468.180672	160	230	20	9	70	0.1285714
NODE_124625_length_337_cov_468.180672	160	230	22	4	70	0.0571429
NODE_124625_length_337_cov_468.180672	160	230	26	7	70	0.1000000
NODE_124625_length_337_cov_468.180672	160	230	28	1	70	0.0142857
NODE_124625_length_337_cov_468.180672	160	230	32	7	70	0.1000000
NODE_124625_length_337_cov_468.180672	160	230	34	2	70	0.0285714
NODE_124625_length_337_cov_468.180672	160	230	36	1	70	0.0142857
NODE_124625_length_337_cov_468.180672	160	230	38	2	70	0.0285714
NODE_124625_length_337_cov_468.180672	160	230	40	4	70	0.0571429
NODE_124625_length_337_cov_468.180672	226	306	12	4	80	0.0500000
NODE_124625_length_337_cov_468.180672	226	306	14	1	80	0.0125000
NODE_124625_length_337_cov_468.180672	226	306	16	1	80	0.0125000
NODE_124625_length_337_cov_468.180672	226	306	18	7	80	0.0875000
NODE_124625_length_337_cov_468.180672	226	306	20	31	80	0.3875000
NODE_124625_length_337_cov_468.180672	226	306	21	1	80	0.0125000
NODE_124625_length_337_cov_468.180672	226	306	22	3	80	0.0375000
NODE_124625_length_337_cov_468.180672	226	306	24	32	80	0.4000000
NODE_124625_length_337_cov_468.180672	279	337	4	2	58	0.0344828
NODE_124625_length_337_cov_468.180672	279	337	8	26	58	0.4482759
NODE_124625_length_337_cov_468.180672	279	337	10	2	58	0.0344828
NODE_124625_length_337_cov_468.180672	279	337	12	5	58	0.0862069
NODE_124625_length_337_cov_468.180672	279	337	14	1	58	0.0172414
NODE_124625_length_337_cov_468.180672	279	337	16	1	58	0.0172414
NODE_124625_length_337_cov_468.180672	279	337	18	6	58	0.1034483
NODE_124625_length_337_cov_468.180672	279	337	20	15	58	0.2586207
NODE_124626_length_337_cov_91.344538	1	50	4	5	49	0.1020408
NODE_124626_length_337_cov_91.344538	1	50	6	13	49	0.2653061
NODE_124626_length_337_cov_91.344538	1	50	15	1	49	0.0204082
NODE_124626_length_337_cov_91.344538	1	50	16	3	49	0.0612245
NODE_124626_length_337_cov_91.344538	1	50	18	4	49	0.0816327
NODE_124626_length_337_cov_91.344538	1	50	20	3	49	0.0612245
NODE_124626_length_337_cov_91.344538	1	50	22	10	49	0.2040816
NODE_124626_length_337_cov_91.344538	1	50	24	5	49	0.1020408
NODE_124626_length_337_cov_91.344538	1	50	26	4	49	0.0816327
NODE_124626_length_337_cov_91.344538	1	50	28	1	49	0.0204082
NODE_124626_length_337_cov_91.344538	23	103	18	4	80	0.0500000
NODE_124626_length_337_cov_91.344538	23	103	20	3	80	0.0375000
NODE_124626_length_337_cov_91.344538	23	103	22	10	80	0.1250000
NODE_124626_length_337_cov_91.344538	23	103	24	5	80	0.0625000
NODE_124626_length_337_cov_91.344538	23	103	26	4	80	0.0500000
NODE_124626_length_337_cov_91.344538	23	103	28	2	80	0.0250000
NODE_124626_length_337_cov_91.344538	23	103	31	1	80	0.0125000
NODE_124626_length_337_cov_91.344538	23	103	32	3	80	0.0375000
NODE_124626_length_337_cov_91.344538	23	103	34	3	80	0.0375000
NODE_124626_length_337_cov_91.344538	23	103	38	8	80	0.1000000
NODE_124626_length_337_cov_91.344538	23	103	40	2	80	0.0250000
NODE_124626_length_337_cov_91.344538	23	103	42	6	80	0.0750000
NODE_124626_length_337_cov_91.344538	23	103	44	4	80	0.0500000
NODE_124626_length_337_cov_91.344538	23	103	46	4	80	0.0500000
NODE_124626_length_337_cov_91.344538	23	103	48	14	80	0.1750000
NODE_124626_length_337_cov_91.344538	23	103	50	2	80	0.0250000
NODE_124626_length_337_cov_91.344538	23	103	52	4	80	0.0500000
NODE_124626_length_337_cov_91.344538	23	103	54	1	80	0.0125000
NODE_124627_length_337_cov_73.352941	71	151	0	80	80	1.0000000
NODE_124627_length_337_cov_73.352941	124	204	0	80	80	1.0000000
NODE_124629_length_337_cov_46.978992	220	305	6	4	85	0.0470588
NODE_124629_length_337_cov_46.978992	220	305	8	2	85	0.0235294
NODE_124629_length_337_cov_46.978992	220	305	10	9	85	0.1058824
NODE_124629_length_337_cov_46.978992	220	305	12	10	85	0.1176471
NODE_124629_length_337_cov_46.978992	220	305	14	11	85	0.1294118
NODE_124629_length_337_cov_46.978992	220	305	16	49	85	0.5764706
NODE_124629_length_337_cov_46.978992	220	305	6	4	85	0.0470588
NODE_124629_length_337_cov_46.978992	220	305	8	2	85	0.0235294
NODE_124629_length_337_cov_46.978992	220	305	10	9	85	0.1058824
NODE_124629_length_337_cov_46.978992	220	305	12	10	85	0.1176471
NODE_124629_length_337_cov_46.978992	220	305	14	11	85	0.1294118
NODE_124629_length_337_cov_46.978992	220	305	16	49	85	0.5764706
NODE_124629_length_337_cov_46.978992	220	305	6	4	85	0.0470588
NODE_124629_length_337_cov_46.978992	220	305	8	2	85	0.0235294
NODE_124629_length_337_cov_46.978992	220	305	10	9	85	0.1058824
NODE_124629_length_337_cov_46.978992	220	305	12	10	85	0.1176471
NODE_124629_length_337_cov_46.978992	220	305	14	11	85	0.1294118
NODE_124629_length_337_cov_46.978992	220	305	16	49	85	0.5764706
NODE_124629_length_337_cov_46.978992	278	327	0	9	49	0.1836735
NODE_124629_length_337_cov_46.978992	278	327	1	1	49	0.0204082
NODE_124629_length_337_cov_46.978992	278	327	2	8	49	0.1632653
NODE_124629_length_337_cov_46.978992	278	327	4	1	49	0.0204082
NODE_124629_length_337_cov_46.978992	278	327	6	7	49	0.1428571
NODE_124629_length_337_cov_46.978992	278	327	8	2	49	0.0408163
NODE_124629_length_337_cov_46.978992	278	327	10	2	49	0.0408163
NODE_124629_length_337_cov_46.978992	278	327	12	4	49	0.0816327
NODE_124629_length_337_cov_46.978992	278	327	14	10	49	0.2040816
NODE_124629_length_337_cov_46.978992	278	327	16	5	49	0.1020408
NODE_124629_length_337_cov_46.978992	278	337	0	19	59	0.3220339
NODE_124629_length_337_cov_46.978992	278	337	1	1	59	0.0169492
NODE_124629_length_337_cov_46.978992	278	337	2	8	59	0.1355932
NODE_124629_length_337_cov_46.978992	278	337	4	1	59	0.0169492
NODE_124629_length_337_cov_46.978992	278	337	6	7	59	0.1186441
NODE_124629_length_337_cov_46.978992	278	337	8	2	59	0.0338983
NODE_124629_length_337_cov_46.978992	278	337	10	2	59	0.0338983
NODE_124629_length_337_cov_46.978992	278	337	12	4	59	0.0677966
NODE_124629_length_337_cov_46.978992	278	337	14	10	59	0.1694915
NODE_124629_length_337_cov_46.978992	278	337	16	5	59	0.0847458
NODE_124629_length_337_cov_46.978992	283	337	0	19	54	0.3518519
NODE_124629_length_337_cov_46.978992	283	337	1	1	54	0.0185185
NODE_124629_length_337_cov_46.978992	283	337	2	8	54	0.1481481
NODE_124629_length_337_cov_46.978992	283	337	4	1	54	0.0185185
NODE_124629_length_337_cov_46.978992	283	337	6	7	54	0.1296296
NODE_124629_length_337_cov_46.978992	283	337	8	2	54	0.0370370
NODE_124629_length_337_cov_46.978992	283	337	10	2	54	0.0370370
NODE_124629_length_337_cov_46.978992	283	337	12	4	54	0.0740741
NODE_124629_length_337_cov_46.978992	283	337	14	10	54	0.1851852
NODE_124640_length_337_cov_6.214286	52	95	0	43	43	1.0000000
NODE_124669_length_337_cov_4.298319	5	58	0	53	53	1.0000000
NODE_124703_length_337_cov_3.478992	179	259	6	15	80	0.1875000
NODE_124703_length_337_cov_3.478992	179	259	7	3	80	0.0375000
NODE_124703_length_337_cov_3.478992	179	259	9	2	80	0.0250000
NODE_124703_length_337_cov_3.478992	179	259	12	3	80	0.0375000
NODE_124703_length_337_cov_3.478992	179	259	14	6	80	0.0750000
NODE_124703_length_337_cov_3.478992	179	259	15	7	80	0.0875000
NODE_124703_length_337_cov_3.478992	179	259	16	20	80	0.2500000
NODE_124703_length_337_cov_3.478992	179	259	17	2	80	0.0250000
NODE_124703_length_337_cov_3.478992	179	259	19	1	80	0.0125000
NODE_124703_length_337_cov_3.478992	179	259	21	3	80	0.0375000
NODE_124703_length_337_cov_3.478992	179	259	23	15	80	0.1875000
NODE_124703_length_337_cov_3.478992	179	259	25	3	80	0.0375000
NODE_124703_length_337_cov_3.478992	232	307	4	40	75	0.5333334
NODE_124703_length_337_cov_3.478992	232	307	6	23	75	0.3066667
NODE_124703_length_337_cov_3.478992	232	307	7	3	75	0.0400000
NODE_124703_length_337_cov_3.478992	232	307	9	2	75	0.0266667
NODE_124703_length_337_cov_3.478992	232	307	12	2	75	0.0266667
NODE_124703_length_337_cov_3.478992	232	307	16	5	75	0.0666667
NODE_124759_length_337_cov_2.647059	80	146	0	65	66	0.9848485
NODE_124759_length_337_cov_2.647059	80	146	4	1	66	0.0151515
NODE_124858_length_337_cov_2.121849	23	103	0	80	80	1.0000000
NODE_124858_length_337_cov_2.121849	76	141	0	65	65	1.0000000
NODE_125001_length_337_cov_1.689076	138	218	0	8	80	0.1000000
NODE_125001_length_337_cov_1.689076	138	218	2	72	80	0.9000000
NODE_125024_length_337_cov_1.592437	109	151	0	42	42	1.0000000
NODE_125024_length_337_cov_1.592437	126	204	0	78	78	1.0000000
NODE_125074_length_337_cov_1.466387	266	332	0	66	66	1.0000000
NODE_125271_length_337_cov_1.071429	279	319	0	40	40	1.0000000
NODE_125332_length_337_cov_0.978992	227	272	0	45	45	1.0000000
NODE_125633_length_336_cov_7.843882	151	231	0	80	80	1.0000000
NODE_125645_length_336_cov_5.578059	159	220	0	28	61	0.4590164
NODE_125645_length_336_cov_5.578059	159	220	2	33	61	0.5409836
NODE_125645_length_336_cov_5.578059	212	273	2	61	61	1.0000000
NODE_125663_length_336_cov_4.481013	129	207	0	25	78	0.3205128
NODE_125663_length_336_cov_4.481013	129	207	2	53	78	0.6794872
NODE_125752_length_336_cov_2.755274	83	112	0	5	29	0.1724138
NODE_125752_length_336_cov_2.755274	83	112	2	18	29	0.6206896
NODE_125752_length_336_cov_2.755274	83	112	4	6	29	0.2068966
NODE_125752_length_336_cov_2.755274	187	268	0	4	81	0.0493827
NODE_125752_length_336_cov_2.755274	187	268	2	77	81	0.9506173
NODE_125806_length_336_cov_2.358650	60	133	0	33	73	0.4520548
NODE_125806_length_336_cov_2.358650	60	133	2	40	73	0.5479452
NODE_125811_length_336_cov_2.337553	93	173	0	80	80	1.0000000
NODE_125965_length_336_cov_1.729958	78	141	2	34	63	0.5396826
NODE_125965_length_336_cov_1.729958	78	141	4	29	63	0.4603175
NODE_125965_length_336_cov_1.729958	131	194	2	55	63	0.8730159
NODE_125965_length_336_cov_1.729958	131	194	4	8	63	0.1269841
NODE_126134_length_336_cov_1.333333	34	114	0	58	80	0.7250000
NODE_126134_length_336_cov_1.333333	34	114	2	3	80	0.0375000
NODE_126134_length_336_cov_1.333333	34	114	4	19	80	0.2375000
NODE_126134_length_336_cov_1.333333	87	124	0	5	37	0.1351351
NODE_126134_length_336_cov_1.333333	87	124	2	3	37	0.0810811
NODE_126134_length_336_cov_1.333333	87	124	4	29	37	0.7837838
NODE_126134_length_336_cov_1.333333	182	213	2	3	31	0.0967742
NODE_126134_length_336_cov_1.333333	182	213	4	28	31	0.9032258
NODE_126216_length_336_cov_1.244726	222	276	0	32	54	0.5925926
NODE_126216_length_336_cov_1.244726	222	276	2	22	54	0.4074074
NODE_126216_length_336_cov_1.244726	288	312	0	24	24	1.0000000
NODE_126260_length_336_cov_1.143460	129	154	0	25	25	1.0000000
NODE_126545_length_336_cov_0.670886	259	288	0	29	29	1.0000000
NODE_126606_length_335_cov_16.114407	162	242	0	80	80	1.0000000
NODE_126606_length_335_cov_16.114407	215	295	0	80	80	1.0000000
NODE_126609_length_335_cov_9.258475	177	250	0	8	73	0.1095890
NODE_126609_length_335_cov_9.258475	177	250	2	65	73	0.8904110
NODE_126614_length_335_cov_7.207627	29	109	0	80	80	1.0000000
NODE_126614_length_335_cov_7.207627	82	162	0	80	80	1.0000000
NODE_126636_length_335_cov_5.046610	182	263	0	27	81	0.3333333
NODE_126636_length_335_cov_5.046610	182	263	2	54	81	0.6666667
NODE_126639_length_335_cov_4.995763	144	215	0	71	71	1.0000000
NODE_126665_length_335_cov_3.923729	163	231	0	68	68	1.0000000
NODE_126787_length_335_cov_2.411017	230	294	2	57	64	0.8906250
NODE_126787_length_335_cov_2.411017	230	294	4	3	64	0.0468750
NODE_126787_length_335_cov_2.411017	230	294	6	4	64	0.0625000
NODE_126791_length_335_cov_2.402542	164	240	0	29	76	0.3815790
NODE_126791_length_335_cov_2.402542	164	240	2	7	76	0.0921053
NODE_126791_length_335_cov_2.402542	164	240	4	8	76	0.1052632
NODE_126791_length_335_cov_2.402542	164	240	6	1	76	0.0131579
NODE_126791_length_335_cov_2.402542	164	240	8	1	76	0.0131579
NODE_126791_length_335_cov_2.402542	164	240	12	2	76	0.0263158
NODE_126791_length_335_cov_2.402542	164	240	14	2	76	0.0263158
NODE_126791_length_335_cov_2.402542	164	240	16	8	76	0.1052632
NODE_126791_length_335_cov_2.402542	164	240	18	3	76	0.0394737
NODE_126791_length_335_cov_2.402542	164	240	20	4	76	0.0526316
NODE_126791_length_335_cov_2.402542	164	240	28	5	76	0.0657895
NODE_126791_length_335_cov_2.402542	164	240	30	4	76	0.0526316
NODE_126791_length_335_cov_2.402542	164	240	32	2	76	0.0263158
NODE_126792_length_335_cov_2.398305	116	179	0	63	63	1.0000000
NODE_126826_length_335_cov_2.161017	82	141	0	59	59	1.0000000
NODE_126835_length_335_cov_2.152542	61	134	0	50	73	0.6849315
NODE_126835_length_335_cov_2.152542	61	134	2	23	73	0.3150685
NODE_126835_length_335_cov_2.152542	114	134	2	20	20	1.0000000
NODE_126920_length_335_cov_1.766949	257	330	2	11	73	0.1506849
NODE_126920_length_335_cov_1.766949	257	330	4	62	73	0.8493150
NODE_126920_length_335_cov_1.766949	297	335	2	16	38	0.4210526
NODE_126920_length_335_cov_1.766949	297	335	4	22	38	0.5789474
NODE_127022_length_335_cov_1.529661	255	320	0	8	65	0.1230769
NODE_127022_length_335_cov_1.529661	255	320	4	57	65	0.8769231
NODE_127023_length_335_cov_1.525424	222	266	0	44	44	1.0000000
NODE_127062_length_335_cov_1.457627	38	87	0	49	49	1.0000000
NODE_127130_length_335_cov_1.296610	291	311	0	20	20	1.0000000
NODE_127130_length_335_cov_1.296610	291	311	0	20	20	1.0000000
NODE_127143_length_335_cov_1.292373	202	232	0	30	30	1.0000000
NODE_127200_length_335_cov_1.194915	75	156	0	8	81	0.0987654
NODE_127200_length_335_cov_1.194915	75	156	2	42	81	0.5185185
NODE_127200_length_335_cov_1.194915	75	156	4	5	81	0.0617284
NODE_127200_length_335_cov_1.194915	75	156	6	20	81	0.2469136
NODE_127200_length_335_cov_1.194915	75	156	8	6	81	0.0740741
NODE_127200_length_335_cov_1.194915	129	195	0	8	66	0.1212121
NODE_127200_length_335_cov_1.194915	129	195	2	50	66	0.7575758
NODE_127200_length_335_cov_1.194915	129	195	6	8	66	0.1212121
NODE_127310_length_335_cov_0.983051	96	117	0	21	21	1.0000000
NODE_127585_length_334_cov_275.425532	135	215	64	3	80	0.0375000
NODE_127585_length_334_cov_275.425532	135	215	68	4	80	0.0500000
NODE_127585_length_334_cov_275.425532	135	215	72	3	80	0.0375000
NODE_127585_length_334_cov_275.425532	135	215	73	2	80	0.0250000
NODE_127585_length_334_cov_275.425532	135	215	74	4	80	0.0500000
NODE_127585_length_334_cov_275.425532	135	215	75	6	80	0.0750000
NODE_127585_length_334_cov_275.425532	135	215	76	3	80	0.0375000
NODE_127585_length_334_cov_275.425532	135	215	77	4	80	0.0500000
NODE_127585_length_334_cov_275.425532	135	215	78	1	80	0.0125000
NODE_127585_length_334_cov_275.425532	135	215	80	4	80	0.0500000
NODE_127585_length_334_cov_275.425532	135	215	82	3	80	0.0375000
NODE_127585_length_334_cov_275.425532	135	215	86	4	80	0.0500000
NODE_127585_length_334_cov_275.425532	135	215	88	4	80	0.0500000
NODE_127585_length_334_cov_275.425532	135	215	89	1	80	0.0125000
NODE_127585_length_334_cov_275.425532	135	215	90	2	80	0.0250000
NODE_127585_length_334_cov_275.425532	135	215	91	4	80	0.0500000
NODE_127585_length_334_cov_275.425532	135	215	95	4	80	0.0500000
NODE_127585_length_334_cov_275.425532	135	215	96	2	80	0.0250000
NODE_127585_length_334_cov_275.425532	135	215	97	3	80	0.0375000
NODE_127585_length_334_cov_275.425532	135	215	98	3	80	0.0375000
NODE_127585_length_334_cov_275.425532	135	215	106	1	80	0.0125000
NODE_127585_length_334_cov_275.425532	135	215	108	3	80	0.0375000
NODE_127585_length_334_cov_275.425532	135	215	109	5	80	0.0625000
NODE_127585_length_334_cov_275.425532	135	215	110	2	80	0.0250000
NODE_127585_length_334_cov_275.425532	135	215	111	4	80	0.0500000
NODE_127585_length_334_cov_275.425532	135	215	113	1	80	0.0125000
NODE_127585_length_334_cov_275.425532	188	269	22	12	81	0.1481481
NODE_127585_length_334_cov_275.425532	188	269	24	2	81	0.0246914
NODE_127585_length_334_cov_275.425532	188	269	27	8	81	0.0987654
NODE_127585_length_334_cov_275.425532	188	269	29	12	81	0.1481481
NODE_127585_length_334_cov_275.425532	188	269	31	1	81	0.0123457
NODE_127585_length_334_cov_275.425532	188	269	35	1	81	0.0123457
NODE_127585_length_334_cov_275.425532	188	269	38	1	81	0.0123457
NODE_127585_length_334_cov_275.425532	188	269	40	2	81	0.0246914
NODE_127585_length_334_cov_275.425532	188	269	42	1	81	0.0123457
NODE_127585_length_334_cov_275.425532	188	269	44	2	81	0.0246914
NODE_127585_length_334_cov_275.425532	188	269	46	1	81	0.0123457
NODE_127585_length_334_cov_275.425532	188	269	48	1	81	0.0123457
NODE_127585_length_334_cov_275.425532	188	269	54	1	81	0.0123457
NODE_127585_length_334_cov_275.425532	188	269	56	1	81	0.0123457
NODE_127585_length_334_cov_275.425532	188	269	59	1	81	0.0123457
NODE_127585_length_334_cov_275.425532	188	269	62	1	81	0.0123457
NODE_127585_length_334_cov_275.425532	188	269	64	9	81	0.1111111
NODE_127585_length_334_cov_275.425532	188	269	68	4	81	0.0493827
NODE_127585_length_334_cov_275.425532	188	269	72	3	81	0.0370370
NODE_127585_length_334_cov_275.425532	188	269	73	2	81	0.0246914
NODE_127585_length_334_cov_275.425532	188	269	74	4	81	0.0493827
NODE_127585_length_334_cov_275.425532	188	269	75	6	81	0.0740741
NODE_127585_length_334_cov_275.425532	188	269	76	3	81	0.0370370
NODE_127585_length_334_cov_275.425532	188	269	77	2	81	0.0246914
NODE_127586_length_334_cov_14.753191	135	215	0	27	80	0.3375000
NODE_127586_length_334_cov_14.753191	135	215	2	53	80	0.6625000
NODE_127586_length_334_cov_14.753191	188	268	0	9	80	0.1125000
NODE_127586_length_334_cov_14.753191	188	268	2	71	80	0.8875000
NODE_127610_length_334_cov_4.829787	92	174	0	82	82	1.0000000
NODE_127610_length_334_cov_4.829787	151	237	0	86	86	1.0000000
NODE_127612_length_334_cov_4.817021	179	231	0	52	52	1.0000000
NODE_127626_length_334_cov_4.438298	121	201	0	80	80	1.0000000
NODE_127672_length_334_cov_3.604255	248	314	0	11	66	0.1666667
NODE_127672_length_334_cov_3.604255	248	314	2	55	66	0.8333333
NODE_127672_length_334_cov_3.604255	287	334	0	31	47	0.6595744
NODE_127672_length_334_cov_3.604255	287	334	2	16	47	0.3404255
NODE_127844_length_334_cov_2.165957	0	48	0	48	48	1.0000000
NODE_128026_length_334_cov_1.595745	253	328	0	6	75	0.0800000
NODE_128026_length_334_cov_1.595745	253	328	2	69	75	0.9200000
NODE_128258_length_334_cov_1.157447	146	177	0	29	31	0.9354839
NODE_128258_length_334_cov_1.157447	146	177	2	2	31	0.0645161
NODE_128665_length_333_cov_5.423077	172	242	0	70	70	1.0000000
NODE_128673_length_333_cov_4.867521	122	172	0	50	50	1.0000000
NODE_128673_length_333_cov_4.867521	175	255	0	21	80	0.2625000
NODE_128673_length_333_cov_4.867521	175	255	2	59	80	0.7375000
NODE_128673_length_333_cov_4.867521	194	219	0	2	25	0.0800000
NODE_128673_length_333_cov_4.867521	194	219	2	23	25	0.9200000
NODE_128717_length_333_cov_3.717949	49	129	0	22	80	0.2750000
NODE_128717_length_333_cov_3.717949	49	129	2	37	80	0.4625000
NODE_128717_length_333_cov_3.717949	49	129	4	15	80	0.1875000
NODE_128717_length_333_cov_3.717949	49	129	7	6	80	0.0750000
NODE_128717_length_333_cov_3.717949	102	182	2	6	80	0.0750000
NODE_128717_length_333_cov_3.717949	102	182	4	15	80	0.1875000
NODE_128717_length_333_cov_3.717949	102	182	7	27	80	0.3375000
NODE_128717_length_333_cov_3.717949	102	182	9	25	80	0.3125000
NODE_128717_length_333_cov_3.717949	102	182	10	7	80	0.0875000
NODE_128767_length_333_cov_2.897436	59	139	4	11	80	0.1375000
NODE_128767_length_333_cov_2.897436	59	139	6	8	80	0.1000000
NODE_128767_length_333_cov_2.897436	59	139	8	13	80	0.1625000
NODE_128767_length_333_cov_2.897436	59	139	10	9	80	0.1125000
NODE_128767_length_333_cov_2.897436	59	139	11	1	80	0.0125000
NODE_128767_length_333_cov_2.897436	59	139	12	26	80	0.3250000
NODE_128767_length_333_cov_2.897436	59	139	14	12	80	0.1500000
NODE_128850_length_333_cov_2.307692	68	148	0	5	80	0.0625000
NODE_128850_length_333_cov_2.307692	68	148	2	58	80	0.7250000
NODE_128850_length_333_cov_2.307692	68	148	4	5	80	0.0625000
NODE_128850_length_333_cov_2.307692	68	148	6	12	80	0.1500000
NODE_128933_length_333_cov_1.940171	135	215	0	80	80	1.0000000
NODE_129252_length_333_cov_1.200855	0	80	2	3	80	0.0375000
NODE_129252_length_333_cov_1.200855	0	80	4	61	80	0.7625000
NODE_129252_length_333_cov_1.200855	0	80	6	16	80	0.2000000
NODE_129263_length_333_cov_1.170940	146	193	0	1	47	0.0212766
NODE_129263_length_333_cov_1.170940	146	193	2	46	47	0.9787234
NODE_129263_length_333_cov_1.170940	203	243	0	17	40	0.4250000
NODE_129263_length_333_cov_1.170940	203	243	2	23	40	0.5750000
NODE_129303_length_333_cov_1.089744	241	306	0	65	65	1.0000000
NODE_129310_length_333_cov_1.089744	206	226	0	20	20	1.0000000
NODE_129665_length_332_cov_5.386266	101	167	0	66	66	1.0000000
NODE_129680_length_332_cov_4.768240	221	250	0	17	29	0.5862069
NODE_129680_length_332_cov_4.768240	221	250	2	12	29	0.4137931
NODE_129695_length_332_cov_4.343348	130	179	0	49	49	1.0000000
NODE_129698_length_332_cov_4.201717	191	237	4	46	46	1.0000000
NODE_129698_length_332_cov_4.201717	211	290	0	32	79	0.4050633
NODE_129698_length_332_cov_4.201717	211	290	4	47	79	0.5949367
NODE_129879_length_332_cov_2.274678	187	227	6	3	40	0.0750000
NODE_129879_length_332_cov_2.274678	187	227	8	11	40	0.2750000
NODE_129879_length_332_cov_2.274678	187	227	10	9	40	0.2250000
NODE_129879_length_332_cov_2.274678	187	227	20	2	40	0.0500000
NODE_129879_length_332_cov_2.274678	187	227	22	6	40	0.1500000
NODE_129879_length_332_cov_2.274678	187	227	28	2	40	0.0500000
NODE_129879_length_332_cov_2.274678	187	227	30	3	40	0.0750000
NODE_129879_length_332_cov_2.274678	187	227	32	1	40	0.0250000
NODE_129879_length_332_cov_2.274678	187	227	33	2	40	0.0500000
NODE_129879_length_332_cov_2.274678	187	227	34	1	40	0.0250000
NODE_129901_length_332_cov_2.184549	194	258	0	49	64	0.7656250
NODE_129901_length_332_cov_2.184549	194	258	2	15	64	0.2343750
NODE_130053_length_332_cov_1.682403	241	316	0	75	75	1.0000000
NODE_130055_length_332_cov_1.673820	157	220	0	63	63	1.0000000
NODE_130183_length_332_cov_1.364807	132	212	0	41	80	0.5125000
NODE_130183_length_332_cov_1.364807	132	212	1	2	80	0.0250000
NODE_130183_length_332_cov_1.364807	132	212	2	2	80	0.0250000
NODE_130183_length_332_cov_1.364807	132	212	4	35	80	0.4375000
NODE_130187_length_332_cov_1.356223	276	332	2	56	56	1.0000000
NODE_130312_length_332_cov_1.210300	120	176	2	47	56	0.8392857
NODE_130312_length_332_cov_1.210300	120	176	4	9	56	0.1607143
NODE_130757_length_331_cov_5.254310	141	221	0	46	80	0.5750000
NODE_130757_length_331_cov_5.254310	141	221	2	34	80	0.4250000
NODE_130757_length_331_cov_5.254310	194	274	0	14	80	0.1750000
NODE_130757_length_331_cov_5.254310	194	274	2	66	80	0.8250000
NODE_130781_length_331_cov_4.323276	26	108	0	1	82	0.0121951
NODE_130781_length_331_cov_4.323276	26	108	2	49	82	0.5975610
NODE_130781_length_331_cov_4.323276	26	108	4	20	82	0.2439024
NODE_130781_length_331_cov_4.323276	26	108	6	12	82	0.1463415
NODE_130902_length_331_cov_2.603448	128	181	0	21	53	0.3962264
NODE_130902_length_331_cov_2.603448	128	181	2	32	53	0.6037736
NODE_131036_length_331_cov_1.965517	183	216	2	33	33	1.0000000
NODE_131054_length_331_cov_1.896552	266	331	0	24	65	0.3692308
NODE_131054_length_331_cov_1.896552	266	331	2	17	65	0.2615385
NODE_131054_length_331_cov_1.896552	266	331	4	7	65	0.1076923
NODE_131054_length_331_cov_1.896552	266	331	6	10	65	0.1538462
NODE_131054_length_331_cov_1.896552	266	331	8	7	65	0.1076923
NODE_131817_length_330_cov_14.731602	209	280	7	5	71	0.0704225
NODE_131817_length_330_cov_14.731602	209	280	9	17	71	0.2394366
NODE_131817_length_330_cov_14.731602	209	280	11	12	71	0.1690141
NODE_131817_length_330_cov_14.731602	209	280	15	37	71	0.5211267
NODE_131840_length_330_cov_4.935065	16	97	0	19	81	0.2345679
NODE_131840_length_330_cov_4.935065	16	97	2	62	81	0.7654321
NODE_131840_length_330_cov_4.935065	81	149	2	58	68	0.8529412
NODE_131840_length_330_cov_4.935065	81	149	4	10	68	0.1470588
NODE_131841_length_330_cov_4.891775	177	255	0	12	78	0.1538462
NODE_131841_length_330_cov_4.891775	177	255	2	66	78	0.8461539
NODE_131845_length_330_cov_4.740260	134	209	0	15	75	0.2000000
NODE_131845_length_330_cov_4.740260	134	209	2	60	75	0.8000000
NODE_131892_length_330_cov_3.467532	161	225	0	18	64	0.2812500
NODE_131892_length_330_cov_3.467532	161	225	2	43	64	0.6718750
NODE_131892_length_330_cov_3.467532	161	225	4	3	64	0.0468750
NODE_131969_length_330_cov_2.601732	8	88	0	80	80	1.0000000
NODE_132188_length_330_cov_1.623377	154	200	0	46	46	1.0000000
NODE_132238_length_330_cov_1.541126	98	156	0	58	58	1.0000000
NODE_132268_length_330_cov_1.467532	234	287	0	53	53	1.0000000
NODE_132268_length_330_cov_1.467532	242	283	0	41	41	1.0000000
NODE_132306_length_330_cov_1.346320	230	296	4	26	66	0.3939394
NODE_132306_length_330_cov_1.346320	230	296	6	40	66	0.6060606
NODE_132306_length_330_cov_1.346320	230	257	6	27	27	1.0000000
NODE_132410_length_330_cov_1.220779	249	272	0	11	23	0.4782609
NODE_132410_length_330_cov_1.220779	249	272	2	12	23	0.5217391
NODE_132478_length_330_cov_1.103896	189	227	0	38	38	1.0000000
NODE_132542_length_330_cov_1.038961	219	297	8	4	78	0.0512821
NODE_132542_length_330_cov_1.038961	219	297	10	3	78	0.0384615
NODE_132542_length_330_cov_1.038961	219	297	12	10	78	0.1282051
NODE_132542_length_330_cov_1.038961	219	297	14	9	78	0.1153846
NODE_132542_length_330_cov_1.038961	219	297	16	5	78	0.0641026
NODE_132542_length_330_cov_1.038961	219	297	17	6	78	0.0769231
NODE_132542_length_330_cov_1.038961	219	297	19	6	78	0.0769231
NODE_132542_length_330_cov_1.038961	219	297	20	1	78	0.0128205
NODE_132542_length_330_cov_1.038961	219	297	21	11	78	0.1410256
NODE_132542_length_330_cov_1.038961	219	297	27	3	78	0.0384615
NODE_132542_length_330_cov_1.038961	219	297	29	4	78	0.0512821
NODE_132542_length_330_cov_1.038961	219	297	39	4	78	0.0512821
NODE_132542_length_330_cov_1.038961	219	297	43	1	78	0.0128205
NODE_132542_length_330_cov_1.038961	219	297	47	3	78	0.0384615
NODE_132542_length_330_cov_1.038961	219	297	49	2	78	0.0256410
NODE_132542_length_330_cov_1.038961	219	297	51	6	78	0.0769231
NODE_132688_length_330_cov_0.883117	284	330	0	46	46	1.0000000
NODE_132873_length_329_cov_110.178261	138	167	79	1	29	0.0344828
NODE_132873_length_329_cov_110.178261	138	167	81	5	29	0.1724138
NODE_132873_length_329_cov_110.178261	138	167	85	5	29	0.1724138
NODE_132873_length_329_cov_110.178261	138	167	87	7	29	0.2413793
NODE_132873_length_329_cov_110.178261	138	167	89	1	29	0.0344828
NODE_132873_length_329_cov_110.178261	138	167	91	2	29	0.0689655
NODE_132873_length_329_cov_110.178261	138	167	93	4	29	0.1379310
NODE_132873_length_329_cov_110.178261	138	167	95	4	29	0.1379310
NODE_132873_length_329_cov_110.178261	189	269	116	1	80	0.0125000
NODE_132873_length_329_cov_110.178261	189	269	120	1	80	0.0125000
NODE_132873_length_329_cov_110.178261	189	269	122	2	80	0.0250000
NODE_132873_length_329_cov_110.178261	189	269	124	1	80	0.0125000
NODE_132873_length_329_cov_110.178261	189	269	126	1	80	0.0125000
NODE_132873_length_329_cov_110.178261	189	269	128	1	80	0.0125000
NODE_132873_length_329_cov_110.178261	189	269	132	1	80	0.0125000
NODE_132873_length_329_cov_110.178261	189	269	134	2	80	0.0250000
NODE_132873_length_329_cov_110.178261	189	269	136	1	80	0.0125000
NODE_132873_length_329_cov_110.178261	189	269	140	1	80	0.0125000
NODE_132873_length_329_cov_110.178261	189	269	142	3	80	0.0375000
NODE_132873_length_329_cov_110.178261	189	269	143	1	80	0.0125000
NODE_132873_length_329_cov_110.178261	189	269	144	2	80	0.0250000
NODE_132873_length_329_cov_110.178261	189	269	145	2	80	0.0250000
NODE_132873_length_329_cov_110.178261	189	269	146	3	80	0.0375000
NODE_132873_length_329_cov_110.178261	189	269	147	2	80	0.0250000
NODE_132873_length_329_cov_110.178261	189	269	148	7	80	0.0875000
NODE_132873_length_329_cov_110.178261	189	269	152	1	80	0.0125000
NODE_132873_length_329_cov_110.178261	189	269	153	1	80	0.0125000
NODE_132873_length_329_cov_110.178261	189	269	155	3	80	0.0375000
NODE_132873_length_329_cov_110.178261	189	269	156	1	80	0.0125000
NODE_132873_length_329_cov_110.178261	189	269	157	2	80	0.0250000
NODE_132873_length_329_cov_110.178261	189	269	160	2	80	0.0250000
NODE_132873_length_329_cov_110.178261	189	269	162	9	80	0.1125000
NODE_132873_length_329_cov_110.178261	189	269	164	6	80	0.0750000
NODE_132873_length_329_cov_110.178261	189	269	165	7	80	0.0875000
NODE_132873_length_329_cov_110.178261	189	269	167	5	80	0.0625000
NODE_132873_length_329_cov_110.178261	189	269	168	1	80	0.0125000
NODE_132873_length_329_cov_110.178261	189	269	169	1	80	0.0125000
NODE_132873_length_329_cov_110.178261	189	269	172	1	80	0.0125000
NODE_132873_length_329_cov_110.178261	189	269	173	1	80	0.0125000
NODE_132873_length_329_cov_110.178261	189	269	174	2	80	0.0250000
NODE_132873_length_329_cov_110.178261	189	269	175	1	80	0.0125000
NODE_132873_length_329_cov_110.178261	189	269	176	1	80	0.0125000
NODE_132873_length_329_cov_110.178261	189	269	177	1	80	0.0125000
NODE_132873_length_329_cov_110.178261	189	269	178	2	80	0.0250000
NODE_132873_length_329_cov_110.178261	242	322	14	1	80	0.0125000
NODE_132873_length_329_cov_110.178261	242	322	16	2	80	0.0250000
NODE_132873_length_329_cov_110.178261	242	322	19	2	80	0.0250000
NODE_132873_length_329_cov_110.178261	242	322	20	1	80	0.0125000
NODE_132873_length_329_cov_110.178261	242	322	22	3	80	0.0375000
NODE_132873_length_329_cov_110.178261	242	322	26	1	80	0.0125000
NODE_132873_length_329_cov_110.178261	242	322	30	1	80	0.0125000
NODE_132873_length_329_cov_110.178261	242	322	32	4	80	0.0500000
NODE_132873_length_329_cov_110.178261	242	322	36	1	80	0.0125000
NODE_132873_length_329_cov_110.178261	242	322	38	3	80	0.0375000
NODE_132873_length_329_cov_110.178261	242	322	40	9	80	0.1125000
NODE_132873_length_329_cov_110.178261	242	322	42	1	80	0.0125000
NODE_132873_length_329_cov_110.178261	242	322	44	1	80	0.0125000
NODE_132873_length_329_cov_110.178261	242	322	46	1	80	0.0125000
NODE_132873_length_329_cov_110.178261	242	322	58	3	80	0.0375000
NODE_132873_length_329_cov_110.178261	242	322	64	1	80	0.0125000
NODE_132873_length_329_cov_110.178261	242	322	70	1	80	0.0125000
NODE_132873_length_329_cov_110.178261	242	322	74	1	80	0.0125000
NODE_132873_length_329_cov_110.178261	242	322	76	1	80	0.0125000
NODE_132873_length_329_cov_110.178261	242	322	78	1	80	0.0125000
NODE_132873_length_329_cov_110.178261	242	322	82	1	80	0.0125000
NODE_132873_length_329_cov_110.178261	242	322	88	2	80	0.0250000
NODE_132873_length_329_cov_110.178261	242	322	92	1	80	0.0125000
NODE_132873_length_329_cov_110.178261	242	322	94	1	80	0.0125000
NODE_132873_length_329_cov_110.178261	242	322	98	1	80	0.0125000
NODE_132873_length_329_cov_110.178261	242	322	102	1	80	0.0125000
NODE_132873_length_329_cov_110.178261	242	322	106	2	80	0.0250000
NODE_132873_length_329_cov_110.178261	242	322	110	4	80	0.0500000
NODE_132873_length_329_cov_110.178261	242	322	114	1	80	0.0125000
NODE_132873_length_329_cov_110.178261	242	322	116	1	80	0.0125000
NODE_132873_length_329_cov_110.178261	242	322	120	1	80	0.0125000
NODE_132873_length_329_cov_110.178261	242	322	122	2	80	0.0250000
NODE_132873_length_329_cov_110.178261	242	322	124	1	80	0.0125000
NODE_132873_length_329_cov_110.178261	242	322	126	1	80	0.0125000
NODE_132873_length_329_cov_110.178261	242	322	128	1	80	0.0125000
NODE_132873_length_329_cov_110.178261	242	322	132	1	80	0.0125000
NODE_132873_length_329_cov_110.178261	242	322	134	2	80	0.0250000
NODE_132873_length_329_cov_110.178261	242	322	136	1	80	0.0125000
NODE_132873_length_329_cov_110.178261	242	322	142	3	80	0.0375000
NODE_132873_length_329_cov_110.178261	242	322	144	2	80	0.0250000
NODE_132873_length_329_cov_110.178261	242	322	146	2	80	0.0250000
NODE_132873_length_329_cov_110.178261	242	322	148	4	80	0.0500000
NODE_132873_length_329_cov_110.178261	242	322	153	1	80	0.0125000
NODE_132873_length_329_cov_110.178261	242	322	155	3	80	0.0375000
NODE_132873_length_329_cov_110.178261	242	322	157	1	80	0.0125000
NODE_132879_length_329_cov_8.882609	61	141	0	80	80	1.0000000
NODE_132879_length_329_cov_8.882609	114	194	0	80	80	1.0000000
NODE_132885_length_329_cov_6.586957	166	207	0	41	41	1.0000000
NODE_132908_length_329_cov_4.617391	175	229	0	54	54	1.0000000
NODE_132970_length_329_cov_3.160870	59	139	0	36	80	0.4500000
NODE_132970_length_329_cov_3.160870	59	139	2	44	80	0.5500000
NODE_133003_length_329_cov_2.821739	164	209	0	45	45	1.0000000
NODE_133003_length_329_cov_2.821739	184	262	0	78	78	1.0000000
NODE_133033_length_329_cov_2.560870	139	201	0	62	62	1.0000000
NODE_133036_length_329_cov_2.543478	145	206	6	61	61	1.0000000
NODE_133123_length_329_cov_2.143478	39	119	6	7	80	0.0875000
NODE_133123_length_329_cov_2.143478	39	119	8	19	80	0.2375000
NODE_133123_length_329_cov_2.143478	39	119	10	14	80	0.1750000
NODE_133123_length_329_cov_2.143478	39	119	12	29	80	0.3625000
NODE_133123_length_329_cov_2.143478	39	119	14	11	80	0.1375000
NODE_133123_length_329_cov_2.143478	92	158	6	4	66	0.0606061
NODE_133123_length_329_cov_2.143478	92	158	8	1	66	0.0151515
NODE_133123_length_329_cov_2.143478	92	158	10	11	66	0.1666667
NODE_133123_length_329_cov_2.143478	92	158	12	39	66	0.5909091
NODE_133123_length_329_cov_2.143478	92	158	14	11	66	0.1666667
NODE_133184_length_329_cov_1.865217	182	252	0	37	70	0.5285714
NODE_133184_length_329_cov_1.865217	182	252	2	30	70	0.4285714
NODE_133184_length_329_cov_1.865217	182	252	4	3	70	0.0428571
NODE_133200_length_329_cov_1.791304	50	84	0	33	34	0.9705882
NODE_133200_length_329_cov_1.791304	50	84	2	1	34	0.0294118
NODE_133200_length_329_cov_1.791304	92	149	2	21	57	0.3684210
NODE_133200_length_329_cov_1.791304	92	149	4	22	57	0.3859649
NODE_133200_length_329_cov_1.791304	92	149	7	1	57	0.0175439
NODE_133200_length_329_cov_1.791304	92	149	8	13	57	0.2280702
NODE_133200_length_329_cov_1.791304	145	203	6	14	58	0.2413793
NODE_133200_length_329_cov_1.791304	145	203	8	44	58	0.7586207
NODE_133332_length_329_cov_1.508696	261	323	0	2	62	0.0322581
NODE_133332_length_329_cov_1.508696	261	323	2	60	62	0.9677419
NODE_133348_length_329_cov_1.469565	168	237	0	69	69	1.0000000
NODE_133376_length_329_cov_1.391304	275	307	4	7	32	0.2187500
NODE_133376_length_329_cov_1.391304	275	307	6	25	32	0.7812500
NODE_133547_length_329_cov_1.165217	199	242	0	43	43	1.0000000
NODE_133768_length_329_cov_0.878261	221	296	6	75	75	1.0000000
NODE_133970_length_328_cov_4.484716	95	175	0	43	80	0.5375000
NODE_133970_length_328_cov_4.484716	95	175	4	11	80	0.1375000
NODE_133970_length_328_cov_4.484716	95	175	6	26	80	0.3250000
NODE_133989_length_328_cov_4.087336	79	159	0	80	80	1.0000000
NODE_133989_length_328_cov_4.087336	132	207	0	75	75	1.0000000
NODE_133993_length_328_cov_3.895197	110	190	2	45	80	0.5625000
NODE_133993_length_328_cov_3.895197	110	190	4	35	80	0.4375000
NODE_134019_length_328_cov_3.393013	30	78	0	48	48	1.0000000
NODE_134144_length_328_cov_2.161572	103	134	2	13	31	0.4193548
NODE_134144_length_328_cov_2.161572	103	134	4	3	31	0.0967742
NODE_134144_length_328_cov_2.161572	103	134	6	15	31	0.4838710
NODE_134247_length_328_cov_1.781659	16	44	0	28	28	1.0000000
NODE_134335_length_328_cov_1.567686	0	76	0	33	76	0.4342105
NODE_134335_length_328_cov_1.567686	0	76	2	43	76	0.5657895
NODE_134335_length_328_cov_1.567686	49	94	2	44	45	0.9777778
NODE_134335_length_328_cov_1.567686	49	94	4	1	45	0.0222222
NODE_134452_length_328_cov_1.336245	0	73	0	73	73	1.0000000
NODE_134508_length_328_cov_1.266376	78	158	0	80	80	1.0000000
NODE_135002_length_327_cov_4.934211	170	250	0	80	80	1.0000000
NODE_135009_length_327_cov_4.701754	225	305	0	28	80	0.3500000
NODE_135009_length_327_cov_4.701754	225	305	2	52	80	0.6500000
NODE_135018_length_327_cov_4.241228	97	173	12	3	76	0.0394737
NODE_135018_length_327_cov_4.241228	97	173	14	39	76	0.5131579
NODE_135018_length_327_cov_4.241228	97	173	16	34	76	0.4473684
NODE_135037_length_327_cov_3.719298	70	150	0	80	80	1.0000000
NODE_135063_length_327_cov_3.350877	156	227	0	71	71	1.0000000
NODE_135328_length_327_cov_1.780702	191	271	4	6	80	0.0750000
NODE_135328_length_327_cov_1.780702	191	271	6	6	80	0.0750000
NODE_135328_length_327_cov_1.780702	191	271	8	1	80	0.0125000
NODE_135328_length_327_cov_1.780702	191	271	10	1	80	0.0125000
NODE_135328_length_327_cov_1.780702	191	271	12	3	80	0.0375000
NODE_135328_length_327_cov_1.780702	191	271	14	5	80	0.0625000
NODE_135328_length_327_cov_1.780702	191	271	16	58	80	0.7250000
NODE_136081_length_326_cov_3.964758	178	228	0	50	50	1.0000000
NODE_136100_length_326_cov_3.502203	211	253	0	42	42	1.0000000
NODE_136100_length_326_cov_3.502203	220	255	0	35	35	1.0000000
NODE_136116_length_326_cov_3.202643	149	203	0	6	54	0.1111111
NODE_136116_length_326_cov_3.202643	149	203	4	8	54	0.1481481
NODE_136116_length_326_cov_3.202643	149	203	6	40	54	0.7407407
NODE_136130_length_326_cov_3.057269	107	126	0	19	19	1.0000000
NODE_136176_length_326_cov_2.594714	125	196	0	71	71	1.0000000
NODE_136283_length_326_cov_2.123348	184	244	0	60	60	1.0000000
NODE_136496_length_326_cov_1.515419	86	166	0	80	80	1.0000000
NODE_137182_length_325_cov_4.893805	142	222	8	8	80	0.1000000
NODE_137182_length_325_cov_4.893805	142	222	10	23	80	0.2875000
NODE_137182_length_325_cov_4.893805	142	222	12	1	80	0.0125000
NODE_137182_length_325_cov_4.893805	142	222	14	48	80	0.6000000
NODE_137182_length_325_cov_4.893805	195	275	4	41	80	0.5125000
NODE_137182_length_325_cov_4.893805	195	275	6	10	80	0.1250000
NODE_137182_length_325_cov_4.893805	195	275	8	10	80	0.1250000
NODE_137182_length_325_cov_4.893805	195	275	10	19	80	0.2375000
NODE_137199_length_325_cov_4.000000	134	198	0	32	64	0.5000000
NODE_137199_length_325_cov_4.000000	134	198	4	32	64	0.5000000
NODE_137221_length_325_cov_3.513274	191	266	0	57	75	0.7600000
NODE_137221_length_325_cov_3.513274	191	266	2	3	75	0.0400000
NODE_137221_length_325_cov_3.513274	191	266	4	15	75	0.2000000
NODE_137221_length_325_cov_3.513274	240	319	0	79	79	1.0000000
NODE_137223_length_325_cov_3.469027	216	278	0	62	62	1.0000000
NODE_137224_length_325_cov_3.429204	178	224	0	46	46	1.0000000
NODE_137243_length_325_cov_3.168142	188	274	0	86	86	1.0000000
NODE_137268_length_325_cov_2.880531	72	152	0	8	80	0.1000000
NODE_137268_length_325_cov_2.880531	72	152	2	4	80	0.0500000
NODE_137268_length_325_cov_2.880531	72	152	4	9	80	0.1125000
NODE_137268_length_325_cov_2.880531	72	152	8	18	80	0.2250000
NODE_137268_length_325_cov_2.880531	72	152	10	41	80	0.5125000
NODE_137268_length_325_cov_2.880531	125	205	4	19	80	0.2375000
NODE_137268_length_325_cov_2.880531	125	205	6	3	80	0.0375000
NODE_137268_length_325_cov_2.880531	125	205	8	22	80	0.2750000
NODE_137268_length_325_cov_2.880531	125	205	10	36	80	0.4500000
NODE_137291_length_325_cov_2.707965	203	261	0	29	58	0.5000000
NODE_137291_length_325_cov_2.707965	203	261	2	29	58	0.5000000
NODE_137296_length_325_cov_2.703540	68	148	2	3	80	0.0375000
NODE_137296_length_325_cov_2.703540	68	148	4	42	80	0.5250000
NODE_137296_length_325_cov_2.703540	68	148	6	35	80	0.4375000
NODE_137330_length_325_cov_2.500000	0	42	0	42	42	1.0000000
NODE_137407_length_325_cov_2.048673	122	202	10	14	80	0.1750000
NODE_137407_length_325_cov_2.048673	122	202	12	45	80	0.5625000
NODE_137407_length_325_cov_2.048673	122	202	14	1	80	0.0125000
NODE_137407_length_325_cov_2.048673	122	202	16	20	80	0.2500000
NODE_137409_length_325_cov_2.035398	83	154	0	71	71	1.0000000
NODE_137642_length_325_cov_1.464602	153	224	2	39	71	0.5492958
NODE_137642_length_325_cov_1.464602	153	224	4	32	71	0.4507042
NODE_137939_length_325_cov_1.017699	103	134	0	31	31	1.0000000
NODE_138113_length_325_cov_0.827434	258	308	0	14	50	0.2800000
NODE_138113_length_325_cov_0.827434	258	308	2	36	50	0.7200000
NODE_138309_length_324_cov_4.737778	113	160	0	47	47	1.0000000
NODE_138309_length_324_cov_4.737778	142	213	0	71	71	1.0000000
NODE_138358_length_324_cov_3.626667	218	273	2	55	55	1.0000000
NODE_138396_length_324_cov_3.124444	101	181	0	64	80	0.8000000
NODE_138396_length_324_cov_3.124444	101	181	2	16	80	0.2000000
NODE_138396_length_324_cov_3.124444	256	285	0	29	29	1.0000000
NODE_138416_length_324_cov_2.924444	114	198	0	56	84	0.6666667
NODE_138416_length_324_cov_2.924444	114	198	2	28	84	0.3333333
NODE_138416_length_324_cov_2.924444	178	237	2	49	59	0.8305085
NODE_138416_length_324_cov_2.924444	178	237	4	10	59	0.1694915
NODE_138418_length_324_cov_2.915556	141	221	0	28	80	0.3500000
NODE_138418_length_324_cov_2.915556	141	221	2	52	80	0.6500000
NODE_138434_length_324_cov_2.715556	4	51	2	47	47	1.0000000
NODE_138434_length_324_cov_2.715556	24	104	2	36	80	0.4500000
NODE_138434_length_324_cov_2.715556	24	104	3	44	80	0.5500000
NODE_138463_length_324_cov_2.506667	270	306	0	36	36	1.0000000
NODE_138483_length_324_cov_2.448889	187	238	4	30	51	0.5882353
NODE_138483_length_324_cov_2.448889	187	238	6	10	51	0.1960784
NODE_138483_length_324_cov_2.448889	187	238	8	11	51	0.2156863
NODE_138527_length_324_cov_2.248889	30	96	0	32	66	0.4848485
NODE_138527_length_324_cov_2.248889	30	96	2	34	66	0.5151515
NODE_138778_length_324_cov_1.502222	10	90	5	10	80	0.1250000
NODE_138778_length_324_cov_1.502222	10	90	7	14	80	0.1750000
NODE_138778_length_324_cov_1.502222	10	90	9	26	80	0.3250000
NODE_138778_length_324_cov_1.502222	10	90	11	30	80	0.3750000
NODE_138792_length_324_cov_1.457778	0	45	0	45	45	1.0000000
NODE_138792_length_324_cov_1.457778	18	75	0	50	57	0.8771930
NODE_138792_length_324_cov_1.457778	18	75	6	5	57	0.0877193
NODE_138792_length_324_cov_1.457778	18	75	8	2	57	0.0350877
NODE_138808_length_324_cov_1.382222	263	304	0	41	41	1.0000000
NODE_139129_length_324_cov_1.017778	0	59	0	59	59	1.0000000
NODE_139497_length_323_cov_6.669643	215	286	0	71	71	1.0000000
NODE_139497_length_323_cov_6.669643	268	315	0	47	47	1.0000000
NODE_139511_length_323_cov_5.089286	224	290	0	66	66	1.0000000
NODE_139511_length_323_cov_5.089286	263	319	0	56	56	1.0000000
NODE_139572_length_323_cov_3.276786	189	269	0	11	80	0.1375000
NODE_139572_length_323_cov_3.276786	189	269	2	15	80	0.1875000
NODE_139572_length_323_cov_3.276786	189	269	10	9	80	0.1125000
NODE_139572_length_323_cov_3.276786	189	269	12	12	80	0.1500000
NODE_139572_length_323_cov_3.276786	189	269	16	16	80	0.2000000
NODE_139572_length_323_cov_3.276786	189	269	18	17	80	0.2125000
NODE_139575_length_323_cov_3.263393	101	181	2	80	80	1.0000000
NODE_139591_length_323_cov_3.089286	128	208	2	12	80	0.1500000
NODE_139591_length_323_cov_3.089286	128	208	4	68	80	0.8500000
NODE_139591_length_323_cov_3.089286	166	208	2	1	42	0.0238095
NODE_139591_length_323_cov_3.089286	166	208	4	41	42	0.9761904
NODE_139591_length_323_cov_3.089286	181	261	2	24	80	0.3000000
NODE_139591_length_323_cov_3.089286	181	261	4	56	80	0.7000000
NODE_139591_length_323_cov_3.089286	181	261	2	24	80	0.3000000
NODE_139591_length_323_cov_3.089286	181	261	4	56	80	0.7000000
NODE_139629_length_323_cov_2.683036	144	215	0	1	71	0.0140845
NODE_139629_length_323_cov_2.683036	144	215	2	3	71	0.0422535
NODE_139629_length_323_cov_2.683036	144	215	4	67	71	0.9436620
NODE_139746_length_323_cov_2.089286	64	144	2	10	80	0.1250000
NODE_139746_length_323_cov_2.089286	64	144	4	32	80	0.4000000
NODE_139746_length_323_cov_2.089286	64	144	6	38	80	0.4750000
NODE_139797_length_323_cov_1.888393	148	207	0	59	59	1.0000000
NODE_139901_length_323_cov_1.705357	195	262	0	30	67	0.4477612
NODE_139901_length_323_cov_1.705357	195	262	2	5	67	0.0746269
NODE_139901_length_323_cov_1.705357	195	262	4	32	67	0.4776119
NODE_139901_length_323_cov_1.705357	235	315	2	20	80	0.2500000
NODE_139901_length_323_cov_1.705357	235	315	4	60	80	0.7500000
NODE_140651_length_322_cov_5.475336	56	136	0	80	80	1.0000000
NODE_140651_length_322_cov_5.475336	113	189	0	54	76	0.7105263
NODE_140651_length_322_cov_5.475336	113	189	2	22	76	0.2894737
NODE_140692_length_322_cov_3.753363	63	133	0	28	70	0.4000000
NODE_140692_length_322_cov_3.753363	63	133	2	42	70	0.6000000
NODE_140692_length_322_cov_3.753363	116	190	0	16	74	0.2162162
NODE_140692_length_322_cov_3.753363	116	190	2	58	74	0.7837838
NODE_140693_length_322_cov_3.735426	60	86	0	26	26	1.0000000
NODE_140693_length_322_cov_3.735426	99	139	0	40	40	1.0000000
NODE_140701_length_322_cov_3.605381	73	116	2	3	43	0.0697674
NODE_140701_length_322_cov_3.605381	73	116	6	40	43	0.9302326
NODE_140702_length_322_cov_3.600897	75	145	4	23	70	0.3285714
NODE_140702_length_322_cov_3.600897	75	145	6	16	70	0.2285714
NODE_140702_length_322_cov_3.600897	75	145	8	31	70	0.4428571
NODE_140820_length_322_cov_2.304933	182	213	0	31	31	1.0000000
NODE_141738_length_321_cov_8.527027	176	240	0	2	64	0.0312500
NODE_141738_length_321_cov_8.527027	176	240	1	1	64	0.0156250
NODE_141738_length_321_cov_8.527027	176	240	2	14	64	0.2187500
NODE_141738_length_321_cov_8.527027	176	240	4	8	64	0.1250000
NODE_141738_length_321_cov_8.527027	176	240	6	39	64	0.6093750
NODE_141786_length_321_cov_4.094595	196	266	0	66	70	0.9428571
NODE_141786_length_321_cov_4.094595	196	266	1	4	70	0.0571429
NODE_141811_length_321_cov_3.563063	59	131	0	32	72	0.4444444
NODE_141811_length_321_cov_3.563063	59	131	2	40	72	0.5555556
NODE_141811_length_321_cov_3.563063	112	183	1	4	71	0.0563380
NODE_141811_length_321_cov_3.563063	112	183	2	40	71	0.5633803
NODE_141811_length_321_cov_3.563063	112	183	3	27	71	0.3802817
NODE_141813_length_321_cov_3.540541	112	141	2	29	29	1.0000000
NODE_141833_length_321_cov_3.049550	65	115	30	20	50	0.4000000
NODE_141833_length_321_cov_3.049550	65	115	32	13	50	0.2600000
NODE_141833_length_321_cov_3.049550	65	115	34	15	50	0.3000000
NODE_141833_length_321_cov_3.049550	65	115	36	2	50	0.0400000
NODE_141833_length_321_cov_3.049550	95	138	14	12	43	0.2790698
NODE_141833_length_321_cov_3.049550	95	138	16	3	43	0.0697674
NODE_141833_length_321_cov_3.049550	95	138	24	5	43	0.1162791
NODE_141833_length_321_cov_3.049550	95	138	27	1	43	0.0232558
NODE_141833_length_321_cov_3.049550	95	138	29	1	43	0.0232558
NODE_141833_length_321_cov_3.049550	95	138	30	8	43	0.1860465
NODE_141833_length_321_cov_3.049550	95	138	32	12	43	0.2790698
NODE_141833_length_321_cov_3.049550	95	138	34	1	43	0.0232558
NODE_141833_length_321_cov_3.049550	118	168	0	2	50	0.0400000
NODE_141833_length_321_cov_3.049550	118	168	2	1	50	0.0200000
NODE_141833_length_321_cov_3.049550	118	168	4	5	50	0.1000000
NODE_141833_length_321_cov_3.049550	118	168	10	5	50	0.1000000
NODE_141833_length_321_cov_3.049550	118	168	14	29	50	0.5800000
NODE_141833_length_321_cov_3.049550	118	168	16	3	50	0.0600000
NODE_141833_length_321_cov_3.049550	118	168	24	5	50	0.1000000
NODE_141837_length_321_cov_2.995495	146	220	0	74	74	1.0000000
NODE_141842_length_321_cov_2.981982	251	304	0	53	53	1.0000000
NODE_141876_length_321_cov_2.734234	239	306	0	62	67	0.9253731
NODE_141876_length_321_cov_2.734234	239	306	2	5	67	0.0746269
NODE_141910_length_321_cov_2.427928	221	265	0	44	44	1.0000000
NODE_141922_length_321_cov_2.315315	22	65	0	43	43	1.0000000
NODE_141951_length_321_cov_2.270270	43	105	2	62	62	1.0000000
NODE_141951_length_321_cov_2.270270	120	203	0	83	83	1.0000000
NODE_141951_length_321_cov_2.270270	127	208	0	81	81	1.0000000
NODE_142200_length_321_cov_1.576577	241	321	0	80	80	1.0000000
NODE_142363_length_321_cov_1.319820	253	304	0	51	51	1.0000000
NODE_142484_length_321_cov_1.130631	0	43	0	43	43	1.0000000
NODE_142700_length_321_cov_0.869369	248	294	0	46	46	1.0000000
NODE_142885_length_320_cov_200.484163	264	320	2	11	56	0.1964286
NODE_142885_length_320_cov_200.484163	264	320	4	4	56	0.0714286
NODE_142885_length_320_cov_200.484163	264	320	6	2	56	0.0357143
NODE_142885_length_320_cov_200.484163	264	320	8	39	56	0.6964286
NODE_142886_length_320_cov_73.357466	51	97	0	46	46	1.0000000
NODE_142886_length_320_cov_73.357466	108	154	0	46	46	1.0000000
NODE_142886_length_320_cov_73.357466	165	245	4	80	80	1.0000000
NODE_142886_length_320_cov_73.357466	218	296	0	51	78	0.6538461
NODE_142886_length_320_cov_73.357466	218	296	4	27	78	0.3461539
NODE_142887_length_320_cov_35.787330	212	292	2	1	80	0.0125000
NODE_142887_length_320_cov_35.787330	212	292	4	5	80	0.0625000
NODE_142887_length_320_cov_35.787330	212	292	6	8	80	0.1000000
NODE_142887_length_320_cov_35.787330	212	292	8	1	80	0.0125000
NODE_142887_length_320_cov_35.787330	212	292	12	1	80	0.0125000
NODE_142887_length_320_cov_35.787330	212	292	14	64	80	0.8000000
NODE_142887_length_320_cov_35.787330	212	292	2	1	80	0.0125000
NODE_142887_length_320_cov_35.787330	212	292	4	5	80	0.0625000
NODE_142887_length_320_cov_35.787330	212	292	6	8	80	0.1000000
NODE_142887_length_320_cov_35.787330	212	292	8	1	80	0.0125000
NODE_142887_length_320_cov_35.787330	212	292	12	1	80	0.0125000
NODE_142887_length_320_cov_35.787330	212	292	14	64	80	0.8000000
NODE_142887_length_320_cov_35.787330	212	292	2	1	80	0.0125000
NODE_142887_length_320_cov_35.787330	212	292	4	5	80	0.0625000
NODE_142887_length_320_cov_35.787330	212	292	6	8	80	0.1000000
NODE_142887_length_320_cov_35.787330	212	292	8	1	80	0.0125000
NODE_142887_length_320_cov_35.787330	212	292	12	1	80	0.0125000
NODE_142887_length_320_cov_35.787330	212	292	14	64	80	0.8000000
NODE_142887_length_320_cov_35.787330	212	292	2	1	80	0.0125000
NODE_142887_length_320_cov_35.787330	212	292	4	5	80	0.0625000
NODE_142887_length_320_cov_35.787330	212	292	6	8	80	0.1000000
NODE_142887_length_320_cov_35.787330	212	292	8	1	80	0.0125000
NODE_142887_length_320_cov_35.787330	212	292	12	1	80	0.0125000
NODE_142887_length_320_cov_35.787330	212	292	14	64	80	0.8000000
NODE_142887_length_320_cov_35.787330	212	292	2	1	80	0.0125000
NODE_142887_length_320_cov_35.787330	212	292	4	5	80	0.0625000
NODE_142887_length_320_cov_35.787330	212	292	6	8	80	0.1000000
NODE_142887_length_320_cov_35.787330	212	292	8	1	80	0.0125000
NODE_142887_length_320_cov_35.787330	212	292	12	1	80	0.0125000
NODE_142887_length_320_cov_35.787330	212	292	14	64	80	0.8000000
NODE_142887_length_320_cov_35.787330	265	314	0	11	49	0.2244898
NODE_142887_length_320_cov_35.787330	265	314	2	12	49	0.2448980
NODE_142887_length_320_cov_35.787330	265	314	4	4	49	0.0816327
NODE_142887_length_320_cov_35.787330	265	314	6	6	49	0.1224490
NODE_142887_length_320_cov_35.787330	265	314	8	1	49	0.0204082
NODE_142887_length_320_cov_35.787330	265	314	14	15	49	0.3061225
NODE_142887_length_320_cov_35.787330	265	320	0	17	55	0.3090909
NODE_142887_length_320_cov_35.787330	265	320	2	12	55	0.2181818
NODE_142887_length_320_cov_35.787330	265	320	4	4	55	0.0727273
NODE_142887_length_320_cov_35.787330	265	320	6	6	55	0.1090909
NODE_142887_length_320_cov_35.787330	265	320	8	1	55	0.0181818
NODE_142887_length_320_cov_35.787330	265	320	14	15	55	0.2727273
NODE_142887_length_320_cov_35.787330	265	320	0	17	55	0.3090909
NODE_142887_length_320_cov_35.787330	265	320	2	12	55	0.2181818
NODE_142887_length_320_cov_35.787330	265	320	4	4	55	0.0727273
NODE_142887_length_320_cov_35.787330	265	320	6	6	55	0.1090909
NODE_142887_length_320_cov_35.787330	265	320	8	1	55	0.0181818
NODE_142887_length_320_cov_35.787330	265	320	14	15	55	0.2727273
NODE_142887_length_320_cov_35.787330	268	320	0	17	52	0.3269231
NODE_142887_length_320_cov_35.787330	268	320	2	12	52	0.2307692
NODE_142887_length_320_cov_35.787330	268	320	4	4	52	0.0769231
NODE_142887_length_320_cov_35.787330	268	320	6	6	52	0.1153846
NODE_142887_length_320_cov_35.787330	268	320	8	1	52	0.0192308
NODE_142887_length_320_cov_35.787330	268	320	14	12	52	0.2307692
NODE_142887_length_320_cov_35.787330	270	320	0	17	50	0.3400000
NODE_142887_length_320_cov_35.787330	270	320	2	12	50	0.2400000
NODE_142887_length_320_cov_35.787330	270	320	4	4	50	0.0800000
NODE_142887_length_320_cov_35.787330	270	320	6	6	50	0.1200000
NODE_142887_length_320_cov_35.787330	270	320	8	1	50	0.0200000
NODE_142887_length_320_cov_35.787330	270	320	14	10	50	0.2000000
NODE_142900_length_320_cov_5.841629	115	172	2	57	57	1.0000000
NODE_142900_length_320_cov_5.841629	168	225	2	57	57	1.0000000
NODE_142934_length_320_cov_4.153846	134	200	0	66	66	1.0000000
NODE_142958_length_320_cov_3.733032	5	40	0	35	35	1.0000000
NODE_142985_length_320_cov_3.402715	142	222	0	19	80	0.2375000
NODE_142985_length_320_cov_3.402715	142	222	2	61	80	0.7625000
NODE_143076_length_320_cov_2.475113	120	187	2	11	67	0.1641791
NODE_143076_length_320_cov_2.475113	120	187	4	14	67	0.2089552
NODE_143076_length_320_cov_2.475113	120	187	6	1	67	0.0149254
NODE_143076_length_320_cov_2.475113	120	187	8	13	67	0.1940299
NODE_143076_length_320_cov_2.475113	120	187	10	1	67	0.0149254
NODE_143076_length_320_cov_2.475113	120	187	12	18	67	0.2686567
NODE_143076_length_320_cov_2.475113	120	187	18	2	67	0.0298507
NODE_143076_length_320_cov_2.475113	120	187	20	1	67	0.0149254
NODE_143076_length_320_cov_2.475113	120	187	24	1	67	0.0149254
NODE_143076_length_320_cov_2.475113	120	187	28	1	67	0.0149254
NODE_143076_length_320_cov_2.475113	120	187	30	2	67	0.0298507
NODE_143076_length_320_cov_2.475113	120	187	34	1	67	0.0149254
NODE_143076_length_320_cov_2.475113	120	187	38	1	67	0.0149254
NODE_143142_length_320_cov_2.171946	16	96	0	7	80	0.0875000
NODE_143142_length_320_cov_2.171946	16	96	5	23	80	0.2875000
NODE_143142_length_320_cov_2.171946	16	96	6	10	80	0.1250000
NODE_143142_length_320_cov_2.171946	16	96	10	10	80	0.1250000
NODE_143142_length_320_cov_2.171946	16	96	12	23	80	0.2875000
NODE_143142_length_320_cov_2.171946	16	96	14	7	80	0.0875000
NODE_143142_length_320_cov_2.171946	69	149	12	28	80	0.3500000
NODE_143142_length_320_cov_2.171946	69	149	14	34	80	0.4250000
NODE_143142_length_320_cov_2.171946	69	149	18	18	80	0.2250000
NODE_143207_length_320_cov_1.900452	37	117	8	12	80	0.1500000
NODE_143207_length_320_cov_1.900452	37	117	9	12	80	0.1500000
NODE_143207_length_320_cov_1.900452	37	117	11	19	80	0.2375000
NODE_143207_length_320_cov_1.900452	37	117	12	37	80	0.4625000
NODE_143207_length_320_cov_1.900452	90	164	0	6	74	0.0810811
NODE_143207_length_320_cov_1.900452	90	164	1	14	74	0.1891892
NODE_143207_length_320_cov_1.900452	90	164	2	8	74	0.1081081
NODE_143207_length_320_cov_1.900452	90	164	4	2	74	0.0270270
NODE_143207_length_320_cov_1.900452	90	164	6	12	74	0.1621622
NODE_143207_length_320_cov_1.900452	90	164	8	17	74	0.2297297
NODE_143207_length_320_cov_1.900452	90	164	12	15	74	0.2027027
NODE_143230_length_320_cov_1.846154	188	220	0	32	32	1.0000000
NODE_143309_length_320_cov_1.665158	144	198	2	37	54	0.6851852
NODE_143309_length_320_cov_1.665158	144	198	4	17	54	0.3148148
NODE_143309_length_320_cov_1.665158	198	251	2	5	53	0.0943396
NODE_143309_length_320_cov_1.665158	198	251	4	19	53	0.3584906
NODE_143309_length_320_cov_1.665158	198	251	6	29	53	0.5471698
NODE_143351_length_320_cov_1.601810	157	181	2	24	24	1.0000000
NODE_143351_length_320_cov_1.601810	231	290	2	40	59	0.6779661
NODE_143351_length_320_cov_1.601810	231	290	4	19	59	0.3220339
NODE_143366_length_320_cov_1.556561	0	39	2	23	39	0.5897436
NODE_143366_length_320_cov_1.556561	0	39	4	2	39	0.0512821
NODE_143366_length_320_cov_1.556561	0	39	6	13	39	0.3333333
NODE_143366_length_320_cov_1.556561	0	39	9	1	39	0.0256410
NODE_143442_length_320_cov_1.384615	18	98	0	46	80	0.5750000
NODE_143442_length_320_cov_1.384615	18	98	2	34	80	0.4250000
NODE_143442_length_320_cov_1.384615	71	145	0	11	74	0.1486486
NODE_143442_length_320_cov_1.384615	71	145	2	56	74	0.7567568
NODE_143442_length_320_cov_1.384615	71	145	4	7	74	0.0945946
NODE_143521_length_320_cov_1.312217	117	170	0	53	53	1.0000000
NODE_143670_length_320_cov_1.117647	58	109	0	51	51	1.0000000
NODE_144091_length_319_cov_5.940909	122	202	2	80	80	1.0000000
NODE_144107_length_319_cov_4.700000	16	47	2	31	31	1.0000000
NODE_144137_length_319_cov_4.068182	5	36	0	31	31	1.0000000
NODE_144162_length_319_cov_3.568182	149	229	0	40	80	0.5000000
NODE_144162_length_319_cov_3.568182	149	229	2	40	80	0.5000000
NODE_144206_length_319_cov_3.036364	112	174	0	62	62	1.0000000
NODE_144226_length_319_cov_2.800000	25	106	0	19	81	0.2345679
NODE_144226_length_319_cov_2.800000	25	106	1	7	81	0.0864198
NODE_144226_length_319_cov_2.800000	25	106	5	3	81	0.0370370
NODE_144226_length_319_cov_2.800000	25	106	7	6	81	0.0740741
NODE_144226_length_319_cov_2.800000	25	106	9	4	81	0.0493827
NODE_144226_length_319_cov_2.800000	25	106	11	4	81	0.0493827
NODE_144226_length_319_cov_2.800000	25	106	14	6	81	0.0740741
NODE_144226_length_319_cov_2.800000	25	106	15	2	81	0.0246914
NODE_144226_length_319_cov_2.800000	25	106	20	1	81	0.0123457
NODE_144226_length_319_cov_2.800000	25	106	21	6	81	0.0740741
NODE_144226_length_319_cov_2.800000	25	106	23	4	81	0.0493827
NODE_144226_length_319_cov_2.800000	25	106	27	6	81	0.0740741
NODE_144226_length_319_cov_2.800000	25	106	31	4	81	0.0493827
NODE_144226_length_319_cov_2.800000	25	106	33	1	81	0.0123457
NODE_144226_length_319_cov_2.800000	25	106	34	8	81	0.0987654
NODE_144226_length_319_cov_2.800000	79	158	21	4	79	0.0506329
NODE_144226_length_319_cov_2.800000	79	158	23	4	79	0.0506329
NODE_144226_length_319_cov_2.800000	79	158	26	7	79	0.0886076
NODE_144226_length_319_cov_2.800000	79	158	27	6	79	0.0759494
NODE_144226_length_319_cov_2.800000	79	158	31	4	79	0.0506329
NODE_144226_length_319_cov_2.800000	79	158	32	8	79	0.1012658
NODE_144226_length_319_cov_2.800000	79	158	33	7	79	0.0886076
NODE_144226_length_319_cov_2.800000	79	158	34	39	79	0.4936709
NODE_144237_length_319_cov_2.740909	67	147	3	17	80	0.2125000
NODE_144237_length_319_cov_2.740909	67	147	5	13	80	0.1625000
NODE_144237_length_319_cov_2.740909	67	147	6	1	80	0.0125000
NODE_144237_length_319_cov_2.740909	67	147	7	49	80	0.6125000
NODE_144252_length_319_cov_2.586364	247	319	0	72	72	1.0000000
NODE_144272_length_319_cov_2.463636	90	153	2	63	63	1.0000000
NODE_144272_length_319_cov_2.463636	163	216	0	40	53	0.7547170
NODE_144272_length_319_cov_2.463636	163	216	2	13	53	0.2452830
NODE_144316_length_319_cov_2.259091	146	212	0	59	66	0.8939394
NODE_144316_length_319_cov_2.259091	146	212	2	6	66	0.0909091
NODE_144316_length_319_cov_2.259091	146	212	4	1	66	0.0151515
NODE_144340_length_319_cov_2.163636	213	275	0	62	62	1.0000000
NODE_144390_length_319_cov_1.968182	120	200	0	80	80	1.0000000
NODE_144616_length_319_cov_1.431818	111	157	2	43	46	0.9347826
NODE_144616_length_319_cov_1.431818	111	157	4	3	46	0.0652174
NODE_144629_length_319_cov_1.395455	129	179	0	14	50	0.2800000
NODE_144629_length_319_cov_1.395455	129	179	2	36	50	0.7200000
NODE_144788_length_319_cov_1.190909	119	182	0	63	63	1.0000000
NODE_144788_length_319_cov_1.190909	197	232	0	35	35	1.0000000
NODE_145289_length_318_cov_232.639269	169	198	127	1	29	0.0344828
NODE_145289_length_318_cov_232.639269	169	198	131	2	29	0.0689655
NODE_145289_length_318_cov_232.639269	169	198	137	1	29	0.0344828
NODE_145289_length_318_cov_232.639269	169	198	139	1	29	0.0344828
NODE_145289_length_318_cov_232.639269	169	198	145	2	29	0.0689655
NODE_145289_length_318_cov_232.639269	169	198	151	2	29	0.0689655
NODE_145289_length_318_cov_232.639269	169	198	159	3	29	0.1034483
NODE_145289_length_318_cov_232.639269	169	198	161	1	29	0.0344828
NODE_145289_length_318_cov_232.639269	169	198	167	1	29	0.0344828
NODE_145289_length_318_cov_232.639269	169	198	169	1	29	0.0344828
NODE_145289_length_318_cov_232.639269	169	198	171	4	29	0.1379310
NODE_145289_length_318_cov_232.639269	169	198	176	1	29	0.0344828
NODE_145289_length_318_cov_232.639269	169	198	177	1	29	0.0344828
NODE_145289_length_318_cov_232.639269	169	198	181	1	29	0.0344828
NODE_145289_length_318_cov_232.639269	169	198	183	1	29	0.0344828
NODE_145289_length_318_cov_232.639269	169	198	185	2	29	0.0689655
NODE_145289_length_318_cov_232.639269	169	198	189	1	29	0.0344828
NODE_145289_length_318_cov_232.639269	169	198	191	1	29	0.0344828
NODE_145289_length_318_cov_232.639269	169	198	193	1	29	0.0344828
NODE_145289_length_318_cov_232.639269	169	198	195	1	29	0.0344828
NODE_145289_length_318_cov_232.639269	171	246	131	1	75	0.0133333
NODE_145289_length_318_cov_232.639269	171	246	137	1	75	0.0133333
NODE_145289_length_318_cov_232.639269	171	246	139	1	75	0.0133333
NODE_145289_length_318_cov_232.639269	171	246	145	2	75	0.0266667
NODE_145289_length_318_cov_232.639269	171	246	151	2	75	0.0266667
NODE_145289_length_318_cov_232.639269	171	246	159	3	75	0.0400000
NODE_145289_length_318_cov_232.639269	171	246	161	1	75	0.0133333
NODE_145289_length_318_cov_232.639269	171	246	162	1	75	0.0133333
NODE_145289_length_318_cov_232.639269	171	246	164	2	75	0.0266667
NODE_145289_length_318_cov_232.639269	171	246	165	2	75	0.0266667
NODE_145289_length_318_cov_232.639269	171	246	167	2	75	0.0266667
NODE_145289_length_318_cov_232.639269	171	246	169	1	75	0.0133333
NODE_145289_length_318_cov_232.639269	171	246	171	8	75	0.1066667
NODE_145289_length_318_cov_232.639269	171	246	176	1	75	0.0133333
NODE_145289_length_318_cov_232.639269	171	246	177	1	75	0.0133333
NODE_145289_length_318_cov_232.639269	171	246	181	1	75	0.0133333
NODE_145289_length_318_cov_232.639269	171	246	182	1	75	0.0133333
NODE_145289_length_318_cov_232.639269	171	246	183	1	75	0.0133333
NODE_145289_length_318_cov_232.639269	171	246	185	2	75	0.0266667
NODE_145289_length_318_cov_232.639269	171	246	187	2	75	0.0266667
NODE_145289_length_318_cov_232.639269	171	246	189	1	75	0.0133333
NODE_145289_length_318_cov_232.639269	171	246	191	1	75	0.0133333
NODE_145289_length_318_cov_232.639269	171	246	192	2	75	0.0266667
NODE_145289_length_318_cov_232.639269	171	246	193	1	75	0.0133333
NODE_145289_length_318_cov_232.639269	171	246	194	2	75	0.0266667
NODE_145289_length_318_cov_232.639269	171	246	195	3	75	0.0400000
NODE_145289_length_318_cov_232.639269	171	246	197	2	75	0.0266667
NODE_145289_length_318_cov_232.639269	171	246	199	4	75	0.0533333
NODE_145289_length_318_cov_232.639269	171	246	201	6	75	0.0800000
NODE_145289_length_318_cov_232.639269	171	246	203	6	75	0.0800000
NODE_145289_length_318_cov_232.639269	171	246	205	2	75	0.0266667
NODE_145289_length_318_cov_232.639269	171	246	207	4	75	0.0533333
NODE_145289_length_318_cov_232.639269	171	246	209	5	75	0.0666667
NODE_145333_length_318_cov_4.237443	222	294	0	29	72	0.4027778
NODE_145333_length_318_cov_4.237443	222	294	2	43	72	0.5972222
NODE_145348_length_318_cov_3.721461	98	148	0	50	50	1.0000000
NODE_145362_length_318_cov_3.515982	60	129	0	69	69	1.0000000
NODE_145362_length_318_cov_3.515982	60	140	0	80	80	1.0000000
NODE_145362_length_318_cov_3.515982	60	140	0	80	80	1.0000000
NODE_145362_length_318_cov_3.515982	113	153	0	40	40	1.0000000
NODE_145362_length_318_cov_3.515982	122	153	0	31	31	1.0000000
NODE_145465_length_318_cov_2.557078	205	247	0	1	42	0.0238095
NODE_145465_length_318_cov_2.557078	205	247	2	41	42	0.9761904
NODE_145551_length_318_cov_2.109589	70	150	0	15	80	0.1875000
NODE_145551_length_318_cov_2.109589	70	150	2	51	80	0.6375000
NODE_145551_length_318_cov_2.109589	70	150	4	14	80	0.1750000
NODE_145619_length_318_cov_1.945205	229	286	0	57	57	1.0000000
NODE_145709_length_318_cov_1.739726	242	308	0	33	66	0.5000000
NODE_145709_length_318_cov_1.739726	242	308	2	33	66	0.5000000
NODE_145725_length_318_cov_1.684932	49	80	0	31	31	1.0000000
NODE_145787_length_318_cov_1.561644	99	158	2	1	59	0.0169492
NODE_145787_length_318_cov_1.561644	99	158	4	58	59	0.9830508
NODE_145807_length_318_cov_1.493151	151	195	0	44	44	1.0000000
NODE_145807_length_318_cov_1.493151	199	258	0	59	59	1.0000000
NODE_145968_length_318_cov_1.301370	91	141	0	50	50	1.0000000
NODE_146017_length_318_cov_1.173516	83	150	2	5	67	0.0746269
NODE_146017_length_318_cov_1.173516	83	150	4	45	67	0.6716418
NODE_146017_length_318_cov_1.173516	83	150	6	2	67	0.0298507
NODE_146017_length_318_cov_1.173516	83	150	8	15	67	0.2238806
NODE_146065_length_318_cov_1.127854	24	51	0	27	27	1.0000000
NODE_146065_length_318_cov_1.127854	24	60	0	36	36	1.0000000
NODE_146467_length_317_cov_55.467890	172	243	20	4	71	0.0563380
NODE_146467_length_317_cov_55.467890	172	243	22	1	71	0.0140845
NODE_146467_length_317_cov_55.467890	172	243	26	2	71	0.0281690
NODE_146467_length_317_cov_55.467890	172	243	28	3	71	0.0422535
NODE_146467_length_317_cov_55.467890	172	243	30	2	71	0.0281690
NODE_146467_length_317_cov_55.467890	172	243	32	4	71	0.0563380
NODE_146467_length_317_cov_55.467890	172	243	34	7	71	0.0985916
NODE_146467_length_317_cov_55.467890	172	243	36	1	71	0.0140845
NODE_146467_length_317_cov_55.467890	172	243	38	1	71	0.0140845
NODE_146467_length_317_cov_55.467890	172	243	42	1	71	0.0140845
NODE_146467_length_317_cov_55.467890	172	243	46	1	71	0.0140845
NODE_146467_length_317_cov_55.467890	172	243	50	1	71	0.0140845
NODE_146467_length_317_cov_55.467890	172	243	52	3	71	0.0422535
NODE_146467_length_317_cov_55.467890	172	243	54	1	71	0.0140845
NODE_146467_length_317_cov_55.467890	172	243	58	5	71	0.0704225
NODE_146467_length_317_cov_55.467890	172	243	60	1	71	0.0140845
NODE_146467_length_317_cov_55.467890	172	243	62	4	71	0.0563380
NODE_146467_length_317_cov_55.467890	172	243	64	7	71	0.0985916
NODE_146467_length_317_cov_55.467890	172	243	66	3	71	0.0422535
NODE_146467_length_317_cov_55.467890	172	243	68	19	71	0.2676056
NODE_146487_length_317_cov_5.252294	247	307	0	2	60	0.0333333
NODE_146487_length_317_cov_5.252294	247	307	4	58	60	0.9666666
NODE_146503_length_317_cov_4.467890	105	185	0	80	80	1.0000000
NODE_146503_length_317_cov_4.467890	113	193	0	80	80	1.0000000
NODE_146554_length_317_cov_3.298165	146	206	4	9	60	0.1500000
NODE_146554_length_317_cov_3.298165	146	206	6	4	60	0.0666667
NODE_146554_length_317_cov_3.298165	146	206	8	8	60	0.1333333
NODE_146554_length_317_cov_3.298165	146	206	12	11	60	0.1833333
NODE_146554_length_317_cov_3.298165	146	206	14	13	60	0.2166667
NODE_146554_length_317_cov_3.298165	146	206	16	15	60	0.2500000
NODE_146562_length_317_cov_3.266055	111	191	2	16	80	0.2000000
NODE_146562_length_317_cov_3.266055	111	191	4	4	80	0.0500000
NODE_146562_length_317_cov_3.266055	111	191	6	19	80	0.2375000
NODE_146562_length_317_cov_3.266055	111	191	8	11	80	0.1375000
NODE_146562_length_317_cov_3.266055	111	191	10	7	80	0.0875000
NODE_146562_length_317_cov_3.266055	111	191	12	11	80	0.1375000
NODE_146562_length_317_cov_3.266055	111	191	14	12	80	0.1500000
NODE_146562_length_317_cov_3.266055	164	244	0	41	80	0.5125000
NODE_146562_length_317_cov_3.266055	164	244	2	28	80	0.3500000
NODE_146562_length_317_cov_3.266055	164	244	4	4	80	0.0500000
NODE_146562_length_317_cov_3.266055	164	244	6	7	80	0.0875000
NODE_146585_length_317_cov_3.036697	3	79	0	76	76	1.0000000
NODE_146601_length_317_cov_2.825688	14	94	0	57	80	0.7125000
NODE_146601_length_317_cov_2.825688	14	94	2	1	80	0.0125000
NODE_146601_length_317_cov_2.825688	14	94	4	22	80	0.2750000
NODE_146601_length_317_cov_2.825688	67	147	0	4	80	0.0500000
NODE_146601_length_317_cov_2.825688	67	147	2	1	80	0.0125000
NODE_146601_length_317_cov_2.825688	67	147	4	71	80	0.8875000
NODE_146601_length_317_cov_2.825688	67	147	6	4	80	0.0500000
NODE_146602_length_317_cov_2.821101	142	208	0	55	66	0.8333333
NODE_146602_length_317_cov_2.821101	142	208	2	11	66	0.1666667
NODE_146604_length_317_cov_2.816514	121	201	0	80	80	1.0000000
NODE_146612_length_317_cov_2.779817	67	138	0	67	71	0.9436620
NODE_146612_length_317_cov_2.779817	67	138	2	4	71	0.0563380
NODE_147046_length_317_cov_1.353211	166	239	2	73	73	1.0000000
NODE_147046_length_317_cov_1.353211	212	292	0	37	80	0.4625000
NODE_147046_length_317_cov_1.353211	212	292	2	43	80	0.5375000
NODE_147172_length_317_cov_1.160550	58	117	2	26	59	0.4406780
NODE_147172_length_317_cov_1.160550	58	117	4	2	59	0.0338983
NODE_147172_length_317_cov_1.160550	58	117	6	18	59	0.3050847
NODE_147172_length_317_cov_1.160550	58	117	8	13	59	0.2203390
NODE_147172_length_317_cov_1.160550	90	170	6	14	80	0.1750000
NODE_147172_length_317_cov_1.160550	90	170	8	42	80	0.5250000
NODE_147172_length_317_cov_1.160550	90	170	10	14	80	0.1750000
NODE_147172_length_317_cov_1.160550	90	170	12	10	80	0.1250000
NODE_147187_length_317_cov_1.137615	245	313	0	68	68	1.0000000
NODE_147259_length_317_cov_0.967890	170	211	0	41	41	1.0000000
NODE_147373_length_317_cov_0.926606	194	232	0	38	38	1.0000000
NODE_147383_length_317_cov_0.912844	186	244	0	58	58	1.0000000
NODE_147595_length_316_cov_31.502304	96	174	0	2	78	0.0256410
NODE_147595_length_316_cov_31.502304	96	174	4	27	78	0.3461539
NODE_147595_length_316_cov_31.502304	96	174	6	10	78	0.1282051
NODE_147595_length_316_cov_31.502304	96	174	8	8	78	0.1025641
NODE_147595_length_316_cov_31.502304	96	174	10	9	78	0.1153846
NODE_147595_length_316_cov_31.502304	96	174	12	1	78	0.0128205
NODE_147595_length_316_cov_31.502304	96	174	14	10	78	0.1282051
NODE_147595_length_316_cov_31.502304	96	174	16	9	78	0.1153846
NODE_147595_length_316_cov_31.502304	96	174	20	2	78	0.0256410
NODE_147595_length_316_cov_31.502304	96	121	0	2	25	0.0800000
NODE_147595_length_316_cov_31.502304	96	121	4	23	25	0.9200000
NODE_147609_length_316_cov_6.179724	225	278	0	53	53	1.0000000
NODE_147623_length_316_cov_5.539171	91	171	2	80	80	1.0000000
NODE_147668_length_316_cov_3.732719	128	208	0	28	80	0.3500000
NODE_147668_length_316_cov_3.732719	128	208	2	52	80	0.6500000
NODE_147668_length_316_cov_3.732719	181	257	2	76	76	1.0000000
NODE_147680_length_316_cov_3.589862	185	247	0	62	62	1.0000000
NODE_147684_length_316_cov_3.520737	101	143	2	42	42	1.0000000
NODE_147702_length_316_cov_3.221198	108	184	0	42	76	0.5526316
NODE_147702_length_316_cov_3.221198	108	184	2	2	76	0.0263158
NODE_147702_length_316_cov_3.221198	108	184	4	32	76	0.4210526
NODE_147734_length_316_cov_2.824885	274	311	0	37	37	1.0000000
NODE_147736_length_316_cov_2.820276	200	280	0	80	80	1.0000000
NODE_147757_length_316_cov_2.672811	23	80	0	57	57	1.0000000
NODE_147796_length_316_cov_2.456221	104	144	0	5	40	0.1250000
NODE_147796_length_316_cov_2.456221	104	144	2	35	40	0.8750000
NODE_147985_length_316_cov_1.751152	73	122	0	27	49	0.5510204
NODE_147985_length_316_cov_1.751152	73	122	2	22	49	0.4489796
NODE_148030_length_316_cov_1.640553	218	300	0	82	82	1.0000000
NODE_148042_length_316_cov_1.631336	180	233	0	53	53	1.0000000
NODE_148042_length_316_cov_1.631336	180	215	0	35	35	1.0000000
NODE_148080_length_316_cov_1.520737	194	275	0	81	81	1.0000000
NODE_148080_length_316_cov_1.520737	248	302	0	54	54	1.0000000
NODE_148086_length_316_cov_1.493088	64	144	2	37	80	0.4625000
NODE_148086_length_316_cov_1.493088	64	144	4	43	80	0.5375000
NODE_148193_length_316_cov_1.377880	22	64	0	42	42	1.0000000
NODE_148204_length_316_cov_1.350230	74	117	0	43	43	1.0000000
NODE_148204_length_316_cov_1.350230	90	140	0	50	50	1.0000000
NODE_148533_length_316_cov_0.940092	104	180	0	25	76	0.3289474
NODE_148533_length_316_cov_0.940092	104	180	2	51	76	0.6710526
NODE_148533_length_316_cov_0.940092	155	234	0	56	79	0.7088608
NODE_148533_length_316_cov_0.940092	155	234	2	23	79	0.2911392
NODE_148693_length_316_cov_0.695853	232	267	4	35	35	1.0000000
NODE_148778_length_315_cov_6.967593	127	191	8	32	64	0.5000000
NODE_148778_length_315_cov_6.967593	127	191	10	32	64	0.5000000
NODE_148786_length_315_cov_6.300926	67	147	0	80	80	1.0000000
NODE_148786_length_315_cov_6.300926	120	200	0	80	80	1.0000000
NODE_148812_length_315_cov_4.449074	125	205	2	26	80	0.3250000
NODE_148812_length_315_cov_4.449074	125	205	4	14	80	0.1750000
NODE_148812_length_315_cov_4.449074	125	205	6	36	80	0.4500000
NODE_148812_length_315_cov_4.449074	125	205	8	4	80	0.0500000
NODE_148812_length_315_cov_4.449074	178	225	0	20	47	0.4255319
NODE_148812_length_315_cov_4.449074	178	225	2	26	47	0.5531915
NODE_148812_length_315_cov_4.449074	178	225	4	1	47	0.0212766
NODE_148834_length_315_cov_4.009259	0	61	0	61	61	1.0000000
NODE_148834_length_315_cov_4.009259	42	61	0	19	19	1.0000000
NODE_148872_length_315_cov_3.421296	37	120	4	83	83	1.0000000
NODE_148915_length_315_cov_2.847222	0	74	0	74	74	1.0000000
NODE_148915_length_315_cov_2.847222	47	127	0	80	80	1.0000000
NODE_148921_length_315_cov_2.833333	186	253	0	67	67	1.0000000
NODE_148921_length_315_cov_2.833333	186	253	0	67	67	1.0000000
NODE_148991_length_315_cov_2.416667	44	117	2	18	73	0.2465753
NODE_148991_length_315_cov_2.416667	44	117	6	1	73	0.0136986
NODE_148991_length_315_cov_2.416667	44	117	8	5	73	0.0684932
NODE_148991_length_315_cov_2.416667	44	117	10	21	73	0.2876712
NODE_148991_length_315_cov_2.416667	44	117	11	5	73	0.0684932
NODE_148991_length_315_cov_2.416667	44	117	12	7	73	0.0958904
NODE_148991_length_315_cov_2.416667	44	117	14	16	73	0.2191781
NODE_149074_length_315_cov_2.115741	128	193	0	1	65	0.0153846
NODE_149074_length_315_cov_2.115741	128	193	3	2	65	0.0307692
NODE_149074_length_315_cov_2.115741	128	193	4	62	65	0.9538462
NODE_149095_length_315_cov_2.004630	270	315	0	24	45	0.5333334
NODE_149095_length_315_cov_2.004630	270	315	2	21	45	0.4666667
NODE_149201_length_315_cov_1.731481	125	202	0	77	77	1.0000000
NODE_149391_length_315_cov_1.384259	183	233	0	50	50	1.0000000
NODE_149935_length_315_cov_0.430556	125	145	2	4	20	0.2000000
NODE_149935_length_315_cov_0.430556	125	145	4	16	20	0.8000000
NODE_149943_length_314_cov_108.139535	151	213	60	2	62	0.0322581
NODE_149943_length_314_cov_108.139535	151	213	62	1	62	0.0161290
NODE_149943_length_314_cov_108.139535	151	213	63	1	62	0.0161290
NODE_149943_length_314_cov_108.139535	151	213	64	4	62	0.0645161
NODE_149943_length_314_cov_108.139535	151	213	65	1	62	0.0161290
NODE_149943_length_314_cov_108.139535	151	213	66	8	62	0.1290323
NODE_149943_length_314_cov_108.139535	151	213	67	7	62	0.1129032
NODE_149943_length_314_cov_108.139535	151	213	68	6	62	0.0967742
NODE_149943_length_314_cov_108.139535	151	213	69	1	62	0.0161290
NODE_149943_length_314_cov_108.139535	151	213	70	5	62	0.0806452
NODE_149943_length_314_cov_108.139535	151	213	71	1	62	0.0161290
NODE_149943_length_314_cov_108.139535	151	213	72	2	62	0.0322581
NODE_149943_length_314_cov_108.139535	151	213	73	1	62	0.0161290
NODE_149943_length_314_cov_108.139535	151	213	74	4	62	0.0645161
NODE_149943_length_314_cov_108.139535	151	213	75	3	62	0.0483871
NODE_149943_length_314_cov_108.139535	151	213	77	2	62	0.0322581
NODE_149943_length_314_cov_108.139535	151	213	81	1	62	0.0161290
NODE_149943_length_314_cov_108.139535	151	213	83	4	62	0.0645161
NODE_149943_length_314_cov_108.139535	151	213	85	1	62	0.0161290
NODE_149943_length_314_cov_108.139535	151	213	87	7	62	0.1129032
NODE_149943_length_314_cov_108.139535	160	213	63	1	53	0.0188679
NODE_149943_length_314_cov_108.139535	160	213	64	2	53	0.0377358
NODE_149943_length_314_cov_108.139535	160	213	65	1	53	0.0188679
NODE_149943_length_314_cov_108.139535	160	213	66	8	53	0.1509434
NODE_149943_length_314_cov_108.139535	160	213	67	7	53	0.1320755
NODE_149943_length_314_cov_108.139535	160	213	68	2	53	0.0377358
NODE_149943_length_314_cov_108.139535	160	213	69	1	53	0.0188679
NODE_149943_length_314_cov_108.139535	160	213	70	5	53	0.0943396
NODE_149943_length_314_cov_108.139535	160	213	71	1	53	0.0188679
NODE_149943_length_314_cov_108.139535	160	213	72	2	53	0.0377358
NODE_149943_length_314_cov_108.139535	160	213	73	1	53	0.0188679
NODE_149943_length_314_cov_108.139535	160	213	74	4	53	0.0754717
NODE_149943_length_314_cov_108.139535	160	213	75	3	53	0.0566038
NODE_149943_length_314_cov_108.139535	160	213	77	2	53	0.0377358
NODE_149943_length_314_cov_108.139535	160	213	81	1	53	0.0188679
NODE_149943_length_314_cov_108.139535	160	213	83	4	53	0.0754717
NODE_149943_length_314_cov_108.139535	160	213	85	1	53	0.0188679
NODE_149943_length_314_cov_108.139535	160	213	87	7	53	0.1320755
NODE_149944_length_314_cov_48.134884	245	314	0	69	69	1.0000000
NODE_149946_length_314_cov_9.097674	149	206	0	57	57	1.0000000
NODE_149967_length_314_cov_4.897674	109	189	0	2	80	0.0250000
NODE_149967_length_314_cov_4.897674	109	189	2	78	80	0.9750000
NODE_150004_length_314_cov_3.823256	119	199	0	28	80	0.3500000
NODE_150004_length_314_cov_3.823256	119	199	2	52	80	0.6500000
NODE_150020_length_314_cov_3.558140	32	92	8	20	60	0.3333333
NODE_150020_length_314_cov_3.558140	32	92	10	30	60	0.5000000
NODE_150020_length_314_cov_3.558140	32	92	12	1	60	0.0166667
NODE_150020_length_314_cov_3.558140	32	92	13	9	60	0.1500000
NODE_150035_length_314_cov_3.316279	84	126	10	10	42	0.2380952
NODE_150035_length_314_cov_3.316279	84	126	12	6	42	0.1428571
NODE_150035_length_314_cov_3.316279	84	126	14	26	42	0.6190476
NODE_150035_length_314_cov_3.316279	127	180	0	25	53	0.4716981
NODE_150035_length_314_cov_3.316279	127	180	4	1	53	0.0188679
NODE_150035_length_314_cov_3.316279	127	180	6	11	53	0.2075472
NODE_150035_length_314_cov_3.316279	127	180	8	1	53	0.0188679
NODE_150035_length_314_cov_3.316279	127	180	10	15	53	0.2830189
NODE_150035_length_314_cov_3.316279	128	148	6	5	20	0.2500000
NODE_150035_length_314_cov_3.316279	128	148	8	1	20	0.0500000
NODE_150035_length_314_cov_3.316279	128	148	10	14	20	0.7000000
NODE_150066_length_314_cov_3.032558	252	308	0	56	56	1.0000000
NODE_150141_length_314_cov_2.520930	0	61	0	3	61	0.0491803
NODE_150141_length_314_cov_2.520930	0	61	2	58	61	0.9508197
NODE_150141_length_314_cov_2.520930	34	93	2	59	59	1.0000000
NODE_150153_length_314_cov_2.441860	48	84	2	36	36	1.0000000
NODE_150159_length_314_cov_2.395349	62	112	2	3	50	0.0600000
NODE_150159_length_314_cov_2.395349	62	112	4	18	50	0.3600000
NODE_150159_length_314_cov_2.395349	62	112	6	29	50	0.5800000
NODE_150200_length_314_cov_2.265116	7	53	0	46	46	1.0000000
NODE_150220_length_314_cov_2.144186	224	264	4	40	40	1.0000000
NODE_150257_length_314_cov_2.004651	68	148	0	80	80	1.0000000
NODE_150257_length_314_cov_2.004651	121	201	0	77	80	0.9625000
NODE_150257_length_314_cov_2.004651	121	201	2	3	80	0.0375000
NODE_150385_length_314_cov_1.665116	204	242	0	38	38	1.0000000
NODE_150385_length_314_cov_1.665116	215	295	0	80	80	1.0000000
NODE_150647_length_314_cov_1.223256	7	87	0	6	80	0.0750000
NODE_150647_length_314_cov_1.223256	7	87	2	16	80	0.2000000
NODE_150647_length_314_cov_1.223256	7	87	4	58	80	0.7250000
NODE_150709_length_314_cov_1.167442	1	69	0	68	68	1.0000000
NODE_151193_length_313_cov_156.051402	177	254	4	10	77	0.1298701
NODE_151193_length_313_cov_156.051402	177	254	6	2	77	0.0259740
NODE_151193_length_313_cov_156.051402	177	254	8	3	77	0.0389610
NODE_151193_length_313_cov_156.051402	177	254	10	3	77	0.0389610
NODE_151193_length_313_cov_156.051402	177	254	12	16	77	0.2077922
NODE_151193_length_313_cov_156.051402	177	254	14	12	77	0.1558442
NODE_151193_length_313_cov_156.051402	177	254	16	31	77	0.4025974
NODE_151193_length_313_cov_156.051402	177	254	4	10	77	0.1298701
NODE_151193_length_313_cov_156.051402	177	254	6	2	77	0.0259740
NODE_151193_length_313_cov_156.051402	177	254	8	3	77	0.0389610
NODE_151193_length_313_cov_156.051402	177	254	10	3	77	0.0389610
NODE_151193_length_313_cov_156.051402	177	254	12	16	77	0.2077922
NODE_151193_length_313_cov_156.051402	177	254	14	12	77	0.1558442
NODE_151193_length_313_cov_156.051402	177	254	16	31	77	0.4025974
NODE_151214_length_313_cov_5.359813	135	196	0	61	61	1.0000000
NODE_151214_length_313_cov_5.359813	169	241	0	72	72	1.0000000
NODE_151230_length_313_cov_4.794393	126	206	0	80	80	1.0000000
NODE_151230_length_313_cov_4.794393	179	259	0	80	80	1.0000000
NODE_151232_length_313_cov_4.761682	104	162	0	17	58	0.2931035
NODE_151232_length_313_cov_4.761682	104	162	5	12	58	0.2068966
NODE_151232_length_313_cov_4.761682	104	162	6	13	58	0.2241379
NODE_151232_length_313_cov_4.761682	104	162	8	16	58	0.2758621
NODE_151232_length_313_cov_4.761682	135	215	0	10	80	0.1250000
NODE_151232_length_313_cov_4.761682	135	215	6	11	80	0.1375000
NODE_151232_length_313_cov_4.761682	135	215	8	59	80	0.7375000
NODE_151277_length_313_cov_3.560748	106	186	2	80	80	1.0000000
NODE_151331_length_313_cov_2.953271	92	153	0	61	61	1.0000000
NODE_151364_length_313_cov_2.640187	110	182	0	72	72	1.0000000
NODE_151364_length_313_cov_2.640187	113	184	0	71	71	1.0000000
NODE_151409_length_313_cov_2.383178	58	137	0	79	79	1.0000000
NODE_151409_length_313_cov_2.383178	110	190	0	78	80	0.9750000
NODE_151409_length_313_cov_2.383178	110	190	2	1	80	0.0125000
NODE_151409_length_313_cov_2.383178	110	190	4	1	80	0.0125000
NODE_151474_length_313_cov_2.107477	153	221	0	27	68	0.3970588
NODE_151474_length_313_cov_2.107477	153	221	2	41	68	0.6029412
NODE_151510_length_313_cov_1.934579	107	187	0	15	80	0.1875000
NODE_151510_length_313_cov_1.934579	107	187	2	16	80	0.2000000
NODE_151510_length_313_cov_1.934579	107	187	6	1	80	0.0125000
NODE_151510_length_313_cov_1.934579	107	187	8	1	80	0.0125000
NODE_151510_length_313_cov_1.934579	107	187	10	6	80	0.0750000
NODE_151510_length_313_cov_1.934579	107	187	12	10	80	0.1250000
NODE_151510_length_313_cov_1.934579	107	187	16	3	80	0.0375000
NODE_151510_length_313_cov_1.934579	107	187	18	3	80	0.0375000
NODE_151510_length_313_cov_1.934579	107	187	20	1	80	0.0125000
NODE_151510_length_313_cov_1.934579	107	187	22	2	80	0.0250000
NODE_151510_length_313_cov_1.934579	107	187	26	1	80	0.0125000
NODE_151510_length_313_cov_1.934579	107	187	34	6	80	0.0750000
NODE_151510_length_313_cov_1.934579	107	187	36	1	80	0.0125000
NODE_151510_length_313_cov_1.934579	107	187	38	2	80	0.0250000
NODE_151510_length_313_cov_1.934579	107	187	42	1	80	0.0125000
NODE_151510_length_313_cov_1.934579	107	187	46	2	80	0.0250000
NODE_151510_length_313_cov_1.934579	107	187	48	2	80	0.0250000
NODE_151510_length_313_cov_1.934579	107	187	50	5	80	0.0625000
NODE_151510_length_313_cov_1.934579	107	187	52	2	80	0.0250000
NODE_151510_length_313_cov_1.934579	160	240	18	2	80	0.0250000
NODE_151510_length_313_cov_1.934579	160	240	20	1	80	0.0125000
NODE_151510_length_313_cov_1.934579	160	240	22	2	80	0.0250000
NODE_151510_length_313_cov_1.934579	160	240	26	1	80	0.0125000
NODE_151510_length_313_cov_1.934579	160	240	34	6	80	0.0750000
NODE_151510_length_313_cov_1.934579	160	240	36	1	80	0.0125000
NODE_151510_length_313_cov_1.934579	160	240	38	2	80	0.0250000
NODE_151510_length_313_cov_1.934579	160	240	42	1	80	0.0125000
NODE_151510_length_313_cov_1.934579	160	240	46	2	80	0.0250000
NODE_151510_length_313_cov_1.934579	160	240	48	2	80	0.0250000
NODE_151510_length_313_cov_1.934579	160	240	50	14	80	0.1750000
NODE_151510_length_313_cov_1.934579	160	240	52	40	80	0.5000000
NODE_151510_length_313_cov_1.934579	160	240	54	6	80	0.0750000
NODE_151576_length_313_cov_1.780374	236	296	0	60	60	1.0000000
NODE_151623_length_313_cov_1.663551	58	135	0	77	77	1.0000000
NODE_151703_length_313_cov_1.439252	0	64	0	64	64	1.0000000
NODE_151703_length_313_cov_1.439252	37	82	0	45	45	1.0000000
NODE_151753_length_313_cov_1.429907	74	111	2	37	37	1.0000000
NODE_151753_length_313_cov_1.429907	109	172	0	3	63	0.0476190
NODE_151753_length_313_cov_1.429907	109	172	2	60	63	0.9523810
NODE_151953_length_313_cov_1.172897	106	161	0	55	55	1.0000000
NODE_151953_length_313_cov_1.172897	149	214	0	37	65	0.5692308
NODE_151953_length_313_cov_1.172897	149	214	5	1	65	0.0153846
NODE_151953_length_313_cov_1.172897	149	214	6	1	65	0.0153846
NODE_151953_length_313_cov_1.172897	149	214	8	6	65	0.0923077
NODE_151953_length_313_cov_1.172897	149	214	10	17	65	0.2615385
NODE_151953_length_313_cov_1.172897	149	214	12	2	65	0.0307692
NODE_151953_length_313_cov_1.172897	149	214	14	1	65	0.0153846
NODE_152525_length_312_cov_3.723005	178	238	0	26	60	0.4333333
NODE_152525_length_312_cov_3.723005	178	238	2	34	60	0.5666667
NODE_152525_length_312_cov_3.723005	231	291	0	60	60	1.0000000
NODE_152609_length_312_cov_2.723005	34	96	0	20	62	0.3225806
NODE_152609_length_312_cov_2.723005	34	96	2	42	62	0.6774194
NODE_152609_length_312_cov_2.723005	87	149	2	62	62	1.0000000
NODE_152680_length_312_cov_2.333333	6	70	0	64	64	1.0000000
NODE_152680_length_312_cov_2.333333	43	123	0	80	80	1.0000000
NODE_152686_length_312_cov_2.267606	176	208	0	32	32	1.0000000
NODE_152697_length_312_cov_2.234742	108	169	0	61	61	1.0000000
NODE_152751_length_312_cov_2.014085	141	205	0	64	64	1.0000000
NODE_152751_length_312_cov_2.014085	178	258	0	80	80	1.0000000
NODE_152827_length_312_cov_1.835681	176	221	0	45	45	1.0000000
NODE_152827_length_312_cov_1.835681	194	269	0	75	75	1.0000000
NODE_153222_length_312_cov_1.173709	87	133	2	26	46	0.5652174
NODE_153222_length_312_cov_1.173709	87	133	4	20	46	0.4347826
NODE_153222_length_312_cov_1.173709	150	217	6	2	67	0.0298507
NODE_153222_length_312_cov_1.173709	150	217	8	2	67	0.0298507
NODE_153222_length_312_cov_1.173709	150	217	10	8	67	0.1194030
NODE_153222_length_312_cov_1.173709	150	217	12	26	67	0.3880597
NODE_153222_length_312_cov_1.173709	150	217	14	5	67	0.0746269
NODE_153222_length_312_cov_1.173709	150	217	16	3	67	0.0447761
NODE_153222_length_312_cov_1.173709	150	217	18	18	67	0.2686567
NODE_153222_length_312_cov_1.173709	150	217	20	2	67	0.0298507
NODE_153222_length_312_cov_1.173709	150	217	25	1	67	0.0149254
NODE_153532_length_312_cov_0.788732	49	110	0	61	61	1.0000000
NODE_153532_length_312_cov_0.788732	102	163	0	61	61	1.0000000
NODE_153708_length_311_cov_5.179245	155	235	2	10	80	0.1250000
NODE_153708_length_311_cov_5.179245	155	235	4	70	80	0.8750000
NODE_153721_length_311_cov_4.589623	133	200	0	67	67	1.0000000
NODE_153730_length_311_cov_4.358491	199	263	0	64	64	1.0000000
NODE_153743_length_311_cov_3.929245	91	127	0	36	36	1.0000000
NODE_153755_length_311_cov_3.825472	224	304	0	80	80	1.0000000
NODE_153773_length_311_cov_3.466981	106	186	0	80	80	1.0000000
NODE_153796_length_311_cov_3.188679	39	96	0	57	57	1.0000000
NODE_153846_length_311_cov_2.702830	144	193	0	40	49	0.8163266
NODE_153846_length_311_cov_2.702830	144	193	2	9	49	0.1836735
NODE_153850_length_311_cov_2.665094	43	113	2	64	70	0.9142857
NODE_153850_length_311_cov_2.665094	43	113	4	6	70	0.0857143
NODE_153859_length_311_cov_2.617925	206	284	0	78	78	1.0000000
NODE_153859_length_311_cov_2.617925	257	301	0	44	44	1.0000000
NODE_153913_length_311_cov_2.349057	177	204	0	27	27	1.0000000
NODE_153919_length_311_cov_2.325472	74	138	0	64	64	1.0000000
NODE_153947_length_311_cov_2.188679	21	92	0	71	71	1.0000000
NODE_154014_length_311_cov_1.924528	46	65	0	3	19	0.1578947
NODE_154014_length_311_cov_1.924528	46	65	2	1	19	0.0526316
NODE_154014_length_311_cov_1.924528	46	65	4	15	19	0.7894737
NODE_154056_length_311_cov_1.891509	122	180	1	58	58	1.0000000
NODE_154188_length_311_cov_1.594340	0	35	0	35	35	1.0000000
NODE_154190_length_311_cov_1.589623	96	151	0	50	55	0.9090909
NODE_154190_length_311_cov_1.589623	96	151	2	5	55	0.0909091
NODE_154194_length_311_cov_1.570755	125	145	0	7	20	0.3500000
NODE_154194_length_311_cov_1.570755	125	145	2	11	20	0.5500000
NODE_154194_length_311_cov_1.570755	125	145	4	2	20	0.1000000
NODE_154957_length_311_cov_0.613208	136	216	0	80	80	1.0000000
NODE_154957_length_311_cov_0.613208	189	264	0	75	75	1.0000000
NODE_154996_length_310_cov_96.995261	211	249	49	4	38	0.1052632
NODE_154996_length_310_cov_96.995261	211	249	51	5	38	0.1315790
NODE_154996_length_310_cov_96.995261	211	249	55	4	38	0.1052632
NODE_154996_length_310_cov_96.995261	211	249	57	5	38	0.1315790
NODE_154996_length_310_cov_96.995261	211	249	58	4	38	0.1052632
NODE_154996_length_310_cov_96.995261	211	249	59	4	38	0.1052632
NODE_154996_length_310_cov_96.995261	211	249	61	1	38	0.0263158
NODE_154996_length_310_cov_96.995261	211	249	64	1	38	0.0263158
NODE_154996_length_310_cov_96.995261	211	249	65	5	38	0.1315790
NODE_154996_length_310_cov_96.995261	211	249	67	1	38	0.0263158
NODE_154996_length_310_cov_96.995261	211	249	69	2	38	0.0526316
NODE_154996_length_310_cov_96.995261	211	249	71	2	38	0.0526316
NODE_155001_length_310_cov_7.767773	80	151	2	71	71	1.0000000
NODE_155001_length_310_cov_7.767773	134	189	0	30	55	0.5454546
NODE_155001_length_310_cov_7.767773	134	189	2	25	55	0.4545455
NODE_155017_length_310_cov_5.914692	84	134	0	47	50	0.9400000
NODE_155017_length_310_cov_5.914692	84	134	4	1	50	0.0200000
NODE_155017_length_310_cov_5.914692	84	134	6	2	50	0.0400000
NODE_155017_length_310_cov_5.914692	113	134	0	21	21	1.0000000
NODE_155017_length_310_cov_5.914692	113	188	0	32	75	0.4266667
NODE_155017_length_310_cov_5.914692	113	188	1	2	75	0.0266667
NODE_155017_length_310_cov_5.914692	113	188	2	41	75	0.5466667
NODE_155066_length_310_cov_3.777251	146	226	0	30	80	0.3750000
NODE_155066_length_310_cov_3.777251	146	226	2	50	80	0.6250000
NODE_155115_length_310_cov_3.180095	137	211	0	16	74	0.2162162
NODE_155115_length_310_cov_3.180095	137	211	2	41	74	0.5540541
NODE_155115_length_310_cov_3.180095	137	211	4	7	74	0.0945946
NODE_155115_length_310_cov_3.180095	137	211	6	10	74	0.1351351
NODE_155179_length_310_cov_2.630332	122	174	0	52	52	1.0000000
NODE_155179_length_310_cov_2.630332	175	222	0	47	47	1.0000000
NODE_155180_length_310_cov_2.625592	258	301	0	42	43	0.9767442
NODE_155180_length_310_cov_2.625592	258	301	4	1	43	0.0232558
NODE_155195_length_310_cov_2.563981	149	196	0	8	47	0.1702128
NODE_155195_length_310_cov_2.563981	149	196	4	15	47	0.3191489
NODE_155195_length_310_cov_2.563981	149	196	6	11	47	0.2340426
NODE_155195_length_310_cov_2.563981	149	196	8	5	47	0.1063830
NODE_155195_length_310_cov_2.563981	149	196	10	4	47	0.0851064
NODE_155195_length_310_cov_2.563981	149	196	12	4	47	0.0851064
NODE_155195_length_310_cov_2.563981	169	249	0	61	80	0.7625000
NODE_155195_length_310_cov_2.563981	169	249	4	15	80	0.1875000
NODE_155195_length_310_cov_2.563981	169	249	6	4	80	0.0500000
NODE_155261_length_310_cov_2.298578	213	259	2	46	46	1.0000000
NODE_155334_length_310_cov_2.009479	223	303	0	63	80	0.7875000
NODE_155334_length_310_cov_2.009479	223	303	6	17	80	0.2125000
NODE_155439_length_310_cov_1.729858	53	91	2	38	38	1.0000000
NODE_155768_length_310_cov_1.222749	181	244	0	33	63	0.5238096
NODE_155768_length_310_cov_1.222749	181	244	2	30	63	0.4761905
NODE_155864_length_310_cov_1.142180	65	135	0	1	70	0.0142857
NODE_155864_length_310_cov_1.142180	65	135	1	1	70	0.0142857
NODE_155864_length_310_cov_1.142180	65	135	2	5	70	0.0714286
NODE_155864_length_310_cov_1.142180	65	135	4	15	70	0.2142857
NODE_155864_length_310_cov_1.142180	65	135	6	5	70	0.0714286
NODE_155864_length_310_cov_1.142180	65	135	8	24	70	0.3428572
NODE_155864_length_310_cov_1.142180	65	135	10	4	70	0.0571429
NODE_155864_length_310_cov_1.142180	65	135	12	9	70	0.1285714
NODE_155864_length_310_cov_1.142180	65	135	14	6	70	0.0857143
NODE_155937_length_310_cov_0.966825	131	212	0	81	81	1.0000000
NODE_155937_length_310_cov_0.966825	193	256	0	63	63	1.0000000
NODE_156078_length_310_cov_0.924171	180	222	0	42	42	1.0000000
NODE_156174_length_310_cov_0.739336	208	288	0	80	80	1.0000000
NODE_156332_length_309_cov_8.552381	154	234	0	80	80	1.0000000
NODE_156340_length_309_cov_6.147619	20	83	0	19	63	0.3015873
NODE_156340_length_309_cov_6.147619	20	83	3	1	63	0.0158730
NODE_156340_length_309_cov_6.147619	20	83	4	43	63	0.6825397
NODE_156349_length_309_cov_5.147619	213	291	0	78	78	1.0000000
NODE_156364_length_309_cov_4.585714	15	95	0	80	80	1.0000000
NODE_156472_length_309_cov_3.028571	0	47	0	47	47	1.0000000
NODE_156472_length_309_cov_3.028571	20	101	0	81	81	1.0000000
NODE_156563_length_309_cov_2.304762	179	218	4	39	39	1.0000000
NODE_156615_length_309_cov_2.095238	55	85	8	30	30	1.0000000
NODE_156678_length_309_cov_1.938095	2	73	0	71	71	1.0000000
NODE_156950_length_309_cov_1.414286	189	231	0	42	42	1.0000000
NODE_156978_length_309_cov_1.376190	94	168	0	22	74	0.2972973
NODE_156978_length_309_cov_1.376190	94	168	2	52	74	0.7027027
NODE_157334_length_309_cov_0.966667	134	153	0	19	19	1.0000000
NODE_157469_length_309_cov_0.738095	150	215	4	9	65	0.1384615
NODE_157469_length_309_cov_0.738095	150	215	6	8	65	0.1230769
NODE_157469_length_309_cov_0.738095	150	215	8	9	65	0.1384615
NODE_157469_length_309_cov_0.738095	150	215	10	19	65	0.2923077
NODE_157469_length_309_cov_0.738095	150	215	12	20	65	0.3076923
NODE_157661_length_308_cov_4.775120	137	174	0	37	37	1.0000000
NODE_157690_length_308_cov_3.966507	126	206	2	80	80	1.0000000
NODE_157705_length_308_cov_3.665072	11	75	0	64	64	1.0000000
NODE_157819_length_308_cov_2.593301	137	193	0	6	56	0.1071429
NODE_157819_length_308_cov_2.593301	137	193	2	50	56	0.8928571
NODE_157852_length_308_cov_2.435407	14	58	0	44	44	1.0000000
NODE_157852_length_308_cov_2.435407	31	111	0	80	80	1.0000000
NODE_157898_length_308_cov_2.191388	14	80	0	66	66	1.0000000
NODE_157903_length_308_cov_2.191388	236	296	0	60	60	1.0000000
NODE_157969_length_308_cov_1.952153	251	296	0	45	45	1.0000000
NODE_158083_length_308_cov_1.708134	102	148	0	2	46	0.0434783
NODE_158083_length_308_cov_1.708134	102	148	2	44	46	0.9565217
NODE_158276_length_308_cov_1.435407	196	276	0	80	80	1.0000000
NODE_158439_length_308_cov_1.162679	260	300	0	40	40	1.0000000
NODE_158439_length_308_cov_1.162679	273	307	0	34	34	1.0000000
NODE_158447_length_308_cov_1.148325	35	83	0	48	48	1.0000000
NODE_158448_length_308_cov_1.148325	253	308	0	46	55	0.8363636
NODE_158448_length_308_cov_1.148325	253	308	1	4	55	0.0727273
NODE_158448_length_308_cov_1.148325	253	308	2	5	55	0.0909091
NODE_158510_length_308_cov_1.038278	147	202	1	3	55	0.0545455
NODE_158510_length_308_cov_1.038278	147	202	2	52	55	0.9454545
NODE_158811_length_308_cov_0.684211	196	275	0	79	79	1.0000000
NODE_158821_length_308_cov_0.660287	109	157	0	22	48	0.4583333
NODE_158821_length_308_cov_0.660287	109	157	2	10	48	0.2083333
NODE_158821_length_308_cov_0.660287	109	157	6	16	48	0.3333333
NODE_158821_length_308_cov_0.660287	130	210	0	1	80	0.0125000
NODE_158821_length_308_cov_0.660287	130	210	2	10	80	0.1250000
NODE_158821_length_308_cov_0.660287	130	210	6	69	80	0.8625000
NODE_158905_length_307_cov_30.725962	0	73	0	73	73	1.0000000
NODE_158905_length_307_cov_30.725962	46	99	0	53	53	1.0000000
NODE_158906_length_307_cov_25.096154	84	164	0	1	80	0.0125000
NODE_158906_length_307_cov_25.096154	84	164	2	79	80	0.9875000
NODE_158906_length_307_cov_25.096154	137	217	0	54	80	0.6750000
NODE_158906_length_307_cov_25.096154	137	217	2	26	80	0.3250000
NODE_158933_length_307_cov_5.524038	150	221	0	35	71	0.4929577
NODE_158933_length_307_cov_5.524038	150	221	4	36	71	0.5070422
NODE_158983_length_307_cov_3.730769	172	252	0	80	80	1.0000000
NODE_158983_length_307_cov_3.730769	225	305	0	80	80	1.0000000
NODE_158999_length_307_cov_3.322115	20	100	0	38	80	0.4750000
NODE_158999_length_307_cov_3.322115	20	100	2	42	80	0.5250000
NODE_158999_length_307_cov_3.322115	78	153	0	16	75	0.2133333
NODE_158999_length_307_cov_3.322115	78	153	2	59	75	0.7866667
NODE_159000_length_307_cov_3.317308	12	94	2	25	82	0.3048781
NODE_159000_length_307_cov_3.317308	12	94	4	57	82	0.6951219
NODE_159000_length_307_cov_3.317308	76	134	0	21	58	0.3620690
NODE_159000_length_307_cov_3.317308	76	134	2	5	58	0.0862069
NODE_159000_length_307_cov_3.317308	76	134	4	32	58	0.5517241
NODE_159053_length_307_cov_2.870192	43	108	0	65	65	1.0000000
NODE_159084_length_307_cov_2.653846	117	177	10	20	60	0.3333333
NODE_159084_length_307_cov_2.653846	117	177	12	40	60	0.6666667
NODE_159142_length_307_cov_2.346154	54	105	2	9	51	0.1764706
NODE_159142_length_307_cov_2.346154	54	105	4	42	51	0.8235294
NODE_159351_length_307_cov_1.716346	124	165	0	41	41	1.0000000
NODE_159362_length_307_cov_1.716346	30	93	0	29	63	0.4603175
NODE_159362_length_307_cov_1.716346	30	93	2	34	63	0.5396826
NODE_159407_length_307_cov_1.600962	221	269	2	6	48	0.1250000
NODE_159407_length_307_cov_1.600962	221	269	4	42	48	0.8750000
NODE_159407_length_307_cov_1.600962	242	307	0	11	65	0.1692308
NODE_159407_length_307_cov_1.600962	242	307	2	33	65	0.5076923
NODE_159407_length_307_cov_1.600962	242	307	4	21	65	0.3230769
NODE_159447_length_307_cov_1.475962	252	307	0	55	55	1.0000000
NODE_159585_length_307_cov_1.326923	96	142	4	19	46	0.4130435
NODE_159585_length_307_cov_1.326923	96	142	6	19	46	0.4130435
NODE_159585_length_307_cov_1.326923	96	142	8	8	46	0.1739130
NODE_159585_length_307_cov_1.326923	115	195	4	17	80	0.2125000
NODE_159585_length_307_cov_1.326923	115	195	6	55	80	0.6875000
NODE_159585_length_307_cov_1.326923	115	195	8	8	80	0.1000000
NODE_159618_length_307_cov_1.264423	13	61	2	45	48	0.9375000
NODE_159618_length_307_cov_1.264423	13	61	6	3	48	0.0625000
NODE_159618_length_307_cov_1.264423	23	54	2	31	31	1.0000000
NODE_159696_length_307_cov_1.197115	92	121	0	28	29	0.9655172
NODE_159696_length_307_cov_1.197115	92	121	2	1	29	0.0344828
NODE_159787_length_307_cov_1.000000	132	168	0	36	36	1.0000000
NODE_160213_length_306_cov_74.526570	68	136	4	66	68	0.9705882
NODE_160213_length_306_cov_74.526570	68	136	6	2	68	0.0294118
NODE_160213_length_306_cov_74.526570	68	148	4	76	80	0.9500000
NODE_160213_length_306_cov_74.526570	68	148	6	4	80	0.0500000
NODE_160213_length_306_cov_74.526570	121	201	4	72	80	0.9000000
NODE_160213_length_306_cov_74.526570	121	201	6	8	80	0.1000000
NODE_160213_length_306_cov_74.526570	121	201	4	72	80	0.9000000
NODE_160213_length_306_cov_74.526570	121	201	6	8	80	0.1000000
NODE_160213_length_306_cov_74.526570	197	277	0	39	80	0.4875000
NODE_160213_length_306_cov_74.526570	197	277	2	10	80	0.1250000
NODE_160213_length_306_cov_74.526570	197	277	4	31	80	0.3875000
NODE_160213_length_306_cov_74.526570	197	277	0	39	80	0.4875000
NODE_160213_length_306_cov_74.526570	197	277	2	10	80	0.1250000
NODE_160213_length_306_cov_74.526570	197	277	4	31	80	0.3875000
NODE_160213_length_306_cov_74.526570	197	277	0	39	80	0.4875000
NODE_160213_length_306_cov_74.526570	197	277	2	10	80	0.1250000
NODE_160213_length_306_cov_74.526570	197	277	4	31	80	0.3875000
NODE_160213_length_306_cov_74.526570	250	299	0	49	49	1.0000000
NODE_160213_length_306_cov_74.526570	250	306	0	56	56	1.0000000
NODE_160213_length_306_cov_74.526570	255	306	0	51	51	1.0000000
NODE_160217_length_306_cov_7.396135	23	117	0	94	94	1.0000000
NODE_160217_length_306_cov_7.396135	90	170	0	80	80	1.0000000
NODE_160261_length_306_cov_4.275362	67	147	0	80	80	1.0000000
NODE_160275_length_306_cov_3.937198	104	176	0	16	72	0.2222222
NODE_160275_length_306_cov_3.937198	104	176	2	56	72	0.7777778
NODE_160300_length_306_cov_3.444444	130	206	0	76	76	1.0000000
NODE_160323_length_306_cov_3.217391	198	278	0	3	80	0.0375000
NODE_160323_length_306_cov_3.217391	198	278	2	45	80	0.5625000
NODE_160323_length_306_cov_3.217391	198	278	4	24	80	0.3000000
NODE_160323_length_306_cov_3.217391	198	278	6	8	80	0.1000000
NODE_160333_length_306_cov_3.043478	90	171	0	48	81	0.5925926
NODE_160333_length_306_cov_3.043478	90	171	2	33	81	0.4074074
NODE_160333_length_306_cov_3.043478	144	202	0	35	58	0.6034483
NODE_160333_length_306_cov_3.043478	144	202	2	23	58	0.3965517
NODE_160340_length_306_cov_2.956522	242	273	2	31	31	1.0000000
NODE_160355_length_306_cov_2.884058	173	243	4	16	70	0.2285714
NODE_160355_length_306_cov_2.884058	173	243	6	54	70	0.7714286
NODE_160403_length_306_cov_2.574879	122	203	0	10	81	0.1234568
NODE_160403_length_306_cov_2.574879	122	203	4	7	81	0.0864198
NODE_160403_length_306_cov_2.574879	122	203	6	15	81	0.1851852
NODE_160403_length_306_cov_2.574879	122	203	8	49	81	0.6049383
NODE_160403_length_306_cov_2.574879	176	254	0	61	78	0.7820513
NODE_160403_length_306_cov_2.574879	176	254	4	7	78	0.0897436
NODE_160403_length_306_cov_2.574879	176	254	6	10	78	0.1282051
NODE_160475_length_306_cov_2.265700	223	278	4	55	55	1.0000000
NODE_160512_length_306_cov_2.106280	73	149	0	14	76	0.1842105
NODE_160512_length_306_cov_2.106280	73	149	2	62	76	0.8157895
NODE_160512_length_306_cov_2.106280	125	205	2	80	80	1.0000000
NODE_160608_length_306_cov_1.879227	165	196	4	31	31	1.0000000
NODE_160752_length_306_cov_1.478261	206	237	0	31	31	1.0000000
NODE_160761_length_306_cov_1.478261	157	220	0	63	63	1.0000000
NODE_160833_length_306_cov_1.434783	40	88	0	48	48	1.0000000
NODE_160875_length_306_cov_1.357488	128	171	0	43	43	1.0000000
NODE_160992_length_306_cov_1.222222	216	252	0	36	36	1.0000000
NODE_160992_length_306_cov_1.222222	230	305	0	75	75	1.0000000
NODE_161018_length_306_cov_1.188406	79	159	0	80	80	1.0000000
NODE_161042_length_306_cov_1.130435	122	202	0	10	80	0.1250000
NODE_161042_length_306_cov_1.130435	122	202	2	70	80	0.8750000
NODE_161042_length_306_cov_1.130435	175	255	0	10	80	0.1250000
NODE_161042_length_306_cov_1.130435	175	255	2	70	80	0.8750000
NODE_161078_length_306_cov_1.067633	156	188	0	32	32	1.0000000
NODE_161234_length_306_cov_0.975845	219	247	0	28	28	1.0000000
NODE_161246_length_306_cov_0.956522	206	284	0	38	78	0.4871795
NODE_161246_length_306_cov_0.956522	206	284	2	40	78	0.5128205
NODE_161550_length_305_cov_5.718447	177	243	0	66	66	1.0000000
NODE_161566_length_305_cov_4.854369	55	135	0	15	80	0.1875000
NODE_161566_length_305_cov_4.854369	55	135	2	65	80	0.8125000
NODE_161584_length_305_cov_4.266990	186	266	0	45	80	0.5625000
NODE_161584_length_305_cov_4.266990	186	266	2	8	80	0.1000000
NODE_161584_length_305_cov_4.266990	186	266	4	27	80	0.3375000
NODE_161723_length_305_cov_2.616505	220	263	0	43	43	1.0000000
NODE_161723_length_305_cov_2.616505	236	305	0	69	69	1.0000000
NODE_161726_length_305_cov_2.597087	171	256	50	8	85	0.0941176
NODE_161726_length_305_cov_2.597087	171	256	51	1	85	0.0117647
NODE_161726_length_305_cov_2.597087	171	256	53	1	85	0.0117647
NODE_161726_length_305_cov_2.597087	171	256	55	1	85	0.0117647
NODE_161726_length_305_cov_2.597087	171	256	56	2	85	0.0235294
NODE_161726_length_305_cov_2.597087	171	256	57	2	85	0.0235294
NODE_161726_length_305_cov_2.597087	171	256	59	3	85	0.0352941
NODE_161726_length_305_cov_2.597087	171	256	60	2	85	0.0235294
NODE_161726_length_305_cov_2.597087	171	256	62	2	85	0.0235294
NODE_161726_length_305_cov_2.597087	171	256	66	1	85	0.0117647
NODE_161726_length_305_cov_2.597087	171	256	69	2	85	0.0235294
NODE_161726_length_305_cov_2.597087	171	256	77	1	85	0.0117647
NODE_161726_length_305_cov_2.597087	171	256	80	1	85	0.0117647
NODE_161726_length_305_cov_2.597087	171	256	81	1	85	0.0117647
NODE_161726_length_305_cov_2.597087	171	256	83	1	85	0.0117647
NODE_161726_length_305_cov_2.597087	171	256	87	1	85	0.0117647
NODE_161726_length_305_cov_2.597087	171	256	89	2	85	0.0235294
NODE_161726_length_305_cov_2.597087	171	256	94	1	85	0.0117647
NODE_161726_length_305_cov_2.597087	171	256	98	2	85	0.0235294
NODE_161726_length_305_cov_2.597087	171	256	101	1	85	0.0117647
NODE_161726_length_305_cov_2.597087	171	256	103	1	85	0.0117647
NODE_161726_length_305_cov_2.597087	171	256	104	1	85	0.0117647
NODE_161726_length_305_cov_2.597087	171	256	106	1	85	0.0117647
NODE_161726_length_305_cov_2.597087	171	256	113	1	85	0.0117647
NODE_161726_length_305_cov_2.597087	171	256	115	1	85	0.0117647
NODE_161726_length_305_cov_2.597087	171	256	116	2	85	0.0235294
NODE_161726_length_305_cov_2.597087	171	256	118	2	85	0.0235294
NODE_161726_length_305_cov_2.597087	171	256	120	1	85	0.0117647
NODE_161726_length_305_cov_2.597087	171	256	123	1	85	0.0117647
NODE_161726_length_305_cov_2.597087	171	256	125	1	85	0.0117647
NODE_161726_length_305_cov_2.597087	171	256	130	1	85	0.0117647
NODE_161726_length_305_cov_2.597087	171	256	139	1	85	0.0117647
NODE_161726_length_305_cov_2.597087	171	256	142	1	85	0.0117647
NODE_161726_length_305_cov_2.597087	171	256	144	2	85	0.0235294
NODE_161726_length_305_cov_2.597087	171	256	147	23	85	0.2705882
NODE_161726_length_305_cov_2.597087	171	256	149	9	85	0.1058824
NODE_161732_length_305_cov_2.533981	3	57	0	4	54	0.0740741
NODE_161732_length_305_cov_2.533981	3	57	2	2	54	0.0370370
NODE_161732_length_305_cov_2.533981	3	57	4	48	54	0.8888889
NODE_161775_length_305_cov_2.339806	149	237	12	12	88	0.1363636
NODE_161775_length_305_cov_2.339806	149	237	16	5	88	0.0568182
NODE_161775_length_305_cov_2.339806	149	237	17	1	88	0.0113636
NODE_161775_length_305_cov_2.339806	149	237	18	12	88	0.1363636
NODE_161775_length_305_cov_2.339806	149	237	19	1	88	0.0113636
NODE_161775_length_305_cov_2.339806	149	237	20	2	88	0.0227273
NODE_161775_length_305_cov_2.339806	149	237	22	55	88	0.6250000
NODE_161795_length_305_cov_2.228155	194	274	0	80	80	1.0000000
NODE_161795_length_305_cov_2.228155	247	300	0	53	53	1.0000000
NODE_161877_length_305_cov_1.975728	44	116	2	11	72	0.1527778
NODE_161877_length_305_cov_1.975728	44	116	4	61	72	0.8472222
NODE_161908_length_305_cov_1.883495	135	172	17	4	37	0.1081081
NODE_161908_length_305_cov_1.883495	135	172	19	8	37	0.2162162
NODE_161908_length_305_cov_1.883495	135	172	21	2	37	0.0540541
NODE_161908_length_305_cov_1.883495	135	172	23	1	37	0.0270270
NODE_161908_length_305_cov_1.883495	135	172	25	4	37	0.1081081
NODE_161908_length_305_cov_1.883495	135	172	29	3	37	0.0810811
NODE_161908_length_305_cov_1.883495	135	172	31	10	37	0.2702703
NODE_161908_length_305_cov_1.883495	135	172	33	1	37	0.0270270
NODE_161908_length_305_cov_1.883495	135	172	37	4	37	0.1081081
NODE_161990_length_305_cov_1.674757	14	80	0	41	66	0.6212121
NODE_161990_length_305_cov_1.674757	14	80	1	1	66	0.0151515
NODE_161990_length_305_cov_1.674757	14	80	2	24	66	0.3636364
NODE_161990_length_305_cov_1.674757	53	133	0	2	80	0.0250000
NODE_161990_length_305_cov_1.674757	53	133	1	1	80	0.0125000
NODE_161990_length_305_cov_1.674757	53	133	2	75	80	0.9375000
NODE_161990_length_305_cov_1.674757	53	133	3	2	80	0.0250000
NODE_161996_length_305_cov_1.655340	110	179	8	42	69	0.6086956
NODE_161996_length_305_cov_1.655340	110	179	10	27	69	0.3913043
NODE_162123_length_305_cov_1.466019	153	238	6	7	85	0.0823529
NODE_162123_length_305_cov_1.466019	153	238	8	45	85	0.5294118
NODE_162123_length_305_cov_1.466019	153	238	13	2	85	0.0235294
NODE_162123_length_305_cov_1.466019	153	238	14	13	85	0.1529412
NODE_162123_length_305_cov_1.466019	153	238	18	2	85	0.0235294
NODE_162123_length_305_cov_1.466019	153	238	20	2	85	0.0235294
NODE_162123_length_305_cov_1.466019	153	238	22	2	85	0.0235294
NODE_162123_length_305_cov_1.466019	153	238	24	6	85	0.0705882
NODE_162123_length_305_cov_1.466019	153	238	26	3	85	0.0352941
NODE_162123_length_305_cov_1.466019	153	238	28	2	85	0.0235294
NODE_162123_length_305_cov_1.466019	153	238	30	1	85	0.0117647
NODE_162123_length_305_cov_1.466019	222	284	18	1	62	0.0161290
NODE_162123_length_305_cov_1.466019	222	284	20	1	62	0.0161290
NODE_162123_length_305_cov_1.466019	222	284	22	2	62	0.0322581
NODE_162123_length_305_cov_1.466019	222	284	24	6	62	0.0967742
NODE_162123_length_305_cov_1.466019	222	284	26	3	62	0.0483871
NODE_162123_length_305_cov_1.466019	222	284	28	15	62	0.2419355
NODE_162123_length_305_cov_1.466019	222	284	30	34	62	0.5483871
NODE_162169_length_305_cov_1.398058	28	75	0	47	47	1.0000000
NODE_162198_length_305_cov_1.330097	212	292	2	6	80	0.0750000
NODE_162198_length_305_cov_1.330097	212	292	6	6	80	0.0750000
NODE_162198_length_305_cov_1.330097	212	292	8	4	80	0.0500000
NODE_162198_length_305_cov_1.330097	212	292	10	1	80	0.0125000
NODE_162198_length_305_cov_1.330097	212	292	12	1	80	0.0125000
NODE_162198_length_305_cov_1.330097	212	292	16	5	80	0.0625000
NODE_162198_length_305_cov_1.330097	212	292	18	5	80	0.0625000
NODE_162198_length_305_cov_1.330097	212	292	20	4	80	0.0500000
NODE_162198_length_305_cov_1.330097	212	292	22	4	80	0.0500000
NODE_162198_length_305_cov_1.330097	212	292	24	6	80	0.0750000
NODE_162198_length_305_cov_1.330097	212	292	26	3	80	0.0375000
NODE_162198_length_305_cov_1.330097	212	292	27	1	80	0.0125000
NODE_162198_length_305_cov_1.330097	212	292	28	2	80	0.0250000
NODE_162198_length_305_cov_1.330097	212	292	34	1	80	0.0125000
NODE_162198_length_305_cov_1.330097	212	292	36	1	80	0.0125000
NODE_162198_length_305_cov_1.330097	212	292	42	4	80	0.0500000
NODE_162198_length_305_cov_1.330097	212	292	44	2	80	0.0250000
NODE_162198_length_305_cov_1.330097	212	292	46	1	80	0.0125000
NODE_162198_length_305_cov_1.330097	212	292	48	4	80	0.0500000
NODE_162198_length_305_cov_1.330097	212	292	50	1	80	0.0125000
NODE_162198_length_305_cov_1.330097	212	292	54	1	80	0.0125000
NODE_162198_length_305_cov_1.330097	212	292	56	4	80	0.0500000
NODE_162198_length_305_cov_1.330097	212	292	58	11	80	0.1375000
NODE_162198_length_305_cov_1.330097	212	292	60	2	80	0.0250000
NODE_162198_length_305_cov_1.330097	265	305	0	3	40	0.0750000
NODE_162198_length_305_cov_1.330097	265	305	2	16	40	0.4000000
NODE_162198_length_305_cov_1.330097	265	305	6	6	40	0.1500000
NODE_162198_length_305_cov_1.330097	265	305	8	4	40	0.1000000
NODE_162198_length_305_cov_1.330097	265	305	10	1	40	0.0250000
NODE_162198_length_305_cov_1.330097	265	305	12	1	40	0.0250000
NODE_162198_length_305_cov_1.330097	265	305	16	5	40	0.1250000
NODE_162198_length_305_cov_1.330097	265	305	18	4	40	0.1000000
NODE_162359_length_305_cov_1.111650	245	275	0	30	30	1.0000000
NODE_162411_length_305_cov_0.990291	46	126	0	80	80	1.0000000
NODE_162593_length_305_cov_0.873786	73	109	0	36	36	1.0000000
NODE_162782_length_305_cov_0.631068	86	166	0	80	80	1.0000000
NODE_162782_length_305_cov_0.631068	139	186	0	47	47	1.0000000
NODE_162854_length_304_cov_44.482927	61	102	48	5	41	0.1219512
NODE_162854_length_304_cov_44.482927	61	102	50	18	41	0.4390244
NODE_162854_length_304_cov_44.482927	61	102	51	2	41	0.0487805
NODE_162854_length_304_cov_44.482927	61	102	58	1	41	0.0243902
NODE_162854_length_304_cov_44.482927	61	102	60	3	41	0.0731707
NODE_162854_length_304_cov_44.482927	61	102	62	1	41	0.0243902
NODE_162854_length_304_cov_44.482927	61	102	64	1	41	0.0243902
NODE_162854_length_304_cov_44.482927	61	102	66	2	41	0.0487805
NODE_162854_length_304_cov_44.482927	61	102	68	3	41	0.0731707
NODE_162854_length_304_cov_44.482927	61	102	70	5	41	0.1219512
NODE_162855_length_304_cov_30.678049	205	281	0	76	76	1.0000000
NODE_162855_length_304_cov_30.678049	254	304	0	50	50	1.0000000
NODE_162886_length_304_cov_4.956098	72	152	2	52	80	0.6500000
NODE_162886_length_304_cov_4.956098	72	152	4	28	80	0.3500000
NODE_162919_length_304_cov_3.980488	46	126	0	80	80	1.0000000
NODE_162919_length_304_cov_3.980488	99	179	0	80	80	1.0000000
NODE_162932_length_304_cov_3.809756	108	156	0	24	48	0.5000000
NODE_162932_length_304_cov_3.809756	108	156	2	24	48	0.5000000
NODE_162955_length_304_cov_3.424390	67	129	6	3	62	0.0483871
NODE_162955_length_304_cov_3.424390	67	129	7	55	62	0.8870968
NODE_162955_length_304_cov_3.424390	67	129	11	4	62	0.0645161
NODE_162955_length_304_cov_3.424390	120	182	4	53	62	0.8548387
NODE_162955_length_304_cov_3.424390	120	182	6	3	62	0.0483871
NODE_162955_length_304_cov_3.424390	120	182	7	6	62	0.0967742
NODE_162997_length_304_cov_2.980488	105	126	0	21	21	1.0000000
NODE_163048_length_304_cov_2.629268	106	186	0	4	80	0.0500000
NODE_163048_length_304_cov_2.629268	106	186	2	31	80	0.3875000
NODE_163048_length_304_cov_2.629268	106	186	4	45	80	0.5625000
NODE_163048_length_304_cov_2.629268	159	209	0	1	50	0.0200000
NODE_163048_length_304_cov_2.629268	159	209	2	5	50	0.1000000
NODE_163048_length_304_cov_2.629268	159	209	3	1	50	0.0200000
NODE_163048_length_304_cov_2.629268	159	209	4	43	50	0.8600000
NODE_163116_length_304_cov_2.239024	57	137	4	80	80	1.0000000
NODE_163116_length_304_cov_2.239024	110	152	4	42	42	1.0000000
NODE_163148_length_304_cov_2.170732	112	145	0	2	33	0.0606061
NODE_163148_length_304_cov_2.170732	112	145	2	31	33	0.9393939
NODE_163148_length_304_cov_2.170732	146	198	2	52	52	1.0000000
NODE_163333_length_304_cov_1.687805	219	288	2	69	69	1.0000000
NODE_163432_length_304_cov_1.492683	190	238	0	48	48	1.0000000
NODE_163559_length_304_cov_1.287805	99	165	4	32	66	0.4848485
NODE_163559_length_304_cov_1.287805	99	165	6	6	66	0.0909091
NODE_163559_length_304_cov_1.287805	99	165	8	7	66	0.1060606
NODE_163559_length_304_cov_1.287805	99	165	10	21	66	0.3181818
NODE_163670_length_304_cov_1.175610	0	30	0	30	30	1.0000000
NODE_163895_length_304_cov_0.951220	70	150	8	19	80	0.2375000
NODE_163895_length_304_cov_0.951220	70	150	10	10	80	0.1250000
NODE_163895_length_304_cov_0.951220	70	150	12	42	80	0.5250000
NODE_163895_length_304_cov_0.951220	70	150	14	5	80	0.0625000
NODE_163895_length_304_cov_0.951220	70	150	16	4	80	0.0500000
NODE_164171_length_303_cov_30.843137	46	97	0	51	51	1.0000000
NODE_164194_length_303_cov_5.401961	33	79	2	46	46	1.0000000
NODE_164224_length_303_cov_4.210784	136	205	4	6	69	0.0869565
NODE_164224_length_303_cov_4.210784	136	205	6	7	69	0.1014493
NODE_164224_length_303_cov_4.210784	136	205	8	2	69	0.0289855
NODE_164224_length_303_cov_4.210784	136	205	10	1	69	0.0144928
NODE_164224_length_303_cov_4.210784	136	205	12	17	69	0.2463768
NODE_164224_length_303_cov_4.210784	136	205	14	36	69	0.5217391
NODE_164224_length_303_cov_4.210784	178	259	0	50	81	0.6172839
NODE_164224_length_303_cov_4.210784	178	259	4	10	81	0.1234568
NODE_164224_length_303_cov_4.210784	178	259	6	7	81	0.0864198
NODE_164224_length_303_cov_4.210784	178	259	8	2	81	0.0246914
NODE_164224_length_303_cov_4.210784	178	259	10	1	81	0.0123457
NODE_164224_length_303_cov_4.210784	178	259	12	11	81	0.1358025
NODE_164251_length_303_cov_3.671569	9	75	2	27	66	0.4090909
NODE_164251_length_303_cov_3.671569	9	75	4	39	66	0.5909091
NODE_164251_length_303_cov_3.671569	48	128	0	8	80	0.1000000
NODE_164251_length_303_cov_3.671569	48	128	2	20	80	0.2500000
NODE_164251_length_303_cov_3.671569	48	128	4	52	80	0.6500000
NODE_164251_length_303_cov_3.671569	48	128	0	8	80	0.1000000
NODE_164251_length_303_cov_3.671569	48	128	2	20	80	0.2500000
NODE_164251_length_303_cov_3.671569	48	128	4	52	80	0.6500000
NODE_164251_length_303_cov_3.671569	220	300	0	1	80	0.0125000
NODE_164251_length_303_cov_3.671569	220	300	4	37	80	0.4625000
NODE_164251_length_303_cov_3.671569	220	300	6	42	80	0.5250000
NODE_164267_length_303_cov_3.500000	55	123	0	14	68	0.2058824
NODE_164267_length_303_cov_3.500000	55	123	2	26	68	0.3823529
NODE_164267_length_303_cov_3.500000	55	123	4	28	68	0.4117647
NODE_164272_length_303_cov_3.460784	0	67	0	7	67	0.1044776
NODE_164272_length_303_cov_3.460784	0	67	2	1	67	0.0149254
NODE_164272_length_303_cov_3.460784	0	67	6	1	67	0.0149254
NODE_164272_length_303_cov_3.460784	0	67	7	2	67	0.0298507
NODE_164272_length_303_cov_3.460784	0	67	8	11	67	0.1641791
NODE_164272_length_303_cov_3.460784	0	67	10	4	67	0.0597015
NODE_164272_length_303_cov_3.460784	0	67	12	3	67	0.0447761
NODE_164272_length_303_cov_3.460784	0	67	14	1	67	0.0149254
NODE_164272_length_303_cov_3.460784	0	67	16	1	67	0.0149254
NODE_164272_length_303_cov_3.460784	0	67	18	1	67	0.0149254
NODE_164272_length_303_cov_3.460784	0	67	27	1	67	0.0149254
NODE_164272_length_303_cov_3.460784	0	67	32	4	67	0.0597015
NODE_164272_length_303_cov_3.460784	0	67	41	1	67	0.0149254
NODE_164272_length_303_cov_3.460784	0	67	50	1	67	0.0149254
NODE_164272_length_303_cov_3.460784	0	67	53	5	67	0.0746269
NODE_164272_length_303_cov_3.460784	0	67	55	1	67	0.0149254
NODE_164272_length_303_cov_3.460784	0	67	57	1	67	0.0149254
NODE_164272_length_303_cov_3.460784	0	67	59	3	67	0.0447761
NODE_164272_length_303_cov_3.460784	0	67	63	5	67	0.0746269
NODE_164272_length_303_cov_3.460784	0	67	65	1	67	0.0149254
NODE_164272_length_303_cov_3.460784	0	67	67	1	67	0.0149254
NODE_164272_length_303_cov_3.460784	0	67	69	7	67	0.1044776
NODE_164272_length_303_cov_3.460784	0	67	70	2	67	0.0298507
NODE_164272_length_303_cov_3.460784	0	67	71	2	67	0.0298507
NODE_164272_length_303_cov_3.460784	98	178	131	2	80	0.0250000
NODE_164272_length_303_cov_3.460784	98	178	132	1	80	0.0125000
NODE_164272_length_303_cov_3.460784	98	178	136	1	80	0.0125000
NODE_164272_length_303_cov_3.460784	98	178	138	1	80	0.0125000
NODE_164272_length_303_cov_3.460784	98	178	144	4	80	0.0500000
NODE_164272_length_303_cov_3.460784	98	178	148	4	80	0.0500000
NODE_164272_length_303_cov_3.460784	98	178	150	2	80	0.0250000
NODE_164272_length_303_cov_3.460784	98	178	152	3	80	0.0375000
NODE_164272_length_303_cov_3.460784	98	178	154	2	80	0.0250000
NODE_164272_length_303_cov_3.460784	98	178	156	3	80	0.0375000
NODE_164272_length_303_cov_3.460784	98	178	157	1	80	0.0125000
NODE_164272_length_303_cov_3.460784	98	178	158	1	80	0.0125000
NODE_164272_length_303_cov_3.460784	98	178	159	3	80	0.0375000
NODE_164272_length_303_cov_3.460784	98	178	160	6	80	0.0750000
NODE_164272_length_303_cov_3.460784	98	178	161	2	80	0.0250000
NODE_164272_length_303_cov_3.460784	98	178	162	8	80	0.1000000
NODE_164272_length_303_cov_3.460784	98	178	163	1	80	0.0125000
NODE_164272_length_303_cov_3.460784	98	178	164	2	80	0.0250000
NODE_164272_length_303_cov_3.460784	98	178	166	4	80	0.0500000
NODE_164272_length_303_cov_3.460784	98	178	167	1	80	0.0125000
NODE_164272_length_303_cov_3.460784	98	178	168	2	80	0.0250000
NODE_164272_length_303_cov_3.460784	98	178	169	4	80	0.0500000
NODE_164272_length_303_cov_3.460784	98	178	171	8	80	0.1000000
NODE_164272_length_303_cov_3.460784	98	178	172	3	80	0.0375000
NODE_164272_length_303_cov_3.460784	98	178	173	2	80	0.0250000
NODE_164272_length_303_cov_3.460784	98	178	174	2	80	0.0250000
NODE_164272_length_303_cov_3.460784	98	178	175	3	80	0.0375000
NODE_164272_length_303_cov_3.460784	98	178	177	1	80	0.0125000
NODE_164272_length_303_cov_3.460784	98	178	178	1	80	0.0125000
NODE_164272_length_303_cov_3.460784	98	178	179	2	80	0.0250000
NODE_164272_length_303_cov_3.460784	151	191	152	2	40	0.0500000
NODE_164272_length_303_cov_3.460784	151	191	154	1	40	0.0250000
NODE_164272_length_303_cov_3.460784	151	191	157	1	40	0.0250000
NODE_164272_length_303_cov_3.460784	151	191	158	1	40	0.0250000
NODE_164272_length_303_cov_3.460784	151	191	159	2	40	0.0500000
NODE_164272_length_303_cov_3.460784	151	191	160	6	40	0.1500000
NODE_164272_length_303_cov_3.460784	151	191	161	1	40	0.0250000
NODE_164272_length_303_cov_3.460784	151	191	162	6	40	0.1500000
NODE_164272_length_303_cov_3.460784	151	191	163	1	40	0.0250000
NODE_164272_length_303_cov_3.460784	151	191	164	2	40	0.0500000
NODE_164272_length_303_cov_3.460784	151	191	166	6	40	0.1500000
NODE_164272_length_303_cov_3.460784	151	191	168	3	40	0.0750000
NODE_164272_length_303_cov_3.460784	151	191	169	5	40	0.1250000
NODE_164272_length_303_cov_3.460784	151	191	172	3	40	0.0750000
NODE_164283_length_303_cov_3.352941	77	146	0	69	69	1.0000000
NODE_164433_length_303_cov_2.284314	78	158	0	3	80	0.0375000
NODE_164433_length_303_cov_2.284314	78	158	2	77	80	0.9625000
NODE_164433_length_303_cov_2.284314	215	295	0	80	80	1.0000000
NODE_164581_length_303_cov_1.848039	90	170	0	80	80	1.0000000
NODE_164581_length_303_cov_1.848039	143	223	0	80	80	1.0000000
NODE_164581_length_303_cov_1.848039	212	235	0	23	23	1.0000000
NODE_164668_length_303_cov_1.686275	62	88	0	26	26	1.0000000
NODE_164695_length_303_cov_1.583333	206	270	0	64	64	1.0000000
NODE_164800_length_303_cov_1.475490	155	221	0	66	66	1.0000000
NODE_164846_length_303_cov_1.392157	135	213	10	2	78	0.0256410
NODE_164846_length_303_cov_1.392157	135	213	12	76	78	0.9743590
NODE_164878_length_303_cov_1.318627	0	75	0	75	75	1.0000000
NODE_164974_length_303_cov_1.215686	278	297	0	19	19	1.0000000
NODE_165498_length_302_cov_10.852217	266	300	0	34	34	1.0000000
NODE_165502_length_302_cov_7.896552	46	131	0	85	85	1.0000000
NODE_165502_length_302_cov_7.896552	104	160	0	56	56	1.0000000
NODE_165505_length_302_cov_7.266010	135	191	0	56	56	1.0000000
NODE_165507_length_302_cov_7.216749	93	149	0	1	56	0.0178571
NODE_165507_length_302_cov_7.216749	93	149	2	55	56	0.9821429
NODE_165507_length_302_cov_7.216749	155	226	0	71	71	1.0000000
NODE_165517_length_302_cov_6.172414	179	243	0	64	64	1.0000000
NODE_165517_length_302_cov_6.172414	232	287	0	55	55	1.0000000
NODE_165528_length_302_cov_5.586207	221	293	0	29	72	0.4027778
NODE_165528_length_302_cov_5.586207	221	293	2	1	72	0.0138889
NODE_165528_length_302_cov_5.586207	221	293	4	10	72	0.1388889
NODE_165528_length_302_cov_5.586207	221	293	6	7	72	0.0972222
NODE_165528_length_302_cov_5.586207	221	293	8	4	72	0.0555556
NODE_165528_length_302_cov_5.586207	221	293	14	5	72	0.0694444
NODE_165528_length_302_cov_5.586207	221	293	16	16	72	0.2222222
NODE_165641_length_302_cov_2.985222	104	186	2	8	82	0.0975610
NODE_165641_length_302_cov_2.985222	104	186	3	4	82	0.0487805
NODE_165641_length_302_cov_2.985222	104	186	4	2	82	0.0243902
NODE_165641_length_302_cov_2.985222	104	186	6	5	82	0.0609756
NODE_165641_length_302_cov_2.985222	104	186	10	1	82	0.0121951
NODE_165641_length_302_cov_2.985222	104	186	12	2	82	0.0243902
NODE_165641_length_302_cov_2.985222	104	186	14	10	82	0.1219512
NODE_165641_length_302_cov_2.985222	104	186	16	6	82	0.0731707
NODE_165641_length_302_cov_2.985222	104	186	18	1	82	0.0121951
NODE_165641_length_302_cov_2.985222	104	186	20	24	82	0.2926829
NODE_165641_length_302_cov_2.985222	104	186	22	19	82	0.2317073
NODE_165848_length_302_cov_2.009852	12	34	0	22	22	1.0000000
NODE_165934_length_302_cov_1.758621	98	152	0	54	54	1.0000000
NODE_165945_length_302_cov_1.758621	230	294	0	64	64	1.0000000
NODE_166007_length_302_cov_1.620690	172	232	0	58	60	0.9666666
NODE_166007_length_302_cov_1.620690	172	232	2	2	60	0.0333333
NODE_166007_length_302_cov_1.620690	225	277	0	52	52	1.0000000
NODE_166320_length_302_cov_1.172414	34	103	0	69	69	1.0000000
NODE_166381_length_302_cov_1.044335	54	130	0	12	76	0.1578947
NODE_166381_length_302_cov_1.044335	54	130	2	6	76	0.0789474
NODE_166381_length_302_cov_1.044335	54	130	4	6	76	0.0789474
NODE_166381_length_302_cov_1.044335	54	130	6	14	76	0.1842105
NODE_166381_length_302_cov_1.044335	54	130	8	21	76	0.2763158
NODE_166381_length_302_cov_1.044335	54	130	10	17	76	0.2236842
NODE_166617_length_302_cov_0.847291	94	172	4	3	78	0.0384615
NODE_166617_length_302_cov_0.847291	94	172	6	3	78	0.0384615
NODE_166617_length_302_cov_0.847291	94	172	8	9	78	0.1153846
NODE_166617_length_302_cov_0.847291	94	172	10	1	78	0.0128205
NODE_166617_length_302_cov_0.847291	94	172	12	15	78	0.1923077
NODE_166617_length_302_cov_0.847291	94	172	14	13	78	0.1666667
NODE_166617_length_302_cov_0.847291	94	172	16	3	78	0.0384615
NODE_166617_length_302_cov_0.847291	94	172	18	12	78	0.1538462
NODE_166617_length_302_cov_0.847291	94	172	30	11	78	0.1410256
NODE_166617_length_302_cov_0.847291	94	172	34	8	78	0.1025641
NODE_166617_length_302_cov_0.847291	94	172	4	3	78	0.0384615
NODE_166617_length_302_cov_0.847291	94	172	6	3	78	0.0384615
NODE_166617_length_302_cov_0.847291	94	172	8	9	78	0.1153846
NODE_166617_length_302_cov_0.847291	94	172	10	1	78	0.0128205
NODE_166617_length_302_cov_0.847291	94	172	12	15	78	0.1923077
NODE_166617_length_302_cov_0.847291	94	172	14	13	78	0.1666667
NODE_166617_length_302_cov_0.847291	94	172	16	3	78	0.0384615
NODE_166617_length_302_cov_0.847291	94	172	18	12	78	0.1538462
NODE_166617_length_302_cov_0.847291	94	172	30	11	78	0.1410256
NODE_166617_length_302_cov_0.847291	94	172	34	8	78	0.1025641
NODE_166617_length_302_cov_0.847291	103	172	8	6	69	0.0869565
NODE_166617_length_302_cov_0.847291	103	172	10	1	69	0.0144928
NODE_166617_length_302_cov_0.847291	103	172	12	15	69	0.2173913
NODE_166617_length_302_cov_0.847291	103	172	14	13	69	0.1884058
NODE_166617_length_302_cov_0.847291	103	172	16	3	69	0.0434783
NODE_166617_length_302_cov_0.847291	103	172	18	12	69	0.1739130
NODE_166617_length_302_cov_0.847291	103	172	30	11	69	0.1594203
NODE_166617_length_302_cov_0.847291	103	172	34	8	69	0.1159420
NODE_166638_length_302_cov_0.807882	97	177	0	80	80	1.0000000
NODE_166819_length_301_cov_6.960396	268	299	0	31	31	1.0000000
NODE_166827_length_301_cov_6.148515	214	283	0	68	69	0.9855072
NODE_166827_length_301_cov_6.148515	214	283	2	1	69	0.0144928
NODE_166889_length_301_cov_3.747525	116	196	4	80	80	1.0000000
NODE_166904_length_301_cov_3.509901	217	277	0	12	60	0.2000000
NODE_166904_length_301_cov_3.509901	217	277	2	1	60	0.0166667
NODE_166904_length_301_cov_3.509901	217	277	3	1	60	0.0166667
NODE_166904_length_301_cov_3.509901	217	277	6	6	60	0.1000000
NODE_166904_length_301_cov_3.509901	217	277	10	2	60	0.0333333
NODE_166904_length_301_cov_3.509901	217	277	14	1	60	0.0166667
NODE_166904_length_301_cov_3.509901	217	277	16	2	60	0.0333333
NODE_166904_length_301_cov_3.509901	217	277	18	9	60	0.1500000
NODE_166904_length_301_cov_3.509901	217	277	20	3	60	0.0500000
NODE_166904_length_301_cov_3.509901	217	277	24	6	60	0.1000000
NODE_166904_length_301_cov_3.509901	217	277	30	2	60	0.0333333
NODE_166904_length_301_cov_3.509901	217	277	32	3	60	0.0500000
NODE_166904_length_301_cov_3.509901	217	277	36	4	60	0.0666667
NODE_166904_length_301_cov_3.509901	217	277	37	1	60	0.0166667
NODE_166904_length_301_cov_3.509901	217	277	38	1	60	0.0166667
NODE_166904_length_301_cov_3.509901	217	277	40	2	60	0.0333333
NODE_166904_length_301_cov_3.509901	217	277	42	1	60	0.0166667
NODE_166904_length_301_cov_3.509901	217	277	46	1	60	0.0166667
NODE_166904_length_301_cov_3.509901	217	277	48	2	60	0.0333333
NODE_166993_length_301_cov_2.653465	133	213	2	46	80	0.5750000
NODE_166993_length_301_cov_2.653465	133	213	4	13	80	0.1625000
NODE_166993_length_301_cov_2.653465	133	213	6	1	80	0.0125000
NODE_166993_length_301_cov_2.653465	133	213	8	20	80	0.2500000
NODE_167126_length_301_cov_2.084158	178	258	20	4	80	0.0500000
NODE_167126_length_301_cov_2.084158	178	258	22	1	80	0.0125000
NODE_167126_length_301_cov_2.084158	178	258	24	5	80	0.0625000
NODE_167126_length_301_cov_2.084158	178	258	26	1	80	0.0125000
NODE_167126_length_301_cov_2.084158	178	258	28	1	80	0.0125000
NODE_167126_length_301_cov_2.084158	178	258	30	1	80	0.0125000
NODE_167126_length_301_cov_2.084158	178	258	32	4	80	0.0500000
NODE_167126_length_301_cov_2.084158	178	258	34	1	80	0.0125000
NODE_167126_length_301_cov_2.084158	178	258	36	1	80	0.0125000
NODE_167126_length_301_cov_2.084158	178	258	38	3	80	0.0375000
NODE_167126_length_301_cov_2.084158	178	258	40	2	80	0.0250000
NODE_167126_length_301_cov_2.084158	178	258	42	4	80	0.0500000
NODE_167126_length_301_cov_2.084158	178	258	44	7	80	0.0875000
NODE_167126_length_301_cov_2.084158	178	258	46	10	80	0.1250000
NODE_167126_length_301_cov_2.084158	178	258	48	22	80	0.2750000
NODE_167126_length_301_cov_2.084158	178	258	50	13	80	0.1625000
NODE_167215_length_301_cov_1.831683	111	175	0	63	64	0.9843750
NODE_167215_length_301_cov_1.831683	111	175	2	1	64	0.0156250
NODE_167215_length_301_cov_1.831683	164	228	0	64	64	1.0000000
NODE_167308_length_301_cov_1.603960	173	233	2	60	60	1.0000000
NODE_167313_length_301_cov_1.584158	30	108	0	36	78	0.4615385
NODE_167313_length_301_cov_1.584158	30	108	2	42	78	0.5384616
NODE_167434_length_301_cov_1.470297	90	165	0	75	75	1.0000000
NODE_167508_length_301_cov_1.326733	175	247	6	4	72	0.0555556
NODE_167508_length_301_cov_1.326733	175	247	8	68	72	0.9444444
NODE_167612_length_301_cov_1.247525	29	73	0	44	44	1.0000000
NODE_167642_length_301_cov_1.183168	123	203	2	5	80	0.0625000
NODE_167642_length_301_cov_1.183168	123	203	4	20	80	0.2500000
NODE_167642_length_301_cov_1.183168	123	203	8	5	80	0.0625000
NODE_167642_length_301_cov_1.183168	123	203	10	2	80	0.0250000
NODE_167642_length_301_cov_1.183168	123	203	12	1	80	0.0125000
NODE_167642_length_301_cov_1.183168	123	203	14	4	80	0.0500000
NODE_167642_length_301_cov_1.183168	123	203	16	13	80	0.1625000
NODE_167642_length_301_cov_1.183168	123	203	18	2	80	0.0250000
NODE_167642_length_301_cov_1.183168	123	203	20	1	80	0.0125000
NODE_167642_length_301_cov_1.183168	123	203	22	3	80	0.0375000
NODE_167642_length_301_cov_1.183168	123	203	24	24	80	0.3000000
NODE_167659_length_301_cov_1.163366	10	83	0	73	73	1.0000000
NODE_167659_length_301_cov_1.163366	91	121	0	30	30	1.0000000
NODE_167668_length_301_cov_1.148515	161	209	0	48	48	1.0000000
NODE_167880_length_301_cov_0.980198	242	297	0	55	55	1.0000000
NODE_167891_length_301_cov_0.960396	22	63	0	41	41	1.0000000
NODE_168253_length_300_cov_3.402985	44	124	0	80	80	1.0000000
NODE_168253_length_300_cov_3.402985	97	177	0	80	80	1.0000000
NODE_168253_length_300_cov_3.402985	173	254	0	9	81	0.1111111
NODE_168253_length_300_cov_3.402985	173	254	2	26	81	0.3209876
NODE_168253_length_300_cov_3.402985	173	254	4	3	81	0.0370370
NODE_168253_length_300_cov_3.402985	173	254	6	2	81	0.0246914
NODE_168253_length_300_cov_3.402985	173	254	8	6	81	0.0740741
NODE_168253_length_300_cov_3.402985	173	254	10	35	81	0.4320988
NODE_168253_length_300_cov_3.402985	233	300	0	3	67	0.0447761
NODE_168253_length_300_cov_3.402985	233	300	2	1	67	0.0149254
NODE_168253_length_300_cov_3.402985	233	300	4	5	67	0.0746269
NODE_168253_length_300_cov_3.402985	233	300	6	2	67	0.0298507
NODE_168253_length_300_cov_3.402985	233	300	10	56	67	0.8358209
NODE_168265_length_300_cov_3.298507	18	98	0	80	80	1.0000000
NODE_168360_length_300_cov_2.597015	110	182	2	72	72	1.0000000
NODE_168363_length_300_cov_2.572139	28	102	0	18	74	0.2432432
NODE_168363_length_300_cov_2.572139	28	102	2	45	74	0.6081081
NODE_168363_length_300_cov_2.572139	28	102	6	5	74	0.0675676
NODE_168363_length_300_cov_2.572139	28	102	8	5	74	0.0675676
NODE_168363_length_300_cov_2.572139	28	102	10	1	74	0.0135135
NODE_168363_length_300_cov_2.572139	75	141	0	11	66	0.1666667
NODE_168363_length_300_cov_2.572139	75	141	2	5	66	0.0757576
NODE_168363_length_300_cov_2.572139	75	141	6	5	66	0.0757576
NODE_168363_length_300_cov_2.572139	75	141	8	5	66	0.0757576
NODE_168363_length_300_cov_2.572139	75	141	10	2	66	0.0303030
NODE_168363_length_300_cov_2.572139	75	141	12	3	66	0.0454545
NODE_168363_length_300_cov_2.572139	75	141	14	1	66	0.0151515
NODE_168363_length_300_cov_2.572139	75	141	16	34	66	0.5151515
NODE_168402_length_300_cov_2.417910	0	44	0	44	44	1.0000000
NODE_168459_length_300_cov_2.174129	117	197	2	3	80	0.0375000
NODE_168459_length_300_cov_2.174129	117	197	4	16	80	0.2000000
NODE_168459_length_300_cov_2.174129	117	197	6	3	80	0.0375000
NODE_168459_length_300_cov_2.174129	117	197	8	13	80	0.1625000
NODE_168459_length_300_cov_2.174129	117	197	10	14	80	0.1750000
NODE_168459_length_300_cov_2.174129	117	197	12	11	80	0.1375000
NODE_168459_length_300_cov_2.174129	117	197	14	20	80	0.2500000
NODE_168459_length_300_cov_2.174129	170	250	12	19	80	0.2375000
NODE_168459_length_300_cov_2.174129	170	250	14	22	80	0.2750000
NODE_168459_length_300_cov_2.174129	170	250	16	2	80	0.0250000
NODE_168459_length_300_cov_2.174129	170	250	20	5	80	0.0625000
NODE_168459_length_300_cov_2.174129	170	250	22	1	80	0.0125000
NODE_168459_length_300_cov_2.174129	170	250	24	1	80	0.0125000
NODE_168459_length_300_cov_2.174129	170	250	26	1	80	0.0125000
NODE_168459_length_300_cov_2.174129	170	250	32	1	80	0.0125000
NODE_168459_length_300_cov_2.174129	170	250	40	4	80	0.0500000
NODE_168459_length_300_cov_2.174129	170	250	42	12	80	0.1500000
NODE_168459_length_300_cov_2.174129	170	250	44	12	80	0.1500000
NODE_168459_length_300_cov_2.174129	216	296	20	3	80	0.0375000
NODE_168459_length_300_cov_2.174129	216	296	22	1	80	0.0125000
NODE_168459_length_300_cov_2.174129	216	296	24	1	80	0.0125000
NODE_168459_length_300_cov_2.174129	216	296	25	1	80	0.0125000
NODE_168459_length_300_cov_2.174129	216	296	26	3	80	0.0375000
NODE_168459_length_300_cov_2.174129	216	296	28	4	80	0.0500000
NODE_168459_length_300_cov_2.174129	216	296	30	1	80	0.0125000
NODE_168459_length_300_cov_2.174129	216	296	32	1	80	0.0125000
NODE_168459_length_300_cov_2.174129	216	296	34	2	80	0.0250000
NODE_168459_length_300_cov_2.174129	216	296	36	5	80	0.0625000
NODE_168459_length_300_cov_2.174129	216	296	38	5	80	0.0625000
NODE_168459_length_300_cov_2.174129	216	296	39	1	80	0.0125000
NODE_168459_length_300_cov_2.174129	216	296	40	28	80	0.3500000
NODE_168459_length_300_cov_2.174129	216	296	42	12	80	0.1500000
NODE_168459_length_300_cov_2.174129	216	296	44	12	80	0.1500000
NODE_168462_length_300_cov_2.164179	122	141	2	19	19	1.0000000
NODE_168479_length_300_cov_2.079602	127	207	0	80	80	1.0000000
NODE_168479_length_300_cov_2.079602	203	273	0	13	70	0.1857143
NODE_168479_length_300_cov_2.079602	203	273	2	57	70	0.8142857
NODE_168541_length_300_cov_1.965174	15	86	0	71	71	1.0000000
NODE_168656_length_300_cov_1.731343	31	88	0	4	57	0.0701754
NODE_168656_length_300_cov_1.731343	31	88	1	1	57	0.0175439
NODE_168656_length_300_cov_1.731343	31	88	2	52	57	0.9122807
NODE_168906_length_300_cov_1.268657	62	98	0	36	36	1.0000000
NODE_168906_length_300_cov_1.268657	151	186	0	35	35	1.0000000
NODE_169014_length_300_cov_1.104478	86	165	8	2	79	0.0253165
NODE_169014_length_300_cov_1.104478	86	165	10	10	79	0.1265823
NODE_169014_length_300_cov_1.104478	86	165	12	67	79	0.8481013
NODE_169053_length_300_cov_1.029851	110	177	0	11	67	0.1641791
NODE_169053_length_300_cov_1.029851	110	177	2	4	67	0.0597015
NODE_169053_length_300_cov_1.029851	110	177	6	10	67	0.1492537
NODE_169053_length_300_cov_1.029851	110	177	8	1	67	0.0149254
NODE_169053_length_300_cov_1.029851	110	177	10	8	67	0.1194030
NODE_169053_length_300_cov_1.029851	110	177	14	20	67	0.2985075
NODE_169053_length_300_cov_1.029851	110	177	16	13	67	0.1940299
NODE_169053_length_300_cov_1.029851	120	177	0	11	57	0.1929825
NODE_169053_length_300_cov_1.029851	120	177	2	4	57	0.0701754
NODE_169053_length_300_cov_1.029851	120	177	6	10	57	0.1754386
NODE_169053_length_300_cov_1.029851	120	177	8	1	57	0.0175439
NODE_169053_length_300_cov_1.029851	120	177	10	8	57	0.1403509
NODE_169053_length_300_cov_1.029851	120	177	14	17	57	0.2982456
NODE_169053_length_300_cov_1.029851	120	177	16	6	57	0.1052632
NODE_169378_length_300_cov_0.716418	191	210	0	19	19	1.0000000
NODE_169528_length_299_cov_4.435000	48	128	6	41	80	0.5125000
NODE_169528_length_299_cov_4.435000	48	128	8	7	80	0.0875000
NODE_169528_length_299_cov_4.435000	48	128	10	32	80	0.4000000
NODE_169528_length_299_cov_4.435000	101	167	0	8	66	0.1212121
NODE_169528_length_299_cov_4.435000	101	167	2	4	66	0.0606061
NODE_169528_length_299_cov_4.435000	101	167	6	43	66	0.6515151
NODE_169528_length_299_cov_4.435000	101	167	8	7	66	0.1060606
NODE_169528_length_299_cov_4.435000	101	167	10	4	66	0.0606061
NODE_169567_length_299_cov_3.780000	114	181	0	67	67	1.0000000
NODE_169631_length_299_cov_3.095000	0	73	0	73	73	1.0000000
NODE_169631_length_299_cov_3.095000	0	20	0	20	20	1.0000000
NODE_169725_length_299_cov_2.495000	46	126	0	80	80	1.0000000
NODE_169725_length_299_cov_2.495000	99	179	0	80	80	1.0000000
NODE_169769_length_299_cov_2.275000	127	192	0	63	65	0.9692308
NODE_169769_length_299_cov_2.275000	127	192	2	2	65	0.0307692
NODE_169781_length_299_cov_2.250000	72	135	2	9	63	0.1428571
NODE_169781_length_299_cov_2.250000	72	135	4	54	63	0.8571429
NODE_169781_length_299_cov_2.250000	108	188	2	11	80	0.1375000
NODE_169781_length_299_cov_2.250000	108	188	4	69	80	0.8625000
NODE_169811_length_299_cov_2.090000	25	105	0	80	80	1.0000000
NODE_169888_length_299_cov_1.955000	173	214	4	2	41	0.0487805
NODE_169888_length_299_cov_1.955000	173	214	6	1	41	0.0243902
NODE_169888_length_299_cov_1.955000	173	214	8	3	41	0.0731707
NODE_169888_length_299_cov_1.955000	173	214	10	6	41	0.1463415
NODE_169888_length_299_cov_1.955000	173	214	12	4	41	0.0975610
NODE_169888_length_299_cov_1.955000	173	214	14	6	41	0.1463415
NODE_169888_length_299_cov_1.955000	173	214	18	5	41	0.1219512
NODE_169888_length_299_cov_1.955000	173	214	20	2	41	0.0487805
NODE_169888_length_299_cov_1.955000	173	214	22	5	41	0.1219512
NODE_169888_length_299_cov_1.955000	173	214	24	1	41	0.0243902
NODE_169888_length_299_cov_1.955000	173	214	26	6	41	0.1463415
NODE_169888_length_299_cov_1.955000	187	227	12	2	40	0.0500000
NODE_169888_length_299_cov_1.955000	187	227	14	6	40	0.1500000
NODE_169888_length_299_cov_1.955000	187	227	18	5	40	0.1250000
NODE_169888_length_299_cov_1.955000	187	227	20	2	40	0.0500000
NODE_169888_length_299_cov_1.955000	187	227	22	10	40	0.2500000
NODE_169888_length_299_cov_1.955000	187	227	24	1	40	0.0250000
NODE_169888_length_299_cov_1.955000	187	227	26	14	40	0.3500000
NODE_169916_length_299_cov_1.885000	29	109	0	1	80	0.0125000
NODE_169916_length_299_cov_1.885000	29	109	2	54	80	0.6750000
NODE_169916_length_299_cov_1.885000	29	109	4	14	80	0.1750000
NODE_169916_length_299_cov_1.885000	29	109	6	11	80	0.1375000
NODE_169920_length_299_cov_1.880000	204	236	0	32	32	1.0000000
NODE_169938_length_299_cov_1.840000	154	190	0	36	36	1.0000000
NODE_169995_length_299_cov_1.710000	211	291	0	80	80	1.0000000
NODE_170048_length_299_cov_1.550000	174	205	0	31	31	1.0000000
NODE_170501_length_299_cov_1.020000	42	115	0	73	73	1.0000000
NODE_170546_length_299_cov_1.020000	132	175	2	43	43	1.0000000
NODE_170620_length_299_cov_0.935000	173	216	2	43	43	1.0000000
NODE_170691_length_299_cov_0.765000	86	128	0	42	42	1.0000000
NODE_170887_length_298_cov_20.894472	70	150	0	28	80	0.3500000
NODE_170887_length_298_cov_20.894472	70	150	4	52	80	0.6500000
NODE_170887_length_298_cov_20.894472	123	203	4	80	80	1.0000000
NODE_170888_length_298_cov_13.859296	228	298	2	19	70	0.2714286
NODE_170888_length_298_cov_13.859296	228	298	4	14	70	0.2000000
NODE_170888_length_298_cov_13.859296	228	298	6	3	70	0.0428571
NODE_170888_length_298_cov_13.859296	228	298	10	5	70	0.0714286
NODE_170888_length_298_cov_13.859296	228	298	16	8	70	0.1142857
NODE_170888_length_298_cov_13.859296	228	298	18	21	70	0.3000000
NODE_170909_length_298_cov_5.859296	1	65	4	1	64	0.0156250
NODE_170909_length_298_cov_5.859296	1	65	8	1	64	0.0156250
NODE_170909_length_298_cov_5.859296	1	65	10	1	64	0.0156250
NODE_170909_length_298_cov_5.859296	1	65	12	61	64	0.9531250
NODE_170909_length_298_cov_5.859296	38	118	0	7	80	0.0875000
NODE_170909_length_298_cov_5.859296	38	118	2	20	80	0.2500000
NODE_170909_length_298_cov_5.859296	38	118	4	5	80	0.0625000
NODE_170909_length_298_cov_5.859296	38	118	6	2	80	0.0250000
NODE_170909_length_298_cov_5.859296	38	118	8	3	80	0.0375000
NODE_170909_length_298_cov_5.859296	38	118	10	2	80	0.0250000
NODE_170909_length_298_cov_5.859296	38	118	12	41	80	0.5125000
NODE_170909_length_298_cov_5.859296	114	194	2	19	80	0.2375000
NODE_170909_length_298_cov_5.859296	114	194	3	16	80	0.2000000
NODE_170909_length_298_cov_5.859296	114	194	5	2	80	0.0250000
NODE_170909_length_298_cov_5.859296	114	194	9	5	80	0.0625000
NODE_170909_length_298_cov_5.859296	114	194	10	21	80	0.2625000
NODE_170909_length_298_cov_5.859296	114	194	12	17	80	0.2125000
NODE_170909_length_298_cov_5.859296	167	238	10	18	71	0.2535211
NODE_170909_length_298_cov_5.859296	167	238	12	34	71	0.4788733
NODE_170909_length_298_cov_5.859296	167	238	14	16	71	0.2253521
NODE_170909_length_298_cov_5.859296	167	238	16	3	71	0.0422535
NODE_170964_length_298_cov_3.829146	80	160	16	25	80	0.3125000
NODE_170964_length_298_cov_3.829146	80	160	17	4	80	0.0500000
NODE_170964_length_298_cov_3.829146	80	160	18	9	80	0.1125000
NODE_170964_length_298_cov_3.829146	80	160	19	3	80	0.0375000
NODE_170964_length_298_cov_3.829146	80	160	20	8	80	0.1000000
NODE_170964_length_298_cov_3.829146	80	160	21	3	80	0.0375000
NODE_170964_length_298_cov_3.829146	80	160	22	8	80	0.1000000
NODE_170964_length_298_cov_3.829146	80	160	24	6	80	0.0750000
NODE_170964_length_298_cov_3.829146	80	160	27	12	80	0.1500000
NODE_170964_length_298_cov_3.829146	80	160	28	2	80	0.0250000
NODE_170964_length_298_cov_3.829146	133	213	7	4	80	0.0500000
NODE_170964_length_298_cov_3.829146	133	213	9	5	80	0.0625000
NODE_170964_length_298_cov_3.829146	133	213	11	5	80	0.0625000
NODE_170964_length_298_cov_3.829146	133	213	13	13	80	0.1625000
NODE_170964_length_298_cov_3.829146	133	213	15	6	80	0.0750000
NODE_170964_length_298_cov_3.829146	133	213	16	15	80	0.1875000
NODE_170964_length_298_cov_3.829146	133	213	17	19	80	0.2375000
NODE_170964_length_298_cov_3.829146	133	213	18	5	80	0.0625000
NODE_170964_length_298_cov_3.829146	133	213	19	5	80	0.0625000
NODE_170964_length_298_cov_3.829146	133	213	21	3	80	0.0375000
NODE_170968_length_298_cov_3.733668	203	283	0	80	80	1.0000000
NODE_170972_length_298_cov_3.673367	117	175	0	32	58	0.5517241
NODE_170972_length_298_cov_3.673367	117	175	2	2	58	0.0344828
NODE_170972_length_298_cov_3.673367	117	175	6	24	58	0.4137931
NODE_171043_length_298_cov_2.924623	159	239	0	15	80	0.1875000
NODE_171043_length_298_cov_2.924623	159	239	2	54	80	0.6750000
NODE_171043_length_298_cov_2.924623	159	239	4	3	80	0.0375000
NODE_171043_length_298_cov_2.924623	159	239	8	2	80	0.0250000
NODE_171043_length_298_cov_2.924623	159	239	10	2	80	0.0250000
NODE_171043_length_298_cov_2.924623	159	239	12	4	80	0.0500000
NODE_171043_length_298_cov_2.924623	212	265	0	41	53	0.7735849
NODE_171043_length_298_cov_2.924623	212	265	2	12	53	0.2264151
NODE_171047_length_298_cov_2.854271	50	120	0	70	70	1.0000000
NODE_171082_length_298_cov_2.663317	87	167	0	16	80	0.2000000
NODE_171082_length_298_cov_2.663317	87	167	2	64	80	0.8000000
NODE_171082_length_298_cov_2.663317	140	192	2	52	52	1.0000000
NODE_171191_length_298_cov_2.201005	112	166	0	54	54	1.0000000
NODE_171210_length_298_cov_2.120603	135	166	0	31	31	1.0000000
NODE_171226_length_298_cov_2.055276	69	132	0	63	63	1.0000000
NODE_171286_length_298_cov_2.025126	21	92	0	68	71	0.9577465
NODE_171286_length_298_cov_2.025126	21	92	3	3	71	0.0422535
NODE_171356_length_298_cov_1.798995	0	67	0	2	67	0.0298507
NODE_171356_length_298_cov_1.798995	0	67	2	48	67	0.7164179
NODE_171356_length_298_cov_1.798995	0	67	3	7	67	0.1044776
NODE_171356_length_298_cov_1.798995	0	67	4	10	67	0.1492537
NODE_171356_length_298_cov_1.798995	40	106	2	49	66	0.7424242
NODE_171356_length_298_cov_1.798995	40	106	3	7	66	0.1060606
NODE_171356_length_298_cov_1.798995	40	106	4	10	66	0.1515152
NODE_171391_length_298_cov_1.788945	140	197	0	12	57	0.2105263
NODE_171391_length_298_cov_1.788945	140	197	2	45	57	0.7894737
NODE_171415_length_298_cov_1.733668	56	91	2	2	35	0.0571429
NODE_171415_length_298_cov_1.733668	56	91	4	4	35	0.1142857
NODE_171415_length_298_cov_1.733668	56	91	6	10	35	0.2857143
NODE_171415_length_298_cov_1.733668	56	91	8	2	35	0.0571429
NODE_171415_length_298_cov_1.733668	56	91	10	2	35	0.0571429
NODE_171415_length_298_cov_1.733668	56	91	12	15	35	0.4285714
NODE_171415_length_298_cov_1.733668	118	172	4	2	54	0.0370370
NODE_171415_length_298_cov_1.733668	118	172	6	6	54	0.1111111
NODE_171415_length_298_cov_1.733668	118	172	8	14	54	0.2592593
NODE_171415_length_298_cov_1.733668	118	172	10	25	54	0.4629630
NODE_171415_length_298_cov_1.733668	118	172	12	4	54	0.0740741
NODE_171415_length_298_cov_1.733668	118	172	14	3	54	0.0555556
NODE_171505_length_298_cov_1.537688	101	154	0	53	53	1.0000000
NODE_172083_length_298_cov_0.829146	34	96	0	62	62	1.0000000
NODE_172330_length_297_cov_6.525253	100	122	0	22	22	1.0000000
NODE_172352_length_297_cov_4.888889	150	218	0	4	68	0.0588235
NODE_172352_length_297_cov_4.888889	150	218	2	5	68	0.0735294
NODE_172352_length_297_cov_4.888889	150	218	4	1	68	0.0147059
NODE_172352_length_297_cov_4.888889	150	218	6	6	68	0.0882353
NODE_172352_length_297_cov_4.888889	150	218	8	46	68	0.6764706
NODE_172352_length_297_cov_4.888889	150	218	10	6	68	0.0882353
NODE_172356_length_297_cov_4.671717	56	120	0	64	64	1.0000000
NODE_172422_length_297_cov_3.338384	96	176	2	80	80	1.0000000
NODE_172422_length_297_cov_3.338384	149	198	0	20	49	0.4081633
NODE_172422_length_297_cov_3.338384	149	198	2	29	49	0.5918368
NODE_172447_length_297_cov_3.040404	0	55	0	55	55	1.0000000
NODE_172447_length_297_cov_3.040404	14	55	0	41	41	1.0000000
NODE_172447_length_297_cov_3.040404	65	119	0	54	54	1.0000000
NODE_172574_length_297_cov_2.308081	8	70	0	62	62	1.0000000
NODE_172606_length_297_cov_2.196970	219	259	36	2	40	0.0500000
NODE_172606_length_297_cov_2.196970	219	259	40	1	40	0.0250000
NODE_172606_length_297_cov_2.196970	219	259	46	1	40	0.0250000
NODE_172606_length_297_cov_2.196970	219	259	48	2	40	0.0500000
NODE_172606_length_297_cov_2.196970	219	259	49	1	40	0.0250000
NODE_172606_length_297_cov_2.196970	219	259	51	2	40	0.0500000
NODE_172606_length_297_cov_2.196970	219	259	53	3	40	0.0750000
NODE_172606_length_297_cov_2.196970	219	259	56	1	40	0.0250000
NODE_172606_length_297_cov_2.196970	219	259	60	1	40	0.0250000
NODE_172606_length_297_cov_2.196970	219	259	62	1	40	0.0250000
NODE_172606_length_297_cov_2.196970	219	259	64	2	40	0.0500000
NODE_172606_length_297_cov_2.196970	219	259	66	2	40	0.0500000
NODE_172606_length_297_cov_2.196970	219	259	68	1	40	0.0250000
NODE_172606_length_297_cov_2.196970	219	259	70	2	40	0.0500000
NODE_172606_length_297_cov_2.196970	219	259	72	1	40	0.0250000
NODE_172606_length_297_cov_2.196970	219	259	74	1	40	0.0250000
NODE_172606_length_297_cov_2.196970	219	259	76	2	40	0.0500000
NODE_172606_length_297_cov_2.196970	219	259	78	1	40	0.0250000
NODE_172606_length_297_cov_2.196970	219	259	86	1	40	0.0250000
NODE_172606_length_297_cov_2.196970	219	259	88	1	40	0.0250000
NODE_172606_length_297_cov_2.196970	219	259	90	11	40	0.2750000
NODE_172629_length_297_cov_2.106061	81	161	2	68	80	0.8500000
NODE_172629_length_297_cov_2.106061	81	161	4	12	80	0.1500000
NODE_172629_length_297_cov_2.106061	134	178	2	39	44	0.8863636
NODE_172629_length_297_cov_2.106061	134	178	4	5	44	0.1136364
NODE_172668_length_297_cov_2.060606	46	76	4	30	30	1.0000000
NODE_172697_length_297_cov_2.010101	9	85	2	6	76	0.0789474
NODE_172697_length_297_cov_2.010101	9	85	4	70	76	0.9210526
NODE_172783_length_297_cov_1.777778	168	208	2	12	40	0.3000000
NODE_172783_length_297_cov_1.777778	168	208	4	22	40	0.5500000
NODE_172783_length_297_cov_1.777778	168	208	8	6	40	0.1500000
NODE_172855_length_297_cov_1.595960	175	255	4	11	80	0.1375000
NODE_172855_length_297_cov_1.595960	175	255	6	2	80	0.0250000
NODE_172855_length_297_cov_1.595960	175	255	8	15	80	0.1875000
NODE_172855_length_297_cov_1.595960	175	255	10	24	80	0.3000000
NODE_172855_length_297_cov_1.595960	175	255	12	28	80	0.3500000
NODE_172862_length_297_cov_1.570707	100	177	0	56	77	0.7272727
NODE_172862_length_297_cov_1.570707	100	177	2	21	77	0.2727273
NODE_172863_length_297_cov_1.570707	194	275	0	35	81	0.4320988
NODE_172863_length_297_cov_1.570707	194	275	2	46	81	0.5679013
NODE_173063_length_297_cov_1.338384	140	199	0	59	59	1.0000000
NODE_173136_length_297_cov_1.277778	39	115	0	41	76	0.5394737
NODE_173136_length_297_cov_1.277778	39	115	2	35	76	0.4605263
NODE_173176_length_297_cov_1.196970	7	87	0	80	80	1.0000000
NODE_173176_length_297_cov_1.196970	60	116	0	56	56	1.0000000
NODE_173345_length_297_cov_1.030303	0	33	0	33	33	1.0000000
NODE_173467_length_297_cov_0.888889	109	172	0	63	63	1.0000000
NODE_173520_length_297_cov_0.782828	24	104	0	7	80	0.0875000
NODE_173520_length_297_cov_0.782828	24	104	2	73	80	0.9125000
NODE_173708_length_296_cov_41.390863	189	260	6	50	71	0.7042254
NODE_173708_length_296_cov_41.390863	189	260	8	21	71	0.2957746
NODE_173709_length_296_cov_34.776650	214	294	0	80	80	1.0000000
NODE_173758_length_296_cov_4.243655	14	54	0	40	40	1.0000000
NODE_173773_length_296_cov_3.954315	120	200	0	80	80	1.0000000
NODE_173787_length_296_cov_3.736041	6	46	0	40	40	1.0000000
NODE_173797_length_296_cov_3.619289	193	251	0	47	58	0.8103448
NODE_173797_length_296_cov_3.619289	193	251	1	3	58	0.0517241
NODE_173797_length_296_cov_3.619289	193	251	2	8	58	0.1379310
NODE_173797_length_296_cov_3.619289	246	296	0	50	50	1.0000000
NODE_173859_length_296_cov_3.015228	177	257	0	9	80	0.1125000
NODE_173859_length_296_cov_3.015228	177	257	1	71	80	0.8875000
NODE_173992_length_296_cov_2.309645	5	77	2	8	72	0.1111111
NODE_173992_length_296_cov_2.309645	5	77	6	1	72	0.0138889
NODE_173992_length_296_cov_2.309645	5	77	7	12	72	0.1666667
NODE_173992_length_296_cov_2.309645	5	77	9	5	72	0.0694444
NODE_173992_length_296_cov_2.309645	5	77	11	17	72	0.2361111
NODE_173992_length_296_cov_2.309645	5	77	15	19	72	0.2638889
NODE_173992_length_296_cov_2.309645	5	77	16	4	72	0.0555556
NODE_173992_length_296_cov_2.309645	5	77	18	4	72	0.0555556
NODE_173992_length_296_cov_2.309645	5	77	22	1	72	0.0138889
NODE_173992_length_296_cov_2.309645	5	77	24	1	72	0.0138889
NODE_173992_length_296_cov_2.309645	50	130	15	17	80	0.2125000
NODE_173992_length_296_cov_2.309645	50	130	16	4	80	0.0500000
NODE_173992_length_296_cov_2.309645	50	130	18	4	80	0.0500000
NODE_173992_length_296_cov_2.309645	50	130	22	1	80	0.0125000
NODE_173992_length_296_cov_2.309645	50	130	24	3	80	0.0375000
NODE_173992_length_296_cov_2.309645	50	130	26	5	80	0.0625000
NODE_173992_length_296_cov_2.309645	50	130	28	5	80	0.0625000
NODE_173992_length_296_cov_2.309645	50	130	30	15	80	0.1875000
NODE_173992_length_296_cov_2.309645	50	130	32	25	80	0.3125000
NODE_173992_length_296_cov_2.309645	50	130	34	1	80	0.0125000
NODE_174040_length_296_cov_2.081218	90	139	0	49	49	1.0000000
NODE_174167_length_296_cov_1.807107	199	246	0	47	47	1.0000000
NODE_174167_length_296_cov_1.807107	219	296	0	77	77	1.0000000
NODE_174213_length_296_cov_1.670051	28	103	6	3	75	0.0400000
NODE_174213_length_296_cov_1.670051	28	103	8	16	75	0.2133333
NODE_174213_length_296_cov_1.670051	28	103	9	6	75	0.0800000
NODE_174213_length_296_cov_1.670051	28	103	10	50	75	0.6666667
NODE_174274_length_296_cov_1.553299	102	179	0	4	77	0.0519481
NODE_174274_length_296_cov_1.553299	102	179	2	73	77	0.9480519
NODE_174274_length_296_cov_1.553299	160	179	0	4	19	0.2105263
NODE_174274_length_296_cov_1.553299	160	179	2	15	19	0.7894737
NODE_174438_length_296_cov_1.319797	82	162	2	22	80	0.2750000
NODE_174438_length_296_cov_1.319797	82	162	4	58	80	0.7250000
NODE_174438_length_296_cov_1.319797	135	205	2	22	70	0.3142857
NODE_174438_length_296_cov_1.319797	135	205	4	48	70	0.6857143
NODE_174545_length_296_cov_1.258883	222	280	0	58	58	1.0000000
NODE_174554_length_296_cov_1.238579	90	147	2	57	57	1.0000000
NODE_174614_length_296_cov_1.116751	130	169	6	4	39	0.1025641
NODE_174614_length_296_cov_1.116751	130	169	8	1	39	0.0256410
NODE_174614_length_296_cov_1.116751	130	169	10	9	39	0.2307692
NODE_174614_length_296_cov_1.116751	130	169	12	6	39	0.1538462
NODE_174614_length_296_cov_1.116751	130	169	16	6	39	0.1538462
NODE_174614_length_296_cov_1.116751	130	169	18	13	39	0.3333333
NODE_175210_length_295_cov_4.290816	2	70	2	68	68	1.0000000
NODE_175210_length_295_cov_4.290816	55	123	0	48	68	0.7058824
NODE_175210_length_295_cov_4.290816	55	123	2	20	68	0.2941177
NODE_175220_length_295_cov_4.040816	119	165	0	45	46	0.9782609
NODE_175220_length_295_cov_4.040816	119	165	2	1	46	0.0217391
NODE_175258_length_295_cov_3.576531	130	198	0	68	68	1.0000000
NODE_175324_length_295_cov_2.918367	0	77	0	77	77	1.0000000
NODE_175416_length_295_cov_2.454082	216	277	18	5	61	0.0819672
NODE_175416_length_295_cov_2.454082	216	277	20	9	61	0.1475410
NODE_175416_length_295_cov_2.454082	216	277	22	44	61	0.7213115
NODE_175416_length_295_cov_2.454082	216	277	24	3	61	0.0491803
NODE_175475_length_295_cov_2.224490	11	91	6	27	80	0.3375000
NODE_175475_length_295_cov_2.224490	11	91	7	2	80	0.0250000
NODE_175475_length_295_cov_2.224490	11	91	8	51	80	0.6375000
NODE_175483_length_295_cov_2.183673	93	151	2	13	58	0.2241379
NODE_175483_length_295_cov_2.183673	93	151	3	2	58	0.0344828
NODE_175483_length_295_cov_2.183673	93	151	5	2	58	0.0344828
NODE_175483_length_295_cov_2.183673	93	151	7	2	58	0.0344828
NODE_175483_length_295_cov_2.183673	93	151	9	4	58	0.0689655
NODE_175483_length_295_cov_2.183673	93	151	10	35	58	0.6034483
NODE_175483_length_295_cov_2.183673	124	204	10	80	80	1.0000000
NODE_175597_length_295_cov_1.867347	191	239	4	28	48	0.5833333
NODE_175597_length_295_cov_1.867347	191	239	6	20	48	0.4166667
NODE_175598_length_295_cov_1.862245	225	285	2	60	60	1.0000000
NODE_175721_length_295_cov_1.596939	173	254	4	43	81	0.5308642
NODE_175721_length_295_cov_1.596939	173	254	6	30	81	0.3703704
NODE_175721_length_295_cov_1.596939	173	254	8	8	81	0.0987654
NODE_175804_length_295_cov_1.520408	217	282	0	65	65	1.0000000
NODE_175930_length_295_cov_1.301020	99	121	0	22	22	1.0000000
NODE_176250_length_295_cov_0.938776	200	247	0	47	47	1.0000000
NODE_176367_length_295_cov_0.780612	24	44	0	20	20	1.0000000
NODE_176436_length_295_cov_0.724490	6	87	0	27	81	0.3333333
NODE_176436_length_295_cov_0.724490	6	87	2	54	81	0.6666667
NODE_176436_length_295_cov_0.724490	83	163	0	61	80	0.7625000
NODE_176436_length_295_cov_0.724490	83	163	2	19	80	0.2375000
NODE_176436_length_295_cov_0.724490	136	216	0	80	80	1.0000000
NODE_176547_length_294_cov_83.882051	143	173	0	30	30	1.0000000
NODE_176547_length_294_cov_83.882051	209	239	0	30	30	1.0000000
NODE_176549_length_294_cov_50.589744	187	258	2	5	71	0.0704225
NODE_176549_length_294_cov_50.589744	187	258	4	1	71	0.0140845
NODE_176549_length_294_cov_50.589744	187	258	6	3	71	0.0422535
NODE_176549_length_294_cov_50.589744	187	258	7	4	71	0.0563380
NODE_176549_length_294_cov_50.589744	187	258	9	2	71	0.0281690
NODE_176549_length_294_cov_50.589744	187	258	21	3	71	0.0422535
NODE_176549_length_294_cov_50.589744	187	258	25	4	71	0.0563380
NODE_176549_length_294_cov_50.589744	187	258	29	1	71	0.0140845
NODE_176549_length_294_cov_50.589744	187	258	31	2	71	0.0281690
NODE_176549_length_294_cov_50.589744	187	258	33	3	71	0.0422535
NODE_176549_length_294_cov_50.589744	187	258	35	5	71	0.0704225
NODE_176549_length_294_cov_50.589744	187	258	37	1	71	0.0140845
NODE_176549_length_294_cov_50.589744	187	258	43	3	71	0.0422535
NODE_176549_length_294_cov_50.589744	187	258	47	1	71	0.0140845
NODE_176549_length_294_cov_50.589744	187	258	49	1	71	0.0140845
NODE_176549_length_294_cov_50.589744	187	258	50	1	71	0.0140845
NODE_176549_length_294_cov_50.589744	187	258	52	2	71	0.0281690
NODE_176549_length_294_cov_50.589744	187	258	56	1	71	0.0140845
NODE_176549_length_294_cov_50.589744	187	258	58	4	71	0.0563380
NODE_176549_length_294_cov_50.589744	187	258	62	1	71	0.0140845
NODE_176549_length_294_cov_50.589744	187	258	64	1	71	0.0140845
NODE_176549_length_294_cov_50.589744	187	258	66	1	71	0.0140845
NODE_176549_length_294_cov_50.589744	187	258	68	4	71	0.0563380
NODE_176549_length_294_cov_50.589744	187	258	70	2	71	0.0281690
NODE_176549_length_294_cov_50.589744	187	258	75	6	71	0.0845070
NODE_176549_length_294_cov_50.589744	187	258	77	1	71	0.0140845
NODE_176549_length_294_cov_50.589744	187	258	81	4	71	0.0563380
NODE_176549_length_294_cov_50.589744	187	258	83	1	71	0.0140845
NODE_176549_length_294_cov_50.589744	187	258	85	1	71	0.0140845
NODE_176549_length_294_cov_50.589744	187	258	89	1	71	0.0140845
NODE_176549_length_294_cov_50.589744	187	258	91	1	71	0.0140845
NODE_176561_length_294_cov_6.676923	61	138	0	77	77	1.0000000
NODE_176596_length_294_cov_4.538462	127	214	2	46	87	0.5287356
NODE_176596_length_294_cov_4.538462	127	214	4	10	87	0.1149425
NODE_176596_length_294_cov_4.538462	127	214	6	31	87	0.3563218
NODE_176598_length_294_cov_4.512821	218	248	0	30	30	1.0000000
NODE_176600_length_294_cov_4.497436	159	200	0	41	41	1.0000000
NODE_176697_length_294_cov_2.953846	114	194	0	18	80	0.2250000
NODE_176697_length_294_cov_2.953846	114	194	2	2	80	0.0250000
NODE_176697_length_294_cov_2.953846	114	194	4	9	80	0.1125000
NODE_176697_length_294_cov_2.953846	114	194	6	1	80	0.0125000
NODE_176697_length_294_cov_2.953846	114	194	8	34	80	0.4250000
NODE_176697_length_294_cov_2.953846	114	194	10	16	80	0.2000000
NODE_176727_length_294_cov_2.764103	103	183	2	45	80	0.5625000
NODE_176727_length_294_cov_2.764103	103	183	4	35	80	0.4375000
NODE_176727_length_294_cov_2.764103	156	236	2	22	80	0.2750000
NODE_176727_length_294_cov_2.764103	156	236	4	11	80	0.1375000
NODE_176727_length_294_cov_2.764103	156	236	6	19	80	0.2375000
NODE_176727_length_294_cov_2.764103	156	236	8	28	80	0.3500000
NODE_176728_length_294_cov_2.764103	224	282	0	54	58	0.9310345
NODE_176728_length_294_cov_2.764103	224	282	2	4	58	0.0689655
NODE_176728_length_294_cov_2.764103	225	277	0	49	52	0.9423077
NODE_176728_length_294_cov_2.764103	225	277	2	3	52	0.0576923
NODE_176735_length_294_cov_2.697436	204	261	0	57	57	1.0000000
NODE_176735_length_294_cov_2.697436	234	294	0	60	60	1.0000000
NODE_176779_length_294_cov_2.517949	23	85	2	62	62	1.0000000
NODE_176816_length_294_cov_2.353846	129	167	2	38	38	1.0000000
NODE_176833_length_294_cov_2.338462	133	213	2	48	80	0.6000000
NODE_176833_length_294_cov_2.338462	133	213	4	8	80	0.1000000
NODE_176833_length_294_cov_2.338462	133	213	6	24	80	0.3000000
NODE_176943_length_294_cov_2.046154	219	269	2	50	50	1.0000000
NODE_176957_length_294_cov_2.010256	191	235	0	20	44	0.4545455
NODE_176957_length_294_cov_2.010256	191	235	2	24	44	0.5454546
NODE_176999_length_294_cov_1.902564	52	83	4	29	31	0.9354839
NODE_176999_length_294_cov_1.902564	52	83	6	2	31	0.0645161
NODE_177102_length_294_cov_1.692308	46	112	0	66	66	1.0000000
NODE_177187_length_294_cov_1.569231	49	95	2	46	46	1.0000000
NODE_177252_length_294_cov_1.482051	28	108	0	2	80	0.0250000
NODE_177252_length_294_cov_1.482051	28	108	2	10	80	0.1250000
NODE_177252_length_294_cov_1.482051	28	108	4	68	80	0.8500000
NODE_177252_length_294_cov_1.482051	201	281	0	9	80	0.1125000
NODE_177252_length_294_cov_1.482051	201	281	2	22	80	0.2750000
NODE_177252_length_294_cov_1.482051	201	281	4	49	80	0.6125000
NODE_177252_length_294_cov_1.482051	201	281	0	9	80	0.1125000
NODE_177252_length_294_cov_1.482051	201	281	2	22	80	0.2750000
NODE_177252_length_294_cov_1.482051	201	281	4	49	80	0.6125000
NODE_177298_length_294_cov_1.420513	216	262	0	29	46	0.6304348
NODE_177298_length_294_cov_1.420513	216	262	2	17	46	0.3695652
NODE_177298_length_294_cov_1.420513	235	294	0	59	59	1.0000000
NODE_177972_length_294_cov_0.666667	245	293	0	48	48	1.0000000
NODE_178066_length_293_cov_6.257732	167	247	0	80	80	1.0000000
NODE_178161_length_293_cov_3.567010	50	130	2	56	80	0.7000000
NODE_178161_length_293_cov_3.567010	50	130	4	24	80	0.3000000
NODE_178226_length_293_cov_2.907216	218	281	0	63	63	1.0000000
NODE_178246_length_293_cov_2.768041	95	175	0	80	80	1.0000000
NODE_178246_length_293_cov_2.768041	148	228	0	46	80	0.5750000
NODE_178246_length_293_cov_2.768041	148	228	2	34	80	0.4250000
NODE_178268_length_293_cov_2.628866	207	266	0	40	59	0.6779661
NODE_178268_length_293_cov_2.628866	207	266	2	19	59	0.3220339
NODE_178277_length_293_cov_2.623711	182	223	12	11	41	0.2682927
NODE_178277_length_293_cov_2.623711	182	223	14	12	41	0.2926829
NODE_178277_length_293_cov_2.623711	182	223	16	18	41	0.4390244
NODE_178299_length_293_cov_2.561856	139	192	0	9	53	0.1698113
NODE_178299_length_293_cov_2.561856	139	192	2	29	53	0.5471698
NODE_178299_length_293_cov_2.561856	139	192	6	14	53	0.2641509
NODE_178299_length_293_cov_2.561856	139	192	8	1	53	0.0188679
NODE_178299_length_293_cov_2.561856	177	223	6	14	46	0.3043478
NODE_178299_length_293_cov_2.561856	177	223	8	32	46	0.6956522
NODE_178317_length_293_cov_2.448454	98	158	4	20	60	0.3333333
NODE_178317_length_293_cov_2.448454	98	158	6	40	60	0.6666667
NODE_178351_length_293_cov_2.335052	62	91	0	29	29	1.0000000
NODE_178357_length_293_cov_2.314433	35	89	4	40	54	0.7407407
NODE_178357_length_293_cov_2.314433	35	89	6	14	54	0.2592593
NODE_178523_length_293_cov_1.840206	27	107	0	58	80	0.7250000
NODE_178523_length_293_cov_1.840206	27	107	2	22	80	0.2750000
NODE_178523_length_293_cov_1.840206	80	160	0	40	80	0.5000000
NODE_178523_length_293_cov_1.840206	80	160	2	40	80	0.5000000
NODE_178560_length_293_cov_1.804124	144	173	2	29	29	1.0000000
NODE_178570_length_293_cov_1.778351	224	258	0	34	34	1.0000000
NODE_178646_length_293_cov_1.577320	158	177	0	19	19	1.0000000
NODE_178692_length_293_cov_1.577320	161	225	0	20	64	0.3125000
NODE_178692_length_293_cov_1.577320	161	225	2	15	64	0.2343750
NODE_178692_length_293_cov_1.577320	161	225	4	29	64	0.4531250
NODE_178693_length_293_cov_1.577320	15	55	0	40	40	1.0000000
NODE_178788_length_293_cov_1.402062	3	72	0	69	69	1.0000000
NODE_178822_length_293_cov_1.319588	202	268	0	5	66	0.0757576
NODE_178822_length_293_cov_1.319588	202	268	2	61	66	0.9242424
NODE_178927_length_293_cov_1.226804	84	141	0	57	57	1.0000000
NODE_179542_length_292_cov_4.523316	240	290	0	50	50	1.0000000
NODE_179552_length_292_cov_4.145078	106	186	0	14	80	0.1750000
NODE_179552_length_292_cov_4.145078	106	186	2	27	80	0.3375000
NODE_179552_length_292_cov_4.145078	106	186	4	12	80	0.1500000
NODE_179552_length_292_cov_4.145078	106	186	6	27	80	0.3375000
NODE_179604_length_292_cov_3.502591	129	205	2	5	76	0.0657895
NODE_179604_length_292_cov_3.502591	129	205	6	8	76	0.1052632
NODE_179604_length_292_cov_3.502591	129	205	8	51	76	0.6710526
NODE_179604_length_292_cov_3.502591	129	205	10	12	76	0.1578947
NODE_179613_length_292_cov_3.435233	176	200	0	24	24	1.0000000
NODE_179621_length_292_cov_3.341969	70	150	2	24	80	0.3000000
NODE_179621_length_292_cov_3.341969	70	150	6	34	80	0.4250000
NODE_179621_length_292_cov_3.341969	70	150	8	22	80	0.2750000
NODE_179621_length_292_cov_3.341969	118	175	0	2	57	0.0350877
NODE_179621_length_292_cov_3.341969	118	175	2	47	57	0.8245614
NODE_179621_length_292_cov_3.341969	118	175	6	8	57	0.1403509
NODE_179627_length_292_cov_3.222798	47	127	0	80	80	1.0000000
NODE_179627_length_292_cov_3.222798	100	129	0	29	29	1.0000000
NODE_179819_length_292_cov_2.238342	211	290	0	79	79	1.0000000
NODE_179943_length_292_cov_1.865285	34	114	5	11	80	0.1375000
NODE_179943_length_292_cov_1.865285	34	114	7	9	80	0.1125000
NODE_179943_length_292_cov_1.865285	34	114	9	26	80	0.3250000
NODE_179943_length_292_cov_1.865285	34	114	11	11	80	0.1375000
NODE_179943_length_292_cov_1.865285	34	114	12	9	80	0.1125000
NODE_179943_length_292_cov_1.865285	34	114	13	2	80	0.0250000
NODE_179943_length_292_cov_1.865285	34	114	14	12	80	0.1500000
NODE_179943_length_292_cov_1.865285	87	167	4	29	80	0.3625000
NODE_179943_length_292_cov_1.865285	87	167	5	27	80	0.3375000
NODE_179943_length_292_cov_1.865285	87	167	6	7	80	0.0875000
NODE_179943_length_292_cov_1.865285	87	167	7	10	80	0.1250000
NODE_179943_length_292_cov_1.865285	87	167	9	7	80	0.0875000
NODE_180013_length_292_cov_1.761658	174	254	0	80	80	1.0000000
NODE_180029_length_292_cov_1.699482	0	80	0	52	80	0.6500000
NODE_180029_length_292_cov_1.699482	0	80	2	1	80	0.0125000
NODE_180029_length_292_cov_1.699482	0	80	4	14	80	0.1750000
NODE_180029_length_292_cov_1.699482	0	80	6	1	80	0.0125000
NODE_180029_length_292_cov_1.699482	0	80	8	6	80	0.0750000
NODE_180029_length_292_cov_1.699482	0	80	10	3	80	0.0375000
NODE_180029_length_292_cov_1.699482	0	80	12	3	80	0.0375000
NODE_180068_length_292_cov_1.611399	89	157	0	68	68	1.0000000
NODE_180210_length_292_cov_1.455959	72	115	2	18	43	0.4186046
NODE_180210_length_292_cov_1.455959	72	115	4	25	43	0.5813953
NODE_180210_length_292_cov_1.455959	203	265	0	62	62	1.0000000
NODE_180302_length_292_cov_1.321244	102	182	0	80	80	1.0000000
NODE_180302_length_292_cov_1.321244	155	217	0	62	62	1.0000000
NODE_180968_length_291_cov_45.031250	71	145	16	9	74	0.1216216
NODE_180968_length_291_cov_45.031250	71	145	17	2	74	0.0270270
NODE_180968_length_291_cov_45.031250	71	145	18	2	74	0.0270270
NODE_180968_length_291_cov_45.031250	71	145	22	6	74	0.0810811
NODE_180968_length_291_cov_45.031250	71	145	24	5	74	0.0675676
NODE_180968_length_291_cov_45.031250	71	145	26	3	74	0.0405405
NODE_180968_length_291_cov_45.031250	71	145	28	47	74	0.6351351
NODE_180968_length_291_cov_45.031250	71	145	16	9	74	0.1216216
NODE_180968_length_291_cov_45.031250	71	145	17	2	74	0.0270270
NODE_180968_length_291_cov_45.031250	71	145	18	2	74	0.0270270
NODE_180968_length_291_cov_45.031250	71	145	22	6	74	0.0810811
NODE_180968_length_291_cov_45.031250	71	145	24	5	74	0.0675676
NODE_180968_length_291_cov_45.031250	71	145	26	3	74	0.0405405
NODE_180968_length_291_cov_45.031250	71	145	28	47	74	0.6351351
NODE_180968_length_291_cov_45.031250	118	184	16	9	66	0.1363636
NODE_180968_length_291_cov_45.031250	118	184	17	2	66	0.0303030
NODE_180968_length_291_cov_45.031250	118	184	18	3	66	0.0454545
NODE_180968_length_291_cov_45.031250	118	184	19	3	66	0.0454545
NODE_180968_length_291_cov_45.031250	118	184	20	15	66	0.2272727
NODE_180968_length_291_cov_45.031250	118	184	21	14	66	0.2121212
NODE_180968_length_291_cov_45.031250	118	184	22	9	66	0.1363636
NODE_180968_length_291_cov_45.031250	118	184	23	2	66	0.0303030
NODE_180968_length_291_cov_45.031250	118	184	24	3	66	0.0454545
NODE_180968_length_291_cov_45.031250	118	184	26	1	66	0.0151515
NODE_180968_length_291_cov_45.031250	118	184	28	5	66	0.0757576
NODE_180969_length_291_cov_14.791667	125	205	0	80	80	1.0000000
NODE_180969_length_291_cov_14.791667	178	258	0	80	80	1.0000000
NODE_180983_length_291_cov_5.536458	97	169	0	72	72	1.0000000
NODE_180986_length_291_cov_5.401042	77	130	2	53	53	1.0000000
NODE_180998_length_291_cov_4.859375	185	257	0	47	72	0.6527778
NODE_180998_length_291_cov_4.859375	185	257	2	25	72	0.3472222
NODE_181043_length_291_cov_3.723958	196	276	0	80	80	1.0000000
NODE_181057_length_291_cov_3.531250	129	152	0	15	23	0.6521739
NODE_181057_length_291_cov_3.531250	129	152	2	8	23	0.3478261
NODE_181191_length_291_cov_2.390625	18	80	0	62	62	1.0000000
NODE_181272_length_291_cov_2.125000	70	117	0	5	47	0.1063830
NODE_181272_length_291_cov_2.125000	70	117	1	42	47	0.8936170
NODE_181391_length_291_cov_1.859375	197	228	0	31	31	1.0000000
NODE_181497_length_291_cov_1.593750	144	175	0	31	31	1.0000000
NODE_181530_length_291_cov_1.593750	206	281	2	16	75	0.2133333
NODE_181530_length_291_cov_1.593750	206	281	4	8	75	0.1066667
NODE_181530_length_291_cov_1.593750	206	281	6	51	75	0.6800000
NODE_181599_length_291_cov_1.552083	189	269	6	3	80	0.0375000
NODE_181599_length_291_cov_1.552083	189	269	8	17	80	0.2125000
NODE_181599_length_291_cov_1.552083	189	269	10	60	80	0.7500000
NODE_181615_length_291_cov_1.520833	180	258	0	76	78	0.9743590
NODE_181615_length_291_cov_1.520833	180	258	2	2	78	0.0256410
NODE_181623_length_291_cov_1.510417	245	291	0	46	46	1.0000000
NODE_181696_length_291_cov_1.385417	80	120	0	33	40	0.8250000
NODE_181696_length_291_cov_1.385417	80	120	2	7	40	0.1750000
NODE_181791_length_291_cov_1.322917	70	96	0	26	26	1.0000000
NODE_181799_length_291_cov_1.307292	108	188	0	39	80	0.4875000
NODE_181799_length_291_cov_1.307292	108	188	2	1	80	0.0125000
NODE_181799_length_291_cov_1.307292	108	188	4	6	80	0.0750000
NODE_181799_length_291_cov_1.307292	108	188	6	5	80	0.0625000
NODE_181799_length_291_cov_1.307292	108	188	8	26	80	0.3250000
NODE_181799_length_291_cov_1.307292	108	188	10	3	80	0.0375000
NODE_181907_length_291_cov_1.114583	79	174	18	1	95	0.0105263
NODE_181907_length_291_cov_1.114583	79	174	22	2	95	0.0210526
NODE_181907_length_291_cov_1.114583	79	174	24	8	95	0.0842105
NODE_181907_length_291_cov_1.114583	79	174	28	1	95	0.0105263
NODE_181907_length_291_cov_1.114583	79	174	32	2	95	0.0210526
NODE_181907_length_291_cov_1.114583	79	174	34	13	95	0.1368421
NODE_181907_length_291_cov_1.114583	79	174	35	1	95	0.0105263
NODE_181907_length_291_cov_1.114583	79	174	36	7	95	0.0736842
NODE_181907_length_291_cov_1.114583	79	174	38	21	95	0.2210526
NODE_181907_length_291_cov_1.114583	79	174	39	20	95	0.2105263
NODE_181907_length_291_cov_1.114583	79	174	40	19	95	0.2000000
NODE_181930_length_291_cov_1.078125	4	85	0	31	81	0.3827161
NODE_181930_length_291_cov_1.078125	4	85	2	5	81	0.0617284
NODE_181930_length_291_cov_1.078125	4	85	4	11	81	0.1358025
NODE_181930_length_291_cov_1.078125	4	85	6	8	81	0.0987654
NODE_181930_length_291_cov_1.078125	4	85	8	26	81	0.3209876
NODE_182112_length_291_cov_1.031250	5	50	0	45	45	1.0000000
NODE_182205_length_291_cov_0.890625	0	55	0	55	55	1.0000000
NODE_182252_length_291_cov_0.802083	80	160	0	2	80	0.0250000
NODE_182252_length_291_cov_0.802083	80	160	2	42	80	0.5250000
NODE_182252_length_291_cov_0.802083	80	160	4	11	80	0.1375000
NODE_182252_length_291_cov_0.802083	80	160	6	25	80	0.3125000
NODE_182491_length_290_cov_96.963351	44	124	0	80	80	1.0000000
NODE_182491_length_290_cov_96.963351	97	177	0	80	80	1.0000000
NODE_182512_length_290_cov_5.968586	89	150	0	5	61	0.0819672
NODE_182512_length_290_cov_5.968586	89	150	2	56	61	0.9180328
NODE_182512_length_290_cov_5.968586	142	203	2	50	61	0.8196721
NODE_182512_length_290_cov_5.968586	142	203	4	11	61	0.1803279
NODE_182535_length_290_cov_4.968586	32	52	0	20	20	1.0000000
NODE_182535_length_290_cov_4.968586	73	93	0	20	20	1.0000000
NODE_182547_length_290_cov_4.670157	63	139	0	76	76	1.0000000
NODE_182550_length_290_cov_4.575916	110	153	2	43	43	1.0000000
NODE_182589_length_290_cov_3.816754	113	186	0	73	73	1.0000000
NODE_182607_length_290_cov_3.612565	114	181	0	22	67	0.3283582
NODE_182607_length_290_cov_3.612565	114	181	2	45	67	0.6716418
NODE_182622_length_290_cov_3.445026	91	150	0	59	59	1.0000000
NODE_182772_length_290_cov_2.596859	189	218	0	29	29	1.0000000
NODE_182844_length_290_cov_2.319372	45	74	4	29	29	1.0000000
NODE_182973_length_290_cov_2.041885	59	139	2	5	80	0.0625000
NODE_182973_length_290_cov_2.041885	59	139	4	29	80	0.3625000
NODE_182973_length_290_cov_2.041885	59	139	6	46	80	0.5750000
NODE_182995_length_290_cov_1.979058	229	271	8	16	42	0.3809524
NODE_182995_length_290_cov_1.979058	229	271	11	1	42	0.0238095
NODE_182995_length_290_cov_1.979058	229	271	12	3	42	0.0714286
NODE_182995_length_290_cov_1.979058	229	271	13	4	42	0.0952381
NODE_182995_length_290_cov_1.979058	229	271	14	18	42	0.4285714
NODE_183288_length_290_cov_1.602094	16	68	2	29	52	0.5576923
NODE_183288_length_290_cov_1.602094	16	68	4	23	52	0.4423077
NODE_183347_length_290_cov_1.575916	173	250	0	77	77	1.0000000
NODE_183373_length_290_cov_1.544503	151	203	0	14	52	0.2692308
NODE_183373_length_290_cov_1.544503	151	203	2	16	52	0.3076923
NODE_183373_length_290_cov_1.544503	151	203	4	22	52	0.4230769
NODE_183403_length_290_cov_1.513089	22	107	0	85	85	1.0000000
NODE_183436_length_290_cov_1.460733	11	91	2	80	80	1.0000000
NODE_183546_length_290_cov_1.335079	91	163	2	37	72	0.5138889
NODE_183546_length_290_cov_1.335079	91	163	4	14	72	0.1944444
NODE_183546_length_290_cov_1.335079	91	163	6	21	72	0.2916667
NODE_183546_length_290_cov_1.335079	144	216	2	12	72	0.1666667
NODE_183546_length_290_cov_1.335079	144	216	4	50	72	0.6944444
NODE_183546_length_290_cov_1.335079	144	216	6	10	72	0.1388889
NODE_183642_length_290_cov_1.314136	0	80	0	52	80	0.6500000
NODE_183642_length_290_cov_1.314136	0	80	2	28	80	0.3500000
NODE_183663_length_290_cov_1.287958	17	97	0	80	80	1.0000000
NODE_183946_length_290_cov_1.068063	0	60	0	60	60	1.0000000
NODE_183946_length_290_cov_1.068063	33	113	0	80	80	1.0000000
NODE_184119_length_290_cov_1.000000	198	254	26	1	56	0.0178571
NODE_184119_length_290_cov_1.000000	198	254	31	2	56	0.0357143
NODE_184119_length_290_cov_1.000000	198	254	35	8	56	0.1428571
NODE_184119_length_290_cov_1.000000	198	254	36	3	56	0.0535714
NODE_184119_length_290_cov_1.000000	198	254	37	29	56	0.5178571
NODE_184119_length_290_cov_1.000000	198	254	38	8	56	0.1428571
NODE_184119_length_290_cov_1.000000	198	254	39	5	56	0.0892857
NODE_184326_length_290_cov_0.832461	154	236	0	82	82	1.0000000
NODE_184585_length_290_cov_0.701571	201	281	0	80	80	1.0000000
NODE_184716_length_289_cov_554.947368	45	125	135	1	80	0.0125000
NODE_184716_length_289_cov_554.947368	45	125	139	1	80	0.0125000
NODE_184716_length_289_cov_554.947368	45	125	141	1	80	0.0125000
NODE_184716_length_289_cov_554.947368	45	125	143	1	80	0.0125000
NODE_184716_length_289_cov_554.947368	45	125	145	1	80	0.0125000
NODE_184716_length_289_cov_554.947368	45	125	147	2	80	0.0250000
NODE_184716_length_289_cov_554.947368	45	125	149	3	80	0.0375000
NODE_184716_length_289_cov_554.947368	45	125	150	3	80	0.0375000
NODE_184716_length_289_cov_554.947368	45	125	151	1	80	0.0125000
NODE_184716_length_289_cov_554.947368	45	125	152	1	80	0.0125000
NODE_184716_length_289_cov_554.947368	45	125	154	5	80	0.0625000
NODE_184716_length_289_cov_554.947368	45	125	155	1	80	0.0125000
NODE_184716_length_289_cov_554.947368	45	125	156	2	80	0.0250000
NODE_184716_length_289_cov_554.947368	45	125	160	1	80	0.0125000
NODE_184716_length_289_cov_554.947368	45	125	162	1	80	0.0125000
NODE_184716_length_289_cov_554.947368	45	125	163	4	80	0.0500000
NODE_184716_length_289_cov_554.947368	45	125	164	2	80	0.0250000
NODE_184716_length_289_cov_554.947368	45	125	165	2	80	0.0250000
NODE_184716_length_289_cov_554.947368	45	125	166	2	80	0.0250000
NODE_184716_length_289_cov_554.947368	45	125	167	1	80	0.0125000
NODE_184716_length_289_cov_554.947368	45	125	168	2	80	0.0250000
NODE_184716_length_289_cov_554.947368	45	125	169	11	80	0.1375000
NODE_184716_length_289_cov_554.947368	45	125	171	31	80	0.3875000
NODE_184729_length_289_cov_7.436842	181	229	0	48	48	1.0000000
NODE_184745_length_289_cov_5.789474	35	100	0	65	65	1.0000000
NODE_184745_length_289_cov_5.789474	85	153	0	68	68	1.0000000
NODE_184745_length_289_cov_5.789474	146	181	0	35	35	1.0000000
NODE_184781_length_289_cov_4.515789	192	254	0	62	62	1.0000000
NODE_184806_length_289_cov_4.136842	101	148	0	47	47	1.0000000
NODE_184892_length_289_cov_2.973684	38	83	0	45	45	1.0000000
NODE_184960_length_289_cov_2.678947	105	168	0	14	63	0.2222222
NODE_184960_length_289_cov_2.678947	105	168	2	6	63	0.0952381
NODE_184960_length_289_cov_2.678947	105	168	4	43	63	0.6825397
NODE_184960_length_289_cov_2.678947	158	204	4	46	46	1.0000000
NODE_184963_length_289_cov_2.673684	216	263	0	47	47	1.0000000
NODE_185036_length_289_cov_2.378947	233	289	0	56	56	1.0000000
NODE_185152_length_289_cov_2.089474	26	91	0	65	65	1.0000000
NODE_185213_length_289_cov_1.921053	0	54	2	54	54	1.0000000
NODE_185383_length_289_cov_1.642105	58	123	0	65	65	1.0000000
NODE_185570_length_289_cov_1.547368	81	124	0	40	43	0.9302326
NODE_185570_length_289_cov_1.547368	81	124	2	3	43	0.0697674
NODE_185617_length_289_cov_1.489474	192	274	0	82	82	1.0000000
NODE_185622_length_289_cov_1.484211	50	69	0	19	19	1.0000000
NODE_185708_length_289_cov_1.357895	31	74	0	43	43	1.0000000
NODE_185852_length_289_cov_1.278947	239	270	0	31	31	1.0000000
NODE_185864_length_289_cov_1.252632	23	66	2	43	43	1.0000000
NODE_185926_length_289_cov_1.168421	40	100	0	60	60	1.0000000
NODE_185937_length_289_cov_1.152632	0	50	0	50	50	1.0000000
NODE_185937_length_289_cov_1.152632	41	103	0	62	62	1.0000000
NODE_186095_length_289_cov_1.073684	152	198	0	46	46	1.0000000
NODE_186491_length_289_cov_0.878947	113	193	0	8	80	0.1000000
NODE_186491_length_289_cov_0.878947	113	193	2	72	80	0.9000000
NODE_186491_length_289_cov_0.878947	166	246	0	20	80	0.2500000
NODE_186491_length_289_cov_0.878947	166	246	2	60	80	0.7500000
NODE_186507_length_289_cov_0.863158	116	211	2	61	95	0.6421053
NODE_186507_length_289_cov_0.863158	116	211	6	34	95	0.3578947
NODE_186515_length_289_cov_0.857895	6	75	0	69	69	1.0000000
NODE_186547_length_289_cov_0.831579	230	289	0	33	59	0.5593221
NODE_186547_length_289_cov_0.831579	230	289	2	17	59	0.2881356
NODE_186547_length_289_cov_0.831579	230	289	4	2	59	0.0338983
NODE_186547_length_289_cov_0.831579	230	289	5	5	59	0.0847458
NODE_186547_length_289_cov_0.831579	230	289	6	2	59	0.0338983
NODE_186631_length_289_cov_0.805263	98	159	2	44	61	0.7213115
NODE_186631_length_289_cov_0.805263	98	159	4	17	61	0.2786885
NODE_186865_length_289_cov_0.568421	141	213	0	72	72	1.0000000
NODE_186934_length_288_cov_11.089947	135	195	0	55	60	0.9166667
NODE_186934_length_288_cov_11.089947	135	195	6	5	60	0.0833333
NODE_187025_length_288_cov_3.587302	108	188	0	11	80	0.1375000
NODE_187025_length_288_cov_3.587302	108	188	2	69	80	0.8625000
NODE_187049_length_288_cov_3.296296	61	125	0	64	64	1.0000000
NODE_187049_length_288_cov_3.296296	102	178	0	76	76	1.0000000
NODE_187062_length_288_cov_3.206349	149	202	0	53	53	1.0000000
NODE_187170_length_288_cov_2.539683	4	68	22	1	64	0.0156250
NODE_187170_length_288_cov_2.539683	4	68	24	1	64	0.0156250
NODE_187170_length_288_cov_2.539683	4	68	28	1	64	0.0156250
NODE_187170_length_288_cov_2.539683	4	68	32	2	64	0.0312500
NODE_187170_length_288_cov_2.539683	4	68	34	1	64	0.0156250
NODE_187170_length_288_cov_2.539683	4	68	36	1	64	0.0156250
NODE_187170_length_288_cov_2.539683	4	68	38	1	64	0.0156250
NODE_187170_length_288_cov_2.539683	4	68	40	4	64	0.0625000
NODE_187170_length_288_cov_2.539683	4	68	44	6	64	0.0937500
NODE_187170_length_288_cov_2.539683	4	68	46	5	64	0.0781250
NODE_187170_length_288_cov_2.539683	4	68	48	8	64	0.1250000
NODE_187170_length_288_cov_2.539683	4	68	50	3	64	0.0468750
NODE_187170_length_288_cov_2.539683	4	68	52	1	64	0.0156250
NODE_187170_length_288_cov_2.539683	4	68	54	4	64	0.0625000
NODE_187170_length_288_cov_2.539683	4	68	56	19	64	0.2968750
NODE_187170_length_288_cov_2.539683	4	68	58	5	64	0.0781250
NODE_187170_length_288_cov_2.539683	4	68	60	1	64	0.0156250
NODE_187187_length_288_cov_2.465608	137	182	0	11	45	0.2444444
NODE_187187_length_288_cov_2.465608	137	182	4	34	45	0.7555556
NODE_187191_length_288_cov_2.449735	216	278	2	62	62	1.0000000
NODE_187191_length_288_cov_2.449735	237	273	2	36	36	1.0000000
NODE_187248_length_288_cov_2.275132	10	46	2	36	36	1.0000000
NODE_187248_length_288_cov_2.275132	13	86	2	40	73	0.5479452
NODE_187248_length_288_cov_2.275132	13	86	4	33	73	0.4520548
NODE_187248_length_288_cov_2.275132	47	100	2	14	53	0.2641509
NODE_187248_length_288_cov_2.275132	47	100	4	39	53	0.7358491
NODE_187318_length_288_cov_2.153439	50	81	0	31	31	1.0000000
NODE_187431_length_288_cov_1.915344	0	75	0	75	75	1.0000000
NODE_187443_length_288_cov_1.888889	49	125	0	2	76	0.0263158
NODE_187443_length_288_cov_1.888889	49	125	2	18	76	0.2368421
NODE_187443_length_288_cov_1.888889	49	125	4	9	76	0.1184211
NODE_187443_length_288_cov_1.888889	49	125	6	47	76	0.6184211
NODE_187484_length_288_cov_1.878307	0	42	0	42	42	1.0000000
NODE_187484_length_288_cov_1.878307	15	63	0	48	48	1.0000000
NODE_187810_length_288_cov_1.492063	0	42	0	42	42	1.0000000
NODE_188135_length_288_cov_1.158730	213	288	0	75	75	1.0000000
NODE_188161_length_288_cov_1.100529	256	288	2	1	32	0.0312500
NODE_188161_length_288_cov_1.100529	256	288	4	31	32	0.9687500
NODE_188169_length_288_cov_1.079365	10	74	0	51	64	0.7968750
NODE_188169_length_288_cov_1.079365	10	74	2	13	64	0.2031250
NODE_188169_length_288_cov_1.079365	65	110	2	32	45	0.7111111
NODE_188169_length_288_cov_1.079365	65	110	4	13	45	0.2888889
NODE_188760_length_288_cov_0.809524	141	170	4	12	29	0.4137931
NODE_188760_length_288_cov_0.809524	141	170	5	9	29	0.3103448
NODE_188760_length_288_cov_0.809524	141	170	6	8	29	0.2758621
NODE_189068_length_287_cov_7.632979	117	184	19	1	67	0.0149254
NODE_189068_length_287_cov_7.632979	117	184	20	27	67	0.4029851
NODE_189068_length_287_cov_7.632979	117	184	22	39	67	0.5820895
NODE_189079_length_287_cov_6.510638	20	100	0	80	80	1.0000000
NODE_189097_length_287_cov_5.781915	164	246	2	80	82	0.9756098
NODE_189097_length_287_cov_5.781915	164	246	4	2	82	0.0243902
NODE_189182_length_287_cov_3.590426	114	194	2	1	80	0.0125000
NODE_189182_length_287_cov_3.590426	114	194	3	1	80	0.0125000
NODE_189182_length_287_cov_3.590426	114	194	4	59	80	0.7375000
NODE_189182_length_287_cov_3.590426	114	194	6	19	80	0.2375000
NODE_189192_length_287_cov_3.452128	0	52	0	41	52	0.7884616
NODE_189192_length_287_cov_3.452128	0	52	1	9	52	0.1730769
NODE_189192_length_287_cov_3.452128	0	52	2	2	52	0.0384615
NODE_189208_length_287_cov_3.281915	263	286	0	17	23	0.7391304
NODE_189208_length_287_cov_3.281915	263	286	4	6	23	0.2608696
NODE_189266_length_287_cov_2.936170	41	110	0	69	69	1.0000000
NODE_189266_length_287_cov_2.936170	41	111	0	70	70	1.0000000
NODE_189266_length_287_cov_2.936170	94	167	0	73	73	1.0000000
NODE_189266_length_287_cov_2.936170	156	179	0	23	23	1.0000000
NODE_189330_length_287_cov_2.638298	22	86	0	64	64	1.0000000
NODE_189381_length_287_cov_2.436170	182	262	0	80	80	1.0000000
NODE_189582_length_287_cov_1.984043	137	166	0	11	29	0.3793103
NODE_189582_length_287_cov_1.984043	137	166	2	1	29	0.0344828
NODE_189582_length_287_cov_1.984043	137	166	4	14	29	0.4827586
NODE_189582_length_287_cov_1.984043	137	166	6	3	29	0.1034483
NODE_189594_length_287_cov_1.941489	56	123	0	61	67	0.9104478
NODE_189594_length_287_cov_1.941489	56	123	2	6	67	0.0895522
NODE_189614_length_287_cov_1.904255	8	51	2	38	43	0.8837209
NODE_189614_length_287_cov_1.904255	8	51	4	5	43	0.1162791
NODE_189710_length_287_cov_1.803191	146	217	0	4	71	0.0563380
NODE_189710_length_287_cov_1.803191	146	217	2	23	71	0.3239437
NODE_189710_length_287_cov_1.803191	146	217	4	44	71	0.6197183
NODE_189843_length_287_cov_1.627660	113	175	10	28	62	0.4516129
NODE_189843_length_287_cov_1.627660	113	175	12	34	62	0.5483871
NODE_189843_length_287_cov_1.627660	148	228	8	17	80	0.2125000
NODE_189843_length_287_cov_1.627660	148	228	10	29	80	0.3625000
NODE_189843_length_287_cov_1.627660	148	228	11	2	80	0.0250000
NODE_189843_length_287_cov_1.627660	148	228	12	32	80	0.4000000
NODE_189864_length_287_cov_1.627660	14	59	0	45	45	1.0000000
NODE_189864_length_287_cov_1.627660	41	112	0	71	71	1.0000000
NODE_189949_length_287_cov_1.574468	150	220	0	70	70	1.0000000
NODE_189985_length_287_cov_1.531915	123	154	0	31	31	1.0000000
NODE_190122_length_287_cov_1.356383	93	147	0	44	54	0.8148148
NODE_190122_length_287_cov_1.356383	93	147	2	10	54	0.1851852
NODE_190142_length_287_cov_1.356383	135	199	2	58	64	0.9062500
NODE_190142_length_287_cov_1.356383	135	199	4	6	64	0.0937500
NODE_190189_length_287_cov_1.335106	149	201	0	52	52	1.0000000
NODE_190654_length_287_cov_1.037234	23	44	0	21	21	1.0000000
NODE_190701_length_287_cov_0.994681	206	225	0	19	19	1.0000000
NODE_190802_length_287_cov_0.898936	0	57	0	14	57	0.2456140
NODE_190802_length_287_cov_0.898936	0	57	2	5	57	0.0877193
NODE_190802_length_287_cov_0.898936	0	57	6	15	57	0.2631579
NODE_190802_length_287_cov_0.898936	0	57	8	6	57	0.1052632
NODE_190802_length_287_cov_0.898936	0	57	10	1	57	0.0175439
NODE_190802_length_287_cov_0.898936	0	57	12	16	57	0.2807018
NODE_190873_length_287_cov_0.840426	46	121	0	39	75	0.5200000
NODE_190873_length_287_cov_0.840426	46	121	2	36	75	0.4800000
NODE_191306_length_286_cov_141.540107	4	63	0	59	59	1.0000000
NODE_191389_length_286_cov_3.935829	79	123	0	44	44	1.0000000
NODE_191391_length_286_cov_3.871658	45	121	0	76	76	1.0000000
NODE_191391_length_286_cov_3.871658	102	169	0	37	67	0.5522388
NODE_191391_length_286_cov_3.871658	102	169	2	30	67	0.4477612
NODE_191393_length_286_cov_3.812834	62	142	4	56	80	0.7000000
NODE_191393_length_286_cov_3.812834	62	142	6	24	80	0.3000000
NODE_191430_length_286_cov_3.352941	63	143	0	80	80	1.0000000
NODE_191430_length_286_cov_3.352941	116	196	0	80	80	1.0000000
NODE_191466_length_286_cov_3.101604	217	271	0	54	54	1.0000000
NODE_191509_length_286_cov_2.823529	56	122	4	2	66	0.0303030
NODE_191509_length_286_cov_2.823529	56	122	6	5	66	0.0757576
NODE_191509_length_286_cov_2.823529	56	122	8	11	66	0.1666667
NODE_191509_length_286_cov_2.823529	56	122	11	1	66	0.0151515
NODE_191509_length_286_cov_2.823529	56	122	13	1	66	0.0151515
NODE_191509_length_286_cov_2.823529	56	122	15	1	66	0.0151515
NODE_191509_length_286_cov_2.823529	56	122	19	1	66	0.0151515
NODE_191509_length_286_cov_2.823529	56	122	22	1	66	0.0151515
NODE_191509_length_286_cov_2.823529	56	122	24	1	66	0.0151515
NODE_191509_length_286_cov_2.823529	56	122	28	2	66	0.0303030
NODE_191509_length_286_cov_2.823529	56	122	32	2	66	0.0303030
NODE_191509_length_286_cov_2.823529	56	122	36	2	66	0.0303030
NODE_191509_length_286_cov_2.823529	56	122	40	1	66	0.0151515
NODE_191509_length_286_cov_2.823529	56	122	42	1	66	0.0151515
NODE_191509_length_286_cov_2.823529	56	122	46	2	66	0.0303030
NODE_191509_length_286_cov_2.823529	56	122	50	1	66	0.0151515
NODE_191509_length_286_cov_2.823529	56	122	52	1	66	0.0151515
NODE_191509_length_286_cov_2.823529	56	122	54	1	66	0.0151515
NODE_191509_length_286_cov_2.823529	56	122	56	1	66	0.0151515
NODE_191509_length_286_cov_2.823529	56	122	60	1	66	0.0151515
NODE_191509_length_286_cov_2.823529	56	122	64	1	66	0.0151515
NODE_191509_length_286_cov_2.823529	56	122	66	2	66	0.0303030
NODE_191509_length_286_cov_2.823529	56	122	72	6	66	0.0909091
NODE_191509_length_286_cov_2.823529	56	122	74	2	66	0.0303030
NODE_191509_length_286_cov_2.823529	56	122	76	2	66	0.0303030
NODE_191509_length_286_cov_2.823529	56	122	79	3	66	0.0454545
NODE_191509_length_286_cov_2.823529	56	122	85	4	66	0.0606061
NODE_191509_length_286_cov_2.823529	56	122	86	1	66	0.0151515
NODE_191509_length_286_cov_2.823529	56	122	90	1	66	0.0151515
NODE_191509_length_286_cov_2.823529	56	122	92	3	66	0.0454545
NODE_191509_length_286_cov_2.823529	56	122	94	2	66	0.0303030
NODE_191598_length_286_cov_2.438503	151	218	0	67	67	1.0000000
NODE_191754_length_286_cov_2.037433	57	138	0	5	81	0.0617284
NODE_191754_length_286_cov_2.037433	57	138	2	46	81	0.5679013
NODE_191754_length_286_cov_2.037433	57	138	4	4	81	0.0493827
NODE_191754_length_286_cov_2.037433	57	138	6	26	81	0.3209876
NODE_191892_length_286_cov_1.807487	186	232	0	46	46	1.0000000
NODE_191892_length_286_cov_1.807487	239	285	0	46	46	1.0000000
NODE_192100_length_286_cov_1.566845	112	160	0	8	48	0.1666667
NODE_192100_length_286_cov_1.566845	112	160	2	40	48	0.8333333
NODE_192100_length_286_cov_1.566845	165	213	0	48	48	1.0000000
NODE_192150_length_286_cov_1.497326	107	160	2	53	53	1.0000000
NODE_192233_length_286_cov_1.363636	20	87	2	67	67	1.0000000
NODE_192302_length_286_cov_1.358289	218	262	0	1	44	0.0227273
NODE_192302_length_286_cov_1.358289	218	262	2	43	44	0.9772727
NODE_192357_length_286_cov_1.304813	147	205	2	7	58	0.1206897
NODE_192357_length_286_cov_1.304813	147	205	4	51	58	0.8793104
NODE_192427_length_286_cov_1.203209	30	76	0	46	46	1.0000000
NODE_192427_length_286_cov_1.203209	49	129	0	80	80	1.0000000
NODE_192757_length_286_cov_1.074866	160	220	0	60	60	1.0000000
NODE_193023_length_286_cov_0.871658	218	279	0	61	61	1.0000000
NODE_193038_length_286_cov_0.855615	224	281	0	53	57	0.9298246
NODE_193038_length_286_cov_0.855615	224	281	2	4	57	0.0701754
NODE_193362_length_286_cov_0.625668	110	190	0	55	80	0.6875000
NODE_193362_length_286_cov_0.625668	110	190	2	25	80	0.3125000
NODE_193362_length_286_cov_0.625668	163	240	0	77	77	1.0000000
NODE_193481_length_285_cov_7.392473	91	152	0	61	61	1.0000000
NODE_193481_length_285_cov_7.392473	150	184	0	34	34	1.0000000
NODE_193513_length_285_cov_4.650538	0	74	0	74	74	1.0000000
NODE_193513_length_285_cov_4.650538	47	127	0	80	80	1.0000000
NODE_193513_length_285_cov_4.650538	123	203	0	80	80	1.0000000
NODE_193513_length_285_cov_4.650538	176	256	0	80	80	1.0000000
NODE_193532_length_285_cov_4.091398	91	154	0	63	63	1.0000000
NODE_193538_length_285_cov_4.010753	120	201	0	81	81	1.0000000
NODE_193547_length_285_cov_3.854839	97	151	0	54	54	1.0000000
NODE_193547_length_285_cov_3.854839	106	153	0	46	47	0.9787234
NODE_193547_length_285_cov_3.854839	106	153	2	1	47	0.0212766
NODE_193566_length_285_cov_3.607527	197	258	0	16	61	0.2622951
NODE_193566_length_285_cov_3.607527	197	258	2	17	61	0.2786885
NODE_193566_length_285_cov_3.607527	197	258	4	13	61	0.2131148
NODE_193566_length_285_cov_3.607527	197	258	8	9	61	0.1475410
NODE_193566_length_285_cov_3.607527	197	258	10	6	61	0.0983607
NODE_193624_length_285_cov_3.037634	190	272	0	82	82	1.0000000
NODE_193660_length_285_cov_2.806452	215	279	0	64	64	1.0000000
NODE_193688_length_285_cov_2.736559	106	173	2	67	67	1.0000000
NODE_193784_length_285_cov_2.311828	220	262	0	42	42	1.0000000
NODE_193883_length_285_cov_2.043011	77	150	0	73	73	1.0000000
NODE_193883_length_285_cov_2.043011	155	197	0	42	42	1.0000000
NODE_193978_length_285_cov_1.876344	67	110	0	43	43	1.0000000
NODE_194150_length_285_cov_1.645161	112	160	0	48	48	1.0000000
NODE_194260_length_285_cov_1.548387	124	172	0	29	48	0.6041667
NODE_194260_length_285_cov_1.548387	124	172	2	19	48	0.3958333
NODE_194332_length_285_cov_1.456989	210	277	0	67	67	1.0000000
NODE_194499_length_285_cov_1.327957	114	191	5	1	77	0.0129870
NODE_194499_length_285_cov_1.327957	114	191	6	7	77	0.0909091
NODE_194499_length_285_cov_1.327957	114	191	8	4	77	0.0519481
NODE_194499_length_285_cov_1.327957	114	191	10	4	77	0.0519481
NODE_194499_length_285_cov_1.327957	114	191	12	9	77	0.1168831
NODE_194499_length_285_cov_1.327957	114	191	16	1	77	0.0129870
NODE_194499_length_285_cov_1.327957	114	191	20	3	77	0.0389610
NODE_194499_length_285_cov_1.327957	114	191	22	2	77	0.0259740
NODE_194499_length_285_cov_1.327957	114	191	24	4	77	0.0519481
NODE_194499_length_285_cov_1.327957	114	191	26	3	77	0.0389610
NODE_194499_length_285_cov_1.327957	114	191	28	4	77	0.0519481
NODE_194499_length_285_cov_1.327957	114	191	30	5	77	0.0649351
NODE_194499_length_285_cov_1.327957	114	191	32	30	77	0.3896104
NODE_194865_length_285_cov_1.096774	175	229	0	41	54	0.7592593
NODE_194865_length_285_cov_1.096774	175	229	2	13	54	0.2407407
NODE_194865_length_285_cov_1.096774	230	271	0	41	41	1.0000000
NODE_195109_length_285_cov_0.924731	128	208	2	16	80	0.2000000
NODE_195109_length_285_cov_0.924731	128	208	4	64	80	0.8000000
NODE_195115_length_285_cov_0.919355	5	65	0	60	60	1.0000000
NODE_195124_length_285_cov_0.913978	6	80	0	74	74	1.0000000
NODE_195124_length_285_cov_0.913978	58	133	0	73	75	0.9733334
NODE_195124_length_285_cov_0.913978	58	133	2	2	75	0.0266667
NODE_195642_length_284_cov_7.967568	143	207	2	3	64	0.0468750
NODE_195642_length_284_cov_7.967568	143	207	4	4	64	0.0625000
NODE_195642_length_284_cov_7.967568	143	207	6	4	64	0.0625000
NODE_195642_length_284_cov_7.967568	143	207	8	29	64	0.4531250
NODE_195642_length_284_cov_7.967568	143	207	12	24	64	0.3750000
NODE_195667_length_284_cov_5.016216	115	169	0	54	54	1.0000000
NODE_195715_length_284_cov_3.913514	26	82	0	56	56	1.0000000
NODE_195760_length_284_cov_3.405405	209	283	0	74	74	1.0000000
NODE_195863_length_284_cov_2.718919	138	162	0	9	24	0.3750000
NODE_195863_length_284_cov_2.718919	138	162	1	1	24	0.0416667
NODE_195863_length_284_cov_2.718919	138	162	2	14	24	0.5833333
NODE_195863_length_284_cov_2.718919	138	215	0	9	77	0.1168831
NODE_195863_length_284_cov_2.718919	138	215	1	1	77	0.0129870
NODE_195863_length_284_cov_2.718919	138	215	2	16	77	0.2077922
NODE_195863_length_284_cov_2.718919	138	215	4	51	77	0.6623377
NODE_196090_length_284_cov_2.097297	46	122	0	60	76	0.7894737
NODE_196090_length_284_cov_2.097297	46	122	2	16	76	0.2105263
NODE_196253_length_284_cov_1.756757	27	100	0	18	73	0.2465753
NODE_196253_length_284_cov_1.756757	27	100	2	39	73	0.5342466
NODE_196253_length_284_cov_1.756757	27	100	4	16	73	0.2191781
NODE_196253_length_284_cov_1.756757	97	153	2	7	56	0.1250000
NODE_196253_length_284_cov_1.756757	97	153	4	49	56	0.8750000
NODE_196273_length_284_cov_1.713514	24	59	0	35	35	1.0000000
NODE_196372_length_284_cov_1.654054	207	251	0	44	44	1.0000000
NODE_196426_length_284_cov_1.643243	180	239	0	59	59	1.0000000
NODE_196505_length_284_cov_1.540541	148	186	8	31	38	0.8157895
NODE_196505_length_284_cov_1.540541	148	186	10	7	38	0.1842105
NODE_196670_length_284_cov_1.378378	65	145	2	5	80	0.0625000
NODE_196670_length_284_cov_1.378378	65	145	4	14	80	0.1750000
NODE_196670_length_284_cov_1.378378	65	145	6	34	80	0.4250000
NODE_196670_length_284_cov_1.378378	65	145	8	6	80	0.0750000
NODE_196670_length_284_cov_1.378378	65	145	10	2	80	0.0250000
NODE_196670_length_284_cov_1.378378	65	145	12	8	80	0.1000000
NODE_196670_length_284_cov_1.378378	65	145	13	8	80	0.1000000
NODE_196670_length_284_cov_1.378378	65	145	14	3	80	0.0375000
NODE_196670_length_284_cov_1.378378	118	165	8	6	47	0.1276596
NODE_196670_length_284_cov_1.378378	118	165	10	2	47	0.0425532
NODE_196670_length_284_cov_1.378378	118	165	12	8	47	0.1702128
NODE_196670_length_284_cov_1.378378	118	165	13	8	47	0.1702128
NODE_196670_length_284_cov_1.378378	118	165	14	13	47	0.2765957
NODE_196670_length_284_cov_1.378378	118	165	16	3	47	0.0638298
NODE_196670_length_284_cov_1.378378	118	165	18	7	47	0.1489362
NODE_196733_length_284_cov_1.329730	114	170	0	56	56	1.0000000
NODE_197755_length_284_cov_0.686486	13	94	0	81	81	1.0000000
NODE_197755_length_284_cov_0.686486	13	94	0	81	81	1.0000000
NODE_197755_length_284_cov_0.686486	13	94	0	81	81	1.0000000
NODE_197835_length_284_cov_0.551351	167	219	0	52	52	1.0000000
NODE_197936_length_283_cov_4.434783	81	137	16	13	56	0.2321429
NODE_197936_length_283_cov_4.434783	81	137	18	3	56	0.0535714
NODE_197936_length_283_cov_4.434783	81	137	20	2	56	0.0357143
NODE_197936_length_283_cov_4.434783	81	137	22	2	56	0.0357143
NODE_197936_length_283_cov_4.434783	81	137	24	10	56	0.1785714
NODE_197936_length_283_cov_4.434783	81	137	26	1	56	0.0178571
NODE_197936_length_283_cov_4.434783	81	137	28	1	56	0.0178571
NODE_197936_length_283_cov_4.434783	81	137	30	7	56	0.1250000
NODE_197936_length_283_cov_4.434783	81	137	34	1	56	0.0178571
NODE_197936_length_283_cov_4.434783	81	137	36	1	56	0.0178571
NODE_197936_length_283_cov_4.434783	81	137	38	1	56	0.0178571
NODE_197936_length_283_cov_4.434783	81	137	40	2	56	0.0357143
NODE_197936_length_283_cov_4.434783	81	137	42	12	56	0.2142857
NODE_197936_length_283_cov_4.434783	114	190	0	1	76	0.0131579
NODE_197936_length_283_cov_4.434783	114	190	1	2	76	0.0263158
NODE_197936_length_283_cov_4.434783	114	190	3	1	76	0.0131579
NODE_197936_length_283_cov_4.434783	114	190	5	3	76	0.0394737
NODE_197936_length_283_cov_4.434783	114	190	6	15	76	0.1973684
NODE_197936_length_283_cov_4.434783	114	190	8	11	76	0.1447368
NODE_197936_length_283_cov_4.434783	114	190	10	9	76	0.1184211
NODE_197936_length_283_cov_4.434783	114	190	12	4	76	0.0526316
NODE_197936_length_283_cov_4.434783	114	190	14	6	76	0.0789474
NODE_197936_length_283_cov_4.434783	114	190	16	14	76	0.1842105
NODE_197936_length_283_cov_4.434783	114	190	18	3	76	0.0394737
NODE_197936_length_283_cov_4.434783	114	190	20	2	76	0.0263158
NODE_197936_length_283_cov_4.434783	114	190	22	2	76	0.0263158
NODE_197936_length_283_cov_4.434783	114	190	24	3	76	0.0394737
NODE_197936_length_283_cov_4.434783	190	270	0	13	80	0.1625000
NODE_197936_length_283_cov_4.434783	190	270	2	67	80	0.8375000
NODE_197937_length_283_cov_4.429348	104	168	6	5	64	0.0781250
NODE_197937_length_283_cov_4.429348	104	168	8	31	64	0.4843750
NODE_197937_length_283_cov_4.429348	104	168	9	5	64	0.0781250
NODE_197937_length_283_cov_4.429348	104	168	11	23	64	0.3593750
NODE_197937_length_283_cov_4.429348	104	168	6	5	64	0.0781250
NODE_197937_length_283_cov_4.429348	104	168	8	31	64	0.4843750
NODE_197937_length_283_cov_4.429348	104	168	9	5	64	0.0781250
NODE_197937_length_283_cov_4.429348	104	168	11	23	64	0.3593750
NODE_197937_length_283_cov_4.429348	141	207	3	6	66	0.0909091
NODE_197937_length_283_cov_4.429348	141	207	4	13	66	0.1969697
NODE_197937_length_283_cov_4.429348	141	207	5	14	66	0.2121212
NODE_197937_length_283_cov_4.429348	141	207	7	6	66	0.0909091
NODE_197937_length_283_cov_4.429348	141	207	9	5	66	0.0757576
NODE_197937_length_283_cov_4.429348	141	207	11	22	66	0.3333333
NODE_197937_length_283_cov_4.429348	141	221	3	6	80	0.0750000
NODE_197937_length_283_cov_4.429348	141	221	4	27	80	0.3375000
NODE_197937_length_283_cov_4.429348	141	221	5	14	80	0.1750000
NODE_197937_length_283_cov_4.429348	141	221	7	6	80	0.0750000
NODE_197937_length_283_cov_4.429348	141	221	9	5	80	0.0625000
NODE_197937_length_283_cov_4.429348	141	221	11	22	80	0.2750000
NODE_198007_length_283_cov_3.369565	0	35	0	35	35	1.0000000
NODE_198022_length_283_cov_3.309783	47	91	0	1	44	0.0227273
NODE_198022_length_283_cov_3.309783	47	91	2	43	44	0.9772727
NODE_198081_length_283_cov_2.923913	95	137	4	3	42	0.0714286
NODE_198081_length_283_cov_2.923913	95	137	6	6	42	0.1428571
NODE_198081_length_283_cov_2.923913	95	137	10	19	42	0.4523810
NODE_198081_length_283_cov_2.923913	95	137	12	14	42	0.3333333
NODE_198081_length_283_cov_2.923913	110	190	10	13	80	0.1625000
NODE_198081_length_283_cov_2.923913	110	190	12	67	80	0.8375000
NODE_198098_length_283_cov_2.782609	120	200	0	80	80	1.0000000
NODE_198109_length_283_cov_2.771739	29	72	0	43	43	1.0000000
NODE_198171_length_283_cov_2.494565	186	229	0	43	43	1.0000000
NODE_198176_length_283_cov_2.494565	181	238	2	57	57	1.0000000
NODE_198271_length_283_cov_2.217391	222	281	0	59	59	1.0000000
NODE_198518_length_283_cov_1.777174	40	120	0	80	80	1.0000000
NODE_198745_length_283_cov_1.543478	125	161	0	9	36	0.2500000
NODE_198745_length_283_cov_1.543478	125	161	4	4	36	0.1111111
NODE_198745_length_283_cov_1.543478	125	161	10	2	36	0.0555556
NODE_198745_length_283_cov_1.543478	125	161	12	11	36	0.3055556
NODE_198745_length_283_cov_1.543478	125	161	14	5	36	0.1388889
NODE_198745_length_283_cov_1.543478	125	161	16	1	36	0.0277778
NODE_198745_length_283_cov_1.543478	125	161	17	4	36	0.1111111
NODE_198751_length_283_cov_1.538043	182	203	0	20	21	0.9523810
NODE_198751_length_283_cov_1.538043	182	203	5	1	21	0.0476190
NODE_198986_length_283_cov_1.304348	208	270	8	2	62	0.0322581
NODE_198986_length_283_cov_1.304348	208	270	10	5	62	0.0806452
NODE_198986_length_283_cov_1.304348	208	270	12	2	62	0.0322581
NODE_198986_length_283_cov_1.304348	208	270	14	12	62	0.1935484
NODE_198986_length_283_cov_1.304348	208	270	16	41	62	0.6612903
NODE_199042_length_283_cov_1.211957	157	234	0	77	77	1.0000000
NODE_199070_length_283_cov_1.168478	183	250	0	27	67	0.4029851
NODE_199070_length_283_cov_1.168478	183	250	2	40	67	0.5970149
NODE_199606_length_283_cov_0.918478	146	226	0	80	80	1.0000000
NODE_199606_length_283_cov_0.918478	199	279	0	80	80	1.0000000
NODE_199641_length_283_cov_0.885870	143	205	0	62	62	1.0000000
NODE_199958_length_283_cov_0.706522	119	159	0	40	40	1.0000000
NODE_200085_length_282_cov_51.027322	219	280	0	61	61	1.0000000
NODE_200085_length_282_cov_51.027322	219	282	0	63	63	1.0000000
NODE_200166_length_282_cov_3.901639	38	118	0	80	80	1.0000000
NODE_200166_length_282_cov_3.901639	91	171	0	80	80	1.0000000
NODE_200171_length_282_cov_3.874317	96	116	0	3	20	0.1500000
NODE_200171_length_282_cov_3.874317	96	116	2	17	20	0.8500000
NODE_200201_length_282_cov_3.562842	224	279	0	55	55	1.0000000
NODE_200270_length_282_cov_2.890710	41	123	2	12	82	0.1463415
NODE_200270_length_282_cov_2.890710	41	123	4	70	82	0.8536586
NODE_200276_length_282_cov_2.846995	26	47	2	21	21	1.0000000
NODE_200304_length_282_cov_2.770492	145	225	2	11	80	0.1375000
NODE_200304_length_282_cov_2.770492	145	225	4	10	80	0.1250000
NODE_200304_length_282_cov_2.770492	145	225	6	59	80	0.7375000
NODE_200304_length_282_cov_2.770492	198	278	0	50	80	0.6250000
NODE_200304_length_282_cov_2.770492	198	278	2	14	80	0.1750000
NODE_200304_length_282_cov_2.770492	198	278	4	10	80	0.1250000
NODE_200304_length_282_cov_2.770492	198	278	6	6	80	0.0750000
NODE_200329_length_282_cov_2.655738	46	119	2	29	73	0.3972603
NODE_200329_length_282_cov_2.655738	46	119	4	24	73	0.3287671
NODE_200329_length_282_cov_2.655738	46	119	6	20	73	0.2739726
NODE_200329_length_282_cov_2.655738	100	159	0	33	59	0.5593221
NODE_200329_length_282_cov_2.655738	100	159	2	26	59	0.4406780
NODE_200335_length_282_cov_2.622951	0	36	0	2	36	0.0555556
NODE_200335_length_282_cov_2.622951	0	36	2	23	36	0.6388889
NODE_200335_length_282_cov_2.622951	0	36	4	5	36	0.1388889
NODE_200335_length_282_cov_2.622951	0	36	5	1	36	0.0277778
NODE_200335_length_282_cov_2.622951	0	36	6	5	36	0.1388889
NODE_200335_length_282_cov_2.622951	9	89	2	16	80	0.2000000
NODE_200335_length_282_cov_2.622951	9	89	4	16	80	0.2000000
NODE_200335_length_282_cov_2.622951	9	89	5	1	80	0.0125000
NODE_200335_length_282_cov_2.622951	9	89	6	47	80	0.5875000
NODE_200336_length_282_cov_2.622951	38	111	0	6	73	0.0821918
NODE_200336_length_282_cov_2.622951	38	111	2	67	73	0.9178082
NODE_200336_length_282_cov_2.622951	98	144	0	20	46	0.4347826
NODE_200336_length_282_cov_2.622951	98	144	2	26	46	0.5652174
NODE_200367_length_282_cov_2.508197	138	186	0	48	48	1.0000000
NODE_200367_length_282_cov_2.508197	191	234	0	43	43	1.0000000
NODE_200425_length_282_cov_2.289617	68	137	3	16	69	0.2318841
NODE_200425_length_282_cov_2.289617	68	137	5	53	69	0.7681159
NODE_200443_length_282_cov_2.229508	169	249	0	80	80	1.0000000
NODE_200501_length_282_cov_2.163934	138	192	2	54	54	1.0000000
NODE_200634_length_282_cov_1.901639	149	216	4	10	67	0.1492537
NODE_200634_length_282_cov_1.901639	149	216	6	15	67	0.2238806
NODE_200634_length_282_cov_1.901639	149	216	8	5	67	0.0746269
NODE_200634_length_282_cov_1.901639	149	216	10	37	67	0.5522388
NODE_200924_length_282_cov_1.612022	123	162	0	39	39	1.0000000
NODE_201084_length_282_cov_1.393443	158	225	0	67	67	1.0000000
NODE_201219_length_282_cov_1.273224	91	140	0	49	49	1.0000000
NODE_201413_length_282_cov_1.114754	5	53	0	18	48	0.3750000
NODE_201413_length_282_cov_1.114754	5	53	2	30	48	0.6250000
NODE_202284_length_281_cov_7.895604	165	210	10	3	45	0.0666667
NODE_202284_length_281_cov_7.895604	165	210	12	6	45	0.1333333
NODE_202284_length_281_cov_7.895604	165	210	14	9	45	0.2000000
NODE_202284_length_281_cov_7.895604	165	210	16	27	45	0.6000000
NODE_202284_length_281_cov_7.895604	183	263	8	3	80	0.0375000
NODE_202284_length_281_cov_7.895604	183	263	10	29	80	0.3625000
NODE_202284_length_281_cov_7.895604	183	263	12	23	80	0.2875000
NODE_202284_length_281_cov_7.895604	183	263	14	9	80	0.1125000
NODE_202284_length_281_cov_7.895604	183	263	16	16	80	0.2000000
NODE_202294_length_281_cov_6.379121	151	231	0	80	80	1.0000000
NODE_202333_length_281_cov_4.565934	71	127	0	56	56	1.0000000
NODE_202337_length_281_cov_4.494505	211	261	0	50	50	1.0000000
NODE_202356_length_281_cov_4.219780	85	135	0	50	50	1.0000000
NODE_202356_length_281_cov_4.219780	145	188	0	39	43	0.9069768
NODE_202356_length_281_cov_4.219780	145	188	4	4	43	0.0930233
NODE_202401_length_281_cov_3.620879	245	281	0	36	36	1.0000000
NODE_202421_length_281_cov_3.324176	104	161	0	2	57	0.0350877
NODE_202421_length_281_cov_3.324176	104	161	2	4	57	0.0701754
NODE_202421_length_281_cov_3.324176	104	161	4	1	57	0.0175439
NODE_202421_length_281_cov_3.324176	104	161	6	8	57	0.1403509
NODE_202421_length_281_cov_3.324176	104	161	8	42	57	0.7368421
NODE_202421_length_281_cov_3.324176	112	192	6	7	80	0.0875000
NODE_202421_length_281_cov_3.324176	112	192	8	71	80	0.8875000
NODE_202421_length_281_cov_3.324176	112	192	10	2	80	0.0250000
NODE_202436_length_281_cov_3.197802	6	80	0	74	74	1.0000000
NODE_202473_length_281_cov_2.923077	92	150	0	58	58	1.0000000
NODE_202650_length_281_cov_2.241758	5	58	0	53	53	1.0000000
NODE_202712_length_281_cov_2.120879	56	136	0	80	80	1.0000000
NODE_202788_length_281_cov_1.961538	199	270	0	71	71	1.0000000
NODE_203008_length_281_cov_1.675824	147	199	0	27	52	0.5192308
NODE_203008_length_281_cov_1.675824	147	199	2	25	52	0.4807692
NODE_203008_length_281_cov_1.675824	178	198	0	20	20	1.0000000
NODE_203008_length_281_cov_1.675824	200	241	0	41	41	1.0000000
NODE_203065_length_281_cov_1.653846	29	65	0	36	36	1.0000000
NODE_203168_length_281_cov_1.483516	85	135	0	50	50	1.0000000
NODE_203168_length_281_cov_1.483516	86	166	0	80	80	1.0000000
NODE_203168_length_281_cov_1.483516	139	184	0	45	45	1.0000000
NODE_203183_length_281_cov_1.461538	223	276	0	53	53	1.0000000
NODE_203262_length_281_cov_1.401099	237	281	0	44	44	1.0000000
NODE_203281_length_281_cov_1.401099	150	214	2	22	64	0.3437500
NODE_203281_length_281_cov_1.401099	150	214	4	2	64	0.0312500
NODE_203281_length_281_cov_1.401099	150	214	6	1	64	0.0156250
NODE_203281_length_281_cov_1.401099	150	214	8	1	64	0.0156250
NODE_203281_length_281_cov_1.401099	150	214	14	38	64	0.5937500
NODE_203281_length_281_cov_1.401099	187	267	0	53	80	0.6625000
NODE_203281_length_281_cov_1.401099	187	267	2	22	80	0.2750000
NODE_203281_length_281_cov_1.401099	187	267	4	2	80	0.0250000
NODE_203281_length_281_cov_1.401099	187	267	6	1	80	0.0125000
NODE_203281_length_281_cov_1.401099	187	267	8	1	80	0.0125000
NODE_203281_length_281_cov_1.401099	187	267	14	1	80	0.0125000
NODE_203292_length_281_cov_1.401099	31	111	0	80	80	1.0000000
NODE_203440_length_281_cov_1.186813	0	79	0	52	79	0.6582279
NODE_203440_length_281_cov_1.186813	0	79	4	6	79	0.0759494
NODE_203440_length_281_cov_1.186813	0	79	6	1	79	0.0126582
NODE_203440_length_281_cov_1.186813	0	79	10	7	79	0.0886076
NODE_203440_length_281_cov_1.186813	0	79	12	4	79	0.0506329
NODE_203440_length_281_cov_1.186813	0	79	16	9	79	0.1139240
NODE_203440_length_281_cov_1.186813	52	132	4	6	80	0.0750000
NODE_203440_length_281_cov_1.186813	52	132	6	1	80	0.0125000
NODE_203440_length_281_cov_1.186813	52	132	10	7	80	0.0875000
NODE_203440_length_281_cov_1.186813	52	132	12	4	80	0.0500000
NODE_203440_length_281_cov_1.186813	52	132	16	9	80	0.1125000
NODE_203440_length_281_cov_1.186813	52	132	18	4	80	0.0500000
NODE_203440_length_281_cov_1.186813	52	132	20	8	80	0.1000000
NODE_203440_length_281_cov_1.186813	52	132	22	41	80	0.5125000
NODE_203516_length_281_cov_1.120879	47	82	0	1	35	0.0285714
NODE_203516_length_281_cov_1.120879	47	82	4	15	35	0.4285714
NODE_203516_length_281_cov_1.120879	47	82	9	2	35	0.0571429
NODE_203516_length_281_cov_1.120879	47	82	10	17	35	0.4857143
NODE_203534_length_281_cov_1.120879	243	276	0	33	33	1.0000000
NODE_203544_length_281_cov_1.120879	216	281	0	8	65	0.1230769
NODE_203544_length_281_cov_1.120879	216	281	2	57	65	0.8769231
NODE_203785_length_281_cov_1.060440	139	179	12	1	40	0.0250000
NODE_203785_length_281_cov_1.060440	139	179	14	12	40	0.3000000
NODE_203785_length_281_cov_1.060440	139	179	16	12	40	0.3000000
NODE_203785_length_281_cov_1.060440	139	179	18	2	40	0.0500000
NODE_203785_length_281_cov_1.060440	139	179	20	8	40	0.2000000
NODE_203785_length_281_cov_1.060440	139	179	22	5	40	0.1250000
NODE_204094_length_281_cov_0.840659	72	138	0	66	66	1.0000000
NODE_204094_length_281_cov_0.840659	111	191	0	80	80	1.0000000
NODE_204467_length_280_cov_39.320442	118	198	0	80	80	1.0000000
NODE_204467_length_280_cov_39.320442	181	251	0	70	70	1.0000000
NODE_204468_length_280_cov_34.259669	97	137	0	18	40	0.4500000
NODE_204468_length_280_cov_34.259669	97	137	1	12	40	0.3000000
NODE_204468_length_280_cov_34.259669	97	137	2	3	40	0.0750000
NODE_204468_length_280_cov_34.259669	97	137	4	7	40	0.1750000
NODE_204532_length_280_cov_4.287293	53	100	2	47	47	1.0000000
NODE_204532_length_280_cov_4.287293	129	186	0	36	57	0.6315789
NODE_204532_length_280_cov_4.287293	129	186	2	21	57	0.3684210
NODE_204596_length_280_cov_3.436464	34	103	8	4	69	0.0579710
NODE_204596_length_280_cov_3.436464	34	103	10	1	69	0.0144928
NODE_204596_length_280_cov_3.436464	34	103	16	1	69	0.0144928
NODE_204596_length_280_cov_3.436464	34	103	30	4	69	0.0579710
NODE_204596_length_280_cov_3.436464	34	103	36	1	69	0.0144928
NODE_204596_length_280_cov_3.436464	34	103	38	1	69	0.0144928
NODE_204596_length_280_cov_3.436464	34	103	40	1	69	0.0144928
NODE_204596_length_280_cov_3.436464	34	103	42	2	69	0.0289855
NODE_204596_length_280_cov_3.436464	34	103	46	1	69	0.0144928
NODE_204596_length_280_cov_3.436464	34	103	47	1	69	0.0144928
NODE_204596_length_280_cov_3.436464	34	103	48	3	69	0.0434783
NODE_204596_length_280_cov_3.436464	34	103	56	1	69	0.0144928
NODE_204596_length_280_cov_3.436464	34	103	58	2	69	0.0289855
NODE_204596_length_280_cov_3.436464	34	103	66	1	69	0.0144928
NODE_204596_length_280_cov_3.436464	34	103	68	3	69	0.0434783
NODE_204596_length_280_cov_3.436464	34	103	72	1	69	0.0144928
NODE_204596_length_280_cov_3.436464	34	103	76	1	69	0.0144928
NODE_204596_length_280_cov_3.436464	34	103	84	1	69	0.0144928
NODE_204596_length_280_cov_3.436464	34	103	86	2	69	0.0289855
NODE_204596_length_280_cov_3.436464	34	103	92	2	69	0.0289855
NODE_204596_length_280_cov_3.436464	34	103	94	2	69	0.0289855
NODE_204596_length_280_cov_3.436464	34	103	96	1	69	0.0144928
NODE_204596_length_280_cov_3.436464	34	103	98	4	69	0.0579710
NODE_204596_length_280_cov_3.436464	34	103	100	4	69	0.0579710
NODE_204596_length_280_cov_3.436464	34	103	102	24	69	0.3478261
NODE_204597_length_280_cov_3.430939	17	97	0	11	80	0.1375000
NODE_204597_length_280_cov_3.430939	17	97	2	69	80	0.8625000
NODE_204597_length_280_cov_3.430939	27	97	0	11	70	0.1571429
NODE_204597_length_280_cov_3.430939	27	97	2	59	70	0.8428571
NODE_204674_length_280_cov_2.988950	118	164	0	46	46	1.0000000
NODE_204938_length_280_cov_2.165746	2	48	0	46	46	1.0000000
NODE_204938_length_280_cov_2.165746	6	48	0	42	42	1.0000000
NODE_204938_length_280_cov_2.165746	21	101	0	80	80	1.0000000
NODE_204938_length_280_cov_2.165746	22	101	0	79	79	1.0000000
NODE_204938_length_280_cov_2.165746	32	101	0	69	69	1.0000000
NODE_204976_length_280_cov_2.022099	105	148	0	43	43	1.0000000
NODE_204976_length_280_cov_2.022099	121	148	0	27	27	1.0000000
NODE_205044_length_280_cov_1.889503	50	132	0	82	82	1.0000000
NODE_205062_length_280_cov_1.828729	45	75	23	4	30	0.1333333
NODE_205062_length_280_cov_1.828729	45	75	25	1	30	0.0333333
NODE_205062_length_280_cov_1.828729	45	75	27	3	30	0.1000000
NODE_205062_length_280_cov_1.828729	45	75	28	6	30	0.2000000
NODE_205062_length_280_cov_1.828729	45	75	32	1	30	0.0333333
NODE_205062_length_280_cov_1.828729	45	75	33	5	30	0.1666667
NODE_205062_length_280_cov_1.828729	45	75	35	8	30	0.2666667
NODE_205062_length_280_cov_1.828729	45	75	37	2	30	0.0666667
NODE_205410_length_280_cov_1.425414	17	50	2	33	33	1.0000000
NODE_205410_length_280_cov_1.425414	70	112	0	1	42	0.0238095
NODE_205410_length_280_cov_1.425414	70	112	2	41	42	0.9761904
NODE_205416_length_280_cov_1.414365	37	97	1	33	60	0.5500000
NODE_205416_length_280_cov_1.414365	37	97	2	27	60	0.4500000
NODE_205633_length_280_cov_1.187845	56	136	0	80	80	1.0000000
NODE_205635_length_280_cov_1.182320	154	234	2	22	80	0.2750000
NODE_205635_length_280_cov_1.182320	154	234	3	5	80	0.0625000
NODE_205635_length_280_cov_1.182320	154	234	4	33	80	0.4125000
NODE_205635_length_280_cov_1.182320	154	234	6	20	80	0.2500000
NODE_205635_length_280_cov_1.182320	207	280	0	15	73	0.2054795
NODE_205635_length_280_cov_1.182320	207	280	3	36	73	0.4931507
NODE_205635_length_280_cov_1.182320	207	280	4	22	73	0.3013699
NODE_205701_length_280_cov_1.127072	204	265	0	50	61	0.8196721
NODE_205701_length_280_cov_1.127072	204	265	2	11	61	0.1803279
NODE_205794_length_280_cov_1.127072	0	39	0	39	39	1.0000000
NODE_205801_length_280_cov_1.127072	218	253	0	35	35	1.0000000
NODE_205894_length_280_cov_1.127072	0	59	0	8	59	0.1355932
NODE_205894_length_280_cov_1.127072	0	59	2	51	59	0.8644068
NODE_206211_length_280_cov_0.911602	176	256	0	80	80	1.0000000
NODE_206211_length_280_cov_0.911602	229	280	0	51	51	1.0000000
NODE_206319_length_280_cov_0.845304	211	268	0	57	57	1.0000000
NODE_206531_length_280_cov_0.779006	129	203	2	13	74	0.1756757
NODE_206531_length_280_cov_0.779006	129	203	4	61	74	0.8243243
NODE_206721_length_279_cov_50.005556	51	130	10	17	79	0.2151899
NODE_206721_length_279_cov_50.005556	51	130	12	38	79	0.4810127
NODE_206721_length_279_cov_50.005556	51	130	14	15	79	0.1898734
NODE_206721_length_279_cov_50.005556	51	130	16	9	79	0.1139240
NODE_206721_length_279_cov_50.005556	103	179	2	4	76	0.0526316
NODE_206721_length_279_cov_50.005556	103	179	4	22	76	0.2894737
NODE_206721_length_279_cov_50.005556	103	179	10	39	76	0.5131579
NODE_206721_length_279_cov_50.005556	103	179	12	2	76	0.0263158
NODE_206721_length_279_cov_50.005556	103	179	14	6	76	0.0789474
NODE_206721_length_279_cov_50.005556	103	179	16	3	76	0.0394737
NODE_206744_length_279_cov_6.055556	196	228	0	32	32	1.0000000
NODE_206762_length_279_cov_5.166667	197	277	0	80	80	1.0000000
NODE_206788_length_279_cov_4.427778	107	187	0	80	80	1.0000000
NODE_206879_length_279_cov_3.200000	205	225	0	20	20	1.0000000
NODE_206886_length_279_cov_3.116667	115	195	0	43	80	0.5375000
NODE_206886_length_279_cov_3.116667	115	195	2	37	80	0.4625000
NODE_206886_length_279_cov_3.116667	168	248	0	53	80	0.6625000
NODE_206886_length_279_cov_3.116667	168	248	2	27	80	0.3375000
NODE_206972_length_279_cov_2.600000	67	147	0	53	80	0.6625000
NODE_206972_length_279_cov_2.600000	67	147	2	4	80	0.0500000
NODE_206972_length_279_cov_2.600000	67	147	4	23	80	0.2875000
NODE_206972_length_279_cov_2.600000	120	199	0	79	79	1.0000000
NODE_207023_length_279_cov_2.427778	155	199	0	44	44	1.0000000
NODE_207052_length_279_cov_2.283333	168	240	0	72	72	1.0000000
NODE_207054_length_279_cov_2.277778	190	265	0	49	75	0.6533333
NODE_207054_length_279_cov_2.277778	190	265	2	26	75	0.3466667
NODE_207086_length_279_cov_2.266667	66	109	0	43	43	1.0000000
NODE_207115_length_279_cov_2.255556	115	176	0	61	61	1.0000000
NODE_207115_length_279_cov_2.255556	168	222	0	54	54	1.0000000
NODE_207155_length_279_cov_2.200000	57	104	0	7	47	0.1489362
NODE_207155_length_279_cov_2.200000	57	104	2	12	47	0.2553191
NODE_207155_length_279_cov_2.200000	57	104	6	28	47	0.5957447
NODE_207269_length_279_cov_1.977778	0	62	0	62	62	1.0000000
NODE_207293_length_279_cov_1.944444	63	105	0	42	42	1.0000000
NODE_207306_length_279_cov_1.916667	182	262	0	80	80	1.0000000
NODE_207318_length_279_cov_1.866667	63	143	0	80	80	1.0000000
NODE_207387_length_279_cov_1.700000	8	37	0	12	29	0.4137931
NODE_207387_length_279_cov_1.700000	8	37	2	17	29	0.5862069
NODE_207389_length_279_cov_1.700000	10	42	0	32	32	1.0000000
NODE_207534_length_279_cov_1.672222	103	183	0	76	80	0.9500000
NODE_207534_length_279_cov_1.672222	103	183	2	4	80	0.0500000
NODE_207641_length_279_cov_1.433333	51	110	2	38	59	0.6440678
NODE_207641_length_279_cov_1.433333	51	110	4	21	59	0.3559322
NODE_207641_length_279_cov_1.433333	83	119	2	15	36	0.4166667
NODE_207641_length_279_cov_1.433333	83	119	4	21	36	0.5833333
NODE_207929_length_279_cov_1.144444	146	211	0	65	65	1.0000000
NODE_207929_length_279_cov_1.144444	184	266	0	82	82	1.0000000
NODE_207931_length_279_cov_1.138889	125	188	8	4	63	0.0634921
NODE_207931_length_279_cov_1.138889	125	188	10	9	63	0.1428571
NODE_207931_length_279_cov_1.138889	125	188	12	50	63	0.7936508
NODE_207932_length_279_cov_1.138889	111	191	0	80	80	1.0000000
NODE_207948_length_279_cov_1.133333	231	271	0	40	40	1.0000000
NODE_208183_length_279_cov_1.116667	15	92	0	77	77	1.0000000
NODE_208334_length_279_cov_0.988889	181	261	0	16	80	0.2000000
NODE_208334_length_279_cov_0.988889	181	261	2	9	80	0.1125000
NODE_208334_length_279_cov_0.988889	181	261	6	4	80	0.0500000
NODE_208334_length_279_cov_0.988889	181	261	8	20	80	0.2500000
NODE_208334_length_279_cov_0.988889	181	261	10	31	80	0.3875000
NODE_208410_length_279_cov_0.927778	50	69	0	19	19	1.0000000
NODE_208410_length_279_cov_0.927778	50	69	0	19	19	1.0000000
NODE_208664_length_279_cov_0.844444	35	70	0	35	35	1.0000000
NODE_209293_length_278_cov_44.882682	158	210	0	11	52	0.2115385
NODE_209293_length_278_cov_44.882682	158	210	2	4	52	0.0769231
NODE_209293_length_278_cov_44.882682	158	210	4	9	52	0.1730769
NODE_209293_length_278_cov_44.882682	158	210	6	2	52	0.0384615
NODE_209293_length_278_cov_44.882682	158	210	8	4	52	0.0769231
NODE_209293_length_278_cov_44.882682	158	210	10	6	52	0.1153846
NODE_209293_length_278_cov_44.882682	158	210	12	5	52	0.0961538
NODE_209293_length_278_cov_44.882682	158	210	14	6	52	0.1153846
NODE_209293_length_278_cov_44.882682	158	210	16	5	52	0.0961538
NODE_209293_length_278_cov_44.882682	206	232	0	26	26	1.0000000
NODE_209293_length_278_cov_44.882682	206	265	0	59	59	1.0000000
NODE_209294_length_278_cov_37.474860	0	52	0	52	52	1.0000000
NODE_209294_length_278_cov_37.474860	48	128	0	42	80	0.5250000
NODE_209294_length_278_cov_37.474860	48	128	2	3	80	0.0375000
NODE_209294_length_278_cov_37.474860	48	128	3	3	80	0.0375000
NODE_209294_length_278_cov_37.474860	48	128	5	32	80	0.4000000
NODE_209294_length_278_cov_37.474860	101	181	3	5	80	0.0625000
NODE_209294_length_278_cov_37.474860	101	181	5	75	80	0.9375000
NODE_209295_length_278_cov_21.340782	84	164	0	28	80	0.3500000
NODE_209295_length_278_cov_21.340782	84	164	2	52	80	0.6500000
NODE_209295_length_278_cov_21.340782	137	217	2	80	80	1.0000000
NODE_209360_length_278_cov_4.156425	132	210	0	10	78	0.1282051
NODE_209360_length_278_cov_4.156425	132	210	2	20	78	0.2564103
NODE_209360_length_278_cov_4.156425	132	210	6	7	78	0.0897436
NODE_209360_length_278_cov_4.156425	132	210	8	4	78	0.0512821
NODE_209360_length_278_cov_4.156425	132	210	10	23	78	0.2948718
NODE_209360_length_278_cov_4.156425	132	210	12	14	78	0.1794872
NODE_209360_length_278_cov_4.156425	193	263	0	63	70	0.9000000
NODE_209360_length_278_cov_4.156425	193	263	2	7	70	0.1000000
NODE_209372_length_278_cov_3.977654	142	221	0	78	79	0.9873418
NODE_209372_length_278_cov_3.977654	142	221	2	1	79	0.0126582
NODE_209378_length_278_cov_3.865922	168	210	2	42	42	1.0000000
NODE_209552_length_278_cov_2.558659	93	123	0	30	30	1.0000000
NODE_209565_length_278_cov_2.513966	54	106	0	52	52	1.0000000
NODE_209565_length_278_cov_2.513966	79	158	0	46	79	0.5822785
NODE_209565_length_278_cov_2.513966	79	158	2	33	79	0.4177215
NODE_209605_length_278_cov_2.296089	127	207	0	26	80	0.3250000
NODE_209605_length_278_cov_2.296089	127	207	2	12	80	0.1500000
NODE_209605_length_278_cov_2.296089	127	207	4	42	80	0.5250000
NODE_209883_length_278_cov_1.731844	145	194	14	2	49	0.0408163
NODE_209883_length_278_cov_1.731844	145	194	16	1	49	0.0204082
NODE_209883_length_278_cov_1.731844	145	194	20	4	49	0.0816327
NODE_209883_length_278_cov_1.731844	145	194	22	4	49	0.0816327
NODE_209883_length_278_cov_1.731844	145	194	24	3	49	0.0612245
NODE_209883_length_278_cov_1.731844	145	194	26	7	49	0.1428571
NODE_209883_length_278_cov_1.731844	145	194	28	7	49	0.1428571
NODE_209883_length_278_cov_1.731844	145	194	30	7	49	0.1428571
NODE_209883_length_278_cov_1.731844	145	194	32	7	49	0.1428571
NODE_209883_length_278_cov_1.731844	145	194	34	7	49	0.1428571
NODE_210038_length_278_cov_1.681564	129	184	0	28	55	0.5090909
NODE_210038_length_278_cov_1.681564	129	184	2	27	55	0.4909091
NODE_210068_length_278_cov_1.636872	13	41	0	2	28	0.0714286
NODE_210068_length_278_cov_1.636872	13	41	8	2	28	0.0714286
NODE_210068_length_278_cov_1.636872	13	41	12	24	28	0.8571429
NODE_210373_length_278_cov_1.290503	3	67	11	4	64	0.0625000
NODE_210373_length_278_cov_1.290503	3	67	15	4	64	0.0625000
NODE_210373_length_278_cov_1.290503	3	67	19	3	64	0.0468750
NODE_210373_length_278_cov_1.290503	3	67	21	6	64	0.0937500
NODE_210373_length_278_cov_1.290503	3	67	25	2	64	0.0312500
NODE_210373_length_278_cov_1.290503	3	67	29	1	64	0.0156250
NODE_210373_length_278_cov_1.290503	3	67	33	6	64	0.0937500
NODE_210373_length_278_cov_1.290503	3	67	35	3	64	0.0468750
NODE_210373_length_278_cov_1.290503	3	67	37	32	64	0.5000000
NODE_210373_length_278_cov_1.290503	3	67	39	1	64	0.0156250
NODE_210373_length_278_cov_1.290503	3	67	42	2	64	0.0312500
NODE_210373_length_278_cov_1.290503	3	67	11	4	64	0.0625000
NODE_210373_length_278_cov_1.290503	3	67	15	4	64	0.0625000
NODE_210373_length_278_cov_1.290503	3	67	19	3	64	0.0468750
NODE_210373_length_278_cov_1.290503	3	67	21	6	64	0.0937500
NODE_210373_length_278_cov_1.290503	3	67	25	2	64	0.0312500
NODE_210373_length_278_cov_1.290503	3	67	29	1	64	0.0156250
NODE_210373_length_278_cov_1.290503	3	67	33	6	64	0.0937500
NODE_210373_length_278_cov_1.290503	3	67	35	3	64	0.0468750
NODE_210373_length_278_cov_1.290503	3	67	37	32	64	0.5000000
NODE_210373_length_278_cov_1.290503	3	67	39	1	64	0.0156250
NODE_210373_length_278_cov_1.290503	3	67	42	2	64	0.0312500
NODE_210373_length_278_cov_1.290503	3	67	11	4	64	0.0625000
NODE_210373_length_278_cov_1.290503	3	67	15	4	64	0.0625000
NODE_210373_length_278_cov_1.290503	3	67	19	3	64	0.0468750
NODE_210373_length_278_cov_1.290503	3	67	21	6	64	0.0937500
NODE_210373_length_278_cov_1.290503	3	67	25	2	64	0.0312500
NODE_210373_length_278_cov_1.290503	3	67	29	1	64	0.0156250
NODE_210373_length_278_cov_1.290503	3	67	33	6	64	0.0937500
NODE_210373_length_278_cov_1.290503	3	67	35	3	64	0.0468750
NODE_210373_length_278_cov_1.290503	3	67	37	32	64	0.5000000
NODE_210373_length_278_cov_1.290503	3	67	39	1	64	0.0156250
NODE_210373_length_278_cov_1.290503	3	67	42	2	64	0.0312500
NODE_210463_length_278_cov_1.150838	52	76	6	24	24	1.0000000
NODE_210463_length_278_cov_1.150838	58	84	4	1	26	0.0384615
NODE_210463_length_278_cov_1.150838	58	84	6	25	26	0.9615384
NODE_210559_length_278_cov_1.139665	108	187	0	79	79	1.0000000
NODE_210612_length_278_cov_1.139665	232	278	0	46	46	1.0000000
NODE_210691_length_278_cov_1.139665	210	278	0	68	68	1.0000000
NODE_212166_length_277_cov_2.691011	0	60	0	60	60	1.0000000
NODE_212166_length_277_cov_2.691011	33	113	0	80	80	1.0000000
NODE_212175_length_277_cov_2.617978	85	127	0	42	42	1.0000000
NODE_212233_length_277_cov_2.438202	137	218	0	20	81	0.2469136
NODE_212233_length_277_cov_2.438202	137	218	2	40	81	0.4938272
NODE_212233_length_277_cov_2.438202	137	218	4	21	81	0.2592593
NODE_212357_length_277_cov_2.140449	234	276	0	42	42	1.0000000
NODE_212377_length_277_cov_2.095506	41	114	0	73	73	1.0000000
NODE_212377_length_277_cov_2.095506	41	114	0	73	73	1.0000000
NODE_212377_length_277_cov_2.095506	94	161	0	65	67	0.9701493
NODE_212377_length_277_cov_2.095506	94	161	2	2	67	0.0298507
NODE_212525_length_277_cov_1.837079	92	172	0	80	80	1.0000000
NODE_212558_length_277_cov_1.764045	115	155	0	17	40	0.4250000
NODE_212558_length_277_cov_1.764045	115	155	2	2	40	0.0500000
NODE_212558_length_277_cov_1.764045	115	155	4	11	40	0.2750000
NODE_212558_length_277_cov_1.764045	115	155	6	3	40	0.0750000
NODE_212558_length_277_cov_1.764045	115	155	8	6	40	0.1500000
NODE_212558_length_277_cov_1.764045	115	155	10	1	40	0.0250000
NODE_212605_length_277_cov_1.719101	150	215	0	65	65	1.0000000
NODE_212845_length_277_cov_1.505618	0	47	0	2	47	0.0425532
NODE_212845_length_277_cov_1.505618	0	47	2	45	47	0.9574468
NODE_212845_length_277_cov_1.505618	20	100	0	14	80	0.1750000
NODE_212845_length_277_cov_1.505618	20	100	2	66	80	0.8250000
NODE_212970_length_277_cov_1.426966	113	191	0	7	78	0.0897436
NODE_212970_length_277_cov_1.426966	113	191	1	18	78	0.2307692
NODE_212970_length_277_cov_1.426966	113	191	2	5	78	0.0641026
NODE_212970_length_277_cov_1.426966	113	191	3	4	78	0.0512821
NODE_212970_length_277_cov_1.426966	113	191	5	1	78	0.0128205
NODE_212970_length_277_cov_1.426966	113	191	7	5	78	0.0641026
NODE_212970_length_277_cov_1.426966	113	191	9	16	78	0.2051282
NODE_212970_length_277_cov_1.426966	113	191	11	22	78	0.2820513
NODE_213057_length_277_cov_1.314607	127	176	2	17	49	0.3469388
NODE_213057_length_277_cov_1.314607	127	176	4	32	49	0.6530612
NODE_213091_length_277_cov_1.258427	141	222	0	81	81	1.0000000
NODE_213223_length_277_cov_1.146067	19	95	2	4	76	0.0526316
NODE_213223_length_277_cov_1.146067	19	95	4	2	76	0.0263158
NODE_213223_length_277_cov_1.146067	19	95	6	2	76	0.0263158
NODE_213223_length_277_cov_1.146067	19	95	8	40	76	0.5263158
NODE_213223_length_277_cov_1.146067	19	95	10	16	76	0.2105263
NODE_213223_length_277_cov_1.146067	19	95	12	5	76	0.0657895
NODE_213223_length_277_cov_1.146067	19	95	14	2	76	0.0263158
NODE_213223_length_277_cov_1.146067	19	95	16	5	76	0.0657895
NODE_213490_length_277_cov_1.061798	67	105	2	38	38	1.0000000
NODE_213505_length_277_cov_1.044944	19	77	0	58	58	1.0000000
NODE_214572_length_276_cov_31.774011	91	153	4	2	62	0.0322581
NODE_214572_length_276_cov_31.774011	91	153	8	3	62	0.0483871
NODE_214572_length_276_cov_31.774011	91	153	10	1	62	0.0161290
NODE_214572_length_276_cov_31.774011	91	153	12	2	62	0.0322581
NODE_214572_length_276_cov_31.774011	91	153	14	4	62	0.0645161
NODE_214572_length_276_cov_31.774011	91	153	15	5	62	0.0806452
NODE_214572_length_276_cov_31.774011	91	153	17	1	62	0.0161290
NODE_214572_length_276_cov_31.774011	91	153	20	5	62	0.0806452
NODE_214572_length_276_cov_31.774011	91	153	21	1	62	0.0161290
NODE_214572_length_276_cov_31.774011	91	153	25	1	62	0.0161290
NODE_214572_length_276_cov_31.774011	91	153	27	1	62	0.0161290
NODE_214572_length_276_cov_31.774011	91	153	28	3	62	0.0483871
NODE_214572_length_276_cov_31.774011	91	153	42	1	62	0.0161290
NODE_214572_length_276_cov_31.774011	91	153	45	1	62	0.0161290
NODE_214572_length_276_cov_31.774011	91	153	48	1	62	0.0161290
NODE_214572_length_276_cov_31.774011	91	153	52	1	62	0.0161290
NODE_214572_length_276_cov_31.774011	91	153	53	1	62	0.0161290
NODE_214572_length_276_cov_31.774011	91	153	57	6	62	0.0967742
NODE_214572_length_276_cov_31.774011	91	153	59	2	62	0.0322581
NODE_214572_length_276_cov_31.774011	91	153	63	5	62	0.0806452
NODE_214572_length_276_cov_31.774011	91	153	68	2	62	0.0322581
NODE_214572_length_276_cov_31.774011	91	153	74	3	62	0.0483871
NODE_214572_length_276_cov_31.774011	91	153	78	1	62	0.0161290
NODE_214572_length_276_cov_31.774011	91	153	80	4	62	0.0645161
NODE_214572_length_276_cov_31.774011	91	153	82	1	62	0.0161290
NODE_214572_length_276_cov_31.774011	91	153	84	1	62	0.0161290
NODE_214572_length_276_cov_31.774011	91	153	86	1	62	0.0161290
NODE_214572_length_276_cov_31.774011	91	153	88	1	62	0.0161290
NODE_214572_length_276_cov_31.774011	91	153	92	1	62	0.0161290
NODE_214576_length_276_cov_10.056497	66	146	2	80	80	1.0000000
NODE_214698_length_276_cov_3.564972	176	256	0	77	80	0.9625000
NODE_214698_length_276_cov_3.564972	176	256	2	3	80	0.0375000
NODE_214785_length_276_cov_2.920904	203	260	0	57	57	1.0000000
NODE_214785_length_276_cov_2.920904	233	276	0	43	43	1.0000000
NODE_214883_length_276_cov_2.542373	164	204	6	8	40	0.2000000
NODE_214883_length_276_cov_2.542373	164	204	8	9	40	0.2250000
NODE_214883_length_276_cov_2.542373	164	204	10	16	40	0.4000000
NODE_214883_length_276_cov_2.542373	164	204	12	7	40	0.1750000
NODE_215016_length_276_cov_2.197740	64	144	2	80	80	1.0000000
NODE_215086_length_276_cov_2.022599	136	193	0	21	57	0.3684210
NODE_215086_length_276_cov_2.022599	136	193	2	12	57	0.2105263
NODE_215086_length_276_cov_2.022599	136	193	4	2	57	0.0350877
NODE_215086_length_276_cov_2.022599	136	193	6	22	57	0.3859649
NODE_215105_length_276_cov_2.016949	97	138	2	41	41	1.0000000
NODE_215139_length_276_cov_2.005650	82	153	0	18	71	0.2535211
NODE_215139_length_276_cov_2.005650	82	153	2	53	71	0.7464789
NODE_215234_length_276_cov_1.734463	102	182	10	7	80	0.0875000
NODE_215234_length_276_cov_1.734463	102	182	12	3	80	0.0375000
NODE_215234_length_276_cov_1.734463	102	182	14	1	80	0.0125000
NODE_215234_length_276_cov_1.734463	102	182	18	16	80	0.2000000
NODE_215234_length_276_cov_1.734463	102	182	20	16	80	0.2000000
NODE_215234_length_276_cov_1.734463	102	182	22	25	80	0.3125000
NODE_215234_length_276_cov_1.734463	102	182	26	12	80	0.1500000
NODE_215516_length_276_cov_1.525424	70	116	2	46	46	1.0000000
NODE_215516_length_276_cov_1.525424	123	169	0	18	46	0.3913043
NODE_215516_length_276_cov_1.525424	123	169	2	28	46	0.6086956
NODE_215519_length_276_cov_1.514124	115	155	17	1	40	0.0250000
NODE_215519_length_276_cov_1.514124	115	155	18	3	40	0.0750000
NODE_215519_length_276_cov_1.514124	115	155	20	3	40	0.0750000
NODE_215519_length_276_cov_1.514124	115	155	22	33	40	0.8250000
NODE_215748_length_276_cov_1.288136	114	154	4	6	40	0.1500000
NODE_215748_length_276_cov_1.288136	114	154	6	9	40	0.2250000
NODE_215748_length_276_cov_1.288136	114	154	8	25	40	0.6250000
NODE_216141_length_276_cov_1.124294	122	170	0	48	48	1.0000000
NODE_216141_length_276_cov_1.124294	132	163	0	31	31	1.0000000
NODE_216220_length_276_cov_1.039548	7	68	0	61	61	1.0000000
NODE_216220_length_276_cov_1.039548	7	70	0	63	63	1.0000000
NODE_216220_length_276_cov_1.039548	7	70	0	63	63	1.0000000
NODE_216220_length_276_cov_1.039548	7	70	0	63	63	1.0000000
NODE_216269_length_276_cov_1.000000	48	89	0	41	41	1.0000000
NODE_216269_length_276_cov_1.000000	62	106	0	44	44	1.0000000
NODE_216414_length_276_cov_0.898305	54	105	0	51	51	1.0000000
NODE_217265_length_275_cov_85.085227	94	174	4	1	80	0.0125000
NODE_217265_length_275_cov_85.085227	94	174	6	8	80	0.1000000
NODE_217265_length_275_cov_85.085227	94	174	8	1	80	0.0125000
NODE_217265_length_275_cov_85.085227	94	174	10	70	80	0.8750000
NODE_217265_length_275_cov_85.085227	147	227	0	43	80	0.5375000
NODE_217265_length_275_cov_85.085227	147	227	2	9	80	0.1125000
NODE_217265_length_275_cov_85.085227	147	227	4	2	80	0.0250000
NODE_217265_length_275_cov_85.085227	147	227	6	8	80	0.1000000
NODE_217265_length_275_cov_85.085227	147	227	8	1	80	0.0125000
NODE_217265_length_275_cov_85.085227	147	227	10	17	80	0.2125000
NODE_217287_length_275_cov_5.818182	0	44	0	44	44	1.0000000
NODE_217355_length_275_cov_3.857955	0	67	0	9	67	0.1343284
NODE_217355_length_275_cov_3.857955	0	67	2	58	67	0.8656716
NODE_217396_length_275_cov_3.306818	199	275	0	76	76	1.0000000
NODE_217402_length_275_cov_3.284091	127	175	0	48	48	1.0000000
NODE_217433_length_275_cov_2.977273	95	145	4	3	50	0.0600000
NODE_217433_length_275_cov_2.977273	95	145	6	18	50	0.3600000
NODE_217433_length_275_cov_2.977273	95	145	8	29	50	0.5800000
NODE_217531_length_275_cov_2.585227	85	122	46	2	37	0.0540541
NODE_217531_length_275_cov_2.585227	85	122	50	9	37	0.2432432
NODE_217531_length_275_cov_2.585227	85	122	52	12	37	0.3243243
NODE_217531_length_275_cov_2.585227	85	122	54	10	37	0.2702703
NODE_217531_length_275_cov_2.585227	85	122	56	4	37	0.1081081
NODE_217714_length_275_cov_2.090909	0	47	0	40	47	0.8510638
NODE_217714_length_275_cov_2.090909	0	47	2	7	47	0.1489362
NODE_217714_length_275_cov_2.090909	20	91	0	20	71	0.2816902
NODE_217714_length_275_cov_2.090909	20	91	2	51	71	0.7183099
NODE_217801_length_275_cov_1.960227	198	251	0	53	53	1.0000000
NODE_217835_length_275_cov_1.875000	190	247	0	57	57	1.0000000
NODE_217839_length_275_cov_1.857955	52	119	0	67	67	1.0000000
NODE_217839_length_275_cov_1.857955	136	182	0	40	46	0.8695652
NODE_217839_length_275_cov_1.857955	136	182	2	6	46	0.1304348
NODE_217885_length_275_cov_1.755682	21	76	2	18	55	0.3272727
NODE_217885_length_275_cov_1.755682	21	76	3	1	55	0.0181818
NODE_217885_length_275_cov_1.755682	21	76	4	36	55	0.6545454
NODE_217912_length_275_cov_1.738636	225	256	0	31	31	1.0000000
NODE_217967_length_275_cov_1.738636	161	241	0	10	80	0.1250000
NODE_217967_length_275_cov_1.738636	161	241	2	70	80	0.8750000
NODE_218257_length_275_cov_1.448864	123	155	8	5	32	0.1562500
NODE_218257_length_275_cov_1.448864	123	155	10	3	32	0.0937500
NODE_218257_length_275_cov_1.448864	123	155	12	24	32	0.7500000
NODE_218402_length_275_cov_1.301136	132	196	0	64	64	1.0000000
NODE_218706_length_275_cov_1.159091	13	93	2	18	80	0.2250000
NODE_218706_length_275_cov_1.159091	13	93	4	62	80	0.7750000
NODE_218734_length_275_cov_1.153409	11	91	2	6	80	0.0750000
NODE_218734_length_275_cov_1.153409	11	91	4	1	80	0.0125000
NODE_218734_length_275_cov_1.153409	11	91	6	8	80	0.1000000
NODE_218734_length_275_cov_1.153409	11	91	8	65	80	0.8125000
NODE_219031_length_275_cov_0.937500	13	49	2	3	36	0.0833333
NODE_219031_length_275_cov_0.937500	13	49	4	3	36	0.0833333
NODE_219031_length_275_cov_0.937500	13	49	6	1	36	0.0277778
NODE_219031_length_275_cov_0.937500	13	49	8	3	36	0.0833333
NODE_219031_length_275_cov_0.937500	13	49	10	4	36	0.1111111
NODE_219031_length_275_cov_0.937500	13	49	16	6	36	0.1666667
NODE_219031_length_275_cov_0.937500	13	49	18	6	36	0.1666667
NODE_219031_length_275_cov_0.937500	13	49	19	1	36	0.0277778
NODE_219031_length_275_cov_0.937500	13	49	20	2	36	0.0555556
NODE_219031_length_275_cov_0.937500	13	49	22	7	36	0.1944444
NODE_219031_length_275_cov_0.937500	22	86	8	1	64	0.0156250
NODE_219031_length_275_cov_0.937500	22	86	10	4	64	0.0625000
NODE_219031_length_275_cov_0.937500	22	86	16	6	64	0.0937500
NODE_219031_length_275_cov_0.937500	22	86	18	6	64	0.0937500
NODE_219031_length_275_cov_0.937500	22	86	19	1	64	0.0156250
NODE_219031_length_275_cov_0.937500	22	86	20	2	64	0.0312500
NODE_219031_length_275_cov_0.937500	22	86	22	7	64	0.1093750
NODE_219031_length_275_cov_0.937500	22	86	24	4	64	0.0625000
NODE_219031_length_275_cov_0.937500	22	86	26	5	64	0.0781250
NODE_219031_length_275_cov_0.937500	22	86	28	6	64	0.0937500
NODE_219031_length_275_cov_0.937500	22	86	30	9	64	0.1406250
NODE_219031_length_275_cov_0.937500	22	86	32	7	64	0.1093750
NODE_219031_length_275_cov_0.937500	22	86	42	1	64	0.0156250
NODE_219031_length_275_cov_0.937500	22	86	44	1	64	0.0156250
NODE_219031_length_275_cov_0.937500	22	86	46	1	64	0.0156250
NODE_219031_length_275_cov_0.937500	22	86	50	3	64	0.0468750
NODE_219220_length_275_cov_0.869318	67	126	0	59	59	1.0000000
NODE_219655_length_275_cov_0.579545	40	70	0	30	30	1.0000000
NODE_220021_length_274_cov_6.074286	141	175	0	34	34	1.0000000
NODE_220047_length_274_cov_4.845714	48	105	0	57	57	1.0000000
NODE_220047_length_274_cov_4.845714	113	175	0	62	62	1.0000000
NODE_220078_length_274_cov_4.080000	210	274	0	64	64	1.0000000
NODE_220215_length_274_cov_2.988571	104	161	0	57	57	1.0000000
NODE_220221_length_274_cov_2.937143	199	234	0	35	35	1.0000000
NODE_220293_length_274_cov_2.622857	29	76	8	2	47	0.0425532
NODE_220293_length_274_cov_2.622857	29	76	10	17	47	0.3617021
NODE_220293_length_274_cov_2.622857	29	76	12	28	47	0.5957447
NODE_220293_length_274_cov_2.622857	82	157	2	2	75	0.0266667
NODE_220293_length_274_cov_2.622857	82	157	4	4	75	0.0533333
NODE_220293_length_274_cov_2.622857	82	157	6	27	75	0.3600000
NODE_220293_length_274_cov_2.622857	82	157	8	3	75	0.0400000
NODE_220293_length_274_cov_2.622857	82	157	10	5	75	0.0666667
NODE_220293_length_274_cov_2.622857	82	157	12	11	75	0.1466667
NODE_220293_length_274_cov_2.622857	82	157	14	23	75	0.3066667
NODE_220413_length_274_cov_2.308571	51	130	5	5	79	0.0632911
NODE_220413_length_274_cov_2.308571	51	130	7	1	79	0.0126582
NODE_220413_length_274_cov_2.308571	51	130	9	4	79	0.0506329
NODE_220413_length_274_cov_2.308571	51	130	11	5	79	0.0632911
NODE_220413_length_274_cov_2.308571	51	130	15	1	79	0.0126582
NODE_220413_length_274_cov_2.308571	51	130	17	1	79	0.0126582
NODE_220413_length_274_cov_2.308571	51	130	19	1	79	0.0126582
NODE_220413_length_274_cov_2.308571	51	130	21	2	79	0.0253165
NODE_220413_length_274_cov_2.308571	51	130	22	1	79	0.0126582
NODE_220413_length_274_cov_2.308571	51	130	26	1	79	0.0126582
NODE_220413_length_274_cov_2.308571	51	130	30	1	79	0.0126582
NODE_220413_length_274_cov_2.308571	51	130	34	1	79	0.0126582
NODE_220413_length_274_cov_2.308571	51	130	36	1	79	0.0126582
NODE_220413_length_274_cov_2.308571	51	130	37	1	79	0.0126582
NODE_220413_length_274_cov_2.308571	51	130	41	3	79	0.0379747
NODE_220413_length_274_cov_2.308571	51	130	44	1	79	0.0126582
NODE_220413_length_274_cov_2.308571	51	130	45	4	79	0.0506329
NODE_220413_length_274_cov_2.308571	51	130	46	1	79	0.0126582
NODE_220413_length_274_cov_2.308571	51	130	52	2	79	0.0253165
NODE_220413_length_274_cov_2.308571	51	130	54	1	79	0.0126582
NODE_220413_length_274_cov_2.308571	51	130	58	6	79	0.0759494
NODE_220413_length_274_cov_2.308571	51	130	59	5	79	0.0632911
NODE_220413_length_274_cov_2.308571	51	130	60	1	79	0.0126582
NODE_220413_length_274_cov_2.308571	51	130	62	1	79	0.0126582
NODE_220413_length_274_cov_2.308571	51	130	64	1	79	0.0126582
NODE_220413_length_274_cov_2.308571	51	130	66	10	79	0.1265823
NODE_220413_length_274_cov_2.308571	51	130	68	13	79	0.1645570
NODE_220413_length_274_cov_2.308571	51	130	70	4	79	0.0506329
NODE_220504_length_274_cov_2.062857	172	242	0	33	70	0.4714286
NODE_220504_length_274_cov_2.062857	172	242	2	5	70	0.0714286
NODE_220504_length_274_cov_2.062857	172	242	4	32	70	0.4571429
NODE_220504_length_274_cov_2.062857	215	256	0	41	41	1.0000000
NODE_220662_length_274_cov_1.754286	219	259	0	40	40	1.0000000
NODE_220681_length_274_cov_1.748571	168	231	0	3	63	0.0476190
NODE_220681_length_274_cov_1.748571	168	231	2	60	63	0.9523810
NODE_220806_length_274_cov_1.737143	134	172	0	38	38	1.0000000
NODE_220847_length_274_cov_1.685714	132	189	0	39	57	0.6842105
NODE_220847_length_274_cov_1.685714	132	189	2	18	57	0.3157895
NODE_220847_length_274_cov_1.685714	141	199	0	49	58	0.8448276
NODE_220847_length_274_cov_1.685714	141	199	2	9	58	0.1551724
NODE_220966_length_274_cov_1.502857	170	232	0	62	62	1.0000000
NODE_220966_length_274_cov_1.502857	223	274	0	51	51	1.0000000
NODE_221005_length_274_cov_1.457143	118	147	2	29	29	1.0000000
NODE_221101_length_274_cov_1.434286	25	69	0	44	44	1.0000000
NODE_221211_length_274_cov_1.285714	84	156	0	25	72	0.3472222
NODE_221211_length_274_cov_1.285714	84	156	2	47	72	0.6527778
NODE_221612_length_274_cov_1.131429	205	251	0	46	46	1.0000000
NODE_221764_length_274_cov_0.994286	219	260	2	41	41	1.0000000
NODE_222849_length_273_cov_4.948276	204	262	0	49	58	0.8448276
NODE_222849_length_273_cov_4.948276	204	262	2	9	58	0.1551724
NODE_222849_length_273_cov_4.948276	204	258	0	45	54	0.8333333
NODE_222849_length_273_cov_4.948276	204	258	2	9	54	0.1666667
NODE_222914_length_273_cov_3.712644	103	183	0	2	80	0.0250000
NODE_222914_length_273_cov_3.712644	103	183	4	5	80	0.0625000
NODE_222914_length_273_cov_3.712644	103	183	6	1	80	0.0125000
NODE_222914_length_273_cov_3.712644	103	183	8	1	80	0.0125000
NODE_222914_length_273_cov_3.712644	103	183	10	9	80	0.1125000
NODE_222914_length_273_cov_3.712644	103	183	12	3	80	0.0375000
NODE_222914_length_273_cov_3.712644	103	183	14	24	80	0.3000000
NODE_222914_length_273_cov_3.712644	103	183	16	35	80	0.4375000
NODE_222955_length_273_cov_3.298851	69	100	0	3	31	0.0967742
NODE_222955_length_273_cov_3.298851	69	100	2	28	31	0.9032258
NODE_222955_length_273_cov_3.298851	73	153	2	80	80	1.0000000
NODE_222974_length_273_cov_3.195402	122	189	0	13	67	0.1940299
NODE_222974_length_273_cov_3.195402	122	189	2	54	67	0.8059701
NODE_222991_length_273_cov_3.063218	76	151	16	10	75	0.1333333
NODE_222991_length_273_cov_3.063218	76	151	18	2	75	0.0266667
NODE_222991_length_273_cov_3.063218	76	151	20	4	75	0.0533333
NODE_222991_length_273_cov_3.063218	76	151	24	14	75	0.1866667
NODE_222991_length_273_cov_3.063218	76	151	26	3	75	0.0400000
NODE_222991_length_273_cov_3.063218	76	151	28	10	75	0.1333333
NODE_222991_length_273_cov_3.063218	76	151	30	4	75	0.0533333
NODE_222991_length_273_cov_3.063218	76	151	32	14	75	0.1866667
NODE_222991_length_273_cov_3.063218	76	151	34	1	75	0.0133333
NODE_222991_length_273_cov_3.063218	76	151	36	2	75	0.0266667
NODE_222991_length_273_cov_3.063218	76	151	38	1	75	0.0133333
NODE_222991_length_273_cov_3.063218	76	151	40	2	75	0.0266667
NODE_222991_length_273_cov_3.063218	76	151	42	8	75	0.1066667
NODE_222991_length_273_cov_3.063218	135	191	6	16	56	0.2857143
NODE_222991_length_273_cov_3.063218	135	191	8	2	56	0.0357143
NODE_222991_length_273_cov_3.063218	135	191	10	3	56	0.0535714
NODE_222991_length_273_cov_3.063218	135	191	12	8	56	0.1428571
NODE_222991_length_273_cov_3.063218	135	191	14	3	56	0.0535714
NODE_222991_length_273_cov_3.063218	135	191	16	18	56	0.3214286
NODE_222991_length_273_cov_3.063218	135	191	18	2	56	0.0357143
NODE_222991_length_273_cov_3.063218	135	191	20	4	56	0.0714286
NODE_223066_length_273_cov_2.706897	11	45	2	11	34	0.3235294
NODE_223066_length_273_cov_2.706897	11	45	4	23	34	0.6764706
NODE_223203_length_273_cov_2.339080	69	145	0	39	76	0.5131579
NODE_223203_length_273_cov_2.339080	69	145	4	11	76	0.1447368
NODE_223203_length_273_cov_2.339080	69	145	6	26	76	0.3421053
NODE_223353_length_273_cov_2.051724	31	74	0	5	43	0.1162791
NODE_223353_length_273_cov_2.051724	31	74	2	38	43	0.8837209
NODE_223377_length_273_cov_2.034483	81	161	0	24	80	0.3000000
NODE_223377_length_273_cov_2.034483	81	161	2	10	80	0.1250000
NODE_223377_length_273_cov_2.034483	81	161	4	46	80	0.5750000
NODE_223377_length_273_cov_2.034483	213	263	0	23	50	0.4600000
NODE_223377_length_273_cov_2.034483	213	263	2	4	50	0.0800000
NODE_223377_length_273_cov_2.034483	213	263	4	23	50	0.4600000
NODE_223680_length_273_cov_1.706897	181	238	0	57	57	1.0000000
NODE_223913_length_273_cov_1.442529	5	47	0	42	42	1.0000000
NODE_224023_length_273_cov_1.281609	167	247	0	80	80	1.0000000
NODE_224082_length_273_cov_1.189655	120	156	0	36	36	1.0000000
NODE_224082_length_273_cov_1.189655	129	160	0	27	31	0.8709677
NODE_224082_length_273_cov_1.189655	129	160	2	4	31	0.1290323
NODE_224165_length_273_cov_1.172414	94	130	0	36	36	1.0000000
NODE_224254_length_273_cov_1.172414	8	58	0	5	50	0.1000000
NODE_224254_length_273_cov_1.172414	8	58	2	15	50	0.3000000
NODE_224254_length_273_cov_1.172414	8	58	4	30	50	0.6000000
NODE_224367_length_273_cov_1.166667	74	93	0	1	19	0.0526316
NODE_224367_length_273_cov_1.166667	74	93	2	18	19	0.9473684
NODE_224441_length_273_cov_1.091954	6	42	0	11	36	0.3055556
NODE_224441_length_273_cov_1.091954	6	42	2	25	36	0.6944444
NODE_224441_length_273_cov_1.091954	43	95	0	8	52	0.1538462
NODE_224441_length_273_cov_1.091954	43	95	2	44	52	0.8461539
NODE_224587_length_273_cov_0.971264	188	235	0	47	47	1.0000000
NODE_225303_length_273_cov_0.586207	27	88	0	61	61	1.0000000
NODE_225344_length_273_cov_0.586207	24	79	0	55	55	1.0000000
NODE_225344_length_273_cov_0.586207	81	113	0	32	32	1.0000000
NODE_225592_length_272_cov_6.190751	172	236	0	39	64	0.6093750
NODE_225592_length_272_cov_6.190751	172	236	2	25	64	0.3906250
NODE_225607_length_272_cov_5.335260	193	272	0	79	79	1.0000000
NODE_225633_length_272_cov_4.716763	228	257	0	29	29	1.0000000
NODE_225656_length_272_cov_4.219653	93	166	2	5	73	0.0684932
NODE_225656_length_272_cov_4.219653	93	166	4	1	73	0.0136986
NODE_225656_length_272_cov_4.219653	93	166	6	24	73	0.3287671
NODE_225656_length_272_cov_4.219653	93	166	8	43	73	0.5890411
NODE_225656_length_272_cov_4.219653	146	219	4	25	73	0.3424658
NODE_225656_length_272_cov_4.219653	146	219	6	13	73	0.1780822
NODE_225656_length_272_cov_4.219653	146	219	8	35	73	0.4794520
NODE_225658_length_272_cov_4.184971	75	128	0	53	53	1.0000000
NODE_225739_length_272_cov_3.352601	154	199	3	39	45	0.8666667
NODE_225739_length_272_cov_3.352601	154	199	4	6	45	0.1333333
NODE_225872_length_272_cov_2.664740	106	186	0	80	80	1.0000000
NODE_226010_length_272_cov_2.335260	33	103	0	70	70	1.0000000
NODE_226029_length_272_cov_2.277457	219	256	0	37	37	1.0000000
NODE_226045_length_272_cov_2.236994	104	184	2	5	80	0.0625000
NODE_226045_length_272_cov_2.236994	104	184	4	18	80	0.2250000
NODE_226045_length_272_cov_2.236994	104	184	6	4	80	0.0500000
NODE_226045_length_272_cov_2.236994	104	184	8	9	80	0.1125000
NODE_226045_length_272_cov_2.236994	104	184	10	10	80	0.1250000
NODE_226045_length_272_cov_2.236994	104	184	12	34	80	0.4250000
NODE_226169_length_272_cov_1.982659	172	252	2	80	80	1.0000000
NODE_226245_length_272_cov_1.780347	37	99	0	62	62	1.0000000
NODE_226245_length_272_cov_1.780347	90	152	0	62	62	1.0000000
NODE_226248_length_272_cov_1.768786	12	45	0	33	33	1.0000000
NODE_226461_length_272_cov_1.618497	97	160	0	27	63	0.4285714
NODE_226461_length_272_cov_1.618497	97	160	2	12	63	0.1904762
NODE_226461_length_272_cov_1.618497	97	160	6	12	63	0.1904762
NODE_226461_length_272_cov_1.618497	97	160	10	12	63	0.1904762
NODE_226508_length_272_cov_1.543353	69	137	0	14	68	0.2058824
NODE_226508_length_272_cov_1.543353	69	137	2	54	68	0.7941176
NODE_227037_length_272_cov_1.173410	147	203	0	56	56	1.0000000
NODE_227265_length_272_cov_0.988439	169	215	0	46	46	1.0000000
NODE_227444_length_272_cov_0.884393	126	163	0	37	37	1.0000000
NODE_228332_length_271_cov_5.238372	103	183	0	66	80	0.8250000
NODE_228332_length_271_cov_5.238372	103	183	2	14	80	0.1750000
NODE_228423_length_271_cov_3.546512	102	165	0	63	63	1.0000000
NODE_228429_length_271_cov_3.476744	62	93	0	31	31	1.0000000
NODE_228494_length_271_cov_2.959302	96	176	2	61	80	0.7625000
NODE_228494_length_271_cov_2.959302	96	176	4	19	80	0.2375000
NODE_228494_length_271_cov_2.959302	149	229	0	15	80	0.1875000
NODE_228494_length_271_cov_2.959302	149	229	2	65	80	0.8125000
NODE_228554_length_271_cov_2.715116	160	241	0	81	81	1.0000000
NODE_228593_length_271_cov_2.622093	180	253	0	73	73	1.0000000
NODE_228623_length_271_cov_2.465116	45	75	0	24	30	0.8000000
NODE_228623_length_271_cov_2.465116	45	75	2	6	30	0.2000000
NODE_228731_length_271_cov_2.284884	95	158	4	47	63	0.7460318
NODE_228731_length_271_cov_2.284884	95	158	6	16	63	0.2539683
NODE_228731_length_271_cov_2.284884	131	211	0	26	80	0.3250000
NODE_228731_length_271_cov_2.284884	131	211	2	24	80	0.3000000
NODE_228731_length_271_cov_2.284884	131	211	4	30	80	0.3750000
NODE_228737_length_271_cov_2.273256	163	219	0	56	56	1.0000000
NODE_228830_length_271_cov_2.069767	130	212	0	9	82	0.1097561
NODE_228830_length_271_cov_2.069767	130	212	2	73	82	0.8902439
NODE_228932_length_271_cov_1.784884	135	183	0	48	48	1.0000000
NODE_228937_length_271_cov_1.779070	204	268	0	19	64	0.2968750
NODE_228937_length_271_cov_1.779070	204	268	1	13	64	0.2031250
NODE_228937_length_271_cov_1.779070	204	268	2	32	64	0.5000000
NODE_229085_length_271_cov_1.755814	119	199	0	33	80	0.4125000
NODE_229085_length_271_cov_1.755814	119	199	2	47	80	0.5875000
NODE_229242_length_271_cov_1.523256	122	183	0	8	61	0.1311475
NODE_229242_length_271_cov_1.523256	122	183	2	12	61	0.1967213
NODE_229242_length_271_cov_1.523256	122	183	3	1	61	0.0163934
NODE_229242_length_271_cov_1.523256	122	183	4	27	61	0.4426230
NODE_229242_length_271_cov_1.523256	122	183	6	13	61	0.2131148
NODE_229254_length_271_cov_1.511628	106	186	32	1	80	0.0125000
NODE_229254_length_271_cov_1.511628	106	186	34	1	80	0.0125000
NODE_229254_length_271_cov_1.511628	106	186	36	4	80	0.0500000
NODE_229254_length_271_cov_1.511628	106	186	38	12	80	0.1500000
NODE_229254_length_271_cov_1.511628	106	186	40	14	80	0.1750000
NODE_229254_length_271_cov_1.511628	106	186	42	3	80	0.0375000
NODE_229254_length_271_cov_1.511628	106	186	44	8	80	0.1000000
NODE_229254_length_271_cov_1.511628	106	186	46	16	80	0.2000000
NODE_229254_length_271_cov_1.511628	106	186	47	1	80	0.0125000
NODE_229254_length_271_cov_1.511628	106	186	48	8	80	0.1000000
NODE_229254_length_271_cov_1.511628	106	186	50	8	80	0.1000000
NODE_229254_length_271_cov_1.511628	106	186	52	4	80	0.0500000
NODE_229525_length_271_cov_1.226744	119	184	2	65	65	1.0000000
NODE_229541_length_271_cov_1.197674	88	145	0	6	57	0.1052632
NODE_229541_length_271_cov_1.197674	88	145	4	51	57	0.8947368
NODE_229541_length_271_cov_1.197674	118	192	4	74	74	1.0000000
NODE_230154_length_271_cov_0.918605	155	227	0	30	72	0.4166667
NODE_230154_length_271_cov_0.918605	155	227	2	42	72	0.5833333
NODE_230255_length_271_cov_0.889535	101	148	0	46	47	0.9787234
NODE_230255_length_271_cov_0.889535	101	148	2	1	47	0.0212766
NODE_230318_length_271_cov_0.889535	127	188	0	58	61	0.9508197
NODE_230318_length_271_cov_0.889535	127	188	2	3	61	0.0491803
NODE_231165_length_270_cov_4.818713	72	118	2	24	46	0.5217391
NODE_231165_length_270_cov_4.818713	72	118	4	22	46	0.4782609
NODE_231187_length_270_cov_4.327485	5	82	0	77	77	1.0000000
NODE_231240_length_270_cov_3.666667	87	154	0	19	67	0.2835821
NODE_231240_length_270_cov_3.666667	87	154	2	6	67	0.0895522
NODE_231240_length_270_cov_3.666667	87	154	4	42	67	0.6268657
NODE_231240_length_270_cov_3.666667	140	207	0	9	67	0.1343284
NODE_231240_length_270_cov_3.666667	140	207	2	25	67	0.3731343
NODE_231240_length_270_cov_3.666667	140	207	4	33	67	0.4925373
NODE_231263_length_270_cov_3.491228	186	270	0	79	84	0.9404762
NODE_231263_length_270_cov_3.491228	186	270	2	5	84	0.0595238
NODE_231310_length_270_cov_3.105263	43	90	0	2	47	0.0425532
NODE_231310_length_270_cov_3.105263	43	90	2	38	47	0.8085107
NODE_231310_length_270_cov_3.105263	43	90	4	7	47	0.1489362
NODE_231316_length_270_cov_3.046784	64	135	0	31	71	0.4366197
NODE_231316_length_270_cov_3.046784	64	135	2	40	71	0.5633803
NODE_231439_length_270_cov_2.649123	210	270	0	60	60	1.0000000
NODE_231655_length_270_cov_2.087719	16	55	0	39	39	1.0000000
NODE_231655_length_270_cov_2.087719	78	108	0	24	30	0.8000000
NODE_231655_length_270_cov_2.087719	78	108	1	6	30	0.2000000
NODE_231714_length_270_cov_2.040936	103	159	30	1	56	0.0178571
NODE_231714_length_270_cov_2.040936	103	159	36	2	56	0.0357143
NODE_231714_length_270_cov_2.040936	103	159	42	1	56	0.0178571
NODE_231714_length_270_cov_2.040936	103	159	44	1	56	0.0178571
NODE_231714_length_270_cov_2.040936	103	159	52	1	56	0.0178571
NODE_231714_length_270_cov_2.040936	103	159	54	2	56	0.0357143
NODE_231714_length_270_cov_2.040936	103	159	60	1	56	0.0178571
NODE_231714_length_270_cov_2.040936	103	159	62	1	56	0.0178571
NODE_231714_length_270_cov_2.040936	103	159	67	1	56	0.0178571
NODE_231714_length_270_cov_2.040936	103	159	72	1	56	0.0178571
NODE_231714_length_270_cov_2.040936	103	159	78	1	56	0.0178571
NODE_231714_length_270_cov_2.040936	103	159	80	1	56	0.0178571
NODE_231714_length_270_cov_2.040936	103	159	84	2	56	0.0357143
NODE_231714_length_270_cov_2.040936	103	159	88	1	56	0.0178571
NODE_231714_length_270_cov_2.040936	103	159	90	2	56	0.0357143
NODE_231714_length_270_cov_2.040936	103	159	94	5	56	0.0892857
NODE_231714_length_270_cov_2.040936	103	159	98	2	56	0.0357143
NODE_231714_length_270_cov_2.040936	103	159	102	5	56	0.0892857
NODE_231714_length_270_cov_2.040936	103	159	106	1	56	0.0178571
NODE_231714_length_270_cov_2.040936	103	159	116	1	56	0.0178571
NODE_231714_length_270_cov_2.040936	103	159	118	2	56	0.0357143
NODE_231714_length_270_cov_2.040936	103	159	120	7	56	0.1250000
NODE_231714_length_270_cov_2.040936	103	159	122	2	56	0.0357143
NODE_231714_length_270_cov_2.040936	103	159	126	2	56	0.0357143
NODE_231714_length_270_cov_2.040936	103	159	128	2	56	0.0357143
NODE_231714_length_270_cov_2.040936	103	159	130	2	56	0.0357143
NODE_231714_length_270_cov_2.040936	103	159	132	4	56	0.0714286
NODE_231714_length_270_cov_2.040936	103	159	134	1	56	0.0178571
NODE_231714_length_270_cov_2.040936	103	159	136	1	56	0.0178571
NODE_231726_length_270_cov_2.017544	1	48	0	47	47	1.0000000
NODE_231820_length_270_cov_1.789474	146	228	0	6	82	0.0731707
NODE_231820_length_270_cov_1.789474	146	228	1	13	82	0.1585366
NODE_231820_length_270_cov_1.789474	146	228	2	63	82	0.7682927
NODE_232008_length_270_cov_1.678363	178	246	0	68	68	1.0000000
NODE_232021_length_270_cov_1.666667	127	191	0	16	64	0.2500000
NODE_232021_length_270_cov_1.666667	127	191	1	1	64	0.0156250
NODE_232021_length_270_cov_1.666667	127	191	2	3	64	0.0468750
NODE_232021_length_270_cov_1.666667	127	191	6	5	64	0.0781250
NODE_232021_length_270_cov_1.666667	127	191	8	5	64	0.0781250
NODE_232021_length_270_cov_1.666667	127	191	10	6	64	0.0937500
NODE_232021_length_270_cov_1.666667	127	191	11	1	64	0.0156250
NODE_232021_length_270_cov_1.666667	127	191	12	9	64	0.1406250
NODE_232021_length_270_cov_1.666667	127	191	16	2	64	0.0312500
NODE_232021_length_270_cov_1.666667	127	191	18	8	64	0.1250000
NODE_232021_length_270_cov_1.666667	127	191	20	2	64	0.0312500
NODE_232021_length_270_cov_1.666667	127	191	22	2	64	0.0312500
NODE_232021_length_270_cov_1.666667	127	191	24	2	64	0.0312500
NODE_232021_length_270_cov_1.666667	127	191	26	2	64	0.0312500
NODE_232021_length_270_cov_1.666667	180	227	0	47	47	1.0000000
NODE_232087_length_270_cov_1.555556	138	218	0	80	80	1.0000000
NODE_232331_length_270_cov_1.280702	4	75	0	46	71	0.6478873
NODE_232331_length_270_cov_1.280702	4	75	2	25	71	0.3521127
NODE_232331_length_270_cov_1.280702	57	137	2	48	80	0.6000000
NODE_232331_length_270_cov_1.280702	57	137	4	8	80	0.1000000
NODE_232331_length_270_cov_1.280702	57	137	6	24	80	0.3000000
NODE_232331_length_270_cov_1.280702	65	120	2	40	55	0.7272727
NODE_232331_length_270_cov_1.280702	65	120	4	8	55	0.1454545
NODE_232331_length_270_cov_1.280702	65	120	6	7	55	0.1272727
NODE_232331_length_270_cov_1.280702	125	198	4	38	73	0.5205479
NODE_232331_length_270_cov_1.280702	125	198	6	35	73	0.4794520
NODE_232440_length_270_cov_1.192982	146	194	0	48	48	1.0000000
NODE_232583_length_270_cov_1.192982	61	141	0	80	80	1.0000000
NODE_233290_length_270_cov_0.847953	53	128	0	7	75	0.0933333
NODE_233290_length_270_cov_0.847953	53	128	2	68	75	0.9066667
NODE_234072_length_269_cov_3.894118	30	110	0	69	80	0.8625000
NODE_234072_length_269_cov_3.894118	30	110	2	11	80	0.1375000
NODE_234072_length_269_cov_3.894118	83	163	0	16	80	0.2000000
NODE_234072_length_269_cov_3.894118	83	163	2	64	80	0.8000000
NODE_234100_length_269_cov_3.605882	175	205	0	30	30	1.0000000
NODE_234116_length_269_cov_3.523529	192	233	0	2	41	0.0487805
NODE_234116_length_269_cov_3.523529	192	233	2	39	41	0.9512195
NODE_234116_length_269_cov_3.523529	206	268	0	37	62	0.5967742
NODE_234116_length_269_cov_3.523529	206	268	2	25	62	0.4032258
NODE_234118_length_269_cov_3.505882	13	93	0	80	80	1.0000000
NODE_234118_length_269_cov_3.505882	66	145	0	79	79	1.0000000
NODE_234162_length_269_cov_3.147059	134	174	2	40	40	1.0000000
NODE_234167_length_269_cov_3.111765	39	119	0	80	80	1.0000000
NODE_234167_length_269_cov_3.111765	92	169	0	77	77	1.0000000
NODE_234178_length_269_cov_3.000000	166	233	0	67	67	1.0000000
NODE_234205_length_269_cov_2.947059	55	123	0	68	68	1.0000000
NODE_234224_length_269_cov_2.858824	9	89	0	80	80	1.0000000
NODE_234224_length_269_cov_2.858824	62	91	0	29	29	1.0000000
NODE_234228_length_269_cov_2.823529	0	73	2	9	73	0.1232877
NODE_234228_length_269_cov_2.823529	0	73	4	24	73	0.3287671
NODE_234228_length_269_cov_2.823529	0	73	6	2	73	0.0273973
NODE_234228_length_269_cov_2.823529	0	73	8	1	73	0.0136986
NODE_234228_length_269_cov_2.823529	0	73	10	12	73	0.1643836
NODE_234228_length_269_cov_2.823529	0	73	12	21	73	0.2876712
NODE_234228_length_269_cov_2.823529	0	73	14	3	73	0.0410959
NODE_234228_length_269_cov_2.823529	0	73	18	1	73	0.0136986
NODE_234228_length_269_cov_2.823529	46	77	10	2	31	0.0645161
NODE_234228_length_269_cov_2.823529	46	77	12	21	31	0.6774194
NODE_234228_length_269_cov_2.823529	46	77	14	3	31	0.0967742
NODE_234228_length_269_cov_2.823529	46	77	18	5	31	0.1612903
NODE_234431_length_269_cov_2.311765	111	157	0	30	46	0.6521739
NODE_234431_length_269_cov_2.311765	111	157	2	16	46	0.3478261
NODE_234431_length_269_cov_2.311765	130	209	0	11	79	0.1392405
NODE_234431_length_269_cov_2.311765	130	209	2	68	79	0.8607595
NODE_234606_length_269_cov_1.958824	176	248	2	55	72	0.7638889
NODE_234606_length_269_cov_1.958824	176	248	4	17	72	0.2361111
NODE_234647_length_269_cov_1.847059	72	99	0	27	27	1.0000000
NODE_234657_length_269_cov_1.823529	30	81	6	2	51	0.0392157
NODE_234657_length_269_cov_1.823529	30	81	8	49	51	0.9607843
NODE_234758_length_269_cov_1.800000	0	42	0	42	42	1.0000000
NODE_234978_length_269_cov_1.552941	90	170	0	63	80	0.7875000
NODE_234978_length_269_cov_1.552941	90	170	2	17	80	0.2125000
NODE_235157_length_269_cov_1.400000	139	219	4	14	80	0.1750000
NODE_235157_length_269_cov_1.400000	139	219	8	2	80	0.0250000
NODE_235157_length_269_cov_1.400000	139	219	10	13	80	0.1625000
NODE_235157_length_269_cov_1.400000	139	219	14	5	80	0.0625000
NODE_235157_length_269_cov_1.400000	139	219	16	41	80	0.5125000
NODE_235157_length_269_cov_1.400000	139	219	18	5	80	0.0625000
NODE_235168_length_269_cov_1.388235	185	252	0	39	67	0.5820895
NODE_235168_length_269_cov_1.388235	185	252	2	28	67	0.4179105
NODE_235239_length_269_cov_1.288235	150	179	0	2	29	0.0689655
NODE_235239_length_269_cov_1.288235	150	179	2	7	29	0.2413793
NODE_235239_length_269_cov_1.288235	150	179	4	15	29	0.5172414
NODE_235239_length_269_cov_1.288235	150	179	5	3	29	0.1034483
NODE_235239_length_269_cov_1.288235	150	179	6	2	29	0.0689655
NODE_235292_length_269_cov_1.217647	141	221	0	12	80	0.1500000
NODE_235292_length_269_cov_1.217647	141	221	2	68	80	0.8500000
NODE_235561_length_269_cov_1.194118	107	170	0	63	63	1.0000000
NODE_235561_length_269_cov_1.194118	143	221	0	78	78	1.0000000
NODE_235714_length_269_cov_1.094118	38	72	0	34	34	1.0000000
NODE_235780_length_269_cov_1.035294	6	36	0	30	30	1.0000000
NODE_235780_length_269_cov_1.035294	96	150	0	54	54	1.0000000
NODE_235930_length_269_cov_0.917647	4	79	0	75	75	1.0000000
NODE_235930_length_269_cov_0.917647	57	93	0	36	36	1.0000000
NODE_236243_length_269_cov_0.782353	2	52	0	14	50	0.2800000
NODE_236243_length_269_cov_0.782353	2	52	2	9	50	0.1800000
NODE_236243_length_269_cov_0.782353	2	52	4	2	50	0.0400000
NODE_236243_length_269_cov_0.782353	2	52	6	4	50	0.0800000
NODE_236243_length_269_cov_0.782353	2	52	8	1	50	0.0200000
NODE_236243_length_269_cov_0.782353	2	52	12	2	50	0.0400000
NODE_236243_length_269_cov_0.782353	2	52	14	4	50	0.0800000
NODE_236243_length_269_cov_0.782353	2	52	16	2	50	0.0400000
NODE_236243_length_269_cov_0.782353	2	52	18	4	50	0.0800000
NODE_236243_length_269_cov_0.782353	2	52	20	2	50	0.0400000
NODE_236243_length_269_cov_0.782353	2	52	22	2	50	0.0400000
NODE_236243_length_269_cov_0.782353	2	52	24	1	50	0.0200000
NODE_236243_length_269_cov_0.782353	2	52	26	3	50	0.0600000
NODE_236243_length_269_cov_0.782353	76	132	24	3	56	0.0535714
NODE_236243_length_269_cov_0.782353	76	132	26	10	56	0.1785714
NODE_236243_length_269_cov_0.782353	76	132	28	20	56	0.3571429
NODE_236243_length_269_cov_0.782353	76	132	30	9	56	0.1607143
NODE_236243_length_269_cov_0.782353	76	132	32	14	56	0.2500000
NODE_236856_length_268_cov_223.165680	161	188	4	27	27	1.0000000
NODE_236856_length_268_cov_223.165680	161	241	2	42	80	0.5250000
NODE_236856_length_268_cov_223.165680	161	241	4	38	80	0.4750000
NODE_236878_length_268_cov_6.266272	29	111	0	82	82	1.0000000
NODE_236909_length_268_cov_5.053254	137	217	0	80	80	1.0000000
NODE_236909_length_268_cov_5.053254	190	253	0	63	63	1.0000000
NODE_236911_length_268_cov_4.994083	92	168	0	15	76	0.1973684
NODE_236911_length_268_cov_4.994083	92	168	1	61	76	0.8026316
NODE_236972_length_268_cov_3.905325	1	61	0	60	60	1.0000000
NODE_237107_length_268_cov_2.982249	95	175	4	34	80	0.4250000
NODE_237107_length_268_cov_2.982249	95	175	6	39	80	0.4875000
NODE_237107_length_268_cov_2.982249	95	175	8	4	80	0.0500000
NODE_237107_length_268_cov_2.982249	95	175	10	3	80	0.0375000
NODE_237115_length_268_cov_2.940828	28	97	0	69	69	1.0000000
NODE_237185_length_268_cov_2.668639	57	110	0	45	53	0.8490566
NODE_237185_length_268_cov_2.668639	57	110	2	8	53	0.1509434
NODE_237190_length_268_cov_2.621302	149	176	0	27	27	1.0000000
NODE_237325_length_268_cov_2.289941	87	127	17	5	40	0.1250000
NODE_237325_length_268_cov_2.289941	87	127	18	4	40	0.1000000
NODE_237325_length_268_cov_2.289941	87	127	20	12	40	0.3000000
NODE_237325_length_268_cov_2.289941	87	127	22	3	40	0.0750000
NODE_237325_length_268_cov_2.289941	87	127	24	9	40	0.2250000
NODE_237325_length_268_cov_2.289941	87	127	26	2	40	0.0500000
NODE_237325_length_268_cov_2.289941	87	127	28	5	40	0.1250000
NODE_237345_length_268_cov_2.224852	96	176	0	11	80	0.1375000
NODE_237345_length_268_cov_2.224852	96	176	6	39	80	0.4875000
NODE_237345_length_268_cov_2.224852	96	176	8	30	80	0.3750000
NODE_237345_length_268_cov_2.224852	149	229	2	8	80	0.1000000
NODE_237345_length_268_cov_2.224852	149	229	8	72	80	0.9000000
NODE_237457_length_268_cov_2.005917	97	162	0	18	65	0.2769231
NODE_237457_length_268_cov_2.005917	97	162	2	47	65	0.7230769
NODE_237502_length_268_cov_1.840237	80	155	0	21	75	0.2800000
NODE_237502_length_268_cov_1.840237	80	155	2	54	75	0.7200000
NODE_237572_length_268_cov_1.810651	8	84	0	76	76	1.0000000
NODE_237831_length_268_cov_1.532544	186	257	2	6	71	0.0845070
NODE_237831_length_268_cov_1.532544	186	257	3	3	71	0.0422535
NODE_237831_length_268_cov_1.532544	186	257	4	6	71	0.0845070
NODE_237831_length_268_cov_1.532544	186	257	12	24	71	0.3380282
NODE_237831_length_268_cov_1.532544	186	257	14	3	71	0.0422535
NODE_237831_length_268_cov_1.532544	186	257	16	2	71	0.0281690
NODE_237831_length_268_cov_1.532544	186	257	18	2	71	0.0281690
NODE_237831_length_268_cov_1.532544	186	257	20	10	71	0.1408451
NODE_237831_length_268_cov_1.532544	186	257	21	15	71	0.2112676
NODE_237906_length_268_cov_1.508876	52	131	0	79	79	1.0000000
NODE_238009_length_268_cov_1.384615	0	46	0	7	46	0.1521739
NODE_238009_length_268_cov_1.384615	0	46	2	39	46	0.8478261
NODE_238070_length_268_cov_1.278107	100	175	2	75	75	1.0000000
NODE_238153_length_268_cov_1.207101	187	209	0	2	22	0.0909091
NODE_238153_length_268_cov_1.207101	187	209	2	20	22	0.9090909
NODE_238478_length_268_cov_1.153846	135	195	0	60	60	1.0000000
NODE_239018_length_268_cov_0.852071	59	119	8	60	60	1.0000000
NODE_239805_length_267_cov_4.297619	0	52	0	52	52	1.0000000
NODE_239817_length_267_cov_4.119048	41	87	0	22	46	0.4782609
NODE_239817_length_267_cov_4.119048	41	87	2	24	46	0.5217391
NODE_239845_length_267_cov_3.785714	96	163	0	67	67	1.0000000
NODE_239845_length_267_cov_3.785714	136	178	0	42	42	1.0000000
NODE_239873_length_267_cov_3.535714	40	101	0	9	61	0.1475410
NODE_239873_length_267_cov_3.535714	40	101	2	21	61	0.3442623
NODE_239873_length_267_cov_3.535714	40	101	4	31	61	0.5081967
NODE_239873_length_267_cov_3.535714	74	154	2	22	80	0.2750000
NODE_239873_length_267_cov_3.535714	74	154	4	58	80	0.7250000
NODE_239958_length_267_cov_3.005952	216	267	0	51	51	1.0000000
NODE_239959_length_267_cov_3.000000	87	144	0	3	57	0.0526316
NODE_239959_length_267_cov_3.000000	87	144	2	11	57	0.1929825
NODE_239959_length_267_cov_3.000000	87	144	4	10	57	0.1754386
NODE_239959_length_267_cov_3.000000	87	144	6	2	57	0.0350877
NODE_239959_length_267_cov_3.000000	87	144	8	5	57	0.0877193
NODE_239959_length_267_cov_3.000000	87	144	12	8	57	0.1403509
NODE_239959_length_267_cov_3.000000	87	144	14	3	57	0.0526316
NODE_239959_length_267_cov_3.000000	87	144	16	7	57	0.1228070
NODE_239959_length_267_cov_3.000000	87	144	18	8	57	0.1403509
NODE_240007_length_267_cov_2.726190	177	220	4	31	43	0.7209302
NODE_240007_length_267_cov_2.726190	177	220	5	12	43	0.2790698
NODE_240024_length_267_cov_2.690476	117	170	10	3	53	0.0566038
NODE_240024_length_267_cov_2.690476	117	170	12	33	53	0.6226415
NODE_240024_length_267_cov_2.690476	117	170	14	17	53	0.3207547
NODE_240029_length_267_cov_2.666667	198	267	0	69	69	1.0000000
NODE_240114_length_267_cov_2.428571	189	254	0	7	65	0.1076923
NODE_240114_length_267_cov_2.428571	189	254	2	56	65	0.8615385
NODE_240114_length_267_cov_2.428571	189	254	14	2	65	0.0307692
NODE_240207_length_267_cov_2.208333	45	103	4	58	58	1.0000000
NODE_240246_length_267_cov_2.125000	124	175	0	51	51	1.0000000
NODE_240303_length_267_cov_2.077381	65	146	6	38	81	0.4691358
NODE_240303_length_267_cov_2.077381	65	146	7	6	81	0.0740741
NODE_240303_length_267_cov_2.077381	65	146	8	37	81	0.4567901
NODE_240303_length_267_cov_2.077381	229	264	0	35	35	1.0000000
NODE_240331_length_267_cov_2.005952	147	228	0	57	81	0.7037037
NODE_240331_length_267_cov_2.005952	147	228	2	6	81	0.0740741
NODE_240331_length_267_cov_2.005952	147	228	4	5	81	0.0617284
NODE_240331_length_267_cov_2.005952	147	228	6	7	81	0.0864198
NODE_240331_length_267_cov_2.005952	147	228	8	6	81	0.0740741
NODE_240331_length_267_cov_2.005952	201	267	0	66	66	1.0000000
NODE_240336_length_267_cov_1.988095	77	157	0	80	80	1.0000000
NODE_240336_length_267_cov_1.988095	130	210	0	80	80	1.0000000
NODE_240620_length_267_cov_1.755952	119	199	0	51	80	0.6375000
NODE_240620_length_267_cov_1.755952	119	199	2	15	80	0.1875000
NODE_240620_length_267_cov_1.755952	119	199	4	14	80	0.1750000
NODE_240624_length_267_cov_1.750000	23	104	10	1	81	0.0123457
NODE_240624_length_267_cov_1.750000	23	104	12	17	81	0.2098765
NODE_240624_length_267_cov_1.750000	23	104	14	6	81	0.0740741
NODE_240624_length_267_cov_1.750000	23	104	16	14	81	0.1728395
NODE_240624_length_267_cov_1.750000	23	104	18	1	81	0.0123457
NODE_240624_length_267_cov_1.750000	23	104	19	2	81	0.0246914
NODE_240624_length_267_cov_1.750000	23	104	20	1	81	0.0123457
NODE_240624_length_267_cov_1.750000	23	104	22	14	81	0.1728395
NODE_240624_length_267_cov_1.750000	23	104	24	25	81	0.3086420
NODE_240624_length_267_cov_1.750000	179	208	2	26	29	0.8965517
NODE_240624_length_267_cov_1.750000	179	208	4	3	29	0.1034483
NODE_240653_length_267_cov_1.690476	18	90	0	8	72	0.1111111
NODE_240653_length_267_cov_1.690476	18	90	2	64	72	0.8888889
NODE_240790_length_267_cov_1.517857	6	43	0	26	37	0.7027027
NODE_240790_length_267_cov_1.517857	6	43	2	11	37	0.2972973
NODE_241075_length_267_cov_1.214286	37	91	0	54	54	1.0000000
NODE_241240_length_267_cov_1.214286	89	126	0	12	37	0.3243243
NODE_241240_length_267_cov_1.214286	89	126	2	25	37	0.6756757
NODE_241352_length_267_cov_1.208333	124	164	0	40	40	1.0000000
NODE_241484_length_267_cov_1.125000	57	103	0	46	46	1.0000000
NODE_241512_length_267_cov_1.089286	119	196	0	77	77	1.0000000
NODE_241512_length_267_cov_1.089286	169	249	0	80	80	1.0000000
NODE_241517_length_267_cov_1.083333	133	152	18	2	19	0.1052632
NODE_241517_length_267_cov_1.083333	133	152	22	11	19	0.5789474
NODE_241517_length_267_cov_1.083333	133	152	24	6	19	0.3157895
NODE_241517_length_267_cov_1.083333	183	264	0	34	81	0.4197531
NODE_241517_length_267_cov_1.083333	183	264	2	2	81	0.0246914
NODE_241517_length_267_cov_1.083333	183	264	4	13	81	0.1604938
NODE_241517_length_267_cov_1.083333	183	264	6	3	81	0.0370370
NODE_241517_length_267_cov_1.083333	183	264	8	2	81	0.0246914
NODE_241517_length_267_cov_1.083333	183	264	12	7	81	0.0864198
NODE_241517_length_267_cov_1.083333	183	264	14	8	81	0.0987654
NODE_241517_length_267_cov_1.083333	183	264	16	6	81	0.0740741
NODE_241517_length_267_cov_1.083333	183	264	18	6	81	0.0740741
NODE_241588_length_267_cov_1.017857	205	267	0	62	62	1.0000000
NODE_241633_length_267_cov_0.982143	4	75	0	6	71	0.0845070
NODE_241633_length_267_cov_0.982143	4	75	2	65	71	0.9154930
NODE_242999_length_266_cov_5.706587	120	199	0	79	79	1.0000000
NODE_242999_length_266_cov_5.706587	172	239	0	67	67	1.0000000
NODE_243010_length_266_cov_5.107784	68	150	0	14	82	0.1707317
NODE_243010_length_266_cov_5.107784	68	150	2	68	82	0.8292683
NODE_243064_length_266_cov_4.125749	99	168	2	9	69	0.1304348
NODE_243064_length_266_cov_4.125749	99	168	4	1	69	0.0144928
NODE_243064_length_266_cov_4.125749	99	168	8	10	69	0.1449275
NODE_243064_length_266_cov_4.125749	99	168	12	15	69	0.2173913
NODE_243064_length_266_cov_4.125749	99	168	16	4	69	0.0579710
NODE_243064_length_266_cov_4.125749	99	168	18	2	69	0.0289855
NODE_243064_length_266_cov_4.125749	99	168	20	5	69	0.0724638
NODE_243064_length_266_cov_4.125749	99	168	22	10	69	0.1449275
NODE_243064_length_266_cov_4.125749	99	168	24	13	69	0.1884058
NODE_243079_length_266_cov_3.958084	40	120	0	80	80	1.0000000
NODE_243079_length_266_cov_3.958084	93	159	0	66	66	1.0000000
NODE_243136_length_266_cov_3.419162	68	130	4	5	62	0.0806452
NODE_243136_length_266_cov_3.419162	68	130	6	57	62	0.9193549
NODE_243136_length_266_cov_3.419162	116	183	2	6	67	0.0895522
NODE_243136_length_266_cov_3.419162	116	183	4	26	67	0.3880597
NODE_243136_length_266_cov_3.419162	116	183	6	35	67	0.5223880
NODE_243168_length_266_cov_3.137725	6	86	0	80	80	1.0000000
NODE_243168_length_266_cov_3.137725	59	120	0	61	61	1.0000000
NODE_243174_length_266_cov_3.107784	166	232	8	5	66	0.0757576
NODE_243174_length_266_cov_3.107784	166	232	10	2	66	0.0303030
NODE_243174_length_266_cov_3.107784	166	232	12	53	66	0.8030303
NODE_243174_length_266_cov_3.107784	166	232	14	1	66	0.0151515
NODE_243174_length_266_cov_3.107784	166	232	18	2	66	0.0303030
NODE_243174_length_266_cov_3.107784	166	232	20	2	66	0.0303030
NODE_243174_length_266_cov_3.107784	166	232	24	1	66	0.0151515
NODE_243475_length_266_cov_2.179641	110	191	8	3	81	0.0370370
NODE_243475_length_266_cov_2.179641	110	191	12	7	81	0.0864198
NODE_243475_length_266_cov_2.179641	110	191	14	1	81	0.0123457
NODE_243475_length_266_cov_2.179641	110	191	15	13	81	0.1604938
NODE_243475_length_266_cov_2.179641	110	191	17	1	81	0.0123457
NODE_243475_length_266_cov_2.179641	110	191	19	14	81	0.1728395
NODE_243475_length_266_cov_2.179641	110	191	20	11	81	0.1358025
NODE_243475_length_266_cov_2.179641	110	191	22	5	81	0.0617284
NODE_243475_length_266_cov_2.179641	110	191	24	1	81	0.0123457
NODE_243475_length_266_cov_2.179641	110	191	26	18	81	0.2222222
NODE_243475_length_266_cov_2.179641	110	191	28	7	81	0.0864198
NODE_243497_length_266_cov_2.137725	156	236	2	29	80	0.3625000
NODE_243497_length_266_cov_2.137725	156	236	4	51	80	0.6375000
NODE_243570_length_266_cov_2.023952	47	123	0	76	76	1.0000000
NODE_243972_length_266_cov_1.532934	155	235	0	80	80	1.0000000
NODE_244681_length_266_cov_1.113772	70	97	0	27	27	1.0000000
NODE_244760_length_266_cov_1.023952	144	201	2	57	57	1.0000000
NODE_244760_length_266_cov_1.023952	199	265	0	34	66	0.5151515
NODE_244760_length_266_cov_1.023952	199	265	2	32	66	0.4848485
NODE_245049_length_266_cov_0.916168	51	122	0	71	71	1.0000000
NODE_245280_length_266_cov_0.730539	132	158	0	26	26	1.0000000
NODE_245538_length_266_cov_0.610778	99	139	0	40	40	1.0000000
NODE_245538_length_266_cov_0.610778	112	156	0	44	44	1.0000000
NODE_246087_length_265_cov_7.843373	128	208	2	24	80	0.3000000
NODE_246087_length_265_cov_7.843373	128	208	3	7	80	0.0875000
NODE_246087_length_265_cov_7.843373	128	208	9	17	80	0.2125000
NODE_246087_length_265_cov_7.843373	128	208	10	7	80	0.0875000
NODE_246087_length_265_cov_7.843373	128	208	11	3	80	0.0375000
NODE_246087_length_265_cov_7.843373	128	208	14	5	80	0.0625000
NODE_246087_length_265_cov_7.843373	128	208	16	6	80	0.0750000
NODE_246087_length_265_cov_7.843373	128	208	18	10	80	0.1250000
NODE_246087_length_265_cov_7.843373	128	208	20	1	80	0.0125000
NODE_246192_length_265_cov_4.054217	65	145	0	80	80	1.0000000
NODE_246192_length_265_cov_4.054217	118	198	0	80	80	1.0000000
NODE_246198_length_265_cov_3.993976	195	231	0	36	36	1.0000000
NODE_246284_length_265_cov_3.150602	183	263	0	56	80	0.7000000
NODE_246284_length_265_cov_3.150602	183	263	2	24	80	0.3000000
NODE_246374_length_265_cov_2.789157	177	238	0	61	61	1.0000000
NODE_246409_length_265_cov_2.734940	167	247	0	3	80	0.0375000
NODE_246409_length_265_cov_2.734940	167	247	2	77	80	0.9625000
NODE_246432_length_265_cov_2.608434	188	259	0	71	71	1.0000000
NODE_246606_length_265_cov_2.156627	197	237	10	9	40	0.2250000
NODE_246606_length_265_cov_2.156627	197	237	13	11	40	0.2750000
NODE_246606_length_265_cov_2.156627	197	237	15	2	40	0.0500000
NODE_246606_length_265_cov_2.156627	197	237	17	18	40	0.4500000
NODE_246624_length_265_cov_2.150602	169	218	4	28	49	0.5714286
NODE_246624_length_265_cov_2.150602	169	218	6	21	49	0.4285714
NODE_246692_length_265_cov_1.975904	15	44	0	29	29	1.0000000
NODE_246811_length_265_cov_1.843373	195	265	0	1	70	0.0142857
NODE_246811_length_265_cov_1.843373	195	265	2	20	70	0.2857143
NODE_246811_length_265_cov_1.843373	195	265	4	49	70	0.7000000
NODE_247028_length_265_cov_1.620482	115	186	0	2	71	0.0281690
NODE_247028_length_265_cov_1.620482	115	186	2	12	71	0.1690141
NODE_247028_length_265_cov_1.620482	115	186	4	57	71	0.8028169
NODE_247028_length_265_cov_1.620482	117	171	2	12	54	0.2222222
NODE_247028_length_265_cov_1.620482	117	171	4	42	54	0.7777778
NODE_247031_length_265_cov_1.614458	53	113	1	5	60	0.0833333
NODE_247031_length_265_cov_1.614458	53	113	4	4	60	0.0666667
NODE_247031_length_265_cov_1.614458	53	113	6	8	60	0.1333333
NODE_247031_length_265_cov_1.614458	53	113	10	7	60	0.1166667
NODE_247031_length_265_cov_1.614458	53	113	12	2	60	0.0333333
NODE_247031_length_265_cov_1.614458	53	113	15	21	60	0.3500000
NODE_247031_length_265_cov_1.614458	53	113	16	12	60	0.2000000
NODE_247031_length_265_cov_1.614458	53	113	18	1	60	0.0166667
NODE_247031_length_265_cov_1.614458	86	166	15	14	80	0.1750000
NODE_247031_length_265_cov_1.614458	86	166	16	12	80	0.1500000
NODE_247031_length_265_cov_1.614458	86	166	18	5	80	0.0625000
NODE_247031_length_265_cov_1.614458	86	166	25	10	80	0.1250000
NODE_247031_length_265_cov_1.614458	86	166	27	2	80	0.0250000
NODE_247031_length_265_cov_1.614458	86	166	31	7	80	0.0875000
NODE_247031_length_265_cov_1.614458	86	166	35	5	80	0.0625000
NODE_247031_length_265_cov_1.614458	86	166	37	20	80	0.2500000
NODE_247031_length_265_cov_1.614458	86	166	41	1	80	0.0125000
NODE_247031_length_265_cov_1.614458	86	166	44	4	80	0.0500000
NODE_247314_length_265_cov_1.337349	107	168	10	5	61	0.0819672
NODE_247314_length_265_cov_1.337349	107	168	12	1	61	0.0163934
NODE_247314_length_265_cov_1.337349	107	168	14	4	61	0.0655738
NODE_247314_length_265_cov_1.337349	107	168	18	13	61	0.2131148
NODE_247314_length_265_cov_1.337349	107	168	20	20	61	0.3278688
NODE_247314_length_265_cov_1.337349	107	168	21	6	61	0.0983607
NODE_247314_length_265_cov_1.337349	107	168	22	12	61	0.1967213
NODE_247952_length_265_cov_1.000000	187	251	0	17	64	0.2656250
NODE_247952_length_265_cov_1.000000	187	251	2	47	64	0.7343750
NODE_247972_length_265_cov_0.987952	44	63	0	19	19	1.0000000
NODE_249395_length_264_cov_4.018182	141	178	0	6	37	0.1621622
NODE_249395_length_264_cov_4.018182	141	178	2	31	37	0.8378378
NODE_249404_length_264_cov_3.957576	59	132	2	30	73	0.4109589
NODE_249404_length_264_cov_3.957576	59	132	4	43	73	0.5890411
NODE_249404_length_264_cov_3.957576	112	192	0	33	80	0.4125000
NODE_249404_length_264_cov_3.957576	112	192	2	47	80	0.5875000
NODE_249415_length_264_cov_3.824242	178	220	0	42	42	1.0000000
NODE_249452_length_264_cov_3.400000	73	125	0	52	52	1.0000000
NODE_249452_length_264_cov_3.400000	124	165	0	41	41	1.0000000
NODE_249485_length_264_cov_3.133333	119	186	0	67	67	1.0000000
NODE_249530_length_264_cov_3.012121	122	198	0	67	76	0.8815789
NODE_249530_length_264_cov_3.012121	122	198	2	9	76	0.1184211
NODE_249904_length_264_cov_2.048485	32	98	6	3	66	0.0454545
NODE_249904_length_264_cov_2.048485	32	98	8	51	66	0.7727273
NODE_249904_length_264_cov_2.048485	32	98	10	3	66	0.0454545
NODE_249904_length_264_cov_2.048485	32	98	12	1	66	0.0151515
NODE_249904_length_264_cov_2.048485	32	98	14	2	66	0.0303030
NODE_249904_length_264_cov_2.048485	32	98	20	1	66	0.0151515
NODE_249904_length_264_cov_2.048485	32	98	26	5	66	0.0757576
NODE_249905_length_264_cov_2.048485	133	176	0	43	43	1.0000000
NODE_249912_length_264_cov_2.012121	20	84	0	64	64	1.0000000
NODE_249931_length_264_cov_1.951515	178	211	0	33	33	1.0000000
NODE_249982_length_264_cov_1.854545	130	161	0	31	31	1.0000000
NODE_250202_length_264_cov_1.745455	26	81	0	55	55	1.0000000
NODE_250202_length_264_cov_1.745455	86	153	0	67	67	1.0000000
NODE_250203_length_264_cov_1.745455	90	169	16	8	79	0.1012658
NODE_250203_length_264_cov_1.745455	90	169	18	4	79	0.0506329
NODE_250203_length_264_cov_1.745455	90	169	20	1	79	0.0126582
NODE_250203_length_264_cov_1.745455	90	169	22	7	79	0.0886076
NODE_250203_length_264_cov_1.745455	90	169	26	1	79	0.0126582
NODE_250203_length_264_cov_1.745455	90	169	30	4	79	0.0506329
NODE_250203_length_264_cov_1.745455	90	169	36	4	79	0.0506329
NODE_250203_length_264_cov_1.745455	90	169	38	4	79	0.0506329
NODE_250203_length_264_cov_1.745455	90	169	40	3	79	0.0379747
NODE_250203_length_264_cov_1.745455	90	169	42	5	79	0.0632911
NODE_250203_length_264_cov_1.745455	90	169	44	2	79	0.0253165
NODE_250203_length_264_cov_1.745455	90	169	46	6	79	0.0759494
NODE_250203_length_264_cov_1.745455	90	169	48	2	79	0.0253165
NODE_250203_length_264_cov_1.745455	90	169	50	1	79	0.0126582
NODE_250203_length_264_cov_1.745455	90	169	52	3	79	0.0379747
NODE_250203_length_264_cov_1.745455	90	169	54	2	79	0.0253165
NODE_250203_length_264_cov_1.745455	90	169	60	2	79	0.0253165
NODE_250203_length_264_cov_1.745455	90	169	62	3	79	0.0379747
NODE_250203_length_264_cov_1.745455	90	169	64	5	79	0.0632911
NODE_250203_length_264_cov_1.745455	90	169	68	2	79	0.0253165
NODE_250203_length_264_cov_1.745455	90	169	70	1	79	0.0126582
NODE_250203_length_264_cov_1.745455	90	169	72	1	79	0.0126582
NODE_250203_length_264_cov_1.745455	90	169	74	4	79	0.0506329
NODE_250203_length_264_cov_1.745455	90	169	76	2	79	0.0253165
NODE_250203_length_264_cov_1.745455	90	169	78	1	79	0.0126582
NODE_250203_length_264_cov_1.745455	90	169	80	1	79	0.0126582
NODE_250203_length_264_cov_1.745455	143	207	52	2	64	0.0312500
NODE_250203_length_264_cov_1.745455	143	207	54	2	64	0.0312500
NODE_250203_length_264_cov_1.745455	143	207	60	2	64	0.0312500
NODE_250203_length_264_cov_1.745455	143	207	62	3	64	0.0468750
NODE_250203_length_264_cov_1.745455	143	207	64	6	64	0.0937500
NODE_250203_length_264_cov_1.745455	143	207	66	7	64	0.1093750
NODE_250203_length_264_cov_1.745455	143	207	68	3	64	0.0468750
NODE_250203_length_264_cov_1.745455	143	207	70	9	64	0.1406250
NODE_250203_length_264_cov_1.745455	143	207	72	3	64	0.0468750
NODE_250203_length_264_cov_1.745455	143	207	74	8	64	0.1250000
NODE_250203_length_264_cov_1.745455	143	207	76	9	64	0.1406250
NODE_250203_length_264_cov_1.745455	143	207	78	9	64	0.1406250
NODE_250203_length_264_cov_1.745455	143	207	80	1	64	0.0156250
NODE_250297_length_264_cov_1.569697	173	236	0	45	63	0.7142857
NODE_250297_length_264_cov_1.569697	173	236	2	18	63	0.2857143
NODE_250314_length_264_cov_1.545455	206	255	0	49	49	1.0000000
NODE_250381_length_264_cov_1.545455	35	66	0	31	31	1.0000000
NODE_250446_length_264_cov_1.503030	0	63	0	63	63	1.0000000
NODE_250513_length_264_cov_1.406061	149	230	0	27	81	0.3333333
NODE_250513_length_264_cov_1.406061	149	230	2	54	81	0.6666667
NODE_250513_length_264_cov_1.406061	225	260	0	35	35	1.0000000
NODE_250635_length_264_cov_1.236364	2	63	0	8	61	0.1311475
NODE_250635_length_264_cov_1.236364	2	63	2	53	61	0.8688524
NODE_251015_length_264_cov_1.151515	11	68	0	57	57	1.0000000
NODE_251529_length_264_cov_0.921212	49	85	0	36	36	1.0000000
NODE_251703_length_264_cov_0.721212	233	252	0	19	19	1.0000000
NODE_252559_length_263_cov_5.115854	132	219	16	1	87	0.0114943
NODE_252559_length_263_cov_5.115854	132	219	19	1	87	0.0114943
NODE_252559_length_263_cov_5.115854	132	219	20	15	87	0.1724138
NODE_252559_length_263_cov_5.115854	132	219	22	43	87	0.4942529
NODE_252559_length_263_cov_5.115854	132	219	24	15	87	0.1724138
NODE_252559_length_263_cov_5.115854	132	219	26	6	87	0.0689655
NODE_252559_length_263_cov_5.115854	132	219	28	6	87	0.0689655
NODE_252563_length_263_cov_4.914634	45	117	1	72	72	1.0000000
NODE_252595_length_263_cov_4.225610	67	124	2	31	57	0.5438597
NODE_252595_length_263_cov_4.225610	67	124	4	26	57	0.4561403
NODE_252663_length_263_cov_3.518293	104	176	4	5	72	0.0694444
NODE_252663_length_263_cov_3.518293	104	176	6	54	72	0.7500000
NODE_252663_length_263_cov_3.518293	104	176	8	13	72	0.1805556
NODE_252766_length_263_cov_2.908537	7	93	2	59	86	0.6860465
NODE_252766_length_263_cov_2.908537	7	93	4	27	86	0.3139535
NODE_252778_length_263_cov_2.798780	67	146	0	3	79	0.0379747
NODE_252778_length_263_cov_2.798780	67	146	2	6	79	0.0759494
NODE_252778_length_263_cov_2.798780	67	146	4	29	79	0.3670886
NODE_252778_length_263_cov_2.798780	67	146	6	41	79	0.5189874
NODE_252932_length_263_cov_2.396341	207	238	0	31	31	1.0000000
NODE_253261_length_263_cov_1.865854	51	81	8	3	30	0.1000000
NODE_253261_length_263_cov_1.865854	51	81	10	27	30	0.9000000
NODE_253310_length_263_cov_1.847561	113	189	0	76	76	1.0000000
NODE_253379_length_263_cov_1.750000	151	231	0	80	80	1.0000000
NODE_253468_length_263_cov_1.579268	32	95	4	2	63	0.0317460
NODE_253468_length_263_cov_1.579268	32	95	6	1	63	0.0158730
NODE_253468_length_263_cov_1.579268	32	95	8	3	63	0.0476190
NODE_253468_length_263_cov_1.579268	32	95	10	6	63	0.0952381
NODE_253468_length_263_cov_1.579268	32	95	12	1	63	0.0158730
NODE_253468_length_263_cov_1.579268	32	95	13	2	63	0.0317460
NODE_253468_length_263_cov_1.579268	32	95	15	5	63	0.0793651
NODE_253468_length_263_cov_1.579268	32	95	17	1	63	0.0158730
NODE_253468_length_263_cov_1.579268	32	95	19	4	63	0.0634921
NODE_253468_length_263_cov_1.579268	32	95	21	6	63	0.0952381
NODE_253468_length_263_cov_1.579268	32	95	26	1	63	0.0158730
NODE_253468_length_263_cov_1.579268	32	95	29	2	63	0.0317460
NODE_253468_length_263_cov_1.579268	32	95	30	3	63	0.0476190
NODE_253468_length_263_cov_1.579268	32	95	32	2	63	0.0317460
NODE_253468_length_263_cov_1.579268	32	95	34	11	63	0.1746032
NODE_253468_length_263_cov_1.579268	32	95	36	13	63	0.2063492
NODE_253477_length_263_cov_1.567073	98	155	0	57	57	1.0000000
NODE_253619_length_263_cov_1.506098	157	217	2	60	60	1.0000000
NODE_253620_length_263_cov_1.506098	84	113	6	29	29	1.0000000
NODE_253753_length_263_cov_1.286585	143	223	0	3	80	0.0375000
NODE_253753_length_263_cov_1.286585	143	223	2	4	80	0.0500000
NODE_253753_length_263_cov_1.286585	143	223	4	2	80	0.0250000
NODE_253753_length_263_cov_1.286585	143	223	6	21	80	0.2625000
NODE_253753_length_263_cov_1.286585	143	223	8	5	80	0.0625000
NODE_253753_length_263_cov_1.286585	143	223	16	1	80	0.0125000
NODE_253753_length_263_cov_1.286585	143	223	26	2	80	0.0250000
NODE_253753_length_263_cov_1.286585	143	223	28	5	80	0.0625000
NODE_253753_length_263_cov_1.286585	143	223	30	8	80	0.1000000
NODE_253753_length_263_cov_1.286585	143	223	32	29	80	0.3625000
NODE_253788_length_263_cov_1.243902	206	263	0	57	57	1.0000000
NODE_254174_length_263_cov_1.170732	12	66	0	54	54	1.0000000
NODE_254174_length_263_cov_1.170732	39	119	0	80	80	1.0000000
NODE_254301_length_263_cov_1.067073	137	202	0	65	65	1.0000000
NODE_254301_length_263_cov_1.067073	175	255	0	80	80	1.0000000
NODE_254783_length_263_cov_0.810976	163	245	17	2	82	0.0243902
NODE_254783_length_263_cov_0.810976	163	245	19	1	82	0.0121951
NODE_254783_length_263_cov_0.810976	163	245	21	2	82	0.0243902
NODE_254783_length_263_cov_0.810976	163	245	22	1	82	0.0121951
NODE_254783_length_263_cov_0.810976	163	245	28	2	82	0.0243902
NODE_254783_length_263_cov_0.810976	163	245	29	1	82	0.0121951
NODE_254783_length_263_cov_0.810976	163	245	32	3	82	0.0365854
NODE_254783_length_263_cov_0.810976	163	245	36	1	82	0.0121951
NODE_254783_length_263_cov_0.810976	163	245	40	5	82	0.0609756
NODE_254783_length_263_cov_0.810976	163	245	46	1	82	0.0121951
NODE_254783_length_263_cov_0.810976	163	245	47	1	82	0.0121951
NODE_254783_length_263_cov_0.810976	163	245	51	2	82	0.0243902
NODE_254783_length_263_cov_0.810976	163	245	52	2	82	0.0243902
NODE_254783_length_263_cov_0.810976	163	245	54	4	82	0.0487805
NODE_254783_length_263_cov_0.810976	163	245	58	1	82	0.0121951
NODE_254783_length_263_cov_0.810976	163	245	59	1	82	0.0121951
NODE_254783_length_263_cov_0.810976	163	245	64	1	82	0.0121951
NODE_254783_length_263_cov_0.810976	163	245	71	1	82	0.0121951
NODE_254783_length_263_cov_0.810976	163	245	73	1	82	0.0121951
NODE_254783_length_263_cov_0.810976	163	245	75	1	82	0.0121951
NODE_254783_length_263_cov_0.810976	163	245	87	1	82	0.0121951
NODE_254783_length_263_cov_0.810976	163	245	91	1	82	0.0121951
NODE_254783_length_263_cov_0.810976	163	245	93	1	82	0.0121951
NODE_254783_length_263_cov_0.810976	163	245	105	1	82	0.0121951
NODE_254783_length_263_cov_0.810976	163	245	107	1	82	0.0121951
NODE_254783_length_263_cov_0.810976	163	245	115	1	82	0.0121951
NODE_254783_length_263_cov_0.810976	163	245	119	1	82	0.0121951
NODE_254783_length_263_cov_0.810976	163	245	129	1	82	0.0121951
NODE_254783_length_263_cov_0.810976	163	245	131	1	82	0.0121951
NODE_254783_length_263_cov_0.810976	163	245	133	1	82	0.0121951
NODE_254783_length_263_cov_0.810976	163	245	137	1	82	0.0121951
NODE_254783_length_263_cov_0.810976	163	245	139	1	82	0.0121951
NODE_254783_length_263_cov_0.810976	163	245	141	1	82	0.0121951
NODE_254783_length_263_cov_0.810976	163	245	145	1	82	0.0121951
NODE_254783_length_263_cov_0.810976	163	245	149	3	82	0.0365854
NODE_254783_length_263_cov_0.810976	163	245	151	1	82	0.0121951
NODE_254783_length_263_cov_0.810976	163	245	153	2	82	0.0243902
NODE_254783_length_263_cov_0.810976	163	245	154	2	82	0.0243902
NODE_254783_length_263_cov_0.810976	163	245	160	1	82	0.0121951
NODE_254783_length_263_cov_0.810976	163	245	166	1	82	0.0121951
NODE_254783_length_263_cov_0.810976	163	245	168	1	82	0.0121951
NODE_254783_length_263_cov_0.810976	163	245	172	1	82	0.0121951
NODE_254783_length_263_cov_0.810976	163	245	173	1	82	0.0121951
NODE_254783_length_263_cov_0.810976	163	245	175	1	82	0.0121951
NODE_254783_length_263_cov_0.810976	163	245	183	1	82	0.0121951
NODE_254783_length_263_cov_0.810976	163	245	187	2	82	0.0243902
NODE_254783_length_263_cov_0.810976	163	245	189	1	82	0.0121951
NODE_254783_length_263_cov_0.810976	163	245	197	2	82	0.0243902
NODE_254783_length_263_cov_0.810976	163	245	199	1	82	0.0121951
NODE_254783_length_263_cov_0.810976	163	245	201	3	82	0.0365854
NODE_254783_length_263_cov_0.810976	163	245	205	1	82	0.0121951
NODE_254783_length_263_cov_0.810976	163	245	211	1	82	0.0121951
NODE_254783_length_263_cov_0.810976	163	245	212	1	82	0.0121951
NODE_254783_length_263_cov_0.810976	163	245	214	1	82	0.0121951
NODE_254783_length_263_cov_0.810976	163	245	216	2	82	0.0243902
NODE_254783_length_263_cov_0.810976	163	245	218	1	82	0.0121951
NODE_254783_length_263_cov_0.810976	163	245	220	1	82	0.0121951
NODE_254783_length_263_cov_0.810976	163	245	222	2	82	0.0243902
NODE_255446_length_263_cov_0.621951	212	258	0	46	46	1.0000000
NODE_255524_length_263_cov_0.621951	131	151	0	20	20	1.0000000
NODE_255559_length_263_cov_0.621951	67	86	0	19	19	1.0000000
NODE_255727_length_262_cov_5.312883	20	82	0	62	62	1.0000000
NODE_255769_length_262_cov_4.447853	102	155	2	1	53	0.0188679
NODE_255769_length_262_cov_4.447853	102	155	6	37	53	0.6981132
NODE_255769_length_262_cov_4.447853	102	155	8	15	53	0.2830189
NODE_255821_length_262_cov_3.766871	48	89	0	41	41	1.0000000
NODE_255860_length_262_cov_3.435583	158	235	0	77	77	1.0000000
NODE_255945_length_262_cov_2.938650	142	222	0	80	80	1.0000000
NODE_256009_length_262_cov_2.723926	103	183	0	80	80	1.0000000
NODE_256049_length_262_cov_2.509202	88	148	2	4	60	0.0666667
NODE_256049_length_262_cov_2.509202	88	148	4	1	60	0.0166667
NODE_256049_length_262_cov_2.509202	88	148	8	20	60	0.3333333
NODE_256049_length_262_cov_2.509202	88	148	10	35	60	0.5833333
NODE_256050_length_262_cov_2.509202	0	61	0	61	61	1.0000000
NODE_256050_length_262_cov_2.509202	107	171	0	64	64	1.0000000
NODE_256050_length_262_cov_2.509202	144	224	0	80	80	1.0000000
NODE_256129_length_262_cov_2.429448	14	87	0	11	73	0.1506849
NODE_256129_length_262_cov_2.429448	14	87	4	1	73	0.0136986
NODE_256129_length_262_cov_2.429448	14	87	6	61	73	0.8356164
NODE_256129_length_262_cov_2.429448	62	149	0	73	87	0.8390805
NODE_256129_length_262_cov_2.429448	62	149	4	1	87	0.0114943
NODE_256129_length_262_cov_2.429448	62	149	6	13	87	0.1494253
NODE_256176_length_262_cov_2.226994	2	79	2	77	77	1.0000000
NODE_256187_length_262_cov_2.202454	61	81	0	20	20	1.0000000
NODE_256199_length_262_cov_2.190184	172	235	31	14	63	0.2222222
NODE_256199_length_262_cov_2.190184	172	235	33	1	63	0.0158730
NODE_256199_length_262_cov_2.190184	172	235	35	14	63	0.2222222
NODE_256199_length_262_cov_2.190184	172	235	37	34	63	0.5396826
NODE_256239_length_262_cov_2.177914	133	189	0	9	56	0.1607143
NODE_256239_length_262_cov_2.177914	133	189	2	5	56	0.0892857
NODE_256239_length_262_cov_2.177914	133	189	4	42	56	0.7500000
NODE_256265_length_262_cov_2.122699	96	157	2	61	61	1.0000000
NODE_256386_length_262_cov_1.877301	0	77	2	77	77	1.0000000
NODE_256390_length_262_cov_1.877301	77	124	8	1	47	0.0212766
NODE_256390_length_262_cov_1.877301	77	124	10	46	47	0.9787234
NODE_256481_length_262_cov_1.871166	192	252	0	60	60	1.0000000
NODE_256596_length_262_cov_1.736196	149	208	0	59	59	1.0000000
NODE_256630_length_262_cov_1.680982	2	82	0	80	80	1.0000000
NODE_256650_length_262_cov_1.656442	135	166	0	31	31	1.0000000
NODE_256659_length_262_cov_1.638037	111	142	4	16	31	0.5161290
NODE_256659_length_262_cov_1.638037	111	142	6	5	31	0.1612903
NODE_256659_length_262_cov_1.638037	111	142	8	10	31	0.3225806
NODE_256704_length_262_cov_1.576687	102	182	0	80	80	1.0000000
NODE_256704_length_262_cov_1.576687	155	221	0	64	66	0.9696970
NODE_256704_length_262_cov_1.576687	155	221	2	2	66	0.0303030
NODE_256742_length_262_cov_1.564417	69	124	0	6	55	0.1090909
NODE_256742_length_262_cov_1.564417	69	124	2	41	55	0.7454545
NODE_256742_length_262_cov_1.564417	69	124	6	1	55	0.0181818
NODE_256742_length_262_cov_1.564417	69	124	8	2	55	0.0363636
NODE_256742_length_262_cov_1.564417	69	124	10	5	55	0.0909091
NODE_256742_length_262_cov_1.564417	106	177	2	10	71	0.1408451
NODE_256742_length_262_cov_1.564417	106	177	6	1	71	0.0140845
NODE_256742_length_262_cov_1.564417	106	177	8	2	71	0.0281690
NODE_256742_length_262_cov_1.564417	106	177	10	6	71	0.0845070
NODE_256742_length_262_cov_1.564417	106	177	12	52	71	0.7323943
NODE_256933_length_262_cov_1.349693	52	102	0	50	50	1.0000000
NODE_256933_length_262_cov_1.349693	83	149	0	66	66	1.0000000
NODE_257199_length_262_cov_1.251534	44	124	0	21	80	0.2625000
NODE_257199_length_262_cov_1.251534	44	124	2	59	80	0.7375000
NODE_257199_length_262_cov_1.251534	97	171	0	7	74	0.0945946
NODE_257199_length_262_cov_1.251534	97	171	2	67	74	0.9054054
NODE_258876_length_261_cov_31.913580	32	112	0	5	80	0.0625000
NODE_258876_length_261_cov_31.913580	32	112	4	75	80	0.9375000
NODE_258876_length_261_cov_31.913580	85	171	0	64	86	0.7441860
NODE_258876_length_261_cov_31.913580	85	171	4	22	86	0.2558140
NODE_258901_length_261_cov_6.376543	126	201	0	75	75	1.0000000
NODE_258901_length_261_cov_6.376543	179	254	0	75	75	1.0000000
NODE_258929_length_261_cov_5.469136	56	132	0	76	76	1.0000000
NODE_259329_length_261_cov_2.425926	53	134	0	77	81	0.9506173
NODE_259329_length_261_cov_2.425926	53	134	2	4	81	0.0493827
NODE_259361_length_261_cov_2.333333	41	136	2	36	95	0.3789474
NODE_259361_length_261_cov_2.333333	41	136	4	59	95	0.6210526
NODE_259435_length_261_cov_2.191358	86	122	0	36	36	1.0000000
NODE_259495_length_261_cov_1.993827	134	214	0	80	80	1.0000000
NODE_259672_length_261_cov_1.882716	51	105	4	5	54	0.0925926
NODE_259672_length_261_cov_1.882716	51	105	8	4	54	0.0740741
NODE_259672_length_261_cov_1.882716	51	105	10	5	54	0.0925926
NODE_259672_length_261_cov_1.882716	51	105	12	9	54	0.1666667
NODE_259672_length_261_cov_1.882716	51	105	14	3	54	0.0555556
NODE_259672_length_261_cov_1.882716	51	105	18	28	54	0.5185185
NODE_259740_length_261_cov_1.839506	118	197	2	60	79	0.7594936
NODE_259740_length_261_cov_1.839506	118	197	4	3	79	0.0379747
NODE_259740_length_261_cov_1.839506	118	197	6	13	79	0.1645570
NODE_259740_length_261_cov_1.839506	118	197	8	3	79	0.0379747
NODE_259769_length_261_cov_1.783951	69	141	0	52	72	0.7222222
NODE_259769_length_261_cov_1.783951	69	141	2	20	72	0.2777778
NODE_260089_length_261_cov_1.388889	202	247	0	45	45	1.0000000
NODE_260090_length_261_cov_1.382716	14	61	0	47	47	1.0000000
NODE_260428_length_261_cov_1.253086	100	138	0	38	38	1.0000000
NODE_260738_length_261_cov_1.030864	122	205	0	26	83	0.3132530
NODE_260738_length_261_cov_1.030864	122	205	2	57	83	0.6867470
NODE_260738_length_261_cov_1.030864	129	210	0	19	81	0.2345679
NODE_260738_length_261_cov_1.030864	129	210	2	62	81	0.7654321
NODE_260738_length_261_cov_1.030864	129	184	0	19	55	0.3454545
NODE_260738_length_261_cov_1.030864	129	184	2	36	55	0.6545454
NODE_260738_length_261_cov_1.030864	187	248	0	12	61	0.1967213
NODE_260738_length_261_cov_1.030864	187	248	2	49	61	0.8032787
NODE_260767_length_261_cov_1.006173	3	45	0	10	42	0.2380952
NODE_260767_length_261_cov_1.006173	3	45	2	4	42	0.0952381
NODE_260767_length_261_cov_1.006173	3	45	4	28	42	0.6666667
NODE_260767_length_261_cov_1.006173	46	98	2	6	52	0.1153846
NODE_260767_length_261_cov_1.006173	46	98	4	46	52	0.8846154
NODE_262062_length_261_cov_0.580247	11	31	0	20	20	1.0000000
NODE_262121_length_260_cov_8.844720	74	138	4	64	64	1.0000000
NODE_262123_length_260_cov_8.447205	30	110	0	80	80	1.0000000
NODE_262123_length_260_cov_8.447205	83	167	0	84	84	1.0000000
NODE_262123_length_260_cov_8.447205	163	243	0	80	80	1.0000000
NODE_262149_length_260_cov_5.807453	38	118	0	80	80	1.0000000
NODE_262149_length_260_cov_5.807453	91	171	0	80	80	1.0000000
NODE_262264_length_260_cov_3.645963	5	57	0	52	52	1.0000000
NODE_262329_length_260_cov_3.167702	91	163	0	72	72	1.0000000
NODE_262378_length_260_cov_2.981366	58	127	0	69	69	1.0000000
NODE_262384_length_260_cov_2.913043	10	90	0	80	80	1.0000000
NODE_262708_length_260_cov_2.161491	174	251	0	77	77	1.0000000
NODE_262733_length_260_cov_2.080745	188	258	0	70	70	1.0000000
NODE_262788_length_260_cov_1.950311	27	85	0	58	58	1.0000000
NODE_262930_length_260_cov_1.900621	14	50	4	36	36	1.0000000
NODE_263117_length_260_cov_1.683230	50	130	0	80	80	1.0000000
NODE_263428_length_260_cov_1.347826	38	118	0	80	80	1.0000000
NODE_263533_length_260_cov_1.267081	114	199	0	85	85	1.0000000
NODE_263556_length_260_cov_1.267081	198	244	0	46	46	1.0000000
NODE_263568_length_260_cov_1.267081	145	189	12	22	44	0.5000000
NODE_263568_length_260_cov_1.267081	145	189	14	22	44	0.5000000
NODE_265483_length_259_cov_4.800000	35	95	2	21	60	0.3500000
NODE_265483_length_259_cov_4.800000	35	95	4	29	60	0.4833333
NODE_265483_length_259_cov_4.800000	35	95	6	10	60	0.1666667
NODE_265584_length_259_cov_3.675000	119	161	0	42	42	1.0000000
NODE_265584_length_259_cov_3.675000	134	214	0	80	80	1.0000000
NODE_265592_length_259_cov_3.593750	100	143	0	43	43	1.0000000
NODE_265611_length_259_cov_3.475000	198	259	0	61	61	1.0000000
NODE_265625_length_259_cov_3.331250	72	118	0	1	46	0.0217391
NODE_265625_length_259_cov_3.331250	72	118	3	1	46	0.0217391
NODE_265625_length_259_cov_3.331250	72	118	4	13	46	0.2826087
NODE_265625_length_259_cov_3.331250	72	118	6	31	46	0.6739131
NODE_265636_length_259_cov_3.237500	103	160	0	33	57	0.5789474
NODE_265636_length_259_cov_3.237500	103	160	2	24	57	0.4210526
NODE_265704_length_259_cov_2.937500	209	233	2	21	24	0.8750000
NODE_265704_length_259_cov_2.937500	209	233	4	2	24	0.0833333
NODE_265704_length_259_cov_2.937500	209	233	6	1	24	0.0416667
NODE_265735_length_259_cov_2.850000	0	41	0	41	41	1.0000000
NODE_265735_length_259_cov_2.850000	14	94	0	80	80	1.0000000
NODE_265818_length_259_cov_2.550000	9	82	0	2	73	0.0273973
NODE_265818_length_259_cov_2.550000	9	82	2	71	73	0.9726027
NODE_265942_length_259_cov_2.287500	147	225	2	78	78	1.0000000
NODE_265942_length_259_cov_2.287500	198	241	2	43	43	1.0000000
NODE_266032_length_259_cov_2.156250	0	72	0	72	72	1.0000000
NODE_266080_length_259_cov_2.012500	8	73	0	65	65	1.0000000
NODE_266080_length_259_cov_2.012500	53	126	0	26	73	0.3561644
NODE_266080_length_259_cov_2.012500	53	126	2	8	73	0.1095890
NODE_266080_length_259_cov_2.012500	53	126	6	39	73	0.5342466
NODE_266101_length_259_cov_1.962500	108	189	2	40	81	0.4938272
NODE_266101_length_259_cov_1.962500	108	189	4	41	81	0.5061728
NODE_266117_length_259_cov_1.918750	49	120	0	60	71	0.8450704
NODE_266117_length_259_cov_1.918750	49	120	2	11	71	0.1549296
NODE_266183_length_259_cov_1.912500	114	177	0	58	63	0.9206349
NODE_266183_length_259_cov_1.912500	114	177	2	5	63	0.0793651
NODE_266365_length_259_cov_1.837500	180	252	0	21	72	0.2916667
NODE_266365_length_259_cov_1.837500	180	252	5	7	72	0.0972222
NODE_266365_length_259_cov_1.837500	180	252	6	44	72	0.6111111
NODE_266609_length_259_cov_1.593750	27	67	8	4	40	0.1000000
NODE_266609_length_259_cov_1.593750	27	67	10	26	40	0.6500000
NODE_266609_length_259_cov_1.593750	27	67	12	10	40	0.2500000
NODE_266746_length_259_cov_1.400000	117	164	0	47	47	1.0000000
NODE_266746_length_259_cov_1.400000	137	217	0	40	80	0.5000000
NODE_266746_length_259_cov_1.400000	137	217	2	40	80	0.5000000
NODE_268816_length_258_cov_6.415094	129	209	0	80	80	1.0000000
NODE_268816_length_258_cov_6.415094	182	258	0	76	76	1.0000000
NODE_268823_length_258_cov_6.157233	1	81	0	80	80	1.0000000
NODE_268823_length_258_cov_6.157233	9	64	0	55	55	1.0000000
NODE_268852_length_258_cov_4.798742	83	163	0	80	80	1.0000000
NODE_268870_length_258_cov_4.396226	0	44	0	44	44	1.0000000
NODE_268870_length_258_cov_4.396226	24	97	0	46	73	0.6301370
NODE_268870_length_258_cov_4.396226	24	97	2	23	73	0.3150685
NODE_268870_length_258_cov_4.396226	24	97	4	4	73	0.0547945
NODE_268880_length_258_cov_4.301887	0	54	0	54	54	1.0000000
NODE_268942_length_258_cov_3.616352	29	58	0	3	29	0.1034483
NODE_268942_length_258_cov_3.616352	29	58	2	26	29	0.8965517
NODE_268982_length_258_cov_3.352201	47	127	2	1	80	0.0125000
NODE_268982_length_258_cov_3.352201	47	127	4	4	80	0.0500000
NODE_268982_length_258_cov_3.352201	47	127	6	7	80	0.0875000
NODE_268982_length_258_cov_3.352201	47	127	10	1	80	0.0125000
NODE_268982_length_258_cov_3.352201	47	127	12	5	80	0.0625000
NODE_268982_length_258_cov_3.352201	47	127	14	62	80	0.7750000
NODE_269086_length_258_cov_2.886792	102	121	2	19	19	1.0000000
NODE_269091_length_258_cov_2.880503	92	172	0	80	80	1.0000000
NODE_269102_length_258_cov_2.855346	96	138	20	5	42	0.1190476
NODE_269102_length_258_cov_2.855346	96	138	22	1	42	0.0238095
NODE_269102_length_258_cov_2.855346	96	138	24	12	42	0.2857143
NODE_269102_length_258_cov_2.855346	96	138	28	3	42	0.0714286
NODE_269102_length_258_cov_2.855346	96	138	30	8	42	0.1904762
NODE_269102_length_258_cov_2.855346	96	138	34	8	42	0.1904762
NODE_269102_length_258_cov_2.855346	96	138	36	5	42	0.1190476
NODE_269102_length_258_cov_2.855346	148	191	2	12	43	0.2790698
NODE_269102_length_258_cov_2.855346	148	191	4	3	43	0.0697674
NODE_269102_length_258_cov_2.855346	148	191	6	7	43	0.1627907
NODE_269102_length_258_cov_2.855346	148	191	12	1	43	0.0232558
NODE_269102_length_258_cov_2.855346	148	191	14	20	43	0.4651163
NODE_269113_length_258_cov_2.817610	10	58	2	18	48	0.3750000
NODE_269113_length_258_cov_2.817610	10	58	4	26	48	0.5416667
NODE_269113_length_258_cov_2.817610	10	58	6	4	48	0.0833333
NODE_269264_length_258_cov_2.383648	48	128	0	80	80	1.0000000
NODE_269264_length_258_cov_2.383648	101	182	0	34	81	0.4197531
NODE_269264_length_258_cov_2.383648	101	182	2	47	81	0.5802469
NODE_269338_length_258_cov_2.238994	61	141	0	80	80	1.0000000
NODE_269615_length_258_cov_1.918239	0	51	0	51	51	1.0000000
NODE_269682_length_258_cov_1.855346	26	47	0	21	21	1.0000000
NODE_269682_length_258_cov_1.855346	71	104	2	33	33	1.0000000
NODE_269682_length_258_cov_1.855346	81	156	2	36	75	0.4800000
NODE_269682_length_258_cov_1.855346	81	156	4	39	75	0.5200000
NODE_269749_length_258_cov_1.735849	105	176	0	29	71	0.4084507
NODE_269749_length_258_cov_1.735849	105	176	2	29	71	0.4084507
NODE_269749_length_258_cov_1.735849	105	176	4	2	71	0.0281690
NODE_269749_length_258_cov_1.735849	105	176	6	9	71	0.1267606
NODE_269749_length_258_cov_1.735849	105	176	8	2	71	0.0281690
NODE_269767_length_258_cov_1.710692	8	49	0	10	41	0.2439024
NODE_269767_length_258_cov_1.710692	8	49	2	31	41	0.7560976
NODE_270191_length_258_cov_1.283019	127	191	4	10	64	0.1562500
NODE_270191_length_258_cov_1.283019	127	191	6	4	64	0.0625000
NODE_270191_length_258_cov_1.283019	127	191	8	50	64	0.7812500
NODE_270191_length_258_cov_1.283019	164	227	6	2	63	0.0317460
NODE_270191_length_258_cov_1.283019	164	227	8	61	63	0.9682540
NODE_270465_length_258_cov_1.270440	4	55	0	51	51	1.0000000
NODE_270504_length_258_cov_1.232704	90	166	6	8	76	0.1052632
NODE_270504_length_258_cov_1.232704	90	166	8	4	76	0.0526316
NODE_270504_length_258_cov_1.232704	90	166	9	1	76	0.0131579
NODE_270504_length_258_cov_1.232704	90	166	10	16	76	0.2105263
NODE_270504_length_258_cov_1.232704	90	166	12	1	76	0.0131579
NODE_270504_length_258_cov_1.232704	90	166	14	31	76	0.4078947
NODE_270504_length_258_cov_1.232704	90	166	16	15	76	0.1973684
NODE_270547_length_258_cov_1.201258	49	98	2	37	49	0.7551020
NODE_270547_length_258_cov_1.201258	49	98	4	12	49	0.2448980
NODE_270876_length_258_cov_0.962264	186	258	0	25	72	0.3472222
NODE_270876_length_258_cov_0.962264	186	258	2	47	72	0.6527778
NODE_270970_length_258_cov_0.962264	69	124	0	55	55	1.0000000
NODE_272169_length_257_cov_71.158228	81	165	84	2	84	0.0238095
NODE_272169_length_257_cov_71.158228	81	165	86	7	84	0.0833333
NODE_272169_length_257_cov_71.158228	81	165	87	1	84	0.0119048
NODE_272169_length_257_cov_71.158228	81	165	89	2	84	0.0238095
NODE_272169_length_257_cov_71.158228	81	165	91	2	84	0.0238095
NODE_272169_length_257_cov_71.158228	81	165	93	2	84	0.0238095
NODE_272169_length_257_cov_71.158228	81	165	96	9	84	0.1071429
NODE_272169_length_257_cov_71.158228	81	165	98	2	84	0.0238095
NODE_272169_length_257_cov_71.158228	81	165	100	2	84	0.0238095
NODE_272169_length_257_cov_71.158228	81	165	102	3	84	0.0357143
NODE_272169_length_257_cov_71.158228	81	165	104	3	84	0.0357143
NODE_272169_length_257_cov_71.158228	81	165	106	1	84	0.0119048
NODE_272169_length_257_cov_71.158228	81	165	110	1	84	0.0119048
NODE_272169_length_257_cov_71.158228	81	165	111	1	84	0.0119048
NODE_272169_length_257_cov_71.158228	81	165	113	1	84	0.0119048
NODE_272169_length_257_cov_71.158228	81	165	114	2	84	0.0238095
NODE_272169_length_257_cov_71.158228	81	165	116	2	84	0.0238095
NODE_272169_length_257_cov_71.158228	81	165	118	4	84	0.0476190
NODE_272169_length_257_cov_71.158228	81	165	120	8	84	0.0952381
NODE_272169_length_257_cov_71.158228	81	165	122	10	84	0.1190476
NODE_272169_length_257_cov_71.158228	81	165	124	2	84	0.0238095
NODE_272169_length_257_cov_71.158228	81	165	126	3	84	0.0357143
NODE_272169_length_257_cov_71.158228	81	165	130	5	84	0.0595238
NODE_272169_length_257_cov_71.158228	81	165	132	4	84	0.0476190
NODE_272169_length_257_cov_71.158228	81	165	134	2	84	0.0238095
NODE_272169_length_257_cov_71.158228	81	165	136	3	84	0.0357143
NODE_272169_length_257_cov_71.158228	145	218	26	1	73	0.0136986
NODE_272169_length_257_cov_71.158228	145	218	29	1	73	0.0136986
NODE_272169_length_257_cov_71.158228	145	218	31	2	73	0.0273973
NODE_272169_length_257_cov_71.158228	145	218	32	14	73	0.1917808
NODE_272169_length_257_cov_71.158228	145	218	34	1	73	0.0136986
NODE_272169_length_257_cov_71.158228	145	218	35	3	73	0.0410959
NODE_272169_length_257_cov_71.158228	145	218	37	2	73	0.0273973
NODE_272169_length_257_cov_71.158228	145	218	43	2	73	0.0273973
NODE_272169_length_257_cov_71.158228	145	218	45	4	73	0.0547945
NODE_272169_length_257_cov_71.158228	145	218	49	1	73	0.0136986
NODE_272169_length_257_cov_71.158228	145	218	52	1	73	0.0136986
NODE_272169_length_257_cov_71.158228	145	218	54	1	73	0.0136986
NODE_272169_length_257_cov_71.158228	145	218	58	2	73	0.0273973
NODE_272169_length_257_cov_71.158228	145	218	61	2	73	0.0273973
NODE_272169_length_257_cov_71.158228	145	218	62	4	73	0.0547945
NODE_272169_length_257_cov_71.158228	145	218	66	2	73	0.0273973
NODE_272169_length_257_cov_71.158228	145	218	67	1	73	0.0136986
NODE_272169_length_257_cov_71.158228	145	218	68	1	73	0.0136986
NODE_272169_length_257_cov_71.158228	145	218	70	1	73	0.0136986
NODE_272169_length_257_cov_71.158228	145	218	72	3	73	0.0410959
NODE_272169_length_257_cov_71.158228	145	218	74	1	73	0.0136986
NODE_272169_length_257_cov_71.158228	145	218	76	2	73	0.0273973
NODE_272169_length_257_cov_71.158228	145	218	80	1	73	0.0136986
NODE_272169_length_257_cov_71.158228	145	218	84	2	73	0.0273973
NODE_272169_length_257_cov_71.158228	145	218	86	7	73	0.0958904
NODE_272169_length_257_cov_71.158228	145	218	87	1	73	0.0136986
NODE_272169_length_257_cov_71.158228	145	218	89	2	73	0.0273973
NODE_272169_length_257_cov_71.158228	145	218	91	2	73	0.0273973
NODE_272169_length_257_cov_71.158228	145	218	93	2	73	0.0273973
NODE_272169_length_257_cov_71.158228	145	218	96	3	73	0.0410959
NODE_272169_length_257_cov_71.158228	145	218	98	1	73	0.0136986
NODE_272194_length_257_cov_6.329114	15	93	0	5	78	0.0641026
NODE_272194_length_257_cov_6.329114	15	93	2	16	78	0.2051282
NODE_272194_length_257_cov_6.329114	15	93	6	57	78	0.7307692
NODE_272275_length_257_cov_4.177215	25	86	0	58	61	0.9508197
NODE_272275_length_257_cov_4.177215	25	86	2	3	61	0.0491803
NODE_272291_length_257_cov_3.987342	55	107	0	52	52	1.0000000
NODE_272304_length_257_cov_3.873418	145	225	0	80	80	1.0000000
NODE_272304_length_257_cov_3.873418	198	254	0	56	56	1.0000000
NODE_272322_length_257_cov_3.740506	133	199	2	27	66	0.4090909
NODE_272322_length_257_cov_3.740506	133	199	4	10	66	0.1515152
NODE_272322_length_257_cov_3.740506	133	199	6	4	66	0.0606061
NODE_272322_length_257_cov_3.740506	133	199	8	5	66	0.0757576
NODE_272322_length_257_cov_3.740506	133	199	10	15	66	0.2272727
NODE_272322_length_257_cov_3.740506	133	199	12	2	66	0.0303030
NODE_272322_length_257_cov_3.740506	133	199	14	3	66	0.0454545
NODE_272322_length_257_cov_3.740506	177	256	0	50	79	0.6329114
NODE_272322_length_257_cov_3.740506	177	256	2	29	79	0.3670886
NODE_272486_length_257_cov_2.734177	1	65	0	64	64	1.0000000
NODE_272491_length_257_cov_2.677215	170	250	0	29	80	0.3625000
NODE_272491_length_257_cov_2.677215	170	250	2	7	80	0.0875000
NODE_272491_length_257_cov_2.677215	170	250	4	6	80	0.0750000
NODE_272491_length_257_cov_2.677215	170	250	6	6	80	0.0750000
NODE_272491_length_257_cov_2.677215	170	250	8	5	80	0.0625000
NODE_272491_length_257_cov_2.677215	170	250	9	2	80	0.0250000
NODE_272491_length_257_cov_2.677215	170	250	11	6	80	0.0750000
NODE_272491_length_257_cov_2.677215	170	250	13	1	80	0.0125000
NODE_272491_length_257_cov_2.677215	170	250	15	1	80	0.0125000
NODE_272491_length_257_cov_2.677215	170	250	16	1	80	0.0125000
NODE_272491_length_257_cov_2.677215	170	250	17	4	80	0.0500000
NODE_272491_length_257_cov_2.677215	170	250	19	12	80	0.1500000
NODE_272580_length_257_cov_2.537975	60	137	4	26	77	0.3376623
NODE_272580_length_257_cov_2.537975	60	137	6	2	77	0.0259740
NODE_272580_length_257_cov_2.537975	60	137	8	49	77	0.6363636
NODE_272596_length_257_cov_2.487342	95	172	0	77	77	1.0000000
NODE_272625_length_257_cov_2.379747	106	186	8	1	80	0.0125000
NODE_272625_length_257_cov_2.379747	106	186	12	11	80	0.1375000
NODE_272625_length_257_cov_2.379747	106	186	14	12	80	0.1500000
NODE_272625_length_257_cov_2.379747	106	186	16	1	80	0.0125000
NODE_272625_length_257_cov_2.379747	106	186	18	14	80	0.1750000
NODE_272625_length_257_cov_2.379747	106	186	20	41	80	0.5125000
NODE_272625_length_257_cov_2.379747	159	207	0	3	48	0.0625000
NODE_272625_length_257_cov_2.379747	159	207	2	5	48	0.1041667
NODE_272625_length_257_cov_2.379747	159	207	4	1	48	0.0208333
NODE_272625_length_257_cov_2.379747	159	207	9	1	48	0.0208333
NODE_272625_length_257_cov_2.379747	159	207	10	4	48	0.0833333
NODE_272625_length_257_cov_2.379747	159	207	12	13	48	0.2708333
NODE_272625_length_257_cov_2.379747	159	207	14	8	48	0.1666667
NODE_272625_length_257_cov_2.379747	159	207	16	1	48	0.0208333
NODE_272625_length_257_cov_2.379747	159	207	18	3	48	0.0625000
NODE_272625_length_257_cov_2.379747	159	207	20	9	48	0.1875000
NODE_272724_length_257_cov_2.221519	163	240	0	77	77	1.0000000
NODE_272729_length_257_cov_2.202532	16	97	0	25	81	0.3086420
NODE_272729_length_257_cov_2.202532	16	97	2	5	81	0.0617284
NODE_272729_length_257_cov_2.202532	16	97	4	25	81	0.3086420
NODE_272729_length_257_cov_2.202532	16	97	6	14	81	0.1728395
NODE_272729_length_257_cov_2.202532	16	97	8	12	81	0.1481481
NODE_273151_length_257_cov_1.664557	220	239	0	19	19	1.0000000
NODE_273357_length_257_cov_1.500000	85	166	0	3	81	0.0370370
NODE_273357_length_257_cov_1.500000	85	166	1	8	81	0.0987654
NODE_273357_length_257_cov_1.500000	85	166	2	70	81	0.8641976
NODE_273462_length_257_cov_1.329114	120	186	0	66	66	1.0000000
NODE_273533_length_257_cov_1.291139	13	53	0	38	40	0.9500000
NODE_273533_length_257_cov_1.291139	13	53	2	2	40	0.0500000
NODE_273697_length_257_cov_1.291139	205	257	0	52	52	1.0000000
NODE_273894_length_257_cov_1.221519	10	74	0	46	64	0.7187500
NODE_273894_length_257_cov_1.221519	10	74	2	18	64	0.2812500
NODE_273917_length_257_cov_1.196203	70	150	0	12	80	0.1500000
NODE_273917_length_257_cov_1.196203	70	150	2	40	80	0.5000000
NODE_273917_length_257_cov_1.196203	70	150	4	28	80	0.3500000
NODE_273917_length_257_cov_1.196203	123	204	0	2	81	0.0246914
NODE_273917_length_257_cov_1.196203	123	204	2	39	81	0.4814815
NODE_273917_length_257_cov_1.196203	123	204	4	40	81	0.4938272
NODE_275399_length_257_cov_0.645570	138	158	0	13	20	0.6500000
NODE_275399_length_257_cov_0.645570	138	158	2	7	20	0.3500000
NODE_275419_length_257_cov_0.645570	181	241	2	58	60	0.9666666
NODE_275419_length_257_cov_0.645570	181	241	4	1	60	0.0166667
NODE_275419_length_257_cov_0.645570	181	241	6	1	60	0.0166667
NODE_275598_length_256_cov_5.235669	30	77	0	47	47	1.0000000
NODE_275624_length_256_cov_4.598726	100	180	0	80	80	1.0000000
NODE_275624_length_256_cov_4.598726	160	211	0	51	51	1.0000000
NODE_275682_length_256_cov_3.866242	112	166	0	50	54	0.9259259
NODE_275682_length_256_cov_3.866242	112	166	2	4	54	0.0740741
NODE_275840_length_256_cov_2.878981	79	159	0	75	80	0.9375000
NODE_275840_length_256_cov_2.878981	79	159	4	5	80	0.0625000
NODE_275840_length_256_cov_2.878981	132	212	0	80	80	1.0000000
NODE_275909_length_256_cov_2.598726	157	222	0	65	65	1.0000000
NODE_275909_length_256_cov_2.598726	195	249	0	54	54	1.0000000
NODE_275981_length_256_cov_2.445860	104	183	0	79	79	1.0000000
NODE_276082_length_256_cov_2.229299	0	58	0	58	58	1.0000000
NODE_276082_length_256_cov_2.229299	17	68	0	51	51	1.0000000
NODE_276082_length_256_cov_2.229299	41	88	0	47	47	1.0000000
NODE_276082_length_256_cov_2.229299	42	122	0	80	80	1.0000000
NODE_276098_length_256_cov_2.184713	192	246	0	54	54	1.0000000
NODE_276119_length_256_cov_2.121019	150	236	0	35	86	0.4069767
NODE_276119_length_256_cov_2.121019	150	236	2	6	86	0.0697674
NODE_276119_length_256_cov_2.121019	150	236	4	45	86	0.5232558
NODE_276174_length_256_cov_1.974522	130	174	0	44	44	1.0000000
NODE_276471_length_256_cov_1.707006	39	92	2	6	53	0.1132075
NODE_276471_length_256_cov_1.707006	39	92	4	6	53	0.1132075
NODE_276471_length_256_cov_1.707006	39	92	6	25	53	0.4716981
NODE_276471_length_256_cov_1.707006	39	92	7	4	53	0.0754717
NODE_276471_length_256_cov_1.707006	39	92	9	7	53	0.1320755
NODE_276471_length_256_cov_1.707006	39	92	10	5	53	0.0943396
NODE_276471_length_256_cov_1.707006	93	135	12	12	42	0.2857143
NODE_276471_length_256_cov_1.707006	93	135	14	8	42	0.1904762
NODE_276471_length_256_cov_1.707006	93	135	16	3	42	0.0714286
NODE_276471_length_256_cov_1.707006	93	135	18	19	42	0.4523810
NODE_276484_length_256_cov_1.700637	107	129	2	22	22	1.0000000
NODE_276495_length_256_cov_1.675159	52	98	0	9	46	0.1956522
NODE_276495_length_256_cov_1.675159	52	98	2	37	46	0.8043478
NODE_276654_length_256_cov_1.598726	125	202	0	77	77	1.0000000
NODE_276654_length_256_cov_1.598726	178	256	0	78	78	1.0000000
NODE_276672_length_256_cov_1.579618	110	172	2	2	62	0.0322581
NODE_276672_length_256_cov_1.579618	110	172	4	40	62	0.6451613
NODE_276672_length_256_cov_1.579618	110	172	6	20	62	0.3225806
NODE_276672_length_256_cov_1.579618	194	239	0	45	45	1.0000000
NODE_276742_length_256_cov_1.464968	112	135	6	23	23	1.0000000
NODE_276826_length_256_cov_1.331210	138	209	2	71	71	1.0000000
NODE_276826_length_256_cov_1.331210	182	240	0	18	58	0.3103448
NODE_276826_length_256_cov_1.331210	182	240	2	40	58	0.6896552
NODE_277113_length_256_cov_1.299363	88	160	2	17	72	0.2361111
NODE_277113_length_256_cov_1.299363	88	160	4	12	72	0.1666667
NODE_277113_length_256_cov_1.299363	88	160	6	43	72	0.5972222
NODE_277305_length_256_cov_1.203822	3	43	6	5	40	0.1250000
NODE_277305_length_256_cov_1.203822	3	43	10	17	40	0.4250000
NODE_277305_length_256_cov_1.203822	3	43	12	3	40	0.0750000
NODE_277305_length_256_cov_1.203822	3	43	14	6	40	0.1500000
NODE_277305_length_256_cov_1.203822	3	43	16	9	40	0.2250000
NODE_277305_length_256_cov_1.203822	16	96	10	9	80	0.1125000
NODE_277305_length_256_cov_1.203822	16	96	12	3	80	0.0375000
NODE_277305_length_256_cov_1.203822	16	96	14	15	80	0.1875000
NODE_277305_length_256_cov_1.203822	16	96	16	27	80	0.3375000
NODE_277305_length_256_cov_1.203822	16	96	18	5	80	0.0625000
NODE_277305_length_256_cov_1.203822	16	96	20	21	80	0.2625000
NODE_278934_length_255_cov_73.756410	52	99	0	11	47	0.2340426
NODE_278934_length_255_cov_73.756410	52	99	1	4	47	0.0851064
NODE_278934_length_255_cov_73.756410	52	99	2	1	47	0.0212766
NODE_278934_length_255_cov_73.756410	52	99	4	31	47	0.6595744
NODE_278934_length_255_cov_73.756410	133	184	18	1	51	0.0196078
NODE_278934_length_255_cov_73.756410	133	184	20	43	51	0.8431373
NODE_278934_length_255_cov_73.756410	133	184	22	7	51	0.1372549
NODE_278934_length_255_cov_73.756410	157	237	2	5	80	0.0625000
NODE_278934_length_255_cov_73.756410	157	237	4	4	80	0.0500000
NODE_278934_length_255_cov_73.756410	157	237	6	6	80	0.0750000
NODE_278934_length_255_cov_73.756410	157	237	8	1	80	0.0125000
NODE_278934_length_255_cov_73.756410	157	237	10	5	80	0.0625000
NODE_278934_length_255_cov_73.756410	157	237	16	2	80	0.0250000
NODE_278934_length_255_cov_73.756410	157	237	17	4	80	0.0500000
NODE_278934_length_255_cov_73.756410	157	237	18	4	80	0.0500000
NODE_278934_length_255_cov_73.756410	157	237	20	49	80	0.6125000
NODE_278937_length_255_cov_15.538462	219	255	0	36	36	1.0000000
NODE_279003_length_255_cov_4.884615	157	230	0	73	73	1.0000000
NODE_279003_length_255_cov_4.884615	203	248	0	45	45	1.0000000
NODE_279058_length_255_cov_4.012821	68	148	0	80	80	1.0000000
NODE_279075_length_255_cov_3.826923	16	80	2	11	64	0.1718750
NODE_279075_length_255_cov_3.826923	16	80	4	4	64	0.0625000
NODE_279075_length_255_cov_3.826923	16	80	6	49	64	0.7656250
NODE_279102_length_255_cov_3.596154	30	60	2	30	30	1.0000000
NODE_279134_length_255_cov_3.423077	64	109	0	3	45	0.0666667
NODE_279134_length_255_cov_3.423077	64	109	2	14	45	0.3111111
NODE_279134_length_255_cov_3.423077	64	109	4	23	45	0.5111111
NODE_279134_length_255_cov_3.423077	64	109	6	5	45	0.1111111
NODE_279166_length_255_cov_3.262821	0	48	0	35	48	0.7291667
NODE_279166_length_255_cov_3.262821	0	48	2	13	48	0.2708333
NODE_279166_length_255_cov_3.262821	66	113	2	47	47	1.0000000
NODE_279241_length_255_cov_2.942308	157	176	0	19	19	1.0000000
NODE_279320_length_255_cov_2.621795	227	254	0	27	27	1.0000000
NODE_279379_length_255_cov_2.602564	131	185	4	7	54	0.1296296
NODE_279379_length_255_cov_2.602564	131	185	6	47	54	0.8703704
NODE_279427_length_255_cov_2.487179	43	119	0	10	76	0.1315790
NODE_279427_length_255_cov_2.487179	43	119	2	1	76	0.0131579
NODE_279427_length_255_cov_2.487179	43	119	4	65	76	0.8552632
NODE_279447_length_255_cov_2.435897	0	58	0	58	58	1.0000000
NODE_279462_length_255_cov_2.391026	189	255	0	66	66	1.0000000
NODE_279507_length_255_cov_2.288462	0	60	0	60	60	1.0000000
NODE_279510_length_255_cov_2.288462	0	74	0	74	74	1.0000000
NODE_279620_length_255_cov_2.089744	105	145	0	40	40	1.0000000
NODE_279649_length_255_cov_1.987179	0	72	0	72	72	1.0000000
NODE_279842_length_255_cov_1.910256	198	255	0	52	57	0.9122807
NODE_279842_length_255_cov_1.910256	198	255	4	5	57	0.0877193
NODE_279871_length_255_cov_1.871795	16	68	0	52	52	1.0000000
NODE_279892_length_255_cov_1.826923	146	218	0	72	72	1.0000000
NODE_279956_length_255_cov_1.705128	0	45	0	45	45	1.0000000
NODE_279956_length_255_cov_1.705128	41	121	0	49	80	0.6125000
NODE_279956_length_255_cov_1.705128	41	121	2	31	80	0.3875000
NODE_279956_length_255_cov_1.705128	94	174	0	13	80	0.1625000
NODE_279956_length_255_cov_1.705128	94	174	2	67	80	0.8375000
NODE_280153_length_255_cov_1.576923	43	117	2	4	74	0.0540541
NODE_280153_length_255_cov_1.576923	43	117	4	3	74	0.0405405
NODE_280153_length_255_cov_1.576923	43	117	6	1	74	0.0135135
NODE_280153_length_255_cov_1.576923	43	117	8	9	74	0.1216216
NODE_280153_length_255_cov_1.576923	43	117	12	1	74	0.0135135
NODE_280153_length_255_cov_1.576923	43	117	14	17	74	0.2297297
NODE_280153_length_255_cov_1.576923	43	117	16	16	74	0.2162162
NODE_280153_length_255_cov_1.576923	43	117	18	16	74	0.2162162
NODE_280153_length_255_cov_1.576923	43	117	20	7	74	0.0945946
NODE_280153_length_255_cov_1.576923	90	175	4	1	85	0.0117647
NODE_280153_length_255_cov_1.576923	90	175	6	1	85	0.0117647
NODE_280153_length_255_cov_1.576923	90	175	12	1	85	0.0117647
NODE_280153_length_255_cov_1.576923	90	175	14	1	85	0.0117647
NODE_280153_length_255_cov_1.576923	90	175	18	20	85	0.2352941
NODE_280153_length_255_cov_1.576923	90	175	20	25	85	0.2941177
NODE_280153_length_255_cov_1.576923	90	175	22	36	85	0.4235294
NODE_280168_length_255_cov_1.557692	62	125	0	57	63	0.9047619
NODE_280168_length_255_cov_1.557692	62	125	2	6	63	0.0952381
NODE_280297_length_255_cov_1.358974	178	246	0	68	68	1.0000000
NODE_280904_length_255_cov_1.128205	183	219	0	33	36	0.9166667
NODE_280904_length_255_cov_1.128205	183	219	2	3	36	0.0833333
NODE_281094_length_255_cov_0.987179	220	241	0	21	21	1.0000000
NODE_281380_length_255_cov_0.955128	119	171	2	52	52	1.0000000
NODE_281384_length_255_cov_0.955128	12	92	4	7	80	0.0875000
NODE_281384_length_255_cov_0.955128	12	92	6	11	80	0.1375000
NODE_281384_length_255_cov_0.955128	12	92	8	3	80	0.0375000
NODE_281384_length_255_cov_0.955128	12	92	10	12	80	0.1500000
NODE_281384_length_255_cov_0.955128	12	92	12	47	80	0.5875000
NODE_282137_length_255_cov_0.653846	87	106	0	19	19	1.0000000
NODE_282534_length_254_cov_4.935484	144	189	2	11	45	0.2444444
NODE_282534_length_254_cov_4.935484	144	189	4	34	45	0.7555556
NODE_282534_length_254_cov_4.935484	164	242	0	22	78	0.2820513
NODE_282534_length_254_cov_4.935484	164	242	2	42	78	0.5384616
NODE_282534_length_254_cov_4.935484	164	242	4	14	78	0.1794872
NODE_282548_length_254_cov_4.722581	44	85	2	41	41	1.0000000
NODE_282576_length_254_cov_4.296774	149	174	0	25	25	1.0000000
NODE_282576_length_254_cov_4.296774	149	223	0	74	74	1.0000000
NODE_282590_length_254_cov_4.206452	57	86	6	2	29	0.0689655
NODE_282590_length_254_cov_4.206452	57	86	8	19	29	0.6551724
NODE_282590_length_254_cov_4.206452	57	86	10	8	29	0.2758621
NODE_282626_length_254_cov_3.677419	7	64	10	4	57	0.0701754
NODE_282626_length_254_cov_3.677419	7	64	12	6	57	0.1052632
NODE_282626_length_254_cov_3.677419	7	64	16	8	57	0.1403509
NODE_282626_length_254_cov_3.677419	7	64	18	5	57	0.0877193
NODE_282626_length_254_cov_3.677419	7	64	20	3	57	0.0526316
NODE_282626_length_254_cov_3.677419	7	64	22	31	57	0.5438597
NODE_282626_length_254_cov_3.677419	60	117	16	3	57	0.0526316
NODE_282626_length_254_cov_3.677419	60	117	18	15	57	0.2631579
NODE_282626_length_254_cov_3.677419	60	117	20	11	57	0.1929825
NODE_282626_length_254_cov_3.677419	60	117	22	28	57	0.4912281
NODE_282642_length_254_cov_3.593548	154	197	0	43	43	1.0000000
NODE_282659_length_254_cov_3.438710	82	129	2	8	47	0.1702128
NODE_282659_length_254_cov_3.438710	82	129	4	39	47	0.8297873
NODE_282659_length_254_cov_3.438710	102	182	4	38	80	0.4750000
NODE_282659_length_254_cov_3.438710	102	182	6	42	80	0.5250000
NODE_282736_length_254_cov_2.961290	5	79	2	74	74	1.0000000
NODE_282736_length_254_cov_2.961290	52	118	0	14	66	0.2121212
NODE_282736_length_254_cov_2.961290	52	118	2	52	66	0.7878788
NODE_282771_length_254_cov_2.780645	169	252	0	1	83	0.0120482
NODE_282771_length_254_cov_2.780645	169	252	1	3	83	0.0361446
NODE_282771_length_254_cov_2.780645	169	252	3	3	83	0.0361446
NODE_282771_length_254_cov_2.780645	169	252	4	38	83	0.4578313
NODE_282771_length_254_cov_2.780645	169	252	6	6	83	0.0722892
NODE_282771_length_254_cov_2.780645	169	252	8	2	83	0.0240964
NODE_282771_length_254_cov_2.780645	169	252	12	1	83	0.0120482
NODE_282771_length_254_cov_2.780645	169	252	14	6	83	0.0722892
NODE_282771_length_254_cov_2.780645	169	252	18	2	83	0.0240964
NODE_282771_length_254_cov_2.780645	169	252	20	1	83	0.0120482
NODE_282771_length_254_cov_2.780645	169	252	24	2	83	0.0240964
NODE_282771_length_254_cov_2.780645	169	252	30	3	83	0.0361446
NODE_282771_length_254_cov_2.780645	169	252	32	3	83	0.0361446
NODE_282771_length_254_cov_2.780645	169	252	40	5	83	0.0602410
NODE_282771_length_254_cov_2.780645	169	252	42	7	83	0.0843373
NODE_282947_length_254_cov_2.341935	167	201	0	34	34	1.0000000
NODE_283082_length_254_cov_2.161290	14	74	0	60	60	1.0000000
NODE_283244_length_254_cov_1.974194	156	204	0	48	48	1.0000000
NODE_283440_length_254_cov_1.780645	79	126	14	1	47	0.0212766
NODE_283440_length_254_cov_1.780645	79	126	16	3	47	0.0638298
NODE_283440_length_254_cov_1.780645	79	126	18	2	47	0.0425532
NODE_283440_length_254_cov_1.780645	79	126	20	6	47	0.1276596
NODE_283440_length_254_cov_1.780645	79	126	22	2	47	0.0425532
NODE_283440_length_254_cov_1.780645	79	126	24	2	47	0.0425532
NODE_283440_length_254_cov_1.780645	79	126	26	3	47	0.0638298
NODE_283440_length_254_cov_1.780645	79	126	28	17	47	0.3617021
NODE_283440_length_254_cov_1.780645	79	126	30	11	47	0.2340426
NODE_283952_length_254_cov_1.316129	23	87	0	64	64	1.0000000
NODE_284013_length_254_cov_1.316129	193	215	0	22	22	1.0000000
NODE_284256_length_254_cov_1.258065	181	249	0	68	68	1.0000000
NODE_284275_length_254_cov_1.238710	9	82	0	17	73	0.2328767
NODE_284275_length_254_cov_1.238710	9	82	2	8	73	0.1095890
NODE_284275_length_254_cov_1.238710	9	82	4	43	73	0.5890411
NODE_284275_length_254_cov_1.238710	9	82	6	5	73	0.0684932
NODE_284275_length_254_cov_1.238710	62	82	4	15	20	0.7500000
NODE_284275_length_254_cov_1.238710	62	82	6	5	20	0.2500000
NODE_284277_length_254_cov_1.238710	54	73	2	19	19	1.0000000
NODE_284301_length_254_cov_1.219355	98	157	0	59	59	1.0000000
NODE_284638_length_254_cov_0.987097	139	193	2	54	54	1.0000000
NODE_284638_length_254_cov_0.987097	205	254	0	49	49	1.0000000
NODE_284796_length_254_cov_0.987097	121	152	0	31	31	1.0000000
NODE_285963_length_253_cov_60.311688	137	202	6	1	65	0.0153846
NODE_285963_length_253_cov_60.311688	137	202	20	7	65	0.1076923
NODE_285963_length_253_cov_60.311688	137	202	22	57	65	0.8769231
NODE_285963_length_253_cov_60.311688	175	253	0	3	78	0.0384615
NODE_285963_length_253_cov_60.311688	175	253	2	1	78	0.0128205
NODE_285963_length_253_cov_60.311688	175	253	3	1	78	0.0128205
NODE_285963_length_253_cov_60.311688	175	253	7	3	78	0.0384615
NODE_285963_length_253_cov_60.311688	175	253	9	3	78	0.0384615
NODE_285963_length_253_cov_60.311688	175	253	12	1	78	0.0128205
NODE_285963_length_253_cov_60.311688	175	253	14	1	78	0.0128205
NODE_285963_length_253_cov_60.311688	175	253	18	4	78	0.0512821
NODE_285963_length_253_cov_60.311688	175	253	22	61	78	0.7820513
NODE_285965_length_253_cov_41.519481	0	68	0	1	68	0.0147059
NODE_285965_length_253_cov_41.519481	0	68	2	2	68	0.0294118
NODE_285965_length_253_cov_41.519481	0	68	7	10	68	0.1470588
NODE_285965_length_253_cov_41.519481	0	68	11	8	68	0.1176471
NODE_285965_length_253_cov_41.519481	0	68	13	5	68	0.0735294
NODE_285965_length_253_cov_41.519481	0	68	15	5	68	0.0735294
NODE_285965_length_253_cov_41.519481	0	68	17	4	68	0.0588235
NODE_285965_length_253_cov_41.519481	0	68	19	1	68	0.0147059
NODE_285965_length_253_cov_41.519481	0	68	21	11	68	0.1617647
NODE_285965_length_253_cov_41.519481	0	68	23	5	68	0.0735294
NODE_285965_length_253_cov_41.519481	0	68	25	16	68	0.2352941
NODE_285965_length_253_cov_41.519481	0	70	0	1	70	0.0142857
NODE_285965_length_253_cov_41.519481	0	70	2	2	70	0.0285714
NODE_285965_length_253_cov_41.519481	0	70	7	10	70	0.1428571
NODE_285965_length_253_cov_41.519481	0	70	11	8	70	0.1142857
NODE_285965_length_253_cov_41.519481	0	70	13	5	70	0.0714286
NODE_285965_length_253_cov_41.519481	0	70	15	5	70	0.0714286
NODE_285965_length_253_cov_41.519481	0	70	17	4	70	0.0571429
NODE_285965_length_253_cov_41.519481	0	70	19	1	70	0.0142857
NODE_285965_length_253_cov_41.519481	0	70	21	11	70	0.1571429
NODE_285965_length_253_cov_41.519481	0	70	23	5	70	0.0714286
NODE_285965_length_253_cov_41.519481	0	70	25	18	70	0.2571429
NODE_285965_length_253_cov_41.519481	2	73	2	1	71	0.0140845
NODE_285965_length_253_cov_41.519481	2	73	7	10	71	0.1408451
NODE_285965_length_253_cov_41.519481	2	73	11	8	71	0.1126761
NODE_285965_length_253_cov_41.519481	2	73	13	5	71	0.0704225
NODE_285965_length_253_cov_41.519481	2	73	15	5	71	0.0704225
NODE_285965_length_253_cov_41.519481	2	73	17	4	71	0.0563380
NODE_285965_length_253_cov_41.519481	2	73	19	1	71	0.0140845
NODE_285965_length_253_cov_41.519481	2	73	21	11	71	0.1549296
NODE_285965_length_253_cov_41.519481	2	73	23	5	71	0.0704225
NODE_285965_length_253_cov_41.519481	2	73	25	21	71	0.2957746
NODE_285965_length_253_cov_41.519481	7	73	7	6	66	0.0909091
NODE_285965_length_253_cov_41.519481	7	73	11	8	66	0.1212121
NODE_285965_length_253_cov_41.519481	7	73	13	5	66	0.0757576
NODE_285965_length_253_cov_41.519481	7	73	15	5	66	0.0757576
NODE_285965_length_253_cov_41.519481	7	73	17	4	66	0.0606061
NODE_285965_length_253_cov_41.519481	7	73	19	1	66	0.0151515
NODE_285965_length_253_cov_41.519481	7	73	21	11	66	0.1666667
NODE_285965_length_253_cov_41.519481	7	73	23	5	66	0.0757576
NODE_285965_length_253_cov_41.519481	7	73	25	21	66	0.3181818
NODE_285965_length_253_cov_41.519481	46	123	8	2	77	0.0259740
NODE_285965_length_253_cov_41.519481	46	123	10	3	77	0.0389610
NODE_285965_length_253_cov_41.519481	46	123	12	2	77	0.0259740
NODE_285965_length_253_cov_41.519481	46	123	17	2	77	0.0259740
NODE_285965_length_253_cov_41.519481	46	123	21	3	77	0.0389610
NODE_285965_length_253_cov_41.519481	46	123	22	5	77	0.0649351
NODE_285965_length_253_cov_41.519481	46	123	23	5	77	0.0649351
NODE_285965_length_253_cov_41.519481	46	123	25	22	77	0.2857143
NODE_285965_length_253_cov_41.519481	46	123	26	33	77	0.4285714
NODE_285965_length_253_cov_41.519481	46	123	8	2	77	0.0259740
NODE_285965_length_253_cov_41.519481	46	123	10	3	77	0.0389610
NODE_285965_length_253_cov_41.519481	46	123	12	2	77	0.0259740
NODE_285965_length_253_cov_41.519481	46	123	17	2	77	0.0259740
NODE_285965_length_253_cov_41.519481	46	123	21	3	77	0.0389610
NODE_285965_length_253_cov_41.519481	46	123	22	5	77	0.0649351
NODE_285965_length_253_cov_41.519481	46	123	23	5	77	0.0649351
NODE_285965_length_253_cov_41.519481	46	123	25	22	77	0.2857143
NODE_285965_length_253_cov_41.519481	46	123	26	33	77	0.4285714
NODE_285965_length_253_cov_41.519481	46	123	8	2	77	0.0259740
NODE_285965_length_253_cov_41.519481	46	123	10	3	77	0.0389610
NODE_285965_length_253_cov_41.519481	46	123	12	2	77	0.0259740
NODE_285965_length_253_cov_41.519481	46	123	17	2	77	0.0259740
NODE_285965_length_253_cov_41.519481	46	123	21	3	77	0.0389610
NODE_285965_length_253_cov_41.519481	46	123	22	5	77	0.0649351
NODE_285965_length_253_cov_41.519481	46	123	23	5	77	0.0649351
NODE_285965_length_253_cov_41.519481	46	123	25	22	77	0.2857143
NODE_285965_length_253_cov_41.519481	46	123	26	33	77	0.4285714
NODE_285967_length_253_cov_13.967532	25	105	0	80	80	1.0000000
NODE_285967_length_253_cov_13.967532	78	158	0	80	80	1.0000000
NODE_285969_length_253_cov_12.259740	0	54	0	54	54	1.0000000
NODE_285969_length_253_cov_12.259740	27	62	0	35	35	1.0000000
NODE_285969_length_253_cov_12.259740	51	131	0	80	80	1.0000000
NODE_285969_length_253_cov_12.259740	104	139	0	35	35	1.0000000
NODE_285969_length_253_cov_12.259740	128	208	0	80	80	1.0000000
NODE_285969_length_253_cov_12.259740	181	216	0	35	35	1.0000000
NODE_285987_length_253_cov_7.279221	184	250	0	4	66	0.0606061
NODE_285987_length_253_cov_7.279221	184	250	2	28	66	0.4242424
NODE_285987_length_253_cov_7.279221	184	250	4	31	66	0.4696970
NODE_285987_length_253_cov_7.279221	184	250	7	1	66	0.0151515
NODE_285987_length_253_cov_7.279221	184	250	8	2	66	0.0303030
NODE_286022_length_253_cov_5.376623	66	147	4	8	81	0.0987654
NODE_286022_length_253_cov_5.376623	66	147	6	20	81	0.2469136
NODE_286022_length_253_cov_5.376623	66	147	10	10	81	0.1234568
NODE_286022_length_253_cov_5.376623	66	147	12	15	81	0.1851852
NODE_286022_length_253_cov_5.376623	66	147	14	9	81	0.1111111
NODE_286022_length_253_cov_5.376623	66	147	16	10	81	0.1234568
NODE_286022_length_253_cov_5.376623	66	147	18	9	81	0.1111111
NODE_286022_length_253_cov_5.376623	120	185	14	42	65	0.6461539
NODE_286022_length_253_cov_5.376623	120	185	16	14	65	0.2153846
NODE_286022_length_253_cov_5.376623	120	185	18	9	65	0.1384615
NODE_286042_length_253_cov_4.896104	102	182	2	9	80	0.1125000
NODE_286042_length_253_cov_4.896104	102	182	8	2	80	0.0250000
NODE_286042_length_253_cov_4.896104	102	182	10	2	80	0.0250000
NODE_286042_length_253_cov_4.896104	102	182	15	8	80	0.1000000
NODE_286042_length_253_cov_4.896104	102	182	17	1	80	0.0125000
NODE_286042_length_253_cov_4.896104	102	182	18	4	80	0.0500000
NODE_286042_length_253_cov_4.896104	102	182	20	8	80	0.1000000
NODE_286042_length_253_cov_4.896104	102	182	26	9	80	0.1125000
NODE_286042_length_253_cov_4.896104	102	182	27	9	80	0.1125000
NODE_286042_length_253_cov_4.896104	102	182	28	7	80	0.0875000
NODE_286042_length_253_cov_4.896104	102	182	30	5	80	0.0625000
NODE_286042_length_253_cov_4.896104	102	182	32	4	80	0.0500000
NODE_286042_length_253_cov_4.896104	102	182	33	2	80	0.0250000
NODE_286042_length_253_cov_4.896104	102	182	34	10	80	0.1250000
NODE_286046_length_253_cov_4.798701	199	253	0	54	54	1.0000000
NODE_286069_length_253_cov_4.487013	85	126	8	5	41	0.1219512
NODE_286069_length_253_cov_4.487013	85	126	10	11	41	0.2682927
NODE_286069_length_253_cov_4.487013	85	126	12	2	41	0.0487805
NODE_286069_length_253_cov_4.487013	85	126	14	23	41	0.5609756
NODE_286151_length_253_cov_3.500000	44	105	4	61	61	1.0000000
NODE_286151_length_253_cov_3.500000	90	158	0	16	68	0.2352941
NODE_286151_length_253_cov_3.500000	90	158	2	8	68	0.1176471
NODE_286151_length_253_cov_3.500000	90	158	4	44	68	0.6470588
NODE_286259_length_253_cov_2.987013	85	165	0	8	80	0.1000000
NODE_286259_length_253_cov_2.987013	85	165	2	63	80	0.7875000
NODE_286259_length_253_cov_2.987013	85	165	4	9	80	0.1125000
NODE_286259_length_253_cov_2.987013	138	169	0	12	31	0.3870968
NODE_286259_length_253_cov_2.987013	138	169	2	19	31	0.6129032
NODE_286275_length_253_cov_2.954545	100	148	0	38	48	0.7916667
NODE_286275_length_253_cov_2.954545	100	148	2	10	48	0.2083333
NODE_286281_length_253_cov_2.909091	34	99	4	7	65	0.1076923
NODE_286281_length_253_cov_2.909091	34	99	6	6	65	0.0923077
NODE_286281_length_253_cov_2.909091	34	99	8	3	65	0.0461538
NODE_286281_length_253_cov_2.909091	34	99	10	8	65	0.1230769
NODE_286281_length_253_cov_2.909091	34	99	12	5	65	0.0769231
NODE_286281_length_253_cov_2.909091	34	99	14	6	65	0.0923077
NODE_286281_length_253_cov_2.909091	34	99	16	30	65	0.4615385
NODE_286288_length_253_cov_2.889610	129	200	4	10	71	0.1408451
NODE_286288_length_253_cov_2.889610	129	200	6	15	71	0.2112676
NODE_286288_length_253_cov_2.889610	129	200	8	9	71	0.1267606
NODE_286288_length_253_cov_2.889610	129	200	10	8	71	0.1126761
NODE_286288_length_253_cov_2.889610	129	200	12	2	71	0.0281690
NODE_286288_length_253_cov_2.889610	129	200	14	1	71	0.0140845
NODE_286288_length_253_cov_2.889610	129	200	16	1	71	0.0140845
NODE_286288_length_253_cov_2.889610	129	200	18	16	71	0.2253521
NODE_286288_length_253_cov_2.889610	129	200	20	9	71	0.1267606
NODE_286288_length_253_cov_2.889610	173	253	2	1	80	0.0125000
NODE_286288_length_253_cov_2.889610	173	253	6	2	80	0.0250000
NODE_286288_length_253_cov_2.889610	173	253	8	1	80	0.0125000
NODE_286288_length_253_cov_2.889610	173	253	14	1	80	0.0125000
NODE_286288_length_253_cov_2.889610	173	253	16	2	80	0.0250000
NODE_286288_length_253_cov_2.889610	173	253	18	17	80	0.2125000
NODE_286288_length_253_cov_2.889610	173	253	20	56	80	0.7000000
NODE_286289_length_253_cov_2.889610	21	76	4	45	55	0.8181818
NODE_286289_length_253_cov_2.889610	21	76	6	10	55	0.1818182
NODE_286289_length_253_cov_2.889610	149	229	0	79	80	0.9875000
NODE_286289_length_253_cov_2.889610	149	229	2	1	80	0.0125000
NODE_286379_length_253_cov_2.610390	113	193	0	79	80	0.9875000
NODE_286379_length_253_cov_2.610390	113	193	2	1	80	0.0125000
NODE_286386_length_253_cov_2.584416	97	154	2	11	57	0.1929825
NODE_286386_length_253_cov_2.584416	97	154	4	46	57	0.8070176
NODE_286545_length_253_cov_2.240260	185	250	0	65	65	1.0000000
NODE_286667_length_253_cov_1.987013	157	237	0	29	80	0.3625000
NODE_286667_length_253_cov_1.987013	157	237	2	51	80	0.6375000
NODE_286667_length_253_cov_1.987013	210	253	0	43	43	1.0000000
NODE_286685_length_253_cov_1.987013	18	60	0	42	42	1.0000000
NODE_286829_length_253_cov_1.961039	186	232	0	46	46	1.0000000
NODE_286837_length_253_cov_1.948052	68	120	0	52	52	1.0000000
NODE_286838_length_253_cov_1.948052	63	114	0	8	51	0.1568628
NODE_286838_length_253_cov_1.948052	63	114	2	43	51	0.8431373
NODE_286947_length_253_cov_1.746753	164	193	0	29	29	1.0000000
NODE_287031_length_253_cov_1.655844	40	120	2	80	80	1.0000000
NODE_287031_length_253_cov_1.655844	93	152	2	39	59	0.6610169
NODE_287031_length_253_cov_1.655844	93	152	4	20	59	0.3389831
NODE_287133_length_253_cov_1.590909	102	148	2	27	46	0.5869565
NODE_287133_length_253_cov_1.590909	102	148	4	19	46	0.4130435
NODE_287156_length_253_cov_1.558442	67	149	0	82	82	1.0000000
NODE_287230_length_253_cov_1.441558	49	113	0	64	64	1.0000000
NODE_287230_length_253_cov_1.441558	102	166	0	64	64	1.0000000
NODE_287232_length_253_cov_1.441558	121	185	0	64	64	1.0000000
NODE_287234_length_253_cov_1.435065	50	81	0	31	31	1.0000000
NODE_287584_length_253_cov_1.324675	193	239	2	46	46	1.0000000
NODE_287599_length_253_cov_1.324675	90	132	22	42	42	1.0000000
NODE_287599_length_253_cov_1.324675	133	185	0	5	52	0.0961538
NODE_287599_length_253_cov_1.324675	133	185	4	1	52	0.0192308
NODE_287599_length_253_cov_1.324675	133	185	6	7	52	0.1346154
NODE_287599_length_253_cov_1.324675	133	185	8	1	52	0.0192308
NODE_287599_length_253_cov_1.324675	133	185	10	5	52	0.0961538
NODE_287599_length_253_cov_1.324675	133	185	12	6	52	0.1153846
NODE_287599_length_253_cov_1.324675	133	185	14	4	52	0.0769231
NODE_287599_length_253_cov_1.324675	133	185	16	3	52	0.0576923
NODE_287599_length_253_cov_1.324675	133	185	18	15	52	0.2884615
NODE_287599_length_253_cov_1.324675	133	185	20	2	52	0.0384615
NODE_287599_length_253_cov_1.324675	133	185	22	3	52	0.0576923
NODE_287721_length_253_cov_1.285714	87	125	0	23	38	0.6052632
NODE_287721_length_253_cov_1.285714	87	125	2	13	38	0.3421053
NODE_287721_length_253_cov_1.285714	87	125	4	2	38	0.0526316
NODE_287794_length_253_cov_1.214286	99	148	5	3	49	0.0612245
NODE_287794_length_253_cov_1.214286	99	148	6	46	49	0.9387755
NODE_287845_length_253_cov_1.181818	185	247	0	62	62	1.0000000
NODE_287845_length_253_cov_1.181818	185	247	0	62	62	1.0000000
NODE_287989_length_253_cov_1.064935	83	159	6	1	76	0.0131579
NODE_287989_length_253_cov_1.064935	83	159	8	5	76	0.0657895
NODE_287989_length_253_cov_1.064935	83	159	10	1	76	0.0131579
NODE_287989_length_253_cov_1.064935	83	159	11	4	76	0.0526316
NODE_287989_length_253_cov_1.064935	83	159	13	12	76	0.1578947
NODE_287989_length_253_cov_1.064935	83	159	15	3	76	0.0394737
NODE_287989_length_253_cov_1.064935	83	159	17	2	76	0.0263158
NODE_287989_length_253_cov_1.064935	83	159	19	6	76	0.0789474
NODE_287989_length_253_cov_1.064935	83	159	21	6	76	0.0789474
NODE_287989_length_253_cov_1.064935	83	159	23	9	76	0.1184211
NODE_287989_length_253_cov_1.064935	83	159	25	6	76	0.0789474
NODE_287989_length_253_cov_1.064935	83	159	27	21	76	0.2763158
NODE_288099_length_253_cov_0.993506	0	44	4	44	44	1.0000000
NODE_288465_length_253_cov_0.870130	17	46	2	16	29	0.5517241
NODE_288465_length_253_cov_0.870130	17	46	4	5	29	0.1724138
NODE_288465_length_253_cov_0.870130	17	46	6	8	29	0.2758621
NODE_288478_length_253_cov_0.850649	0	89	0	89	89	1.0000000
NODE_289563_length_252_cov_4.771242	94	148	0	54	54	1.0000000
NODE_289574_length_252_cov_4.614379	16	37	0	21	21	1.0000000
NODE_289624_length_252_cov_3.960784	7	85	2	78	78	1.0000000
NODE_289624_length_252_cov_3.960784	63	136	0	25	73	0.3424658
NODE_289624_length_252_cov_3.960784	63	136	1	1	73	0.0136986
NODE_289624_length_252_cov_3.960784	63	136	2	47	73	0.6438356
NODE_289663_length_252_cov_3.549020	89	157	0	68	68	1.0000000
NODE_289672_length_252_cov_3.405229	26	107	0	34	81	0.4197531
NODE_289672_length_252_cov_3.405229	26	107	2	2	81	0.0246914
NODE_289672_length_252_cov_3.405229	26	107	4	21	81	0.2592593
NODE_289672_length_252_cov_3.405229	26	107	8	2	81	0.0246914
NODE_289672_length_252_cov_3.405229	26	107	10	20	81	0.2469136
NODE_289672_length_252_cov_3.405229	26	107	12	2	81	0.0246914
NODE_289705_length_252_cov_3.307190	91	141	0	50	50	1.0000000
NODE_289742_length_252_cov_3.032680	135	212	6	6	77	0.0779221
NODE_289742_length_252_cov_3.032680	135	212	10	24	77	0.3116883
NODE_289742_length_252_cov_3.032680	135	212	12	8	77	0.1038961
NODE_289742_length_252_cov_3.032680	135	212	14	39	77	0.5064935
NODE_289775_length_252_cov_2.928105	0	57	0	57	57	1.0000000
NODE_289799_length_252_cov_2.803922	41	121	0	80	80	1.0000000
NODE_290032_length_252_cov_2.320261	0	64	0	64	64	1.0000000
NODE_290046_length_252_cov_2.281046	120	170	0	37	50	0.7400000
NODE_290046_length_252_cov_2.281046	120	170	2	13	50	0.2600000
NODE_290066_length_252_cov_2.215686	137	175	29	2	38	0.0526316
NODE_290066_length_252_cov_2.215686	137	175	31	7	38	0.1842105
NODE_290066_length_252_cov_2.215686	137	175	34	1	38	0.0263158
NODE_290066_length_252_cov_2.215686	137	175	35	16	38	0.4210526
NODE_290066_length_252_cov_2.215686	137	175	36	4	38	0.1052632
NODE_290066_length_252_cov_2.215686	137	175	37	8	38	0.2105263
NODE_290103_length_252_cov_2.052288	18	39	0	21	21	1.0000000
NODE_290238_length_252_cov_1.993464	80	139	6	12	59	0.2033898
NODE_290238_length_252_cov_1.993464	80	139	8	42	59	0.7118644
NODE_290238_length_252_cov_1.993464	80	139	10	5	59	0.0847458
NODE_290385_length_252_cov_1.810458	3	49	0	46	46	1.0000000
NODE_290623_length_252_cov_1.594771	103	156	0	51	53	0.9622642
NODE_290623_length_252_cov_1.594771	103	156	6	2	53	0.0377358
NODE_290623_length_252_cov_1.594771	152	192	0	2	40	0.0500000
NODE_290623_length_252_cov_1.594771	152	192	6	38	40	0.9500000
NODE_290638_length_252_cov_1.568627	1	68	0	67	67	1.0000000
NODE_290767_length_252_cov_1.359477	26	93	0	67	67	1.0000000
NODE_290790_length_252_cov_1.333333	179	232	0	9	53	0.1698113
NODE_290790_length_252_cov_1.333333	179	232	2	44	53	0.8301887
NODE_290850_length_252_cov_1.333333	187	222	0	35	35	1.0000000
NODE_291072_length_252_cov_1.333333	31	111	0	34	80	0.4250000
NODE_291072_length_252_cov_1.333333	31	111	2	46	80	0.5750000
NODE_291076_length_252_cov_1.333333	90	140	0	4	50	0.0800000
NODE_291076_length_252_cov_1.333333	90	140	4	4	50	0.0800000
NODE_291076_length_252_cov_1.333333	90	140	6	2	50	0.0400000
NODE_291076_length_252_cov_1.333333	90	140	8	40	50	0.8000000
NODE_291118_length_252_cov_1.326797	112	143	2	3	31	0.0967742
NODE_291118_length_252_cov_1.326797	112	143	4	28	31	0.9032258
NODE_291351_length_252_cov_1.156863	1	32	0	31	31	1.0000000
NODE_291650_length_252_cov_1.000000	49	79	0	30	30	1.0000000
NODE_291911_length_252_cov_0.836601	125	172	2	2	47	0.0425532
NODE_291911_length_252_cov_0.836601	125	172	4	37	47	0.7872341
NODE_291911_length_252_cov_0.836601	125	172	6	8	47	0.1702128
NODE_293004_length_251_cov_5.032895	0	62	0	62	62	1.0000000
NODE_293005_length_251_cov_5.026316	84	164	2	80	80	1.0000000
NODE_293165_length_251_cov_3.302632	187	249	0	62	62	1.0000000
NODE_293195_length_251_cov_3.131579	96	148	0	52	52	1.0000000
NODE_293238_length_251_cov_2.980263	11	38	2	27	27	1.0000000
NODE_293238_length_251_cov_2.980263	11	91	2	64	80	0.8000000
NODE_293238_length_251_cov_2.980263	11	91	4	9	80	0.1125000
NODE_293238_length_251_cov_2.980263	11	91	7	7	80	0.0875000
NODE_293259_length_251_cov_2.842105	170	198	2	10	28	0.3571429
NODE_293259_length_251_cov_2.842105	170	198	4	18	28	0.6428571
NODE_293279_length_251_cov_2.743421	181	232	0	51	51	1.0000000
NODE_293335_length_251_cov_2.677632	35	54	0	19	19	1.0000000
NODE_293454_length_251_cov_2.348684	196	251	0	6	55	0.1090909
NODE_293454_length_251_cov_2.348684	196	251	2	49	55	0.8909091
NODE_293502_length_251_cov_2.328947	86	149	0	63	63	1.0000000
NODE_293516_length_251_cov_2.296053	91	171	0	80	80	1.0000000
NODE_293516_length_251_cov_2.296053	144	224	0	80	80	1.0000000
NODE_293591_length_251_cov_2.065789	7	52	0	45	45	1.0000000
NODE_293698_length_251_cov_2.013158	96	179	8	8	83	0.0963855
NODE_293698_length_251_cov_2.013158	96	179	10	75	83	0.9036145
NODE_293698_length_251_cov_2.013158	96	179	8	8	83	0.0963855
NODE_293698_length_251_cov_2.013158	96	179	10	75	83	0.9036145
NODE_293698_length_251_cov_2.013158	152	203	0	11	51	0.2156863
NODE_293698_length_251_cov_2.013158	152	203	8	14	51	0.2745098
NODE_293698_length_251_cov_2.013158	152	203	10	26	51	0.5098040
NODE_293698_length_251_cov_2.013158	152	201	0	9	49	0.1836735
NODE_293698_length_251_cov_2.013158	152	201	8	14	49	0.2857143
NODE_293698_length_251_cov_2.013158	152	201	10	26	49	0.5306122
NODE_293919_length_251_cov_1.710526	135	194	0	59	59	1.0000000
NODE_294028_length_251_cov_1.671053	94	127	0	33	33	1.0000000
NODE_294063_length_251_cov_1.644737	135	164	0	29	29	1.0000000
NODE_294147_length_251_cov_1.473684	137	202	0	65	65	1.0000000
NODE_294153_length_251_cov_1.460526	17	78	2	61	61	1.0000000
NODE_294190_length_251_cov_1.407895	182	246	0	64	64	1.0000000
NODE_294393_length_251_cov_1.342105	9	89	0	80	80	1.0000000
NODE_294393_length_251_cov_1.342105	62	91	0	29	29	1.0000000
NODE_294624_length_251_cov_1.296053	7	47	0	40	40	1.0000000
NODE_294624_length_251_cov_1.296053	24	47	0	23	23	1.0000000
NODE_295165_length_251_cov_1.006579	4	50	0	46	46	1.0000000
NODE_296033_length_251_cov_0.671053	184	204	0	20	20	1.0000000
NODE_296386_length_251_cov_0.572368	54	74	0	20	20	1.0000000
NODE_296437_length_250_cov_35.662252	33	99	0	66	66	1.0000000
NODE_296437_length_250_cov_35.662252	143	223	0	80	80	1.0000000
NODE_296456_length_250_cov_6.503311	186	250	0	64	64	1.0000000
NODE_296467_length_250_cov_5.867550	99	120	0	21	21	1.0000000
NODE_296520_length_250_cov_4.662252	143	187	0	44	44	1.0000000
NODE_296520_length_250_cov_4.662252	160	227	0	67	67	1.0000000
NODE_296598_length_250_cov_3.715232	37	90	2	14	53	0.2641509
NODE_296598_length_250_cov_3.715232	37	90	4	39	53	0.7358491
NODE_296633_length_250_cov_3.417219	113	193	2	26	80	0.3250000
NODE_296633_length_250_cov_3.417219	113	193	4	54	80	0.6750000
NODE_296633_length_250_cov_3.417219	166	246	0	39	80	0.4875000
NODE_296633_length_250_cov_3.417219	166	246	2	40	80	0.5000000
NODE_296633_length_250_cov_3.417219	166	246	4	1	80	0.0125000
NODE_296653_length_250_cov_3.364238	0	61	0	61	61	1.0000000
NODE_296653_length_250_cov_3.364238	34	94	0	60	60	1.0000000
NODE_296680_length_250_cov_3.225166	157	209	0	52	52	1.0000000
NODE_296680_length_250_cov_3.225166	182	250	0	68	68	1.0000000
NODE_296699_length_250_cov_3.086093	33	67	0	34	34	1.0000000
NODE_296703_length_250_cov_3.052980	29	94	4	16	65	0.2461538
NODE_296703_length_250_cov_3.052980	29	94	6	13	65	0.2000000
NODE_296703_length_250_cov_3.052980	29	94	8	36	65	0.5538462
NODE_296707_length_250_cov_3.039735	51	106	0	55	55	1.0000000
NODE_296737_length_250_cov_2.986755	124	185	10	39	61	0.6393443
NODE_296737_length_250_cov_2.986755	124	185	12	15	61	0.2459016
NODE_296737_length_250_cov_2.986755	124	185	14	7	61	0.1147541
NODE_296737_length_250_cov_2.986755	172	243	0	11	71	0.1549296
NODE_296737_length_250_cov_2.986755	172	243	2	20	71	0.2816902
NODE_296737_length_250_cov_2.986755	172	243	4	6	71	0.0845070
NODE_296737_length_250_cov_2.986755	172	243	6	13	71	0.1830986
NODE_296737_length_250_cov_2.986755	172	243	10	8	71	0.1126761
NODE_296737_length_250_cov_2.986755	172	243	12	13	71	0.1830986
NODE_296885_length_250_cov_2.516556	0	49	0	49	49	1.0000000
NODE_296893_length_250_cov_2.476821	94	174	0	80	80	1.0000000
NODE_296893_length_250_cov_2.476821	147	227	0	80	80	1.0000000
NODE_296897_length_250_cov_2.470199	166	212	0	46	46	1.0000000
NODE_297070_length_250_cov_2.059603	150	207	0	57	57	1.0000000
NODE_297211_length_250_cov_2.019868	74	141	4	43	67	0.6417910
NODE_297211_length_250_cov_2.019868	74	141	6	13	67	0.1940299
NODE_297211_length_250_cov_2.019868	74	141	8	11	67	0.1641791
NODE_297211_length_250_cov_2.019868	158	204	12	29	46	0.6304348
NODE_297211_length_250_cov_2.019868	158	204	16	17	46	0.3695652
NODE_297550_length_250_cov_1.688742	6	42	0	36	36	1.0000000
NODE_297624_length_250_cov_1.635762	150	191	12	4	41	0.0975610
NODE_297624_length_250_cov_1.635762	150	191	14	2	41	0.0487805
NODE_297624_length_250_cov_1.635762	150	191	16	4	41	0.0975610
NODE_297624_length_250_cov_1.635762	150	191	18	3	41	0.0731707
NODE_297624_length_250_cov_1.635762	150	191	20	12	41	0.2926829
NODE_297624_length_250_cov_1.635762	150	191	22	16	41	0.3902439
NODE_297679_length_250_cov_1.529801	59	108	0	49	49	1.0000000
NODE_297679_length_250_cov_1.529801	81	161	0	45	80	0.5625000
NODE_297679_length_250_cov_1.529801	81	161	2	35	80	0.4375000
NODE_297693_length_250_cov_1.516556	124	184	0	60	60	1.0000000
NODE_297693_length_250_cov_1.516556	166	237	0	71	71	1.0000000
NODE_297762_length_250_cov_1.377483	0	80	0	80	80	1.0000000
NODE_297963_length_250_cov_1.350993	40	98	0	58	58	1.0000000
NODE_298213_length_250_cov_1.291391	116	196	2	5	80	0.0625000
NODE_298213_length_250_cov_1.291391	116	196	6	7	80	0.0875000
NODE_298213_length_250_cov_1.291391	116	196	8	8	80	0.1000000
NODE_298213_length_250_cov_1.291391	116	196	10	18	80	0.2250000
NODE_298213_length_250_cov_1.291391	116	196	12	42	80	0.5250000
NODE_298719_length_250_cov_1.013245	126	163	0	37	37	1.0000000
NODE_298794_length_250_cov_1.006623	129	148	0	19	19	1.0000000
NODE_298900_length_250_cov_0.920530	126	178	26	7	52	0.1346154
NODE_298900_length_250_cov_0.920530	126	178	28	1	52	0.0192308
NODE_298900_length_250_cov_0.920530	126	178	30	4	52	0.0769231
NODE_298900_length_250_cov_0.920530	126	178	31	4	52	0.0769231
NODE_298900_length_250_cov_0.920530	126	178	33	5	52	0.0961538
NODE_298900_length_250_cov_0.920530	126	178	34	4	52	0.0769231
NODE_298900_length_250_cov_0.920530	126	178	36	5	52	0.0961538
NODE_298900_length_250_cov_0.920530	126	178	38	2	52	0.0384615
NODE_298900_length_250_cov_0.920530	126	178	40	4	52	0.0769231
NODE_298900_length_250_cov_0.920530	126	178	44	4	52	0.0769231
NODE_298900_length_250_cov_0.920530	126	178	46	12	52	0.2307692
NODE_299979_length_249_cov_55.413333	97	172	0	75	75	1.0000000
NODE_299979_length_249_cov_55.413333	150	225	0	75	75	1.0000000
NODE_300012_length_247_cov_51.243243	172	247	0	75	75	1.0000000
NODE_300014_length_247_cov_37.614865	156	239	0	83	83	1.0000000
NODE_300056_length_245_cov_40.876712	138	202	24	10	64	0.1562500
NODE_300056_length_245_cov_40.876712	138	202	26	2	64	0.0312500
NODE_300056_length_245_cov_40.876712	138	202	28	2	64	0.0312500
NODE_300056_length_245_cov_40.876712	138	202	30	2	64	0.0312500
NODE_300056_length_245_cov_40.876712	138	202	32	1	64	0.0156250
NODE_300056_length_245_cov_40.876712	138	202	33	2	64	0.0312500
NODE_300056_length_245_cov_40.876712	138	202	37	6	64	0.0937500
NODE_300056_length_245_cov_40.876712	138	202	41	12	64	0.1875000
NODE_300056_length_245_cov_40.876712	138	202	42	9	64	0.1406250
NODE_300056_length_245_cov_40.876712	138	202	43	2	64	0.0312500
NODE_300056_length_245_cov_40.876712	138	202	44	2	64	0.0312500
NODE_300056_length_245_cov_40.876712	138	202	46	4	64	0.0625000
NODE_300056_length_245_cov_40.876712	138	202	47	9	64	0.1406250
NODE_300056_length_245_cov_40.876712	138	202	49	1	64	0.0156250
NODE_300056_length_245_cov_40.876712	138	202	24	10	64	0.1562500
NODE_300056_length_245_cov_40.876712	138	202	26	2	64	0.0312500
NODE_300056_length_245_cov_40.876712	138	202	28	2	64	0.0312500
NODE_300056_length_245_cov_40.876712	138	202	30	2	64	0.0312500
NODE_300056_length_245_cov_40.876712	138	202	32	1	64	0.0156250
NODE_300056_length_245_cov_40.876712	138	202	33	2	64	0.0312500
NODE_300056_length_245_cov_40.876712	138	202	37	6	64	0.0937500
NODE_300056_length_245_cov_40.876712	138	202	41	12	64	0.1875000
NODE_300056_length_245_cov_40.876712	138	202	42	9	64	0.1406250
NODE_300056_length_245_cov_40.876712	138	202	43	2	64	0.0312500
NODE_300056_length_245_cov_40.876712	138	202	44	2	64	0.0312500
NODE_300056_length_245_cov_40.876712	138	202	46	4	64	0.0625000
NODE_300056_length_245_cov_40.876712	138	202	47	9	64	0.1406250
NODE_300056_length_245_cov_40.876712	138	202	49	1	64	0.0156250
NODE_300056_length_245_cov_40.876712	138	202	24	10	64	0.1562500
NODE_300056_length_245_cov_40.876712	138	202	26	2	64	0.0312500
NODE_300056_length_245_cov_40.876712	138	202	28	2	64	0.0312500
NODE_300056_length_245_cov_40.876712	138	202	30	2	64	0.0312500
NODE_300056_length_245_cov_40.876712	138	202	32	1	64	0.0156250
NODE_300056_length_245_cov_40.876712	138	202	33	2	64	0.0312500
NODE_300056_length_245_cov_40.876712	138	202	37	6	64	0.0937500
NODE_300056_length_245_cov_40.876712	138	202	41	12	64	0.1875000
NODE_300056_length_245_cov_40.876712	138	202	42	9	64	0.1406250
NODE_300056_length_245_cov_40.876712	138	202	43	2	64	0.0312500
NODE_300056_length_245_cov_40.876712	138	202	44	2	64	0.0312500
NODE_300056_length_245_cov_40.876712	138	202	46	4	64	0.0625000
NODE_300056_length_245_cov_40.876712	138	202	47	9	64	0.1406250
NODE_300056_length_245_cov_40.876712	138	202	49	1	64	0.0156250
NODE_300056_length_245_cov_40.876712	175	241	0	6	66	0.0909091
NODE_300056_length_245_cov_40.876712	175	241	2	1	66	0.0151515
NODE_300056_length_245_cov_40.876712	175	241	3	1	66	0.0151515
NODE_300056_length_245_cov_40.876712	175	241	9	3	66	0.0454545
NODE_300056_length_245_cov_40.876712	175	241	11	3	66	0.0454545
NODE_300056_length_245_cov_40.876712	175	241	13	6	66	0.0909091
NODE_300056_length_245_cov_40.876712	175	241	15	3	66	0.0454545
NODE_300056_length_245_cov_40.876712	175	241	19	7	66	0.1060606
NODE_300056_length_245_cov_40.876712	175	241	21	3	66	0.0454545
NODE_300056_length_245_cov_40.876712	175	241	22	2	66	0.0303030
NODE_300056_length_245_cov_40.876712	175	241	23	1	66	0.0151515
NODE_300056_length_245_cov_40.876712	175	241	24	13	66	0.1969697
NODE_300056_length_245_cov_40.876712	175	241	26	2	66	0.0303030
NODE_300056_length_245_cov_40.876712	175	241	28	2	66	0.0303030
NODE_300056_length_245_cov_40.876712	175	241	30	2	66	0.0303030
NODE_300056_length_245_cov_40.876712	175	241	32	1	66	0.0151515
NODE_300056_length_245_cov_40.876712	175	241	33	2	66	0.0303030
NODE_300056_length_245_cov_40.876712	175	241	37	6	66	0.0909091
NODE_300056_length_245_cov_40.876712	175	241	41	2	66	0.0303030
NODE_300147_length_240_cov_80.744681	167	238	0	71	71	1.0000000
NODE_300148_length_240_cov_38.035461	31	82	2	12	51	0.2352941
NODE_300148_length_240_cov_38.035461	31	82	4	8	51	0.1568628
NODE_300148_length_240_cov_38.035461	31	82	6	31	51	0.6078432
NODE_300165_length_239_cov_72.878571	0	48	0	48	48	1.0000000
NODE_300165_length_239_cov_72.878571	21	101	0	38	80	0.4750000
NODE_300165_length_239_cov_72.878571	21	101	2	42	80	0.5250000
NODE_300165_length_239_cov_72.878571	150	230	0	59	80	0.7375000
NODE_300165_length_239_cov_72.878571	150	230	2	21	80	0.2625000
NODE_300165_length_239_cov_72.878571	150	230	0	59	80	0.7375000
NODE_300165_length_239_cov_72.878571	150	230	2	21	80	0.2625000
NODE_300165_length_239_cov_72.878571	150	212	0	41	62	0.6612903
NODE_300165_length_239_cov_72.878571	150	212	2	21	62	0.3387097
NODE_300165_length_239_cov_72.878571	150	221	0	50	71	0.7042254
NODE_300165_length_239_cov_72.878571	150	221	2	21	71	0.2957746
NODE_300208_length_238_cov_385.683453	35	104	14	8	69	0.1159420
NODE_300208_length_238_cov_385.683453	35	104	16	8	69	0.1159420
NODE_300208_length_238_cov_385.683453	35	104	19	16	69	0.2318841
NODE_300208_length_238_cov_385.683453	35	104	21	15	69	0.2173913
NODE_300208_length_238_cov_385.683453	35	104	23	9	69	0.1304348
NODE_300208_length_238_cov_385.683453	35	104	26	4	69	0.0579710
NODE_300208_length_238_cov_385.683453	35	104	28	8	69	0.1159420
NODE_300208_length_238_cov_385.683453	35	104	30	1	69	0.0144928
NODE_300225_length_237_cov_101.543478	83	163	0	15	80	0.1875000
NODE_300225_length_237_cov_101.543478	83	163	1	1	80	0.0125000
NODE_300225_length_237_cov_101.543478	83	163	2	16	80	0.2000000
NODE_300225_length_237_cov_101.543478	83	163	4	48	80	0.6000000
NODE_300225_length_237_cov_101.543478	83	163	0	15	80	0.1875000
NODE_300225_length_237_cov_101.543478	83	163	1	1	80	0.0125000
NODE_300225_length_237_cov_101.543478	83	163	2	16	80	0.2000000
NODE_300225_length_237_cov_101.543478	83	163	4	48	80	0.6000000
NODE_300225_length_237_cov_101.543478	83	163	0	15	80	0.1875000
NODE_300225_length_237_cov_101.543478	83	163	1	1	80	0.0125000
NODE_300225_length_237_cov_101.543478	83	163	2	16	80	0.2000000
NODE_300225_length_237_cov_101.543478	83	163	4	48	80	0.6000000
NODE_300225_length_237_cov_101.543478	83	163	0	15	80	0.1875000
NODE_300225_length_237_cov_101.543478	83	163	1	1	80	0.0125000
NODE_300225_length_237_cov_101.543478	83	163	2	16	80	0.2000000
NODE_300225_length_237_cov_101.543478	83	163	4	48	80	0.6000000
NODE_300225_length_237_cov_101.543478	136	216	0	7	80	0.0875000
NODE_300225_length_237_cov_101.543478	136	216	2	40	80	0.5000000
NODE_300225_length_237_cov_101.543478	136	216	4	33	80	0.4125000
NODE_300225_length_237_cov_101.543478	136	216	0	7	80	0.0875000
NODE_300225_length_237_cov_101.543478	136	216	2	40	80	0.5000000
NODE_300225_length_237_cov_101.543478	136	216	4	33	80	0.4125000
NODE_300225_length_237_cov_101.543478	136	216	0	7	80	0.0875000
NODE_300225_length_237_cov_101.543478	136	216	2	40	80	0.5000000
NODE_300225_length_237_cov_101.543478	136	216	4	33	80	0.4125000
NODE_300225_length_237_cov_101.543478	138	216	0	7	78	0.0897436
NODE_300225_length_237_cov_101.543478	138	216	2	40	78	0.5128205
NODE_300225_length_237_cov_101.543478	138	216	4	31	78	0.3974359
NODE_300225_length_237_cov_101.543478	138	216	0	7	78	0.0897436
NODE_300225_length_237_cov_101.543478	138	216	2	40	78	0.5128205
NODE_300225_length_237_cov_101.543478	138	216	4	31	78	0.3974359
NODE_300227_length_237_cov_49.623188	13	88	0	75	75	1.0000000
NODE_300227_length_237_cov_49.623188	73	153	0	80	80	1.0000000
NODE_300227_length_237_cov_49.623188	126	206	0	80	80	1.0000000
NODE_300289_length_235_cov_67.904412	0	62	0	62	62	1.0000000
NODE_300289_length_235_cov_67.904412	25	111	0	86	86	1.0000000
NODE_300289_length_235_cov_67.904412	69	150	0	81	81	1.0000000
NODE_300289_length_235_cov_67.904412	113	194	0	81	81	1.0000000
NODE_300289_length_235_cov_67.904412	157	235	0	78	78	1.0000000
NODE_300322_length_234_cov_76.496296	0	76	4	54	76	0.7105263
NODE_300322_length_234_cov_76.496296	0	76	6	22	76	0.2894737
NODE_300322_length_234_cov_76.496296	0	76	4	54	76	0.7105263
NODE_300322_length_234_cov_76.496296	0	76	6	22	76	0.2894737
NODE_300322_length_234_cov_76.496296	0	76	4	54	76	0.7105263
NODE_300322_length_234_cov_76.496296	0	76	6	22	76	0.2894737
NODE_300322_length_234_cov_76.496296	0	76	4	54	76	0.7105263
NODE_300322_length_234_cov_76.496296	0	76	6	22	76	0.2894737
NODE_300322_length_234_cov_76.496296	49	128	4	5	79	0.0632911
NODE_300322_length_234_cov_76.496296	49	128	6	55	79	0.6962025
NODE_300322_length_234_cov_76.496296	49	128	8	10	79	0.1265823
NODE_300322_length_234_cov_76.496296	49	128	10	9	79	0.1139240
NODE_300322_length_234_cov_76.496296	49	128	4	5	79	0.0632911
NODE_300322_length_234_cov_76.496296	49	128	6	55	79	0.6962025
NODE_300322_length_234_cov_76.496296	49	128	8	10	79	0.1265823
NODE_300322_length_234_cov_76.496296	49	128	10	9	79	0.1139240
NODE_300322_length_234_cov_76.496296	124	204	4	28	80	0.3500000
NODE_300322_length_234_cov_76.496296	124	204	6	37	80	0.4625000
NODE_300322_length_234_cov_76.496296	124	204	10	15	80	0.1875000
NODE_300322_length_234_cov_76.496296	124	204	4	28	80	0.3500000
NODE_300322_length_234_cov_76.496296	124	204	6	37	80	0.4625000
NODE_300322_length_234_cov_76.496296	124	204	10	15	80	0.1875000
NODE_300322_length_234_cov_76.496296	124	204	4	28	80	0.3500000
NODE_300322_length_234_cov_76.496296	124	204	6	37	80	0.4625000
NODE_300322_length_234_cov_76.496296	124	204	10	15	80	0.1875000
NODE_300322_length_234_cov_76.496296	177	226	0	19	49	0.3877551
NODE_300322_length_234_cov_76.496296	177	226	2	3	49	0.0612245
NODE_300322_length_234_cov_76.496296	177	226	4	27	49	0.5510204
NODE_300322_length_234_cov_76.496296	177	234	0	27	57	0.4736842
NODE_300322_length_234_cov_76.496296	177	234	2	3	57	0.0526316
NODE_300322_length_234_cov_76.496296	177	234	4	27	57	0.4736842
NODE_300322_length_234_cov_76.496296	182	234	0	27	52	0.5192308
NODE_300322_length_234_cov_76.496296	182	234	2	3	52	0.0576923
NODE_300322_length_234_cov_76.496296	182	234	4	22	52	0.4230769
NODE_300323_length_234_cov_71.548148	90	162	4	2	72	0.0277778
NODE_300323_length_234_cov_71.548148	90	162	6	13	72	0.1805556
NODE_300323_length_234_cov_71.548148	90	162	8	57	72	0.7916667
NODE_300323_length_234_cov_71.548148	90	162	4	2	72	0.0277778
NODE_300323_length_234_cov_71.548148	90	162	6	13	72	0.1805556
NODE_300323_length_234_cov_71.548148	90	162	8	57	72	0.7916667
NODE_300323_length_234_cov_71.548148	135	215	0	22	80	0.2750000
NODE_300323_length_234_cov_71.548148	135	215	2	4	80	0.0500000
NODE_300323_length_234_cov_71.548148	135	215	4	6	80	0.0750000
NODE_300323_length_234_cov_71.548148	135	215	6	16	80	0.2000000
NODE_300323_length_234_cov_71.548148	135	215	8	32	80	0.4000000
NODE_300323_length_234_cov_71.548148	135	215	0	22	80	0.2750000
NODE_300323_length_234_cov_71.548148	135	215	2	4	80	0.0500000
NODE_300323_length_234_cov_71.548148	135	215	4	6	80	0.0750000
NODE_300323_length_234_cov_71.548148	135	215	6	16	80	0.2000000
NODE_300323_length_234_cov_71.548148	135	215	8	32	80	0.4000000
NODE_300357_length_233_cov_180.701493	0	65	0	13	65	0.2000000
NODE_300357_length_233_cov_180.701493	0	65	2	14	65	0.2153846
NODE_300357_length_233_cov_180.701493	0	65	4	10	65	0.1538462
NODE_300357_length_233_cov_180.701493	0	65	6	6	65	0.0923077
NODE_300357_length_233_cov_180.701493	0	65	8	22	65	0.3384615
NODE_300357_length_233_cov_180.701493	38	118	6	18	80	0.2250000
NODE_300357_length_233_cov_180.701493	38	118	8	62	80	0.7750000
NODE_300392_length_232_cov_132.045113	53	133	0	56	80	0.7000000
NODE_300392_length_232_cov_132.045113	53	133	4	2	80	0.0250000
NODE_300392_length_232_cov_132.045113	53	133	6	3	80	0.0375000
NODE_300392_length_232_cov_132.045113	53	133	8	19	80	0.2375000
NODE_300392_length_232_cov_132.045113	106	186	0	3	80	0.0375000
NODE_300392_length_232_cov_132.045113	106	186	4	2	80	0.0250000
NODE_300392_length_232_cov_132.045113	106	186	6	3	80	0.0375000
NODE_300392_length_232_cov_132.045113	106	186	8	72	80	0.9000000
NODE_300471_length_230_cov_34.427481	0	59	0	59	59	1.0000000
NODE_300471_length_230_cov_34.427481	0	59	0	59	59	1.0000000
NODE_300471_length_230_cov_34.427481	10	59	0	49	49	1.0000000
NODE_300487_length_229_cov_76.907692	94	176	14	1	82	0.0121951
NODE_300487_length_229_cov_76.907692	94	176	16	18	82	0.2195122
NODE_300487_length_229_cov_76.907692	94	176	18	20	82	0.2439024
NODE_300487_length_229_cov_76.907692	94	176	20	21	82	0.2560976
NODE_300487_length_229_cov_76.907692	94	176	22	18	82	0.2195122
NODE_300487_length_229_cov_76.907692	94	176	24	4	82	0.0487805
NODE_300523_length_228_cov_127.131783	0	76	0	56	76	0.7368421
NODE_300523_length_228_cov_127.131783	0	76	4	20	76	0.2631579
NODE_300523_length_228_cov_127.131783	5	76	0	51	71	0.7183099
NODE_300523_length_228_cov_127.131783	5	76	4	20	71	0.2816902
NODE_300523_length_228_cov_127.131783	10	76	0	46	66	0.6969697
NODE_300523_length_228_cov_127.131783	10	76	4	20	66	0.3030303
NODE_300523_length_228_cov_127.131783	49	129	0	7	80	0.0875000
NODE_300523_length_228_cov_127.131783	49	129	4	73	80	0.9125000
NODE_300523_length_228_cov_127.131783	49	129	0	7	80	0.0875000
NODE_300523_length_228_cov_127.131783	49	129	4	73	80	0.9125000
NODE_300523_length_228_cov_127.131783	49	129	0	7	80	0.0875000
NODE_300523_length_228_cov_127.131783	49	129	4	73	80	0.9125000
NODE_300523_length_228_cov_127.131783	125	205	0	71	80	0.8875000
NODE_300523_length_228_cov_127.131783	125	205	4	9	80	0.1125000
NODE_300523_length_228_cov_127.131783	125	205	0	71	80	0.8875000
NODE_300523_length_228_cov_127.131783	125	205	4	9	80	0.1125000
NODE_300523_length_228_cov_127.131783	125	205	0	71	80	0.8875000
NODE_300523_length_228_cov_127.131783	125	205	4	9	80	0.1125000
NODE_300523_length_228_cov_127.131783	178	228	0	50	50	1.0000000
NODE_300523_length_228_cov_127.131783	178	228	0	50	50	1.0000000
NODE_300523_length_228_cov_127.131783	178	228	0	50	50	1.0000000
NODE_300524_length_228_cov_94.255814	34	99	4	48	65	0.7384616
NODE_300524_length_228_cov_94.255814	34	99	8	17	65	0.2615385
NODE_300524_length_228_cov_94.255814	34	114	4	48	80	0.6000000
NODE_300524_length_228_cov_94.255814	34	114	8	32	80	0.4000000
NODE_300524_length_228_cov_94.255814	41	111	4	41	70	0.5857143
NODE_300524_length_228_cov_94.255814	41	111	8	29	70	0.4142857
NODE_300524_length_228_cov_94.255814	43	114	4	39	71	0.5492958
NODE_300524_length_228_cov_94.255814	43	114	8	32	71	0.4507042
NODE_300524_length_228_cov_94.255814	87	167	0	4	80	0.0500000
NODE_300524_length_228_cov_94.255814	87	167	4	11	80	0.1375000
NODE_300524_length_228_cov_94.255814	87	167	8	65	80	0.8125000
NODE_300524_length_228_cov_94.255814	87	167	0	4	80	0.0500000
NODE_300524_length_228_cov_94.255814	87	167	4	11	80	0.1375000
NODE_300524_length_228_cov_94.255814	87	167	8	65	80	0.8125000
NODE_300524_length_228_cov_94.255814	87	167	0	4	80	0.0500000
NODE_300524_length_228_cov_94.255814	87	167	4	11	80	0.1375000
NODE_300524_length_228_cov_94.255814	87	167	8	65	80	0.8125000
NODE_300524_length_228_cov_94.255814	87	167	0	4	80	0.0500000
NODE_300524_length_228_cov_94.255814	87	167	4	11	80	0.1375000
NODE_300524_length_228_cov_94.255814	87	167	8	65	80	0.8125000
NODE_300547_length_228_cov_0.395349	27	107	0	80	80	1.0000000
NODE_300547_length_228_cov_0.395349	70	150	0	80	80	1.0000000
NODE_300556_length_227_cov_37.429688	40	111	0	7	71	0.0985916
NODE_300556_length_227_cov_37.429688	40	111	2	21	71	0.2957746
NODE_300556_length_227_cov_37.429688	40	111	3	5	71	0.0704225
NODE_300556_length_227_cov_37.429688	40	111	4	2	71	0.0281690
NODE_300556_length_227_cov_37.429688	40	111	6	36	71	0.5070422
NODE_300556_length_227_cov_37.429688	49	112	2	19	63	0.3015873
NODE_300556_length_227_cov_37.429688	49	112	3	5	63	0.0793651
NODE_300556_length_227_cov_37.429688	49	112	4	2	63	0.0317460
NODE_300556_length_227_cov_37.429688	49	112	6	37	63	0.5873016
NODE_300556_length_227_cov_37.429688	93	172	0	2	79	0.0253165
NODE_300556_length_227_cov_37.429688	93	172	2	14	79	0.1772152
NODE_300556_length_227_cov_37.429688	93	172	4	5	79	0.0632911
NODE_300556_length_227_cov_37.429688	93	172	6	58	79	0.7341772
NODE_300556_length_227_cov_37.429688	168	227	0	57	59	0.9661017
NODE_300556_length_227_cov_37.429688	168	227	2	2	59	0.0338983
NODE_300556_length_227_cov_37.429688	168	227	0	57	59	0.9661017
NODE_300556_length_227_cov_37.429688	168	227	2	2	59	0.0338983
NODE_300595_length_226_cov_547.629921	82	162	385	1	80	0.0125000
NODE_300595_length_226_cov_547.629921	82	162	399	2	80	0.0250000
NODE_300595_length_226_cov_547.629921	82	162	403	2	80	0.0250000
NODE_300595_length_226_cov_547.629921	82	162	404	1	80	0.0125000
NODE_300595_length_226_cov_547.629921	82	162	413	1	80	0.0125000
NODE_300595_length_226_cov_547.629921	82	162	416	1	80	0.0125000
NODE_300595_length_226_cov_547.629921	82	162	418	1	80	0.0125000
NODE_300595_length_226_cov_547.629921	82	162	419	3	80	0.0375000
NODE_300595_length_226_cov_547.629921	82	162	422	1	80	0.0125000
NODE_300595_length_226_cov_547.629921	82	162	424	1	80	0.0125000
NODE_300595_length_226_cov_547.629921	82	162	425	1	80	0.0125000
NODE_300595_length_226_cov_547.629921	82	162	428	1	80	0.0125000
NODE_300595_length_226_cov_547.629921	82	162	430	1	80	0.0125000
NODE_300595_length_226_cov_547.629921	82	162	434	1	80	0.0125000
NODE_300595_length_226_cov_547.629921	82	162	436	2	80	0.0250000
NODE_300595_length_226_cov_547.629921	82	162	438	1	80	0.0125000
NODE_300595_length_226_cov_547.629921	82	162	440	1	80	0.0125000
NODE_300595_length_226_cov_547.629921	82	162	442	1	80	0.0125000
NODE_300595_length_226_cov_547.629921	82	162	447	1	80	0.0125000
NODE_300595_length_226_cov_547.629921	82	162	448	2	80	0.0250000
NODE_300595_length_226_cov_547.629921	82	162	449	1	80	0.0125000
NODE_300595_length_226_cov_547.629921	82	162	451	1	80	0.0125000
NODE_300595_length_226_cov_547.629921	82	162	453	1	80	0.0125000
NODE_300595_length_226_cov_547.629921	82	162	456	3	80	0.0375000
NODE_300595_length_226_cov_547.629921	82	162	458	1	80	0.0125000
NODE_300595_length_226_cov_547.629921	82	162	460	2	80	0.0250000
NODE_300595_length_226_cov_547.629921	82	162	461	1	80	0.0125000
NODE_300595_length_226_cov_547.629921	82	162	468	1	80	0.0125000
NODE_300595_length_226_cov_547.629921	82	162	470	3	80	0.0375000
NODE_300595_length_226_cov_547.629921	82	162	472	2	80	0.0250000
NODE_300595_length_226_cov_547.629921	82	162	478	1	80	0.0125000
NODE_300595_length_226_cov_547.629921	82	162	482	2	80	0.0250000
NODE_300595_length_226_cov_547.629921	82	162	486	1	80	0.0125000
NODE_300595_length_226_cov_547.629921	82	162	488	2	80	0.0250000
NODE_300595_length_226_cov_547.629921	82	162	490	1	80	0.0125000
NODE_300595_length_226_cov_547.629921	82	162	492	2	80	0.0250000
NODE_300595_length_226_cov_547.629921	82	162	494	1	80	0.0125000
NODE_300595_length_226_cov_547.629921	82	162	496	2	80	0.0250000
NODE_300595_length_226_cov_547.629921	82	162	500	3	80	0.0375000
NODE_300595_length_226_cov_547.629921	82	162	502	1	80	0.0125000
NODE_300595_length_226_cov_547.629921	82	162	504	1	80	0.0125000
NODE_300595_length_226_cov_547.629921	82	162	506	4	80	0.0500000
NODE_300595_length_226_cov_547.629921	82	162	510	2	80	0.0250000
NODE_300595_length_226_cov_547.629921	82	162	512	4	80	0.0500000
NODE_300595_length_226_cov_547.629921	82	162	514	1	80	0.0125000
NODE_300595_length_226_cov_547.629921	82	162	516	2	80	0.0250000
NODE_300595_length_226_cov_547.629921	82	162	518	2	80	0.0250000
NODE_300595_length_226_cov_547.629921	82	162	522	3	80	0.0375000
NODE_300595_length_226_cov_547.629921	82	162	524	2	80	0.0250000
NODE_300595_length_226_cov_547.629921	82	162	526	1	80	0.0125000
NODE_300617_length_225_cov_41.269841	81	165	10	11	84	0.1309524
NODE_300617_length_225_cov_41.269841	81	165	14	8	84	0.0952381
NODE_300617_length_225_cov_41.269841	81	165	16	8	84	0.0952381
NODE_300617_length_225_cov_41.269841	81	165	18	1	84	0.0119048
NODE_300617_length_225_cov_41.269841	81	165	22	2	84	0.0238095
NODE_300617_length_225_cov_41.269841	81	165	26	7	84	0.0833333
NODE_300617_length_225_cov_41.269841	81	165	27	2	84	0.0238095
NODE_300617_length_225_cov_41.269841	81	165	28	19	84	0.2261905
NODE_300617_length_225_cov_41.269841	81	165	30	9	84	0.1071429
NODE_300617_length_225_cov_41.269841	81	165	32	17	84	0.2023810
NODE_300617_length_225_cov_41.269841	134	218	2	16	84	0.1904762
NODE_300617_length_225_cov_41.269841	134	218	4	25	84	0.2976190
NODE_300617_length_225_cov_41.269841	134	218	8	8	84	0.0952381
NODE_300617_length_225_cov_41.269841	134	218	10	15	84	0.1785714
NODE_300617_length_225_cov_41.269841	134	218	14	8	84	0.0952381
NODE_300617_length_225_cov_41.269841	134	218	16	8	84	0.0952381
NODE_300617_length_225_cov_41.269841	134	218	18	1	84	0.0119048
NODE_300617_length_225_cov_41.269841	134	218	22	2	84	0.0238095
NODE_300617_length_225_cov_41.269841	134	218	26	1	84	0.0119048
NODE_300661_length_224_cov_209.528000	12	84	4	6	72	0.0833333
NODE_300661_length_224_cov_209.528000	12	84	5	18	72	0.2500000
NODE_300661_length_224_cov_209.528000	12	84	6	5	72	0.0694444
NODE_300661_length_224_cov_209.528000	12	84	8	5	72	0.0694444
NODE_300661_length_224_cov_209.528000	12	84	10	14	72	0.1944444
NODE_300661_length_224_cov_209.528000	12	84	12	5	72	0.0694444
NODE_300661_length_224_cov_209.528000	12	84	14	3	72	0.0416667
NODE_300661_length_224_cov_209.528000	12	84	16	5	72	0.0694444
NODE_300661_length_224_cov_209.528000	12	84	18	3	72	0.0416667
NODE_300661_length_224_cov_209.528000	12	84	20	3	72	0.0416667
NODE_300661_length_224_cov_209.528000	12	84	22	5	72	0.0694444
NODE_300663_length_224_cov_146.568000	13	72	4	7	59	0.1186441
NODE_300663_length_224_cov_146.568000	13	72	5	2	59	0.0338983
NODE_300663_length_224_cov_146.568000	13	72	7	2	59	0.0338983
NODE_300663_length_224_cov_146.568000	13	72	9	1	59	0.0169492
NODE_300663_length_224_cov_146.568000	13	72	11	10	59	0.1694915
NODE_300663_length_224_cov_146.568000	13	72	13	4	59	0.0677966
NODE_300663_length_224_cov_146.568000	13	72	15	2	59	0.0338983
NODE_300663_length_224_cov_146.568000	13	72	17	7	59	0.1186441
NODE_300663_length_224_cov_146.568000	13	72	18	1	59	0.0169492
NODE_300663_length_224_cov_146.568000	13	72	20	11	59	0.1864407
NODE_300663_length_224_cov_146.568000	13	72	22	12	59	0.2033898
NODE_300663_length_224_cov_146.568000	46	72	17	2	26	0.0769231
NODE_300663_length_224_cov_146.568000	46	72	18	1	26	0.0384615
NODE_300663_length_224_cov_146.568000	46	72	20	11	26	0.4230769
NODE_300663_length_224_cov_146.568000	46	72	22	12	26	0.4615385
NODE_300663_length_224_cov_146.568000	68	120	22	6	52	0.1153846
NODE_300663_length_224_cov_146.568000	68	120	26	1	52	0.0192308
NODE_300663_length_224_cov_146.568000	68	120	32	1	52	0.0192308
NODE_300663_length_224_cov_146.568000	68	120	34	3	52	0.0576923
NODE_300663_length_224_cov_146.568000	68	120	40	2	52	0.0384615
NODE_300663_length_224_cov_146.568000	68	120	45	1	52	0.0192308
NODE_300663_length_224_cov_146.568000	68	120	47	2	52	0.0384615
NODE_300663_length_224_cov_146.568000	68	120	50	1	52	0.0192308
NODE_300663_length_224_cov_146.568000	68	120	54	1	52	0.0192308
NODE_300663_length_224_cov_146.568000	68	120	62	1	52	0.0192308
NODE_300663_length_224_cov_146.568000	68	120	64	1	52	0.0192308
NODE_300663_length_224_cov_146.568000	68	120	67	1	52	0.0192308
NODE_300663_length_224_cov_146.568000	68	120	68	3	52	0.0576923
NODE_300663_length_224_cov_146.568000	68	120	70	1	52	0.0192308
NODE_300663_length_224_cov_146.568000	68	120	72	2	52	0.0384615
NODE_300663_length_224_cov_146.568000	68	120	74	3	52	0.0576923
NODE_300663_length_224_cov_146.568000	68	120	76	4	52	0.0769231
NODE_300663_length_224_cov_146.568000	68	120	78	1	52	0.0192308
NODE_300663_length_224_cov_146.568000	68	120	80	1	52	0.0192308
NODE_300663_length_224_cov_146.568000	68	120	83	2	52	0.0384615
NODE_300663_length_224_cov_146.568000	68	120	84	1	52	0.0192308
NODE_300663_length_224_cov_146.568000	68	120	86	3	52	0.0576923
NODE_300663_length_224_cov_146.568000	68	120	88	2	52	0.0384615
NODE_300663_length_224_cov_146.568000	68	120	92	3	52	0.0576923
NODE_300663_length_224_cov_146.568000	68	120	93	1	52	0.0192308
NODE_300663_length_224_cov_146.568000	68	120	95	1	52	0.0192308
NODE_300663_length_224_cov_146.568000	68	120	97	3	52	0.0576923
NODE_300665_length_224_cov_59.088000	98	178	16	25	80	0.3125000
NODE_300665_length_224_cov_59.088000	98	178	18	24	80	0.3000000
NODE_300665_length_224_cov_59.088000	98	178	20	31	80	0.3875000
NODE_300665_length_224_cov_59.088000	98	178	16	25	80	0.3125000
NODE_300665_length_224_cov_59.088000	98	178	18	24	80	0.3000000
NODE_300665_length_224_cov_59.088000	98	178	20	31	80	0.3875000
NODE_300665_length_224_cov_59.088000	98	178	16	25	80	0.3125000
NODE_300665_length_224_cov_59.088000	98	178	18	24	80	0.3000000
NODE_300665_length_224_cov_59.088000	98	178	20	31	80	0.3875000
NODE_300665_length_224_cov_59.088000	151	217	0	3	66	0.0454545
NODE_300665_length_224_cov_59.088000	151	217	2	1	66	0.0151515
NODE_300665_length_224_cov_59.088000	151	217	4	8	66	0.1212121
NODE_300665_length_224_cov_59.088000	151	217	6	6	66	0.0909091
NODE_300665_length_224_cov_59.088000	151	217	8	6	66	0.0909091
NODE_300665_length_224_cov_59.088000	151	217	10	9	66	0.1363636
NODE_300665_length_224_cov_59.088000	151	217	12	1	66	0.0151515
NODE_300665_length_224_cov_59.088000	151	217	14	2	66	0.0303030
NODE_300665_length_224_cov_59.088000	151	217	16	7	66	0.1060606
NODE_300665_length_224_cov_59.088000	151	217	18	22	66	0.3333333
NODE_300665_length_224_cov_59.088000	151	217	20	1	66	0.0151515
NODE_300665_length_224_cov_59.088000	151	224	0	10	73	0.1369863
NODE_300665_length_224_cov_59.088000	151	224	2	1	73	0.0136986
NODE_300665_length_224_cov_59.088000	151	224	4	8	73	0.1095890
NODE_300665_length_224_cov_59.088000	151	224	6	6	73	0.0821918
NODE_300665_length_224_cov_59.088000	151	224	8	6	73	0.0821918
NODE_300665_length_224_cov_59.088000	151	224	10	9	73	0.1232877
NODE_300665_length_224_cov_59.088000	151	224	12	1	73	0.0136986
NODE_300665_length_224_cov_59.088000	151	224	14	2	73	0.0273973
NODE_300665_length_224_cov_59.088000	151	224	16	7	73	0.0958904
NODE_300665_length_224_cov_59.088000	151	224	18	22	73	0.3013699
NODE_300665_length_224_cov_59.088000	151	224	20	1	73	0.0136986
NODE_300667_length_224_cov_43.640000	98	157	0	59	59	1.0000000
NODE_300667_length_224_cov_43.640000	98	157	0	59	59	1.0000000
NODE_300667_length_224_cov_43.640000	106	157	0	51	51	1.0000000
NODE_300669_length_224_cov_36.224000	100	171	0	71	71	1.0000000
NODE_300669_length_224_cov_36.224000	151	224	0	73	73	1.0000000
NODE_300696_length_223_cov_35.814516	0	54	0	54	54	1.0000000
NODE_300696_length_223_cov_35.814516	30	107	0	77	77	1.0000000
NODE_300768_length_221_cov_71.319672	14	94	26	5	80	0.0625000
NODE_300768_length_221_cov_71.319672	14	94	28	5	80	0.0625000
NODE_300768_length_221_cov_71.319672	14	94	32	3	80	0.0375000
NODE_300768_length_221_cov_71.319672	14	94	34	7	80	0.0875000
NODE_300768_length_221_cov_71.319672	14	94	36	1	80	0.0125000
NODE_300768_length_221_cov_71.319672	14	94	40	6	80	0.0750000
NODE_300768_length_221_cov_71.319672	14	94	42	1	80	0.0125000
NODE_300768_length_221_cov_71.319672	14	94	48	1	80	0.0125000
NODE_300768_length_221_cov_71.319672	14	94	50	7	80	0.0875000
NODE_300768_length_221_cov_71.319672	14	94	52	14	80	0.1750000
NODE_300768_length_221_cov_71.319672	14	94	56	30	80	0.3750000
NODE_300800_length_220_cov_42.206612	3	74	7	5	71	0.0704225
NODE_300800_length_220_cov_42.206612	3	74	9	14	71	0.1971831
NODE_300800_length_220_cov_42.206612	3	74	13	1	71	0.0140845
NODE_300800_length_220_cov_42.206612	3	74	15	2	71	0.0281690
NODE_300800_length_220_cov_42.206612	3	74	16	1	71	0.0140845
NODE_300800_length_220_cov_42.206612	3	74	19	1	71	0.0140845
NODE_300800_length_220_cov_42.206612	3	74	23	3	71	0.0422535
NODE_300800_length_220_cov_42.206612	3	74	26	5	71	0.0704225
NODE_300800_length_220_cov_42.206612	3	74	28	8	71	0.1126761
NODE_300800_length_220_cov_42.206612	3	74	31	2	71	0.0281690
NODE_300800_length_220_cov_42.206612	3	74	32	8	71	0.1126761
NODE_300800_length_220_cov_42.206612	3	74	34	21	71	0.2957746
NODE_300800_length_220_cov_42.206612	8	74	9	14	66	0.2121212
NODE_300800_length_220_cov_42.206612	8	74	13	1	66	0.0151515
NODE_300800_length_220_cov_42.206612	8	74	15	2	66	0.0303030
NODE_300800_length_220_cov_42.206612	8	74	16	1	66	0.0151515
NODE_300800_length_220_cov_42.206612	8	74	19	1	66	0.0151515
NODE_300800_length_220_cov_42.206612	8	74	23	3	66	0.0454545
NODE_300800_length_220_cov_42.206612	8	74	26	5	66	0.0757576
NODE_300800_length_220_cov_42.206612	8	74	28	8	66	0.1212121
NODE_300800_length_220_cov_42.206612	8	74	31	2	66	0.0303030
NODE_300800_length_220_cov_42.206612	8	74	32	8	66	0.1212121
NODE_300800_length_220_cov_42.206612	8	74	34	21	66	0.3181818
NODE_300800_length_220_cov_42.206612	47	98	32	6	51	0.1176471
NODE_300800_length_220_cov_42.206612	47	98	34	45	51	0.8823529
NODE_300800_length_220_cov_42.206612	47	98	32	6	51	0.1176471
NODE_300800_length_220_cov_42.206612	47	98	34	45	51	0.8823529
NODE_300800_length_220_cov_42.206612	47	98	32	6	51	0.1176471
NODE_300800_length_220_cov_42.206612	47	98	34	45	51	0.8823529
NODE_300874_length_218_cov_244.773109	128	203	2	15	75	0.2000000
NODE_300874_length_218_cov_244.773109	128	203	4	1	75	0.0133333
NODE_300874_length_218_cov_244.773109	128	203	6	4	75	0.0533333
NODE_300874_length_218_cov_244.773109	128	203	8	15	75	0.2000000
NODE_300874_length_218_cov_244.773109	128	203	10	3	75	0.0400000
NODE_300874_length_218_cov_244.773109	128	203	12	1	75	0.0133333
NODE_300874_length_218_cov_244.773109	128	203	14	4	75	0.0533333
NODE_300874_length_218_cov_244.773109	128	203	16	12	75	0.1600000
NODE_300874_length_218_cov_244.773109	128	203	18	1	75	0.0133333
NODE_300874_length_218_cov_244.773109	128	203	20	9	75	0.1200000
NODE_300874_length_218_cov_244.773109	128	203	24	10	75	0.1333333
NODE_300874_length_218_cov_244.773109	176	218	2	30	42	0.7142857
NODE_300874_length_218_cov_244.773109	176	218	4	1	42	0.0238095
NODE_300874_length_218_cov_244.773109	176	218	6	4	42	0.0952381
NODE_300874_length_218_cov_244.773109	176	218	8	7	42	0.1666667
NODE_300915_length_217_cov_2.144068	14	49	0	35	35	1.0000000
NODE_300915_length_217_cov_2.144068	132	167	0	35	35	1.0000000
NODE_300924_length_216_cov_215.410256	0	63	0	20	63	0.3174603
NODE_300924_length_216_cov_215.410256	0	63	2	1	63	0.0158730
NODE_300924_length_216_cov_215.410256	0	63	4	6	63	0.0952381
NODE_300924_length_216_cov_215.410256	0	63	6	8	63	0.1269841
NODE_300924_length_216_cov_215.410256	0	63	10	28	63	0.4444444
NODE_300924_length_216_cov_215.410256	36	102	10	41	66	0.6212121
NODE_300924_length_216_cov_215.410256	36	102	12	1	66	0.0151515
NODE_300924_length_216_cov_215.410256	36	102	14	24	66	0.3636364
NODE_300925_length_216_cov_51.940171	164	216	0	46	52	0.8846154
NODE_300925_length_216_cov_51.940171	164	216	2	6	52	0.1153846
NODE_300953_length_215_cov_14.784483	0	50	0	50	50	1.0000000
NODE_300953_length_215_cov_14.784483	23	103	0	80	80	1.0000000
NODE_300984_length_214_cov_144.165217	0	62	0	27	62	0.4354839
NODE_300984_length_214_cov_144.165217	0	62	2	16	62	0.2580645
NODE_300984_length_214_cov_144.165217	0	62	4	6	62	0.0967742
NODE_300984_length_214_cov_144.165217	0	62	6	1	62	0.0161290
NODE_300984_length_214_cov_144.165217	0	62	8	5	62	0.0806452
NODE_300984_length_214_cov_144.165217	0	62	10	7	62	0.1129032
NODE_300984_length_214_cov_144.165217	0	62	0	27	62	0.4354839
NODE_300984_length_214_cov_144.165217	0	62	2	16	62	0.2580645
NODE_300984_length_214_cov_144.165217	0	62	4	6	62	0.0967742
NODE_300984_length_214_cov_144.165217	0	62	6	1	62	0.0161290
NODE_300984_length_214_cov_144.165217	0	62	8	5	62	0.0806452
NODE_300984_length_214_cov_144.165217	0	62	10	7	62	0.1129032
NODE_300984_length_214_cov_144.165217	35	115	2	8	80	0.1000000
NODE_300984_length_214_cov_144.165217	35	115	4	6	80	0.0750000
NODE_300984_length_214_cov_144.165217	35	115	6	1	80	0.0125000
NODE_300984_length_214_cov_144.165217	35	115	8	5	80	0.0625000
NODE_300984_length_214_cov_144.165217	35	115	10	15	80	0.1875000
NODE_300984_length_214_cov_144.165217	35	115	12	45	80	0.5625000
NODE_300984_length_214_cov_144.165217	35	115	2	8	80	0.1000000
NODE_300984_length_214_cov_144.165217	35	115	4	6	80	0.0750000
NODE_300984_length_214_cov_144.165217	35	115	6	1	80	0.0125000
NODE_300984_length_214_cov_144.165217	35	115	8	5	80	0.0625000
NODE_300984_length_214_cov_144.165217	35	115	10	15	80	0.1875000
NODE_300984_length_214_cov_144.165217	35	115	12	45	80	0.5625000
NODE_300984_length_214_cov_144.165217	35	115	2	8	80	0.1000000
NODE_300984_length_214_cov_144.165217	35	115	4	6	80	0.0750000
NODE_300984_length_214_cov_144.165217	35	115	6	1	80	0.0125000
NODE_300984_length_214_cov_144.165217	35	115	8	5	80	0.0625000
NODE_300984_length_214_cov_144.165217	35	115	10	15	80	0.1875000
NODE_300984_length_214_cov_144.165217	35	115	12	45	80	0.5625000
NODE_300984_length_214_cov_144.165217	111	191	0	30	80	0.3750000
NODE_300984_length_214_cov_144.165217	111	191	2	2	80	0.0250000
NODE_300984_length_214_cov_144.165217	111	191	4	23	80	0.2875000
NODE_300984_length_214_cov_144.165217	111	191	6	6	80	0.0750000
NODE_300984_length_214_cov_144.165217	111	191	8	6	80	0.0750000
NODE_300984_length_214_cov_144.165217	111	191	12	13	80	0.1625000
NODE_300984_length_214_cov_144.165217	111	191	0	30	80	0.3750000
NODE_300984_length_214_cov_144.165217	111	191	2	2	80	0.0250000
NODE_300984_length_214_cov_144.165217	111	191	4	23	80	0.2875000
NODE_300984_length_214_cov_144.165217	111	191	6	6	80	0.0750000
NODE_300984_length_214_cov_144.165217	111	191	8	6	80	0.0750000
NODE_300984_length_214_cov_144.165217	111	191	12	13	80	0.1625000
NODE_300984_length_214_cov_144.165217	111	191	0	30	80	0.3750000
NODE_300984_length_214_cov_144.165217	111	191	2	2	80	0.0250000
NODE_300984_length_214_cov_144.165217	111	191	4	23	80	0.2875000
NODE_300984_length_214_cov_144.165217	111	191	6	6	80	0.0750000
NODE_300984_length_214_cov_144.165217	111	191	8	6	80	0.0750000
NODE_300984_length_214_cov_144.165217	111	191	12	13	80	0.1625000
NODE_300984_length_214_cov_144.165217	164	214	0	50	50	1.0000000
NODE_300984_length_214_cov_144.165217	164	214	0	50	50	1.0000000
NODE_300984_length_214_cov_144.165217	164	214	0	50	50	1.0000000
NODE_301068_length_211_cov_39.571429	4	84	0	17	80	0.2125000
NODE_301068_length_211_cov_39.571429	4	84	2	63	80	0.7875000
NODE_301169_length_208_cov_45.238532	3	59	0	56	56	1.0000000
NODE_301169_length_208_cov_45.238532	35	112	0	77	77	1.0000000
NODE_301170_length_208_cov_35.229358	76	156	0	2	80	0.0250000
NODE_301170_length_208_cov_35.229358	76	156	2	78	80	0.9750000
NODE_301179_length_207_cov_341.324074	33	113	0	80	80	1.0000000
NODE_301179_length_207_cov_341.324074	86	166	0	80	80	1.0000000
NODE_301248_length_205_cov_64.179245	6	77	0	8	71	0.1126761
NODE_301248_length_205_cov_64.179245	6	77	2	11	71	0.1549296
NODE_301248_length_205_cov_64.179245	6	77	3	7	71	0.0985916
NODE_301248_length_205_cov_64.179245	6	77	5	1	71	0.0140845
NODE_301248_length_205_cov_64.179245	6	77	6	6	71	0.0845070
NODE_301248_length_205_cov_64.179245	6	77	8	6	71	0.0845070
NODE_301248_length_205_cov_64.179245	6	77	10	5	71	0.0704225
NODE_301248_length_205_cov_64.179245	6	77	12	8	71	0.1126761
NODE_301248_length_205_cov_64.179245	6	77	15	2	71	0.0281690
NODE_301248_length_205_cov_64.179245	6	77	17	3	71	0.0422535
NODE_301248_length_205_cov_64.179245	6	77	18	8	71	0.1126761
NODE_301248_length_205_cov_64.179245	6	77	20	1	71	0.0140845
NODE_301248_length_205_cov_64.179245	6	77	22	4	71	0.0563380
NODE_301248_length_205_cov_64.179245	6	77	24	1	71	0.0140845
NODE_301248_length_205_cov_64.179245	11	77	0	3	66	0.0454545
NODE_301248_length_205_cov_64.179245	11	77	2	11	66	0.1666667
NODE_301248_length_205_cov_64.179245	11	77	3	7	66	0.1060606
NODE_301248_length_205_cov_64.179245	11	77	5	1	66	0.0151515
NODE_301248_length_205_cov_64.179245	11	77	6	6	66	0.0909091
NODE_301248_length_205_cov_64.179245	11	77	8	6	66	0.0909091
NODE_301248_length_205_cov_64.179245	11	77	10	5	66	0.0757576
NODE_301248_length_205_cov_64.179245	11	77	12	8	66	0.1212121
NODE_301248_length_205_cov_64.179245	11	77	15	2	66	0.0303030
NODE_301248_length_205_cov_64.179245	11	77	17	3	66	0.0454545
NODE_301248_length_205_cov_64.179245	11	77	18	8	66	0.1212121
NODE_301248_length_205_cov_64.179245	11	77	20	1	66	0.0151515
NODE_301248_length_205_cov_64.179245	11	77	22	4	66	0.0606061
NODE_301248_length_205_cov_64.179245	11	77	24	1	66	0.0151515
NODE_301248_length_205_cov_64.179245	50	98	12	8	48	0.1666667
NODE_301248_length_205_cov_64.179245	50	98	15	2	48	0.0416667
NODE_301248_length_205_cov_64.179245	50	98	17	3	48	0.0625000
NODE_301248_length_205_cov_64.179245	50	98	18	8	48	0.1666667
NODE_301248_length_205_cov_64.179245	50	98	20	1	48	0.0208333
NODE_301248_length_205_cov_64.179245	50	98	22	4	48	0.0833333
NODE_301248_length_205_cov_64.179245	50	98	24	20	48	0.4166667
NODE_301248_length_205_cov_64.179245	50	98	26	2	48	0.0416667
NODE_301248_length_205_cov_64.179245	50	98	12	8	48	0.1666667
NODE_301248_length_205_cov_64.179245	50	98	15	2	48	0.0416667
NODE_301248_length_205_cov_64.179245	50	98	17	3	48	0.0625000
NODE_301248_length_205_cov_64.179245	50	98	18	8	48	0.1666667
NODE_301248_length_205_cov_64.179245	50	98	20	1	48	0.0208333
NODE_301248_length_205_cov_64.179245	50	98	22	4	48	0.0833333
NODE_301248_length_205_cov_64.179245	50	98	24	20	48	0.4166667
NODE_301248_length_205_cov_64.179245	50	98	26	2	48	0.0416667
NODE_301248_length_205_cov_64.179245	50	98	12	8	48	0.1666667
NODE_301248_length_205_cov_64.179245	50	98	15	2	48	0.0416667
NODE_301248_length_205_cov_64.179245	50	98	17	3	48	0.0625000
NODE_301248_length_205_cov_64.179245	50	98	18	8	48	0.1666667
NODE_301248_length_205_cov_64.179245	50	98	20	1	48	0.0208333
NODE_301248_length_205_cov_64.179245	50	98	22	4	48	0.0833333
NODE_301248_length_205_cov_64.179245	50	98	24	20	48	0.4166667
NODE_301248_length_205_cov_64.179245	50	98	26	2	48	0.0416667
NODE_301281_length_204_cov_183.390476	119	199	4	39	80	0.4875000
NODE_301281_length_204_cov_183.390476	119	199	6	22	80	0.2750000
NODE_301281_length_204_cov_183.390476	119	199	8	6	80	0.0750000
NODE_301281_length_204_cov_183.390476	119	199	10	13	80	0.1625000
NODE_301281_length_204_cov_183.390476	172	194	4	22	22	1.0000000
NODE_301283_length_204_cov_80.095238	10	90	0	15	80	0.1875000
NODE_301283_length_204_cov_80.095238	10	90	6	41	80	0.5125000
NODE_301283_length_204_cov_80.095238	10	90	8	24	80	0.3000000
NODE_301283_length_204_cov_80.095238	63	143	6	3	80	0.0375000
NODE_301283_length_204_cov_80.095238	63	143	8	77	80	0.9625000
NODE_301345_length_202_cov_123.184466	0	64	6	1	64	0.0156250
NODE_301345_length_202_cov_123.184466	0	64	11	1	64	0.0156250
NODE_301345_length_202_cov_123.184466	0	64	13	2	64	0.0312500
NODE_301345_length_202_cov_123.184466	0	64	17	1	64	0.0156250
NODE_301345_length_202_cov_123.184466	0	64	20	7	64	0.1093750
NODE_301345_length_202_cov_123.184466	0	64	22	1	64	0.0156250
NODE_301345_length_202_cov_123.184466	0	64	24	1	64	0.0156250
NODE_301345_length_202_cov_123.184466	0	64	29	1	64	0.0156250
NODE_301345_length_202_cov_123.184466	0	64	31	1	64	0.0156250
NODE_301345_length_202_cov_123.184466	0	64	32	2	64	0.0312500
NODE_301345_length_202_cov_123.184466	0	64	35	3	64	0.0468750
NODE_301345_length_202_cov_123.184466	0	64	37	1	64	0.0156250
NODE_301345_length_202_cov_123.184466	0	64	38	3	64	0.0468750
NODE_301345_length_202_cov_123.184466	0	64	41	1	64	0.0156250
NODE_301345_length_202_cov_123.184466	0	64	43	4	64	0.0625000
NODE_301345_length_202_cov_123.184466	0	64	45	3	64	0.0468750
NODE_301345_length_202_cov_123.184466	0	64	49	2	64	0.0312500
NODE_301345_length_202_cov_123.184466	0	64	51	1	64	0.0156250
NODE_301345_length_202_cov_123.184466	0	64	52	1	64	0.0156250
NODE_301345_length_202_cov_123.184466	0	64	54	1	64	0.0156250
NODE_301345_length_202_cov_123.184466	0	64	58	2	64	0.0312500
NODE_301345_length_202_cov_123.184466	0	64	60	1	64	0.0156250
NODE_301345_length_202_cov_123.184466	0	64	62	3	64	0.0468750
NODE_301345_length_202_cov_123.184466	0	64	64	1	64	0.0156250
NODE_301345_length_202_cov_123.184466	0	64	68	1	64	0.0156250
NODE_301345_length_202_cov_123.184466	0	64	69	2	64	0.0312500
NODE_301345_length_202_cov_123.184466	0	64	71	1	64	0.0156250
NODE_301345_length_202_cov_123.184466	0	64	72	1	64	0.0156250
NODE_301345_length_202_cov_123.184466	0	64	79	1	64	0.0156250
NODE_301345_length_202_cov_123.184466	0	64	89	1	64	0.0156250
NODE_301345_length_202_cov_123.184466	0	64	91	4	64	0.0625000
NODE_301345_length_202_cov_123.184466	0	64	94	1	64	0.0156250
NODE_301345_length_202_cov_123.184466	0	64	96	2	64	0.0312500
NODE_301345_length_202_cov_123.184466	0	64	98	3	64	0.0468750
NODE_301345_length_202_cov_123.184466	0	64	100	2	64	0.0312500
NODE_301345_length_202_cov_123.184466	31	72	45	2	41	0.0487805
NODE_301345_length_202_cov_123.184466	31	72	49	2	41	0.0487805
NODE_301345_length_202_cov_123.184466	31	72	51	1	41	0.0243902
NODE_301345_length_202_cov_123.184466	31	72	52	1	41	0.0243902
NODE_301345_length_202_cov_123.184466	31	72	54	1	41	0.0243902
NODE_301345_length_202_cov_123.184466	31	72	58	2	41	0.0487805
NODE_301345_length_202_cov_123.184466	31	72	60	1	41	0.0243902
NODE_301345_length_202_cov_123.184466	31	72	62	3	41	0.0731707
NODE_301345_length_202_cov_123.184466	31	72	64	1	41	0.0243902
NODE_301345_length_202_cov_123.184466	31	72	68	1	41	0.0243902
NODE_301345_length_202_cov_123.184466	31	72	69	2	41	0.0487805
NODE_301345_length_202_cov_123.184466	31	72	71	1	41	0.0243902
NODE_301345_length_202_cov_123.184466	31	72	72	1	41	0.0243902
NODE_301345_length_202_cov_123.184466	31	72	79	1	41	0.0243902
NODE_301345_length_202_cov_123.184466	31	72	89	1	41	0.0243902
NODE_301345_length_202_cov_123.184466	31	72	91	4	41	0.0975610
NODE_301345_length_202_cov_123.184466	31	72	94	1	41	0.0243902
NODE_301345_length_202_cov_123.184466	31	72	96	2	41	0.0487805
NODE_301345_length_202_cov_123.184466	31	72	98	3	41	0.0731707
NODE_301345_length_202_cov_123.184466	31	72	100	2	41	0.0487805
NODE_301345_length_202_cov_123.184466	31	72	102	1	41	0.0243902
NODE_301345_length_202_cov_123.184466	31	72	110	1	41	0.0243902
NODE_301345_length_202_cov_123.184466	31	72	114	1	41	0.0243902
NODE_301345_length_202_cov_123.184466	31	72	124	1	41	0.0243902
NODE_301345_length_202_cov_123.184466	31	72	126	2	41	0.0487805
NODE_301345_length_202_cov_123.184466	31	72	130	2	41	0.0487805
NODE_301370_length_201_cov_56.323529	133	201	0	22	68	0.3235294
NODE_301370_length_201_cov_56.323529	133	201	2	1	68	0.0147059
NODE_301370_length_201_cov_56.323529	133	201	4	41	68	0.6029412
NODE_301370_length_201_cov_56.323529	133	201	6	4	68	0.0588235
NODE_301371_length_201_cov_50.647059	44	99	24	1	55	0.0181818
NODE_301371_length_201_cov_50.647059	44	99	26	1	55	0.0181818
NODE_301371_length_201_cov_50.647059	44	99	28	4	55	0.0727273
NODE_301371_length_201_cov_50.647059	44	99	30	6	55	0.1090909
NODE_301371_length_201_cov_50.647059	44	99	36	2	55	0.0363636
NODE_301371_length_201_cov_50.647059	44	99	38	1	55	0.0181818
NODE_301371_length_201_cov_50.647059	44	99	40	1	55	0.0181818
NODE_301371_length_201_cov_50.647059	44	99	42	1	55	0.0181818
NODE_301371_length_201_cov_50.647059	44	99	46	1	55	0.0181818
NODE_301371_length_201_cov_50.647059	44	99	48	6	55	0.1090909
NODE_301371_length_201_cov_50.647059	44	99	52	1	55	0.0181818
NODE_301371_length_201_cov_50.647059	44	99	54	6	55	0.1090909
NODE_301371_length_201_cov_50.647059	44	99	56	6	55	0.1090909
NODE_301371_length_201_cov_50.647059	44	99	60	4	55	0.0727273
NODE_301371_length_201_cov_50.647059	44	99	62	4	55	0.0727273
NODE_301371_length_201_cov_50.647059	44	99	64	6	55	0.1090909
NODE_301371_length_201_cov_50.647059	44	99	66	4	55	0.0727273
NODE_301371_length_201_cov_50.647059	136	201	12	2	65	0.0307692
NODE_301371_length_201_cov_50.647059	136	201	16	4	65	0.0615385
NODE_301371_length_201_cov_50.647059	136	201	18	1	65	0.0153846
NODE_301371_length_201_cov_50.647059	136	201	22	4	65	0.0615385
NODE_301371_length_201_cov_50.647059	136	201	24	1	65	0.0153846
NODE_301371_length_201_cov_50.647059	136	201	28	1	65	0.0153846
NODE_301371_length_201_cov_50.647059	136	201	29	3	65	0.0461538
NODE_301371_length_201_cov_50.647059	136	201	31	11	65	0.1692308
NODE_301371_length_201_cov_50.647059	136	201	32	2	65	0.0307692
NODE_301371_length_201_cov_50.647059	136	201	33	2	65	0.0307692
NODE_301371_length_201_cov_50.647059	136	201	37	1	65	0.0153846
NODE_301371_length_201_cov_50.647059	136	201	39	9	65	0.1384615
NODE_301371_length_201_cov_50.647059	136	201	40	4	65	0.0615385
NODE_301371_length_201_cov_50.647059	136	201	41	3	65	0.0461538
NODE_301371_length_201_cov_50.647059	136	201	42	1	65	0.0153846
NODE_301371_length_201_cov_50.647059	136	201	44	10	65	0.1538462
NODE_301371_length_201_cov_50.647059	136	201	46	4	65	0.0615385
NODE_301371_length_201_cov_50.647059	136	201	48	2	65	0.0307692
NODE_301371_length_201_cov_50.647059	136	201	12	2	65	0.0307692
NODE_301371_length_201_cov_50.647059	136	201	16	4	65	0.0615385
NODE_301371_length_201_cov_50.647059	136	201	18	1	65	0.0153846
NODE_301371_length_201_cov_50.647059	136	201	22	4	65	0.0615385
NODE_301371_length_201_cov_50.647059	136	201	24	1	65	0.0153846
NODE_301371_length_201_cov_50.647059	136	201	28	1	65	0.0153846
NODE_301371_length_201_cov_50.647059	136	201	29	3	65	0.0461538
NODE_301371_length_201_cov_50.647059	136	201	31	11	65	0.1692308
NODE_301371_length_201_cov_50.647059	136	201	32	2	65	0.0307692
NODE_301371_length_201_cov_50.647059	136	201	33	2	65	0.0307692
NODE_301371_length_201_cov_50.647059	136	201	37	1	65	0.0153846
NODE_301371_length_201_cov_50.647059	136	201	39	9	65	0.1384615
NODE_301371_length_201_cov_50.647059	136	201	40	4	65	0.0615385
NODE_301371_length_201_cov_50.647059	136	201	41	3	65	0.0461538
NODE_301371_length_201_cov_50.647059	136	201	42	1	65	0.0153846
NODE_301371_length_201_cov_50.647059	136	201	44	10	65	0.1538462
NODE_301371_length_201_cov_50.647059	136	201	46	4	65	0.0615385
NODE_301371_length_201_cov_50.647059	136	201	48	2	65	0.0307692
NODE_301371_length_201_cov_50.647059	136	201	12	2	65	0.0307692
NODE_301371_length_201_cov_50.647059	136	201	16	4	65	0.0615385
NODE_301371_length_201_cov_50.647059	136	201	18	1	65	0.0153846
NODE_301371_length_201_cov_50.647059	136	201	22	4	65	0.0615385
NODE_301371_length_201_cov_50.647059	136	201	24	1	65	0.0153846
NODE_301371_length_201_cov_50.647059	136	201	28	1	65	0.0153846
NODE_301371_length_201_cov_50.647059	136	201	29	3	65	0.0461538
NODE_301371_length_201_cov_50.647059	136	201	31	11	65	0.1692308
NODE_301371_length_201_cov_50.647059	136	201	32	2	65	0.0307692
NODE_301371_length_201_cov_50.647059	136	201	33	2	65	0.0307692
NODE_301371_length_201_cov_50.647059	136	201	37	1	65	0.0153846
NODE_301371_length_201_cov_50.647059	136	201	39	9	65	0.1384615
NODE_301371_length_201_cov_50.647059	136	201	40	4	65	0.0615385
NODE_301371_length_201_cov_50.647059	136	201	41	3	65	0.0461538
NODE_301371_length_201_cov_50.647059	136	201	42	1	65	0.0153846
NODE_301371_length_201_cov_50.647059	136	201	44	10	65	0.1538462
NODE_301371_length_201_cov_50.647059	136	201	46	4	65	0.0615385
NODE_301371_length_201_cov_50.647059	136	201	48	2	65	0.0307692
NODE_301371_length_201_cov_50.647059	136	201	12	2	65	0.0307692
NODE_301371_length_201_cov_50.647059	136	201	16	4	65	0.0615385
NODE_301371_length_201_cov_50.647059	136	201	18	1	65	0.0153846
NODE_301371_length_201_cov_50.647059	136	201	22	4	65	0.0615385
NODE_301371_length_201_cov_50.647059	136	201	24	1	65	0.0153846
NODE_301371_length_201_cov_50.647059	136	201	28	1	65	0.0153846
NODE_301371_length_201_cov_50.647059	136	201	29	3	65	0.0461538
NODE_301371_length_201_cov_50.647059	136	201	31	11	65	0.1692308
NODE_301371_length_201_cov_50.647059	136	201	32	2	65	0.0307692
NODE_301371_length_201_cov_50.647059	136	201	33	2	65	0.0307692
NODE_301371_length_201_cov_50.647059	136	201	37	1	65	0.0153846
NODE_301371_length_201_cov_50.647059	136	201	39	9	65	0.1384615
NODE_301371_length_201_cov_50.647059	136	201	40	4	65	0.0615385
NODE_301371_length_201_cov_50.647059	136	201	41	3	65	0.0461538
NODE_301371_length_201_cov_50.647059	136	201	42	1	65	0.0153846
NODE_301371_length_201_cov_50.647059	136	201	44	10	65	0.1538462
NODE_301371_length_201_cov_50.647059	136	201	46	4	65	0.0615385
NODE_301371_length_201_cov_50.647059	136	201	48	2	65	0.0307692
NODE_301405_length_200_cov_29.118812	0	73	0	1	73	0.0136986
NODE_301405_length_200_cov_29.118812	0	73	2	2	73	0.0273973
NODE_301405_length_200_cov_29.118812	0	73	4	4	73	0.0547945
NODE_301405_length_200_cov_29.118812	0	73	8	2	73	0.0273973
NODE_301405_length_200_cov_29.118812	0	73	12	3	73	0.0410959
NODE_301405_length_200_cov_29.118812	0	73	16	2	73	0.0273973
NODE_301405_length_200_cov_29.118812	0	73	20	8	73	0.1095890
NODE_301405_length_200_cov_29.118812	0	73	22	10	73	0.1369863
NODE_301405_length_200_cov_29.118812	0	73	24	16	73	0.2191781
NODE_301405_length_200_cov_29.118812	0	73	26	22	73	0.3013699
NODE_301405_length_200_cov_29.118812	0	73	28	3	73	0.0410959
NODE_301419_length_199_cov_768.700000	94	142	219	1	48	0.0208333
NODE_301419_length_199_cov_768.700000	94	142	220	1	48	0.0208333
NODE_301419_length_199_cov_768.700000	94	142	223	6	48	0.1250000
NODE_301419_length_199_cov_768.700000	94	142	225	5	48	0.1041667
NODE_301419_length_199_cov_768.700000	94	142	226	3	48	0.0625000
NODE_301419_length_199_cov_768.700000	94	142	228	2	48	0.0416667
NODE_301419_length_199_cov_768.700000	94	142	232	1	48	0.0208333
NODE_301419_length_199_cov_768.700000	94	142	233	1	48	0.0208333
NODE_301419_length_199_cov_768.700000	94	142	234	1	48	0.0208333
NODE_301419_length_199_cov_768.700000	94	142	236	12	48	0.2500000
NODE_301419_length_199_cov_768.700000	94	142	238	15	48	0.3125000
NODE_301419_length_199_cov_768.700000	115	186	35	1	71	0.0140845
NODE_301419_length_199_cov_768.700000	115	186	41	1	71	0.0140845
NODE_301419_length_199_cov_768.700000	115	186	53	1	71	0.0140845
NODE_301419_length_199_cov_768.700000	115	186	59	1	71	0.0140845
NODE_301419_length_199_cov_768.700000	115	186	61	1	71	0.0140845
NODE_301419_length_199_cov_768.700000	115	186	65	1	71	0.0140845
NODE_301419_length_199_cov_768.700000	115	186	67	1	71	0.0140845
NODE_301419_length_199_cov_768.700000	115	186	74	1	71	0.0140845
NODE_301419_length_199_cov_768.700000	115	186	84	1	71	0.0140845
NODE_301419_length_199_cov_768.700000	115	186	88	2	71	0.0281690
NODE_301419_length_199_cov_768.700000	115	186	90	1	71	0.0140845
NODE_301419_length_199_cov_768.700000	115	186	100	2	71	0.0281690
NODE_301419_length_199_cov_768.700000	115	186	101	4	71	0.0563380
NODE_301419_length_199_cov_768.700000	115	186	105	1	71	0.0140845
NODE_301419_length_199_cov_768.700000	115	186	110	1	71	0.0140845
NODE_301419_length_199_cov_768.700000	115	186	112	1	71	0.0140845
NODE_301419_length_199_cov_768.700000	115	186	118	1	71	0.0140845
NODE_301419_length_199_cov_768.700000	115	186	122	1	71	0.0140845
NODE_301419_length_199_cov_768.700000	115	186	126	2	71	0.0281690
NODE_301419_length_199_cov_768.700000	115	186	132	2	71	0.0281690
NODE_301419_length_199_cov_768.700000	115	186	134	1	71	0.0140845
NODE_301419_length_199_cov_768.700000	115	186	139	1	71	0.0140845
NODE_301419_length_199_cov_768.700000	115	186	147	1	71	0.0140845
NODE_301419_length_199_cov_768.700000	115	186	149	1	71	0.0140845
NODE_301419_length_199_cov_768.700000	115	186	157	1	71	0.0140845
NODE_301419_length_199_cov_768.700000	115	186	159	1	71	0.0140845
NODE_301419_length_199_cov_768.700000	115	186	161	1	71	0.0140845
NODE_301419_length_199_cov_768.700000	115	186	167	1	71	0.0140845
NODE_301419_length_199_cov_768.700000	115	186	172	1	71	0.0140845
NODE_301419_length_199_cov_768.700000	115	186	179	1	71	0.0140845
NODE_301419_length_199_cov_768.700000	115	186	185	1	71	0.0140845
NODE_301419_length_199_cov_768.700000	115	186	191	1	71	0.0140845
NODE_301419_length_199_cov_768.700000	115	186	201	1	71	0.0140845
NODE_301419_length_199_cov_768.700000	115	186	203	1	71	0.0140845
NODE_301419_length_199_cov_768.700000	115	186	215	1	71	0.0140845
NODE_301419_length_199_cov_768.700000	115	186	217	2	71	0.0281690
NODE_301419_length_199_cov_768.700000	115	186	219	1	71	0.0140845
NODE_301419_length_199_cov_768.700000	115	186	220	1	71	0.0140845
NODE_301419_length_199_cov_768.700000	115	186	223	6	71	0.0845070
NODE_301419_length_199_cov_768.700000	115	186	225	5	71	0.0704225
NODE_301419_length_199_cov_768.700000	115	186	226	3	71	0.0422535
NODE_301419_length_199_cov_768.700000	115	186	228	2	71	0.0281690
NODE_301419_length_199_cov_768.700000	115	186	233	1	71	0.0140845
NODE_301419_length_199_cov_768.700000	115	186	234	1	71	0.0140845
NODE_301419_length_199_cov_768.700000	115	186	236	7	71	0.0985916
NODE_301420_length_199_cov_702.860000	3	78	19	1	75	0.0133333
NODE_301420_length_199_cov_702.860000	3	78	23	1	75	0.0133333
NODE_301420_length_199_cov_702.860000	3	78	30	1	75	0.0133333
NODE_301420_length_199_cov_702.860000	3	78	31	1	75	0.0133333
NODE_301420_length_199_cov_702.860000	3	78	33	2	75	0.0266667
NODE_301420_length_199_cov_702.860000	3	78	36	2	75	0.0266667
NODE_301420_length_199_cov_702.860000	3	78	42	1	75	0.0133333
NODE_301420_length_199_cov_702.860000	3	78	44	1	75	0.0133333
NODE_301420_length_199_cov_702.860000	3	78	50	1	75	0.0133333
NODE_301420_length_199_cov_702.860000	3	78	52	1	75	0.0133333
NODE_301420_length_199_cov_702.860000	3	78	58	1	75	0.0133333
NODE_301420_length_199_cov_702.860000	3	78	60	1	75	0.0133333
NODE_301420_length_199_cov_702.860000	3	78	73	1	75	0.0133333
NODE_301420_length_199_cov_702.860000	3	78	77	1	75	0.0133333
NODE_301420_length_199_cov_702.860000	3	78	79	2	75	0.0266667
NODE_301420_length_199_cov_702.860000	3	78	85	1	75	0.0133333
NODE_301420_length_199_cov_702.860000	3	78	92	1	75	0.0133333
NODE_301420_length_199_cov_702.860000	3	78	94	1	75	0.0133333
NODE_301420_length_199_cov_702.860000	3	78	96	1	75	0.0133333
NODE_301420_length_199_cov_702.860000	3	78	102	1	75	0.0133333
NODE_301420_length_199_cov_702.860000	3	78	112	1	75	0.0133333
NODE_301420_length_199_cov_702.860000	3	78	120	1	75	0.0133333
NODE_301420_length_199_cov_702.860000	3	78	128	1	75	0.0133333
NODE_301420_length_199_cov_702.860000	3	78	132	1	75	0.0133333
NODE_301420_length_199_cov_702.860000	3	78	140	1	75	0.0133333
NODE_301420_length_199_cov_702.860000	3	78	150	1	75	0.0133333
NODE_301420_length_199_cov_702.860000	3	78	152	1	75	0.0133333
NODE_301420_length_199_cov_702.860000	3	78	156	1	75	0.0133333
NODE_301420_length_199_cov_702.860000	3	78	160	2	75	0.0266667
NODE_301420_length_199_cov_702.860000	3	78	168	1	75	0.0133333
NODE_301420_length_199_cov_702.860000	3	78	176	1	75	0.0133333
NODE_301420_length_199_cov_702.860000	3	78	186	1	75	0.0133333
NODE_301420_length_199_cov_702.860000	3	78	188	1	75	0.0133333
NODE_301420_length_199_cov_702.860000	3	78	192	1	75	0.0133333
NODE_301420_length_199_cov_702.860000	3	78	196	1	75	0.0133333
NODE_301420_length_199_cov_702.860000	3	78	204	1	75	0.0133333
NODE_301420_length_199_cov_702.860000	3	78	208	1	75	0.0133333
NODE_301420_length_199_cov_702.860000	3	78	210	1	75	0.0133333
NODE_301420_length_199_cov_702.860000	3	78	212	1	75	0.0133333
NODE_301420_length_199_cov_702.860000	3	78	218	1	75	0.0133333
NODE_301420_length_199_cov_702.860000	3	78	226	2	75	0.0266667
NODE_301420_length_199_cov_702.860000	3	78	248	3	75	0.0400000
NODE_301420_length_199_cov_702.860000	3	78	258	1	75	0.0133333
NODE_301420_length_199_cov_702.860000	3	78	262	1	75	0.0133333
NODE_301420_length_199_cov_702.860000	3	78	276	1	75	0.0133333
NODE_301420_length_199_cov_702.860000	3	78	292	2	75	0.0266667
NODE_301420_length_199_cov_702.860000	3	78	296	1	75	0.0133333
NODE_301420_length_199_cov_702.860000	3	78	304	2	75	0.0266667
NODE_301420_length_199_cov_702.860000	3	78	306	2	75	0.0266667
NODE_301420_length_199_cov_702.860000	3	78	314	3	75	0.0400000
NODE_301420_length_199_cov_702.860000	3	78	316	1	75	0.0133333
NODE_301420_length_199_cov_702.860000	3	78	322	1	75	0.0133333
NODE_301420_length_199_cov_702.860000	3	78	324	1	75	0.0133333
NODE_301420_length_199_cov_702.860000	3	78	326	2	75	0.0266667
NODE_301420_length_199_cov_702.860000	3	78	334	2	75	0.0266667
NODE_301420_length_199_cov_702.860000	3	78	336	1	75	0.0133333
NODE_301420_length_199_cov_702.860000	3	78	338	1	75	0.0133333
NODE_301420_length_199_cov_702.860000	3	78	340	2	75	0.0266667
NODE_301420_length_199_cov_702.860000	3	78	344	2	75	0.0266667
NODE_301420_length_199_cov_702.860000	51	131	209	1	80	0.0125000
NODE_301420_length_199_cov_702.860000	51	131	215	1	80	0.0125000
NODE_301420_length_199_cov_702.860000	51	131	233	2	80	0.0250000
NODE_301420_length_199_cov_702.860000	51	131	240	2	80	0.0250000
NODE_301420_length_199_cov_702.860000	51	131	243	1	80	0.0125000
NODE_301420_length_199_cov_702.860000	51	131	248	1	80	0.0125000
NODE_301420_length_199_cov_702.860000	51	131	253	1	80	0.0125000
NODE_301420_length_199_cov_702.860000	51	131	257	1	80	0.0125000
NODE_301420_length_199_cov_702.860000	51	131	258	1	80	0.0125000
NODE_301420_length_199_cov_702.860000	51	131	262	1	80	0.0125000
NODE_301420_length_199_cov_702.860000	51	131	263	1	80	0.0125000
NODE_301420_length_199_cov_702.860000	51	131	267	1	80	0.0125000
NODE_301420_length_199_cov_702.860000	51	131	276	1	80	0.0125000
NODE_301420_length_199_cov_702.860000	51	131	281	1	80	0.0125000
NODE_301420_length_199_cov_702.860000	51	131	292	2	80	0.0250000
NODE_301420_length_199_cov_702.860000	51	131	296	1	80	0.0125000
NODE_301420_length_199_cov_702.860000	51	131	298	1	80	0.0125000
NODE_301420_length_199_cov_702.860000	51	131	304	2	80	0.0250000
NODE_301420_length_199_cov_702.860000	51	131	306	3	80	0.0375000
NODE_301420_length_199_cov_702.860000	51	131	314	4	80	0.0500000
NODE_301420_length_199_cov_702.860000	51	131	316	2	80	0.0250000
NODE_301420_length_199_cov_702.860000	51	131	322	3	80	0.0375000
NODE_301420_length_199_cov_702.860000	51	131	324	1	80	0.0125000
NODE_301420_length_199_cov_702.860000	51	131	326	2	80	0.0250000
NODE_301420_length_199_cov_702.860000	51	131	328	1	80	0.0125000
NODE_301420_length_199_cov_702.860000	51	131	334	2	80	0.0250000
NODE_301420_length_199_cov_702.860000	51	131	336	1	80	0.0125000
NODE_301420_length_199_cov_702.860000	51	131	338	1	80	0.0125000
NODE_301420_length_199_cov_702.860000	51	131	340	2	80	0.0250000
NODE_301420_length_199_cov_702.860000	51	131	343	1	80	0.0125000
NODE_301420_length_199_cov_702.860000	51	131	344	3	80	0.0375000
NODE_301420_length_199_cov_702.860000	51	131	346	3	80	0.0375000
NODE_301420_length_199_cov_702.860000	51	131	348	1	80	0.0125000
NODE_301420_length_199_cov_702.860000	51	131	349	1	80	0.0125000
NODE_301420_length_199_cov_702.860000	51	131	351	2	80	0.0250000
NODE_301420_length_199_cov_702.860000	51	131	352	1	80	0.0125000
NODE_301420_length_199_cov_702.860000	51	131	353	1	80	0.0125000
NODE_301420_length_199_cov_702.860000	51	131	354	2	80	0.0250000
NODE_301420_length_199_cov_702.860000	51	131	357	1	80	0.0125000
NODE_301420_length_199_cov_702.860000	51	131	360	2	80	0.0250000
NODE_301420_length_199_cov_702.860000	51	131	361	1	80	0.0125000
NODE_301420_length_199_cov_702.860000	51	131	362	1	80	0.0125000
NODE_301420_length_199_cov_702.860000	51	131	363	2	80	0.0250000
NODE_301420_length_199_cov_702.860000	51	131	364	2	80	0.0250000
NODE_301420_length_199_cov_702.860000	51	131	366	2	80	0.0250000
NODE_301420_length_199_cov_702.860000	51	131	367	3	80	0.0375000
NODE_301420_length_199_cov_702.860000	51	131	368	7	80	0.0875000
NODE_301421_length_199_cov_670.570000	22	52	54	1	30	0.0333333
NODE_301421_length_199_cov_670.570000	22	52	56	1	30	0.0333333
NODE_301421_length_199_cov_670.570000	22	52	60	1	30	0.0333333
NODE_301421_length_199_cov_670.570000	22	52	64	1	30	0.0333333
NODE_301421_length_199_cov_670.570000	22	52	66	7	30	0.2333333
NODE_301421_length_199_cov_670.570000	22	52	68	1	30	0.0333333
NODE_301421_length_199_cov_670.570000	22	52	69	1	30	0.0333333
NODE_301421_length_199_cov_670.570000	22	52	72	2	30	0.0666667
NODE_301421_length_199_cov_670.570000	22	52	79	2	30	0.0666667
NODE_301421_length_199_cov_670.570000	22	52	81	7	30	0.2333333
NODE_301421_length_199_cov_670.570000	22	52	83	1	30	0.0333333
NODE_301421_length_199_cov_670.570000	22	52	87	1	30	0.0333333
NODE_301421_length_199_cov_670.570000	22	52	89	1	30	0.0333333
NODE_301421_length_199_cov_670.570000	22	52	93	1	30	0.0333333
NODE_301421_length_199_cov_670.570000	22	52	99	2	30	0.0666667
NODE_301421_length_199_cov_670.570000	25	105	64	1	80	0.0125000
NODE_301421_length_199_cov_670.570000	25	105	66	7	80	0.0875000
NODE_301421_length_199_cov_670.570000	25	105	68	1	80	0.0125000
NODE_301421_length_199_cov_670.570000	25	105	69	1	80	0.0125000
NODE_301421_length_199_cov_670.570000	25	105	72	2	80	0.0250000
NODE_301421_length_199_cov_670.570000	25	105	79	2	80	0.0250000
NODE_301421_length_199_cov_670.570000	25	105	81	7	80	0.0875000
NODE_301421_length_199_cov_670.570000	25	105	83	1	80	0.0125000
NODE_301421_length_199_cov_670.570000	25	105	87	1	80	0.0125000
NODE_301421_length_199_cov_670.570000	25	105	89	1	80	0.0125000
NODE_301421_length_199_cov_670.570000	25	105	93	1	80	0.0125000
NODE_301421_length_199_cov_670.570000	25	105	99	2	80	0.0250000
NODE_301421_length_199_cov_670.570000	25	105	105	3	80	0.0375000
NODE_301421_length_199_cov_670.570000	25	105	108	1	80	0.0125000
NODE_301421_length_199_cov_670.570000	25	105	110	1	80	0.0125000
NODE_301421_length_199_cov_670.570000	25	105	111	1	80	0.0125000
NODE_301421_length_199_cov_670.570000	25	105	112	1	80	0.0125000
NODE_301421_length_199_cov_670.570000	25	105	115	3	80	0.0375000
NODE_301421_length_199_cov_670.570000	25	105	117	3	80	0.0375000
NODE_301421_length_199_cov_670.570000	25	105	119	1	80	0.0125000
NODE_301421_length_199_cov_670.570000	25	105	121	1	80	0.0125000
NODE_301421_length_199_cov_670.570000	25	105	125	3	80	0.0375000
NODE_301421_length_199_cov_670.570000	25	105	129	1	80	0.0125000
NODE_301421_length_199_cov_670.570000	25	105	135	3	80	0.0375000
NODE_301421_length_199_cov_670.570000	25	105	137	2	80	0.0250000
NODE_301421_length_199_cov_670.570000	25	105	139	2	80	0.0250000
NODE_301421_length_199_cov_670.570000	25	105	141	1	80	0.0125000
NODE_301421_length_199_cov_670.570000	25	105	143	3	80	0.0375000
NODE_301421_length_199_cov_670.570000	25	105	145	5	80	0.0625000
NODE_301421_length_199_cov_670.570000	25	105	151	4	80	0.0500000
NODE_301421_length_199_cov_670.570000	25	105	153	1	80	0.0125000
NODE_301421_length_199_cov_670.570000	25	105	155	2	80	0.0250000
NODE_301421_length_199_cov_670.570000	25	105	157	4	80	0.0500000
NODE_301421_length_199_cov_670.570000	25	105	159	7	80	0.0875000
NODE_301430_length_199_cov_215.860000	3	75	0	1	72	0.0138889
NODE_301430_length_199_cov_215.860000	3	75	2	10	72	0.1388889
NODE_301430_length_199_cov_215.860000	3	75	6	3	72	0.0416667
NODE_301430_length_199_cov_215.860000	3	75	8	1	72	0.0138889
NODE_301430_length_199_cov_215.860000	3	75	10	1	72	0.0138889
NODE_301430_length_199_cov_215.860000	3	75	12	1	72	0.0138889
NODE_301430_length_199_cov_215.860000	3	75	14	4	72	0.0555556
NODE_301430_length_199_cov_215.860000	3	75	19	1	72	0.0138889
NODE_301430_length_199_cov_215.860000	3	75	20	6	72	0.0833333
NODE_301430_length_199_cov_215.860000	3	75	24	1	72	0.0138889
NODE_301430_length_199_cov_215.860000	3	75	26	1	72	0.0138889
NODE_301430_length_199_cov_215.860000	3	75	28	1	72	0.0138889
NODE_301430_length_199_cov_215.860000	3	75	32	1	72	0.0138889
NODE_301430_length_199_cov_215.860000	3	75	34	8	72	0.1111111
NODE_301430_length_199_cov_215.860000	3	75	36	1	72	0.0138889
NODE_301430_length_199_cov_215.860000	3	75	40	2	72	0.0277778
NODE_301430_length_199_cov_215.860000	3	75	42	1	72	0.0138889
NODE_301430_length_199_cov_215.860000	3	75	44	1	72	0.0138889
NODE_301430_length_199_cov_215.860000	3	75	46	6	72	0.0833333
NODE_301430_length_199_cov_215.860000	3	75	48	5	72	0.0694444
NODE_301430_length_199_cov_215.860000	3	75	52	3	72	0.0416667
NODE_301430_length_199_cov_215.860000	3	75	54	5	72	0.0694444
NODE_301430_length_199_cov_215.860000	3	75	57	1	72	0.0138889
NODE_301430_length_199_cov_215.860000	3	75	58	7	72	0.0972222
NODE_301430_length_199_cov_215.860000	48	128	30	1	80	0.0125000
NODE_301430_length_199_cov_215.860000	48	128	32	2	80	0.0250000
NODE_301430_length_199_cov_215.860000	48	128	34	1	80	0.0125000
NODE_301430_length_199_cov_215.860000	48	128	36	2	80	0.0250000
NODE_301430_length_199_cov_215.860000	48	128	38	1	80	0.0125000
NODE_301430_length_199_cov_215.860000	48	128	40	1	80	0.0125000
NODE_301430_length_199_cov_215.860000	48	128	42	1	80	0.0125000
NODE_301430_length_199_cov_215.860000	48	128	46	8	80	0.1000000
NODE_301430_length_199_cov_215.860000	48	128	48	5	80	0.0625000
NODE_301430_length_199_cov_215.860000	48	128	50	1	80	0.0125000
NODE_301430_length_199_cov_215.860000	48	128	52	4	80	0.0500000
NODE_301430_length_199_cov_215.860000	48	128	54	5	80	0.0625000
NODE_301430_length_199_cov_215.860000	48	128	56	11	80	0.1375000
NODE_301430_length_199_cov_215.860000	48	128	57	1	80	0.0125000
NODE_301430_length_199_cov_215.860000	48	128	58	30	80	0.3750000
NODE_301430_length_199_cov_215.860000	48	128	60	6	80	0.0750000
NODE_301432_length_199_cov_206.800000	120	199	0	79	79	1.0000000
NODE_301441_length_199_cov_131.120000	97	177	2	80	80	1.0000000
NODE_301448_length_199_cov_97.490000	4	77	0	12	73	0.1643836
NODE_301448_length_199_cov_97.490000	4	77	2	3	73	0.0410959
NODE_301448_length_199_cov_97.490000	4	77	4	6	73	0.0821918
NODE_301448_length_199_cov_97.490000	4	77	8	1	73	0.0136986
NODE_301448_length_199_cov_97.490000	4	77	10	1	73	0.0136986
NODE_301448_length_199_cov_97.490000	4	77	13	1	73	0.0136986
NODE_301448_length_199_cov_97.490000	4	77	15	2	73	0.0273973
NODE_301448_length_199_cov_97.490000	4	77	17	1	73	0.0136986
NODE_301448_length_199_cov_97.490000	4	77	19	1	73	0.0136986
NODE_301448_length_199_cov_97.490000	4	77	23	3	73	0.0410959
NODE_301448_length_199_cov_97.490000	4	77	25	1	73	0.0136986
NODE_301448_length_199_cov_97.490000	4	77	29	2	73	0.0273973
NODE_301448_length_199_cov_97.490000	4	77	33	2	73	0.0273973
NODE_301448_length_199_cov_97.490000	4	77	34	3	73	0.0410959
NODE_301448_length_199_cov_97.490000	4	77	36	2	73	0.0273973
NODE_301448_length_199_cov_97.490000	4	77	38	1	73	0.0136986
NODE_301448_length_199_cov_97.490000	4	77	40	3	73	0.0410959
NODE_301448_length_199_cov_97.490000	4	77	43	2	73	0.0273973
NODE_301448_length_199_cov_97.490000	4	77	45	1	73	0.0136986
NODE_301448_length_199_cov_97.490000	4	77	47	1	73	0.0136986
NODE_301448_length_199_cov_97.490000	4	77	49	1	73	0.0136986
NODE_301448_length_199_cov_97.490000	4	77	52	4	73	0.0547945
NODE_301448_length_199_cov_97.490000	4	77	54	3	73	0.0410959
NODE_301448_length_199_cov_97.490000	4	77	62	3	73	0.0410959
NODE_301448_length_199_cov_97.490000	4	77	64	11	73	0.1506849
NODE_301448_length_199_cov_97.490000	4	77	68	2	73	0.0273973
NODE_301449_length_199_cov_96.090000	91	171	2	29	80	0.3625000
NODE_301449_length_199_cov_96.090000	91	171	4	2	80	0.0250000
NODE_301449_length_199_cov_96.090000	91	171	6	5	80	0.0625000
NODE_301449_length_199_cov_96.090000	91	171	8	4	80	0.0500000
NODE_301449_length_199_cov_96.090000	91	171	10	5	80	0.0625000
NODE_301449_length_199_cov_96.090000	91	171	12	7	80	0.0875000
NODE_301449_length_199_cov_96.090000	91	171	14	3	80	0.0375000
NODE_301449_length_199_cov_96.090000	91	171	16	7	80	0.0875000
NODE_301449_length_199_cov_96.090000	91	171	18	18	80	0.2250000
NODE_301455_length_199_cov_84.060000	44	75	4	3	31	0.0967742
NODE_301455_length_199_cov_84.060000	44	75	6	1	31	0.0322581
NODE_301455_length_199_cov_84.060000	44	75	8	27	31	0.8709677
NODE_301456_length_199_cov_83.220000	0	64	0	64	64	1.0000000
NODE_301459_length_199_cov_80.390000	15	98	8	1	83	0.0120482
NODE_301459_length_199_cov_80.390000	15	98	9	3	83	0.0361446
NODE_301459_length_199_cov_80.390000	15	98	14	7	83	0.0843373
NODE_301459_length_199_cov_80.390000	15	98	16	15	83	0.1807229
NODE_301459_length_199_cov_80.390000	15	98	18	3	83	0.0361446
NODE_301459_length_199_cov_80.390000	15	98	20	7	83	0.0843373
NODE_301459_length_199_cov_80.390000	15	98	24	26	83	0.3132530
NODE_301459_length_199_cov_80.390000	15	98	26	21	83	0.2530121
NODE_301469_length_199_cov_63.420000	128	194	2	1	66	0.0151515
NODE_301469_length_199_cov_63.420000	128	194	4	4	66	0.0606061
NODE_301469_length_199_cov_63.420000	128	194	6	2	66	0.0303030
NODE_301469_length_199_cov_63.420000	128	194	8	2	66	0.0303030
NODE_301469_length_199_cov_63.420000	128	194	10	2	66	0.0303030
NODE_301469_length_199_cov_63.420000	128	194	12	4	66	0.0606061
NODE_301469_length_199_cov_63.420000	128	194	14	7	66	0.1060606
NODE_301469_length_199_cov_63.420000	128	194	18	4	66	0.0606061
NODE_301469_length_199_cov_63.420000	128	194	20	1	66	0.0151515
NODE_301469_length_199_cov_63.420000	128	194	24	1	66	0.0151515
NODE_301469_length_199_cov_63.420000	128	194	28	2	66	0.0303030
NODE_301469_length_199_cov_63.420000	128	194	30	1	66	0.0151515
NODE_301469_length_199_cov_63.420000	128	194	36	1	66	0.0151515
NODE_301469_length_199_cov_63.420000	128	194	38	1	66	0.0151515
NODE_301469_length_199_cov_63.420000	128	194	42	1	66	0.0151515
NODE_301469_length_199_cov_63.420000	128	194	48	6	66	0.0909091
NODE_301469_length_199_cov_63.420000	128	194	50	3	66	0.0454545
NODE_301469_length_199_cov_63.420000	128	194	54	2	66	0.0303030
NODE_301469_length_199_cov_63.420000	128	194	58	2	66	0.0303030
NODE_301469_length_199_cov_63.420000	128	194	62	1	66	0.0151515
NODE_301469_length_199_cov_63.420000	128	194	64	2	66	0.0303030
NODE_301469_length_199_cov_63.420000	128	194	66	1	66	0.0151515
NODE_301469_length_199_cov_63.420000	128	194	68	6	66	0.0909091
NODE_301469_length_199_cov_63.420000	128	194	74	5	66	0.0757576
NODE_301469_length_199_cov_63.420000	128	194	78	1	66	0.0151515
NODE_301469_length_199_cov_63.420000	128	194	80	1	66	0.0151515
NODE_301469_length_199_cov_63.420000	128	194	84	1	66	0.0151515
NODE_301469_length_199_cov_63.420000	128	194	86	1	66	0.0151515
NODE_301477_length_199_cov_58.660000	18	85	0	67	67	1.0000000
NODE_301484_length_199_cov_50.350000	102	183	0	81	81	1.0000000
NODE_301485_length_199_cov_49.630000	5	47	2	42	42	1.0000000
NODE_301485_length_199_cov_49.630000	100	163	12	12	63	0.1904762
NODE_301485_length_199_cov_49.630000	100	163	13	5	63	0.0793651
NODE_301485_length_199_cov_49.630000	100	163	14	6	63	0.0952381
NODE_301485_length_199_cov_49.630000	100	163	16	8	63	0.1269841
NODE_301485_length_199_cov_49.630000	100	163	18	32	63	0.5079365
NODE_301485_length_199_cov_49.630000	100	163	12	12	63	0.1904762
NODE_301485_length_199_cov_49.630000	100	163	13	5	63	0.0793651
NODE_301485_length_199_cov_49.630000	100	163	14	6	63	0.0952381
NODE_301485_length_199_cov_49.630000	100	163	16	8	63	0.1269841
NODE_301485_length_199_cov_49.630000	100	163	18	32	63	0.5079365
NODE_301485_length_199_cov_49.630000	100	163	12	12	63	0.1904762
NODE_301485_length_199_cov_49.630000	100	163	13	5	63	0.0793651
NODE_301485_length_199_cov_49.630000	100	163	14	6	63	0.0952381
NODE_301485_length_199_cov_49.630000	100	163	16	8	63	0.1269841
NODE_301485_length_199_cov_49.630000	100	163	18	32	63	0.5079365
NODE_301485_length_199_cov_49.630000	136	185	10	13	49	0.2653061
NODE_301485_length_199_cov_49.630000	136	185	12	21	49	0.4285714
NODE_301485_length_199_cov_49.630000	136	185	13	5	49	0.1020408
NODE_301485_length_199_cov_49.630000	136	185	14	6	49	0.1224490
NODE_301485_length_199_cov_49.630000	136	185	16	4	49	0.0816327
NODE_301485_length_199_cov_49.630000	153	199	0	5	46	0.1086956
NODE_301485_length_199_cov_49.630000	153	199	8	9	46	0.1956522
NODE_301485_length_199_cov_49.630000	153	199	10	13	46	0.2826087
NODE_301485_length_199_cov_49.630000	153	199	12	19	46	0.4130435
NODE_301491_length_199_cov_40.000000	0	66	0	29	66	0.4393939
NODE_301491_length_199_cov_40.000000	0	66	2	6	66	0.0909091
NODE_301491_length_199_cov_40.000000	0	66	4	7	66	0.1060606
NODE_301491_length_199_cov_40.000000	0	66	8	24	66	0.3636364
NODE_301491_length_199_cov_40.000000	34	114	2	1	80	0.0125000
NODE_301491_length_199_cov_40.000000	34	114	4	7	80	0.0875000
NODE_301491_length_199_cov_40.000000	34	114	7	2	80	0.0250000
NODE_301491_length_199_cov_40.000000	34	114	8	70	80	0.8750000
NODE_301491_length_199_cov_40.000000	39	61	4	3	22	0.1363636
NODE_301491_length_199_cov_40.000000	39	61	8	19	22	0.8636364
NODE_301498_length_199_cov_31.400000	3	77	0	58	74	0.7837838
NODE_301498_length_199_cov_31.400000	3	77	2	8	74	0.1081081
NODE_301498_length_199_cov_31.400000	3	77	4	8	74	0.1081081
NODE_301498_length_199_cov_31.400000	76	153	2	15	77	0.1948052
NODE_301498_length_199_cov_31.400000	76	153	4	62	77	0.8051948
NODE_301498_length_199_cov_31.400000	76	153	2	15	77	0.1948052
NODE_301498_length_199_cov_31.400000	76	153	4	62	77	0.8051948
NODE_301498_length_199_cov_31.400000	76	153	2	15	77	0.1948052
NODE_301498_length_199_cov_31.400000	76	153	4	62	77	0.8051948
NODE_301498_length_199_cov_31.400000	126	192	0	21	66	0.3181818
NODE_301498_length_199_cov_31.400000	126	192	2	33	66	0.5000000
NODE_301498_length_199_cov_31.400000	126	192	4	12	66	0.1818182
NODE_301498_length_199_cov_31.400000	129	199	0	28	70	0.4000000
NODE_301498_length_199_cov_31.400000	129	199	2	33	70	0.4714286
NODE_301498_length_199_cov_31.400000	129	199	4	9	70	0.1285714
NODE_301498_length_199_cov_31.400000	131	199	0	28	68	0.4117647
NODE_301498_length_199_cov_31.400000	131	199	2	33	68	0.4852941
NODE_301498_length_199_cov_31.400000	131	199	4	7	68	0.1029412
NODE_301500_length_199_cov_30.140000	118	198	0	80	80	1.0000000
NODE_301500_length_199_cov_30.140000	118	198	0	80	80	1.0000000
NODE_301500_length_199_cov_30.140000	118	198	0	80	80	1.0000000
NODE_301500_length_199_cov_30.140000	118	198	0	80	80	1.0000000
NODE_301500_length_199_cov_30.140000	118	198	0	80	80	1.0000000
NODE_301500_length_199_cov_30.140000	127	198	0	71	71	1.0000000
NODE_301581_length_197_cov_41.265306	0	70	0	70	70	1.0000000
NODE_301611_length_196_cov_101.855670	72	136	49	6	64	0.0937500
NODE_301611_length_196_cov_101.855670	72	136	53	1	64	0.0156250
NODE_301611_length_196_cov_101.855670	72	136	54	1	64	0.0156250
NODE_301611_length_196_cov_101.855670	72	136	62	1	64	0.0156250
NODE_301611_length_196_cov_101.855670	72	136	64	1	64	0.0156250
NODE_301611_length_196_cov_101.855670	72	136	67	1	64	0.0156250
NODE_301611_length_196_cov_101.855670	72	136	68	3	64	0.0468750
NODE_301611_length_196_cov_101.855670	72	136	69	3	64	0.0468750
NODE_301611_length_196_cov_101.855670	72	136	71	15	64	0.2343750
NODE_301611_length_196_cov_101.855670	72	136	73	32	64	0.5000000
NODE_301611_length_196_cov_101.855670	72	136	49	6	64	0.0937500
NODE_301611_length_196_cov_101.855670	72	136	53	1	64	0.0156250
NODE_301611_length_196_cov_101.855670	72	136	54	1	64	0.0156250
NODE_301611_length_196_cov_101.855670	72	136	62	1	64	0.0156250
NODE_301611_length_196_cov_101.855670	72	136	64	1	64	0.0156250
NODE_301611_length_196_cov_101.855670	72	136	67	1	64	0.0156250
NODE_301611_length_196_cov_101.855670	72	136	68	3	64	0.0468750
NODE_301611_length_196_cov_101.855670	72	136	69	3	64	0.0468750
NODE_301611_length_196_cov_101.855670	72	136	71	15	64	0.2343750
NODE_301611_length_196_cov_101.855670	72	136	73	32	64	0.5000000
NODE_301611_length_196_cov_101.855670	109	169	10	2	60	0.0333333
NODE_301611_length_196_cov_101.855670	109	169	16	2	60	0.0333333
NODE_301611_length_196_cov_101.855670	109	169	17	9	60	0.1500000
NODE_301611_length_196_cov_101.855670	109	169	23	1	60	0.0166667
NODE_301611_length_196_cov_101.855670	109	169	29	1	60	0.0166667
NODE_301611_length_196_cov_101.855670	109	169	31	2	60	0.0333333
NODE_301611_length_196_cov_101.855670	109	169	33	6	60	0.1000000
NODE_301611_length_196_cov_101.855670	109	169	35	1	60	0.0166667
NODE_301611_length_196_cov_101.855670	109	169	36	2	60	0.0333333
NODE_301611_length_196_cov_101.855670	109	169	41	1	60	0.0166667
NODE_301611_length_196_cov_101.855670	109	169	45	1	60	0.0166667
NODE_301611_length_196_cov_101.855670	109	169	47	4	60	0.0666667
NODE_301611_length_196_cov_101.855670	109	169	49	7	60	0.1166667
NODE_301611_length_196_cov_101.855670	109	169	53	1	60	0.0166667
NODE_301611_length_196_cov_101.855670	109	169	54	1	60	0.0166667
NODE_301611_length_196_cov_101.855670	109	169	62	1	60	0.0166667
NODE_301611_length_196_cov_101.855670	109	169	64	1	60	0.0166667
NODE_301611_length_196_cov_101.855670	109	169	68	3	60	0.0500000
NODE_301611_length_196_cov_101.855670	109	169	69	1	60	0.0166667
NODE_301611_length_196_cov_101.855670	109	169	71	1	60	0.0166667
NODE_301611_length_196_cov_101.855670	109	169	73	12	60	0.2000000
NODE_301613_length_196_cov_100.618557	129	196	0	1	67	0.0149254
NODE_301613_length_196_cov_100.618557	129	196	2	7	67	0.1044776
NODE_301613_length_196_cov_100.618557	129	196	4	7	67	0.1044776
NODE_301613_length_196_cov_100.618557	129	196	6	1	67	0.0149254
NODE_301613_length_196_cov_100.618557	129	196	8	5	67	0.0746269
NODE_301613_length_196_cov_100.618557	129	196	12	1	67	0.0149254
NODE_301613_length_196_cov_100.618557	129	196	16	3	67	0.0447761
NODE_301613_length_196_cov_100.618557	129	196	18	1	67	0.0149254
NODE_301613_length_196_cov_100.618557	129	196	24	7	67	0.1044776
NODE_301613_length_196_cov_100.618557	129	196	26	3	67	0.0447761
NODE_301613_length_196_cov_100.618557	129	196	28	5	67	0.0746269
NODE_301613_length_196_cov_100.618557	129	196	30	6	67	0.0895522
NODE_301613_length_196_cov_100.618557	129	196	32	16	67	0.2388060
NODE_301613_length_196_cov_100.618557	129	196	34	4	67	0.0597015
NODE_301618_length_196_cov_67.268041	8	88	1	4	80	0.0500000
NODE_301618_length_196_cov_67.268041	8	88	3	8	80	0.1000000
NODE_301618_length_196_cov_67.268041	8	88	4	3	80	0.0375000
NODE_301618_length_196_cov_67.268041	8	88	5	6	80	0.0750000
NODE_301618_length_196_cov_67.268041	8	88	6	10	80	0.1250000
NODE_301618_length_196_cov_67.268041	8	88	8	1	80	0.0125000
NODE_301618_length_196_cov_67.268041	8	88	10	7	80	0.0875000
NODE_301618_length_196_cov_67.268041	8	88	12	3	80	0.0375000
NODE_301618_length_196_cov_67.268041	8	88	16	8	80	0.1000000
NODE_301618_length_196_cov_67.268041	8	88	17	1	80	0.0125000
NODE_301618_length_196_cov_67.268041	8	88	19	9	80	0.1125000
NODE_301618_length_196_cov_67.268041	8	88	21	5	80	0.0625000
NODE_301618_length_196_cov_67.268041	8	88	23	15	80	0.1875000
NODE_301618_length_196_cov_67.268041	61	124	19	7	63	0.1111111
NODE_301618_length_196_cov_67.268041	61	124	21	5	63	0.0793651
NODE_301618_length_196_cov_67.268041	61	124	23	33	63	0.5238096
NODE_301618_length_196_cov_67.268041	61	124	24	18	63	0.2857143
NODE_301629_length_196_cov_40.195876	101	184	0	11	83	0.1325301
NODE_301629_length_196_cov_40.195876	101	184	2	2	83	0.0240964
NODE_301629_length_196_cov_40.195876	101	184	6	5	83	0.0602410
NODE_301629_length_196_cov_40.195876	101	184	8	10	83	0.1204819
NODE_301629_length_196_cov_40.195876	101	184	10	5	83	0.0602410
NODE_301629_length_196_cov_40.195876	101	184	12	1	83	0.0120482
NODE_301629_length_196_cov_40.195876	101	184	14	14	83	0.1686747
NODE_301629_length_196_cov_40.195876	101	184	16	25	83	0.3012048
NODE_301629_length_196_cov_40.195876	101	184	18	10	83	0.1204819
NODE_301704_length_194_cov_63.252632	12	78	0	16	66	0.2424242
NODE_301704_length_194_cov_63.252632	12	78	1	5	66	0.0757576
NODE_301704_length_194_cov_63.252632	12	78	2	4	66	0.0606061
NODE_301704_length_194_cov_63.252632	12	78	3	3	66	0.0454545
NODE_301704_length_194_cov_63.252632	12	78	5	2	66	0.0303030
NODE_301704_length_194_cov_63.252632	12	78	11	3	66	0.0454545
NODE_301704_length_194_cov_63.252632	12	78	13	3	66	0.0454545
NODE_301704_length_194_cov_63.252632	12	78	17	7	66	0.1060606
NODE_301704_length_194_cov_63.252632	12	78	19	1	66	0.0151515
NODE_301704_length_194_cov_63.252632	12	78	21	3	66	0.0454545
NODE_301704_length_194_cov_63.252632	12	78	22	8	66	0.1212121
NODE_301704_length_194_cov_63.252632	12	78	24	2	66	0.0303030
NODE_301704_length_194_cov_63.252632	12	78	26	2	66	0.0303030
NODE_301704_length_194_cov_63.252632	12	78	28	1	66	0.0151515
NODE_301704_length_194_cov_63.252632	12	78	30	1	66	0.0151515
NODE_301704_length_194_cov_63.252632	12	78	32	1	66	0.0151515
NODE_301704_length_194_cov_63.252632	12	78	34	4	66	0.0606061
NODE_301704_length_194_cov_63.252632	51	112	17	4	61	0.0655738
NODE_301704_length_194_cov_63.252632	51	112	19	1	61	0.0163934
NODE_301704_length_194_cov_63.252632	51	112	21	3	61	0.0491803
NODE_301704_length_194_cov_63.252632	51	112	22	8	61	0.1311475
NODE_301704_length_194_cov_63.252632	51	112	24	2	61	0.0327869
NODE_301704_length_194_cov_63.252632	51	112	26	2	61	0.0327869
NODE_301704_length_194_cov_63.252632	51	112	28	1	61	0.0163934
NODE_301704_length_194_cov_63.252632	51	112	30	1	61	0.0163934
NODE_301704_length_194_cov_63.252632	51	112	32	1	61	0.0163934
NODE_301704_length_194_cov_63.252632	51	112	34	38	61	0.6229508
NODE_301704_length_194_cov_63.252632	51	99	17	4	48	0.0833333
NODE_301704_length_194_cov_63.252632	51	99	19	1	48	0.0208333
NODE_301704_length_194_cov_63.252632	51	99	21	3	48	0.0625000
NODE_301704_length_194_cov_63.252632	51	99	22	8	48	0.1666667
NODE_301704_length_194_cov_63.252632	51	99	24	2	48	0.0416667
NODE_301704_length_194_cov_63.252632	51	99	26	2	48	0.0416667
NODE_301704_length_194_cov_63.252632	51	99	28	1	48	0.0208333
NODE_301704_length_194_cov_63.252632	51	99	30	1	48	0.0208333
NODE_301704_length_194_cov_63.252632	51	99	32	1	48	0.0208333
NODE_301704_length_194_cov_63.252632	51	99	34	25	48	0.5208333
NODE_301704_length_194_cov_63.252632	51	112	17	4	61	0.0655738
NODE_301704_length_194_cov_63.252632	51	112	19	1	61	0.0163934
NODE_301704_length_194_cov_63.252632	51	112	21	3	61	0.0491803
NODE_301704_length_194_cov_63.252632	51	112	22	8	61	0.1311475
NODE_301704_length_194_cov_63.252632	51	112	24	2	61	0.0327869
NODE_301704_length_194_cov_63.252632	51	112	26	2	61	0.0327869
NODE_301704_length_194_cov_63.252632	51	112	28	1	61	0.0163934
NODE_301704_length_194_cov_63.252632	51	112	30	1	61	0.0163934
NODE_301704_length_194_cov_63.252632	51	112	32	1	61	0.0163934
NODE_301704_length_194_cov_63.252632	51	112	34	38	61	0.6229508
NODE_301708_length_194_cov_35.010526	95	162	2	16	67	0.2388060
NODE_301708_length_194_cov_35.010526	95	162	4	51	67	0.7611941
NODE_301708_length_194_cov_35.010526	95	162	2	16	67	0.2388060
NODE_301708_length_194_cov_35.010526	95	162	4	51	67	0.7611941
NODE_301708_length_194_cov_35.010526	135	184	0	18	49	0.3673469
NODE_301708_length_194_cov_35.010526	135	184	2	20	49	0.4081633
NODE_301708_length_194_cov_35.010526	135	184	4	11	49	0.2244898
NODE_301714_length_194_cov_9.978947	153	194	0	41	41	1.0000000
NODE_301727_length_193_cov_117.170213	21	93	15	1	72	0.0138889
NODE_301727_length_193_cov_117.170213	21	93	18	3	72	0.0416667
NODE_301727_length_193_cov_117.170213	21	93	22	20	72	0.2777778
NODE_301727_length_193_cov_117.170213	21	93	26	1	72	0.0138889
NODE_301727_length_193_cov_117.170213	21	93	28	4	72	0.0555556
NODE_301727_length_193_cov_117.170213	21	93	30	2	72	0.0277778
NODE_301727_length_193_cov_117.170213	21	93	32	8	72	0.1111111
NODE_301727_length_193_cov_117.170213	21	93	36	1	72	0.0138889
NODE_301727_length_193_cov_117.170213	21	93	38	1	72	0.0138889
NODE_301727_length_193_cov_117.170213	21	93	40	17	72	0.2361111
NODE_301727_length_193_cov_117.170213	21	93	42	3	72	0.0416667
NODE_301727_length_193_cov_117.170213	21	93	44	5	72	0.0694444
NODE_301727_length_193_cov_117.170213	21	93	46	6	72	0.0833333
NODE_301727_length_193_cov_117.170213	41	121	22	4	80	0.0500000
NODE_301727_length_193_cov_117.170213	41	121	26	1	80	0.0125000
NODE_301727_length_193_cov_117.170213	41	121	28	4	80	0.0500000
NODE_301727_length_193_cov_117.170213	41	121	30	2	80	0.0250000
NODE_301727_length_193_cov_117.170213	41	121	32	12	80	0.1500000
NODE_301727_length_193_cov_117.170213	41	121	36	1	80	0.0125000
NODE_301727_length_193_cov_117.170213	41	121	38	4	80	0.0500000
NODE_301727_length_193_cov_117.170213	41	121	40	19	80	0.2375000
NODE_301727_length_193_cov_117.170213	41	121	42	3	80	0.0375000
NODE_301727_length_193_cov_117.170213	41	121	44	6	80	0.0750000
NODE_301727_length_193_cov_117.170213	41	121	46	24	80	0.3000000
NODE_301729_length_193_cov_54.734043	108	188	5	4	80	0.0500000
NODE_301729_length_193_cov_54.734043	108	188	9	11	80	0.1375000
NODE_301729_length_193_cov_54.734043	108	188	10	9	80	0.1125000
NODE_301729_length_193_cov_54.734043	108	188	13	10	80	0.1250000
NODE_301729_length_193_cov_54.734043	108	188	15	4	80	0.0500000
NODE_301729_length_193_cov_54.734043	108	188	17	27	80	0.3375000
NODE_301729_length_193_cov_54.734043	108	188	18	15	80	0.1875000
NODE_301729_length_193_cov_54.734043	161	183	9	10	22	0.4545455
NODE_301729_length_193_cov_54.734043	161	183	10	9	22	0.4090909
NODE_301729_length_193_cov_54.734043	161	183	13	3	22	0.1363636
NODE_301735_length_193_cov_30.638298	108	188	12	3	80	0.0375000
NODE_301735_length_193_cov_30.638298	108	188	14	3	80	0.0375000
NODE_301735_length_193_cov_30.638298	108	188	16	2	80	0.0250000
NODE_301735_length_193_cov_30.638298	108	188	17	3	80	0.0375000
NODE_301735_length_193_cov_30.638298	108	188	19	2	80	0.0250000
NODE_301735_length_193_cov_30.638298	108	188	22	14	80	0.1750000
NODE_301735_length_193_cov_30.638298	108	188	24	1	80	0.0125000
NODE_301735_length_193_cov_30.638298	108	188	30	1	80	0.0125000
NODE_301735_length_193_cov_30.638298	108	188	32	12	80	0.1500000
NODE_301735_length_193_cov_30.638298	108	188	34	2	80	0.0250000
NODE_301735_length_193_cov_30.638298	108	188	36	10	80	0.1250000
NODE_301735_length_193_cov_30.638298	108	188	38	27	80	0.3375000
NODE_301735_length_193_cov_30.638298	161	183	14	1	22	0.0454545
NODE_301735_length_193_cov_30.638298	161	183	16	2	22	0.0909091
NODE_301735_length_193_cov_30.638298	161	183	17	3	22	0.1363636
NODE_301735_length_193_cov_30.638298	161	183	19	2	22	0.0909091
NODE_301735_length_193_cov_30.638298	161	183	22	14	22	0.6363636
NODE_301737_length_193_cov_29.968085	0	45	0	3	45	0.0666667
NODE_301737_length_193_cov_29.968085	0	45	2	11	45	0.2444444
NODE_301737_length_193_cov_29.968085	0	45	4	2	45	0.0444444
NODE_301737_length_193_cov_29.968085	0	45	6	4	45	0.0888889
NODE_301737_length_193_cov_29.968085	0	45	13	4	45	0.0888889
NODE_301737_length_193_cov_29.968085	0	45	19	1	45	0.0222222
NODE_301737_length_193_cov_29.968085	0	45	24	2	45	0.0444444
NODE_301737_length_193_cov_29.968085	0	45	26	3	45	0.0666667
NODE_301737_length_193_cov_29.968085	0	45	30	2	45	0.0444444
NODE_301737_length_193_cov_29.968085	0	45	31	4	45	0.0888889
NODE_301737_length_193_cov_29.968085	0	45	35	2	45	0.0444444
NODE_301737_length_193_cov_29.968085	0	45	41	2	45	0.0444444
NODE_301737_length_193_cov_29.968085	0	45	43	1	45	0.0222222
NODE_301737_length_193_cov_29.968085	0	45	45	4	45	0.0888889
NODE_301737_length_193_cov_29.968085	8	57	2	6	49	0.1224490
NODE_301737_length_193_cov_29.968085	8	57	4	2	49	0.0408163
NODE_301737_length_193_cov_29.968085	8	57	6	4	49	0.0816327
NODE_301737_length_193_cov_29.968085	8	57	13	4	49	0.0816327
NODE_301737_length_193_cov_29.968085	8	57	19	1	49	0.0204082
NODE_301737_length_193_cov_29.968085	8	57	24	2	49	0.0408163
NODE_301737_length_193_cov_29.968085	8	57	26	3	49	0.0612245
NODE_301737_length_193_cov_29.968085	8	57	30	2	49	0.0408163
NODE_301737_length_193_cov_29.968085	8	57	31	4	49	0.0816327
NODE_301737_length_193_cov_29.968085	8	57	35	2	49	0.0408163
NODE_301737_length_193_cov_29.968085	8	57	41	2	49	0.0408163
NODE_301737_length_193_cov_29.968085	8	57	43	1	49	0.0204082
NODE_301737_length_193_cov_29.968085	8	57	45	5	49	0.1020408
NODE_301737_length_193_cov_29.968085	8	57	49	5	49	0.1020408
NODE_301737_length_193_cov_29.968085	8	57	50	1	49	0.0204082
NODE_301737_length_193_cov_29.968085	8	57	54	5	49	0.1020408
NODE_301737_length_193_cov_29.968085	30	98	30	2	68	0.0294118
NODE_301737_length_193_cov_29.968085	30	98	31	4	68	0.0588235
NODE_301737_length_193_cov_29.968085	30	98	35	2	68	0.0294118
NODE_301737_length_193_cov_29.968085	30	98	41	2	68	0.0294118
NODE_301737_length_193_cov_29.968085	30	98	43	1	68	0.0147059
NODE_301737_length_193_cov_29.968085	30	98	45	5	68	0.0735294
NODE_301737_length_193_cov_29.968085	30	98	49	5	68	0.0735294
NODE_301737_length_193_cov_29.968085	30	98	50	1	68	0.0147059
NODE_301737_length_193_cov_29.968085	30	98	54	6	68	0.0882353
NODE_301737_length_193_cov_29.968085	30	98	58	19	68	0.2794118
NODE_301737_length_193_cov_29.968085	30	98	60	1	68	0.0147059
NODE_301737_length_193_cov_29.968085	30	98	62	3	68	0.0441176
NODE_301737_length_193_cov_29.968085	30	98	64	17	68	0.2500000
NODE_301737_length_193_cov_29.968085	30	98	30	2	68	0.0294118
NODE_301737_length_193_cov_29.968085	30	98	31	4	68	0.0588235
NODE_301737_length_193_cov_29.968085	30	98	35	2	68	0.0294118
NODE_301737_length_193_cov_29.968085	30	98	41	2	68	0.0294118
NODE_301737_length_193_cov_29.968085	30	98	43	1	68	0.0147059
NODE_301737_length_193_cov_29.968085	30	98	45	5	68	0.0735294
NODE_301737_length_193_cov_29.968085	30	98	49	5	68	0.0735294
NODE_301737_length_193_cov_29.968085	30	98	50	1	68	0.0147059
NODE_301737_length_193_cov_29.968085	30	98	54	6	68	0.0882353
NODE_301737_length_193_cov_29.968085	30	98	58	19	68	0.2794118
NODE_301737_length_193_cov_29.968085	30	98	60	1	68	0.0147059
NODE_301737_length_193_cov_29.968085	30	98	62	3	68	0.0441176
NODE_301737_length_193_cov_29.968085	30	98	64	17	68	0.2500000
NODE_301737_length_193_cov_29.968085	30	98	30	2	68	0.0294118
NODE_301737_length_193_cov_29.968085	30	98	31	4	68	0.0588235
NODE_301737_length_193_cov_29.968085	30	98	35	2	68	0.0294118
NODE_301737_length_193_cov_29.968085	30	98	41	2	68	0.0294118
NODE_301737_length_193_cov_29.968085	30	98	43	1	68	0.0147059
NODE_301737_length_193_cov_29.968085	30	98	45	5	68	0.0735294
NODE_301737_length_193_cov_29.968085	30	98	49	5	68	0.0735294
NODE_301737_length_193_cov_29.968085	30	98	50	1	68	0.0147059
NODE_301737_length_193_cov_29.968085	30	98	54	6	68	0.0882353
NODE_301737_length_193_cov_29.968085	30	98	58	19	68	0.2794118
NODE_301737_length_193_cov_29.968085	30	98	60	1	68	0.0147059
NODE_301737_length_193_cov_29.968085	30	98	62	3	68	0.0441176
NODE_301737_length_193_cov_29.968085	30	98	64	17	68	0.2500000
NODE_301737_length_193_cov_29.968085	146	188	0	12	42	0.2857143
NODE_301737_length_193_cov_29.968085	146	188	2	1	42	0.0238095
NODE_301737_length_193_cov_29.968085	146	188	4	3	42	0.0714286
NODE_301737_length_193_cov_29.968085	146	188	6	9	42	0.2142857
NODE_301737_length_193_cov_29.968085	146	188	12	11	42	0.2619048
NODE_301737_length_193_cov_29.968085	146	188	14	1	42	0.0238095
NODE_301737_length_193_cov_29.968085	146	188	16	5	42	0.1190476
NODE_301776_length_192_cov_160.258065	0	76	2	1	76	0.0131579
NODE_301776_length_192_cov_160.258065	0	76	5	2	76	0.0263158
NODE_301776_length_192_cov_160.258065	0	76	6	1	76	0.0131579
NODE_301776_length_192_cov_160.258065	0	76	8	3	76	0.0394737
NODE_301776_length_192_cov_160.258065	0	76	10	3	76	0.0394737
NODE_301776_length_192_cov_160.258065	0	76	12	1	76	0.0131579
NODE_301776_length_192_cov_160.258065	0	76	14	14	76	0.1842105
NODE_301776_length_192_cov_160.258065	0	76	16	4	76	0.0526316
NODE_301776_length_192_cov_160.258065	0	76	18	9	76	0.1184211
NODE_301776_length_192_cov_160.258065	0	76	20	14	76	0.1842105
NODE_301776_length_192_cov_160.258065	0	76	24	1	76	0.0131579
NODE_301776_length_192_cov_160.258065	0	76	26	1	76	0.0131579
NODE_301776_length_192_cov_160.258065	0	76	32	3	76	0.0394737
NODE_301776_length_192_cov_160.258065	0	76	34	2	76	0.0263158
NODE_301776_length_192_cov_160.258065	0	76	40	2	76	0.0263158
NODE_301776_length_192_cov_160.258065	0	76	46	1	76	0.0131579
NODE_301776_length_192_cov_160.258065	0	76	48	1	76	0.0131579
NODE_301776_length_192_cov_160.258065	0	76	50	2	76	0.0263158
NODE_301776_length_192_cov_160.258065	0	76	52	1	76	0.0131579
NODE_301776_length_192_cov_160.258065	0	76	58	3	76	0.0394737
NODE_301776_length_192_cov_160.258065	0	76	62	2	76	0.0263158
NODE_301776_length_192_cov_160.258065	0	76	66	1	76	0.0131579
NODE_301776_length_192_cov_160.258065	0	76	70	1	76	0.0131579
NODE_301776_length_192_cov_160.258065	0	76	74	2	76	0.0263158
NODE_301776_length_192_cov_160.258065	0	76	76	1	76	0.0131579
NODE_301825_length_191_cov_92.913043	81	144	0	38	63	0.6031746
NODE_301825_length_191_cov_92.913043	81	144	2	25	63	0.3968254
NODE_301855_length_190_cov_112.285714	8	91	0	5	83	0.0602410
NODE_301855_length_190_cov_112.285714	8	91	2	78	83	0.9397590
NODE_301859_length_190_cov_41.373626	92	172	8	4	80	0.0500000
NODE_301859_length_190_cov_41.373626	92	172	9	5	80	0.0625000
NODE_301859_length_190_cov_41.373626	92	172	10	5	80	0.0625000
NODE_301859_length_190_cov_41.373626	92	172	12	5	80	0.0625000
NODE_301859_length_190_cov_41.373626	92	172	14	6	80	0.0750000
NODE_301859_length_190_cov_41.373626	92	172	16	11	80	0.1375000
NODE_301859_length_190_cov_41.373626	92	172	18	1	80	0.0125000
NODE_301859_length_190_cov_41.373626	92	172	20	14	80	0.1750000
NODE_301859_length_190_cov_41.373626	92	172	22	29	80	0.3625000
NODE_301859_length_190_cov_41.373626	145	190	0	2	45	0.0444444
NODE_301859_length_190_cov_41.373626	145	190	4	9	45	0.2000000
NODE_301859_length_190_cov_41.373626	145	190	8	11	45	0.2444444
NODE_301859_length_190_cov_41.373626	145	190	9	5	45	0.1111111
NODE_301859_length_190_cov_41.373626	145	190	10	5	45	0.1111111
NODE_301859_length_190_cov_41.373626	145	190	12	5	45	0.1111111
NODE_301859_length_190_cov_41.373626	145	190	14	6	45	0.1333333
NODE_301859_length_190_cov_41.373626	145	190	16	2	45	0.0444444
NODE_301880_length_189_cov_234.500000	19	88	0	69	69	1.0000000
NODE_301882_length_189_cov_192.211111	134	186	2	8	52	0.1538462
NODE_301882_length_189_cov_192.211111	134	186	4	17	52	0.3269231
NODE_301882_length_189_cov_192.211111	134	186	8	17	52	0.3269231
NODE_301882_length_189_cov_192.211111	134	186	10	10	52	0.1923077
NODE_301885_length_189_cov_70.600000	19	88	0	69	69	1.0000000
NODE_301885_length_189_cov_70.600000	72	156	0	84	84	1.0000000
NODE_301886_length_189_cov_63.455556	70	150	32	2	80	0.0250000
NODE_301886_length_189_cov_63.455556	70	150	36	2	80	0.0250000
NODE_301886_length_189_cov_63.455556	70	150	38	1	80	0.0125000
NODE_301886_length_189_cov_63.455556	70	150	40	2	80	0.0250000
NODE_301886_length_189_cov_63.455556	70	150	46	3	80	0.0375000
NODE_301886_length_189_cov_63.455556	70	150	48	5	80	0.0625000
NODE_301886_length_189_cov_63.455556	70	150	50	1	80	0.0125000
NODE_301886_length_189_cov_63.455556	70	150	52	3	80	0.0375000
NODE_301886_length_189_cov_63.455556	70	150	58	2	80	0.0250000
NODE_301886_length_189_cov_63.455556	70	150	62	1	80	0.0125000
NODE_301886_length_189_cov_63.455556	70	150	64	6	80	0.0750000
NODE_301886_length_189_cov_63.455556	70	150	66	4	80	0.0500000
NODE_301886_length_189_cov_63.455556	70	150	68	7	80	0.0875000
NODE_301886_length_189_cov_63.455556	70	150	70	4	80	0.0500000
NODE_301886_length_189_cov_63.455556	70	150	73	1	80	0.0125000
NODE_301886_length_189_cov_63.455556	70	150	78	4	80	0.0500000
NODE_301886_length_189_cov_63.455556	70	150	80	1	80	0.0125000
NODE_301886_length_189_cov_63.455556	70	150	82	2	80	0.0250000
NODE_301886_length_189_cov_63.455556	70	150	84	10	80	0.1250000
NODE_301886_length_189_cov_63.455556	70	150	88	19	80	0.2375000
NODE_301886_length_189_cov_63.455556	70	141	46	1	71	0.0140845
NODE_301886_length_189_cov_63.455556	70	141	48	5	71	0.0704225
NODE_301886_length_189_cov_63.455556	70	141	50	1	71	0.0140845
NODE_301886_length_189_cov_63.455556	70	141	52	3	71	0.0422535
NODE_301886_length_189_cov_63.455556	70	141	58	2	71	0.0281690
NODE_301886_length_189_cov_63.455556	70	141	62	1	71	0.0140845
NODE_301886_length_189_cov_63.455556	70	141	64	6	71	0.0845070
NODE_301886_length_189_cov_63.455556	70	141	66	4	71	0.0563380
NODE_301886_length_189_cov_63.455556	70	141	68	7	71	0.0985916
NODE_301886_length_189_cov_63.455556	70	141	70	4	71	0.0563380
NODE_301886_length_189_cov_63.455556	70	141	73	1	71	0.0140845
NODE_301886_length_189_cov_63.455556	70	141	78	4	71	0.0563380
NODE_301886_length_189_cov_63.455556	70	141	80	1	71	0.0140845
NODE_301886_length_189_cov_63.455556	70	141	82	2	71	0.0281690
NODE_301886_length_189_cov_63.455556	70	141	84	10	71	0.1408451
NODE_301886_length_189_cov_63.455556	70	141	88	19	71	0.2676056
NODE_301891_length_189_cov_43.600000	0	73	6	8	73	0.1095890
NODE_301891_length_189_cov_43.600000	0	73	15	7	73	0.0958904
NODE_301891_length_189_cov_43.600000	0	73	17	10	73	0.1369863
NODE_301891_length_189_cov_43.600000	0	73	19	7	73	0.0958904
NODE_301891_length_189_cov_43.600000	0	73	21	2	73	0.0273973
NODE_301891_length_189_cov_43.600000	0	73	23	3	73	0.0410959
NODE_301891_length_189_cov_43.600000	0	73	24	6	73	0.0821918
NODE_301891_length_189_cov_43.600000	0	73	28	1	73	0.0136986
NODE_301891_length_189_cov_43.600000	0	73	30	1	73	0.0136986
NODE_301891_length_189_cov_43.600000	0	73	32	2	73	0.0273973
NODE_301891_length_189_cov_43.600000	0	73	34	7	73	0.0958904
NODE_301891_length_189_cov_43.600000	0	73	36	17	73	0.2328767
NODE_301891_length_189_cov_43.600000	0	73	38	2	73	0.0273973
NODE_301940_length_188_cov_2021.561798	108	188	2	2	80	0.0250000
NODE_301940_length_188_cov_2021.561798	108	188	10	1	80	0.0125000
NODE_301940_length_188_cov_2021.561798	108	188	12	1	80	0.0125000
NODE_301940_length_188_cov_2021.561798	108	188	13	2	80	0.0250000
NODE_301940_length_188_cov_2021.561798	108	188	17	1	80	0.0125000
NODE_301940_length_188_cov_2021.561798	108	188	23	1	80	0.0125000
NODE_301940_length_188_cov_2021.561798	108	188	40	1	80	0.0125000
NODE_301940_length_188_cov_2021.561798	108	188	48	1	80	0.0125000
NODE_301940_length_188_cov_2021.561798	108	188	55	1	80	0.0125000
NODE_301940_length_188_cov_2021.561798	108	188	59	1	80	0.0125000
NODE_301940_length_188_cov_2021.561798	108	188	63	1	80	0.0125000
NODE_301940_length_188_cov_2021.561798	108	188	67	1	80	0.0125000
NODE_301940_length_188_cov_2021.561798	108	188	81	1	80	0.0125000
NODE_301940_length_188_cov_2021.561798	108	188	83	1	80	0.0125000
NODE_301940_length_188_cov_2021.561798	108	188	88	2	80	0.0250000
NODE_301940_length_188_cov_2021.561798	108	188	94	1	80	0.0125000
NODE_301940_length_188_cov_2021.561798	108	188	99	5	80	0.0625000
NODE_301940_length_188_cov_2021.561798	108	188	102	1	80	0.0125000
NODE_301940_length_188_cov_2021.561798	108	188	103	1	80	0.0125000
NODE_301940_length_188_cov_2021.561798	108	188	108	1	80	0.0125000
NODE_301940_length_188_cov_2021.561798	108	188	110	3	80	0.0375000
NODE_301940_length_188_cov_2021.561798	108	188	111	3	80	0.0375000
NODE_301940_length_188_cov_2021.561798	108	188	113	3	80	0.0375000
NODE_301940_length_188_cov_2021.561798	108	188	114	1	80	0.0125000
NODE_301940_length_188_cov_2021.561798	108	188	116	2	80	0.0250000
NODE_301940_length_188_cov_2021.561798	108	188	121	1	80	0.0125000
NODE_301940_length_188_cov_2021.561798	108	188	127	1	80	0.0125000
NODE_301940_length_188_cov_2021.561798	108	188	129	3	80	0.0375000
NODE_301940_length_188_cov_2021.561798	108	188	131	1	80	0.0125000
NODE_301940_length_188_cov_2021.561798	108	188	133	1	80	0.0125000
NODE_301940_length_188_cov_2021.561798	108	188	137	3	80	0.0375000
NODE_301940_length_188_cov_2021.561798	108	188	142	1	80	0.0125000
NODE_301940_length_188_cov_2021.561798	108	188	144	1	80	0.0125000
NODE_301940_length_188_cov_2021.561798	108	188	148	2	80	0.0250000
NODE_301940_length_188_cov_2021.561798	108	188	150	5	80	0.0625000
NODE_301940_length_188_cov_2021.561798	108	188	154	1	80	0.0125000
NODE_301940_length_188_cov_2021.561798	108	188	158	3	80	0.0375000
NODE_301940_length_188_cov_2021.561798	108	188	163	2	80	0.0250000
NODE_301940_length_188_cov_2021.561798	108	188	171	2	80	0.0250000
NODE_301940_length_188_cov_2021.561798	108	188	174	2	80	0.0250000
NODE_301940_length_188_cov_2021.561798	108	188	178	4	80	0.0500000
NODE_301940_length_188_cov_2021.561798	108	188	182	2	80	0.0250000
NODE_301940_length_188_cov_2021.561798	108	188	184	3	80	0.0375000
NODE_301940_length_188_cov_2021.561798	108	188	186	1	80	0.0125000
NODE_301940_length_188_cov_2021.561798	108	188	188	2	80	0.0250000
NODE_301940_length_188_cov_2021.561798	161	183	13	1	22	0.0454545
NODE_301940_length_188_cov_2021.561798	161	183	17	1	22	0.0454545
NODE_301940_length_188_cov_2021.561798	161	183	23	1	22	0.0454545
NODE_301940_length_188_cov_2021.561798	161	183	40	1	22	0.0454545
NODE_301940_length_188_cov_2021.561798	161	183	48	1	22	0.0454545
NODE_301940_length_188_cov_2021.561798	161	183	55	1	22	0.0454545
NODE_301940_length_188_cov_2021.561798	161	183	59	1	22	0.0454545
NODE_301940_length_188_cov_2021.561798	161	183	63	1	22	0.0454545
NODE_301940_length_188_cov_2021.561798	161	183	67	1	22	0.0454545
NODE_301940_length_188_cov_2021.561798	161	183	81	1	22	0.0454545
NODE_301940_length_188_cov_2021.561798	161	183	83	1	22	0.0454545
NODE_301940_length_188_cov_2021.561798	161	183	88	2	22	0.0909091
NODE_301940_length_188_cov_2021.561798	161	183	94	1	22	0.0454545
NODE_301940_length_188_cov_2021.561798	161	183	99	5	22	0.2272727
NODE_301940_length_188_cov_2021.561798	161	183	102	1	22	0.0454545
NODE_301940_length_188_cov_2021.561798	161	183	103	1	22	0.0454545
NODE_301940_length_188_cov_2021.561798	161	183	108	1	22	0.0454545
NODE_301952_length_188_cov_37.988764	0	50	0	16	50	0.3200000
NODE_301952_length_188_cov_37.988764	0	50	2	26	50	0.5200000
NODE_301952_length_188_cov_37.988764	0	50	4	3	50	0.0600000
NODE_301952_length_188_cov_37.988764	0	50	6	5	50	0.1000000
NODE_301980_length_187_cov_71.170455	124	155	2	31	31	1.0000000
NODE_301981_length_187_cov_56.000000	72	136	61	1	64	0.0156250
NODE_301981_length_187_cov_56.000000	72	136	64	4	64	0.0625000
NODE_301981_length_187_cov_56.000000	72	136	66	1	64	0.0156250
NODE_301981_length_187_cov_56.000000	72	136	72	1	64	0.0156250
NODE_301981_length_187_cov_56.000000	72	136	74	3	64	0.0468750
NODE_301981_length_187_cov_56.000000	72	136	78	2	64	0.0312500
NODE_301981_length_187_cov_56.000000	72	136	80	4	64	0.0625000
NODE_301981_length_187_cov_56.000000	72	136	86	1	64	0.0156250
NODE_301981_length_187_cov_56.000000	72	136	94	1	64	0.0156250
NODE_301981_length_187_cov_56.000000	72	136	96	1	64	0.0156250
NODE_301981_length_187_cov_56.000000	72	136	98	2	64	0.0312500
NODE_301981_length_187_cov_56.000000	72	136	100	4	64	0.0625000
NODE_301981_length_187_cov_56.000000	72	136	102	2	64	0.0312500
NODE_301981_length_187_cov_56.000000	72	136	104	10	64	0.1562500
NODE_301981_length_187_cov_56.000000	72	136	106	27	64	0.4218750
NODE_301981_length_187_cov_56.000000	72	136	61	1	64	0.0156250
NODE_301981_length_187_cov_56.000000	72	136	64	4	64	0.0625000
NODE_301981_length_187_cov_56.000000	72	136	66	1	64	0.0156250
NODE_301981_length_187_cov_56.000000	72	136	72	1	64	0.0156250
NODE_301981_length_187_cov_56.000000	72	136	74	3	64	0.0468750
NODE_301981_length_187_cov_56.000000	72	136	78	2	64	0.0312500
NODE_301981_length_187_cov_56.000000	72	136	80	4	64	0.0625000
NODE_301981_length_187_cov_56.000000	72	136	86	1	64	0.0156250
NODE_301981_length_187_cov_56.000000	72	136	94	1	64	0.0156250
NODE_301981_length_187_cov_56.000000	72	136	96	1	64	0.0156250
NODE_301981_length_187_cov_56.000000	72	136	98	2	64	0.0312500
NODE_301981_length_187_cov_56.000000	72	136	100	4	64	0.0625000
NODE_301981_length_187_cov_56.000000	72	136	102	2	64	0.0312500
NODE_301981_length_187_cov_56.000000	72	136	104	10	64	0.1562500
NODE_301981_length_187_cov_56.000000	72	136	106	27	64	0.4218750
NODE_301981_length_187_cov_56.000000	109	175	14	1	66	0.0151515
NODE_301981_length_187_cov_56.000000	109	175	16	4	66	0.0606061
NODE_301981_length_187_cov_56.000000	109	175	18	3	66	0.0454545
NODE_301981_length_187_cov_56.000000	109	175	20	10	66	0.1515152
NODE_301981_length_187_cov_56.000000	109	175	22	5	66	0.0757576
NODE_301981_length_187_cov_56.000000	109	175	25	1	66	0.0151515
NODE_301981_length_187_cov_56.000000	109	175	27	1	66	0.0151515
NODE_301981_length_187_cov_56.000000	109	175	31	1	66	0.0151515
NODE_301981_length_187_cov_56.000000	109	175	33	1	66	0.0151515
NODE_301981_length_187_cov_56.000000	109	175	36	1	66	0.0151515
NODE_301981_length_187_cov_56.000000	109	175	43	1	66	0.0151515
NODE_301981_length_187_cov_56.000000	109	175	46	4	66	0.0606061
NODE_301981_length_187_cov_56.000000	109	175	48	1	66	0.0151515
NODE_301981_length_187_cov_56.000000	109	175	52	1	66	0.0151515
NODE_301981_length_187_cov_56.000000	109	175	57	1	66	0.0151515
NODE_301981_length_187_cov_56.000000	109	175	59	2	66	0.0303030
NODE_301981_length_187_cov_56.000000	109	175	61	2	66	0.0303030
NODE_301981_length_187_cov_56.000000	109	175	64	4	66	0.0606061
NODE_301981_length_187_cov_56.000000	109	175	66	1	66	0.0151515
NODE_301981_length_187_cov_56.000000	109	175	72	1	66	0.0151515
NODE_301981_length_187_cov_56.000000	109	175	74	3	66	0.0454545
NODE_301981_length_187_cov_56.000000	109	175	78	2	66	0.0303030
NODE_301981_length_187_cov_56.000000	109	175	80	4	66	0.0606061
NODE_301981_length_187_cov_56.000000	109	175	86	1	66	0.0151515
NODE_301981_length_187_cov_56.000000	109	175	94	1	66	0.0151515
NODE_301981_length_187_cov_56.000000	109	175	96	1	66	0.0151515
NODE_301981_length_187_cov_56.000000	109	175	98	1	66	0.0151515
NODE_301981_length_187_cov_56.000000	109	175	100	2	66	0.0303030
NODE_301981_length_187_cov_56.000000	109	175	104	3	66	0.0454545
NODE_301981_length_187_cov_56.000000	109	175	106	2	66	0.0303030
NODE_301981_length_187_cov_56.000000	109	180	4	1	71	0.0140845
NODE_301981_length_187_cov_56.000000	109	180	6	1	71	0.0140845
NODE_301981_length_187_cov_56.000000	109	180	8	1	71	0.0140845
NODE_301981_length_187_cov_56.000000	109	180	9	2	71	0.0281690
NODE_301981_length_187_cov_56.000000	109	180	14	1	71	0.0140845
NODE_301981_length_187_cov_56.000000	109	180	16	4	71	0.0563380
NODE_301981_length_187_cov_56.000000	109	180	18	3	71	0.0422535
NODE_301981_length_187_cov_56.000000	109	180	20	10	71	0.1408451
NODE_301981_length_187_cov_56.000000	109	180	22	5	71	0.0704225
NODE_301981_length_187_cov_56.000000	109	180	25	1	71	0.0140845
NODE_301981_length_187_cov_56.000000	109	180	27	1	71	0.0140845
NODE_301981_length_187_cov_56.000000	109	180	31	1	71	0.0140845
NODE_301981_length_187_cov_56.000000	109	180	33	1	71	0.0140845
NODE_301981_length_187_cov_56.000000	109	180	36	1	71	0.0140845
NODE_301981_length_187_cov_56.000000	109	180	43	1	71	0.0140845
NODE_301981_length_187_cov_56.000000	109	180	46	4	71	0.0563380
NODE_301981_length_187_cov_56.000000	109	180	48	1	71	0.0140845
NODE_301981_length_187_cov_56.000000	109	180	52	1	71	0.0140845
NODE_301981_length_187_cov_56.000000	109	180	57	1	71	0.0140845
NODE_301981_length_187_cov_56.000000	109	180	59	2	71	0.0281690
NODE_301981_length_187_cov_56.000000	109	180	61	2	71	0.0281690
NODE_301981_length_187_cov_56.000000	109	180	64	4	71	0.0563380
NODE_301981_length_187_cov_56.000000	109	180	66	1	71	0.0140845
NODE_301981_length_187_cov_56.000000	109	180	72	1	71	0.0140845
NODE_301981_length_187_cov_56.000000	109	180	74	3	71	0.0422535
NODE_301981_length_187_cov_56.000000	109	180	78	2	71	0.0281690
NODE_301981_length_187_cov_56.000000	109	180	80	4	71	0.0563380
NODE_301981_length_187_cov_56.000000	109	180	86	1	71	0.0140845
NODE_301981_length_187_cov_56.000000	109	180	94	1	71	0.0140845
NODE_301981_length_187_cov_56.000000	109	180	96	1	71	0.0140845
NODE_301981_length_187_cov_56.000000	109	180	98	1	71	0.0140845
NODE_301981_length_187_cov_56.000000	109	180	100	2	71	0.0281690
NODE_301981_length_187_cov_56.000000	109	180	104	3	71	0.0422535
NODE_301981_length_187_cov_56.000000	109	180	106	2	71	0.0281690
NODE_301986_length_187_cov_37.397727	4	57	0	20	53	0.3773585
NODE_301986_length_187_cov_37.397727	4	57	2	6	53	0.1132075
NODE_301986_length_187_cov_37.397727	4	57	4	1	53	0.0188679
NODE_301986_length_187_cov_37.397727	4	57	6	6	53	0.1132075
NODE_301986_length_187_cov_37.397727	4	57	10	1	53	0.0188679
NODE_301986_length_187_cov_37.397727	4	57	12	2	53	0.0377358
NODE_301986_length_187_cov_37.397727	4	57	14	2	53	0.0377358
NODE_301986_length_187_cov_37.397727	4	57	16	4	53	0.0754717
NODE_301986_length_187_cov_37.397727	4	57	18	4	53	0.0754717
NODE_301986_length_187_cov_37.397727	4	57	22	4	53	0.0754717
NODE_301986_length_187_cov_37.397727	4	57	26	1	53	0.0188679
NODE_301986_length_187_cov_37.397727	4	57	28	1	53	0.0188679
NODE_301986_length_187_cov_37.397727	4	57	30	1	53	0.0188679
NODE_301986_length_187_cov_37.397727	12	78	0	12	66	0.1818182
NODE_301986_length_187_cov_37.397727	12	78	2	6	66	0.0909091
NODE_301986_length_187_cov_37.397727	12	78	4	1	66	0.0151515
NODE_301986_length_187_cov_37.397727	12	78	6	6	66	0.0909091
NODE_301986_length_187_cov_37.397727	12	78	10	1	66	0.0151515
NODE_301986_length_187_cov_37.397727	12	78	12	2	66	0.0303030
NODE_301986_length_187_cov_37.397727	12	78	14	2	66	0.0303030
NODE_301986_length_187_cov_37.397727	12	78	16	4	66	0.0606061
NODE_301986_length_187_cov_37.397727	12	78	18	4	66	0.0606061
NODE_301986_length_187_cov_37.397727	12	78	22	4	66	0.0606061
NODE_301986_length_187_cov_37.397727	12	78	26	1	66	0.0151515
NODE_301986_length_187_cov_37.397727	12	78	28	1	66	0.0151515
NODE_301986_length_187_cov_37.397727	12	78	30	1	66	0.0151515
NODE_301986_length_187_cov_37.397727	12	78	32	2	66	0.0303030
NODE_301986_length_187_cov_37.397727	12	78	38	1	66	0.0151515
NODE_301986_length_187_cov_37.397727	12	78	40	2	66	0.0303030
NODE_301986_length_187_cov_37.397727	12	78	42	1	66	0.0151515
NODE_301986_length_187_cov_37.397727	12	78	46	2	66	0.0303030
NODE_301986_length_187_cov_37.397727	12	78	48	3	66	0.0454545
NODE_301986_length_187_cov_37.397727	12	78	50	3	66	0.0454545
NODE_301986_length_187_cov_37.397727	12	78	54	7	66	0.1060606
NODE_301986_length_187_cov_37.397727	51	112	22	3	61	0.0491803
NODE_301986_length_187_cov_37.397727	51	112	26	1	61	0.0163934
NODE_301986_length_187_cov_37.397727	51	112	28	1	61	0.0163934
NODE_301986_length_187_cov_37.397727	51	112	30	1	61	0.0163934
NODE_301986_length_187_cov_37.397727	51	112	32	2	61	0.0327869
NODE_301986_length_187_cov_37.397727	51	112	38	1	61	0.0163934
NODE_301986_length_187_cov_37.397727	51	112	40	2	61	0.0327869
NODE_301986_length_187_cov_37.397727	51	112	42	1	61	0.0163934
NODE_301986_length_187_cov_37.397727	51	112	46	2	61	0.0327869
NODE_301986_length_187_cov_37.397727	51	112	48	3	61	0.0491803
NODE_301986_length_187_cov_37.397727	51	112	50	3	61	0.0491803
NODE_301986_length_187_cov_37.397727	51	112	54	17	61	0.2786885
NODE_301986_length_187_cov_37.397727	51	112	56	24	61	0.3934426
NODE_301986_length_187_cov_37.397727	51	114	22	3	63	0.0476190
NODE_301986_length_187_cov_37.397727	51	114	26	1	63	0.0158730
NODE_301986_length_187_cov_37.397727	51	114	28	1	63	0.0158730
NODE_301986_length_187_cov_37.397727	51	114	30	1	63	0.0158730
NODE_301986_length_187_cov_37.397727	51	114	32	2	63	0.0317460
NODE_301986_length_187_cov_37.397727	51	114	38	1	63	0.0158730
NODE_301986_length_187_cov_37.397727	51	114	40	2	63	0.0317460
NODE_301986_length_187_cov_37.397727	51	114	42	1	63	0.0158730
NODE_301986_length_187_cov_37.397727	51	114	46	2	63	0.0317460
NODE_301986_length_187_cov_37.397727	51	114	48	3	63	0.0476190
NODE_301986_length_187_cov_37.397727	51	114	50	3	63	0.0476190
NODE_301986_length_187_cov_37.397727	51	114	52	1	63	0.0158730
NODE_301986_length_187_cov_37.397727	51	114	54	18	63	0.2857143
NODE_301986_length_187_cov_37.397727	51	114	56	24	63	0.3809524
NODE_302020_length_186_cov_309.620690	20	104	0	84	84	1.0000000
NODE_302021_length_186_cov_295.505747	57	115	68	4	58	0.0689655
NODE_302021_length_186_cov_295.505747	57	115	71	1	58	0.0172414
NODE_302021_length_186_cov_295.505747	57	115	72	4	58	0.0689655
NODE_302021_length_186_cov_295.505747	57	115	74	3	58	0.0517241
NODE_302021_length_186_cov_295.505747	57	115	75	1	58	0.0172414
NODE_302021_length_186_cov_295.505747	57	115	76	2	58	0.0344828
NODE_302021_length_186_cov_295.505747	57	115	78	4	58	0.0689655
NODE_302021_length_186_cov_295.505747	57	115	80	6	58	0.1034483
NODE_302021_length_186_cov_295.505747	57	115	82	1	58	0.0172414
NODE_302021_length_186_cov_295.505747	57	115	84	6	58	0.1034483
NODE_302021_length_186_cov_295.505747	57	115	86	26	58	0.4482759
NODE_302021_length_186_cov_295.505747	101	168	10	1	67	0.0149254
NODE_302021_length_186_cov_295.505747	101	168	12	3	67	0.0447761
NODE_302021_length_186_cov_295.505747	101	168	14	1	67	0.0149254
NODE_302021_length_186_cov_295.505747	101	168	16	11	67	0.1641791
NODE_302021_length_186_cov_295.505747	101	168	18	2	67	0.0298507
NODE_302021_length_186_cov_295.505747	101	168	24	2	67	0.0298507
NODE_302021_length_186_cov_295.505747	101	168	26	2	67	0.0298507
NODE_302021_length_186_cov_295.505747	101	168	32	1	67	0.0149254
NODE_302021_length_186_cov_295.505747	101	168	39	1	67	0.0149254
NODE_302021_length_186_cov_295.505747	101	168	41	2	67	0.0298507
NODE_302021_length_186_cov_295.505747	101	168	43	3	67	0.0447761
NODE_302021_length_186_cov_295.505747	101	168	45	5	67	0.0746269
NODE_302021_length_186_cov_295.505747	101	168	47	4	67	0.0597015
NODE_302021_length_186_cov_295.505747	101	168	49	1	67	0.0149254
NODE_302021_length_186_cov_295.505747	101	168	53	1	67	0.0149254
NODE_302021_length_186_cov_295.505747	101	168	57	4	67	0.0597015
NODE_302021_length_186_cov_295.505747	101	168	59	1	67	0.0149254
NODE_302021_length_186_cov_295.505747	101	168	61	2	67	0.0298507
NODE_302021_length_186_cov_295.505747	101	168	63	1	67	0.0149254
NODE_302021_length_186_cov_295.505747	101	168	65	1	67	0.0149254
NODE_302021_length_186_cov_295.505747	101	168	67	1	67	0.0149254
NODE_302021_length_186_cov_295.505747	101	168	69	1	67	0.0149254
NODE_302021_length_186_cov_295.505747	101	168	71	3	67	0.0447761
NODE_302021_length_186_cov_295.505747	101	168	75	1	67	0.0149254
NODE_302021_length_186_cov_295.505747	101	168	76	2	67	0.0298507
NODE_302021_length_186_cov_295.505747	101	168	78	4	67	0.0597015
NODE_302021_length_186_cov_295.505747	101	168	80	3	67	0.0447761
NODE_302021_length_186_cov_295.505747	101	168	82	1	67	0.0149254
NODE_302021_length_186_cov_295.505747	101	168	84	1	67	0.0149254
NODE_302021_length_186_cov_295.505747	101	168	86	1	67	0.0149254
NODE_302025_length_186_cov_61.344828	38	118	2	1	80	0.0125000
NODE_302025_length_186_cov_61.344828	38	118	6	5	80	0.0625000
NODE_302025_length_186_cov_61.344828	38	118	10	6	80	0.0750000
NODE_302025_length_186_cov_61.344828	38	118	12	4	80	0.0500000
NODE_302025_length_186_cov_61.344828	38	118	14	6	80	0.0750000
NODE_302025_length_186_cov_61.344828	38	118	16	13	80	0.1625000
NODE_302025_length_186_cov_61.344828	38	118	20	2	80	0.0250000
NODE_302025_length_186_cov_61.344828	38	118	28	2	80	0.0250000
NODE_302025_length_186_cov_61.344828	38	118	30	41	80	0.5125000
NODE_302025_length_186_cov_61.344828	91	171	4	1	80	0.0125000
NODE_302025_length_186_cov_61.344828	91	171	8	1	80	0.0125000
NODE_302025_length_186_cov_61.344828	91	171	10	3	80	0.0375000
NODE_302025_length_186_cov_61.344828	91	171	11	2	80	0.0250000
NODE_302025_length_186_cov_61.344828	91	171	12	5	80	0.0625000
NODE_302025_length_186_cov_61.344828	91	171	14	8	80	0.1000000
NODE_302025_length_186_cov_61.344828	91	171	16	2	80	0.0250000
NODE_302025_length_186_cov_61.344828	91	171	18	3	80	0.0375000
NODE_302025_length_186_cov_61.344828	91	171	22	1	80	0.0125000
NODE_302025_length_186_cov_61.344828	91	171	24	3	80	0.0375000
NODE_302025_length_186_cov_61.344828	91	171	28	16	80	0.2000000
NODE_302025_length_186_cov_61.344828	91	171	30	35	80	0.4375000
NODE_302201_length_182_cov_127.759036	6	52	14	6	46	0.1304348
NODE_302201_length_182_cov_127.759036	6	52	16	2	46	0.0434783
NODE_302201_length_182_cov_127.759036	6	52	17	1	46	0.0217391
NODE_302201_length_182_cov_127.759036	6	52	19	6	46	0.1304348
NODE_302201_length_182_cov_127.759036	6	52	21	2	46	0.0434783
NODE_302201_length_182_cov_127.759036	6	52	23	3	46	0.0652174
NODE_302201_length_182_cov_127.759036	6	52	27	4	46	0.0869565
NODE_302201_length_182_cov_127.759036	6	52	29	1	46	0.0217391
NODE_302201_length_182_cov_127.759036	6	52	33	1	46	0.0217391
NODE_302201_length_182_cov_127.759036	6	52	35	1	46	0.0217391
NODE_302201_length_182_cov_127.759036	6	52	39	1	46	0.0217391
NODE_302201_length_182_cov_127.759036	6	52	41	1	46	0.0217391
NODE_302201_length_182_cov_127.759036	6	52	44	2	46	0.0434783
NODE_302201_length_182_cov_127.759036	6	52	48	8	46	0.1739130
NODE_302201_length_182_cov_127.759036	6	52	50	1	46	0.0217391
NODE_302201_length_182_cov_127.759036	6	52	51	1	46	0.0217391
NODE_302201_length_182_cov_127.759036	6	52	52	1	46	0.0217391
NODE_302201_length_182_cov_127.759036	6	52	56	4	46	0.0869565
NODE_302201_length_182_cov_127.759036	59	105	70	1	46	0.0217391
NODE_302201_length_182_cov_127.759036	59	105	72	1	46	0.0217391
NODE_302201_length_182_cov_127.759036	59	105	76	2	46	0.0434783
NODE_302201_length_182_cov_127.759036	59	105	78	1	46	0.0217391
NODE_302201_length_182_cov_127.759036	59	105	80	2	46	0.0434783
NODE_302201_length_182_cov_127.759036	59	105	82	2	46	0.0434783
NODE_302201_length_182_cov_127.759036	59	105	94	3	46	0.0652174
NODE_302201_length_182_cov_127.759036	59	105	96	2	46	0.0434783
NODE_302201_length_182_cov_127.759036	59	105	98	2	46	0.0434783
NODE_302201_length_182_cov_127.759036	59	105	100	2	46	0.0434783
NODE_302201_length_182_cov_127.759036	59	105	102	28	46	0.6086956
NODE_302214_length_182_cov_29.421687	5	35	0	2	30	0.0666667
NODE_302214_length_182_cov_29.421687	5	35	4	28	30	0.9333333
NODE_302214_length_182_cov_29.421687	8	88	4	37	80	0.4625000
NODE_302214_length_182_cov_29.421687	8	88	6	2	80	0.0250000
NODE_302214_length_182_cov_29.421687	8	88	8	41	80	0.5125000
NODE_302236_length_181_cov_141.195122	1	60	0	40	59	0.6779661
NODE_302236_length_181_cov_141.195122	1	60	2	19	59	0.3220339
NODE_302236_length_181_cov_141.195122	34	60	0	7	26	0.2692308
NODE_302236_length_181_cov_141.195122	34	60	2	19	26	0.7307692
NODE_302236_length_181_cov_141.195122	114	145	2	9	31	0.2903226
NODE_302236_length_181_cov_141.195122	114	145	4	22	31	0.7096774
NODE_302285_length_180_cov_102.567901	6	75	6	1	69	0.0144928
NODE_302285_length_180_cov_102.567901	6	75	10	2	69	0.0289855
NODE_302285_length_180_cov_102.567901	6	75	15	3	69	0.0434783
NODE_302285_length_180_cov_102.567901	6	75	17	6	69	0.0869565
NODE_302285_length_180_cov_102.567901	6	75	19	1	69	0.0144928
NODE_302285_length_180_cov_102.567901	6	75	27	1	69	0.0144928
NODE_302285_length_180_cov_102.567901	6	75	29	9	69	0.1304348
NODE_302285_length_180_cov_102.567901	6	75	35	1	69	0.0144928
NODE_302285_length_180_cov_102.567901	6	75	37	1	69	0.0144928
NODE_302285_length_180_cov_102.567901	6	75	49	3	69	0.0434783
NODE_302285_length_180_cov_102.567901	6	75	52	1	69	0.0144928
NODE_302285_length_180_cov_102.567901	6	75	54	3	69	0.0434783
NODE_302285_length_180_cov_102.567901	6	75	56	1	69	0.0144928
NODE_302285_length_180_cov_102.567901	6	75	61	1	69	0.0144928
NODE_302285_length_180_cov_102.567901	6	75	66	1	69	0.0144928
NODE_302285_length_180_cov_102.567901	6	75	68	3	69	0.0434783
NODE_302285_length_180_cov_102.567901	6	75	70	1	69	0.0144928
NODE_302285_length_180_cov_102.567901	6	75	76	1	69	0.0144928
NODE_302285_length_180_cov_102.567901	6	75	84	1	69	0.0144928
NODE_302285_length_180_cov_102.567901	6	75	86	2	69	0.0289855
NODE_302285_length_180_cov_102.567901	6	75	90	1	69	0.0144928
NODE_302285_length_180_cov_102.567901	6	75	92	2	69	0.0289855
NODE_302285_length_180_cov_102.567901	6	75	94	3	69	0.0434783
NODE_302285_length_180_cov_102.567901	6	75	98	1	69	0.0144928
NODE_302285_length_180_cov_102.567901	6	75	103	1	69	0.0144928
NODE_302285_length_180_cov_102.567901	6	75	105	1	69	0.0144928
NODE_302285_length_180_cov_102.567901	6	75	107	1	69	0.0144928
NODE_302285_length_180_cov_102.567901	6	75	109	1	69	0.0144928
NODE_302285_length_180_cov_102.567901	6	75	111	1	69	0.0144928
NODE_302285_length_180_cov_102.567901	6	75	112	1	69	0.0144928
NODE_302285_length_180_cov_102.567901	6	75	115	1	69	0.0144928
NODE_302285_length_180_cov_102.567901	6	75	116	1	69	0.0144928
NODE_302285_length_180_cov_102.567901	6	75	122	3	69	0.0434783
NODE_302285_length_180_cov_102.567901	6	75	124	3	69	0.0434783
NODE_302285_length_180_cov_102.567901	6	75	128	1	69	0.0144928
NODE_302285_length_180_cov_102.567901	6	75	132	3	69	0.0434783
NODE_302285_length_180_cov_102.567901	6	75	134	1	69	0.0144928
NODE_302363_length_178_cov_93.620253	81	112	26	7	31	0.2258064
NODE_302363_length_178_cov_93.620253	81	112	28	24	31	0.7741935
NODE_302365_length_178_cov_62.696203	0	78	9	5	78	0.0641026
NODE_302365_length_178_cov_62.696203	0	78	10	15	78	0.1923077
NODE_302365_length_178_cov_62.696203	0	78	12	23	78	0.2948718
NODE_302365_length_178_cov_62.696203	0	78	14	4	78	0.0512821
NODE_302365_length_178_cov_62.696203	0	78	16	15	78	0.1923077
NODE_302365_length_178_cov_62.696203	0	78	18	16	78	0.2051282
NODE_302365_length_178_cov_62.696203	51	131	16	24	80	0.3000000
NODE_302365_length_178_cov_62.696203	51	131	18	56	80	0.7000000
NODE_302477_length_175_cov_116.684211	42	122	6	13	80	0.1625000
NODE_302477_length_175_cov_116.684211	42	122	8	3	80	0.0375000
NODE_302477_length_175_cov_116.684211	42	122	10	10	80	0.1250000
NODE_302477_length_175_cov_116.684211	42	122	12	20	80	0.2500000
NODE_302477_length_175_cov_116.684211	42	122	14	34	80	0.4250000
NODE_302477_length_175_cov_116.684211	95	175	0	11	80	0.1375000
NODE_302477_length_175_cov_116.684211	95	175	2	18	80	0.2250000
NODE_302477_length_175_cov_116.684211	95	175	4	21	80	0.2625000
NODE_302477_length_175_cov_116.684211	95	175	6	1	80	0.0125000
NODE_302477_length_175_cov_116.684211	95	175	8	1	80	0.0125000
NODE_302477_length_175_cov_116.684211	95	175	10	7	80	0.0875000
NODE_302477_length_175_cov_116.684211	95	175	12	12	80	0.1500000
NODE_302477_length_175_cov_116.684211	95	175	14	9	80	0.1125000
NODE_302482_length_175_cov_61.000000	81	121	144	2	40	0.0500000
NODE_302482_length_175_cov_61.000000	81	121	150	5	40	0.1250000
NODE_302482_length_175_cov_61.000000	81	121	154	1	40	0.0250000
NODE_302482_length_175_cov_61.000000	81	121	156	1	40	0.0250000
NODE_302482_length_175_cov_61.000000	81	121	158	5	40	0.1250000
NODE_302482_length_175_cov_61.000000	81	121	160	1	40	0.0250000
NODE_302482_length_175_cov_61.000000	81	121	163	1	40	0.0250000
NODE_302482_length_175_cov_61.000000	81	121	164	1	40	0.0250000
NODE_302482_length_175_cov_61.000000	81	121	166	1	40	0.0250000
NODE_302482_length_175_cov_61.000000	81	121	170	22	40	0.5500000
NODE_302538_length_174_cov_173.893333	53	93	86	1	40	0.0250000
NODE_302538_length_174_cov_173.893333	53	93	90	1	40	0.0250000
NODE_302538_length_174_cov_173.893333	53	93	96	1	40	0.0250000
NODE_302538_length_174_cov_173.893333	53	93	102	3	40	0.0750000
NODE_302538_length_174_cov_173.893333	53	93	104	1	40	0.0250000
NODE_302538_length_174_cov_173.893333	53	93	108	1	40	0.0250000
NODE_302538_length_174_cov_173.893333	53	93	110	2	40	0.0500000
NODE_302538_length_174_cov_173.893333	53	93	112	1	40	0.0250000
NODE_302538_length_174_cov_173.893333	53	93	114	1	40	0.0250000
NODE_302538_length_174_cov_173.893333	53	93	116	2	40	0.0500000
NODE_302538_length_174_cov_173.893333	53	93	118	3	40	0.0750000
NODE_302538_length_174_cov_173.893333	53	93	126	2	40	0.0500000
NODE_302538_length_174_cov_173.893333	53	93	132	21	40	0.5250000
NODE_302543_length_174_cov_50.346667	91	161	4	9	70	0.1285714
NODE_302543_length_174_cov_50.346667	91	161	6	7	70	0.1000000
NODE_302543_length_174_cov_50.346667	91	161	8	12	70	0.1714286
NODE_302543_length_174_cov_50.346667	91	161	10	5	70	0.0714286
NODE_302543_length_174_cov_50.346667	91	161	12	1	70	0.0142857
NODE_302543_length_174_cov_50.346667	91	161	18	7	70	0.1000000
NODE_302543_length_174_cov_50.346667	91	161	20	1	70	0.0142857
NODE_302543_length_174_cov_50.346667	91	161	24	1	70	0.0142857
NODE_302543_length_174_cov_50.346667	91	161	26	1	70	0.0142857
NODE_302543_length_174_cov_50.346667	91	161	30	1	70	0.0142857
NODE_302543_length_174_cov_50.346667	91	161	32	2	70	0.0285714
NODE_302543_length_174_cov_50.346667	91	161	34	2	70	0.0285714
NODE_302543_length_174_cov_50.346667	91	161	37	10	70	0.1428571
NODE_302543_length_174_cov_50.346667	91	161	38	11	70	0.1571429
NODE_302590_length_173_cov_184.351351	62	126	119	4	64	0.0625000
NODE_302590_length_173_cov_184.351351	62	126	121	1	64	0.0156250
NODE_302590_length_173_cov_184.351351	62	126	123	1	64	0.0156250
NODE_302590_length_173_cov_184.351351	62	126	127	1	64	0.0156250
NODE_302590_length_173_cov_184.351351	62	126	129	1	64	0.0156250
NODE_302590_length_173_cov_184.351351	62	126	139	1	64	0.0156250
NODE_302590_length_173_cov_184.351351	62	126	141	1	64	0.0156250
NODE_302590_length_173_cov_184.351351	62	126	145	2	64	0.0312500
NODE_302590_length_173_cov_184.351351	62	126	149	2	64	0.0312500
NODE_302590_length_173_cov_184.351351	62	126	155	2	64	0.0312500
NODE_302590_length_173_cov_184.351351	62	126	157	1	64	0.0156250
NODE_302590_length_173_cov_184.351351	62	126	159	2	64	0.0312500
NODE_302590_length_173_cov_184.351351	62	126	165	1	64	0.0156250
NODE_302590_length_173_cov_184.351351	62	126	169	2	64	0.0312500
NODE_302590_length_173_cov_184.351351	62	126	170	7	64	0.1093750
NODE_302590_length_173_cov_184.351351	62	126	171	11	64	0.1718750
NODE_302590_length_173_cov_184.351351	62	126	172	24	64	0.3750000
NODE_302590_length_173_cov_184.351351	62	126	119	4	64	0.0625000
NODE_302590_length_173_cov_184.351351	62	126	121	1	64	0.0156250
NODE_302590_length_173_cov_184.351351	62	126	123	1	64	0.0156250
NODE_302590_length_173_cov_184.351351	62	126	127	1	64	0.0156250
NODE_302590_length_173_cov_184.351351	62	126	129	1	64	0.0156250
NODE_302590_length_173_cov_184.351351	62	126	139	1	64	0.0156250
NODE_302590_length_173_cov_184.351351	62	126	141	1	64	0.0156250
NODE_302590_length_173_cov_184.351351	62	126	145	2	64	0.0312500
NODE_302590_length_173_cov_184.351351	62	126	149	2	64	0.0312500
NODE_302590_length_173_cov_184.351351	62	126	155	2	64	0.0312500
NODE_302590_length_173_cov_184.351351	62	126	157	1	64	0.0156250
NODE_302590_length_173_cov_184.351351	62	126	159	2	64	0.0312500
NODE_302590_length_173_cov_184.351351	62	126	165	1	64	0.0156250
NODE_302590_length_173_cov_184.351351	62	126	169	2	64	0.0312500
NODE_302590_length_173_cov_184.351351	62	126	170	7	64	0.1093750
NODE_302590_length_173_cov_184.351351	62	126	171	11	64	0.1718750
NODE_302590_length_173_cov_184.351351	62	126	172	24	64	0.3750000
NODE_302590_length_173_cov_184.351351	62	126	119	4	64	0.0625000
NODE_302590_length_173_cov_184.351351	62	126	121	1	64	0.0156250
NODE_302590_length_173_cov_184.351351	62	126	123	1	64	0.0156250
NODE_302590_length_173_cov_184.351351	62	126	127	1	64	0.0156250
NODE_302590_length_173_cov_184.351351	62	126	129	1	64	0.0156250
NODE_302590_length_173_cov_184.351351	62	126	139	1	64	0.0156250
NODE_302590_length_173_cov_184.351351	62	126	141	1	64	0.0156250
NODE_302590_length_173_cov_184.351351	62	126	145	2	64	0.0312500
NODE_302590_length_173_cov_184.351351	62	126	149	2	64	0.0312500
NODE_302590_length_173_cov_184.351351	62	126	155	2	64	0.0312500
NODE_302590_length_173_cov_184.351351	62	126	157	1	64	0.0156250
NODE_302590_length_173_cov_184.351351	62	126	159	2	64	0.0312500
NODE_302590_length_173_cov_184.351351	62	126	165	1	64	0.0156250
NODE_302590_length_173_cov_184.351351	62	126	169	2	64	0.0312500
NODE_302590_length_173_cov_184.351351	62	126	170	7	64	0.1093750
NODE_302590_length_173_cov_184.351351	62	126	171	11	64	0.1718750
NODE_302590_length_173_cov_184.351351	62	126	172	24	64	0.3750000
NODE_302590_length_173_cov_184.351351	62	126	119	4	64	0.0625000
NODE_302590_length_173_cov_184.351351	62	126	121	1	64	0.0156250
NODE_302590_length_173_cov_184.351351	62	126	123	1	64	0.0156250
NODE_302590_length_173_cov_184.351351	62	126	127	1	64	0.0156250
NODE_302590_length_173_cov_184.351351	62	126	129	1	64	0.0156250
NODE_302590_length_173_cov_184.351351	62	126	139	1	64	0.0156250
NODE_302590_length_173_cov_184.351351	62	126	141	1	64	0.0156250
NODE_302590_length_173_cov_184.351351	62	126	145	2	64	0.0312500
NODE_302590_length_173_cov_184.351351	62	126	149	2	64	0.0312500
NODE_302590_length_173_cov_184.351351	62	126	155	2	64	0.0312500
NODE_302590_length_173_cov_184.351351	62	126	157	1	64	0.0156250
NODE_302590_length_173_cov_184.351351	62	126	159	2	64	0.0312500
NODE_302590_length_173_cov_184.351351	62	126	165	1	64	0.0156250
NODE_302590_length_173_cov_184.351351	62	126	169	2	64	0.0312500
NODE_302590_length_173_cov_184.351351	62	126	170	7	64	0.1093750
NODE_302590_length_173_cov_184.351351	62	126	171	11	64	0.1718750
NODE_302590_length_173_cov_184.351351	62	126	172	24	64	0.3750000
NODE_302590_length_173_cov_184.351351	99	165	8	3	66	0.0454545
NODE_302590_length_173_cov_184.351351	99	165	10	1	66	0.0151515
NODE_302590_length_173_cov_184.351351	99	165	14	1	66	0.0151515
NODE_302590_length_173_cov_184.351351	99	165	20	1	66	0.0151515
NODE_302590_length_173_cov_184.351351	99	165	26	2	66	0.0303030
NODE_302590_length_173_cov_184.351351	99	165	29	2	66	0.0303030
NODE_302590_length_173_cov_184.351351	99	165	31	2	66	0.0303030
NODE_302590_length_173_cov_184.351351	99	165	33	4	66	0.0606061
NODE_302590_length_173_cov_184.351351	99	165	37	2	66	0.0303030
NODE_302590_length_173_cov_184.351351	99	165	38	1	66	0.0151515
NODE_302590_length_173_cov_184.351351	99	165	45	1	66	0.0151515
NODE_302590_length_173_cov_184.351351	99	165	47	1	66	0.0151515
NODE_302590_length_173_cov_184.351351	99	165	49	2	66	0.0303030
NODE_302590_length_173_cov_184.351351	99	165	53	1	66	0.0151515
NODE_302590_length_173_cov_184.351351	99	165	57	1	66	0.0151515
NODE_302590_length_173_cov_184.351351	99	165	66	1	66	0.0151515
NODE_302590_length_173_cov_184.351351	99	165	67	2	66	0.0303030
NODE_302590_length_173_cov_184.351351	99	165	71	1	66	0.0151515
NODE_302590_length_173_cov_184.351351	99	165	73	1	66	0.0151515
NODE_302590_length_173_cov_184.351351	99	165	79	2	66	0.0303030
NODE_302590_length_173_cov_184.351351	99	165	91	1	66	0.0151515
NODE_302590_length_173_cov_184.351351	99	165	94	1	66	0.0151515
NODE_302590_length_173_cov_184.351351	99	165	102	2	66	0.0303030
NODE_302590_length_173_cov_184.351351	99	165	107	1	66	0.0151515
NODE_302590_length_173_cov_184.351351	99	165	109	2	66	0.0303030
NODE_302590_length_173_cov_184.351351	99	165	119	4	66	0.0606061
NODE_302590_length_173_cov_184.351351	99	165	121	1	66	0.0151515
NODE_302590_length_173_cov_184.351351	99	165	123	1	66	0.0151515
NODE_302590_length_173_cov_184.351351	99	165	127	1	66	0.0151515
NODE_302590_length_173_cov_184.351351	99	165	129	1	66	0.0151515
NODE_302590_length_173_cov_184.351351	99	165	139	1	66	0.0151515
NODE_302590_length_173_cov_184.351351	99	165	141	1	66	0.0151515
NODE_302590_length_173_cov_184.351351	99	165	145	2	66	0.0303030
NODE_302590_length_173_cov_184.351351	99	165	149	2	66	0.0303030
NODE_302590_length_173_cov_184.351351	99	165	155	2	66	0.0303030
NODE_302590_length_173_cov_184.351351	99	165	157	1	66	0.0151515
NODE_302590_length_173_cov_184.351351	99	165	159	2	66	0.0303030
NODE_302590_length_173_cov_184.351351	99	165	165	1	66	0.0151515
NODE_302590_length_173_cov_184.351351	99	165	169	2	66	0.0303030
NODE_302590_length_173_cov_184.351351	99	165	171	5	66	0.0757576
NODE_302590_length_173_cov_184.351351	99	170	6	2	71	0.0281690
NODE_302590_length_173_cov_184.351351	99	170	8	6	71	0.0845070
NODE_302590_length_173_cov_184.351351	99	170	10	1	71	0.0140845
NODE_302590_length_173_cov_184.351351	99	170	14	1	71	0.0140845
NODE_302590_length_173_cov_184.351351	99	170	20	1	71	0.0140845
NODE_302590_length_173_cov_184.351351	99	170	26	2	71	0.0281690
NODE_302590_length_173_cov_184.351351	99	170	29	2	71	0.0281690
NODE_302590_length_173_cov_184.351351	99	170	31	2	71	0.0281690
NODE_302590_length_173_cov_184.351351	99	170	33	4	71	0.0563380
NODE_302590_length_173_cov_184.351351	99	170	37	2	71	0.0281690
NODE_302590_length_173_cov_184.351351	99	170	38	1	71	0.0140845
NODE_302590_length_173_cov_184.351351	99	170	45	1	71	0.0140845
NODE_302590_length_173_cov_184.351351	99	170	47	1	71	0.0140845
NODE_302590_length_173_cov_184.351351	99	170	49	2	71	0.0281690
NODE_302590_length_173_cov_184.351351	99	170	53	1	71	0.0140845
NODE_302590_length_173_cov_184.351351	99	170	57	1	71	0.0140845
NODE_302590_length_173_cov_184.351351	99	170	66	1	71	0.0140845
NODE_302590_length_173_cov_184.351351	99	170	67	2	71	0.0281690
NODE_302590_length_173_cov_184.351351	99	170	71	1	71	0.0140845
NODE_302590_length_173_cov_184.351351	99	170	73	1	71	0.0140845
NODE_302590_length_173_cov_184.351351	99	170	79	2	71	0.0281690
NODE_302590_length_173_cov_184.351351	99	170	91	1	71	0.0140845
NODE_302590_length_173_cov_184.351351	99	170	94	1	71	0.0140845
NODE_302590_length_173_cov_184.351351	99	170	102	2	71	0.0281690
NODE_302590_length_173_cov_184.351351	99	170	107	1	71	0.0140845
NODE_302590_length_173_cov_184.351351	99	170	109	2	71	0.0281690
NODE_302590_length_173_cov_184.351351	99	170	119	4	71	0.0563380
NODE_302590_length_173_cov_184.351351	99	170	121	1	71	0.0140845
NODE_302590_length_173_cov_184.351351	99	170	123	1	71	0.0140845
NODE_302590_length_173_cov_184.351351	99	170	127	1	71	0.0140845
NODE_302590_length_173_cov_184.351351	99	170	129	1	71	0.0140845
NODE_302590_length_173_cov_184.351351	99	170	139	1	71	0.0140845
NODE_302590_length_173_cov_184.351351	99	170	141	1	71	0.0140845
NODE_302590_length_173_cov_184.351351	99	170	145	2	71	0.0281690
NODE_302590_length_173_cov_184.351351	99	170	149	2	71	0.0281690
NODE_302590_length_173_cov_184.351351	99	170	155	2	71	0.0281690
NODE_302590_length_173_cov_184.351351	99	170	157	1	71	0.0140845
NODE_302590_length_173_cov_184.351351	99	170	159	2	71	0.0281690
NODE_302590_length_173_cov_184.351351	99	170	165	1	71	0.0140845
NODE_302590_length_173_cov_184.351351	99	170	169	2	71	0.0281690
NODE_302590_length_173_cov_184.351351	99	170	171	5	71	0.0704225
NODE_302590_length_173_cov_184.351351	115	173	0	1	58	0.0172414
NODE_302590_length_173_cov_184.351351	115	173	4	1	58	0.0172414
NODE_302590_length_173_cov_184.351351	115	173	6	3	58	0.0517241
NODE_302590_length_173_cov_184.351351	115	173	8	6	58	0.1034483
NODE_302590_length_173_cov_184.351351	115	173	10	1	58	0.0172414
NODE_302590_length_173_cov_184.351351	115	173	14	1	58	0.0172414
NODE_302590_length_173_cov_184.351351	115	173	20	1	58	0.0172414
NODE_302590_length_173_cov_184.351351	115	173	26	2	58	0.0344828
NODE_302590_length_173_cov_184.351351	115	173	29	2	58	0.0344828
NODE_302590_length_173_cov_184.351351	115	173	31	2	58	0.0344828
NODE_302590_length_173_cov_184.351351	115	173	33	4	58	0.0689655
NODE_302590_length_173_cov_184.351351	115	173	37	2	58	0.0344828
NODE_302590_length_173_cov_184.351351	115	173	38	1	58	0.0172414
NODE_302590_length_173_cov_184.351351	115	173	45	1	58	0.0172414
NODE_302590_length_173_cov_184.351351	115	173	47	1	58	0.0172414
NODE_302590_length_173_cov_184.351351	115	173	49	2	58	0.0344828
NODE_302590_length_173_cov_184.351351	115	173	53	1	58	0.0172414
NODE_302590_length_173_cov_184.351351	115	173	57	1	58	0.0172414
NODE_302590_length_173_cov_184.351351	115	173	66	1	58	0.0172414
NODE_302590_length_173_cov_184.351351	115	173	67	2	58	0.0344828
NODE_302590_length_173_cov_184.351351	115	173	71	1	58	0.0172414
NODE_302590_length_173_cov_184.351351	115	173	73	1	58	0.0172414
NODE_302590_length_173_cov_184.351351	115	173	79	2	58	0.0344828
NODE_302590_length_173_cov_184.351351	115	173	91	1	58	0.0172414
NODE_302590_length_173_cov_184.351351	115	173	94	1	58	0.0172414
NODE_302590_length_173_cov_184.351351	115	173	102	2	58	0.0344828
NODE_302590_length_173_cov_184.351351	115	173	107	1	58	0.0172414
NODE_302590_length_173_cov_184.351351	115	173	109	2	58	0.0344828
NODE_302590_length_173_cov_184.351351	115	173	119	4	58	0.0689655
NODE_302590_length_173_cov_184.351351	115	173	121	1	58	0.0172414
NODE_302590_length_173_cov_184.351351	115	173	123	1	58	0.0172414
NODE_302590_length_173_cov_184.351351	115	173	127	1	58	0.0172414
NODE_302590_length_173_cov_184.351351	115	173	129	1	58	0.0172414
NODE_302590_length_173_cov_184.351351	115	173	139	1	58	0.0172414
NODE_302590_length_173_cov_184.351351	115	173	141	1	58	0.0172414
NODE_302590_length_173_cov_184.351351	115	173	145	1	58	0.0172414
NODE_302596_length_173_cov_58.472973	0	78	0	17	78	0.2179487
NODE_302596_length_173_cov_58.472973	0	78	2	14	78	0.1794872
NODE_302596_length_173_cov_58.472973	0	78	4	5	78	0.0641026
NODE_302596_length_173_cov_58.472973	0	78	5	5	78	0.0641026
NODE_302596_length_173_cov_58.472973	0	78	7	3	78	0.0384615
NODE_302596_length_173_cov_58.472973	0	78	8	1	78	0.0128205
NODE_302596_length_173_cov_58.472973	0	78	9	1	78	0.0128205
NODE_302596_length_173_cov_58.472973	0	78	11	1	78	0.0128205
NODE_302596_length_173_cov_58.472973	0	78	14	3	78	0.0384615
NODE_302596_length_173_cov_58.472973	0	78	16	2	78	0.0256410
NODE_302596_length_173_cov_58.472973	0	78	18	5	78	0.0641026
NODE_302596_length_173_cov_58.472973	0	78	20	6	78	0.0769231
NODE_302596_length_173_cov_58.472973	0	78	22	1	78	0.0128205
NODE_302596_length_173_cov_58.472973	0	78	24	4	78	0.0512821
NODE_302596_length_173_cov_58.472973	0	78	26	10	78	0.1282051
NODE_302597_length_173_cov_57.148649	101	142	49	1	41	0.0243902
NODE_302597_length_173_cov_57.148649	101	142	51	1	41	0.0243902
NODE_302597_length_173_cov_57.148649	101	142	53	4	41	0.0975610
NODE_302597_length_173_cov_57.148649	101	142	55	1	41	0.0243902
NODE_302597_length_173_cov_57.148649	101	142	57	1	41	0.0243902
NODE_302597_length_173_cov_57.148649	101	142	59	5	41	0.1219512
NODE_302597_length_173_cov_57.148649	101	142	61	3	41	0.0731707
NODE_302597_length_173_cov_57.148649	101	142	63	1	41	0.0243902
NODE_302597_length_173_cov_57.148649	101	142	67	2	41	0.0487805
NODE_302597_length_173_cov_57.148649	101	142	69	1	41	0.0243902
NODE_302597_length_173_cov_57.148649	101	142	71	1	41	0.0243902
NODE_302597_length_173_cov_57.148649	101	142	75	6	41	0.1463415
NODE_302597_length_173_cov_57.148649	101	142	77	1	41	0.0243902
NODE_302597_length_173_cov_57.148649	101	142	82	1	41	0.0243902
NODE_302597_length_173_cov_57.148649	101	142	83	1	41	0.0243902
NODE_302597_length_173_cov_57.148649	101	142	85	1	41	0.0243902
NODE_302597_length_173_cov_57.148649	101	142	87	1	41	0.0243902
NODE_302597_length_173_cov_57.148649	101	142	91	1	41	0.0243902
NODE_302597_length_173_cov_57.148649	101	142	93	2	41	0.0487805
NODE_302597_length_173_cov_57.148649	101	142	95	5	41	0.1219512
NODE_302597_length_173_cov_57.148649	101	142	97	1	41	0.0243902
NODE_302597_length_173_cov_57.148649	109	173	10	4	64	0.0625000
NODE_302597_length_173_cov_57.148649	109	173	12	2	64	0.0312500
NODE_302597_length_173_cov_57.148649	109	173	16	3	64	0.0468750
NODE_302597_length_173_cov_57.148649	109	173	18	1	64	0.0156250
NODE_302597_length_173_cov_57.148649	109	173	19	1	64	0.0156250
NODE_302597_length_173_cov_57.148649	109	173	21	5	64	0.0781250
NODE_302597_length_173_cov_57.148649	109	173	23	2	64	0.0312500
NODE_302597_length_173_cov_57.148649	109	173	29	1	64	0.0156250
NODE_302597_length_173_cov_57.148649	109	173	30	1	64	0.0156250
NODE_302597_length_173_cov_57.148649	109	173	32	1	64	0.0156250
NODE_302597_length_173_cov_57.148649	109	173	35	1	64	0.0156250
NODE_302597_length_173_cov_57.148649	109	173	37	1	64	0.0156250
NODE_302597_length_173_cov_57.148649	109	173	43	1	64	0.0156250
NODE_302597_length_173_cov_57.148649	109	173	45	3	64	0.0468750
NODE_302597_length_173_cov_57.148649	109	173	47	1	64	0.0156250
NODE_302597_length_173_cov_57.148649	109	173	49	4	64	0.0625000
NODE_302597_length_173_cov_57.148649	109	173	51	1	64	0.0156250
NODE_302597_length_173_cov_57.148649	109	173	53	4	64	0.0625000
NODE_302597_length_173_cov_57.148649	109	173	55	1	64	0.0156250
NODE_302597_length_173_cov_57.148649	109	173	57	1	64	0.0156250
NODE_302597_length_173_cov_57.148649	109	173	59	5	64	0.0781250
NODE_302597_length_173_cov_57.148649	109	173	61	3	64	0.0468750
NODE_302597_length_173_cov_57.148649	109	173	63	1	64	0.0156250
NODE_302597_length_173_cov_57.148649	109	173	67	2	64	0.0312500
NODE_302597_length_173_cov_57.148649	109	173	69	1	64	0.0156250
NODE_302597_length_173_cov_57.148649	109	173	71	1	64	0.0156250
NODE_302597_length_173_cov_57.148649	109	173	75	6	64	0.0937500
NODE_302597_length_173_cov_57.148649	109	173	77	1	64	0.0156250
NODE_302597_length_173_cov_57.148649	109	173	82	1	64	0.0156250
NODE_302597_length_173_cov_57.148649	109	173	83	1	64	0.0156250
NODE_302597_length_173_cov_57.148649	109	173	85	1	64	0.0156250
NODE_302597_length_173_cov_57.148649	109	173	87	1	64	0.0156250
NODE_302597_length_173_cov_57.148649	109	173	91	1	64	0.0156250
NODE_302686_length_171_cov_218.666667	12	90	6	13	78	0.1666667
NODE_302686_length_171_cov_218.666667	12	90	8	4	78	0.0512821
NODE_302686_length_171_cov_218.666667	12	90	10	1	78	0.0128205
NODE_302686_length_171_cov_218.666667	12	90	12	1	78	0.0128205
NODE_302686_length_171_cov_218.666667	12	90	16	8	78	0.1025641
NODE_302686_length_171_cov_218.666667	12	90	18	4	78	0.0512821
NODE_302686_length_171_cov_218.666667	12	90	20	18	78	0.2307692
NODE_302686_length_171_cov_218.666667	12	90	22	2	78	0.0256410
NODE_302686_length_171_cov_218.666667	12	90	24	2	78	0.0256410
NODE_302686_length_171_cov_218.666667	12	90	26	25	78	0.3205128
NODE_302686_length_171_cov_218.666667	12	90	6	13	78	0.1666667
NODE_302686_length_171_cov_218.666667	12	90	8	4	78	0.0512821
NODE_302686_length_171_cov_218.666667	12	90	10	1	78	0.0128205
NODE_302686_length_171_cov_218.666667	12	90	12	1	78	0.0128205
NODE_302686_length_171_cov_218.666667	12	90	16	8	78	0.1025641
NODE_302686_length_171_cov_218.666667	12	90	18	4	78	0.0512821
NODE_302686_length_171_cov_218.666667	12	90	20	18	78	0.2307692
NODE_302686_length_171_cov_218.666667	12	90	22	2	78	0.0256410
NODE_302686_length_171_cov_218.666667	12	90	24	2	78	0.0256410
NODE_302686_length_171_cov_218.666667	12	90	26	25	78	0.3205128
NODE_302686_length_171_cov_218.666667	21	90	6	4	69	0.0579710
NODE_302686_length_171_cov_218.666667	21	90	8	4	69	0.0579710
NODE_302686_length_171_cov_218.666667	21	90	10	1	69	0.0144928
NODE_302686_length_171_cov_218.666667	21	90	12	1	69	0.0144928
NODE_302686_length_171_cov_218.666667	21	90	16	8	69	0.1159420
NODE_302686_length_171_cov_218.666667	21	90	18	4	69	0.0579710
NODE_302686_length_171_cov_218.666667	21	90	20	18	69	0.2608696
NODE_302686_length_171_cov_218.666667	21	90	22	2	69	0.0289855
NODE_302686_length_171_cov_218.666667	21	90	24	2	69	0.0289855
NODE_302686_length_171_cov_218.666667	21	90	26	25	69	0.3623188
NODE_302689_length_171_cov_110.194444	81	161	2	2	80	0.0250000
NODE_302689_length_171_cov_110.194444	81	161	4	78	80	0.9750000
NODE_302689_length_171_cov_110.194444	81	152	4	71	71	1.0000000
NODE_302691_length_171_cov_86.013889	106	171	0	17	65	0.2615385
NODE_302691_length_171_cov_86.013889	106	171	2	18	65	0.2769231
NODE_302691_length_171_cov_86.013889	106	171	4	30	65	0.4615385
NODE_302697_length_171_cov_46.430556	0	59	2	5	59	0.0847458
NODE_302697_length_171_cov_46.430556	0	59	4	2	59	0.0338983
NODE_302697_length_171_cov_46.430556	0	59	8	3	59	0.0508475
NODE_302697_length_171_cov_46.430556	0	59	12	5	59	0.0847458
NODE_302697_length_171_cov_46.430556	0	59	14	4	59	0.0677966
NODE_302697_length_171_cov_46.430556	0	59	16	4	59	0.0677966
NODE_302697_length_171_cov_46.430556	0	59	18	2	59	0.0338983
NODE_302697_length_171_cov_46.430556	0	59	20	5	59	0.0847458
NODE_302697_length_171_cov_46.430556	0	59	22	2	59	0.0338983
NODE_302697_length_171_cov_46.430556	0	59	24	2	59	0.0338983
NODE_302697_length_171_cov_46.430556	0	59	30	1	59	0.0169492
NODE_302697_length_171_cov_46.430556	0	59	32	1	59	0.0169492
NODE_302697_length_171_cov_46.430556	0	59	38	2	59	0.0338983
NODE_302697_length_171_cov_46.430556	0	59	44	2	59	0.0338983
NODE_302697_length_171_cov_46.430556	0	59	48	3	59	0.0508475
NODE_302697_length_171_cov_46.430556	0	59	50	3	59	0.0508475
NODE_302697_length_171_cov_46.430556	0	59	51	1	59	0.0169492
NODE_302697_length_171_cov_46.430556	0	59	52	1	59	0.0169492
NODE_302697_length_171_cov_46.430556	0	59	54	2	59	0.0338983
NODE_302697_length_171_cov_46.430556	0	59	56	3	59	0.0508475
NODE_302697_length_171_cov_46.430556	0	59	58	3	59	0.0508475
NODE_302697_length_171_cov_46.430556	0	59	60	2	59	0.0338983
NODE_302697_length_171_cov_46.430556	0	59	68	1	59	0.0169492
NODE_302697_length_171_cov_46.430556	32	98	24	2	66	0.0303030
NODE_302697_length_171_cov_46.430556	32	98	30	1	66	0.0151515
NODE_302697_length_171_cov_46.430556	32	98	32	1	66	0.0151515
NODE_302697_length_171_cov_46.430556	32	98	38	2	66	0.0303030
NODE_302697_length_171_cov_46.430556	32	98	44	2	66	0.0303030
NODE_302697_length_171_cov_46.430556	32	98	48	3	66	0.0454545
NODE_302697_length_171_cov_46.430556	32	98	50	3	66	0.0454545
NODE_302697_length_171_cov_46.430556	32	98	51	1	66	0.0151515
NODE_302697_length_171_cov_46.430556	32	98	52	1	66	0.0151515
NODE_302697_length_171_cov_46.430556	32	98	54	2	66	0.0303030
NODE_302697_length_171_cov_46.430556	32	98	56	3	66	0.0454545
NODE_302697_length_171_cov_46.430556	32	98	58	3	66	0.0454545
NODE_302697_length_171_cov_46.430556	32	98	60	2	66	0.0303030
NODE_302697_length_171_cov_46.430556	32	98	68	1	66	0.0151515
NODE_302697_length_171_cov_46.430556	32	98	70	2	66	0.0303030
NODE_302697_length_171_cov_46.430556	32	98	72	1	66	0.0151515
NODE_302697_length_171_cov_46.430556	32	98	78	1	66	0.0151515
NODE_302697_length_171_cov_46.430556	32	98	82	1	66	0.0151515
NODE_302697_length_171_cov_46.430556	32	98	86	4	66	0.0606061
NODE_302697_length_171_cov_46.430556	32	98	88	30	66	0.4545455
NODE_302700_length_171_cov_40.069444	13	87	0	74	74	1.0000000
NODE_302702_length_171_cov_33.319444	84	158	0	47	74	0.6351351
NODE_302702_length_171_cov_33.319444	84	158	4	27	74	0.3648649
NODE_302764_length_170_cov_217.422535	10	90	18	2	80	0.0250000
NODE_302764_length_170_cov_217.422535	10	90	24	5	80	0.0625000
NODE_302764_length_170_cov_217.422535	10	90	30	1	80	0.0125000
NODE_302764_length_170_cov_217.422535	10	90	32	5	80	0.0625000
NODE_302764_length_170_cov_217.422535	10	90	34	1	80	0.0125000
NODE_302764_length_170_cov_217.422535	10	90	36	2	80	0.0250000
NODE_302764_length_170_cov_217.422535	10	90	38	1	80	0.0125000
NODE_302764_length_170_cov_217.422535	10	90	42	6	80	0.0750000
NODE_302764_length_170_cov_217.422535	10	90	44	1	80	0.0125000
NODE_302764_length_170_cov_217.422535	10	90	46	4	80	0.0500000
NODE_302764_length_170_cov_217.422535	10	90	48	4	80	0.0500000
NODE_302764_length_170_cov_217.422535	10	90	53	2	80	0.0250000
NODE_302764_length_170_cov_217.422535	10	90	57	1	80	0.0125000
NODE_302764_length_170_cov_217.422535	10	90	61	2	80	0.0250000
NODE_302764_length_170_cov_217.422535	10	90	67	1	80	0.0125000
NODE_302764_length_170_cov_217.422535	10	90	78	1	80	0.0125000
NODE_302764_length_170_cov_217.422535	10	90	81	3	80	0.0375000
NODE_302764_length_170_cov_217.422535	10	90	83	1	80	0.0125000
NODE_302764_length_170_cov_217.422535	10	90	85	1	80	0.0125000
NODE_302764_length_170_cov_217.422535	10	90	89	3	80	0.0375000
NODE_302764_length_170_cov_217.422535	10	90	91	1	80	0.0125000
NODE_302764_length_170_cov_217.422535	10	90	97	2	80	0.0250000
NODE_302764_length_170_cov_217.422535	10	90	99	1	80	0.0125000
NODE_302764_length_170_cov_217.422535	10	90	101	1	80	0.0125000
NODE_302764_length_170_cov_217.422535	10	90	103	5	80	0.0625000
NODE_302764_length_170_cov_217.422535	10	90	111	2	80	0.0250000
NODE_302764_length_170_cov_217.422535	10	90	113	7	80	0.0875000
NODE_302764_length_170_cov_217.422535	10	90	114	14	80	0.1750000
NODE_302764_length_170_cov_217.422535	10	90	18	2	80	0.0250000
NODE_302764_length_170_cov_217.422535	10	90	24	5	80	0.0625000
NODE_302764_length_170_cov_217.422535	10	90	30	1	80	0.0125000
NODE_302764_length_170_cov_217.422535	10	90	32	5	80	0.0625000
NODE_302764_length_170_cov_217.422535	10	90	34	1	80	0.0125000
NODE_302764_length_170_cov_217.422535	10	90	36	2	80	0.0250000
NODE_302764_length_170_cov_217.422535	10	90	38	1	80	0.0125000
NODE_302764_length_170_cov_217.422535	10	90	42	6	80	0.0750000
NODE_302764_length_170_cov_217.422535	10	90	44	1	80	0.0125000
NODE_302764_length_170_cov_217.422535	10	90	46	4	80	0.0500000
NODE_302764_length_170_cov_217.422535	10	90	48	4	80	0.0500000
NODE_302764_length_170_cov_217.422535	10	90	53	2	80	0.0250000
NODE_302764_length_170_cov_217.422535	10	90	57	1	80	0.0125000
NODE_302764_length_170_cov_217.422535	10	90	61	2	80	0.0250000
NODE_302764_length_170_cov_217.422535	10	90	67	1	80	0.0125000
NODE_302764_length_170_cov_217.422535	10	90	78	1	80	0.0125000
NODE_302764_length_170_cov_217.422535	10	90	81	3	80	0.0375000
NODE_302764_length_170_cov_217.422535	10	90	83	1	80	0.0125000
NODE_302764_length_170_cov_217.422535	10	90	85	1	80	0.0125000
NODE_302764_length_170_cov_217.422535	10	90	89	3	80	0.0375000
NODE_302764_length_170_cov_217.422535	10	90	91	1	80	0.0125000
NODE_302764_length_170_cov_217.422535	10	90	97	2	80	0.0250000
NODE_302764_length_170_cov_217.422535	10	90	99	1	80	0.0125000
NODE_302764_length_170_cov_217.422535	10	90	101	1	80	0.0125000
NODE_302764_length_170_cov_217.422535	10	90	103	5	80	0.0625000
NODE_302764_length_170_cov_217.422535	10	90	111	2	80	0.0250000
NODE_302764_length_170_cov_217.422535	10	90	113	7	80	0.0875000
NODE_302764_length_170_cov_217.422535	10	90	114	14	80	0.1750000
NODE_302764_length_170_cov_217.422535	10	90	18	2	80	0.0250000
NODE_302764_length_170_cov_217.422535	10	90	24	5	80	0.0625000
NODE_302764_length_170_cov_217.422535	10	90	30	1	80	0.0125000
NODE_302764_length_170_cov_217.422535	10	90	32	5	80	0.0625000
NODE_302764_length_170_cov_217.422535	10	90	34	1	80	0.0125000
NODE_302764_length_170_cov_217.422535	10	90	36	2	80	0.0250000
NODE_302764_length_170_cov_217.422535	10	90	38	1	80	0.0125000
NODE_302764_length_170_cov_217.422535	10	90	42	6	80	0.0750000
NODE_302764_length_170_cov_217.422535	10	90	44	1	80	0.0125000
NODE_302764_length_170_cov_217.422535	10	90	46	4	80	0.0500000
NODE_302764_length_170_cov_217.422535	10	90	48	4	80	0.0500000
NODE_302764_length_170_cov_217.422535	10	90	53	2	80	0.0250000
NODE_302764_length_170_cov_217.422535	10	90	57	1	80	0.0125000
NODE_302764_length_170_cov_217.422535	10	90	61	2	80	0.0250000
NODE_302764_length_170_cov_217.422535	10	90	67	1	80	0.0125000
NODE_302764_length_170_cov_217.422535	10	90	78	1	80	0.0125000
NODE_302764_length_170_cov_217.422535	10	90	81	3	80	0.0375000
NODE_302764_length_170_cov_217.422535	10	90	83	1	80	0.0125000
NODE_302764_length_170_cov_217.422535	10	90	85	1	80	0.0125000
NODE_302764_length_170_cov_217.422535	10	90	89	3	80	0.0375000
NODE_302764_length_170_cov_217.422535	10	90	91	1	80	0.0125000
NODE_302764_length_170_cov_217.422535	10	90	97	2	80	0.0250000
NODE_302764_length_170_cov_217.422535	10	90	99	1	80	0.0125000
NODE_302764_length_170_cov_217.422535	10	90	101	1	80	0.0125000
NODE_302764_length_170_cov_217.422535	10	90	103	5	80	0.0625000
NODE_302764_length_170_cov_217.422535	10	90	111	2	80	0.0250000
NODE_302764_length_170_cov_217.422535	10	90	113	7	80	0.0875000
NODE_302764_length_170_cov_217.422535	10	90	114	14	80	0.1750000
NODE_302764_length_170_cov_217.422535	10	90	18	2	80	0.0250000
NODE_302764_length_170_cov_217.422535	10	90	24	5	80	0.0625000
NODE_302764_length_170_cov_217.422535	10	90	30	1	80	0.0125000
NODE_302764_length_170_cov_217.422535	10	90	32	5	80	0.0625000
NODE_302764_length_170_cov_217.422535	10	90	34	1	80	0.0125000
NODE_302764_length_170_cov_217.422535	10	90	36	2	80	0.0250000
NODE_302764_length_170_cov_217.422535	10	90	38	1	80	0.0125000
NODE_302764_length_170_cov_217.422535	10	90	42	6	80	0.0750000
NODE_302764_length_170_cov_217.422535	10	90	44	1	80	0.0125000
NODE_302764_length_170_cov_217.422535	10	90	46	4	80	0.0500000
NODE_302764_length_170_cov_217.422535	10	90	48	4	80	0.0500000
NODE_302764_length_170_cov_217.422535	10	90	53	2	80	0.0250000
NODE_302764_length_170_cov_217.422535	10	90	57	1	80	0.0125000
NODE_302764_length_170_cov_217.422535	10	90	61	2	80	0.0250000
NODE_302764_length_170_cov_217.422535	10	90	67	1	80	0.0125000
NODE_302764_length_170_cov_217.422535	10	90	78	1	80	0.0125000
NODE_302764_length_170_cov_217.422535	10	90	81	3	80	0.0375000
NODE_302764_length_170_cov_217.422535	10	90	83	1	80	0.0125000
NODE_302764_length_170_cov_217.422535	10	90	85	1	80	0.0125000
NODE_302764_length_170_cov_217.422535	10	90	89	3	80	0.0375000
NODE_302764_length_170_cov_217.422535	10	90	91	1	80	0.0125000
NODE_302764_length_170_cov_217.422535	10	90	97	2	80	0.0250000
NODE_302764_length_170_cov_217.422535	10	90	99	1	80	0.0125000
NODE_302764_length_170_cov_217.422535	10	90	101	1	80	0.0125000
NODE_302764_length_170_cov_217.422535	10	90	103	5	80	0.0625000
NODE_302764_length_170_cov_217.422535	10	90	111	2	80	0.0250000
NODE_302764_length_170_cov_217.422535	10	90	113	7	80	0.0875000
NODE_302764_length_170_cov_217.422535	10	90	114	14	80	0.1750000
NODE_302764_length_170_cov_217.422535	10	90	18	2	80	0.0250000
NODE_302764_length_170_cov_217.422535	10	90	24	5	80	0.0625000
NODE_302764_length_170_cov_217.422535	10	90	30	1	80	0.0125000
NODE_302764_length_170_cov_217.422535	10	90	32	5	80	0.0625000
NODE_302764_length_170_cov_217.422535	10	90	34	1	80	0.0125000
NODE_302764_length_170_cov_217.422535	10	90	36	2	80	0.0250000
NODE_302764_length_170_cov_217.422535	10	90	38	1	80	0.0125000
NODE_302764_length_170_cov_217.422535	10	90	42	6	80	0.0750000
NODE_302764_length_170_cov_217.422535	10	90	44	1	80	0.0125000
NODE_302764_length_170_cov_217.422535	10	90	46	4	80	0.0500000
NODE_302764_length_170_cov_217.422535	10	90	48	4	80	0.0500000
NODE_302764_length_170_cov_217.422535	10	90	53	2	80	0.0250000
NODE_302764_length_170_cov_217.422535	10	90	57	1	80	0.0125000
NODE_302764_length_170_cov_217.422535	10	90	61	2	80	0.0250000
NODE_302764_length_170_cov_217.422535	10	90	67	1	80	0.0125000
NODE_302764_length_170_cov_217.422535	10	90	78	1	80	0.0125000
NODE_302764_length_170_cov_217.422535	10	90	81	3	80	0.0375000
NODE_302764_length_170_cov_217.422535	10	90	83	1	80	0.0125000
NODE_302764_length_170_cov_217.422535	10	90	85	1	80	0.0125000
NODE_302764_length_170_cov_217.422535	10	90	89	3	80	0.0375000
NODE_302764_length_170_cov_217.422535	10	90	91	1	80	0.0125000
NODE_302764_length_170_cov_217.422535	10	90	97	2	80	0.0250000
NODE_302764_length_170_cov_217.422535	10	90	99	1	80	0.0125000
NODE_302764_length_170_cov_217.422535	10	90	101	1	80	0.0125000
NODE_302764_length_170_cov_217.422535	10	90	103	5	80	0.0625000
NODE_302764_length_170_cov_217.422535	10	90	111	2	80	0.0250000
NODE_302764_length_170_cov_217.422535	10	90	113	7	80	0.0875000
NODE_302764_length_170_cov_217.422535	10	90	114	14	80	0.1750000
NODE_302764_length_170_cov_217.422535	19	90	32	4	71	0.0563380
NODE_302764_length_170_cov_217.422535	19	90	34	1	71	0.0140845
NODE_302764_length_170_cov_217.422535	19	90	36	2	71	0.0281690
NODE_302764_length_170_cov_217.422535	19	90	38	1	71	0.0140845
NODE_302764_length_170_cov_217.422535	19	90	42	6	71	0.0845070
NODE_302764_length_170_cov_217.422535	19	90	44	1	71	0.0140845
NODE_302764_length_170_cov_217.422535	19	90	46	4	71	0.0563380
NODE_302764_length_170_cov_217.422535	19	90	48	4	71	0.0563380
NODE_302764_length_170_cov_217.422535	19	90	53	2	71	0.0281690
NODE_302764_length_170_cov_217.422535	19	90	57	1	71	0.0140845
NODE_302764_length_170_cov_217.422535	19	90	61	2	71	0.0281690
NODE_302764_length_170_cov_217.422535	19	90	67	1	71	0.0140845
NODE_302764_length_170_cov_217.422535	19	90	78	1	71	0.0140845
NODE_302764_length_170_cov_217.422535	19	90	81	3	71	0.0422535
NODE_302764_length_170_cov_217.422535	19	90	83	1	71	0.0140845
NODE_302764_length_170_cov_217.422535	19	90	85	1	71	0.0140845
NODE_302764_length_170_cov_217.422535	19	90	89	3	71	0.0422535
NODE_302764_length_170_cov_217.422535	19	90	91	1	71	0.0140845
NODE_302764_length_170_cov_217.422535	19	90	97	2	71	0.0281690
NODE_302764_length_170_cov_217.422535	19	90	99	1	71	0.0140845
NODE_302764_length_170_cov_217.422535	19	90	101	1	71	0.0140845
NODE_302764_length_170_cov_217.422535	19	90	103	5	71	0.0704225
NODE_302764_length_170_cov_217.422535	19	90	111	2	71	0.0281690
NODE_302764_length_170_cov_217.422535	19	90	113	7	71	0.0985916
NODE_302764_length_170_cov_217.422535	19	90	114	14	71	0.1971831
NODE_302764_length_170_cov_217.422535	63	126	86	1	63	0.0158730
NODE_302764_length_170_cov_217.422535	63	126	92	1	63	0.0158730
NODE_302764_length_170_cov_217.422535	63	126	94	1	63	0.0158730
NODE_302764_length_170_cov_217.422535	63	126	102	1	63	0.0158730
NODE_302764_length_170_cov_217.422535	63	126	103	4	63	0.0634921
NODE_302764_length_170_cov_217.422535	63	126	104	1	63	0.0158730
NODE_302764_length_170_cov_217.422535	63	126	107	1	63	0.0158730
NODE_302764_length_170_cov_217.422535	63	126	109	6	63	0.0952381
NODE_302764_length_170_cov_217.422535	63	126	111	4	63	0.0634921
NODE_302764_length_170_cov_217.422535	63	126	113	7	63	0.1111111
NODE_302764_length_170_cov_217.422535	63	126	114	36	63	0.5714286
NODE_302764_length_170_cov_217.422535	63	126	86	1	63	0.0158730
NODE_302764_length_170_cov_217.422535	63	126	92	1	63	0.0158730
NODE_302764_length_170_cov_217.422535	63	126	94	1	63	0.0158730
NODE_302764_length_170_cov_217.422535	63	126	102	1	63	0.0158730
NODE_302764_length_170_cov_217.422535	63	126	103	4	63	0.0634921
NODE_302764_length_170_cov_217.422535	63	126	104	1	63	0.0158730
NODE_302764_length_170_cov_217.422535	63	126	107	1	63	0.0158730
NODE_302764_length_170_cov_217.422535	63	126	109	6	63	0.0952381
NODE_302764_length_170_cov_217.422535	63	126	111	4	63	0.0634921
NODE_302764_length_170_cov_217.422535	63	126	113	7	63	0.1111111
NODE_302764_length_170_cov_217.422535	63	126	114	36	63	0.5714286
NODE_302768_length_170_cov_102.816901	23	86	12	3	63	0.0476190
NODE_302768_length_170_cov_102.816901	23	86	14	2	63	0.0317460
NODE_302768_length_170_cov_102.816901	23	86	16	7	63	0.1111111
NODE_302768_length_170_cov_102.816901	23	86	18	11	63	0.1746032
NODE_302768_length_170_cov_102.816901	23	86	20	3	63	0.0476190
NODE_302768_length_170_cov_102.816901	23	86	24	5	63	0.0793651
NODE_302768_length_170_cov_102.816901	23	86	26	32	63	0.5079365
NODE_302806_length_169_cov_47.757143	70	150	30	2	80	0.0250000
NODE_302806_length_169_cov_47.757143	70	150	34	12	80	0.1500000
NODE_302806_length_169_cov_47.757143	70	150	36	5	80	0.0625000
NODE_302806_length_169_cov_47.757143	70	150	38	3	80	0.0375000
NODE_302806_length_169_cov_47.757143	70	150	40	3	80	0.0375000
NODE_302806_length_169_cov_47.757143	70	150	46	55	80	0.6875000
NODE_302869_length_168_cov_10.391304	66	99	0	33	33	1.0000000
NODE_302869_length_168_cov_10.391304	135	168	0	33	33	1.0000000
NODE_302966_length_166_cov_401.149254	31	109	48	2	78	0.0256410
NODE_302966_length_166_cov_401.149254	31	109	50	1	78	0.0128205
NODE_302966_length_166_cov_401.149254	31	109	58	1	78	0.0128205
NODE_302966_length_166_cov_401.149254	31	109	68	2	78	0.0256410
NODE_302966_length_166_cov_401.149254	31	109	76	1	78	0.0128205
NODE_302966_length_166_cov_401.149254	31	109	80	1	78	0.0128205
NODE_302966_length_166_cov_401.149254	31	109	92	1	78	0.0128205
NODE_302966_length_166_cov_401.149254	31	109	94	1	78	0.0128205
NODE_302966_length_166_cov_401.149254	31	109	100	1	78	0.0128205
NODE_302966_length_166_cov_401.149254	31	109	102	1	78	0.0128205
NODE_302966_length_166_cov_401.149254	31	109	106	2	78	0.0256410
NODE_302966_length_166_cov_401.149254	31	109	110	1	78	0.0128205
NODE_302966_length_166_cov_401.149254	31	109	119	1	78	0.0128205
NODE_302966_length_166_cov_401.149254	31	109	124	2	78	0.0256410
NODE_302966_length_166_cov_401.149254	31	109	128	1	78	0.0128205
NODE_302966_length_166_cov_401.149254	31	109	130	3	78	0.0384615
NODE_302966_length_166_cov_401.149254	31	109	132	1	78	0.0128205
NODE_302966_length_166_cov_401.149254	31	109	134	1	78	0.0128205
NODE_302966_length_166_cov_401.149254	31	109	136	1	78	0.0128205
NODE_302966_length_166_cov_401.149254	31	109	138	5	78	0.0641026
NODE_302966_length_166_cov_401.149254	31	109	140	48	78	0.6153846
NODE_302966_length_166_cov_401.149254	82	157	14	1	75	0.0133333
NODE_302966_length_166_cov_401.149254	82	157	18	5	75	0.0666667
NODE_302966_length_166_cov_401.149254	82	157	20	2	75	0.0266667
NODE_302966_length_166_cov_401.149254	82	157	22	1	75	0.0133333
NODE_302966_length_166_cov_401.149254	82	157	24	1	75	0.0133333
NODE_302966_length_166_cov_401.149254	82	157	28	2	75	0.0266667
NODE_302966_length_166_cov_401.149254	82	157	34	1	75	0.0133333
NODE_302966_length_166_cov_401.149254	82	157	36	2	75	0.0266667
NODE_302966_length_166_cov_401.149254	82	157	42	1	75	0.0133333
NODE_302966_length_166_cov_401.149254	82	157	46	3	75	0.0400000
NODE_302966_length_166_cov_401.149254	82	157	48	2	75	0.0266667
NODE_302966_length_166_cov_401.149254	82	157	50	2	75	0.0266667
NODE_302966_length_166_cov_401.149254	82	157	52	2	75	0.0266667
NODE_302966_length_166_cov_401.149254	82	157	56	1	75	0.0133333
NODE_302966_length_166_cov_401.149254	82	157	58	1	75	0.0133333
NODE_302966_length_166_cov_401.149254	82	157	60	1	75	0.0133333
NODE_302966_length_166_cov_401.149254	82	157	64	1	75	0.0133333
NODE_302966_length_166_cov_401.149254	82	157	70	1	75	0.0133333
NODE_302966_length_166_cov_401.149254	82	157	74	2	75	0.0266667
NODE_302966_length_166_cov_401.149254	82	157	76	4	75	0.0533333
NODE_302966_length_166_cov_401.149254	82	157	82	1	75	0.0133333
NODE_302966_length_166_cov_401.149254	82	157	89	1	75	0.0133333
NODE_302966_length_166_cov_401.149254	82	157	94	4	75	0.0533333
NODE_302966_length_166_cov_401.149254	82	157	104	2	75	0.0266667
NODE_302966_length_166_cov_401.149254	82	157	112	1	75	0.0133333
NODE_302966_length_166_cov_401.149254	82	157	116	1	75	0.0133333
NODE_302966_length_166_cov_401.149254	82	157	118	1	75	0.0133333
NODE_302966_length_166_cov_401.149254	82	157	130	4	75	0.0533333
NODE_302966_length_166_cov_401.149254	82	157	132	1	75	0.0133333
NODE_302966_length_166_cov_401.149254	82	157	134	1	75	0.0133333
NODE_302966_length_166_cov_401.149254	82	157	140	22	75	0.2933333
NODE_302974_length_166_cov_123.223881	46	97	12	8	51	0.1568628
NODE_302974_length_166_cov_123.223881	46	97	16	43	51	0.8431373
NODE_303071_length_164_cov_154.076923	0	75	0	13	75	0.1733333
NODE_303071_length_164_cov_154.076923	0	75	2	43	75	0.5733333
NODE_303071_length_164_cov_154.076923	0	75	4	19	75	0.2533333
NODE_303071_length_164_cov_154.076923	48	128	0	4	80	0.0500000
NODE_303071_length_164_cov_154.076923	48	128	2	14	80	0.1750000
NODE_303071_length_164_cov_154.076923	48	128	4	62	80	0.7750000
NODE_303074_length_164_cov_69.369231	0	64	0	11	64	0.1718750
NODE_303074_length_164_cov_69.369231	0	64	2	2	64	0.0312500
NODE_303074_length_164_cov_69.369231	0	64	4	12	64	0.1875000
NODE_303074_length_164_cov_69.369231	0	64	6	9	64	0.1406250
NODE_303074_length_164_cov_69.369231	0	64	8	7	64	0.1093750
NODE_303074_length_164_cov_69.369231	0	64	10	23	64	0.3593750
NODE_303079_length_164_cov_43.923077	36	100	21	2	64	0.0312500
NODE_303079_length_164_cov_43.923077	36	100	22	3	64	0.0468750
NODE_303079_length_164_cov_43.923077	36	100	24	14	64	0.2187500
NODE_303079_length_164_cov_43.923077	36	100	26	6	64	0.0937500
NODE_303079_length_164_cov_43.923077	36	100	28	39	64	0.6093750
NODE_303079_length_164_cov_43.923077	36	100	21	2	64	0.0312500
NODE_303079_length_164_cov_43.923077	36	100	22	3	64	0.0468750
NODE_303079_length_164_cov_43.923077	36	100	24	14	64	0.2187500
NODE_303079_length_164_cov_43.923077	36	100	26	6	64	0.0937500
NODE_303079_length_164_cov_43.923077	36	100	28	39	64	0.6093750
NODE_303079_length_164_cov_43.923077	73	153	10	2	80	0.0250000
NODE_303079_length_164_cov_43.923077	73	153	12	2	80	0.0250000
NODE_303079_length_164_cov_43.923077	73	153	13	2	80	0.0250000
NODE_303079_length_164_cov_43.923077	73	153	14	1	80	0.0125000
NODE_303079_length_164_cov_43.923077	73	153	16	6	80	0.0750000
NODE_303079_length_164_cov_43.923077	73	153	18	9	80	0.1125000
NODE_303079_length_164_cov_43.923077	73	153	20	6	80	0.0750000
NODE_303079_length_164_cov_43.923077	73	153	22	3	80	0.0375000
NODE_303079_length_164_cov_43.923077	73	153	24	16	80	0.2000000
NODE_303079_length_164_cov_43.923077	73	153	28	33	80	0.4125000
NODE_303079_length_164_cov_43.923077	73	153	10	2	80	0.0250000
NODE_303079_length_164_cov_43.923077	73	153	12	2	80	0.0250000
NODE_303079_length_164_cov_43.923077	73	153	13	2	80	0.0250000
NODE_303079_length_164_cov_43.923077	73	153	14	1	80	0.0125000
NODE_303079_length_164_cov_43.923077	73	153	16	6	80	0.0750000
NODE_303079_length_164_cov_43.923077	73	153	18	9	80	0.1125000
NODE_303079_length_164_cov_43.923077	73	153	20	6	80	0.0750000
NODE_303079_length_164_cov_43.923077	73	153	22	3	80	0.0375000
NODE_303079_length_164_cov_43.923077	73	153	24	16	80	0.2000000
NODE_303079_length_164_cov_43.923077	73	153	28	33	80	0.4125000
NODE_303079_length_164_cov_43.923077	73	153	10	2	80	0.0250000
NODE_303079_length_164_cov_43.923077	73	153	12	2	80	0.0250000
NODE_303079_length_164_cov_43.923077	73	153	13	2	80	0.0250000
NODE_303079_length_164_cov_43.923077	73	153	14	1	80	0.0125000
NODE_303079_length_164_cov_43.923077	73	153	16	6	80	0.0750000
NODE_303079_length_164_cov_43.923077	73	153	18	9	80	0.1125000
NODE_303079_length_164_cov_43.923077	73	153	20	6	80	0.0750000
NODE_303079_length_164_cov_43.923077	73	153	22	3	80	0.0375000
NODE_303079_length_164_cov_43.923077	73	153	24	16	80	0.2000000
NODE_303079_length_164_cov_43.923077	73	153	28	33	80	0.4125000
NODE_303079_length_164_cov_43.923077	73	153	10	2	80	0.0250000
NODE_303079_length_164_cov_43.923077	73	153	12	2	80	0.0250000
NODE_303079_length_164_cov_43.923077	73	153	13	2	80	0.0250000
NODE_303079_length_164_cov_43.923077	73	153	14	1	80	0.0125000
NODE_303079_length_164_cov_43.923077	73	153	16	6	80	0.0750000
NODE_303079_length_164_cov_43.923077	73	153	18	9	80	0.1125000
NODE_303079_length_164_cov_43.923077	73	153	20	6	80	0.0750000
NODE_303079_length_164_cov_43.923077	73	153	22	3	80	0.0375000
NODE_303079_length_164_cov_43.923077	73	153	24	16	80	0.2000000
NODE_303079_length_164_cov_43.923077	73	153	28	33	80	0.4125000
NODE_303079_length_164_cov_43.923077	73	153	10	2	80	0.0250000
NODE_303079_length_164_cov_43.923077	73	153	12	2	80	0.0250000
NODE_303079_length_164_cov_43.923077	73	153	13	2	80	0.0250000
NODE_303079_length_164_cov_43.923077	73	153	14	1	80	0.0125000
NODE_303079_length_164_cov_43.923077	73	153	16	6	80	0.0750000
NODE_303079_length_164_cov_43.923077	73	153	18	9	80	0.1125000
NODE_303079_length_164_cov_43.923077	73	153	20	6	80	0.0750000
NODE_303079_length_164_cov_43.923077	73	153	22	3	80	0.0375000
NODE_303079_length_164_cov_43.923077	73	153	24	16	80	0.2000000
NODE_303079_length_164_cov_43.923077	73	153	28	33	80	0.4125000
NODE_303079_length_164_cov_43.923077	73	144	16	4	71	0.0563380
NODE_303079_length_164_cov_43.923077	73	144	18	9	71	0.1267606
NODE_303079_length_164_cov_43.923077	73	144	20	6	71	0.0845070
NODE_303079_length_164_cov_43.923077	73	144	22	3	71	0.0422535
NODE_303079_length_164_cov_43.923077	73	144	24	16	71	0.2253521
NODE_303079_length_164_cov_43.923077	73	144	28	33	71	0.4647887
NODE_303135_length_163_cov_480.593750	0	40	0	2	40	0.0500000
NODE_303135_length_163_cov_480.593750	0	40	2	1	40	0.0250000
NODE_303135_length_163_cov_480.593750	0	40	4	1	40	0.0250000
NODE_303135_length_163_cov_480.593750	0	40	6	3	40	0.0750000
NODE_303135_length_163_cov_480.593750	0	40	10	5	40	0.1250000
NODE_303135_length_163_cov_480.593750	0	40	12	1	40	0.0250000
NODE_303135_length_163_cov_480.593750	0	40	14	3	40	0.0750000
NODE_303135_length_163_cov_480.593750	0	40	16	3	40	0.0750000
NODE_303135_length_163_cov_480.593750	0	40	18	2	40	0.0500000
NODE_303135_length_163_cov_480.593750	0	40	22	1	40	0.0250000
NODE_303135_length_163_cov_480.593750	0	40	26	3	40	0.0750000
NODE_303135_length_163_cov_480.593750	0	40	30	1	40	0.0250000
NODE_303135_length_163_cov_480.593750	0	40	34	3	40	0.0750000
NODE_303135_length_163_cov_480.593750	0	40	36	3	40	0.0750000
NODE_303135_length_163_cov_480.593750	0	40	38	2	40	0.0500000
NODE_303135_length_163_cov_480.593750	0	40	40	3	40	0.0750000
NODE_303135_length_163_cov_480.593750	0	40	44	3	40	0.0750000
NODE_303136_length_163_cov_368.000000	24	96	2	7	72	0.0972222
NODE_303136_length_163_cov_368.000000	24	96	4	65	72	0.9027778
NODE_303138_length_163_cov_319.843750	0	68	14	2	68	0.0294118
NODE_303138_length_163_cov_319.843750	0	68	20	3	68	0.0441176
NODE_303138_length_163_cov_319.843750	0	68	21	1	68	0.0147059
NODE_303138_length_163_cov_319.843750	0	68	23	1	68	0.0147059
NODE_303138_length_163_cov_319.843750	0	68	26	9	68	0.1323529
NODE_303138_length_163_cov_319.843750	0	68	28	1	68	0.0147059
NODE_303138_length_163_cov_319.843750	0	68	32	8	68	0.1176471
NODE_303138_length_163_cov_319.843750	0	68	36	3	68	0.0441176
NODE_303138_length_163_cov_319.843750	0	68	39	1	68	0.0147059
NODE_303138_length_163_cov_319.843750	0	68	40	1	68	0.0147059
NODE_303138_length_163_cov_319.843750	0	68	42	5	68	0.0735294
NODE_303138_length_163_cov_319.843750	0	68	43	16	68	0.2352941
NODE_303138_length_163_cov_319.843750	0	68	44	9	68	0.1323529
NODE_303138_length_163_cov_319.843750	0	68	45	8	68	0.1176471
NODE_303139_length_163_cov_198.078125	34	109	16	1	75	0.0133333
NODE_303139_length_163_cov_198.078125	34	109	18	2	75	0.0266667
NODE_303139_length_163_cov_198.078125	34	109	22	1	75	0.0133333
NODE_303139_length_163_cov_198.078125	34	109	24	11	75	0.1466667
NODE_303139_length_163_cov_198.078125	34	109	26	10	75	0.1333333
NODE_303139_length_163_cov_198.078125	34	109	28	50	75	0.6666667
NODE_303139_length_163_cov_198.078125	34	114	16	1	80	0.0125000
NODE_303139_length_163_cov_198.078125	34	114	18	2	80	0.0250000
NODE_303139_length_163_cov_198.078125	34	114	22	1	80	0.0125000
NODE_303139_length_163_cov_198.078125	34	114	24	11	80	0.1375000
NODE_303139_length_163_cov_198.078125	34	114	26	10	80	0.1250000
NODE_303139_length_163_cov_198.078125	34	114	28	55	80	0.6875000
NODE_303139_length_163_cov_198.078125	35	110	18	2	75	0.0266667
NODE_303139_length_163_cov_198.078125	35	110	22	1	75	0.0133333
NODE_303139_length_163_cov_198.078125	35	110	24	11	75	0.1466667
NODE_303139_length_163_cov_198.078125	35	110	26	10	75	0.1333333
NODE_303139_length_163_cov_198.078125	35	110	28	51	75	0.6800000
NODE_303139_length_163_cov_198.078125	87	163	2	9	76	0.1184211
NODE_303139_length_163_cov_198.078125	87	163	3	2	76	0.0263158
NODE_303139_length_163_cov_198.078125	87	163	5	1	76	0.0131579
NODE_303139_length_163_cov_198.078125	87	163	6	2	76	0.0263158
NODE_303139_length_163_cov_198.078125	87	163	8	2	76	0.0263158
NODE_303139_length_163_cov_198.078125	87	163	12	2	76	0.0263158
NODE_303139_length_163_cov_198.078125	87	163	18	8	76	0.1052632
NODE_303139_length_163_cov_198.078125	87	163	20	8	76	0.1052632
NODE_303139_length_163_cov_198.078125	87	163	22	6	76	0.0789474
NODE_303139_length_163_cov_198.078125	87	163	25	1	76	0.0131579
NODE_303139_length_163_cov_198.078125	87	163	26	3	76	0.0394737
NODE_303139_length_163_cov_198.078125	87	163	28	32	76	0.4210526
NODE_303139_length_163_cov_198.078125	87	163	2	9	76	0.1184211
NODE_303139_length_163_cov_198.078125	87	163	3	2	76	0.0263158
NODE_303139_length_163_cov_198.078125	87	163	5	1	76	0.0131579
NODE_303139_length_163_cov_198.078125	87	163	6	2	76	0.0263158
NODE_303139_length_163_cov_198.078125	87	163	8	2	76	0.0263158
NODE_303139_length_163_cov_198.078125	87	163	12	2	76	0.0263158
NODE_303139_length_163_cov_198.078125	87	163	18	8	76	0.1052632
NODE_303139_length_163_cov_198.078125	87	163	20	8	76	0.1052632
NODE_303139_length_163_cov_198.078125	87	163	22	6	76	0.0789474
NODE_303139_length_163_cov_198.078125	87	163	25	1	76	0.0131579
NODE_303139_length_163_cov_198.078125	87	163	26	3	76	0.0394737
NODE_303139_length_163_cov_198.078125	87	163	28	32	76	0.4210526
NODE_303139_length_163_cov_198.078125	87	163	2	9	76	0.1184211
NODE_303139_length_163_cov_198.078125	87	163	3	2	76	0.0263158
NODE_303139_length_163_cov_198.078125	87	163	5	1	76	0.0131579
NODE_303139_length_163_cov_198.078125	87	163	6	2	76	0.0263158
NODE_303139_length_163_cov_198.078125	87	163	8	2	76	0.0263158
NODE_303139_length_163_cov_198.078125	87	163	12	2	76	0.0263158
NODE_303139_length_163_cov_198.078125	87	163	18	8	76	0.1052632
NODE_303139_length_163_cov_198.078125	87	163	20	8	76	0.1052632
NODE_303139_length_163_cov_198.078125	87	163	22	6	76	0.0789474
NODE_303139_length_163_cov_198.078125	87	163	25	1	76	0.0131579
NODE_303139_length_163_cov_198.078125	87	163	26	3	76	0.0394737
NODE_303139_length_163_cov_198.078125	87	163	28	32	76	0.4210526
NODE_303231_length_162_cov_421.047619	7	56	26	1	49	0.0204082
NODE_303231_length_162_cov_421.047619	7	56	28	2	49	0.0408163
NODE_303231_length_162_cov_421.047619	7	56	30	1	49	0.0204082
NODE_303231_length_162_cov_421.047619	7	56	32	2	49	0.0408163
NODE_303231_length_162_cov_421.047619	7	56	44	1	49	0.0204082
NODE_303231_length_162_cov_421.047619	7	56	46	1	49	0.0204082
NODE_303231_length_162_cov_421.047619	7	56	62	3	49	0.0612245
NODE_303231_length_162_cov_421.047619	7	56	66	1	49	0.0204082
NODE_303231_length_162_cov_421.047619	7	56	74	2	49	0.0408163
NODE_303231_length_162_cov_421.047619	7	56	76	2	49	0.0408163
NODE_303231_length_162_cov_421.047619	7	56	78	1	49	0.0204082
NODE_303231_length_162_cov_421.047619	7	56	82	4	49	0.0816327
NODE_303231_length_162_cov_421.047619	7	56	90	1	49	0.0204082
NODE_303231_length_162_cov_421.047619	7	56	98	1	49	0.0204082
NODE_303231_length_162_cov_421.047619	7	56	100	1	49	0.0204082
NODE_303231_length_162_cov_421.047619	7	56	108	1	49	0.0204082
NODE_303231_length_162_cov_421.047619	7	56	110	1	49	0.0204082
NODE_303231_length_162_cov_421.047619	7	56	112	2	49	0.0408163
NODE_303231_length_162_cov_421.047619	7	56	120	2	49	0.0408163
NODE_303231_length_162_cov_421.047619	7	56	130	3	49	0.0612245
NODE_303231_length_162_cov_421.047619	7	56	136	1	49	0.0204082
NODE_303231_length_162_cov_421.047619	7	56	142	1	49	0.0204082
NODE_303231_length_162_cov_421.047619	7	56	146	1	49	0.0204082
NODE_303231_length_162_cov_421.047619	7	56	148	1	49	0.0204082
NODE_303231_length_162_cov_421.047619	7	56	150	1	49	0.0204082
NODE_303231_length_162_cov_421.047619	7	56	154	1	49	0.0204082
NODE_303231_length_162_cov_421.047619	7	56	158	1	49	0.0204082
NODE_303231_length_162_cov_421.047619	7	56	160	1	49	0.0204082
NODE_303231_length_162_cov_421.047619	7	56	162	1	49	0.0204082
NODE_303231_length_162_cov_421.047619	7	56	172	1	49	0.0204082
NODE_303231_length_162_cov_421.047619	7	56	174	1	49	0.0204082
NODE_303231_length_162_cov_421.047619	7	56	178	4	49	0.0816327
NODE_303231_length_162_cov_421.047619	7	56	180	1	49	0.0204082
NODE_303231_length_162_cov_421.047619	29	90	98	1	61	0.0163934
NODE_303231_length_162_cov_421.047619	29	90	100	1	61	0.0163934
NODE_303231_length_162_cov_421.047619	29	90	108	1	61	0.0163934
NODE_303231_length_162_cov_421.047619	29	90	110	1	61	0.0163934
NODE_303231_length_162_cov_421.047619	29	90	112	2	61	0.0327869
NODE_303231_length_162_cov_421.047619	29	90	120	2	61	0.0327869
NODE_303231_length_162_cov_421.047619	29	90	130	3	61	0.0491803
NODE_303231_length_162_cov_421.047619	29	90	136	1	61	0.0163934
NODE_303231_length_162_cov_421.047619	29	90	142	1	61	0.0163934
NODE_303231_length_162_cov_421.047619	29	90	146	1	61	0.0163934
NODE_303231_length_162_cov_421.047619	29	90	148	1	61	0.0163934
NODE_303231_length_162_cov_421.047619	29	90	150	1	61	0.0163934
NODE_303231_length_162_cov_421.047619	29	90	154	1	61	0.0163934
NODE_303231_length_162_cov_421.047619	29	90	158	1	61	0.0163934
NODE_303231_length_162_cov_421.047619	29	90	160	1	61	0.0163934
NODE_303231_length_162_cov_421.047619	29	90	162	1	61	0.0163934
NODE_303231_length_162_cov_421.047619	29	90	172	1	61	0.0163934
NODE_303231_length_162_cov_421.047619	29	90	174	1	61	0.0163934
NODE_303231_length_162_cov_421.047619	29	90	178	4	61	0.0655738
NODE_303231_length_162_cov_421.047619	29	90	180	35	61	0.5737705
NODE_303231_length_162_cov_421.047619	29	92	98	1	63	0.0158730
NODE_303231_length_162_cov_421.047619	29	92	100	1	63	0.0158730
NODE_303231_length_162_cov_421.047619	29	92	108	1	63	0.0158730
NODE_303231_length_162_cov_421.047619	29	92	110	1	63	0.0158730
NODE_303231_length_162_cov_421.047619	29	92	112	2	63	0.0317460
NODE_303231_length_162_cov_421.047619	29	92	120	2	63	0.0317460
NODE_303231_length_162_cov_421.047619	29	92	130	3	63	0.0476190
NODE_303231_length_162_cov_421.047619	29	92	136	1	63	0.0158730
NODE_303231_length_162_cov_421.047619	29	92	142	1	63	0.0158730
NODE_303231_length_162_cov_421.047619	29	92	146	1	63	0.0158730
NODE_303231_length_162_cov_421.047619	29	92	148	1	63	0.0158730
NODE_303231_length_162_cov_421.047619	29	92	150	1	63	0.0158730
NODE_303231_length_162_cov_421.047619	29	92	154	1	63	0.0158730
NODE_303231_length_162_cov_421.047619	29	92	158	1	63	0.0158730
NODE_303231_length_162_cov_421.047619	29	92	160	1	63	0.0158730
NODE_303231_length_162_cov_421.047619	29	92	162	1	63	0.0158730
NODE_303231_length_162_cov_421.047619	29	92	172	1	63	0.0158730
NODE_303231_length_162_cov_421.047619	29	92	174	1	63	0.0158730
NODE_303231_length_162_cov_421.047619	29	92	178	4	63	0.0634921
NODE_303231_length_162_cov_421.047619	29	92	180	37	63	0.5873016
NODE_303231_length_162_cov_421.047619	29	92	98	1	63	0.0158730
NODE_303231_length_162_cov_421.047619	29	92	100	1	63	0.0158730
NODE_303231_length_162_cov_421.047619	29	92	108	1	63	0.0158730
NODE_303231_length_162_cov_421.047619	29	92	110	1	63	0.0158730
NODE_303231_length_162_cov_421.047619	29	92	112	2	63	0.0317460
NODE_303231_length_162_cov_421.047619	29	92	120	2	63	0.0317460
NODE_303231_length_162_cov_421.047619	29	92	130	3	63	0.0476190
NODE_303231_length_162_cov_421.047619	29	92	136	1	63	0.0158730
NODE_303231_length_162_cov_421.047619	29	92	142	1	63	0.0158730
NODE_303231_length_162_cov_421.047619	29	92	146	1	63	0.0158730
NODE_303231_length_162_cov_421.047619	29	92	148	1	63	0.0158730
NODE_303231_length_162_cov_421.047619	29	92	150	1	63	0.0158730
NODE_303231_length_162_cov_421.047619	29	92	154	1	63	0.0158730
NODE_303231_length_162_cov_421.047619	29	92	158	1	63	0.0158730
NODE_303231_length_162_cov_421.047619	29	92	160	1	63	0.0158730
NODE_303231_length_162_cov_421.047619	29	92	162	1	63	0.0158730
NODE_303231_length_162_cov_421.047619	29	92	172	1	63	0.0158730
NODE_303231_length_162_cov_421.047619	29	92	174	1	63	0.0158730
NODE_303231_length_162_cov_421.047619	29	92	178	4	63	0.0634921
NODE_303231_length_162_cov_421.047619	29	92	180	37	63	0.5873016
NODE_303231_length_162_cov_421.047619	29	92	98	1	63	0.0158730
NODE_303231_length_162_cov_421.047619	29	92	100	1	63	0.0158730
NODE_303231_length_162_cov_421.047619	29	92	108	1	63	0.0158730
NODE_303231_length_162_cov_421.047619	29	92	110	1	63	0.0158730
NODE_303231_length_162_cov_421.047619	29	92	112	2	63	0.0317460
NODE_303231_length_162_cov_421.047619	29	92	120	2	63	0.0317460
NODE_303231_length_162_cov_421.047619	29	92	130	3	63	0.0476190
NODE_303231_length_162_cov_421.047619	29	92	136	1	63	0.0158730
NODE_303231_length_162_cov_421.047619	29	92	142	1	63	0.0158730
NODE_303231_length_162_cov_421.047619	29	92	146	1	63	0.0158730
NODE_303231_length_162_cov_421.047619	29	92	148	1	63	0.0158730
NODE_303231_length_162_cov_421.047619	29	92	150	1	63	0.0158730
NODE_303231_length_162_cov_421.047619	29	92	154	1	63	0.0158730
NODE_303231_length_162_cov_421.047619	29	92	158	1	63	0.0158730
NODE_303231_length_162_cov_421.047619	29	92	160	1	63	0.0158730
NODE_303231_length_162_cov_421.047619	29	92	162	1	63	0.0158730
NODE_303231_length_162_cov_421.047619	29	92	172	1	63	0.0158730
NODE_303231_length_162_cov_421.047619	29	92	174	1	63	0.0158730
NODE_303231_length_162_cov_421.047619	29	92	178	4	63	0.0634921
NODE_303231_length_162_cov_421.047619	29	92	180	37	63	0.5873016
NODE_303250_length_162_cov_45.380952	63	127	19	7	64	0.1093750
NODE_303250_length_162_cov_45.380952	63	127	20	4	64	0.0625000
NODE_303250_length_162_cov_45.380952	63	127	22	2	64	0.0312500
NODE_303250_length_162_cov_45.380952	63	127	24	51	64	0.7968750
NODE_303250_length_162_cov_45.380952	63	127	19	7	64	0.1093750
NODE_303250_length_162_cov_45.380952	63	127	20	4	64	0.0625000
NODE_303250_length_162_cov_45.380952	63	127	22	2	64	0.0312500
NODE_303250_length_162_cov_45.380952	63	127	24	51	64	0.7968750
NODE_303250_length_162_cov_45.380952	100	162	3	16	62	0.2580645
NODE_303250_length_162_cov_45.380952	100	162	4	3	62	0.0483871
NODE_303250_length_162_cov_45.380952	100	162	6	2	62	0.0322581
NODE_303250_length_162_cov_45.380952	100	162	8	1	62	0.0161290
NODE_303250_length_162_cov_45.380952	100	162	10	4	62	0.0645161
NODE_303250_length_162_cov_45.380952	100	162	12	2	62	0.0322581
NODE_303250_length_162_cov_45.380952	100	162	17	2	62	0.0322581
NODE_303250_length_162_cov_45.380952	100	162	19	12	62	0.1935484
NODE_303250_length_162_cov_45.380952	100	162	20	4	62	0.0645161
NODE_303250_length_162_cov_45.380952	100	162	22	2	62	0.0322581
NODE_303250_length_162_cov_45.380952	100	162	24	14	62	0.2258064
NODE_303301_length_161_cov_1483.177419	51	131	62	1	80	0.0125000
NODE_303301_length_161_cov_1483.177419	51	131	64	2	80	0.0250000
NODE_303301_length_161_cov_1483.177419	51	131	66	10	80	0.1250000
NODE_303301_length_161_cov_1483.177419	51	131	68	2	80	0.0250000
NODE_303301_length_161_cov_1483.177419	51	131	70	2	80	0.0250000
NODE_303301_length_161_cov_1483.177419	51	131	72	7	80	0.0875000
NODE_303301_length_161_cov_1483.177419	51	131	74	1	80	0.0125000
NODE_303301_length_161_cov_1483.177419	51	131	76	3	80	0.0375000
NODE_303301_length_161_cov_1483.177419	51	131	78	2	80	0.0250000
NODE_303301_length_161_cov_1483.177419	51	131	80	5	80	0.0625000
NODE_303301_length_161_cov_1483.177419	51	131	82	45	80	0.5625000
NODE_303301_length_161_cov_1483.177419	104	161	12	2	57	0.0350877
NODE_303301_length_161_cov_1483.177419	104	161	14	2	57	0.0350877
NODE_303301_length_161_cov_1483.177419	104	161	16	1	57	0.0175439
NODE_303301_length_161_cov_1483.177419	104	161	18	1	57	0.0175439
NODE_303301_length_161_cov_1483.177419	104	161	20	1	57	0.0175439
NODE_303301_length_161_cov_1483.177419	104	161	25	1	57	0.0175439
NODE_303301_length_161_cov_1483.177419	104	161	29	2	57	0.0350877
NODE_303301_length_161_cov_1483.177419	104	161	37	1	57	0.0175439
NODE_303301_length_161_cov_1483.177419	104	161	38	1	57	0.0175439
NODE_303301_length_161_cov_1483.177419	104	161	43	1	57	0.0175439
NODE_303301_length_161_cov_1483.177419	104	161	47	1	57	0.0175439
NODE_303301_length_161_cov_1483.177419	104	161	49	4	57	0.0701754
NODE_303301_length_161_cov_1483.177419	104	161	51	1	57	0.0175439
NODE_303301_length_161_cov_1483.177419	104	161	55	2	57	0.0350877
NODE_303301_length_161_cov_1483.177419	104	161	56	2	57	0.0350877
NODE_303301_length_161_cov_1483.177419	104	161	58	1	57	0.0175439
NODE_303301_length_161_cov_1483.177419	104	161	60	1	57	0.0175439
NODE_303301_length_161_cov_1483.177419	104	161	62	3	57	0.0526316
NODE_303301_length_161_cov_1483.177419	104	161	64	2	57	0.0350877
NODE_303301_length_161_cov_1483.177419	104	161	66	10	57	0.1754386
NODE_303301_length_161_cov_1483.177419	104	161	68	2	57	0.0350877
NODE_303301_length_161_cov_1483.177419	104	161	72	7	57	0.1228070
NODE_303301_length_161_cov_1483.177419	104	161	76	3	57	0.0526316
NODE_303301_length_161_cov_1483.177419	104	161	78	1	57	0.0175439
NODE_303301_length_161_cov_1483.177419	104	161	80	4	57	0.0701754
NODE_303312_length_161_cov_71.500000	33	110	2	8	77	0.1038961
NODE_303312_length_161_cov_71.500000	33	110	4	69	77	0.8961039
NODE_303312_length_161_cov_71.500000	33	110	2	8	77	0.1038961
NODE_303312_length_161_cov_71.500000	33	110	4	69	77	0.8961039
NODE_303312_length_161_cov_71.500000	33	110	2	8	77	0.1038961
NODE_303312_length_161_cov_71.500000	33	110	4	69	77	0.8961039
NODE_303312_length_161_cov_71.500000	33	110	2	8	77	0.1038961
NODE_303312_length_161_cov_71.500000	33	110	4	69	77	0.8961039
NODE_303312_length_161_cov_71.500000	83	149	0	28	66	0.4242424
NODE_303312_length_161_cov_71.500000	83	149	2	19	66	0.2878788
NODE_303312_length_161_cov_71.500000	83	149	4	19	66	0.2878788
NODE_303312_length_161_cov_71.500000	83	161	0	40	78	0.5128205
NODE_303312_length_161_cov_71.500000	83	161	2	19	78	0.2435897
NODE_303312_length_161_cov_71.500000	83	161	4	19	78	0.2435897
NODE_303312_length_161_cov_71.500000	86	161	0	40	75	0.5333334
NODE_303312_length_161_cov_71.500000	86	161	2	19	75	0.2533333
NODE_303312_length_161_cov_71.500000	86	161	4	16	75	0.2133333
NODE_303312_length_161_cov_71.500000	86	161	0	40	75	0.5333334
NODE_303312_length_161_cov_71.500000	86	161	2	19	75	0.2533333
NODE_303312_length_161_cov_71.500000	86	161	4	16	75	0.2133333
NODE_303312_length_161_cov_71.500000	88	161	0	40	73	0.5479452
NODE_303312_length_161_cov_71.500000	88	161	2	19	73	0.2602740
NODE_303312_length_161_cov_71.500000	88	161	4	14	73	0.1917808
NODE_303321_length_161_cov_29.758065	0	80	0	11	80	0.1375000
NODE_303321_length_161_cov_29.758065	0	80	4	3	80	0.0375000
NODE_303321_length_161_cov_29.758065	0	80	6	15	80	0.1875000
NODE_303321_length_161_cov_29.758065	0	80	8	51	80	0.6375000
NODE_303381_length_160_cov_143.573770	45	125	4	14	80	0.1750000
NODE_303381_length_160_cov_143.573770	45	125	6	66	80	0.8250000
NODE_303381_length_160_cov_143.573770	93	160	0	23	67	0.3432836
NODE_303381_length_160_cov_143.573770	93	160	2	7	67	0.1044776
NODE_303381_length_160_cov_143.573770	93	160	4	19	67	0.2835821
NODE_303381_length_160_cov_143.573770	93	160	6	18	67	0.2686567
NODE_303381_length_160_cov_143.573770	98	120	4	9	22	0.4090909
NODE_303381_length_160_cov_143.573770	98	120	6	13	22	0.5909091
NODE_303388_length_160_cov_58.245902	0	45	2	10	45	0.2222222
NODE_303388_length_160_cov_58.245902	0	45	4	7	45	0.1555556
NODE_303388_length_160_cov_58.245902	0	45	6	9	45	0.2000000
NODE_303388_length_160_cov_58.245902	0	45	8	5	45	0.1111111
NODE_303388_length_160_cov_58.245902	0	45	10	1	45	0.0222222
NODE_303388_length_160_cov_58.245902	0	45	12	4	45	0.0888889
NODE_303388_length_160_cov_58.245902	0	45	13	8	45	0.1777778
NODE_303388_length_160_cov_58.245902	0	45	14	1	45	0.0222222
NODE_303431_length_159_cov_182.016667	71	156	6	1	85	0.0117647
NODE_303431_length_159_cov_182.016667	71	156	10	7	85	0.0823529
NODE_303431_length_159_cov_182.016667	71	156	14	7	85	0.0823529
NODE_303431_length_159_cov_182.016667	71	156	16	2	85	0.0235294
NODE_303431_length_159_cov_182.016667	71	156	18	1	85	0.0117647
NODE_303431_length_159_cov_182.016667	71	156	20	17	85	0.2000000
NODE_303431_length_159_cov_182.016667	71	156	22	9	85	0.1058824
NODE_303431_length_159_cov_182.016667	71	156	24	3	85	0.0352941
NODE_303431_length_159_cov_182.016667	71	156	26	38	85	0.4470588
NODE_303431_length_159_cov_182.016667	71	156	6	1	85	0.0117647
NODE_303431_length_159_cov_182.016667	71	156	10	7	85	0.0823529
NODE_303431_length_159_cov_182.016667	71	156	14	7	85	0.0823529
NODE_303431_length_159_cov_182.016667	71	156	16	2	85	0.0235294
NODE_303431_length_159_cov_182.016667	71	156	18	1	85	0.0117647
NODE_303431_length_159_cov_182.016667	71	156	20	17	85	0.2000000
NODE_303431_length_159_cov_182.016667	71	156	22	9	85	0.1058824
NODE_303431_length_159_cov_182.016667	71	156	24	3	85	0.0352941
NODE_303431_length_159_cov_182.016667	71	156	26	38	85	0.4470588
NODE_303431_length_159_cov_182.016667	71	156	6	1	85	0.0117647
NODE_303431_length_159_cov_182.016667	71	156	10	7	85	0.0823529
NODE_303431_length_159_cov_182.016667	71	156	14	7	85	0.0823529
NODE_303431_length_159_cov_182.016667	71	156	16	2	85	0.0235294
NODE_303431_length_159_cov_182.016667	71	156	18	1	85	0.0117647
NODE_303431_length_159_cov_182.016667	71	156	20	17	85	0.2000000
NODE_303431_length_159_cov_182.016667	71	156	22	9	85	0.1058824
NODE_303431_length_159_cov_182.016667	71	156	24	3	85	0.0352941
NODE_303431_length_159_cov_182.016667	71	156	26	38	85	0.4470588
NODE_303440_length_159_cov_85.750000	0	43	0	18	43	0.4186046
NODE_303440_length_159_cov_85.750000	0	43	4	1	43	0.0232558
NODE_303440_length_159_cov_85.750000	0	43	7	3	43	0.0697674
NODE_303440_length_159_cov_85.750000	0	43	13	5	43	0.1162791
NODE_303440_length_159_cov_85.750000	0	43	17	2	43	0.0465116
NODE_303440_length_159_cov_85.750000	0	43	18	2	43	0.0465116
NODE_303440_length_159_cov_85.750000	0	43	20	1	43	0.0232558
NODE_303440_length_159_cov_85.750000	0	43	24	5	43	0.1162791
NODE_303440_length_159_cov_85.750000	0	43	32	3	43	0.0697674
NODE_303440_length_159_cov_85.750000	0	43	34	3	43	0.0697674
NODE_303440_length_159_cov_85.750000	16	97	0	2	81	0.0246914
NODE_303440_length_159_cov_85.750000	16	97	4	1	81	0.0123457
NODE_303440_length_159_cov_85.750000	16	97	7	3	81	0.0370370
NODE_303440_length_159_cov_85.750000	16	97	13	5	81	0.0617284
NODE_303440_length_159_cov_85.750000	16	97	17	2	81	0.0246914
NODE_303440_length_159_cov_85.750000	16	97	18	2	81	0.0246914
NODE_303440_length_159_cov_85.750000	16	97	20	1	81	0.0123457
NODE_303440_length_159_cov_85.750000	16	97	24	5	81	0.0617284
NODE_303440_length_159_cov_85.750000	16	97	32	3	81	0.0370370
NODE_303440_length_159_cov_85.750000	16	97	34	17	81	0.2098765
NODE_303440_length_159_cov_85.750000	16	97	41	31	81	0.3827161
NODE_303440_length_159_cov_85.750000	16	97	42	9	81	0.1111111
NODE_303440_length_159_cov_85.750000	65	145	24	1	80	0.0125000
NODE_303440_length_159_cov_85.750000	65	145	25	4	80	0.0500000
NODE_303440_length_159_cov_85.750000	65	145	33	8	80	0.1000000
NODE_303440_length_159_cov_85.750000	65	145	35	11	80	0.1375000
NODE_303440_length_159_cov_85.750000	65	145	39	10	80	0.1250000
NODE_303440_length_159_cov_85.750000	65	145	41	45	80	0.5625000
NODE_303440_length_159_cov_85.750000	65	145	42	1	80	0.0125000
NODE_303440_length_159_cov_85.750000	70	92	41	22	22	1.0000000
NODE_303546_length_158_cov_119.813559	34	77	0	4	43	0.0930233
NODE_303546_length_158_cov_119.813559	34	77	2	39	43	0.9069768
NODE_303546_length_158_cov_119.813559	78	113	2	35	35	1.0000000
NODE_303546_length_158_cov_119.813559	123	158	0	35	35	1.0000000
NODE_303552_length_158_cov_70.135593	5	82	0	18	77	0.2337662
NODE_303552_length_158_cov_70.135593	5	82	2	59	77	0.7662337
NODE_303552_length_158_cov_70.135593	5	82	0	18	77	0.2337662
NODE_303552_length_158_cov_70.135593	5	82	2	59	77	0.7662337
NODE_303552_length_158_cov_70.135593	81	155	0	47	74	0.6351351
NODE_303552_length_158_cov_70.135593	81	155	2	27	74	0.3648649
NODE_303555_length_158_cov_63.559322	80	151	2	1	71	0.0140845
NODE_303555_length_158_cov_63.559322	80	151	4	4	71	0.0563380
NODE_303555_length_158_cov_63.559322	80	151	8	7	71	0.0985916
NODE_303555_length_158_cov_63.559322	80	151	10	2	71	0.0281690
NODE_303555_length_158_cov_63.559322	80	151	12	1	71	0.0140845
NODE_303555_length_158_cov_63.559322	80	151	14	2	71	0.0281690
NODE_303555_length_158_cov_63.559322	80	151	18	6	71	0.0845070
NODE_303555_length_158_cov_63.559322	80	151	22	6	71	0.0845070
NODE_303555_length_158_cov_63.559322	80	151	24	1	71	0.0140845
NODE_303555_length_158_cov_63.559322	80	151	26	2	71	0.0281690
NODE_303555_length_158_cov_63.559322	80	151	30	3	71	0.0422535
NODE_303555_length_158_cov_63.559322	80	151	32	3	71	0.0422535
NODE_303555_length_158_cov_63.559322	80	151	34	1	71	0.0140845
NODE_303555_length_158_cov_63.559322	80	151	36	2	71	0.0281690
NODE_303555_length_158_cov_63.559322	80	151	38	30	71	0.4225352
NODE_303556_length_158_cov_61.203390	2	66	11	1	64	0.0156250
NODE_303556_length_158_cov_61.203390	2	66	13	2	64	0.0312500
NODE_303556_length_158_cov_61.203390	2	66	14	3	64	0.0468750
NODE_303556_length_158_cov_61.203390	2	66	20	1	64	0.0156250
NODE_303556_length_158_cov_61.203390	2	66	22	3	64	0.0468750
NODE_303556_length_158_cov_61.203390	2	66	24	2	64	0.0312500
NODE_303556_length_158_cov_61.203390	2	66	30	2	64	0.0312500
NODE_303556_length_158_cov_61.203390	2	66	32	2	64	0.0312500
NODE_303556_length_158_cov_61.203390	2	66	42	1	64	0.0156250
NODE_303556_length_158_cov_61.203390	2	66	43	1	64	0.0156250
NODE_303556_length_158_cov_61.203390	2	66	48	1	64	0.0156250
NODE_303556_length_158_cov_61.203390	2	66	66	1	64	0.0156250
NODE_303556_length_158_cov_61.203390	2	66	70	2	64	0.0312500
NODE_303556_length_158_cov_61.203390	2	66	72	2	64	0.0312500
NODE_303556_length_158_cov_61.203390	2	66	74	2	64	0.0312500
NODE_303556_length_158_cov_61.203390	2	66	76	2	64	0.0312500
NODE_303556_length_158_cov_61.203390	2	66	83	1	64	0.0156250
NODE_303556_length_158_cov_61.203390	2	66	88	1	64	0.0156250
NODE_303556_length_158_cov_61.203390	2	66	90	2	64	0.0312500
NODE_303556_length_158_cov_61.203390	2	66	98	1	64	0.0156250
NODE_303556_length_158_cov_61.203390	2	66	99	1	64	0.0156250
NODE_303556_length_158_cov_61.203390	2	66	100	1	64	0.0156250
NODE_303556_length_158_cov_61.203390	2	66	104	2	64	0.0312500
NODE_303556_length_158_cov_61.203390	2	66	106	4	64	0.0625000
NODE_303556_length_158_cov_61.203390	2	66	116	1	64	0.0156250
NODE_303556_length_158_cov_61.203390	2	66	118	1	64	0.0156250
NODE_303556_length_158_cov_61.203390	2	66	123	2	64	0.0312500
NODE_303556_length_158_cov_61.203390	2	66	125	2	64	0.0312500
NODE_303556_length_158_cov_61.203390	2	66	127	2	64	0.0312500
NODE_303556_length_158_cov_61.203390	2	66	129	1	64	0.0156250
NODE_303556_length_158_cov_61.203390	2	66	131	2	64	0.0312500
NODE_303556_length_158_cov_61.203390	2	66	135	12	64	0.1875000
NODE_303556_length_158_cov_61.203390	2	66	11	1	64	0.0156250
NODE_303556_length_158_cov_61.203390	2	66	13	2	64	0.0312500
NODE_303556_length_158_cov_61.203390	2	66	14	3	64	0.0468750
NODE_303556_length_158_cov_61.203390	2	66	20	1	64	0.0156250
NODE_303556_length_158_cov_61.203390	2	66	22	3	64	0.0468750
NODE_303556_length_158_cov_61.203390	2	66	24	2	64	0.0312500
NODE_303556_length_158_cov_61.203390	2	66	30	2	64	0.0312500
NODE_303556_length_158_cov_61.203390	2	66	32	2	64	0.0312500
NODE_303556_length_158_cov_61.203390	2	66	42	1	64	0.0156250
NODE_303556_length_158_cov_61.203390	2	66	43	1	64	0.0156250
NODE_303556_length_158_cov_61.203390	2	66	48	1	64	0.0156250
NODE_303556_length_158_cov_61.203390	2	66	66	1	64	0.0156250
NODE_303556_length_158_cov_61.203390	2	66	70	2	64	0.0312500
NODE_303556_length_158_cov_61.203390	2	66	72	2	64	0.0312500
NODE_303556_length_158_cov_61.203390	2	66	74	2	64	0.0312500
NODE_303556_length_158_cov_61.203390	2	66	76	2	64	0.0312500
NODE_303556_length_158_cov_61.203390	2	66	83	1	64	0.0156250
NODE_303556_length_158_cov_61.203390	2	66	88	1	64	0.0156250
NODE_303556_length_158_cov_61.203390	2	66	90	2	64	0.0312500
NODE_303556_length_158_cov_61.203390	2	66	98	1	64	0.0156250
NODE_303556_length_158_cov_61.203390	2	66	99	1	64	0.0156250
NODE_303556_length_158_cov_61.203390	2	66	100	1	64	0.0156250
NODE_303556_length_158_cov_61.203390	2	66	104	2	64	0.0312500
NODE_303556_length_158_cov_61.203390	2	66	106	4	64	0.0625000
NODE_303556_length_158_cov_61.203390	2	66	116	1	64	0.0156250
NODE_303556_length_158_cov_61.203390	2	66	118	1	64	0.0156250
NODE_303556_length_158_cov_61.203390	2	66	123	2	64	0.0312500
NODE_303556_length_158_cov_61.203390	2	66	125	2	64	0.0312500
NODE_303556_length_158_cov_61.203390	2	66	127	2	64	0.0312500
NODE_303556_length_158_cov_61.203390	2	66	129	1	64	0.0156250
NODE_303556_length_158_cov_61.203390	2	66	131	2	64	0.0312500
NODE_303556_length_158_cov_61.203390	2	66	135	12	64	0.1875000
NODE_303556_length_158_cov_61.203390	2	66	11	1	64	0.0156250
NODE_303556_length_158_cov_61.203390	2	66	13	2	64	0.0312500
NODE_303556_length_158_cov_61.203390	2	66	14	3	64	0.0468750
NODE_303556_length_158_cov_61.203390	2	66	20	1	64	0.0156250
NODE_303556_length_158_cov_61.203390	2	66	22	3	64	0.0468750
NODE_303556_length_158_cov_61.203390	2	66	24	2	64	0.0312500
NODE_303556_length_158_cov_61.203390	2	66	30	2	64	0.0312500
NODE_303556_length_158_cov_61.203390	2	66	32	2	64	0.0312500
NODE_303556_length_158_cov_61.203390	2	66	42	1	64	0.0156250
NODE_303556_length_158_cov_61.203390	2	66	43	1	64	0.0156250
NODE_303556_length_158_cov_61.203390	2	66	48	1	64	0.0156250
NODE_303556_length_158_cov_61.203390	2	66	66	1	64	0.0156250
NODE_303556_length_158_cov_61.203390	2	66	70	2	64	0.0312500
NODE_303556_length_158_cov_61.203390	2	66	72	2	64	0.0312500
NODE_303556_length_158_cov_61.203390	2	66	74	2	64	0.0312500
NODE_303556_length_158_cov_61.203390	2	66	76	2	64	0.0312500
NODE_303556_length_158_cov_61.203390	2	66	83	1	64	0.0156250
NODE_303556_length_158_cov_61.203390	2	66	88	1	64	0.0156250
NODE_303556_length_158_cov_61.203390	2	66	90	2	64	0.0312500
NODE_303556_length_158_cov_61.203390	2	66	98	1	64	0.0156250
NODE_303556_length_158_cov_61.203390	2	66	99	1	64	0.0156250
NODE_303556_length_158_cov_61.203390	2	66	100	1	64	0.0156250
NODE_303556_length_158_cov_61.203390	2	66	104	2	64	0.0312500
NODE_303556_length_158_cov_61.203390	2	66	106	4	64	0.0625000
NODE_303556_length_158_cov_61.203390	2	66	116	1	64	0.0156250
NODE_303556_length_158_cov_61.203390	2	66	118	1	64	0.0156250
NODE_303556_length_158_cov_61.203390	2	66	123	2	64	0.0312500
NODE_303556_length_158_cov_61.203390	2	66	125	2	64	0.0312500
NODE_303556_length_158_cov_61.203390	2	66	127	2	64	0.0312500
NODE_303556_length_158_cov_61.203390	2	66	129	1	64	0.0156250
NODE_303556_length_158_cov_61.203390	2	66	131	2	64	0.0312500
NODE_303556_length_158_cov_61.203390	2	66	135	12	64	0.1875000
NODE_303556_length_158_cov_61.203390	39	119	102	1	80	0.0125000
NODE_303556_length_158_cov_61.203390	39	119	104	1	80	0.0125000
NODE_303556_length_158_cov_61.203390	39	119	106	4	80	0.0500000
NODE_303556_length_158_cov_61.203390	39	119	112	1	80	0.0125000
NODE_303556_length_158_cov_61.203390	39	119	116	2	80	0.0250000
NODE_303556_length_158_cov_61.203390	39	119	118	1	80	0.0125000
NODE_303556_length_158_cov_61.203390	39	119	120	2	80	0.0250000
NODE_303556_length_158_cov_61.203390	39	119	123	2	80	0.0250000
NODE_303556_length_158_cov_61.203390	39	119	125	2	80	0.0250000
NODE_303556_length_158_cov_61.203390	39	119	126	1	80	0.0125000
NODE_303556_length_158_cov_61.203390	39	119	127	2	80	0.0250000
NODE_303556_length_158_cov_61.203390	39	119	129	1	80	0.0125000
NODE_303556_length_158_cov_61.203390	39	119	130	1	80	0.0125000
NODE_303556_length_158_cov_61.203390	39	119	131	2	80	0.0250000
NODE_303556_length_158_cov_61.203390	39	119	132	1	80	0.0125000
NODE_303556_length_158_cov_61.203390	39	119	134	10	80	0.1250000
NODE_303556_length_158_cov_61.203390	39	119	135	21	80	0.2625000
NODE_303556_length_158_cov_61.203390	39	119	136	25	80	0.3125000
NODE_303563_length_158_cov_40.271186	43	107	28	1	64	0.0156250
NODE_303563_length_158_cov_40.271186	43	107	30	5	64	0.0781250
NODE_303563_length_158_cov_40.271186	43	107	32	1	64	0.0156250
NODE_303563_length_158_cov_40.271186	43	107	34	57	64	0.8906250
NODE_303563_length_158_cov_40.271186	80	151	7	1	71	0.0140845
NODE_303563_length_158_cov_40.271186	80	151	8	3	71	0.0422535
NODE_303563_length_158_cov_40.271186	80	151	12	8	71	0.1126761
NODE_303563_length_158_cov_40.271186	80	151	14	1	71	0.0140845
NODE_303563_length_158_cov_40.271186	80	151	16	10	71	0.1408451
NODE_303563_length_158_cov_40.271186	80	151	18	2	71	0.0281690
NODE_303563_length_158_cov_40.271186	80	151	22	2	71	0.0281690
NODE_303563_length_158_cov_40.271186	80	151	24	1	71	0.0140845
NODE_303563_length_158_cov_40.271186	80	151	26	7	71	0.0985916
NODE_303563_length_158_cov_40.271186	80	151	28	3	71	0.0422535
NODE_303563_length_158_cov_40.271186	80	151	30	1	71	0.0140845
NODE_303563_length_158_cov_40.271186	80	151	32	1	71	0.0140845
NODE_303563_length_158_cov_40.271186	80	151	34	31	71	0.4366197
NODE_303566_length_158_cov_29.661017	0	61	0	61	61	1.0000000
NODE_303566_length_158_cov_29.661017	34	64	0	30	30	1.0000000
NODE_303605_length_157_cov_1488.586207	57	138	52	3	81	0.0370370
NODE_303605_length_157_cov_1488.586207	57	138	54	1	81	0.0123457
NODE_303605_length_157_cov_1488.586207	57	138	56	1	81	0.0123457
NODE_303605_length_157_cov_1488.586207	57	138	60	1	81	0.0123457
NODE_303605_length_157_cov_1488.586207	57	138	67	1	81	0.0123457
NODE_303605_length_157_cov_1488.586207	57	138	69	1	81	0.0123457
NODE_303605_length_157_cov_1488.586207	57	138	79	2	81	0.0246914
NODE_303605_length_157_cov_1488.586207	57	138	83	1	81	0.0123457
NODE_303605_length_157_cov_1488.586207	57	138	87	1	81	0.0123457
NODE_303605_length_157_cov_1488.586207	57	138	91	1	81	0.0123457
NODE_303605_length_157_cov_1488.586207	57	138	95	1	81	0.0123457
NODE_303605_length_157_cov_1488.586207	57	138	98	1	81	0.0123457
NODE_303605_length_157_cov_1488.586207	57	138	99	2	81	0.0246914
NODE_303605_length_157_cov_1488.586207	57	138	100	1	81	0.0123457
NODE_303605_length_157_cov_1488.586207	57	138	103	2	81	0.0246914
NODE_303605_length_157_cov_1488.586207	57	138	105	2	81	0.0246914
NODE_303605_length_157_cov_1488.586207	57	138	111	1	81	0.0123457
NODE_303605_length_157_cov_1488.586207	57	138	115	1	81	0.0123457
NODE_303605_length_157_cov_1488.586207	57	138	119	3	81	0.0370370
NODE_303605_length_157_cov_1488.586207	57	138	123	4	81	0.0493827
NODE_303605_length_157_cov_1488.586207	57	138	127	3	81	0.0370370
NODE_303605_length_157_cov_1488.586207	57	138	129	1	81	0.0123457
NODE_303605_length_157_cov_1488.586207	57	138	131	1	81	0.0123457
NODE_303605_length_157_cov_1488.586207	57	138	135	45	81	0.5555556
NODE_303605_length_157_cov_1488.586207	111	157	2	6	46	0.1304348
NODE_303605_length_157_cov_1488.586207	111	157	8	2	46	0.0434783
NODE_303605_length_157_cov_1488.586207	111	157	12	1	46	0.0217391
NODE_303605_length_157_cov_1488.586207	111	157	21	1	46	0.0217391
NODE_303605_length_157_cov_1488.586207	111	157	23	1	46	0.0217391
NODE_303605_length_157_cov_1488.586207	111	157	29	1	46	0.0217391
NODE_303605_length_157_cov_1488.586207	111	157	31	4	46	0.0869565
NODE_303605_length_157_cov_1488.586207	111	157	37	1	46	0.0217391
NODE_303605_length_157_cov_1488.586207	111	157	47	1	46	0.0217391
NODE_303605_length_157_cov_1488.586207	111	157	51	1	46	0.0217391
NODE_303605_length_157_cov_1488.586207	111	157	52	3	46	0.0652174
NODE_303605_length_157_cov_1488.586207	111	157	54	1	46	0.0217391
NODE_303605_length_157_cov_1488.586207	111	157	56	1	46	0.0217391
NODE_303605_length_157_cov_1488.586207	111	157	60	1	46	0.0217391
NODE_303605_length_157_cov_1488.586207	111	157	67	1	46	0.0217391
NODE_303605_length_157_cov_1488.586207	111	157	69	1	46	0.0217391
NODE_303605_length_157_cov_1488.586207	111	157	79	2	46	0.0434783
NODE_303605_length_157_cov_1488.586207	111	157	83	1	46	0.0217391
NODE_303605_length_157_cov_1488.586207	111	157	87	1	46	0.0217391
NODE_303605_length_157_cov_1488.586207	111	157	91	1	46	0.0217391
NODE_303605_length_157_cov_1488.586207	111	157	95	1	46	0.0217391
NODE_303605_length_157_cov_1488.586207	111	157	98	1	46	0.0217391
NODE_303605_length_157_cov_1488.586207	111	157	99	2	46	0.0434783
NODE_303605_length_157_cov_1488.586207	111	157	100	1	46	0.0217391
NODE_303605_length_157_cov_1488.586207	111	157	103	2	46	0.0434783
NODE_303605_length_157_cov_1488.586207	111	157	105	2	46	0.0434783
NODE_303605_length_157_cov_1488.586207	111	157	111	1	46	0.0217391
NODE_303605_length_157_cov_1488.586207	111	157	115	1	46	0.0217391
NODE_303605_length_157_cov_1488.586207	111	157	119	3	46	0.0652174
NODE_303606_length_157_cov_295.896552	32	78	28	1	46	0.0217391
NODE_303606_length_157_cov_295.896552	32	78	32	1	46	0.0217391
NODE_303606_length_157_cov_295.896552	32	78	36	3	46	0.0652174
NODE_303606_length_157_cov_295.896552	32	78	38	1	46	0.0217391
NODE_303606_length_157_cov_295.896552	32	78	40	3	46	0.0652174
NODE_303606_length_157_cov_295.896552	32	78	42	2	46	0.0434783
NODE_303606_length_157_cov_295.896552	32	78	44	1	46	0.0217391
NODE_303606_length_157_cov_295.896552	32	78	46	3	46	0.0652174
NODE_303606_length_157_cov_295.896552	32	78	48	1	46	0.0217391
NODE_303606_length_157_cov_295.896552	32	78	50	1	46	0.0217391
NODE_303606_length_157_cov_295.896552	32	78	52	2	46	0.0434783
NODE_303606_length_157_cov_295.896552	32	78	54	27	46	0.5869565
NODE_303608_length_157_cov_161.689655	0	59	0	31	59	0.5254237
NODE_303608_length_157_cov_161.689655	0	59	2	23	59	0.3898305
NODE_303608_length_157_cov_161.689655	0	59	4	5	59	0.0847458
NODE_303608_length_157_cov_161.689655	0	59	0	31	59	0.5254237
NODE_303608_length_157_cov_161.689655	0	59	2	23	59	0.3898305
NODE_303608_length_157_cov_161.689655	0	59	4	5	59	0.0847458
NODE_303608_length_157_cov_161.689655	55	135	2	24	80	0.3000000
NODE_303608_length_157_cov_161.689655	55	135	4	56	80	0.7000000
NODE_303608_length_157_cov_161.689655	55	135	2	24	80	0.3000000
NODE_303608_length_157_cov_161.689655	55	135	4	56	80	0.7000000
NODE_303608_length_157_cov_161.689655	108	157	0	17	49	0.3469388
NODE_303608_length_157_cov_161.689655	108	157	2	29	49	0.5918368
NODE_303608_length_157_cov_161.689655	108	157	4	3	49	0.0612245
NODE_303608_length_157_cov_161.689655	113	157	0	17	44	0.3863636
NODE_303608_length_157_cov_161.689655	113	157	2	27	44	0.6136364
NODE_303677_length_156_cov_100.491228	0	41	0	8	41	0.1951219
NODE_303677_length_156_cov_100.491228	0	41	2	4	41	0.0975610
NODE_303677_length_156_cov_100.491228	0	41	3	1	41	0.0243902
NODE_303677_length_156_cov_100.491228	0	41	4	25	41	0.6097561
NODE_303677_length_156_cov_100.491228	0	41	6	3	41	0.0731707
NODE_303677_length_156_cov_100.491228	21	94	4	17	73	0.2328767
NODE_303677_length_156_cov_100.491228	21	94	6	56	73	0.7671233
NODE_303688_length_156_cov_37.368421	24	81	0	1	57	0.0175439
NODE_303688_length_156_cov_37.368421	24	81	2	4	57	0.0701754
NODE_303688_length_156_cov_37.368421	24	81	4	3	57	0.0526316
NODE_303688_length_156_cov_37.368421	24	81	6	13	57	0.2280702
NODE_303688_length_156_cov_37.368421	24	81	10	5	57	0.0877193
NODE_303688_length_156_cov_37.368421	24	81	12	31	57	0.5438597
NODE_303688_length_156_cov_37.368421	54	134	12	80	80	1.0000000
NODE_303700_length_156_cov_9.543860	2	48	0	46	46	1.0000000
NODE_303700_length_156_cov_9.543860	59	105	0	46	46	1.0000000
NODE_303752_length_155_cov_56.750000	27	102	0	75	75	1.0000000
NODE_303752_length_155_cov_56.750000	80	155	0	75	75	1.0000000
NODE_304022_length_153_cov_0.944444	5	48	0	43	43	1.0000000
NODE_304022_length_153_cov_0.944444	37	86	0	49	49	1.0000000
NODE_304022_length_153_cov_0.944444	59	102	0	43	43	1.0000000
NODE_304022_length_153_cov_0.944444	91	140	0	49	49	1.0000000
NODE_304022_length_153_cov_0.944444	113	153	0	40	40	1.0000000
NODE_304027_length_152_cov_195.396226	9	89	0	16	80	0.2000000
NODE_304027_length_152_cov_195.396226	9	89	1	3	80	0.0375000
NODE_304027_length_152_cov_195.396226	9	89	2	1	80	0.0125000
NODE_304027_length_152_cov_195.396226	9	89	4	60	80	0.7500000
NODE_304027_length_152_cov_195.396226	9	89	0	16	80	0.2000000
NODE_304027_length_152_cov_195.396226	9	89	1	3	80	0.0375000
NODE_304027_length_152_cov_195.396226	9	89	2	1	80	0.0125000
NODE_304027_length_152_cov_195.396226	9	89	4	60	80	0.7500000
NODE_304027_length_152_cov_195.396226	85	149	2	33	64	0.5156250
NODE_304027_length_152_cov_195.396226	85	149	4	31	64	0.4843750
NODE_304027_length_152_cov_195.396226	85	152	2	36	67	0.5373135
NODE_304027_length_152_cov_195.396226	85	152	4	31	67	0.4626866
NODE_304027_length_152_cov_195.396226	85	152	2	36	67	0.5373135
NODE_304027_length_152_cov_195.396226	85	152	4	31	67	0.4626866
NODE_304027_length_152_cov_195.396226	85	152	2	36	67	0.5373135
NODE_304027_length_152_cov_195.396226	85	152	4	31	67	0.4626866
NODE_304030_length_152_cov_68.094340	99	150	0	19	51	0.3725490
NODE_304030_length_152_cov_68.094340	99	150	2	32	51	0.6274510
NODE_304112_length_151_cov_541.615385	19	88	0	17	69	0.2463768
NODE_304112_length_151_cov_541.615385	19	88	2	2	69	0.0289855
NODE_304112_length_151_cov_541.615385	19	88	6	1	69	0.0144928
NODE_304112_length_151_cov_541.615385	19	88	7	1	69	0.0144928
NODE_304112_length_151_cov_541.615385	19	88	10	1	69	0.0144928
NODE_304112_length_151_cov_541.615385	19	88	12	1	69	0.0144928
NODE_304112_length_151_cov_541.615385	19	88	17	1	69	0.0144928
NODE_304112_length_151_cov_541.615385	19	88	18	3	69	0.0434783
NODE_304112_length_151_cov_541.615385	19	88	20	1	69	0.0144928
NODE_304112_length_151_cov_541.615385	19	88	22	41	69	0.5942029
NODE_304112_length_151_cov_541.615385	72	149	5	5	77	0.0649351
NODE_304112_length_151_cov_541.615385	72	149	7	1	77	0.0129870
NODE_304112_length_151_cov_541.615385	72	149	13	3	77	0.0389610
NODE_304112_length_151_cov_541.615385	72	149	15	5	77	0.0649351
NODE_304112_length_151_cov_541.615385	72	149	17	3	77	0.0389610
NODE_304112_length_151_cov_541.615385	72	149	19	8	77	0.1038961
NODE_304112_length_151_cov_541.615385	72	149	21	23	77	0.2987013
NODE_304112_length_151_cov_541.615385	72	149	22	29	77	0.3766234
NODE_304229_length_150_cov_88.647059	51	102	10	51	51	1.0000000
NODE_304472_length_148_cov_34.183673	23	99	10	6	76	0.0789474
NODE_304472_length_148_cov_34.183673	23	99	14	1	76	0.0131579
NODE_304472_length_148_cov_34.183673	23	99	15	4	76	0.0526316
NODE_304472_length_148_cov_34.183673	23	99	19	2	76	0.0263158
NODE_304472_length_148_cov_34.183673	23	99	23	1	76	0.0131579
NODE_304472_length_148_cov_34.183673	23	99	24	1	76	0.0131579
NODE_304472_length_148_cov_34.183673	23	99	28	7	76	0.0921053
NODE_304472_length_148_cov_34.183673	23	99	30	54	76	0.7105263
NODE_304570_length_147_cov_472.354167	0	55	0	3	55	0.0545455
NODE_304570_length_147_cov_472.354167	0	55	4	6	55	0.1090909
NODE_304570_length_147_cov_472.354167	0	55	6	11	55	0.2000000
NODE_304570_length_147_cov_472.354167	0	55	8	20	55	0.3636364
NODE_304570_length_147_cov_472.354167	0	55	10	15	55	0.2727273
NODE_304570_length_147_cov_472.354167	12	89	6	8	77	0.1038961
NODE_304570_length_147_cov_472.354167	12	89	8	20	77	0.2597403
NODE_304570_length_147_cov_472.354167	12	89	10	49	77	0.6363636
NODE_304570_length_147_cov_472.354167	65	137	0	5	72	0.0694444
NODE_304570_length_147_cov_472.354167	65	137	2	1	72	0.0138889
NODE_304570_length_147_cov_472.354167	65	137	4	4	72	0.0555556
NODE_304570_length_147_cov_472.354167	65	137	6	1	72	0.0138889
NODE_304570_length_147_cov_472.354167	65	137	8	8	72	0.1111111
NODE_304570_length_147_cov_472.354167	65	137	10	53	72	0.7361111
NODE_304572_length_147_cov_229.729167	7	56	6	4	49	0.0816327
NODE_304572_length_147_cov_229.729167	7	56	8	2	49	0.0408163
NODE_304572_length_147_cov_229.729167	7	56	10	2	49	0.0408163
NODE_304572_length_147_cov_229.729167	7	56	12	5	49	0.1020408
NODE_304572_length_147_cov_229.729167	7	56	14	7	49	0.1428571
NODE_304572_length_147_cov_229.729167	7	56	15	1	49	0.0204082
NODE_304572_length_147_cov_229.729167	7	56	18	1	49	0.0204082
NODE_304572_length_147_cov_229.729167	7	56	21	1	49	0.0204082
NODE_304572_length_147_cov_229.729167	7	56	22	2	49	0.0408163
NODE_304572_length_147_cov_229.729167	7	56	26	5	49	0.1020408
NODE_304572_length_147_cov_229.729167	7	56	30	2	49	0.0408163
NODE_304572_length_147_cov_229.729167	7	56	32	3	49	0.0612245
NODE_304572_length_147_cov_229.729167	7	56	34	1	49	0.0204082
NODE_304572_length_147_cov_229.729167	7	56	36	13	49	0.2653061
NODE_304572_length_147_cov_229.729167	29	93	21	1	64	0.0156250
NODE_304572_length_147_cov_229.729167	29	93	22	2	64	0.0312500
NODE_304572_length_147_cov_229.729167	29	93	26	5	64	0.0781250
NODE_304572_length_147_cov_229.729167	29	93	30	2	64	0.0312500
NODE_304572_length_147_cov_229.729167	29	93	32	3	64	0.0468750
NODE_304572_length_147_cov_229.729167	29	93	34	1	64	0.0156250
NODE_304572_length_147_cov_229.729167	29	93	36	50	64	0.7812500
NODE_304572_length_147_cov_229.729167	29	93	21	1	64	0.0156250
NODE_304572_length_147_cov_229.729167	29	93	22	2	64	0.0312500
NODE_304572_length_147_cov_229.729167	29	93	26	5	64	0.0781250
NODE_304572_length_147_cov_229.729167	29	93	30	2	64	0.0312500
NODE_304572_length_147_cov_229.729167	29	93	32	3	64	0.0468750
NODE_304572_length_147_cov_229.729167	29	93	34	1	64	0.0156250
NODE_304572_length_147_cov_229.729167	29	93	36	50	64	0.7812500
NODE_304572_length_147_cov_229.729167	29	93	21	1	64	0.0156250
NODE_304572_length_147_cov_229.729167	29	93	22	2	64	0.0312500
NODE_304572_length_147_cov_229.729167	29	93	26	5	64	0.0781250
NODE_304572_length_147_cov_229.729167	29	93	30	2	64	0.0312500
NODE_304572_length_147_cov_229.729167	29	93	32	3	64	0.0468750
NODE_304572_length_147_cov_229.729167	29	93	34	1	64	0.0156250
NODE_304572_length_147_cov_229.729167	29	93	36	50	64	0.7812500
NODE_304573_length_147_cov_213.770833	37	117	0	80	80	1.0000000
NODE_304573_length_147_cov_213.770833	90	146	0	56	56	1.0000000
NODE_304697_length_146_cov_182.893617	1	60	0	27	59	0.4576271
NODE_304697_length_146_cov_182.893617	1	60	2	11	59	0.1864407
NODE_304697_length_146_cov_182.893617	1	60	4	21	59	0.3559322
NODE_304697_length_146_cov_182.893617	34	60	2	5	26	0.1923077
NODE_304697_length_146_cov_182.893617	34	60	4	21	26	0.8076923
NODE_304697_length_146_cov_182.893617	113	144	0	16	31	0.5161290
NODE_304697_length_146_cov_182.893617	113	144	2	15	31	0.4838710
NODE_304698_length_146_cov_152.808511	0	69	0	69	69	1.0000000
NODE_304698_length_146_cov_152.808511	42	122	0	80	80	1.0000000
NODE_304703_length_146_cov_89.808511	0	53	2	53	53	1.0000000
NODE_304703_length_146_cov_89.808511	26	106	2	80	80	1.0000000
NODE_304703_length_146_cov_89.808511	74	146	0	23	72	0.3194444
NODE_304703_length_146_cov_89.808511	74	146	2	49	72	0.6805556
NODE_304703_length_146_cov_89.808511	79	101	2	22	22	1.0000000
NODE_304707_length_146_cov_57.446809	44	124	0	80	80	1.0000000
NODE_304708_length_146_cov_54.106383	0	69	0	69	69	1.0000000
NODE_304708_length_146_cov_54.106383	42	122	0	80	80	1.0000000
NODE_304710_length_146_cov_46.765957	3	83	2	2	80	0.0250000
NODE_304710_length_146_cov_46.765957	3	83	9	1	80	0.0125000
NODE_304710_length_146_cov_46.765957	3	83	11	9	80	0.1125000
NODE_304710_length_146_cov_46.765957	3	83	15	2	80	0.0250000
NODE_304710_length_146_cov_46.765957	3	83	16	66	80	0.8250000
NODE_304710_length_146_cov_46.765957	3	83	2	2	80	0.0250000
NODE_304710_length_146_cov_46.765957	3	83	9	1	80	0.0125000
NODE_304710_length_146_cov_46.765957	3	83	11	9	80	0.1125000
NODE_304710_length_146_cov_46.765957	3	83	15	2	80	0.0250000
NODE_304710_length_146_cov_46.765957	3	83	16	66	80	0.8250000
NODE_304710_length_146_cov_46.765957	3	83	2	2	80	0.0250000
NODE_304710_length_146_cov_46.765957	3	83	9	1	80	0.0125000
NODE_304710_length_146_cov_46.765957	3	83	11	9	80	0.1125000
NODE_304710_length_146_cov_46.765957	3	83	15	2	80	0.0250000
NODE_304710_length_146_cov_46.765957	3	83	16	66	80	0.8250000
NODE_304710_length_146_cov_46.765957	3	83	2	2	80	0.0250000
NODE_304710_length_146_cov_46.765957	3	83	9	1	80	0.0125000
NODE_304710_length_146_cov_46.765957	3	83	11	9	80	0.1125000
NODE_304710_length_146_cov_46.765957	3	83	15	2	80	0.0250000
NODE_304710_length_146_cov_46.765957	3	83	16	66	80	0.8250000
NODE_304710_length_146_cov_46.765957	3	83	2	2	80	0.0250000
NODE_304710_length_146_cov_46.765957	3	83	9	1	80	0.0125000
NODE_304710_length_146_cov_46.765957	3	83	11	9	80	0.1125000
NODE_304710_length_146_cov_46.765957	3	83	15	2	80	0.0250000
NODE_304710_length_146_cov_46.765957	3	83	16	66	80	0.8250000
NODE_304710_length_146_cov_46.765957	12	83	11	3	71	0.0422535
NODE_304710_length_146_cov_46.765957	12	83	15	2	71	0.0281690
NODE_304710_length_146_cov_46.765957	12	83	16	66	71	0.9295775
NODE_304710_length_146_cov_46.765957	56	136	4	3	80	0.0375000
NODE_304710_length_146_cov_46.765957	56	136	14	19	80	0.2375000
NODE_304710_length_146_cov_46.765957	56	136	16	58	80	0.7250000
NODE_304710_length_146_cov_46.765957	56	136	4	3	80	0.0375000
NODE_304710_length_146_cov_46.765957	56	136	14	19	80	0.2375000
NODE_304710_length_146_cov_46.765957	56	136	16	58	80	0.7250000
NODE_304711_length_146_cov_44.021277	0	69	0	69	69	1.0000000
NODE_304711_length_146_cov_44.021277	42	122	0	80	80	1.0000000
NODE_304798_length_145_cov_1385.413043	0	69	26	1	69	0.0144928
NODE_304798_length_145_cov_1385.413043	0	69	28	1	69	0.0144928
NODE_304798_length_145_cov_1385.413043	0	69	40	1	69	0.0144928
NODE_304798_length_145_cov_1385.413043	0	69	44	1	69	0.0144928
NODE_304798_length_145_cov_1385.413043	0	69	46	2	69	0.0289855
NODE_304798_length_145_cov_1385.413043	0	69	56	1	69	0.0144928
NODE_304798_length_145_cov_1385.413043	0	69	59	1	69	0.0144928
NODE_304798_length_145_cov_1385.413043	0	69	61	2	69	0.0289855
NODE_304798_length_145_cov_1385.413043	0	69	64	1	69	0.0144928
NODE_304798_length_145_cov_1385.413043	0	69	65	1	69	0.0144928
NODE_304798_length_145_cov_1385.413043	0	69	77	1	69	0.0144928
NODE_304798_length_145_cov_1385.413043	0	69	78	1	69	0.0144928
NODE_304798_length_145_cov_1385.413043	0	69	85	1	69	0.0144928
NODE_304798_length_145_cov_1385.413043	0	69	86	2	69	0.0289855
NODE_304798_length_145_cov_1385.413043	0	69	90	1	69	0.0144928
NODE_304798_length_145_cov_1385.413043	0	69	94	1	69	0.0144928
NODE_304798_length_145_cov_1385.413043	0	69	104	1	69	0.0144928
NODE_304798_length_145_cov_1385.413043	0	69	108	1	69	0.0144928
NODE_304798_length_145_cov_1385.413043	0	69	112	1	69	0.0144928
NODE_304798_length_145_cov_1385.413043	0	69	118	4	69	0.0579710
NODE_304798_length_145_cov_1385.413043	0	69	123	1	69	0.0144928
NODE_304798_length_145_cov_1385.413043	0	69	126	1	69	0.0144928
NODE_304798_length_145_cov_1385.413043	0	69	128	1	69	0.0144928
NODE_304798_length_145_cov_1385.413043	0	69	136	1	69	0.0144928
NODE_304798_length_145_cov_1385.413043	0	69	140	1	69	0.0144928
NODE_304798_length_145_cov_1385.413043	0	69	160	1	69	0.0144928
NODE_304798_length_145_cov_1385.413043	0	69	162	1	69	0.0144928
NODE_304798_length_145_cov_1385.413043	0	69	182	1	69	0.0144928
NODE_304798_length_145_cov_1385.413043	0	69	184	1	69	0.0144928
NODE_304798_length_145_cov_1385.413043	0	69	187	1	69	0.0144928
NODE_304798_length_145_cov_1385.413043	0	69	192	2	69	0.0289855
NODE_304798_length_145_cov_1385.413043	0	69	198	1	69	0.0144928
NODE_304798_length_145_cov_1385.413043	0	69	205	1	69	0.0144928
NODE_304798_length_145_cov_1385.413043	0	69	208	1	69	0.0144928
NODE_304798_length_145_cov_1385.413043	0	69	212	2	69	0.0289855
NODE_304798_length_145_cov_1385.413043	0	69	214	2	69	0.0289855
NODE_304798_length_145_cov_1385.413043	0	69	216	24	69	0.3478261
NODE_304798_length_145_cov_1385.413043	42	122	143	1	80	0.0125000
NODE_304798_length_145_cov_1385.413043	42	122	145	1	80	0.0125000
NODE_304798_length_145_cov_1385.413043	42	122	158	1	80	0.0125000
NODE_304798_length_145_cov_1385.413043	42	122	161	1	80	0.0125000
NODE_304798_length_145_cov_1385.413043	42	122	163	2	80	0.0250000
NODE_304798_length_145_cov_1385.413043	42	122	169	1	80	0.0125000
NODE_304798_length_145_cov_1385.413043	42	122	173	1	80	0.0125000
NODE_304798_length_145_cov_1385.413043	42	122	177	1	80	0.0125000
NODE_304798_length_145_cov_1385.413043	42	122	183	2	80	0.0250000
NODE_304798_length_145_cov_1385.413043	42	122	186	1	80	0.0125000
NODE_304798_length_145_cov_1385.413043	42	122	191	1	80	0.0125000
NODE_304798_length_145_cov_1385.413043	42	122	193	1	80	0.0125000
NODE_304798_length_145_cov_1385.413043	42	122	203	2	80	0.0250000
NODE_304798_length_145_cov_1385.413043	42	122	205	1	80	0.0125000
NODE_304798_length_145_cov_1385.413043	42	122	210	1	80	0.0125000
NODE_304798_length_145_cov_1385.413043	42	122	211	1	80	0.0125000
NODE_304798_length_145_cov_1385.413043	42	122	212	1	80	0.0125000
NODE_304798_length_145_cov_1385.413043	42	122	213	1	80	0.0125000
NODE_304798_length_145_cov_1385.413043	42	122	214	2	80	0.0250000
NODE_304798_length_145_cov_1385.413043	42	122	215	13	80	0.1625000
NODE_304798_length_145_cov_1385.413043	42	122	216	44	80	0.5500000
NODE_304799_length_145_cov_880.369565	56	120	139	1	64	0.0156250
NODE_304799_length_145_cov_880.369565	56	120	143	1	64	0.0156250
NODE_304799_length_145_cov_880.369565	56	120	145	1	64	0.0156250
NODE_304799_length_145_cov_880.369565	56	120	147	1	64	0.0156250
NODE_304799_length_145_cov_880.369565	56	120	153	1	64	0.0156250
NODE_304799_length_145_cov_880.369565	56	120	157	1	64	0.0156250
NODE_304799_length_145_cov_880.369565	56	120	159	1	64	0.0156250
NODE_304799_length_145_cov_880.369565	56	120	163	1	64	0.0156250
NODE_304799_length_145_cov_880.369565	56	120	167	1	64	0.0156250
NODE_304799_length_145_cov_880.369565	56	120	168	1	64	0.0156250
NODE_304799_length_145_cov_880.369565	56	120	172	2	64	0.0312500
NODE_304799_length_145_cov_880.369565	56	120	180	1	64	0.0156250
NODE_304799_length_145_cov_880.369565	56	120	184	1	64	0.0156250
NODE_304799_length_145_cov_880.369565	56	120	191	1	64	0.0156250
NODE_304799_length_145_cov_880.369565	56	120	196	1	64	0.0156250
NODE_304799_length_145_cov_880.369565	56	120	198	1	64	0.0156250
NODE_304799_length_145_cov_880.369565	56	120	202	47	64	0.7343750
NODE_304799_length_145_cov_880.369565	56	120	139	1	64	0.0156250
NODE_304799_length_145_cov_880.369565	56	120	143	1	64	0.0156250
NODE_304799_length_145_cov_880.369565	56	120	145	1	64	0.0156250
NODE_304799_length_145_cov_880.369565	56	120	147	1	64	0.0156250
NODE_304799_length_145_cov_880.369565	56	120	153	1	64	0.0156250
NODE_304799_length_145_cov_880.369565	56	120	157	1	64	0.0156250
NODE_304799_length_145_cov_880.369565	56	120	159	1	64	0.0156250
NODE_304799_length_145_cov_880.369565	56	120	163	1	64	0.0156250
NODE_304799_length_145_cov_880.369565	56	120	167	1	64	0.0156250
NODE_304799_length_145_cov_880.369565	56	120	168	1	64	0.0156250
NODE_304799_length_145_cov_880.369565	56	120	172	2	64	0.0312500
NODE_304799_length_145_cov_880.369565	56	120	180	1	64	0.0156250
NODE_304799_length_145_cov_880.369565	56	120	184	1	64	0.0156250
NODE_304799_length_145_cov_880.369565	56	120	191	1	64	0.0156250
NODE_304799_length_145_cov_880.369565	56	120	196	1	64	0.0156250
NODE_304799_length_145_cov_880.369565	56	120	198	1	64	0.0156250
NODE_304799_length_145_cov_880.369565	56	120	202	47	64	0.7343750
NODE_304799_length_145_cov_880.369565	56	120	139	1	64	0.0156250
NODE_304799_length_145_cov_880.369565	56	120	143	1	64	0.0156250
NODE_304799_length_145_cov_880.369565	56	120	145	1	64	0.0156250
NODE_304799_length_145_cov_880.369565	56	120	147	1	64	0.0156250
NODE_304799_length_145_cov_880.369565	56	120	153	1	64	0.0156250
NODE_304799_length_145_cov_880.369565	56	120	157	1	64	0.0156250
NODE_304799_length_145_cov_880.369565	56	120	159	1	64	0.0156250
NODE_304799_length_145_cov_880.369565	56	120	163	1	64	0.0156250
NODE_304799_length_145_cov_880.369565	56	120	167	1	64	0.0156250
NODE_304799_length_145_cov_880.369565	56	120	168	1	64	0.0156250
NODE_304799_length_145_cov_880.369565	56	120	172	2	64	0.0312500
NODE_304799_length_145_cov_880.369565	56	120	180	1	64	0.0156250
NODE_304799_length_145_cov_880.369565	56	120	184	1	64	0.0156250
NODE_304799_length_145_cov_880.369565	56	120	191	1	64	0.0156250
NODE_304799_length_145_cov_880.369565	56	120	196	1	64	0.0156250
NODE_304799_length_145_cov_880.369565	56	120	198	1	64	0.0156250
NODE_304799_length_145_cov_880.369565	56	120	202	47	64	0.7343750
NODE_304799_length_145_cov_880.369565	93	142	8	1	49	0.0204082
NODE_304799_length_145_cov_880.369565	93	142	10	1	49	0.0204082
NODE_304799_length_145_cov_880.369565	93	142	11	1	49	0.0204082
NODE_304799_length_145_cov_880.369565	93	142	13	1	49	0.0204082
NODE_304799_length_145_cov_880.369565	93	142	17	2	49	0.0408163
NODE_304799_length_145_cov_880.369565	93	142	26	1	49	0.0204082
NODE_304799_length_145_cov_880.369565	93	142	31	1	49	0.0204082
NODE_304799_length_145_cov_880.369565	93	142	40	1	49	0.0204082
NODE_304799_length_145_cov_880.369565	93	142	46	2	49	0.0408163
NODE_304799_length_145_cov_880.369565	93	142	56	1	49	0.0204082
NODE_304799_length_145_cov_880.369565	93	142	66	1	49	0.0204082
NODE_304799_length_145_cov_880.369565	93	142	79	1	49	0.0204082
NODE_304799_length_145_cov_880.369565	93	142	84	1	49	0.0204082
NODE_304799_length_145_cov_880.369565	93	142	92	1	49	0.0204082
NODE_304799_length_145_cov_880.369565	93	142	94	1	49	0.0204082
NODE_304799_length_145_cov_880.369565	93	142	100	1	49	0.0204082
NODE_304799_length_145_cov_880.369565	93	142	106	1	49	0.0204082
NODE_304799_length_145_cov_880.369565	93	142	118	1	49	0.0204082
NODE_304799_length_145_cov_880.369565	93	142	124	1	49	0.0204082
NODE_304799_length_145_cov_880.369565	93	142	133	1	49	0.0204082
NODE_304799_length_145_cov_880.369565	93	142	139	1	49	0.0204082
NODE_304799_length_145_cov_880.369565	93	142	143	1	49	0.0204082
NODE_304799_length_145_cov_880.369565	93	142	145	1	49	0.0204082
NODE_304799_length_145_cov_880.369565	93	142	147	1	49	0.0204082
NODE_304799_length_145_cov_880.369565	93	142	153	1	49	0.0204082
NODE_304799_length_145_cov_880.369565	93	142	157	1	49	0.0204082
NODE_304799_length_145_cov_880.369565	93	142	159	1	49	0.0204082
NODE_304799_length_145_cov_880.369565	93	142	163	1	49	0.0204082
NODE_304799_length_145_cov_880.369565	93	142	167	1	49	0.0204082
NODE_304799_length_145_cov_880.369565	93	142	168	1	49	0.0204082
NODE_304799_length_145_cov_880.369565	93	142	172	2	49	0.0408163
NODE_304799_length_145_cov_880.369565	93	142	180	1	49	0.0204082
NODE_304799_length_145_cov_880.369565	93	142	184	1	49	0.0204082
NODE_304799_length_145_cov_880.369565	93	142	191	1	49	0.0204082
NODE_304799_length_145_cov_880.369565	93	142	196	1	49	0.0204082
NODE_304799_length_145_cov_880.369565	93	142	198	1	49	0.0204082
NODE_304799_length_145_cov_880.369565	93	142	202	10	49	0.2040816
NODE_304923_length_144_cov_46.155556	1	81	0	8	80	0.1000000
NODE_304923_length_144_cov_46.155556	1	81	4	13	80	0.1625000
NODE_304923_length_144_cov_46.155556	1	81	7	1	80	0.0125000
NODE_304923_length_144_cov_46.155556	1	81	8	5	80	0.0625000
NODE_304923_length_144_cov_46.155556	1	81	12	1	80	0.0125000
NODE_304923_length_144_cov_46.155556	1	81	14	1	80	0.0125000
NODE_304923_length_144_cov_46.155556	1	81	16	2	80	0.0250000
NODE_304923_length_144_cov_46.155556	1	81	18	3	80	0.0375000
NODE_304923_length_144_cov_46.155556	1	81	19	21	80	0.2625000
NODE_304923_length_144_cov_46.155556	1	81	20	25	80	0.3125000
NODE_305208_length_142_cov_244.488372	0	52	0	14	52	0.2692308
NODE_305208_length_142_cov_244.488372	0	52	2	6	52	0.1153846
NODE_305208_length_142_cov_244.488372	0	52	4	9	52	0.1730769
NODE_305208_length_142_cov_244.488372	0	52	6	6	52	0.1153846
NODE_305208_length_142_cov_244.488372	0	52	8	3	52	0.0576923
NODE_305208_length_142_cov_244.488372	0	52	10	14	52	0.2692308
NODE_305229_length_142_cov_46.976744	1	65	0	2	64	0.0312500
NODE_305229_length_142_cov_46.976744	1	65	2	5	64	0.0781250
NODE_305229_length_142_cov_46.976744	1	65	4	1	64	0.0156250
NODE_305229_length_142_cov_46.976744	1	65	6	1	64	0.0156250
NODE_305229_length_142_cov_46.976744	1	65	8	2	64	0.0312500
NODE_305229_length_142_cov_46.976744	1	65	10	1	64	0.0156250
NODE_305229_length_142_cov_46.976744	1	65	12	2	64	0.0312500
NODE_305229_length_142_cov_46.976744	1	65	18	1	64	0.0156250
NODE_305229_length_142_cov_46.976744	1	65	20	2	64	0.0312500
NODE_305229_length_142_cov_46.976744	1	65	26	1	64	0.0156250
NODE_305229_length_142_cov_46.976744	1	65	28	1	64	0.0156250
NODE_305229_length_142_cov_46.976744	1	65	34	3	64	0.0468750
NODE_305229_length_142_cov_46.976744	1	65	38	3	64	0.0468750
NODE_305229_length_142_cov_46.976744	1	65	40	2	64	0.0312500
NODE_305229_length_142_cov_46.976744	1	65	42	1	64	0.0156250
NODE_305229_length_142_cov_46.976744	1	65	44	36	64	0.5625000
NODE_305229_length_142_cov_46.976744	1	65	0	2	64	0.0312500
NODE_305229_length_142_cov_46.976744	1	65	2	5	64	0.0781250
NODE_305229_length_142_cov_46.976744	1	65	4	1	64	0.0156250
NODE_305229_length_142_cov_46.976744	1	65	6	1	64	0.0156250
NODE_305229_length_142_cov_46.976744	1	65	8	2	64	0.0312500
NODE_305229_length_142_cov_46.976744	1	65	10	1	64	0.0156250
NODE_305229_length_142_cov_46.976744	1	65	12	2	64	0.0312500
NODE_305229_length_142_cov_46.976744	1	65	18	1	64	0.0156250
NODE_305229_length_142_cov_46.976744	1	65	20	2	64	0.0312500
NODE_305229_length_142_cov_46.976744	1	65	26	1	64	0.0156250
NODE_305229_length_142_cov_46.976744	1	65	28	1	64	0.0156250
NODE_305229_length_142_cov_46.976744	1	65	34	3	64	0.0468750
NODE_305229_length_142_cov_46.976744	1	65	38	3	64	0.0468750
NODE_305229_length_142_cov_46.976744	1	65	40	2	64	0.0312500
NODE_305229_length_142_cov_46.976744	1	65	42	1	64	0.0156250
NODE_305229_length_142_cov_46.976744	1	65	44	36	64	0.5625000
NODE_305229_length_142_cov_46.976744	1	65	0	2	64	0.0312500
NODE_305229_length_142_cov_46.976744	1	65	2	5	64	0.0781250
NODE_305229_length_142_cov_46.976744	1	65	4	1	64	0.0156250
NODE_305229_length_142_cov_46.976744	1	65	6	1	64	0.0156250
NODE_305229_length_142_cov_46.976744	1	65	8	2	64	0.0312500
NODE_305229_length_142_cov_46.976744	1	65	10	1	64	0.0156250
NODE_305229_length_142_cov_46.976744	1	65	12	2	64	0.0312500
NODE_305229_length_142_cov_46.976744	1	65	18	1	64	0.0156250
NODE_305229_length_142_cov_46.976744	1	65	20	2	64	0.0312500
NODE_305229_length_142_cov_46.976744	1	65	26	1	64	0.0156250
NODE_305229_length_142_cov_46.976744	1	65	28	1	64	0.0156250
NODE_305229_length_142_cov_46.976744	1	65	34	3	64	0.0468750
NODE_305229_length_142_cov_46.976744	1	65	38	3	64	0.0468750
NODE_305229_length_142_cov_46.976744	1	65	40	2	64	0.0312500
NODE_305229_length_142_cov_46.976744	1	65	42	1	64	0.0156250
NODE_305229_length_142_cov_46.976744	1	65	44	36	64	0.5625000
NODE_305230_length_142_cov_45.000000	0	69	0	69	69	1.0000000
NODE_305385_length_141_cov_178.785714	58	118	72	1	60	0.0166667
NODE_305385_length_141_cov_178.785714	58	118	74	2	60	0.0333333
NODE_305385_length_141_cov_178.785714	58	118	76	5	60	0.0833333
NODE_305385_length_141_cov_178.785714	58	118	78	3	60	0.0500000
NODE_305385_length_141_cov_178.785714	58	118	80	4	60	0.0666667
NODE_305385_length_141_cov_178.785714	58	118	82	45	60	0.7500000
NODE_305398_length_141_cov_62.285714	26	106	0	80	80	1.0000000
NODE_305398_length_141_cov_62.285714	26	106	0	80	80	1.0000000
NODE_305398_length_141_cov_62.285714	26	97	0	71	71	1.0000000
NODE_305402_length_141_cov_41.142857	26	97	0	71	71	1.0000000
NODE_305600_length_140_cov_60.439024	8	88	2	6	80	0.0750000
NODE_305600_length_140_cov_60.439024	8	88	4	3	80	0.0375000
NODE_305600_length_140_cov_60.439024	8	88	6	11	80	0.1375000
NODE_305600_length_140_cov_60.439024	8	88	8	7	80	0.0875000
NODE_305600_length_140_cov_60.439024	8	88	12	53	80	0.6625000
NODE_305600_length_140_cov_60.439024	8	88	2	6	80	0.0750000
NODE_305600_length_140_cov_60.439024	8	88	4	3	80	0.0375000
NODE_305600_length_140_cov_60.439024	8	88	6	11	80	0.1375000
NODE_305600_length_140_cov_60.439024	8	88	8	7	80	0.0875000
NODE_305600_length_140_cov_60.439024	8	88	12	53	80	0.6625000
NODE_305600_length_140_cov_60.439024	8	88	2	6	80	0.0750000
NODE_305600_length_140_cov_60.439024	8	88	4	3	80	0.0375000
NODE_305600_length_140_cov_60.439024	8	88	6	11	80	0.1375000
NODE_305600_length_140_cov_60.439024	8	88	8	7	80	0.0875000
NODE_305600_length_140_cov_60.439024	8	88	12	53	80	0.6625000
NODE_305600_length_140_cov_60.439024	8	88	2	6	80	0.0750000
NODE_305600_length_140_cov_60.439024	8	88	4	3	80	0.0375000
NODE_305600_length_140_cov_60.439024	8	88	6	11	80	0.1375000
NODE_305600_length_140_cov_60.439024	8	88	8	7	80	0.0875000
NODE_305600_length_140_cov_60.439024	8	88	12	53	80	0.6625000
NODE_305600_length_140_cov_60.439024	8	88	2	6	80	0.0750000
NODE_305600_length_140_cov_60.439024	8	88	4	3	80	0.0375000
NODE_305600_length_140_cov_60.439024	8	88	6	11	80	0.1375000
NODE_305600_length_140_cov_60.439024	8	88	8	7	80	0.0875000
NODE_305600_length_140_cov_60.439024	8	88	12	53	80	0.6625000
NODE_305616_length_140_cov_35.146341	22	102	0	80	80	1.0000000
NODE_305616_length_140_cov_35.146341	75	105	0	30	30	1.0000000
NODE_305618_length_140_cov_34.048780	0	77	0	31	77	0.4025974
NODE_305618_length_140_cov_34.048780	0	77	2	46	77	0.5974026
NODE_305618_length_140_cov_34.048780	0	77	0	31	77	0.4025974
NODE_305618_length_140_cov_34.048780	0	77	2	46	77	0.5974026
NODE_305618_length_140_cov_34.048780	50	130	0	18	80	0.2250000
NODE_305618_length_140_cov_34.048780	50	130	2	62	80	0.7750000
NODE_305618_length_140_cov_34.048780	50	130	0	18	80	0.2250000
NODE_305618_length_140_cov_34.048780	50	130	2	62	80	0.7750000
NODE_305618_length_140_cov_34.048780	55	130	0	18	75	0.2400000
NODE_305618_length_140_cov_34.048780	55	130	2	57	75	0.7600000
NODE_305619_length_140_cov_19.926829	44	118	0	74	74	1.0000000
NODE_305783_length_139_cov_29.700000	0	40	0	34	40	0.8500000
NODE_305783_length_139_cov_29.700000	0	40	2	6	40	0.1500000
NODE_305783_length_139_cov_29.700000	0	40	0	34	40	0.8500000
NODE_305783_length_139_cov_29.700000	0	40	2	6	40	0.1500000
NODE_305783_length_139_cov_29.700000	13	93	0	21	80	0.2625000
NODE_305783_length_139_cov_29.700000	13	93	2	59	80	0.7375000
NODE_305783_length_139_cov_29.700000	13	93	0	21	80	0.2625000
NODE_305783_length_139_cov_29.700000	13	93	2	59	80	0.7375000
NODE_305783_length_139_cov_29.700000	13	93	0	21	80	0.2625000
NODE_305783_length_139_cov_29.700000	13	93	2	59	80	0.7375000
NODE_305783_length_139_cov_29.700000	13	93	0	21	80	0.2625000
NODE_305783_length_139_cov_29.700000	13	93	2	59	80	0.7375000
NODE_305783_length_139_cov_29.700000	13	93	0	21	80	0.2625000
NODE_305783_length_139_cov_29.700000	13	93	2	59	80	0.7375000
NODE_305783_length_139_cov_29.700000	13	84	0	21	71	0.2957746
NODE_305783_length_139_cov_29.700000	13	84	2	50	71	0.7042254
NODE_305936_length_138_cov_1475.615385	30	97	46	1	67	0.0149254
NODE_305936_length_138_cov_1475.615385	30	97	48	3	67	0.0447761
NODE_305936_length_138_cov_1475.615385	30	97	50	63	67	0.9402985
NODE_305936_length_138_cov_1475.615385	70	138	12	1	68	0.0147059
NODE_305936_length_138_cov_1475.615385	70	138	14	1	68	0.0147059
NODE_305936_length_138_cov_1475.615385	70	138	18	1	68	0.0147059
NODE_305936_length_138_cov_1475.615385	70	138	24	1	68	0.0147059
NODE_305936_length_138_cov_1475.615385	70	138	26	2	68	0.0294118
NODE_305936_length_138_cov_1475.615385	70	138	28	1	68	0.0147059
NODE_305936_length_138_cov_1475.615385	70	138	34	1	68	0.0147059
NODE_305936_length_138_cov_1475.615385	70	138	36	6	68	0.0882353
NODE_305936_length_138_cov_1475.615385	70	138	38	3	68	0.0441176
NODE_305936_length_138_cov_1475.615385	70	138	40	8	68	0.1176471
NODE_305936_length_138_cov_1475.615385	70	138	42	2	68	0.0294118
NODE_305936_length_138_cov_1475.615385	70	138	44	1	68	0.0147059
NODE_305936_length_138_cov_1475.615385	70	138	46	2	68	0.0294118
NODE_305936_length_138_cov_1475.615385	70	138	48	2	68	0.0294118
NODE_305936_length_138_cov_1475.615385	70	138	50	36	68	0.5294118
NODE_305963_length_138_cov_29.564103	11	91	0	1	80	0.0125000
NODE_305963_length_138_cov_29.564103	11	91	5	38	80	0.4750000
NODE_305963_length_138_cov_29.564103	11	91	6	41	80	0.5125000
NODE_305963_length_138_cov_29.564103	11	91	0	1	80	0.0125000
NODE_305963_length_138_cov_29.564103	11	91	5	38	80	0.4750000
NODE_305963_length_138_cov_29.564103	11	91	6	41	80	0.5125000
NODE_305963_length_138_cov_29.564103	64	128	6	64	64	1.0000000
NODE_305963_length_138_cov_29.564103	64	128	6	64	64	1.0000000
NODE_306081_length_137_cov_185.684211	20	104	16	13	84	0.1547619
NODE_306081_length_137_cov_185.684211	20	104	18	2	84	0.0238095
NODE_306081_length_137_cov_185.684211	20	104	20	69	84	0.8214286
NODE_306092_length_137_cov_58.289474	76	106	32	4	30	0.1333333
NODE_306092_length_137_cov_58.289474	76	106	34	26	30	0.8666667
NODE_306099_length_137_cov_36.473684	31	111	10	2	80	0.0250000
NODE_306099_length_137_cov_36.473684	31	111	12	78	80	0.9750000
NODE_306208_length_136_cov_1257.621622	27	107	38	1	80	0.0125000
NODE_306208_length_136_cov_1257.621622	27	107	40	1	80	0.0125000
NODE_306208_length_136_cov_1257.621622	27	107	46	1	80	0.0125000
NODE_306208_length_136_cov_1257.621622	27	107	48	77	80	0.9625000
NODE_306209_length_136_cov_769.594595	0	69	0	69	69	1.0000000
NODE_306222_length_136_cov_128.324324	39	119	8	4	80	0.0500000
NODE_306222_length_136_cov_128.324324	39	119	12	76	80	0.9500000
NODE_306227_length_136_cov_90.783784	10	86	0	76	76	1.0000000
NODE_306227_length_136_cov_90.783784	59	136	0	77	77	1.0000000
NODE_306368_length_135_cov_2144.166667	0	73	26	1	73	0.0136986
NODE_306368_length_135_cov_2144.166667	0	73	34	2	73	0.0273973
NODE_306368_length_135_cov_2144.166667	0	73	46	1	73	0.0136986
NODE_306368_length_135_cov_2144.166667	0	73	50	1	73	0.0136986
NODE_306368_length_135_cov_2144.166667	0	73	56	1	73	0.0136986
NODE_306368_length_135_cov_2144.166667	0	73	58	1	73	0.0136986
NODE_306368_length_135_cov_2144.166667	0	73	65	1	73	0.0136986
NODE_306368_length_135_cov_2144.166667	0	73	70	2	73	0.0273973
NODE_306368_length_135_cov_2144.166667	0	73	72	1	73	0.0136986
NODE_306368_length_135_cov_2144.166667	0	73	74	3	73	0.0410959
NODE_306368_length_135_cov_2144.166667	0	73	82	2	73	0.0273973
NODE_306368_length_135_cov_2144.166667	0	73	88	3	73	0.0410959
NODE_306368_length_135_cov_2144.166667	0	73	98	1	73	0.0136986
NODE_306368_length_135_cov_2144.166667	0	73	100	1	73	0.0136986
NODE_306368_length_135_cov_2144.166667	0	73	102	1	73	0.0136986
NODE_306368_length_135_cov_2144.166667	0	73	104	1	73	0.0136986
NODE_306368_length_135_cov_2144.166667	0	73	106	2	73	0.0273973
NODE_306368_length_135_cov_2144.166667	0	73	110	1	73	0.0136986
NODE_306368_length_135_cov_2144.166667	0	73	112	2	73	0.0273973
NODE_306368_length_135_cov_2144.166667	0	73	114	1	73	0.0136986
NODE_306368_length_135_cov_2144.166667	0	73	121	1	73	0.0136986
NODE_306368_length_135_cov_2144.166667	0	73	126	1	73	0.0136986
NODE_306368_length_135_cov_2144.166667	0	73	128	2	73	0.0273973
NODE_306368_length_135_cov_2144.166667	0	73	132	40	73	0.5479452
NODE_306368_length_135_cov_2144.166667	46	126	42	2	80	0.0250000
NODE_306368_length_135_cov_2144.166667	46	126	48	1	80	0.0125000
NODE_306368_length_135_cov_2144.166667	46	126	58	1	80	0.0125000
NODE_306368_length_135_cov_2144.166667	46	126	64	1	80	0.0125000
NODE_306368_length_135_cov_2144.166667	46	126	70	1	80	0.0125000
NODE_306368_length_135_cov_2144.166667	46	126	88	1	80	0.0125000
NODE_306368_length_135_cov_2144.166667	46	126	90	1	80	0.0125000
NODE_306368_length_135_cov_2144.166667	46	126	92	1	80	0.0125000
NODE_306368_length_135_cov_2144.166667	46	126	97	1	80	0.0125000
NODE_306368_length_135_cov_2144.166667	46	126	98	4	80	0.0500000
NODE_306368_length_135_cov_2144.166667	46	126	102	1	80	0.0125000
NODE_306368_length_135_cov_2144.166667	46	126	110	1	80	0.0125000
NODE_306368_length_135_cov_2144.166667	46	126	112	1	80	0.0125000
NODE_306368_length_135_cov_2144.166667	46	126	114	1	80	0.0125000
NODE_306368_length_135_cov_2144.166667	46	126	118	4	80	0.0500000
NODE_306368_length_135_cov_2144.166667	46	126	120	1	80	0.0125000
NODE_306368_length_135_cov_2144.166667	46	126	131	1	80	0.0125000
NODE_306368_length_135_cov_2144.166667	46	126	132	56	80	0.7000000
NODE_306368_length_135_cov_2144.166667	83	135	12	1	52	0.0192308
NODE_306368_length_135_cov_2144.166667	83	135	14	1	52	0.0192308
NODE_306368_length_135_cov_2144.166667	83	135	24	1	52	0.0192308
NODE_306368_length_135_cov_2144.166667	83	135	28	2	52	0.0384615
NODE_306368_length_135_cov_2144.166667	83	135	32	1	52	0.0192308
NODE_306368_length_135_cov_2144.166667	83	135	33	1	52	0.0192308
NODE_306368_length_135_cov_2144.166667	83	135	34	1	52	0.0192308
NODE_306368_length_135_cov_2144.166667	83	135	41	1	52	0.0192308
NODE_306368_length_135_cov_2144.166667	83	135	42	2	52	0.0384615
NODE_306368_length_135_cov_2144.166667	83	135	48	1	52	0.0192308
NODE_306368_length_135_cov_2144.166667	83	135	58	1	52	0.0192308
NODE_306368_length_135_cov_2144.166667	83	135	64	1	52	0.0192308
NODE_306368_length_135_cov_2144.166667	83	135	70	1	52	0.0192308
NODE_306368_length_135_cov_2144.166667	83	135	88	1	52	0.0192308
NODE_306368_length_135_cov_2144.166667	83	135	90	1	52	0.0192308
NODE_306368_length_135_cov_2144.166667	83	135	92	1	52	0.0192308
NODE_306368_length_135_cov_2144.166667	83	135	97	1	52	0.0192308
NODE_306368_length_135_cov_2144.166667	83	135	98	4	52	0.0769231
NODE_306368_length_135_cov_2144.166667	83	135	102	1	52	0.0192308
NODE_306368_length_135_cov_2144.166667	83	135	110	1	52	0.0192308
NODE_306368_length_135_cov_2144.166667	83	135	112	1	52	0.0192308
NODE_306368_length_135_cov_2144.166667	83	135	114	1	52	0.0192308
NODE_306368_length_135_cov_2144.166667	83	135	118	4	52	0.0769231
NODE_306368_length_135_cov_2144.166667	83	135	120	1	52	0.0192308
NODE_306368_length_135_cov_2144.166667	83	135	131	1	52	0.0192308
NODE_306368_length_135_cov_2144.166667	83	135	132	19	52	0.3653846
NODE_306370_length_135_cov_630.194444	0	76	4	4	76	0.0526316
NODE_306370_length_135_cov_630.194444	0	76	10	4	76	0.0526316
NODE_306370_length_135_cov_630.194444	0	76	12	3	76	0.0394737
NODE_306370_length_135_cov_630.194444	0	76	14	3	76	0.0394737
NODE_306370_length_135_cov_630.194444	0	76	15	1	76	0.0131579
NODE_306370_length_135_cov_630.194444	0	76	20	1	76	0.0131579
NODE_306370_length_135_cov_630.194444	0	76	22	1	76	0.0131579
NODE_306370_length_135_cov_630.194444	0	76	24	1	76	0.0131579
NODE_306370_length_135_cov_630.194444	0	76	26	7	76	0.0921053
NODE_306370_length_135_cov_630.194444	0	76	28	4	76	0.0526316
NODE_306370_length_135_cov_630.194444	0	76	30	1	76	0.0131579
NODE_306370_length_135_cov_630.194444	0	76	32	46	76	0.6052632
NODE_306371_length_135_cov_540.611111	0	76	4	3	76	0.0394737
NODE_306371_length_135_cov_540.611111	0	76	8	3	76	0.0394737
NODE_306371_length_135_cov_540.611111	0	76	14	1	76	0.0131579
NODE_306371_length_135_cov_540.611111	0	76	18	2	76	0.0263158
NODE_306371_length_135_cov_540.611111	0	76	20	1	76	0.0131579
NODE_306371_length_135_cov_540.611111	0	76	24	1	76	0.0131579
NODE_306371_length_135_cov_540.611111	0	76	28	2	76	0.0263158
NODE_306371_length_135_cov_540.611111	0	76	30	2	76	0.0263158
NODE_306371_length_135_cov_540.611111	0	76	34	2	76	0.0263158
NODE_306371_length_135_cov_540.611111	0	76	38	2	76	0.0263158
NODE_306371_length_135_cov_540.611111	0	76	46	5	76	0.0657895
NODE_306371_length_135_cov_540.611111	0	76	50	2	76	0.0263158
NODE_306371_length_135_cov_540.611111	0	76	52	50	76	0.6578947
NODE_306373_length_135_cov_257.416667	36	88	2	52	52	1.0000000
NODE_306374_length_135_cov_239.638889	97	135	8	9	38	0.2368421
NODE_306374_length_135_cov_239.638889	97	135	13	1	38	0.0263158
NODE_306374_length_135_cov_239.638889	97	135	14	5	38	0.1315790
NODE_306374_length_135_cov_239.638889	97	135	18	7	38	0.1842105
NODE_306374_length_135_cov_239.638889	97	135	20	1	38	0.0263158
NODE_306374_length_135_cov_239.638889	97	135	22	3	38	0.0789474
NODE_306374_length_135_cov_239.638889	97	135	24	5	38	0.1315790
NODE_306374_length_135_cov_239.638889	97	135	32	7	38	0.1842105
NODE_306400_length_135_cov_35.055556	8	88	2	4	80	0.0500000
NODE_306400_length_135_cov_35.055556	8	88	6	11	80	0.1375000
NODE_306400_length_135_cov_35.055556	8	88	10	3	80	0.0375000
NODE_306400_length_135_cov_35.055556	8	88	12	6	80	0.0750000
NODE_306400_length_135_cov_35.055556	8	88	14	56	80	0.7000000
NODE_306400_length_135_cov_35.055556	61	125	6	1	64	0.0156250
NODE_306400_length_135_cov_35.055556	61	125	12	18	64	0.2812500
NODE_306400_length_135_cov_35.055556	61	125	14	45	64	0.7031250
NODE_306400_length_135_cov_35.055556	61	125	6	1	64	0.0156250
NODE_306400_length_135_cov_35.055556	61	125	12	18	64	0.2812500
NODE_306400_length_135_cov_35.055556	61	125	14	45	64	0.7031250
NODE_306402_length_135_cov_31.805556	0	76	0	6	76	0.0789474
NODE_306402_length_135_cov_31.805556	0	76	2	70	76	0.9210526
NODE_306658_length_133_cov_140.411765	8	43	2	2	35	0.0571429
NODE_306658_length_133_cov_140.411765	8	43	4	33	35	0.9428571
NODE_306658_length_133_cov_140.411765	53	88	4	35	35	1.0000000
NODE_306658_length_133_cov_140.411765	98	133	0	11	35	0.3142857
NODE_306658_length_133_cov_140.411765	98	133	2	16	35	0.4571429
NODE_306658_length_133_cov_140.411765	98	133	4	8	35	0.2285714
NODE_306661_length_133_cov_109.441176	63	129	0	2	66	0.0303030
NODE_306661_length_133_cov_109.441176	63	129	2	4	66	0.0606061
NODE_306661_length_133_cov_109.441176	63	129	6	60	66	0.9090909
NODE_306812_length_132_cov_114.151515	2	44	0	6	42	0.1428571
NODE_306812_length_132_cov_114.151515	2	44	2	2	42	0.0476190
NODE_306812_length_132_cov_114.151515	2	44	4	34	42	0.8095238
NODE_306812_length_132_cov_114.151515	4	44	0	4	40	0.1000000
NODE_306812_length_132_cov_114.151515	4	44	2	2	40	0.0500000
NODE_306812_length_132_cov_114.151515	4	44	4	34	40	0.8500000
NODE_306812_length_132_cov_114.151515	17	83	4	66	66	1.0000000
NODE_306812_length_132_cov_114.151515	17	88	4	71	71	1.0000000
NODE_306824_length_132_cov_61.636364	3	76	2	11	73	0.1506849
NODE_306824_length_132_cov_61.636364	3	76	4	11	73	0.1506849
NODE_306824_length_132_cov_61.636364	3	76	6	51	73	0.6986302
NODE_306824_length_132_cov_61.636364	49	130	2	5	81	0.0617284
NODE_306824_length_132_cov_61.636364	49	130	4	1	81	0.0123457
NODE_306824_length_132_cov_61.636364	49	130	6	75	81	0.9259259
NODE_306824_length_132_cov_61.636364	103	125	4	1	22	0.0454545
NODE_306824_length_132_cov_61.636364	103	125	6	21	22	0.9545454
NODE_306834_length_132_cov_33.393939	2	83	0	81	81	1.0000000
NODE_306834_length_132_cov_33.393939	7	29	0	22	22	1.0000000
NODE_306834_length_132_cov_33.393939	56	129	0	73	73	1.0000000
NODE_306965_length_131_cov_810.000000	0	60	7	1	60	0.0166667
NODE_306965_length_131_cov_810.000000	0	60	24	2	60	0.0333333
NODE_306965_length_131_cov_810.000000	0	60	27	1	60	0.0166667
NODE_306965_length_131_cov_810.000000	0	60	33	1	60	0.0166667
NODE_306965_length_131_cov_810.000000	0	60	35	1	60	0.0166667
NODE_306965_length_131_cov_810.000000	0	60	37	4	60	0.0666667
NODE_306965_length_131_cov_810.000000	0	60	38	1	60	0.0166667
NODE_306965_length_131_cov_810.000000	0	60	44	1	60	0.0166667
NODE_306965_length_131_cov_810.000000	0	60	46	1	60	0.0166667
NODE_306965_length_131_cov_810.000000	0	60	52	4	60	0.0666667
NODE_306965_length_131_cov_810.000000	0	60	56	1	60	0.0166667
NODE_306965_length_131_cov_810.000000	0	60	63	1	60	0.0166667
NODE_306965_length_131_cov_810.000000	0	60	69	1	60	0.0166667
NODE_306965_length_131_cov_810.000000	0	60	71	1	60	0.0166667
NODE_306965_length_131_cov_810.000000	0	60	77	1	60	0.0166667
NODE_306965_length_131_cov_810.000000	0	60	81	1	60	0.0166667
NODE_306965_length_131_cov_810.000000	0	60	86	1	60	0.0166667
NODE_306965_length_131_cov_810.000000	0	60	93	3	60	0.0500000
NODE_306965_length_131_cov_810.000000	0	60	95	1	60	0.0166667
NODE_306965_length_131_cov_810.000000	0	60	106	1	60	0.0166667
NODE_306965_length_131_cov_810.000000	0	60	112	31	60	0.5166667
NODE_306965_length_131_cov_810.000000	33	97	112	64	64	1.0000000
NODE_306965_length_131_cov_810.000000	33	97	112	64	64	1.0000000
NODE_306965_length_131_cov_810.000000	33	97	112	64	64	1.0000000
NODE_306985_length_131_cov_149.187500	25	105	50	2	80	0.0250000
NODE_306985_length_131_cov_149.187500	25	105	52	2	80	0.0250000
NODE_306985_length_131_cov_149.187500	25	105	54	76	80	0.9500000
NODE_306985_length_131_cov_149.187500	78	131	3	1	53	0.0188679
NODE_306985_length_131_cov_149.187500	78	131	4	1	53	0.0188679
NODE_306985_length_131_cov_149.187500	78	131	6	2	53	0.0377358
NODE_306985_length_131_cov_149.187500	78	131	10	2	53	0.0377358
NODE_306985_length_131_cov_149.187500	78	131	12	1	53	0.0188679
NODE_306985_length_131_cov_149.187500	78	131	16	1	53	0.0188679
NODE_306985_length_131_cov_149.187500	78	131	20	1	53	0.0188679
NODE_306985_length_131_cov_149.187500	78	131	24	1	53	0.0188679
NODE_306985_length_131_cov_149.187500	78	131	32	1	53	0.0188679
NODE_306985_length_131_cov_149.187500	78	131	36	2	53	0.0377358
NODE_306985_length_131_cov_149.187500	78	131	42	6	53	0.1132075
NODE_306985_length_131_cov_149.187500	78	131	44	1	53	0.0188679
NODE_306985_length_131_cov_149.187500	78	131	46	3	53	0.0566038
NODE_306985_length_131_cov_149.187500	78	131	48	1	53	0.0188679
NODE_306985_length_131_cov_149.187500	78	131	50	1	53	0.0188679
NODE_306985_length_131_cov_149.187500	78	131	52	2	53	0.0377358
NODE_306985_length_131_cov_149.187500	78	131	54	26	53	0.4905660
NODE_307121_length_130_cov_319.806452	54	126	2	7	72	0.0972222
NODE_307121_length_130_cov_319.806452	54	126	4	2	72	0.0277778
NODE_307121_length_130_cov_319.806452	54	126	6	2	72	0.0277778
NODE_307121_length_130_cov_319.806452	54	126	8	4	72	0.0555556
NODE_307121_length_130_cov_319.806452	54	126	10	3	72	0.0416667
NODE_307121_length_130_cov_319.806452	54	126	14	2	72	0.0277778
NODE_307121_length_130_cov_319.806452	54	126	16	1	72	0.0138889
NODE_307121_length_130_cov_319.806452	54	126	22	1	72	0.0138889
NODE_307121_length_130_cov_319.806452	54	126	24	50	72	0.6944444
NODE_307132_length_130_cov_153.516129	82	113	2	31	31	1.0000000
NODE_307140_length_130_cov_79.064516	0	53	2	5	53	0.0943396
NODE_307140_length_130_cov_79.064516	0	53	4	13	53	0.2452830
NODE_307140_length_130_cov_79.064516	0	53	8	2	53	0.0377358
NODE_307140_length_130_cov_79.064516	0	53	12	3	53	0.0566038
NODE_307140_length_130_cov_79.064516	0	53	14	30	53	0.5660377
NODE_307140_length_130_cov_79.064516	26	56	14	30	30	1.0000000
NODE_307270_length_129_cov_1851.133333	0	45	0	3	45	0.0666667
NODE_307270_length_129_cov_1851.133333	0	45	2	2	45	0.0444444
NODE_307270_length_129_cov_1851.133333	0	45	4	3	45	0.0666667
NODE_307270_length_129_cov_1851.133333	0	45	8	2	45	0.0444444
NODE_307270_length_129_cov_1851.133333	0	45	10	1	45	0.0222222
NODE_307270_length_129_cov_1851.133333	0	45	14	4	45	0.0888889
NODE_307270_length_129_cov_1851.133333	0	45	18	9	45	0.2000000
NODE_307270_length_129_cov_1851.133333	0	45	20	2	45	0.0444444
NODE_307270_length_129_cov_1851.133333	0	45	22	19	45	0.4222222
NODE_307270_length_129_cov_1851.133333	18	98	18	6	80	0.0750000
NODE_307270_length_129_cov_1851.133333	18	98	20	2	80	0.0250000
NODE_307270_length_129_cov_1851.133333	18	98	22	72	80	0.9000000
NODE_307285_length_129_cov_186.500000	0	78	2	10	78	0.1282051
NODE_307285_length_129_cov_186.500000	0	78	6	5	78	0.0641026
NODE_307285_length_129_cov_186.500000	0	78	8	11	78	0.1410256
NODE_307285_length_129_cov_186.500000	0	78	10	52	78	0.6666667
NODE_307285_length_129_cov_186.500000	53	129	4	7	76	0.0921053
NODE_307285_length_129_cov_186.500000	53	129	6	5	76	0.0657895
NODE_307285_length_129_cov_186.500000	53	129	8	9	76	0.1184211
NODE_307285_length_129_cov_186.500000	53	129	10	55	76	0.7236842
NODE_307287_length_129_cov_165.466667	36	111	12	3	75	0.0400000
NODE_307287_length_129_cov_165.466667	36	111	14	4	75	0.0533333
NODE_307287_length_129_cov_165.466667	36	111	18	68	75	0.9066667
NODE_307287_length_129_cov_165.466667	84	113	10	2	29	0.0689655
NODE_307287_length_129_cov_165.466667	84	113	12	3	29	0.1034483
NODE_307287_length_129_cov_165.466667	84	113	14	4	29	0.1379310
NODE_307287_length_129_cov_165.466667	84	113	18	20	29	0.6896552
NODE_307292_length_129_cov_90.366667	0	48	0	13	48	0.2708333
NODE_307292_length_129_cov_90.366667	0	48	2	12	48	0.2500000
NODE_307292_length_129_cov_90.366667	0	48	6	2	48	0.0416667
NODE_307292_length_129_cov_90.366667	0	48	10	21	48	0.4375000
NODE_307292_length_129_cov_90.366667	0	48	0	13	48	0.2708333
NODE_307292_length_129_cov_90.366667	0	48	2	12	48	0.2500000
NODE_307292_length_129_cov_90.366667	0	48	6	2	48	0.0416667
NODE_307292_length_129_cov_90.366667	0	48	10	21	48	0.4375000
NODE_307292_length_129_cov_90.366667	0	48	0	13	48	0.2708333
NODE_307292_length_129_cov_90.366667	0	48	2	12	48	0.2500000
NODE_307292_length_129_cov_90.366667	0	48	6	2	48	0.0416667
NODE_307292_length_129_cov_90.366667	0	48	10	21	48	0.4375000
NODE_307292_length_129_cov_90.366667	21	101	2	4	80	0.0500000
NODE_307292_length_129_cov_90.366667	21	101	6	2	80	0.0250000
NODE_307292_length_129_cov_90.366667	21	101	10	74	80	0.9250000
NODE_307442_length_128_cov_2621.517241	3	83	14	1	80	0.0125000
NODE_307442_length_128_cov_2621.517241	3	83	18	1	80	0.0125000
NODE_307442_length_128_cov_2621.517241	3	83	20	2	80	0.0250000
NODE_307442_length_128_cov_2621.517241	3	83	22	2	80	0.0250000
NODE_307442_length_128_cov_2621.517241	3	83	26	1	80	0.0125000
NODE_307442_length_128_cov_2621.517241	3	83	28	1	80	0.0125000
NODE_307442_length_128_cov_2621.517241	3	83	32	1	80	0.0125000
NODE_307442_length_128_cov_2621.517241	3	83	36	1	80	0.0125000
NODE_307442_length_128_cov_2621.517241	3	83	38	1	80	0.0125000
NODE_307442_length_128_cov_2621.517241	3	83	40	1	80	0.0125000
NODE_307442_length_128_cov_2621.517241	3	83	44	2	80	0.0250000
NODE_307442_length_128_cov_2621.517241	3	83	46	3	80	0.0375000
NODE_307442_length_128_cov_2621.517241	3	83	48	63	80	0.7875000
NODE_307442_length_128_cov_2621.517241	8	30	22	1	22	0.0454545
NODE_307442_length_128_cov_2621.517241	8	30	26	1	22	0.0454545
NODE_307442_length_128_cov_2621.517241	8	30	28	1	22	0.0454545
NODE_307442_length_128_cov_2621.517241	8	30	32	1	22	0.0454545
NODE_307442_length_128_cov_2621.517241	8	30	36	1	22	0.0454545
NODE_307442_length_128_cov_2621.517241	8	30	38	1	22	0.0454545
NODE_307442_length_128_cov_2621.517241	8	30	40	1	22	0.0454545
NODE_307442_length_128_cov_2621.517241	8	30	44	2	22	0.0909091
NODE_307442_length_128_cov_2621.517241	8	30	46	3	22	0.1363636
NODE_307442_length_128_cov_2621.517241	8	30	48	10	22	0.4545455
NODE_307442_length_128_cov_2621.517241	56	128	6	3	72	0.0416667
NODE_307442_length_128_cov_2621.517241	56	128	8	1	72	0.0138889
NODE_307442_length_128_cov_2621.517241	56	128	12	1	72	0.0138889
NODE_307442_length_128_cov_2621.517241	56	128	14	4	72	0.0555556
NODE_307442_length_128_cov_2621.517241	56	128	16	1	72	0.0138889
NODE_307442_length_128_cov_2621.517241	56	128	18	1	72	0.0138889
NODE_307442_length_128_cov_2621.517241	56	128	20	2	72	0.0277778
NODE_307442_length_128_cov_2621.517241	56	128	24	1	72	0.0138889
NODE_307442_length_128_cov_2621.517241	56	128	29	3	72	0.0416667
NODE_307442_length_128_cov_2621.517241	56	128	30	3	72	0.0416667
NODE_307442_length_128_cov_2621.517241	56	128	34	1	72	0.0138889
NODE_307442_length_128_cov_2621.517241	56	128	44	2	72	0.0277778
NODE_307442_length_128_cov_2621.517241	56	128	46	1	72	0.0138889
NODE_307442_length_128_cov_2621.517241	56	128	48	48	72	0.6666667
NODE_307443_length_128_cov_1604.275862	58	127	0	2	69	0.0289855
NODE_307443_length_128_cov_1604.275862	58	127	2	4	69	0.0579710
NODE_307443_length_128_cov_1604.275862	58	127	4	5	69	0.0724638
NODE_307443_length_128_cov_1604.275862	58	127	8	2	69	0.0289855
NODE_307443_length_128_cov_1604.275862	58	127	10	3	69	0.0434783
NODE_307443_length_128_cov_1604.275862	58	127	11	1	69	0.0144928
NODE_307443_length_128_cov_1604.275862	58	127	12	52	69	0.7536232
NODE_307458_length_128_cov_79.034483	43	123	2	80	80	1.0000000
NODE_307464_length_128_cov_61.793103	5	85	0	5	80	0.0625000
NODE_307464_length_128_cov_61.793103	5	85	2	75	80	0.9375000
NODE_307549_length_127_cov_1879.785714	21	101	44	2	80	0.0250000
NODE_307549_length_127_cov_1879.785714	21	101	53	1	80	0.0125000
NODE_307549_length_127_cov_1879.785714	21	101	56	1	80	0.0125000
NODE_307549_length_127_cov_1879.785714	21	101	58	76	80	0.9500000
NODE_307549_length_127_cov_1879.785714	74	127	8	1	53	0.0188679
NODE_307549_length_127_cov_1879.785714	74	127	10	6	53	0.1132075
NODE_307549_length_127_cov_1879.785714	74	127	12	1	53	0.0188679
NODE_307549_length_127_cov_1879.785714	74	127	14	2	53	0.0377358
NODE_307549_length_127_cov_1879.785714	74	127	18	1	53	0.0188679
NODE_307549_length_127_cov_1879.785714	74	127	22	1	53	0.0188679
NODE_307549_length_127_cov_1879.785714	74	127	26	1	53	0.0188679
NODE_307549_length_127_cov_1879.785714	74	127	35	1	53	0.0188679
NODE_307549_length_127_cov_1879.785714	74	127	40	1	53	0.0188679
NODE_307549_length_127_cov_1879.785714	74	127	42	2	53	0.0377358
NODE_307549_length_127_cov_1879.785714	74	127	44	1	53	0.0188679
NODE_307549_length_127_cov_1879.785714	74	127	46	1	53	0.0188679
NODE_307549_length_127_cov_1879.785714	74	127	52	5	53	0.0943396
NODE_307549_length_127_cov_1879.785714	74	127	54	1	53	0.0188679
NODE_307549_length_127_cov_1879.785714	74	127	58	28	53	0.5283019
NODE_307583_length_127_cov_66.142857	38	118	0	80	80	1.0000000
NODE_307583_length_127_cov_66.142857	47	118	0	71	71	1.0000000
NODE_307590_length_127_cov_38.285714	12	86	4	74	74	1.0000000
NODE_307596_length_127_cov_30.607143	21	93	0	72	72	1.0000000
NODE_307662_length_126_cov_936.777778	24	96	2	72	72	1.0000000
NODE_307675_length_126_cov_147.185185	2	66	2	17	64	0.2656250
NODE_307675_length_126_cov_147.185185	2	66	4	47	64	0.7343750
NODE_307675_length_126_cov_147.185185	2	66	2	17	64	0.2656250
NODE_307675_length_126_cov_147.185185	2	66	4	47	64	0.7343750
NODE_307675_length_126_cov_147.185185	2	66	2	17	64	0.2656250
NODE_307675_length_126_cov_147.185185	2	66	4	47	64	0.7343750
NODE_307675_length_126_cov_147.185185	39	99	4	60	60	1.0000000
NODE_307675_length_126_cov_147.185185	55	99	4	44	44	1.0000000
NODE_307684_length_126_cov_82.518519	44	75	0	31	31	1.0000000
NODE_307793_length_125_cov_656.807692	19	99	54	1	80	0.0125000
NODE_307793_length_125_cov_656.807692	19	99	62	1	80	0.0125000
NODE_307793_length_125_cov_656.807692	19	99	66	1	80	0.0125000
NODE_307793_length_125_cov_656.807692	19	99	68	77	80	0.9625000
NODE_307806_length_125_cov_143.615385	52	125	0	12	73	0.1643836
NODE_307806_length_125_cov_143.615385	52	125	2	61	73	0.8356164
NODE_307810_length_125_cov_131.923077	3	52	2	3	49	0.0612245
NODE_307810_length_125_cov_131.923077	3	52	4	9	49	0.1836735
NODE_307810_length_125_cov_131.923077	3	52	8	2	49	0.0408163
NODE_307810_length_125_cov_131.923077	3	52	10	6	49	0.1224490
NODE_307810_length_125_cov_131.923077	3	52	12	29	49	0.5918368
NODE_307810_length_125_cov_131.923077	25	89	12	64	64	1.0000000
NODE_307810_length_125_cov_131.923077	25	89	12	64	64	1.0000000
NODE_307816_length_125_cov_102.500000	0	56	0	10	56	0.1785714
NODE_307816_length_125_cov_102.500000	0	56	4	1	56	0.0178571
NODE_307816_length_125_cov_102.500000	0	56	6	3	56	0.0535714
NODE_307816_length_125_cov_102.500000	0	56	8	1	56	0.0178571
NODE_307816_length_125_cov_102.500000	0	56	10	1	56	0.0178571
NODE_307816_length_125_cov_102.500000	0	56	14	40	56	0.7142857
NODE_307816_length_125_cov_102.500000	7	56	0	3	49	0.0612245
NODE_307816_length_125_cov_102.500000	7	56	4	1	49	0.0204082
NODE_307816_length_125_cov_102.500000	7	56	6	3	49	0.0612245
NODE_307816_length_125_cov_102.500000	7	56	8	1	49	0.0204082
NODE_307816_length_125_cov_102.500000	7	56	10	1	49	0.0204082
NODE_307816_length_125_cov_102.500000	7	56	14	40	49	0.8163266
NODE_307816_length_125_cov_102.500000	29	114	2	2	85	0.0235294
NODE_307816_length_125_cov_102.500000	29	114	4	2	85	0.0235294
NODE_307816_length_125_cov_102.500000	29	114	7	1	85	0.0117647
NODE_307816_length_125_cov_102.500000	29	114	10	3	85	0.0352941
NODE_307816_length_125_cov_102.500000	29	114	13	1	85	0.0117647
NODE_307816_length_125_cov_102.500000	29	114	14	76	85	0.8941177
NODE_307816_length_125_cov_102.500000	29	114	2	2	85	0.0235294
NODE_307816_length_125_cov_102.500000	29	114	4	2	85	0.0235294
NODE_307816_length_125_cov_102.500000	29	114	7	1	85	0.0117647
NODE_307816_length_125_cov_102.500000	29	114	10	3	85	0.0352941
NODE_307816_length_125_cov_102.500000	29	114	13	1	85	0.0117647
NODE_307816_length_125_cov_102.500000	29	114	14	76	85	0.8941177
NODE_307816_length_125_cov_102.500000	29	114	2	2	85	0.0235294
NODE_307816_length_125_cov_102.500000	29	114	4	2	85	0.0235294
NODE_307816_length_125_cov_102.500000	29	114	7	1	85	0.0117647
NODE_307816_length_125_cov_102.500000	29	114	10	3	85	0.0352941
NODE_307816_length_125_cov_102.500000	29	114	13	1	85	0.0117647
NODE_307816_length_125_cov_102.500000	29	114	14	76	85	0.8941177
NODE_307839_length_125_cov_28.115385	17	90	6	1	73	0.0136986
NODE_307839_length_125_cov_28.115385	17	90	8	72	73	0.9863014
NODE_307839_length_125_cov_28.115385	57	98	8	41	41	1.0000000
NODE_307906_length_124_cov_945.680000	0	73	2	1	73	0.0136986
NODE_307906_length_124_cov_945.680000	0	73	4	2	73	0.0273973
NODE_307906_length_124_cov_945.680000	0	73	6	4	73	0.0547945
NODE_307906_length_124_cov_945.680000	0	73	8	6	73	0.0821918
NODE_307906_length_124_cov_945.680000	0	73	10	3	73	0.0410959
NODE_307906_length_124_cov_945.680000	0	73	12	2	73	0.0273973
NODE_307906_length_124_cov_945.680000	0	73	16	55	73	0.7534246
NODE_307906_length_124_cov_945.680000	53	124	0	2	71	0.0281690
NODE_307906_length_124_cov_945.680000	53	124	2	1	71	0.0140845
NODE_307906_length_124_cov_945.680000	53	124	4	1	71	0.0140845
NODE_307906_length_124_cov_945.680000	53	124	6	5	71	0.0704225
NODE_307906_length_124_cov_945.680000	53	124	7	1	71	0.0140845
NODE_307906_length_124_cov_945.680000	53	124	8	2	71	0.0281690
NODE_307906_length_124_cov_945.680000	53	124	10	5	71	0.0704225
NODE_307906_length_124_cov_945.680000	53	124	14	1	71	0.0140845
NODE_307906_length_124_cov_945.680000	53	124	16	53	71	0.7464789
NODE_308023_length_123_cov_1186.083333	0	76	2	2	76	0.0263158
NODE_308023_length_123_cov_1186.083333	0	76	8	1	76	0.0131579
NODE_308023_length_123_cov_1186.083333	0	76	10	3	76	0.0394737
NODE_308023_length_123_cov_1186.083333	0	76	12	2	76	0.0263158
NODE_308023_length_123_cov_1186.083333	0	76	16	1	76	0.0131579
NODE_308023_length_123_cov_1186.083333	0	76	18	1	76	0.0131579
NODE_308023_length_123_cov_1186.083333	0	76	20	1	76	0.0131579
NODE_308023_length_123_cov_1186.083333	0	76	22	2	76	0.0263158
NODE_308023_length_123_cov_1186.083333	0	76	24	1	76	0.0131579
NODE_308023_length_123_cov_1186.083333	0	76	26	2	76	0.0263158
NODE_308023_length_123_cov_1186.083333	0	76	30	4	76	0.0526316
NODE_308023_length_123_cov_1186.083333	0	76	32	56	76	0.7368421
NODE_308023_length_123_cov_1186.083333	0	76	2	2	76	0.0263158
NODE_308023_length_123_cov_1186.083333	0	76	8	1	76	0.0131579
NODE_308023_length_123_cov_1186.083333	0	76	10	3	76	0.0394737
NODE_308023_length_123_cov_1186.083333	0	76	12	2	76	0.0263158
NODE_308023_length_123_cov_1186.083333	0	76	16	1	76	0.0131579
NODE_308023_length_123_cov_1186.083333	0	76	18	1	76	0.0131579
NODE_308023_length_123_cov_1186.083333	0	76	20	1	76	0.0131579
NODE_308023_length_123_cov_1186.083333	0	76	22	2	76	0.0263158
NODE_308023_length_123_cov_1186.083333	0	76	24	1	76	0.0131579
NODE_308023_length_123_cov_1186.083333	0	76	26	2	76	0.0263158
NODE_308023_length_123_cov_1186.083333	0	76	30	4	76	0.0526316
NODE_308023_length_123_cov_1186.083333	0	76	32	56	76	0.7368421
NODE_308023_length_123_cov_1186.083333	0	76	2	2	76	0.0263158
NODE_308023_length_123_cov_1186.083333	0	76	8	1	76	0.0131579
NODE_308023_length_123_cov_1186.083333	0	76	10	3	76	0.0394737
NODE_308023_length_123_cov_1186.083333	0	76	12	2	76	0.0263158
NODE_308023_length_123_cov_1186.083333	0	76	16	1	76	0.0131579
NODE_308023_length_123_cov_1186.083333	0	76	18	1	76	0.0131579
NODE_308023_length_123_cov_1186.083333	0	76	20	1	76	0.0131579
NODE_308023_length_123_cov_1186.083333	0	76	22	2	76	0.0263158
NODE_308023_length_123_cov_1186.083333	0	76	24	1	76	0.0131579
NODE_308023_length_123_cov_1186.083333	0	76	26	2	76	0.0263158
NODE_308023_length_123_cov_1186.083333	0	76	30	4	76	0.0526316
NODE_308023_length_123_cov_1186.083333	0	76	32	56	76	0.7368421
NODE_308023_length_123_cov_1186.083333	0	76	2	2	76	0.0263158
NODE_308023_length_123_cov_1186.083333	0	76	8	1	76	0.0131579
NODE_308023_length_123_cov_1186.083333	0	76	10	3	76	0.0394737
NODE_308023_length_123_cov_1186.083333	0	76	12	2	76	0.0263158
NODE_308023_length_123_cov_1186.083333	0	76	16	1	76	0.0131579
NODE_308023_length_123_cov_1186.083333	0	76	18	1	76	0.0131579
NODE_308023_length_123_cov_1186.083333	0	76	20	1	76	0.0131579
NODE_308023_length_123_cov_1186.083333	0	76	22	2	76	0.0263158
NODE_308023_length_123_cov_1186.083333	0	76	24	1	76	0.0131579
NODE_308023_length_123_cov_1186.083333	0	76	26	2	76	0.0263158
NODE_308023_length_123_cov_1186.083333	0	76	30	4	76	0.0526316
NODE_308023_length_123_cov_1186.083333	0	76	32	56	76	0.7368421
NODE_308023_length_123_cov_1186.083333	49	123	4	1	74	0.0135135
NODE_308023_length_123_cov_1186.083333	49	123	6	2	74	0.0270270
NODE_308023_length_123_cov_1186.083333	49	123	12	1	74	0.0135135
NODE_308023_length_123_cov_1186.083333	49	123	14	2	74	0.0270270
NODE_308023_length_123_cov_1186.083333	49	123	16	3	74	0.0405405
NODE_308023_length_123_cov_1186.083333	49	123	18	3	74	0.0405405
NODE_308023_length_123_cov_1186.083333	49	123	20	1	74	0.0135135
NODE_308023_length_123_cov_1186.083333	49	123	24	2	74	0.0270270
NODE_308023_length_123_cov_1186.083333	49	123	26	1	74	0.0135135
NODE_308023_length_123_cov_1186.083333	49	123	28	1	74	0.0135135
NODE_308023_length_123_cov_1186.083333	49	123	31	1	74	0.0135135
NODE_308023_length_123_cov_1186.083333	49	123	32	56	74	0.7567568
NODE_308023_length_123_cov_1186.083333	49	123	4	1	74	0.0135135
NODE_308023_length_123_cov_1186.083333	49	123	6	2	74	0.0270270
NODE_308023_length_123_cov_1186.083333	49	123	12	1	74	0.0135135
NODE_308023_length_123_cov_1186.083333	49	123	14	2	74	0.0270270
NODE_308023_length_123_cov_1186.083333	49	123	16	3	74	0.0405405
NODE_308023_length_123_cov_1186.083333	49	123	18	3	74	0.0405405
NODE_308023_length_123_cov_1186.083333	49	123	20	1	74	0.0135135
NODE_308023_length_123_cov_1186.083333	49	123	24	2	74	0.0270270
NODE_308023_length_123_cov_1186.083333	49	123	26	1	74	0.0135135
NODE_308023_length_123_cov_1186.083333	49	123	28	1	74	0.0135135
NODE_308023_length_123_cov_1186.083333	49	123	31	1	74	0.0135135
NODE_308023_length_123_cov_1186.083333	49	123	32	56	74	0.7567568
NODE_308023_length_123_cov_1186.083333	49	123	4	1	74	0.0135135
NODE_308023_length_123_cov_1186.083333	49	123	6	2	74	0.0270270
NODE_308023_length_123_cov_1186.083333	49	123	12	1	74	0.0135135
NODE_308023_length_123_cov_1186.083333	49	123	14	2	74	0.0270270
NODE_308023_length_123_cov_1186.083333	49	123	16	3	74	0.0405405
NODE_308023_length_123_cov_1186.083333	49	123	18	3	74	0.0405405
NODE_308023_length_123_cov_1186.083333	49	123	20	1	74	0.0135135
NODE_308023_length_123_cov_1186.083333	49	123	24	2	74	0.0270270
NODE_308023_length_123_cov_1186.083333	49	123	26	1	74	0.0135135
NODE_308023_length_123_cov_1186.083333	49	123	28	1	74	0.0135135
NODE_308023_length_123_cov_1186.083333	49	123	31	1	74	0.0135135
NODE_308023_length_123_cov_1186.083333	49	123	32	56	74	0.7567568
NODE_308024_length_123_cov_963.500000	19	88	0	69	69	1.0000000
NODE_308037_length_123_cov_181.291667	0	47	0	47	47	1.0000000
NODE_308037_length_123_cov_181.291667	24	100	0	76	76	1.0000000
NODE_308057_length_123_cov_55.375000	52	123	4	20	71	0.2816902
NODE_308057_length_123_cov_55.375000	52	123	6	51	71	0.7183099
NODE_308057_length_123_cov_55.375000	52	123	4	20	71	0.2816902
NODE_308057_length_123_cov_55.375000	52	123	6	51	71	0.7183099
NODE_308057_length_123_cov_55.375000	61	123	4	20	62	0.3225806
NODE_308057_length_123_cov_55.375000	61	123	6	42	62	0.6774194
NODE_308068_length_123_cov_40.958333	9	89	8	4	80	0.0500000
NODE_308068_length_123_cov_40.958333	9	89	12	76	80	0.9500000
NODE_308068_length_123_cov_40.958333	9	89	8	4	80	0.0500000
NODE_308068_length_123_cov_40.958333	9	89	12	76	80	0.9500000
NODE_308068_length_123_cov_40.958333	9	89	8	4	80	0.0500000
NODE_308068_length_123_cov_40.958333	9	89	12	76	80	0.9500000
NODE_308068_length_123_cov_40.958333	9	89	8	4	80	0.0500000
NODE_308068_length_123_cov_40.958333	9	89	12	76	80	0.9500000
NODE_308068_length_123_cov_40.958333	9	89	8	4	80	0.0500000
NODE_308068_length_123_cov_40.958333	9	89	12	76	80	0.9500000
NODE_308068_length_123_cov_40.958333	9	80	8	4	71	0.0563380
NODE_308068_length_123_cov_40.958333	9	80	12	67	71	0.9436620
NODE_308180_length_122_cov_111.043478	8	88	0	80	80	1.0000000
NODE_308180_length_122_cov_111.043478	8	88	0	80	80	1.0000000
NODE_308184_length_122_cov_67.565217	0	50	0	1	50	0.0200000
NODE_308184_length_122_cov_67.565217	0	50	2	8	50	0.1600000
NODE_308184_length_122_cov_67.565217	0	50	6	41	50	0.8200000
NODE_308184_length_122_cov_67.565217	0	50	0	1	50	0.0200000
NODE_308184_length_122_cov_67.565217	0	50	2	8	50	0.1600000
NODE_308184_length_122_cov_67.565217	0	50	6	41	50	0.8200000
NODE_308184_length_122_cov_67.565217	23	103	6	80	80	1.0000000
NODE_308184_length_122_cov_67.565217	23	103	6	80	80	1.0000000
NODE_308184_length_122_cov_67.565217	23	103	6	80	80	1.0000000
NODE_308184_length_122_cov_67.565217	23	103	6	80	80	1.0000000
NODE_308184_length_122_cov_67.565217	23	103	6	80	80	1.0000000
NODE_308184_length_122_cov_67.565217	23	94	6	71	71	1.0000000
NODE_308188_length_122_cov_58.826087	28	99	0	71	71	1.0000000
NODE_308188_length_122_cov_58.826087	33	99	0	66	66	1.0000000
NODE_308188_length_122_cov_58.826087	72	122	0	50	50	1.0000000
NODE_308188_length_122_cov_58.826087	72	122	0	50	50	1.0000000
NODE_308198_length_122_cov_38.173913	12	93	0	81	81	1.0000000
NODE_308257_length_121_cov_159.318182	24	55	4	31	31	1.0000000
NODE_308260_length_121_cov_120.181818	20	100	2	80	80	1.0000000
NODE_308260_length_121_cov_120.181818	20	95	2	75	75	1.0000000
NODE_308260_length_121_cov_120.181818	20	100	2	80	80	1.0000000
NODE_308260_length_121_cov_120.181818	29	100	2	71	71	1.0000000
NODE_308273_length_121_cov_54.181818	7	70	0	63	63	1.0000000
NODE_308273_length_121_cov_54.181818	7	70	0	63	63	1.0000000
NODE_308273_length_121_cov_54.181818	7	70	0	63	63	1.0000000
NODE_308273_length_121_cov_54.181818	9	70	0	61	61	1.0000000
NODE_308273_length_121_cov_54.181818	43	109	0	66	66	1.0000000
NODE_308273_length_121_cov_54.181818	43	121	0	78	78	1.0000000
NODE_308273_length_121_cov_54.181818	64	117	0	53	53	1.0000000
NODE_308317_length_120_cov_1404.619048	0	64	0	2	64	0.0312500
NODE_308317_length_120_cov_1404.619048	0	64	4	1	64	0.0156250
NODE_308317_length_120_cov_1404.619048	0	64	6	2	64	0.0312500
NODE_308317_length_120_cov_1404.619048	0	64	8	1	64	0.0156250
NODE_308317_length_120_cov_1404.619048	0	64	10	1	64	0.0156250
NODE_308317_length_120_cov_1404.619048	0	64	12	2	64	0.0312500
NODE_308317_length_120_cov_1404.619048	0	64	14	1	64	0.0156250
NODE_308317_length_120_cov_1404.619048	0	64	18	2	64	0.0312500
NODE_308317_length_120_cov_1404.619048	0	64	20	4	64	0.0625000
NODE_308317_length_120_cov_1404.619048	0	64	22	48	64	0.7500000
NODE_308317_length_120_cov_1404.619048	45	117	6	2	72	0.0277778
NODE_308317_length_120_cov_1404.619048	45	117	8	2	72	0.0277778
NODE_308317_length_120_cov_1404.619048	45	117	10	1	72	0.0138889
NODE_308317_length_120_cov_1404.619048	45	117	12	2	72	0.0277778
NODE_308317_length_120_cov_1404.619048	45	117	16	1	72	0.0138889
NODE_308317_length_120_cov_1404.619048	45	117	22	64	72	0.8888889
NODE_308318_length_120_cov_1138.428571	19	99	0	80	80	1.0000000
NODE_308318_length_120_cov_1138.428571	72	120	0	48	48	1.0000000
NODE_308357_length_120_cov_54.666667	0	69	2	69	69	1.0000000
NODE_308357_length_120_cov_54.666667	0	69	2	69	69	1.0000000
NODE_308357_length_120_cov_54.666667	0	69	2	69	69	1.0000000
NODE_308357_length_120_cov_54.666667	42	108	2	66	66	1.0000000
NODE_308357_length_120_cov_54.666667	53	120	0	6	67	0.0895522
NODE_308357_length_120_cov_54.666667	53	120	2	61	67	0.9104478
NODE_308357_length_120_cov_54.666667	53	120	0	6	67	0.0895522
NODE_308357_length_120_cov_54.666667	53	120	2	61	67	0.9104478
NODE_308487_length_118_cov_1211.578947	49	116	0	67	67	1.0000000
NODE_308488_length_118_cov_1157.157895	4	70	2	2	66	0.0303030
NODE_308488_length_118_cov_1157.157895	4	70	4	4	66	0.0606061
NODE_308488_length_118_cov_1157.157895	4	70	6	2	66	0.0303030
NODE_308488_length_118_cov_1157.157895	4	70	10	58	66	0.8787879
NODE_308500_length_118_cov_218.210526	0	63	0	1	63	0.0158730
NODE_308500_length_118_cov_218.210526	0	63	2	12	63	0.1904762
NODE_308500_length_118_cov_218.210526	0	63	4	50	63	0.7936508
NODE_308500_length_118_cov_218.210526	35	115	2	3	80	0.0375000
NODE_308500_length_118_cov_218.210526	35	115	4	77	80	0.9625000
NODE_308504_length_118_cov_161.052632	4	70	0	66	66	1.0000000
NODE_308572_length_117_cov_338.555556	7	70	8	5	63	0.0793651
NODE_308572_length_117_cov_338.555556	7	70	10	58	63	0.9206349
NODE_308572_length_117_cov_338.555556	7	70	8	5	63	0.0793651
NODE_308572_length_117_cov_338.555556	7	70	10	58	63	0.9206349
NODE_308572_length_117_cov_338.555556	7	70	8	5	63	0.0793651
NODE_308572_length_117_cov_338.555556	7	70	10	58	63	0.9206349
NODE_308572_length_117_cov_338.555556	9	70	8	3	61	0.0491803
NODE_308572_length_117_cov_338.555556	9	70	10	58	61	0.9508197
NODE_308572_length_117_cov_338.555556	43	109	4	3	66	0.0454545
NODE_308572_length_117_cov_338.555556	43	109	6	1	66	0.0151515
NODE_308572_length_117_cov_338.555556	43	109	8	1	66	0.0151515
NODE_308572_length_117_cov_338.555556	43	109	10	61	66	0.9242424
NODE_308572_length_117_cov_338.555556	43	114	2	1	71	0.0140845
NODE_308572_length_117_cov_338.555556	43	114	4	7	71	0.0985916
NODE_308572_length_117_cov_338.555556	43	114	6	1	71	0.0140845
NODE_308572_length_117_cov_338.555556	43	114	8	1	71	0.0140845
NODE_308572_length_117_cov_338.555556	43	114	10	61	71	0.8591549
NODE_308572_length_117_cov_338.555556	64	117	0	2	53	0.0377358
NODE_308572_length_117_cov_338.555556	64	117	2	2	53	0.0377358
NODE_308572_length_117_cov_338.555556	64	117	4	7	53	0.1320755
NODE_308572_length_117_cov_338.555556	64	117	6	1	53	0.0188679
NODE_308572_length_117_cov_338.555556	64	117	8	1	53	0.0188679
NODE_308572_length_117_cov_338.555556	64	117	10	40	53	0.7547170
NODE_308654_length_116_cov_1897.470588	0	77	2	1	77	0.0129870
NODE_308654_length_116_cov_1897.470588	0	77	4	3	77	0.0389610
NODE_308654_length_116_cov_1897.470588	0	77	6	8	77	0.1038961
NODE_308654_length_116_cov_1897.470588	0	77	8	1	77	0.0129870
NODE_308654_length_116_cov_1897.470588	0	77	10	1	77	0.0129870
NODE_308654_length_116_cov_1897.470588	0	77	14	63	77	0.8181818
NODE_308654_length_116_cov_1897.470588	34	111	8	1	77	0.0129870
NODE_308654_length_116_cov_1897.470588	34	111	10	2	77	0.0259740
NODE_308654_length_116_cov_1897.470588	34	111	12	2	77	0.0259740
NODE_308654_length_116_cov_1897.470588	34	111	14	72	77	0.9350649
NODE_308668_length_116_cov_438.529412	15	95	2	80	80	1.0000000
NODE_308668_length_116_cov_438.529412	68	116	0	1	48	0.0208333
NODE_308668_length_116_cov_438.529412	68	116	2	47	48	0.9791667
NODE_308701_length_116_cov_93.235294	52	116	0	13	64	0.2031250
NODE_308701_length_116_cov_93.235294	52	116	4	51	64	0.7968750
NODE_308722_length_116_cov_46.882353	6	66	0	1	60	0.0166667
NODE_308722_length_116_cov_46.882353	6	66	8	3	60	0.0500000
NODE_308722_length_116_cov_46.882353	6	66	12	3	60	0.0500000
NODE_308722_length_116_cov_46.882353	6	66	14	53	60	0.8833333
NODE_308727_length_116_cov_38.352941	20	100	6	80	80	1.0000000
NODE_308746_length_115_cov_1012.625000	31	114	8	1	83	0.0120482
NODE_308746_length_115_cov_1012.625000	31	114	10	1	83	0.0120482
NODE_308746_length_115_cov_1012.625000	31	114	12	6	83	0.0722892
NODE_308746_length_115_cov_1012.625000	31	114	14	3	83	0.0361446
NODE_308746_length_115_cov_1012.625000	31	114	16	1	83	0.0120482
NODE_308746_length_115_cov_1012.625000	31	114	18	71	83	0.8554217
NODE_308750_length_115_cov_776.625000	9	92	4	2	83	0.0240964
NODE_308750_length_115_cov_776.625000	9	92	6	81	83	0.9759036
NODE_308752_length_115_cov_623.937500	0	74	0	2	74	0.0270270
NODE_308752_length_115_cov_623.937500	0	74	2	1	74	0.0135135
NODE_308752_length_115_cov_623.937500	0	74	4	7	74	0.0945946
NODE_308752_length_115_cov_623.937500	0	74	6	64	74	0.8648649
NODE_308782_length_115_cov_144.812500	4	73	0	69	69	1.0000000
NODE_308806_length_115_cov_65.187500	16	76	8	60	60	1.0000000
NODE_308846_length_114_cov_819.466667	40	114	0	2	74	0.0270270
NODE_308846_length_114_cov_819.466667	40	114	2	72	74	0.9729730
NODE_308846_length_114_cov_819.466667	40	114	0	2	74	0.0270270
NODE_308846_length_114_cov_819.466667	40	114	2	72	74	0.9729730
NODE_308846_length_114_cov_819.466667	49	114	0	2	65	0.0307692
NODE_308846_length_114_cov_819.466667	49	114	2	63	65	0.9692308
NODE_308866_length_114_cov_285.666667	0	78	0	1	78	0.0128205
NODE_308866_length_114_cov_285.666667	0	78	2	4	78	0.0512821
NODE_308866_length_114_cov_285.666667	0	78	6	1	78	0.0128205
NODE_308866_length_114_cov_285.666667	0	78	8	1	78	0.0128205
NODE_308866_length_114_cov_285.666667	0	78	10	3	78	0.0384615
NODE_308866_length_114_cov_285.666667	0	78	14	68	78	0.8717949
NODE_308866_length_114_cov_285.666667	51	114	0	2	63	0.0317460
NODE_308866_length_114_cov_285.666667	51	114	2	1	63	0.0158730
NODE_308866_length_114_cov_285.666667	51	114	4	3	63	0.0476190
NODE_308866_length_114_cov_285.666667	51	114	6	3	63	0.0476190
NODE_308866_length_114_cov_285.666667	51	114	12	1	63	0.0158730
NODE_308866_length_114_cov_285.666667	51	114	14	53	63	0.8412699
NODE_308886_length_114_cov_83.600000	51	82	0	31	31	1.0000000
NODE_308891_length_114_cov_67.666667	40	90	0	50	50	1.0000000
NODE_308939_length_113_cov_446.214286	5	82	0	77	77	1.0000000
NODE_308939_length_113_cov_446.214286	5	82	0	77	77	1.0000000
NODE_308967_length_113_cov_160.071429	0	64	4	2	64	0.0312500
NODE_308967_length_113_cov_160.071429	0	64	6	5	64	0.0781250
NODE_308967_length_113_cov_160.071429	0	64	8	57	64	0.8906250
NODE_308967_length_113_cov_160.071429	0	64	4	2	64	0.0312500
NODE_308967_length_113_cov_160.071429	0	64	6	5	64	0.0781250
NODE_308967_length_113_cov_160.071429	0	64	8	57	64	0.8906250
NODE_308967_length_113_cov_160.071429	37	103	8	66	66	1.0000000
NODE_308967_length_113_cov_160.071429	37	108	7	2	71	0.0281690
NODE_308967_length_113_cov_160.071429	37	108	8	69	71	0.9718310
NODE_309037_length_112_cov_963.384615	43	112	2	3	69	0.0434783
NODE_309037_length_112_cov_963.384615	43	112	4	66	69	0.9565217
NODE_309044_length_112_cov_653.615385	7	78	0	71	71	1.0000000
NODE_309044_length_112_cov_653.615385	12	78	0	66	66	1.0000000
NODE_309044_length_112_cov_653.615385	51	112	0	61	61	1.0000000
NODE_309044_length_112_cov_653.615385	51	112	0	61	61	1.0000000
NODE_309067_length_112_cov_219.538462	0	62	0	62	62	1.0000000
NODE_309067_length_112_cov_219.538462	0	57	0	57	57	1.0000000
NODE_309067_length_112_cov_219.538462	0	62	0	62	62	1.0000000
NODE_309067_length_112_cov_219.538462	0	59	0	59	59	1.0000000
NODE_309067_length_112_cov_219.538462	35	112	0	77	77	1.0000000
NODE_309067_length_112_cov_219.538462	35	112	0	77	77	1.0000000
NODE_309067_length_112_cov_219.538462	35	112	0	77	77	1.0000000
NODE_309078_length_112_cov_160.307692	0	69	0	3	69	0.0434783
NODE_309078_length_112_cov_160.307692	0	69	2	3	69	0.0434783
NODE_309078_length_112_cov_160.307692	0	69	4	63	69	0.9130435
NODE_309079_length_112_cov_134.846154	11	91	0	80	80	1.0000000
NODE_309079_length_112_cov_134.846154	11	91	0	80	80	1.0000000
NODE_309079_length_112_cov_134.846154	64	112	0	48	48	1.0000000
NODE_309079_length_112_cov_134.846154	64	112	0	48	48	1.0000000
NODE_309079_length_112_cov_134.846154	64	112	0	48	48	1.0000000
NODE_309092_length_112_cov_84.384615	10	90	6	80	80	1.0000000
NODE_309097_length_112_cov_72.769231	36	100	0	64	64	1.0000000
NODE_309106_length_112_cov_35.307692	13	76	0	63	63	1.0000000
NODE_309123_length_111_cov_1107.833333	0	52	0	52	52	1.0000000
NODE_309123_length_111_cov_1107.833333	0	52	0	52	52	1.0000000
NODE_309123_length_111_cov_1107.833333	0	52	0	52	52	1.0000000
NODE_309123_length_111_cov_1107.833333	0	52	0	52	52	1.0000000
NODE_309123_length_111_cov_1107.833333	25	105	0	80	80	1.0000000
NODE_309123_length_111_cov_1107.833333	25	105	0	80	80	1.0000000
NODE_309123_length_111_cov_1107.833333	25	105	0	80	80	1.0000000
NODE_309123_length_111_cov_1107.833333	25	105	0	80	80	1.0000000
NODE_309123_length_111_cov_1107.833333	25	105	0	80	80	1.0000000
NODE_309123_length_111_cov_1107.833333	25	105	0	80	80	1.0000000
NODE_309126_length_111_cov_827.500000	3	74	8	3	71	0.0422535
NODE_309126_length_111_cov_827.500000	3	74	10	3	71	0.0422535
NODE_309126_length_111_cov_827.500000	3	74	14	65	71	0.9154930
NODE_309126_length_111_cov_827.500000	8	74	10	1	66	0.0151515
NODE_309126_length_111_cov_827.500000	8	74	14	65	66	0.9848485
NODE_309126_length_111_cov_827.500000	47	111	0	1	64	0.0156250
NODE_309126_length_111_cov_827.500000	47	111	6	3	64	0.0468750
NODE_309126_length_111_cov_827.500000	47	111	8	1	64	0.0156250
NODE_309126_length_111_cov_827.500000	47	111	11	1	64	0.0156250
NODE_309126_length_111_cov_827.500000	47	111	14	58	64	0.9062500
NODE_309126_length_111_cov_827.500000	47	111	0	1	64	0.0156250
NODE_309126_length_111_cov_827.500000	47	111	6	3	64	0.0468750
NODE_309126_length_111_cov_827.500000	47	111	8	1	64	0.0156250
NODE_309126_length_111_cov_827.500000	47	111	11	1	64	0.0156250
NODE_309126_length_111_cov_827.500000	47	111	14	58	64	0.9062500
NODE_309126_length_111_cov_827.500000	47	111	0	1	64	0.0156250
NODE_309126_length_111_cov_827.500000	47	111	6	3	64	0.0468750
NODE_309126_length_111_cov_827.500000	47	111	8	1	64	0.0156250
NODE_309126_length_111_cov_827.500000	47	111	11	1	64	0.0156250
NODE_309126_length_111_cov_827.500000	47	111	14	58	64	0.9062500
NODE_309129_length_111_cov_726.833333	12	89	4	77	77	1.0000000
NODE_309129_length_111_cov_726.833333	12	89	4	77	77	1.0000000
NODE_309129_length_111_cov_726.833333	62	111	0	1	49	0.0204082
NODE_309129_length_111_cov_726.833333	62	111	4	48	49	0.9795918
NODE_309129_length_111_cov_726.833333	67	111	0	1	44	0.0227273
NODE_309129_length_111_cov_726.833333	67	111	4	43	44	0.9772727
NODE_309131_length_111_cov_692.416667	31	111	4	2	80	0.0250000
NODE_309131_length_111_cov_692.416667	31	111	8	78	80	0.9750000
NODE_309149_length_111_cov_241.750000	30	97	2	67	67	1.0000000
NODE_309160_length_111_cov_169.416667	21	102	0	81	81	1.0000000
NODE_309200_length_110_cov_554.909091	1	28	8	1	27	0.0370370
NODE_309200_length_110_cov_554.909091	1	28	10	2	27	0.0740741
NODE_309200_length_110_cov_554.909091	1	28	12	1	27	0.0370370
NODE_309200_length_110_cov_554.909091	1	28	14	23	27	0.8518519
NODE_309200_length_110_cov_554.909091	1	81	8	1	80	0.0125000
NODE_309200_length_110_cov_554.909091	1	81	10	2	80	0.0250000
NODE_309200_length_110_cov_554.909091	1	81	12	1	80	0.0125000
NODE_309200_length_110_cov_554.909091	1	81	14	76	80	0.9500000
NODE_309202_length_110_cov_537.545455	0	75	4	1	75	0.0133333
NODE_309202_length_110_cov_537.545455	0	75	6	4	75	0.0533333
NODE_309202_length_110_cov_537.545455	0	75	8	70	75	0.9333333
NODE_309202_length_110_cov_537.545455	53	107	6	4	54	0.0740741
NODE_309202_length_110_cov_537.545455	53	107	8	50	54	0.9259259
NODE_309235_length_110_cov_91.636364	19	54	0	35	35	1.0000000
NODE_309235_length_110_cov_91.636364	64	107	0	43	43	1.0000000
NODE_309239_length_110_cov_80.272727	19	54	0	35	35	1.0000000
NODE_309239_length_110_cov_80.272727	64	99	0	35	35	1.0000000
NODE_309241_length_110_cov_78.363636	19	54	0	35	35	1.0000000
NODE_309241_length_110_cov_78.363636	64	107	0	43	43	1.0000000
NODE_309245_length_110_cov_68.727273	11	46	0	35	35	1.0000000
NODE_309245_length_110_cov_68.727273	56	91	0	35	35	1.0000000
NODE_309252_length_110_cov_44.545455	5	57	0	52	52	1.0000000
NODE_309263_length_109_cov_1364.100000	29	98	0	69	69	1.0000000
NODE_309275_length_109_cov_689.800000	12	86	6	74	74	1.0000000
NODE_309309_length_109_cov_250.800000	4	66	0	62	62	1.0000000
NODE_309311_length_109_cov_242.000000	29	98	0	69	69	1.0000000
NODE_309326_length_109_cov_139.000000	26	106	0	1	80	0.0125000
NODE_309326_length_109_cov_139.000000	26	106	2	79	80	0.9875000
NODE_309345_length_109_cov_84.500000	33	93	0	60	60	1.0000000
NODE_309349_length_109_cov_75.300000	0	65	0	65	65	1.0000000
NODE_309384_length_108_cov_1542.666667	28	108	0	5	80	0.0625000
NODE_309384_length_108_cov_1542.666667	28	108	2	75	80	0.9375000
NODE_309391_length_108_cov_987.666667	5	85	0	80	80	1.0000000
NODE_309391_length_108_cov_987.666667	5	85	0	80	80	1.0000000
NODE_309391_length_108_cov_987.666667	5	85	0	80	80	1.0000000
NODE_309391_length_108_cov_987.666667	5	85	0	80	80	1.0000000
NODE_309391_length_108_cov_987.666667	5	85	0	80	80	1.0000000
NODE_309391_length_108_cov_987.666667	58	108	0	50	50	1.0000000
NODE_309391_length_108_cov_987.666667	58	108	0	50	50	1.0000000
NODE_309395_length_108_cov_841.666667	1	65	2	64	64	1.0000000
NODE_309395_length_108_cov_841.666667	1	65	2	64	64	1.0000000
NODE_309395_length_108_cov_841.666667	1	65	2	64	64	1.0000000
NODE_309433_length_108_cov_213.333333	22	81	0	59	59	1.0000000
NODE_309433_length_108_cov_213.333333	55	81	0	26	26	1.0000000
NODE_309464_length_108_cov_107.888889	11	82	0	71	71	1.0000000
NODE_309464_length_108_cov_107.888889	16	82	0	66	66	1.0000000
NODE_309464_length_108_cov_107.888889	55	108	0	53	53	1.0000000
NODE_309464_length_108_cov_107.888889	55	108	0	53	53	1.0000000
NODE_309464_length_108_cov_107.888889	55	108	0	53	53	1.0000000
NODE_309472_length_108_cov_76.444444	13	76	0	63	63	1.0000000
NODE_309479_length_108_cov_51.000000	0	53	0	53	53	1.0000000
NODE_309479_length_108_cov_51.000000	0	53	0	53	53	1.0000000
NODE_309479_length_108_cov_51.000000	0	53	0	53	53	1.0000000
NODE_309479_length_108_cov_51.000000	26	106	0	80	80	1.0000000
NODE_309479_length_108_cov_51.000000	26	106	0	80	80	1.0000000
NODE_309479_length_108_cov_51.000000	26	106	0	80	80	1.0000000
NODE_309479_length_108_cov_51.000000	26	106	0	80	80	1.0000000
NODE_309479_length_108_cov_51.000000	26	106	0	80	80	1.0000000
NODE_309479_length_108_cov_51.000000	26	97	0	71	71	1.0000000
NODE_309490_length_108_cov_31.111111	11	82	0	71	71	1.0000000
NODE_309490_length_108_cov_31.111111	16	82	0	66	66	1.0000000
NODE_309490_length_108_cov_31.111111	55	108	0	53	53	1.0000000
NODE_309490_length_108_cov_31.111111	55	108	0	53	53	1.0000000
NODE_309490_length_108_cov_31.111111	55	108	0	53	53	1.0000000
NODE_309530_length_107_cov_608.250000	0	64	0	64	64	1.0000000
NODE_309530_length_107_cov_608.250000	53	103	0	50	50	1.0000000
NODE_309551_length_107_cov_303.250000	0	56	0	1	56	0.0178571
NODE_309551_length_107_cov_303.250000	0	56	2	2	56	0.0357143
NODE_309551_length_107_cov_303.250000	0	56	6	53	56	0.9464286
NODE_309551_length_107_cov_303.250000	29	99	6	70	70	1.0000000
NODE_309657_length_106_cov_522.571429	10	90	0	80	80	1.0000000
NODE_309657_length_106_cov_522.571429	10	90	0	80	80	1.0000000
NODE_309657_length_106_cov_522.571429	10	90	0	80	80	1.0000000
NODE_309657_length_106_cov_522.571429	10	90	0	80	80	1.0000000
NODE_309657_length_106_cov_522.571429	10	90	0	80	80	1.0000000
NODE_309657_length_106_cov_522.571429	19	90	0	71	71	1.0000000
NODE_309696_length_106_cov_161.857143	7	78	0	71	71	1.0000000
NODE_309696_length_106_cov_161.857143	51	106	0	55	55	1.0000000
NODE_309707_length_106_cov_130.714286	0	76	0	76	76	1.0000000
NODE_309714_length_106_cov_108.000000	0	76	0	76	76	1.0000000
NODE_309717_length_106_cov_102.142857	0	62	0	62	62	1.0000000
NODE_309717_length_106_cov_102.142857	35	106	0	71	71	1.0000000
NODE_309717_length_106_cov_102.142857	35	106	0	71	71	1.0000000
NODE_309747_length_106_cov_39.428571	0	76	0	76	76	1.0000000
NODE_309761_length_106_cov_30.857143	0	70	0	70	70	1.0000000
NODE_309761_length_106_cov_30.857143	0	70	0	70	70	1.0000000
NODE_309761_length_106_cov_30.857143	0	70	0	70	70	1.0000000
NODE_309761_length_106_cov_30.857143	43	92	0	49	49	1.0000000
NODE_309761_length_106_cov_30.857143	53	106	0	53	53	1.0000000
NODE_309761_length_106_cov_30.857143	53	106	0	53	53	1.0000000
NODE_309775_length_105_cov_2054.666667	31	105	0	74	74	1.0000000
NODE_309775_length_105_cov_2054.666667	31	105	0	74	74	1.0000000
NODE_309775_length_105_cov_2054.666667	31	105	0	74	74	1.0000000
NODE_309775_length_105_cov_2054.666667	31	105	0	74	74	1.0000000
NODE_309788_length_105_cov_830.833333	30	105	0	75	75	1.0000000
NODE_309789_length_105_cov_825.500000	0	77	0	77	77	1.0000000
NODE_309789_length_105_cov_825.500000	0	77	0	77	77	1.0000000
NODE_309789_length_105_cov_825.500000	50	99	0	49	49	1.0000000
NODE_309789_length_105_cov_825.500000	55	105	0	50	50	1.0000000
NODE_309815_length_105_cov_231.333333	0	54	0	54	54	1.0000000
NODE_309815_length_105_cov_231.333333	27	99	0	72	72	1.0000000
NODE_309842_length_105_cov_85.333333	14	94	0	80	80	1.0000000
NODE_309842_length_105_cov_85.333333	67	89	0	22	22	1.0000000
NODE_309855_length_105_cov_61.833333	23	103	0	80	80	1.0000000
NODE_309867_length_105_cov_40.666667	6	66	0	60	60	1.0000000
NODE_309925_length_104_cov_1016.000000	0	78	0	78	78	1.0000000
NODE_309925_length_104_cov_1016.000000	53	99	0	46	46	1.0000000
NODE_309935_length_104_cov_791.200000	0	67	0	67	67	1.0000000
NODE_309935_length_104_cov_791.200000	0	67	0	67	67	1.0000000
NODE_309935_length_104_cov_791.200000	40	104	0	64	64	1.0000000
NODE_309938_length_104_cov_574.200000	21	101	0	80	80	1.0000000
NODE_309938_length_104_cov_574.200000	21	101	0	80	80	1.0000000
NODE_309938_length_104_cov_574.200000	21	101	0	80	80	1.0000000
NODE_309938_length_104_cov_574.200000	21	101	0	80	80	1.0000000
NODE_309938_length_104_cov_574.200000	21	101	0	80	80	1.0000000
NODE_309938_length_104_cov_574.200000	21	92	0	71	71	1.0000000
NODE_309940_length_104_cov_547.400000	10	87	2	77	77	1.0000000
NODE_309940_length_104_cov_547.400000	10	87	2	77	77	1.0000000
NODE_310020_length_104_cov_46.800000	42	104	0	62	62	1.0000000
NODE_310054_length_103_cov_2267.000000	0	54	2	54	54	1.0000000
NODE_310054_length_103_cov_2267.000000	27	100	2	73	73	1.0000000
NODE_310082_length_103_cov_890.000000	6	70	0	64	64	1.0000000
NODE_310082_length_103_cov_890.000000	6	70	0	64	64	1.0000000
NODE_310082_length_103_cov_890.000000	6	70	0	64	64	1.0000000
NODE_310082_length_103_cov_890.000000	43	103	0	60	60	1.0000000
NODE_310082_length_103_cov_890.000000	59	103	0	44	44	1.0000000
NODE_310090_length_103_cov_768.500000	7	78	0	71	71	1.0000000
NODE_310090_length_103_cov_768.500000	12	78	0	66	66	1.0000000
NODE_310090_length_103_cov_768.500000	51	99	0	48	48	1.0000000
NODE_310090_length_103_cov_768.500000	51	99	0	48	48	1.0000000
NODE_310090_length_103_cov_768.500000	51	99	0	48	48	1.0000000
NODE_310091_length_103_cov_751.000000	0	71	0	71	71	1.0000000
NODE_310091_length_103_cov_751.000000	0	71	0	71	71	1.0000000
NODE_310091_length_103_cov_751.000000	44	93	0	49	49	1.0000000
NODE_310094_length_103_cov_678.000000	10	74	0	64	64	1.0000000
NODE_310094_length_103_cov_678.000000	10	74	0	64	64	1.0000000
NODE_310094_length_103_cov_678.000000	10	74	0	64	64	1.0000000
NODE_310094_length_103_cov_678.000000	47	96	0	49	49	1.0000000
NODE_310103_length_103_cov_462.750000	19	99	0	80	80	1.0000000
NODE_310116_length_103_cov_300.250000	0	63	0	63	63	1.0000000
NODE_310147_length_103_cov_103.250000	4	47	0	43	43	1.0000000
NODE_310152_length_103_cov_80.250000	36	99	0	63	63	1.0000000
NODE_310153_length_103_cov_76.500000	4	63	0	59	59	1.0000000
NODE_310160_length_103_cov_42.000000	0	78	0	78	78	1.0000000
NODE_310160_length_103_cov_42.000000	7	78	0	71	71	1.0000000
NODE_310160_length_103_cov_42.000000	12	78	0	66	66	1.0000000
NODE_310160_length_103_cov_42.000000	51	99	0	48	48	1.0000000
NODE_310160_length_103_cov_42.000000	51	99	0	48	48	1.0000000
NODE_310160_length_103_cov_42.000000	51	99	0	48	48	1.0000000
NODE_310211_length_102_cov_2033.666667	0	48	0	48	48	1.0000000
NODE_310211_length_102_cov_2033.666667	21	101	0	80	80	1.0000000
NODE_310227_length_102_cov_1028.333333	52	102	0	50	50	1.0000000
NODE_310230_length_102_cov_987.666667	15	98	0	83	83	1.0000000
NODE_310231_length_102_cov_934.000000	12	95	0	83	83	1.0000000
NODE_310246_length_102_cov_685.666667	0	73	0	73	73	1.0000000
NODE_310247_length_102_cov_646.666667	15	89	0	74	74	1.0000000
NODE_310269_length_102_cov_250.000000	12	72	0	60	60	1.0000000
NODE_310273_length_102_cov_216.333333	4	70	0	66	66	1.0000000
NODE_310273_length_102_cov_216.333333	4	70	0	66	66	1.0000000
NODE_310273_length_102_cov_216.333333	4	70	0	66	66	1.0000000
NODE_310273_length_102_cov_216.333333	43	92	0	49	49	1.0000000
NODE_310273_length_102_cov_216.333333	57	102	0	45	45	1.0000000
NODE_310287_length_102_cov_152.333333	0	63	0	63	63	1.0000000
NODE_310295_length_102_cov_124.333333	0	70	0	70	70	1.0000000
NODE_310302_length_102_cov_106.333333	0	78	0	78	78	1.0000000
NODE_310302_length_102_cov_106.333333	7	78	0	71	71	1.0000000
NODE_310302_length_102_cov_106.333333	12	78	0	66	66	1.0000000
NODE_310302_length_102_cov_106.333333	51	102	0	51	51	1.0000000
NODE_310302_length_102_cov_106.333333	51	102	0	51	51	1.0000000
NODE_310302_length_102_cov_106.333333	51	102	0	51	51	1.0000000
NODE_310316_length_102_cov_74.333333	31	99	0	68	68	1.0000000
NODE_310321_length_102_cov_71.000000	11	91	0	80	80	1.0000000
NODE_310336_length_102_cov_32.666667	0	65	0	65	65	1.0000000
NODE_310336_length_102_cov_32.666667	38	99	0	61	61	1.0000000
NODE_310405_length_101_cov_2217.000000	0	43	0	43	43	1.0000000
NODE_310405_length_101_cov_2217.000000	23	96	0	73	73	1.0000000
NODE_310464_length_101_cov_740.500000	2	66	0	64	64	1.0000000
NODE_310464_length_101_cov_740.500000	2	66	0	64	64	1.0000000
NODE_310464_length_101_cov_740.500000	2	66	0	64	64	1.0000000
NODE_310464_length_101_cov_740.500000	39	101	0	62	62	1.0000000
NODE_310464_length_101_cov_740.500000	55	101	0	46	46	1.0000000
NODE_310469_length_101_cov_701.000000	0	62	0	62	62	1.0000000
NODE_310469_length_101_cov_701.000000	35	99	0	64	64	1.0000000
NODE_310469_length_101_cov_701.000000	35	99	0	64	64	1.0000000
NODE_310469_length_101_cov_701.000000	35	99	0	64	64	1.0000000
NODE_310471_length_101_cov_679.000000	2	76	0	74	74	1.0000000
NODE_310500_length_101_cov_374.500000	2	50	0	48	48	1.0000000
NODE_310500_length_101_cov_374.500000	2	50	0	48	48	1.0000000
NODE_310500_length_101_cov_374.500000	2	50	0	48	48	1.0000000
NODE_310500_length_101_cov_374.500000	23	89	0	66	66	1.0000000
NODE_310500_length_101_cov_374.500000	23	94	0	71	71	1.0000000
NODE_310516_length_101_cov_294.000000	4	52	0	48	48	1.0000000
NODE_310516_length_101_cov_294.000000	4	52	0	48	48	1.0000000
NODE_310516_length_101_cov_294.000000	4	52	0	48	48	1.0000000
NODE_310516_length_101_cov_294.000000	25	91	0	66	66	1.0000000
NODE_310516_length_101_cov_294.000000	25	96	0	71	71	1.0000000
NODE_310529_length_101_cov_230.500000	2	76	0	74	74	1.0000000
NODE_310529_length_101_cov_230.500000	2	76	0	74	74	1.0000000
NODE_310529_length_101_cov_230.500000	2	76	0	74	74	1.0000000
NODE_310529_length_101_cov_230.500000	49	101	0	52	52	1.0000000
NODE_310529_length_101_cov_230.500000	55	101	0	46	46	1.0000000
NODE_310550_length_101_cov_157.000000	13	72	0	59	59	1.0000000
NODE_310550_length_101_cov_157.000000	46	72	0	26	26	1.0000000
NODE_310565_length_101_cov_134.500000	2	37	0	35	35	1.0000000
NODE_310685_length_100_cov_1883.000000	32	100	0	68	68	1.0000000
NODE_310685_length_100_cov_1883.000000	32	100	0	68	68	1.0000000
NODE_310685_length_100_cov_1883.000000	32	99	0	67	67	1.0000000
NODE_310685_length_100_cov_1883.000000	32	100	0	68	68	1.0000000
NODE_310704_length_100_cov_1310.000000	0	42	0	42	42	1.0000000
NODE_310704_length_100_cov_1310.000000	1	42	0	41	41	1.0000000
NODE_310704_length_100_cov_1310.000000	38	100	0	62	62	1.0000000
NODE_310704_length_100_cov_1310.000000	38	95	0	57	57	1.0000000
NODE_310704_length_100_cov_1310.000000	38	100	0	62	62	1.0000000
NODE_310704_length_100_cov_1310.000000	38	100	0	62	62	1.0000000
NODE_310708_length_100_cov_1239.000000	1	48	0	47	47	1.0000000
NODE_310740_length_100_cov_694.000000	0	62	0	62	62	1.0000000
NODE_310740_length_100_cov_694.000000	0	62	0	62	62	1.0000000
NODE_310740_length_100_cov_694.000000	35	100	0	65	65	1.0000000
NODE_310748_length_100_cov_602.000000	0	57	0	57	57	1.0000000
NODE_310750_length_100_cov_590.000000	0	58	0	58	58	1.0000000
NODE_310798_length_100_cov_274.000000	1	67	0	66	66	1.0000000
NODE_310798_length_100_cov_274.000000	1	67	0	66	66	1.0000000
NODE_310798_length_100_cov_274.000000	1	67	0	66	66	1.0000000
NODE_310798_length_100_cov_274.000000	40	100	0	60	60	1.0000000
NODE_310798_length_100_cov_274.000000	54	100	0	46	46	1.0000000
NODE_310808_length_100_cov_217.000000	4	75	0	71	71	1.0000000
NODE_310808_length_100_cov_217.000000	9	75	0	66	66	1.0000000
NODE_310808_length_100_cov_217.000000	48	99	0	51	51	1.0000000
NODE_310808_length_100_cov_217.000000	48	99	0	51	51	1.0000000
NODE_310808_length_100_cov_217.000000	48	99	0	51	51	1.0000000
NODE_310810_length_100_cov_209.000000	1	44	0	43	43	1.0000000
NODE_310810_length_100_cov_209.000000	40	100	0	60	60	1.0000000
NODE_310810_length_100_cov_209.000000	40	100	0	60	60	1.0000000
NODE_310819_length_100_cov_185.000000	0	46	0	46	46	1.0000000
NODE_310819_length_100_cov_185.000000	9	58	0	49	49	1.0000000
NODE_310819_length_100_cov_185.000000	31	99	0	68	68	1.0000000
NODE_310819_length_100_cov_185.000000	31	99	0	68	68	1.0000000
NODE_310819_length_100_cov_185.000000	31	99	0	68	68	1.0000000
NODE_310828_length_100_cov_164.000000	9	92	0	83	83	1.0000000
NODE_310837_length_100_cov_152.000000	11	91	0	80	80	1.0000000
NODE_310837_length_100_cov_152.000000	11	91	0	80	80	1.0000000
NODE_310837_length_100_cov_152.000000	11	91	0	80	80	1.0000000
NODE_310837_length_100_cov_152.000000	11	91	0	80	80	1.0000000
NODE_310837_length_100_cov_152.000000	11	91	0	80	80	1.0000000
NODE_310839_length_100_cov_150.000000	0	54	0	54	54	1.0000000
NODE_310839_length_100_cov_150.000000	0	54	0	54	54	1.0000000
NODE_310839_length_100_cov_150.000000	27	100	0	73	73	1.0000000
NODE_310839_length_100_cov_150.000000	27	100	0	73	73	1.0000000
NODE_310840_length_100_cov_148.000000	2	82	0	80	80	1.0000000
NODE_310841_length_100_cov_148.000000	0	71	0	71	71	1.0000000
NODE_310841_length_100_cov_148.000000	0	71	0	71	71	1.0000000
NODE_310841_length_100_cov_148.000000	0	62	0	62	62	1.0000000
NODE_310876_length_100_cov_71.000000	0	75	0	75	75	1.0000000
NODE_310876_length_100_cov_71.000000	4	75	0	71	71	1.0000000
NODE_310876_length_100_cov_71.000000	9	75	0	66	66	1.0000000
NODE_310876_length_100_cov_71.000000	48	100	0	52	52	1.0000000
NODE_310876_length_100_cov_71.000000	48	100	0	52	52	1.0000000
NODE_310876_length_100_cov_71.000000	48	100	0	52	52	1.0000000
NODE_310896_length_100_cov_41.000000	0	75	0	75	75	1.0000000
NODE_310896_length_100_cov_41.000000	4	75	0	71	71	1.0000000
NODE_310896_length_100_cov_41.000000	9	75	0	66	66	1.0000000
NODE_310896_length_100_cov_41.000000	48	99	0	51	51	1.0000000
NODE_310896_length_100_cov_41.000000	48	99	0	51	51	1.0000000
NODE_310896_length_100_cov_41.000000	48	99	0	51	51	1.0000000
NODE_310904_length_100_cov_30.000000	1	42	0	41	41	1.0000000
